ibge;anomes;cadunico_tot_fam;cadunico_tot_pes;cadunico_tot_fam_rpc_ate_meio_sm;cadunico_tot_pes_rpc_ate_meio_sm;cadunico_tot_fam_pob;cadunico_tot_pes_pob;cadunico_tot_fam_ext_pob;cadunico_tot_pes_ext_pob;cadunico_tot_fam_pob_e_ext_pob;cadunico_tot_pes_pob_e_ext_pob
110001;201312;4385;14561;3806;13616;1107;4104;2026;7338;3133;11442
110002;201312;12913;42188;11372;39453;3832;14262;4793;16698;8625;30960
110003;201312;980;3214;915;3108;276;995;377;1243;653;2238
110004;201312;9429;31304;8106;28480;2620;10040;2663;9333;5283;19373
110005;201312;2359;8012;2238;7778;864;3096;903;3173;1767;6269
110006;201312;3413;9239;2132;7410;718;2650;614;2012;1332;4662
110007;201312;1490;4790;1379;4624;321;1147;776;2757;1097;3904
110008;201312;2586;8932;2426;8702;587;2022;1598;6045;2185;8067
110009;201312;5326;15523;4178;13810;1067;3754;2083;6825;3150;10579
110010;201312;8378;24250;7407;23043;1540;4390;4745;16017;6285;20407
110011;201312;10814;33597;8931;30309;3417;12298;3097;10492;6514;22790
110012;201312;16478;51753;14421;47773;5087;17890;5188;17008;10275;34898
110013;201312;5235;16794;4376;15540;1418;5322;1931;6972;3349;12294
110014;201312;4308;12990;3662;12059;865;2983;2150;7173;3015;10156
110015;201312;5095;16676;4194;15043;1650;6299;1379;4963;3029;11262
110018;201312;5127;15297;4211;14091;1338;4977;1890;6095;3228;11072
110020;201312;55054;164799;46938;154477;10992;37332;27658;93828;38650;131160
110025;201312;4433;13201;3745;11953;629;2156;2631;8370;3260;10526
110026;201312;821;2412;693;2260;163;537;450;1519;613;2056
110028;201312;7438;22318;5630;19292;1753;6557;1575;5286;3328;11843
110029;201312;1692;5047;1366;4482;465;1595;558;1867;1023;3462
110030;201312;11270;32918;9277;30350;2569;9013;4805;16279;7374;25292
110032;201312;4059;13443;3648;12519;1080;3855;1547;5361;2627;9216
110033;201312;5511;17870;5141;17290;1738;5930;2310;8316;4048;14246
110034;201312;3855;10200;3241;9462;508;1447;2488;7370;2996;8817
110037;201312;2053;7050;1806;6582;513;1884;961;3564;1474;5448
110040;201312;3511;11631;3273;11192;1085;3984;1494;5058;2579;9042
110045;201312;5195;18107;4810;17638;1447;5642;2740;10030;4187;15672
110050;201312;1830;5928;1531;5535;547;2017;773;2866;1320;4883
110060;201312;991;3494;877;3280;259;1019;457;1706;716;2725
110070;201312;1947;6718;1892;6586;328;1199;1334;4667;1662;5866
110080;201312;3398;11071;3274;10909;687;2169;2418;8309;3105;10478
110090;201312;930;2802;744;2500;242;901;304;944;546;1845
110092;201312;1728;5627;1570;5417;376;1321;888;3232;1264;4553
110094;201312;3097;10062;2847;9689;753;2725;1646;5720;2399;8445
110100;201312;2649;8544;2298;7952;718;2586;1139;3970;1857;6556
110110;201312;1770;5792;1657;5659;754;2608;702;2513;1456;5121
110120;201312;1600;5455;1350;4830;382;1422;509;1827;891;3249
110130;201312;2782;8043;2127;7091;573;2006;1026;3462;1599;5468
110140;201312;2489;8679;2358;8469;527;1915;1528;5612;2055;7527
110143;201312;1571;5159;1245;4588;319;1222;677;2488;996;3710
110145;201312;991;3063;876;2876;175;617;553;1820;728;2437
110146;201312;449;1461;406;1392;109;385;220;766;329;1151
110147;201312;903;2728;706;2396;202;742;248;760;450;1502
110148;201312;1335;4022;1069;3481;353;1273;358;1096;711;2369
110149;201312;3695;10980;2931;9788;716;2536;1787;6038;2503;8574
110150;201312;2857;8538;2364;7798;395;1423;1512;5010;1907;6433
110155;201312;919;3109;874;3005;297;1092;422;1412;719;2504
110160;201312;2176;6905;1801;6236;613;2174;824;2882;1437;5056
110170;201312;3208;9419;2515;8230;557;1951;1544;5085;2101;7036
110175;201312;1596;5187;1236;4721;121;501;915;3543;1036;4044
110180;201312;1693;5348;1450;4936;350;1217;866;2989;1216;4206
120001;201312;2851;10351;2753;10163;727;2850;1527;5757;2254;8607
120005;201312;1545;6233;1500;6149;181;706;1153;4918;1334;5624
120010;201312;4395;15748;4221;15443;1007;3488;2683;10317;3690;13805
120013;201312;1829;7186;1791;7121;386;1544;1164;4848;1550;6392
120017;201312;2108;7586;1989;7367;563;2191;945;3792;1508;5983
120020;201312;14088;62259;13859;61705;2582;10876;9906;46201;12488;57077
120025;201312;2678;9384;2598;9255;657;2455;1532;5547;2189;8002
120030;201312;5864;23919;5805;23821;548;2109;4882;20517;5430;22626
120032;201312;1365;6646;1314;6515;186;1059;958;4790;1144;5849
120033;201312;3585;13761;3554;13702;224;897;3139;12256;3363;13153
120034;201312;1764;7159;1756;7146;78;366;1637;6655;1715;7021
120035;201312;2722;13198;2692;13122;254;1204;2227;11212;2481;12416
120038;201312;3186;11780;3069;11521;895;3461;1597;6193;2492;9654
120039;201312;1357;7701;1333;7641;181;1089;1048;6105;1229;7194
120040;201312;44038;161908;40837;154933;12634;50257;19252;75019;31886;125276
120042;201312;2736;12036;2637;11787;434;2021;1846;8448;2280;10469
120043;201312;827;3981;802;3923;74;359;670;3356;744;3715
120045;201312;4390;15509;4340;15430;1086;3838;2902;10636;3988;14474
120050;201312;8114;33744;7854;33196;1568;6433;5133;23016;6701;29449
120060;201312;6297;30481;6202;30309;777;3820;4947;24854;5724;28674
120070;201312;2741;10527;2690;10400;587;2153;1706;6966;2293;9119
120080;201312;3663;13944;3511;13687;613;2435;2513;10099;3126;12534
130002;201312;2841;12152;2680;11871;286;1294;2117;9549;2403;10843
130006;201312;1684;7338;1516;7021;191;977;1104;5169;1295;6146
130008;201312;1969;8128;1888;7972;182;838;1504;6482;1686;7320
130010;201312;2713;9191;2358;8772;244;829;1945;7458;2189;8287
130014;201312;3416;11146;2956;10452;460;1762;1971;7046;2431;8808
130020;201312;2412;8582;2398;8566;55;210;2320;8287;2375;8497
130030;201312;6799;27077;6603;26816;579;2002;5700;23835;6279;25837
130040;201312;3634;11556;3425;11253;355;1245;2853;9390;3208;10635
130050;201312;5826;23671;5159;22595;771;3210;3579;16841;4350;20051
130060;201312;5893;25693;5549;25188;638;2832;4481;20831;5119;23663
130063;201312;3209;14318;3185;14273;385;1661;2639;12096;3024;13757
130068;201312;2998;12702;2785;12276;354;1727;2011;8910;2365;10637
130070;201312;6452;22052;5942;21376;715;2526;4657;17208;5372;19734
130080;201312;4990;22352;4839;22122;837;3944;3455;16269;4292;20213
130083;201312;1740;7401;1665;7272;300;1454;1140;4978;1440;6432
130090;201312;2401;8851;2290;8695;201;897;1943;7344;2144;8241
130100;201312;5354;20803;5153;20523;463;1989;4313;17377;4776;19366
130110;201312;6517;21361;6120;20873;821;2673;4825;17045;5646;19718
130115;201312;3620;13591;3458;13374;141;422;3236;12688;3377;13110
130120;201312;13002;50879;12705;50458;1218;4467;10725;43915;11943;48382
130130;201312;3311;14430;3208;14236;477;2072;2453;11184;2930;13256
130140;201312;5698;23142;5657;23089;140;419;5465;22556;5605;22975
130150;201312;3492;13045;3415;12944;225;1059;2988;11289;3213;12348
130160;201312;3855;16061;3792;15969;239;867;3455;14770;3694;15637
130165;201312;2722;11331;2681;11261;481;2017;2051;8758;2532;10775
130170;201312;8465;31967;7447;30637;1465;6096;4937;21330;6402;27426
130180;201312;3317;10618;3251;10526;120;360;3030;9873;3150;10233
130185;201312;8810;31886;8509;31484;1599;5671;6191;23871;7790;29542
130190;201312;16323;58258;14504;55909;3149;11765;9192;37708;12341;49473
130195;201312;1751;7374;1692;7284;98;453;1493;6502;1591;6955
130200;201312;1970;7219;1828;6971;353;1399;1207;4683;1560;6082
130210;201312;1125;4492;1069;4391;169;675;797;3398;966;4073
130220;201312;2011;8353;1837;8027;369;1794;1083;4766;1452;6560
130230;201312;3288;15064;3127;14785;415;2085;2303;11257;2718;13342
130240;201312;8106;31883;7502;30976;519;2416;6352;26644;6871;29060
130250;201312;17069;63152;16539;62359;3047;11010;11878;46888;14925;57898
130255;201312;3907;14331;3696;13959;187;596;3278;12751;3465;13347
130260;201312;244163;800425;221507;763936;63174;222800;114729;410579;177903;633379
130270;201312;7235;30407;6541;29309;1135;4949;4593;21638;5728;26587
130280;201312;3152;12451;3081;12344;155;513;2777;11410;2932;11923
130290;201312;10553;38606;10374;38347;230;679;9800;36788;10030;37467
130300;201312;4314;16980;4070;16621;349;1542;3337;13822;3686;15364
130310;201312;4769;18436;4354;17906;672;2662;3209;13713;3881;16375
130320;201312;2814;9781;2577;9454;376;1448;1833;6886;2209;8334
130330;201312;3371;12715;3011;12212;239;1023;2511;10386;2750;11409
130340;201312;16819;66426;16277;65533;3138;11926;10930;46931;14068;58857
130350;201312;3198;13065;3054;12894;353;1368;2470;10762;2823;12130
130353;201312;5529;17794;4911;16932;1338;4614;2725;9987;4063;14601
130356;201312;4152;15310;3993;15058;494;1728;3174;12511;3668;14239
130360;201312;2744;7962;2474;7646;53;114;2315;7346;2368;7460
130370;201312;4834;19294;4141;18364;269;1460;3465;15446;3734;16906
130380;201312;6703;28398;6463;28006;438;2057;5559;24333;5997;26390
130390;201312;4411;19828;4137;19348;491;2319;3248;15620;3739;17939
130395;201312;2007;7461;1839;7152;307;1328;1197;4638;1504;5966
130400;201312;2136;7824;2068;7721;95;374;1878;7090;1973;7464
130406;201312;9192;35767;8229;34185;2087;8438;4656;20754;6743;29192
130410;201312;4081;15699;3768;15107;920;3806;2101;8781;3021;12587
130420;201312;9747;41971;9427;41302;2890;12401;5154;23980;8044;36381
130423;201312;3044;12048;2891;11844;240;1154;2447;10044;2687;11198
130426;201312;1983;8625;1899;8474;345;1529;1314;6134;1659;7663
130430;201312;3402;12389;3212;12105;396;1631;2345;9011;2741;10642
130440;201312;3726;13650;3432;13328;215;718;3041;12169;3256;12887
140002;201312;1418;4812;1333;4678;192;653;936;3457;1128;4110
140005;201312;2568;8011;2399;7816;137;418;2165;7152;2302;7570
140010;201312;43851;144637;39737;137699;9453;34870;22575;79939;32028;114809
140015;201312;2792;9386;2700;9263;256;608;2292;8255;2548;8863
140017;201312;2836;9125;2707;8961;211;648;2317;7846;2528;8494
140020;201312;4214;14534;3947;14176;506;1749;2999;11161;3505;12910
140023;201312;1925;6811;1756;6522;267;1070;1182;4502;1449;5572
140028;201312;2106;5965;2042;5891;111;254;1852;5476;1963;5730
140030;201312;3507;11437;3361;11247;405;1018;2812;9906;3217;10924
140040;201312;1467;7118;1409;6940;131;723;1051;5284;1182;6007
140045;201312;2364;8675;2232;8492;309;1013;1710;6955;2019;7968
140047;201312;5087;14517;4655;13915;1582;4924;1835;5962;3417;10886
140050;201312;1469;4588;1369;4445;178;591;1036;3440;1214;4031
140060;201312;1372;4414;1257;4255;338;1186;727;2551;1065;3737
140070;201312;1416;6993;1413;6987;58;235;1342;6710;1400;6945
150010;201312;31924;105377;30612;103596;2294;8186;26038;89220;28332;97406
150013;201312;1523;4831;1475;4777;138;495;1213;3933;1351;4428
150020;201312;10573;37683;10334;37317;1450;5226;8048;29722;9498;34948
150030;201312;6230;27467;6067;27184;677;2578;5000;23424;5677;26002
150034;201312;4332;11900;4111;11630;151;342;3895;11176;4046;11518
150040;201312;11977;42403;10563;40603;2344;8196;6946;28807;9290;37003
150050;201312;5954;22997;5813;22727;649;2750;4660;18385;5309;21135
150060;201312;14825;49460;14042;48261;3581;12087;8442;30355;12023;42442
150070;201312;5240;22634;4853;22159;545;2518;3960;18453;4505;20971
150080;201312;58957;163604;52614;155512;7598;20861;38602;117916;46200;138777
150085;201312;5003;17950;4793;17644;728;2342;3702;14337;4430;16679
150090;201312;9736;38278;9215;37551;1234;4800;7166;30117;8400;34917
150095;201312;5038;17701;4683;17138;551;2013;3677;13836;4228;15849
150100;201312;3368;12931;3176;12650;291;1378;2567;10151;2858;11529
150110;201312;3123;15061;3111;15031;162;673;2877;14098;3039;14771
150120;201312;5828;23229;5692;22958;1031;4041;4170;17199;5201;21240
150125;201312;792;2479;729;2378;168;574;440;1438;608;2012
150130;201312;19433;63183;18557;61868;1804;6040;15066;50976;16870;57016
150140;201312;139502;426608;134744;420605;18455;57585;106371;337008;124826;394593
150145;201312;4835;15398;4470;14930;691;2422;3243;10980;3934;13402
150150;201312;9175;30763;8625;29872;1889;6800;5490;19285;7379;26085
150157;201312;2805;9028;2557;8682;416;1458;1918;6580;2334;8038
150160;201312;2746;9480;2624;9299;706;2403;1568;5845;2274;8248
150170;201312;21700;81137;20634;79725;3782;14337;15013;59184;18795;73521
150172;201312;2936;10343;2659;9928;334;1280;2117;8039;2451;9319
150175;201312;1980;6329;1916;6253;151;459;1677;5596;1828;6055
150178;201312;10624;33720;9237;32077;550;1657;8274;29432;8824;31089
150180;201312;17371;71112;16856;70399;1652;7226;14036;59463;15688;66689
150190;201312;7075;22925;6693;22390;440;1056;5856;20426;6296;21482
150195;201312;4495;16162;4216;15671;486;1809;3335;12603;3821;14412
150200;201312;4923;16289;4797;16132;142;427;4505;15328;4647;15755
150210;201312;21871;84986;21571;84543;2265;8438;18204;72757;20469;81195
150215;201312;5758;18772;5262;18026;1334;4692;3021;10651;4355;15343
150220;201312;12332;40262;11329;38644;2809;9833;6250;21958;9059;31791
150230;201312;11008;38258;10033;36873;857;3815;8287;30232;9144;34047
150240;201312;32872;102490;30052;97644;9157;30993;13684;45799;22841;76792
150250;201312;3871;15823;3750;15634;717;2847;2635;11580;3352;14427
150260;201312;1834;7835;1761;7696;372;1775;1068;4745;1440;6520
150270;201312;9452;29161;7388;26571;1718;6560;4513;16577;6231;23137
150275;201312;5654;21033;5366;20558;871;3387;3866;15146;4737;18533
150276;201312;2078;6330;1939;6148;324;1080;1468;4673;1792;5753
150277;201312;5024;15982;4423;15272;544;1913;3499;12354;4043;14267
150280;201312;5747;25301;5604;24975;830;3630;4235;19374;5065;23004
150285;201312;2596;10635;2568;10573;273;1127;2132;8892;2405;10019
150290;201312;8408;26981;8209;26725;852;2519;6786;22847;7638;25366
150293;201312;8160;26170;7080;24479;2446;8750;3093;11217;5539;19967
150295;201312;5584;19426;4974;18632;1197;4605;3126;12041;4323;16646
150300;201312;1777;6342;1737;6284;125;425;1461;5455;1586;5880
150304;201312;4047;12816;3520;12087;523;1815;2549;9028;3072;10843
150307;201312;6453;22561;6014;21920;488;1715;5008;18805;5496;20520
150309;201312;6366;23163;5945;22567;1637;6176;3638;14468;5275;20644
150310;201312;4892;23081;4806;22931;548;2456;3926;19322;4474;21778
150320;201312;8431;23114;8105;22758;582;1517;7076;20305;7658;21822
150330;201312;12925;47843;12316;46839;1566;5966;9546;37233;11112;43199
150340;201312;2091;7332;1978;7168;406;1560;1285;4711;1691;6271
150345;201312;6346;22729;5952;22188;698;2619;4801;18317;5499;20936
150350;201312;7167;24339;6817;23815;1011;3460;5053;18043;6064;21503
150360;201312;20435;66048;18011;62985;2829;10113;12957;46729;15786;56842
150370;201312;9794;37532;9418;37005;1158;4182;7670;31267;8828;35449
150375;201312;2711;11573;2656;11499;213;718;2303;10432;2516;11150
150380;201312;9195;29150;8389;28026;898;3182;6907;23189;7805;26371
150390;201312;7992;34758;7638;34016;1864;7843;4610;21771;6474;29614
150400;201312;5241;22241;5075;21872;647;2712;3782;16847;4429;19559
150405;201312;8052;25583;7332;24665;1496;4577;4991;17892;6487;22469
150410;201312;1664;6532;1629;6473;318;1287;1049;4303;1367;5590
150420;201312;32244;118435;29396;113673;7784;31617;15792;63315;23576;94932
150430;201312;6410;24201;6212;23842;799;3325;4770;18446;5569;21771
150440;201312;5246;18621;5139;18451;803;2834;3826;14049;4629;16883
150442;201312;21113;62068;19409;59863;3338;10497;13355;42377;16693;52874
150445;201312;5009;18096;4643;17569;715;2550;3525;13775;4240;16325
150450;201312;4158;20077;4029;19905;418;2032;3351;16936;3769;18968
150460;201312;6740;24924;5647;23758;475;2113;4856;20882;5331;22995
150470;201312;16797;52444;16254;51744;1380;3658;14144;46383;15524;50041
150475;201312;291;829;224;741;68;219;99;374;167;593
150480;201312;13843;47961;13277;47139;965;3161;11441;41562;12406;44723
150490;201312;6333;24845;6220;24693;352;1398;5624;22560;5976;23958
150495;201312;4527;16968;4434;16804;345;1328;3876;14788;4221;16116
150497;201312;3248;11455;2974;10991;870;3242;1655;6377;2525;9619
150500;201312;2850;8571;2731;8373;416;1244;2040;6326;2456;7570
150503;201312;3721;11947;3186;11254;1191;4403;1372;5056;2563;9459
150506;201312;12138;43942;11344;42844;2793;9569;7337;29832;10130;39401
150510;201312;9465;37960;8908;36979;1474;6154;6266;27091;7740;33245
150520;201312;5979;25015;5885;24873;498;1678;5193;22585;5691;24263
150530;201312;11242;41096;10290;39640;1478;5154;7596;30512;9074;35666
150540;201312;4559;14333;4170;13746;359;1229;3456;11408;3815;12637
150543;201312;4770;15531;4413;15012;1373;4718;2474;8665;3847;13383
150548;201312;8018;26448;7574;25876;680;2168;6473;22620;7153;24788
150549;201312;2162;6986;2063;6865;112;283;1861;6360;1973;6643
150550;201312;20660;67061;18506;63305;5631;19968;8631;30223;14262;50191
150553;201312;21302;79433;19176;74104;7816;32287;3582;13595;11398;45882
150555;201312;1638;5283;1446;4999;243;904;1010;3529;1253;4433
150560;201312;1981;6485;1914;6339;247;889;1431;4713;1678;5602
150563;201312;2812;9499;2630;9164;622;2321;1560;5438;2182;7759
150565;201312;3315;12128;3119;11832;263;1101;2522;9726;2785;10827
150570;201312;5103;19991;5022;19849;421;1601;4222;17145;4643;18746
150580;201312;9245;38332;9091;38135;822;2971;7831;34037;8653;37008
150590;201312;5290;21697;5177;21560;130;566;4905;20559;5035;21125
150600;201312;7362;29484;7196;29202;628;2323;6178;25756;6806;28079
150610;201312;2438;8480;2259;8103;291;1194;1562;5508;1853;6702
150611;201312;2592;9664;2476;9393;309;1217;1785;6866;2094;8083
150613;201312;11096;35254;9781;33361;3350;11724;4536;16310;7886;28034
150616;201312;3016;8827;2405;8097;582;1941;1499;5203;2081;7144
150618;201312;7348;26203;7050;25637;2321;8832;3407;12641;5728;21473
150619;201312;5111;18063;4811;17610;734;2834;3442;12778;4176;15612
150620;201312;5929;22045;5423;21382;803;3185;4092;16729;4895;19914
150630;201312;5180;16682;4962;16399;443;1452;4168;13996;4611;15448
150635;201312;4400;14722;4134;14217;816;2881;2566;9139;3382;12020
150640;201312;1392;4578;1379;4557;39;108;1306;4369;1345;4477
150650;201312;11798;37308;10771;35439;2975;10212;5498;18411;8473;28623
150655;201312;5255;17791;4850;17195;737;2684;3590;12919;4327;15603
150658;201312;3968;13448;3768;13119;388;1621;2933;10130;3321;11751
150660;201312;5523;17883;5065;17289;1391;4696;2921;10398;4312;15094
150670;201312;6004;18012;5253;17104;1747;5757;2733;9512;4480;15269
150680;201312;49487;198916;46688;193587;16525;68330;20916;93329;37441;161659
150690;201312;1772;5957;1656;5741;277;989;1076;3833;1353;4822
150700;201312;5686;18245;5381;17840;1126;3723;3608;12273;4734;15996
150710;201312;4006;13131;3670;12597;399;1175;3010;10660;3409;11835
150715;201312;4883;16277;4424;15617;649;2367;3358;12056;4007;14423
150720;201312;6311;26449;6004;25894;990;4019;4324;19541;5314;23560
150730;201312;8835;31281;8361;30638;1142;4083;6722;25212;7864;29295
150740;201312;3602;11794;3310;11269;499;1797;2246;7799;2745;9596
150745;201312;5861;18750;5447;18189;978;3446;3890;13093;4868;16539
150746;201312;1382;4625;1318;4506;202;760;882;3059;1084;3819
150747;201312;4869;16403;4531;15954;447;1479;3646;13331;4093;14810
150750;201312;2583;9214;2527;9150;110;247;2378;8810;2488;9057
150760;201312;11154;36913;10659;36228;2762;9321;6385;22578;9147;31899
150770;201312;5513;21137;5354;20902;915;3333;3953;16411;4868;19744
150775;201312;1111;3603;999;3381;203;831;601;1936;804;2767
150780;201312;2978;10212;2955;10187;88;217;2795;9796;2883;10013
150790;201312;4851;15902;4576;15544;353;1000;3905;13773;4258;14773
150795;201312;14619;46489;13360;44594;2268;7271;9464;32826;11732;40097
150796;201312;2744;8639;2654;8522;407;1228;2016;6752;2423;7980
150797;201312;3696;12613;3544;12377;165;618;3145;11082;3310;11700
150800;201312;13852;47126;12707;45698;3201;10998;8039;30702;11240;41700
150803;201312;6680;24573;6363;24108;913;3595;4666;18132;5579;21727
150805;201312;2664;9494;2480;9228;373;1318;1809;6964;2182;8282
150808;201312;5807;20234;5009;18696;2187;8623;1177;4589;3364;13212
150810;201312;19092;61311;16205;57757;2738;9350;11421;42949;14159;52299
150812;201312;5195;16408;4808;15855;482;1991;3687;11845;4169;13836
150815;201312;8589;27836;7764;26802;1255;4060;5858;21017;7113;25077
150820;201312;10355;31065;9498;30129;586;1228;8532;28014;9118;29242
150830;201312;12213;47835;11648;46881;817;3361;9553;39774;10370;43135
150835;201312;1934;7247;1797;6925;532;2160;801;3107;1333;5267
150840;201312;7224;21357;5846;19468;1470;5488;3074;9982;4544;15470
160005;201312;691;2682;652;2599;123;568;394;1546;517;2114
160010;201312;1529;5318;1518;5306;165;449;1294;4715;1459;5164
160015;201312;1507;5737;1472;5674;259;949;1055;4289;1314;5238
160020;201312;2274;7690;2123;7482;316;1145;1524;5512;1840;6657
160021;201312;806;3562;785;3527;146;697;537;2487;683;3184
160023;201312;957;3757;942;3732;86;298;817;3320;903;3618
160025;201312;1233;3580;1199;3544;23;77;1156;3417;1179;3494
160027;201312;7904;24930;7426;24353;2569;8536;3754;12958;6323;21494
160030;201312;38872;146306;36213;140352;8660;33237;22721;90875;31381;124112
160040;201312;3743;15081;3679;14981;190;831;3336;13645;3526;14476
160050;201312;3359;12737;3042;12262;1107;4313;1454;6398;2561;10711
160053;201312;2259;9360;2230;9317;615;2602;1374;5882;1989;8484
160055;201312;759;2997;744;2975;142;627;525;2110;667;2737
160060;201312;17319;58696;16334;57584;4812;16094;9796;36787;14608;52881
160070;201312;1953;8457;1931;8408;221;946;1608;7143;1829;8089
160080;201312;2618;9869;2601;9842;124;412;2427;9301;2551;9713
170025;201312;564;1953;514;1871;186;706;224;850;410;1556
170030;201312;1190;3959;1078;3746;312;1143;465;1631;777;2774
170035;201312;1516;4645;1248;4131;446;1600;390;1323;836;2923
170040;201312;1760;5954;1567;5655;295;1237;990;3552;1285;4789
170070;201312;2064;5695;1699;5233;489;1631;846;2643;1335;4274
170100;201312;2493;7029;2203;6519;343;1129;1602;4697;1945;5826
170105;201312;725;2419;615;2199;131;586;328;1122;459;1708
170110;201312;1193;3713;1040;3457;226;767;611;2054;837;2821
170130;201312;1373;4433;1223;4225;197;680;845;3026;1042;3706
170190;201312;1662;4868;1368;4436;643;2108;342;1247;985;3355
170200;201312;1458;4573;1144;3996;316;1221;369;1245;685;2466
170210;201312;27912;88191;24157;81428;9111;33086;7329;25358;16440;58444
170215;201312;1155;3740;1045;3568;138;500;789;2728;927;3228
170220;201312;6426;21570;5918;20766;920;3404;4071;14622;4991;18026
170230;201312;1433;4886;1269;4595;340;1401;597;2102;937;3503
170240;201312;2966;8494;2396;7740;342;1233;1619;5271;1961;6504
170255;201312;3626;11767;3076;10841;1085;3820;1268;4790;2353;8610
170270;201312;1046;2731;759;2336;153;492;459;1425;612;1917
170290;201312;2927;8973;2593;8566;205;604;2173;7483;2378;8087
170300;201312;2026;6520;1789;6123;304;1157;1174;4035;1478;5192
170305;201312;739;2326;607;2079;126;483;346;1173;472;1656
170307;201312;1067;3810;935;3581;259;1001;417;1759;676;2760
170310;201312;1654;4622;1325;4087;373;1203;573;1856;946;3059
170320;201312;989;2923;798;2588;220;729;374;1262;594;1991
170330;201312;822;2515;689;2344;133;467;449;1531;582;1998
170360;201312;454;1615;431;1575;94;366;204;729;298;1095
170370;201312;1368;4145;1159;3841;195;762;700;2306;895;3068
170380;201312;2117;6786;1735;6207;418;1718;915;3205;1333;4923
170382;201312;558;1887;492;1784;103;409;317;1139;420;1548
170384;201312;1524;6396;1449;6264;374;1639;880;3931;1254;5570
170386;201312;897;2733;755;2520;205;764;320;1076;525;1840
170388;201312;652;1974;566;1824;123;466;220;698;343;1164
170389;201312;915;3163;852;3064;100;439;641;2267;741;2706
170390;201312;1331;4006;1157;3785;183;635;842;2818;1025;3453
170410;201312;468;1558;445;1514;70;267;298;1014;368;1281
170460;201312;520;1440;390;1226;107;370;132;413;239;783
170510;201312;754;2631;645;2457;127;553;338;1287;465;1840
170550;201312;5456;17345;4537;15650;1805;6676;1244;4395;3049;11071
170555;201312;1342;3986;1112;3640;290;1047;587;1912;877;2959
170560;201312;980;3387;824;3201;168;674;548;2213;716;2887
170600;201312;1293;3764;1157;3600;73;253;964;3053;1037;3306
170610;201312;1625;4984;1282;4424;198;765;752;2629;950;3394
170625;201312;427;1354;336;1157;90;322;92;319;182;641
170650;201312;1218;4032;1103;3807;285;1073;559;1934;844;3007
170700;201312;3907;13170;3291;12132;834;3394;1551;5936;2385;9330
170710;201312;1719;5173;1444;4750;212;833;983;3210;1195;4043
170720;201312;1828;4942;1585;4564;299;866;1066;3128;1365;3994
170730;201312;1115;3237;916;2931;291;1045;405;1279;696;2324
170740;201312;2212;7944;1957;7474;324;1343;1310;5038;1634;6381
170755;201312;875;2803;740;2505;204;736;288;955;492;1691
170765;201312;1569;4291;1275;3813;336;1105;534;1636;870;2741
170770;201312;1799;6322;1676;6083;395;1486;974;3642;1369;5128
170820;201312;4147;13389;3728;12715;1099;3979;1556;5418;2655;9397
170825;201312;759;2347;579;1996;141;535;241;829;382;1364
170830;201312;1324;3991;1253;3881;46;98;1165;3658;1211;3756
170900;201312;2831;10147;2714;9923;345;1278;2034;7670;2379;8948
170930;201312;4208;12968;3452;11846;1369;4934;1126;3862;2495;8796
170950;201312;12450;37073;9633;32254;3916;14679;2159;6799;6075;21478
170980;201312;492;1517;404;1375;120;447;192;644;312;1091
171050;201312;1273;4612;1209;4491;59;272;1073;3937;1132;4209
171070;201312;1701;5467;1573;5296;337;1190;971;3357;1308;4547
171090;201312;937;2762;797;2542;138;460;532;1714;670;2174
171110;201312;639;1893;523;1713;169;608;278;868;447;1476
171150;201312;853;2569;637;2154;126;463;359;1220;485;1683
171180;201312;621;1976;479;1675;123;479;192;697;315;1176
171190;201312;1869;6809;1601;6247;395;1633;770;3127;1165;4760
171195;201312;860;3157;783;3014;107;451;496;1979;603;2430
171200;201312;697;2289;573;2057;150;621;266;904;416;1525
171215;201312;461;1412;365;1240;69;264;161;558;230;822
171240;201312;827;2808;778;2727;79;229;620;2273;699;2502
171245;201312;665;2216;552;1941;124;484;243;844;367;1328
171250;201312;1159;3362;1037;3219;64;201;882;2783;946;2984
171270;201312;417;1733;388;1665;103;425;183;864;286;1289
171280;201312;897;2829;793;2647;190;615;401;1488;591;2103
171320;201312;4028;12491;3484;11675;1136;4006;1613;5423;2749;9429
171330;201312;2794;8556;2477;8078;648;2273;1337;4387;1985;6660
171360;201312;1507;4929;1283;4588;310;1140;696;2553;1006;3693
171370;201312;721;2062;645;1937;145;521;342;973;487;1494
171380;201312;1297;4455;1132;4122;337;1236;518;1948;855;3184
171395;201312;887;2781;742;2512;156;611;375;1259;531;1870
171420;201312;2272;7019;1837;6227;494;1820;776;2638;1270;4458
171430;201312;1039;3301;926;3131;212;733;555;1897;767;2630
171488;201312;2451;7645;2254;7356;588;1901;1206;4143;1794;6044
171500;201312;888;2763;781;2546;137;410;443;1497;580;1907
171510;201312;911;3303;827;3170;163;654;506;2030;669;2684
171515;201312;621;1805;484;1592;114;383;238;796;352;1179
171525;201312;594;2013;500;1835;104;426;268;968;372;1394
171550;201312;344;1167;292;1052;122;501;46;169;168;670
171570;201312;1207;3869;1077;3664;251;860;650;2286;901;3146
171575;201312;1950;5683;1544;4929;417;1365;668;2242;1085;3607
171610;201312;6116;21160;5577;20117;1926;7363;1912;6906;3838;14269
171620;201312;2277;7253;2080;6952;200;734;1674;5643;1874;6377
171630;201312;903;3028;752;2759;188;753;314;1147;502;1900
171650;201312;2379;7555;1975;6836;547;2040;831;2826;1378;4866
171660;201312;2627;7380;2096;6430;460;1507;1104;3450;1564;4957
171665;201312;1376;4280;1180;3953;220;822;734;2504;954;3326
171670;201312;2344;6403;1916;5834;457;1498;1093;3264;1550;4762
171700;201312;1110;3735;1010;3566;165;649;635;2255;800;2904
171720;201312;686;2199;601;2036;207;747;249;851;456;1598
171750;201312;1249;4141;1112;3866;396;1448;381;1353;777;2801
171780;201312;1166;3364;862;2915;155;585;497;1660;652;2245
171790;201312;1723;5578;1409;5120;287;1066;840;3197;1127;4263
171800;201312;710;2307;656;2226;97;370;445;1514;542;1884
171820;201312;9588;30109;8806;29128;2202;7874;4961;16623;7163;24497
171830;201312;1628;5998;1491;5699;376;1520;691;2656;1067;4176
171840;201312;767;2293;690;2186;67;230;522;1661;589;1891
171845;201312;799;2191;622;1881;88;310;363;1070;451;1380
171850;201312;1016;3695;908;3456;111;490;587;2238;698;2728
171855;201312;1248;4017;1132;3821;120;499;853;2812;973;3311
171865;201312;480;1575;407;1467;106;425;197;695;303;1120
171870;201312;659;2150;549;1951;126;475;252;937;378;1412
171875;201312;1372;4420;1159;4088;169;675;829;2907;998;3582
171880;201312;992;3553;964;3507;124;477;725;2704;849;3181
171884;201312;894;2596;661;2242;153;585;259;895;412;1480
171886;201312;1471;5070;1321;4749;445;1679;443;1645;888;3324
171888;201312;673;2100;576;1920;106;366;345;1189;451;1555
171889;201312;476;1607;455;1557;107;349;266;958;373;1307
171890;201312;1111;3731;1003;3571;140;595;676;2385;816;2980
171900;201312;434;1742;411;1684;100;399;224;948;324;1347
172000;201312;662;2150;566;2007;96;404;335;1157;431;1561
172010;201312;1167;4047;1106;3933;109;434;877;3142;986;3576
172015;201312;352;1338;307;1267;56;226;182;803;238;1029
172020;201312;2316;7736;2085;7393;310;1207;1481;5313;1791;6520
172025;201312;727;2181;590;1931;104;382;344;1111;448;1493
172030;201312;1084;3750;991;3577;167;699;634;2289;801;2988
172049;201312;1112;3206;1044;3113;141;415;776;2376;917;2791
172065;201312;1216;3641;1023;3394;131;491;805;2658;936;3149
172080;201312;2620;8098;2230;7428;295;1150;1481;4846;1776;5996
172085;201312;504;1402;384;1180;83;279;120;367;203;646
172090;201312;3408;10337;2661;9347;561;2133;1597;5730;2158;7863
172093;201312;574;1879;450;1651;187;786;168;585;355;1371
172097;201312;667;2021;561;1836;166;589;194;618;360;1207
172100;201312;25530;88649;22702;82705;8049;32040;6256;22714;14305;54754
172110;201312;1684;6171;1558;5987;150;555;1230;4887;1380;5442
172120;201312;5497;16607;4592;15449;495;1757;3485;11978;3980;13735
172125;201312;319;987;259;896;59;228;121;431;180;659
172130;201312;511;1500;455;1415;71;238;299;965;370;1203
172208;201312;2158;6756;2024;6523;439;1526;1115;3639;1554;5165
172210;201312;2285;6972;2156;6796;203;706;1788;5617;1991;6323
210005;201312;21496;70839;19345;67408;6231;23018;9258;32653;15489;55671
210010;201312;1623;5786;1458;5559;176;642;1112;4397;1288;5039
210015;201312;3497;10989;3228;10606;238;483;2748;9567;2986;10050
210020;201312;7067;18195;6640;17681;465;1399;5457;14710;5922;16109
210030;201312;5866;19758;5562;19332;452;1873;4640;16048;5092;17921
210040;201312;1935;5670;1756;5444;186;597;1367;4290;1553;4887
210043;201312;5890;18260;5536;17720;519;1646;4462;14609;4981;16255
210047;201312;6693;26419;6238;25584;918;4103;4267;17661;5185;21764
210050;201312;2484;8864;1988;8138;466;1896;1038;4508;1504;6404
210055;201312;1656;5730;1549;5585;200;681;1190;4382;1390;5063
210060;201312;7893;29311;7120;28080;806;3524;5270;21206;6076;24730
210070;201312;6807;20567;6434;20085;311;1061;5709;17936;6020;18997
210080;201312;3694;12734;3625;12629;88;347;3399;11885;3487;12232
210083;201312;3753;13411;3647;13280;196;726;3302;12162;3498;12888
210087;201312;2485;7961;2358;7806;201;724;2023;6706;2224;7430
210090;201312;9714;32526;9361;31929;496;1920;8142;27857;8638;29777
210095;201312;6127;23771;6001;23556;770;2960;4783;19235;5553;22195
210100;201312;7526;22593;7104;22090;327;1215;6334;19659;6661;20874
210110;201312;3169;11035;3070;10894;201;760;2600;9401;2801;10161
210120;201312;24993;74428;21453;70007;2325;8078;16427;54544;18752;62622
210125;201312;3353;11211;3226;11066;214;684;2860;10000;3074;10684
210130;201312;3738;11566;3608;11395;375;1149;2906;9307;3281;10456
210135;201312;1644;4876;1461;4604;125;403;1204;3859;1329;4262
210140;201312;16995;55168;14490;51851;3281;12054;8933;33265;12214;45319
210150;201312;4543;11738;4176;11277;149;400;3809;10296;3958;10696
210160;201312;18275;60406;17143;58725;2698;8795;12821;45486;15519;54281
210170;201312;13962;52123;13725;51785;1021;3469;12031;46364;13052;49833
210173;201312;1761;7657;1710;7549;142;660;1474;6559;1616;7219
210177;201312;2926;9675;2776;9483;331;1277;2184;7393;2515;8670
210180;201312;1459;4623;1390;4517;101;355;1171;3812;1272;4167
210190;201312;5074;16505;4757;15943;381;1697;3635;11864;4016;13561
210193;201312;1423;4586;1326;4416;91;355;1075;3626;1166;3981
210197;201312;1776;6337;1685;6235;112;471;1468;5469;1580;5940
210200;201312;9147;31093;8457;30085;1249;4190;6153;22909;7402;27099
210203;201312;6164;21120;5812;20664;497;1609;4976;18072;5473;19681
210207;201312;2942;10073;2784;9790;400;1376;2041;7376;2441;8752
210210;201312;8755;29807;8394;29287;313;1175;7382;26265;7695;27440
210215;201312;1727;6908;1677;6820;184;830;1344;5493;1528;6323
210220;201312;6165;24163;5959;23816;505;2016;4847;19892;5352;21908
210230;201312;5331;18286;4956;17675;470;1737;3967;14323;4437;16060
210232;201312;11925;42611;10856;41238;2233;8425;7317;29341;9550;37766
210235;201312;3448;10951;3129;10544;239;847;2664;9040;2903;9887
210237;201312;2533;9258;2504;9219;49;122;2416;9009;2465;9131
210240;201312;2956;9428;2831;9240;289;818;2268;7629;2557;8447
210250;201312;4968;15650;4775;15409;153;562;4428;14339;4581;14901
210255;201312;2698;8913;2470;8521;589;2198;1479;5142;2068;7340
210260;201312;5207;16856;4822;16285;647;2146;3642;12559;4289;14705
210270;201312;5223;15124;4705;14423;191;639;4182;12944;4373;13583
210275;201312;3477;8951;3262;8719;134;287;3067;8299;3201;8586
210280;201312;5925;17488;5181;16549;371;1267;4395;14207;4766;15474
210290;201312;5819;18708;5369;18141;520;1725;4403;15208;4923;16933
210300;201312;35880;111065;30651;104151;3232;11812;24204;83771;27436;95583
210310;201312;2840;8284;2707;8076;129;387;2381;7135;2510;7522
210312;201312;2142;6999;2106;6941;139;547;1851;6080;1990;6627
210315;201312;2309;8378;2212;8224;138;585;1898;7086;2036;7671
210317;201312;4277;12833;4096;12598;323;985;3501;10926;3824;11911
210320;201312;19360;61627;18193;60208;1237;4076;15870;53467;17107;57543
210325;201312;3569;11484;3223;10957;348;1305;2512;8585;2860;9890
210330;201312;31635;86514;27148;81569;3811;10117;20147;65324;23958;75441
210340;201312;11890;37518;10932;36332;1410;4080;8256;29250;9666;33330
210350;201312;10338;32923;9637;31919;787;2714;7844;26439;8631;29153
210355;201312;3946;14255;3634;13859;137;359;3346;13152;3483;13511
210360;201312;16459;51460;15499;50029;1455;4863;12337;40514;13792;45377
210370;201312;7864;21325;7114;20518;379;938;6302;18614;6681;19552
210375;201312;3232;10011;2824;9527;472;1738;2053;7022;2525;8760
210380;201312;6223;18395;5609;17480;666;1864;4456;14314;5122;16178
210390;201312;2737;9826;2541;9497;116;520;2260;8472;2376;8992
210400;201312;4850;15705;4675;15475;368;1140;4037;13608;4405;14748
210405;201312;8616;24373;7075;22260;2181;6951;3221;10978;5402;17929
210407;201312;2083;7379;1872;7046;199;698;1455;5709;1654;6407
210408;201312;2103;8598;2008;8486;75;295;1842;7979;1917;8274
210409;201312;3857;14114;3670;13817;287;1104;2957;11436;3244;12540
210410;201312;3543;11526;3319;11243;355;1146;2740;9490;3095;10636
210420;201312;4144;13963;3874;13474;366;1271;3128;11094;3494;12365
210430;201312;2009;6517;1961;6454;170;575;1660;5504;1830;6079
210440;201312;4215;13363;4121;13217;212;699;3684;11923;3896;12622
210450;201312;2871;9190;2631;8817;239;869;2124;7110;2363;7979
210455;201312;4159;12608;3570;11692;748;2498;2229;7535;2977;10033
210460;201312;4065;13175;3838;12873;206;795;3324;11235;3530;12030
210462;201312;1771;6442;1708;6322;181;697;1307;4944;1488;5641
210465;201312;2702;8939;2547;8734;388;1147;1982;7120;2370;8267
210467;201312;6131;20792;5730;20251;484;1531;4792;17568;5276;19099
210470;201312;1831;5423;1558;5019;103;390;1247;4031;1350;4421
210480;201312;13378;45622;11928;43627;3751;13724;6016;23679;9767;37403
210490;201312;3382;10433;3157;10091;363;1225;2457;7886;2820;9111
210500;201312;6709;26541;6434;26059;727;2881;5020;21059;5747;23940
210510;201312;6796;22784;6593;22557;317;717;5907;21096;6224;21813
210515;201312;3431;11261;3353;11161;190;561;3033;10263;3223;10824
210520;201312;2671;8538;2517;8327;223;761;2062;6932;2285;7693
210530;201312;39369;132973;34508;125340;11342;44205;16963;62712;28305;106917
210535;201312;3092;11051;3021;10921;160;598;2672;9751;2832;10349
210540;201312;12203;43621;10928;41487;2706;10227;5885;24076;8591;34303
210542;201312;6385;18736;5612;17886;329;958;4951;16191;5280;17149
210545;201312;2192;7522;2097;7365;88;404;1825;6405;1913;6809
210547;201312;3570;12958;3385;12660;233;923;2810;10670;3043;11593
210550;201312;6273;17969;5468;17068;311;768;4925;15792;5236;16560
210560;201312;3925;12850;3611;12346;257;1016;3027;10328;3284;11344
210565;201312;1538;5308;1333;4991;136;633;984;3665;1120;4298
210570;201312;12599;36607;11479;35305;1047;2763;9594;30568;10641;33331
210580;201312;2875;9264;2557;8847;295;926;2053;7324;2348;8250
210590;201312;4471;13821;4214;13511;308;971;3644;11890;3952;12861
210592;201312;2464;7925;2398;7819;108;413;2131;6937;2239;7350
210594;201312;2730;7942;2315;7397;168;505;1975;6468;2143;6973
210596;201312;2828;10730;2692;10476;342;1354;2005;7944;2347;9298
210598;201312;1998;6224;1878;6078;125;499;1663;5314;1788;5813
210600;201312;3296;9825;3058;9486;378;1198;2356;7339;2734;8537
210610;201312;2613;8428;2347;8102;269;971;1901;6606;2170;7577
210620;201312;1803;5617;1669;5436;55;147;1533;5059;1588;5206
210630;201312;3354;12593;2938;11757;541;2169;1759;7337;2300;9506
210632;201312;4817;16735;4435;16192;510;1858;3491;12981;4001;14839
210635;201312;1857;6759;1804;6680;90;302;1637;6173;1727;6475
210637;201312;2705;9362;2603;9219;135;500;2339;8369;2474;8869
210640;201312;4170;14145;4102;14065;25;77;4013;13829;4038;13906
210650;201312;6715;20702;6600;20553;195;595;6246;19576;6441;20171
210660;201312;7398;23362;6948;22640;303;854;6340;20824;6643;21678
210663;201312;2685;7889;2534;7685;154;546;2160;6561;2314;7107
210667;201312;1654;6144;1592;6053;93;417;1370;5241;1463;5658
210670;201312;4700;17752;4546;17478;462;1778;3582;14164;4044;15942
210675;201312;4819;13614;4571;13298;304;814;3961;11759;4265;12573
210680;201312;4422;12879;3978;12349;221;693;3482;10896;3703;11589
210690;201312;6764;23522;6500;23236;315;1083;5891;21341;6206;22424
210700;201312;2592;7376;2315;7053;210;415;1872;6250;2082;6665
210710;201312;4880;16028;4693;15731;194;661;4200;14173;4394;14834
210720;201312;2362;8978;2261;8826;156;683;1963;7664;2119;8347
210725;201312;1178;4410;1012;4104;133;592;637;2616;770;3208
210730;201312;1180;3768;1057;3631;105;339;874;3061;979;3400
210735;201312;3702;13888;3499;13533;661;2593;2386;9519;3047;12112
210740;201312;4902;13565;4586;13245;186;408;4256;12569;4442;12977
210745;201312;3675;11346;3474;11060;344;936;2836;9225;3180;10161
210750;201312;19732;55950;18212;54187;2283;6825;14574;43994;16857;50819
210760;201312;5899;16359;5625;16060;75;234;5473;15637;5548;15871
210770;201312;6181;17031;5299;16028;277;889;4674;14184;4951;15073
210780;201312;8636;29547;8059;28460;1156;4312;5749;20652;6905;24964
210790;201312;4766;14441;4128;13724;308;804;3531;12277;3839;13081
210800;201312;4885;14158;4455;13682;211;731;3833;12122;4044;12853
210805;201312;3698;15760;3598;15559;195;872;3109;13729;3304;14601
210810;201312;5603;17407;5074;16800;497;1218;4303;14932;4800;16150
210820;201312;8908;25871;8393;25170;1451;4315;5876;18121;7327;22436
210825;201312;5506;18657;5353;18463;244;849;4821;16852;5065;17701
210830;201312;8408;26684;8031;26252;353;1019;7348;24367;7701;25386
210840;201312;3742;10504;3453;10077;336;816;2718;8091;3054;8907
210845;201312;5511;17743;5298;17492;307;865;4651;15874;4958;16739
210850;201312;5910;22286;5550;21636;989;4301;3771;14728;4760;19029
210860;201312;17018;53692;16092;52392;1382;4883;13181;43088;14563;47971
210870;201312;6302;20843;5732;20083;833;2815;4160;15005;4993;17820
210880;201312;4040;13329;3962;13222;213;704;3558;12018;3771;12722
210890;201312;5320;16265;4975;15819;490;1697;4047;12847;4537;14544
210900;201312;4607;15339;4259;14717;1497;5279;1929;7002;3426;12281
210905;201312;1821;5762;1735;5651;125;323;1516;5087;1641;5410
210910;201312;10530;33555;9897;32564;1928;6801;6520;21607;8448;28408
210920;201312;3442;11530;3336;11386;152;460;3033;10531;3185;10991
210923;201312;1511;5676;1446;5564;197;787;1041;4168;1238;4955
210927;201312;4663;14938;4560;14832;36;97;4489;14655;4525;14752
210930;201312;2613;9698;2522;9562;211;965;2113;7980;2324;8945
210940;201312;2872;11528;2831;11448;315;1160;2296;9550;2611;10710
210945;201312;5879;17398;5689;17204;187;245;5444;16848;5631;17093
210950;201312;5558;17719;4903;16715;691;2408;3481;12195;4172;14603
210955;201312;1890;6416;1717;6122;288;1126;1169;4203;1457;5329
210960;201312;9155;30748;8827;30247;2142;7025;5763;20796;7905;27821
210970;201312;1370;5055;1223;4836;189;820;865;3468;1054;4288
210975;201312;1676;5983;1593;5818;179;670;1235;4581;1414;5251
210980;201312;8930;22674;8707;22417;605;1331;7662;20160;8267;21491
210990;201312;15492;45714;12679;42397;2197;7783;8799;29822;10996;37605
211000;201312;16081;52770;14704;51002;1091;3869;12493;44119;13584;47988
211003;201312;5094;17993;4678;17356;654;2604;3314;12559;3968;15163
211010;201312;6613;22399;6445;22181;148;485;6050;21021;6198;21506
211020;201312;7364;22833;7286;22728;191;384;6985;22056;7176;22440
211023;201312;2413;8288;2320;8121;175;629;1949;6928;2124;7557
211027;201312;3056;11955;2920;11727;286;1071;2340;9767;2626;10838
211030;201312;4218;13088;3814;12617;840;2320;2709;9568;3549;11888
211040;201312;4056;15744;3941;15548;150;652;3471;13961;3621;14613
211050;201312;10075;27759;9921;27575;489;1288;9206;25745;9695;27033
211060;201312;5598;20918;5478;20676;618;2173;4452;17300;5070;19473
211065;201312;1698;5916;1564;5734;62;236;1450;5358;1512;5594
211070;201312;8643;29417;8190;28634;811;2911;6495;23106;7306;26017
211080;201312;1342;4239;1103;3907;87;440;903;3111;990;3551
211085;201312;2010;6848;1748;6504;323;1166;1271;4901;1594;6067
211090;201312;3510;11187;3318;10920;223;881;2797;9142;3020;10023
211100;201312;6783;17926;6616;17726;98;353;6287;16794;6385;17147
211102;201312;3115;11665;3013;11512;353;1271;2440;9598;2793;10869
211105;201312;2787;8913;2500;8532;199;754;2096;7150;2295;7904
211107;201312;4481;13938;4128;13449;189;620;3697;12218;3886;12838
211110;201312;6452;19672;5157;17854;903;3038;3376;12357;4279;15395
211120;201312;31862;89082;27799;83862;4025;11848;20000;62678;24025;74526
211125;201312;2152;7016;1969;6730;193;644;1579;5492;1772;6136
211130;201312;144691;433099;136304;422111;28689;88794;91901;291895;120590;380689
211140;201312;5651;18425;5367;17961;298;1083;4667;15645;4965;16728
211150;201312;9800;30393;9328;29789;760;2441;7965;25808;8725;28249
211153;201312;3200;9678;2929;9355;311;790;2414;8087;2725;8877
211157;201312;1238;4127;1059;3846;141;622;737;2746;878;3368
211160;201312;4173;14502;3643;13609;394;1717;2736;10224;3130;11941
211163;201312;1685;5646;1611;5547;64;230;1460;5087;1524;5317
211167;201312;1464;5057;1364;4893;55;226;1217;4375;1272;4601
211170;201312;6660;18092;6450;17835;152;524;6024;16576;6176;17100
211172;201312;2374;7055;2084;6601;179;687;1686;5216;1865;5903
211174;201312;2831;8476;2605;8184;130;537;2268;7042;2398;7579
211176;201312;5570;16420;4761;15473;561;1512;3761;12820;4322;14332
211178;201312;3010;9786;2947;9719;73;197;2817;9393;2890;9590
211180;201312;4352;15755;4086;15329;414;1691;3219;12209;3633;13900
211190;201312;2771;9464;2528;9110;146;635;2171;7856;2317;8491
211195;201312;1455;4624;1257;4382;115;403;1015;3637;1130;4040
211200;201312;2146;7551;1938;7260;283;996;1407;5575;1690;6571
211210;201312;6743;22465;6565;22167;544;1814;5547;19013;6091;20827
211220;201312;35232;106636;31002;100999;7375;24772;18711;62895;26086;87667
211223;201312;5942;17223;5507;16500;727;2223;3812;11982;4539;14205
211227;201312;1525;5835;1470;5746;162;734;1148;4484;1310;5218
211230;201312;8873;30574;8232;29459;1352;4889;5722;21022;7074;25911
211240;201312;8373;28474;8135;28187;363;1290;7491;26124;7854;27414
211245;201312;5064;15429;4989;15332;193;512;4632;14443;4825;14955
211250;201312;11863;44551;11305;43896;1448;4436;9171;37697;10619;42133
211260;201312;8256;26090;8141;25919;449;1303;7388;23808;7837;25111
211270;201312;9984;35882;9463;35180;664;2709;7929;29889;8593;32598
211280;201312;12168;35672;11719;35140;1295;3160;9782;30544;11077;33704
211285;201312;2003;7127;1741;6642;424;1692;865;3489;1289;5181
211290;201312;7732;25441;7561;25229;600;1681;6550;22453;7150;24134
211300;201312;8514;26545;7701;25313;662;2270;6276;20784;6938;23054
211400;201312;11752;35408;10370;33819;2488;8074;6093;21867;8581;29941
220005;201312;1701;5069;1632;4961;57;266;1445;4262;1502;4528
220010;201312;1720;4623;1314;4118;134;515;1035;3167;1169;3682
220020;201312;3698;11437;3518;11135;607;2068;2365;7439;2972;9507
220025;201312;2134;5380;1994;5175;64;199;1776;4547;1840;4746
220027;201312;1387;3849;1290;3724;104;234;1093;3253;1197;3487
220030;201312;3344;10178;3276;10064;319;1023;2704;8367;3023;9390
220040;201312;8325;26228;7951;25605;1543;5263;4998;16167;6541;21430
220045;201312;1442;4699;1314;4488;157;613;944;3184;1101;3797
220050;201312;4795;13927;4247;13151;349;1285;3437;10497;3786;11782
220060;201312;2023;5359;1930;5249;108;296;1732;4727;1840;5023
220070;201312;2574;7702;2291;7293;215;703;1806;5817;2021;6520
220080;201312;828;2583;778;2492;96;386;550;1691;646;2077
220090;201312;1766;4866;1583;4598;147;519;1253;3541;1400;4060
220095;201312;661;1884;632;1835;28;85;583;1682;611;1767
220100;201312;1406;4303;1209;3983;148;472;895;3023;1043;3495
220105;201312;2206;7398;2074;7145;216;779;1531;5314;1747;6093
220110;201312;3559;10422;3151;9831;289;1081;2548;7819;2837;8900
220115;201312;2176;8101;2096;7966;316;1254;1610;6184;1926;7438
220117;201312;1416;3786;1172;3430;80;255;943;2743;1023;2998
220120;201312;12565;36743;11700;35643;394;1507;10659;32413;11053;33920
220130;201312;782;2921;692;2802;58;173;602;2528;660;2701
220140;201312;1599;4321;1484;4178;283;638;1144;3393;1427;4031
220150;201312;7193;22937;6889;22494;458;1794;5847;18983;6305;20777
220155;201312;1045;3353;896;3074;82;354;622;2082;704;2436
220157;201312;1043;2712;952;2567;45;120;811;2188;856;2308
220160;201312;2853;8593;2563;8085;203;789;1951;6087;2154;6876
220170;201312;1283;4195;1187;4024;112;420;938;3195;1050;3615
220173;201312;2104;6418;1701;5624;79;367;1402;4537;1481;4904
220177;201312;1687;5050;1660;5006;80;260;1509;4554;1589;4814
220180;201312;1155;3175;1031;2974;62;215;792;2236;854;2451
220190;201312;4589;15228;4021;14494;506;1856;3085;11286;3591;13142
220191;201312;1429;4894;1367;4790;259;871;949;3366;1208;4237
220192;201312;1748;5103;1410;4514;171;539;1013;3279;1184;3818
220194;201312;1716;5030;1551;4733;192;649;1140;3383;1332;4032
220196;201312;2035;6188;1908;5966;214;772;1454;4500;1668;5272
220198;201312;1329;3711;1112;3423;38;126;1025;3181;1063;3307
220200;201312;4650;16178;4389;15762;749;2930;3021;10796;3770;13726
220202;201312;2046;6509;1866;6179;68;279;1649;5422;1717;5701
220205;201312;2909;7737;2575;7277;100;383;2247;6253;2347;6636
220207;201312;917;2830;796;2615;99;366;591;1928;690;2294
220208;201312;1649;5812;1523;5584;273;1165;995;3605;1268;4770
220209;201312;1576;4997;1449;4779;97;387;1122;3709;1219;4096
220210;201312;1856;4976;1623;4665;95;334;1280;3685;1375;4019
220211;201312;1636;4965;1552;4843;108;472;1281;3966;1389;4438
220213;201312;1819;5318;1692;5080;112;389;1335;3939;1447;4328
220217;201312;1792;5826;1730;5747;76;228;1569;5288;1645;5516
220220;201312;11597;33833;10714;32394;1377;4120;7584;23511;8961;27631
220225;201312;997;3117;930;3011;41;174;808;2592;849;2766
220230;201312;6061;16180;5050;14799;269;801;4408;12986;4677;13787
220240;201312;2696;8739;2575;8513;213;787;2028;6638;2241;7425
220245;201312;1423;3946;1337;3835;63;170;1191;3451;1254;3621
220250;201312;3371;9137;3056;8717;60;142;2858;8246;2918;8388
220253;201312;1843;5567;1600;5123;125;465;1182;3813;1307;4278
220255;201312;1759;5046;1556;4695;113;454;1257;3670;1370;4124
220260;201312;5220;16957;4738;16041;503;1903;3528;11953;4031;13856
220265;201312;1240;4532;1179;4422;111;525;861;3202;972;3727
220270;201312;6662;22393;6488;22067;423;1927;5501;18248;5924;20175
220271;201312;1525;4373;1463;4287;82;235;1280;3807;1362;4042
220272;201312;1766;5567;1647;5381;112;473;1302;4211;1414;4684
220273;201312;1304;3785;1146;3543;113;376;856;2630;969;3006
220275;201312;2074;5565;1790;5198;79;256;1562;4547;1641;4803
220277;201312;2552;7076;2178;6514;175;562;1682;5075;1857;5637
220280;201312;1782;4668;1555;4341;105;382;1250;3434;1355;3816
220285;201312;1667;4559;1495;4319;102;314;1238;3661;1340;3975
220290;201312;6590;21564;5591;20276;554;2116;4381;16127;4935;18243
220300;201312;1906;6264;1685;5959;94;418;1437;5082;1531;5500
220310;201312;2588;8454;2146;7924;99;321;1944;7353;2043;7674
220320;201312;3391;10131;2858;9234;440;1491;2014;6538;2454;8029
220323;201312;1413;5333;1299;5166;215;920;931;3724;1146;4644
220325;201312;1275;4043;1164;3822;162;582;775;2613;937;3195
220327;201312;1366;4391;1235;4160;76;368;990;3259;1066;3627
220330;201312;3656;10587;3483;10346;282;949;2928;8716;3210;9665
220335;201312;2088;6048;1856;5750;101;362;1614;4987;1715;5349
220340;201312;1819;5230;1611;4939;155;533;1258;3829;1413;4362
220342;201312;1207;4001;1145;3908;121;496;851;2993;972;3489
220345;201312;2862;7955;2437;7257;90;248;2112;6307;2202;6555
220350;201312;4468;12180;3933;11443;303;972;3134;9117;3437;10089
220360;201312;1478;4070;1165;3576;117;395;851;2599;968;2994
220370;201312;9140;26558;8359;25512;478;1380;7425;22828;7903;24208
220375;201312;1553;4864;1447;4720;84;323;1285;4167;1369;4490
220380;201312;1369;3818;1179;3547;81;264;922;2787;1003;3051
220385;201312;702;1939;628;1800;38;133;523;1440;561;1573
220390;201312;10308;32868;9418;31103;2385;8416;4462;14818;6847;23234
220400;201312;1443;3515;1304;3325;66;220;1127;2808;1193;3028
220410;201312;1380;4008;1178;3725;107;449;939;2884;1046;3333
220415;201312;882;2393;794;2269;90;254;593;1708;683;1962
220420;201312;2261;6635;2055;6218;159;477;1665;5055;1824;5532
220430;201312;2966;8736;2819;8541;390;1229;2110;6408;2500;7637
220435;201312;1632;4840;1533;4700;83;272;1302;3996;1385;4268
220440;201312;2808;8473;2323;7904;143;395;2067;7166;2210;7561
220450;201312;2718;8126;2360;7635;578;1951;1407;4597;1985;6548
220455;201312;1425;4380;1278;4173;55;185;1151;3797;1206;3982
220460;201312;1023;2872;970;2794;64;192;834;2393;898;2585
220465;201312;2436;8105;2261;7845;466;1729;1502;5242;1968;6971
220470;201312;4034;12276;3662;11615;268;970;2840;8880;3108;9850
220480;201312;2329;7106;2133;6804;161;542;1761;5617;1922;6159
220490;201312;2357;6947;2240;6785;132;494;1928;5774;2060;6268
220500;201312;3417;9303;2940;8504;206;802;2363;6604;2569;7406
220510;201312;2932;8289;2260;7314;102;458;1772;5709;1874;6167
220515;201312;1969;4961;1740;4666;86;243;1475;3963;1561;4206
220520;201312;5019;14370;4709;13914;237;664;4134;12351;4371;13015
220525;201312;1469;4190;1367;4042;108;396;1107;3197;1215;3593
220527;201312;1440;4618;1340;4401;149;473;1047;3515;1196;3988
220530;201312;1182;3503;1098;3372;110;419;894;2659;1004;3078
220535;201312;885;2799;855;2753;82;324;679;2149;761;2473
220540;201312;3601;12211;3466;11984;290;1184;2818;9725;3108;10909
220545;201312;1425;4952;1362;4836;215;858;938;3288;1153;4146
220550;201312;9218;30545;8727;29642;1611;5857;5782;19653;7393;25510
220551;201312;1413;4897;1326;4745;134;568;1023;3613;1157;4181
220552;201312;1668;5271;1431;4863;132;612;1049;3416;1181;4028
220553;201312;1624;4873;1409;4558;87;311;1161;3749;1248;4060
220554;201312;927;2607;808;2442;113;344;576;1780;689;2124
220555;201312;2435;7219;2277;7003;98;336;1955;6101;2053;6437
220556;201312;1466;4702;1333;4445;105;441;1007;3312;1112;3753
220557;201312;1609;5394;1459;5100;207;828;981;3397;1188;4225
220558;201312;1032;3270;959;3132;108;422;726;2315;834;2737
220559;201312;1549;4456;1431;4282;78;265;1232;3681;1310;3946
220560;201312;1752;4404;1461;3991;82;229;1242;3377;1324;3606
220570;201312;7506;24167;7070;23573;1018;3111;5417;18688;6435;21799
220580;201312;6588;21645;6416;21438;421;1377;5709;19321;6130;20698
220585;201312;1920;7211;1857;7094;138;560;1568;6020;1706;6580
220590;201312;1414;4496;1276;4288;244;862;810;2761;1054;3623
220595;201312;2476;7235;2289;6980;86;288;2063;6310;2149;6598
220600;201312;1321;3330;1138;3109;226;506;742;2163;968;2669
220605;201312;2062;6175;1825;5803;116;390;1446;4612;1562;5002
220610;201312;2770;8745;2681;8613;175;685;2269;7220;2444;7905
220620;201312;7776;26798;7552;26448;413;1664;6595;23126;7008;24790
220630;201312;402;1253;343;1142;84;306;179;602;263;908
220635;201312;1875;6742;1741;6432;157;673;1163;4295;1320;4968
220640;201312;2787;8351;2673;8170;283;964;2063;6295;2346;7259
220650;201312;2482;6979;2224;6575;149;498;1811;5336;1960;5834
220660;201312;2485;8373;2038;7813;194;806;1724;6634;1918;7440
220665;201312;1220;4240;1171;4163;56;242;1028;3630;1084;3872
220667;201312;1747;5949;1658;5819;82;332;1427;4999;1509;5331
220669;201312;1895;6285;1764;6033;258;994;1222;4167;1480;5161
220670;201312;2160;6588;2031;6428;167;435;1743;5695;1910;6130
220672;201312;2242;6559;2178;6472;234;650;1819;5502;2053;6152
220675;201312;1363;3992;1274;3842;146;395;938;2884;1084;3279
220680;201312;2241;7426;2146;7280;211;698;1731;5973;1942;6671
220690;201312;1724;4986;1549;4692;133;490;1224;3654;1357;4144
220695;201312;859;2661;811;2576;76;252;614;1961;690;2213
220700;201312;9094;26687;8279;25445;796;2695;6391;19633;7187;22328
220710;201312;754;2299;657;2135;70;216;475;1570;545;1786
220720;201312;2142;5825;2027;5664;98;218;1807;5144;1905;5362
220730;201312;1378;3844;1207;3577;55;194;1015;2978;1070;3172
220735;201312;1035;2744;888;2504;81;261;659;1855;740;2116
220740;201312;1335;4423;1165;4188;157;519;897;3365;1054;3884
220750;201312;3958;11823;3753;11510;527;1470;2836;9024;3363;10494
220755;201312;1183;3534;1119;3429;70;210;965;2971;1035;3181
220760;201312;2641;9443;2461;9163;123;490;2158;8110;2281;8600
220770;201312;23245;81029;21862;78429;7612;28393;9132;33742;16744;62135
220775;201312;1174;2971;1154;2949;22;40;1125;2891;1147;2931
220777;201312;1696;4920;1601;4778;140;430;1304;3878;1444;4308
220779;201312;1147;3564;1118;3521;68;263;985;3068;1053;3331
220780;201312;6260;16495;5666;15709;468;1235;4677;13174;5145;14409
220785;201312;1286;3586;1245;3501;72;197;1122;3151;1194;3348
220790;201312;9311;30965;9048;30465;965;3558;7212;24226;8177;27784
220793;201312;916;2656;849;2545;67;223;689;2059;756;2282
220795;201312;1526;4336;1477;4262;110;343;1242;3603;1352;3946
220800;201312;16964;49015;15840;47308;1922;6670;11970;35035;13892;41705
220810;201312;3355;9960;2904;9149;245;946;2273;7070;2518;8016
220820;201312;5563;15910;5105;15305;327;1099;4362;13126;4689;14225
220830;201312;7671;22031;7322;21450;925;2734;5560;16495;6485;19229
220840;201312;14883;48512;13669;46034;3592;12384;6281;21915;9873;34299
220850;201312;2706;9987;2597;9820;348;1425;1985;7574;2333;8999
220855;201312;622;1964;565;1860;70;268;404;1305;474;1573
220860;201312;938;2684;880;2592;56;220;724;2086;780;2306
220865;201312;2662;7574;2200;6813;114;514;1812;5492;1926;6006
220870;201312;2423;8090;2131;7722;132;521;1856;6735;1988;7256
220880;201312;5365;14230;4933;13692;251;851;4334;12021;4585;12872
220885;201312;1336;4745;1180;4462;124;578;862;3250;986;3828
220887;201312;1322;3615;1163;3393;47;149;1038;3043;1085;3192
220890;201312;1609;5793;1444;5527;142;545;1152;4527;1294;5072
220900;201312;1870;5730;1678;5298;122;375;1364;4355;1486;4730
220910;201312;1735;5107;1548;4813;76;272;1351;4227;1427;4499
220915;201312;1040;3049;921;2850;51;229;730;2187;781;2416
220920;201312;1320;4945;1259;4857;123;554;978;3762;1101;4316
220930;201312;1478;4838;1308;4614;106;440;1060;3761;1166;4201
220935;201312;1032;3240;923;2999;68;300;691;2142;759;2442
220937;201312;1545;4340;1333;3967;82;293;1065;3101;1147;3394
220940;201312;1475;4544;1364;4297;107;406;1050;3287;1157;3693
220945;201312;474;1746;442;1649;58;248;305;1130;363;1378
220950;201312;1262;3250;926;2669;48;188;700;1955;748;2143
220955;201312;1620;4535;1378;4159;140;476;1065;3195;1205;3671
220960;201312;822;2338;726;2168;66;258;551;1595;617;1853
220965;201312;1677;5151;1589;5025;68;278;1377;4343;1445;4621
220970;201312;2140;5768;1578;4837;175;547;1054;3255;1229;3802
220975;201312;521;2082;517;2073;56;216;443;1793;499;2009
220980;201312;1493;4508;1319;4199;129;478;901;2929;1030;3407
220985;201312;1362;3936;1303;3853;128;435;1000;2940;1128;3375
220987;201312;1480;4927;1388;4758;125;515;1048;3523;1173;4038
220990;201312;1802;5360;1600;5006;85;360;1247;3837;1332;4197
220995;201312;1195;3697;981;3341;86;357;763;2601;849;2958
220997;201312;2106;6796;2007;6624;132;453;1787;5888;1919;6341
221000;201312;4389;13772;4082;13228;502;1754;3005;9724;3507;11478
221005;201312;1415;4550;1336;4400;411;1295;707;2444;1118;3739
221010;201312;1244;3393;1096;3198;58;178;939;2757;997;2935
221020;201312;1922;6028;1806;5814;128;569;1384;4348;1512;4917
221030;201312;1815;5074;1584;4733;87;356;1286;3781;1373;4137
221035;201312;1559;4257;1416;4073;90;259;1235;3594;1325;3853
221037;201312;636;1972;575;1866;36;159;461;1431;497;1590
221038;201312;640;1859;524;1671;46;163;364;1169;410;1332
221039;201312;927;2770;879;2696;69;233;755;2300;824;2533
221040;201312;5215;16199;4944;15752;422;1468;3892;12544;4314;14012
221050;201312;3739;11704;3463;11301;233;914;2943;9525;3176;10439
221060;201312;9158;25195;7892;23487;923;2885;5980;17894;6903;20779
221062;201312;1282;4553;1222;4463;37;113;1146;4211;1183;4324
221063;201312;1128;3665;1052;3527;365;1184;529;1922;894;3106
221065;201312;2709;8112;2547;7853;278;884;1973;6092;2251;6976
221070;201312;4396;13569;3991;12935;277;1068;3167;10215;3444;11283
221080;201312;3442;9582;3115;9138;223;732;2548;7496;2771;8228
221090;201312;1311;3684;1159;3451;50;203;968;2820;1018;3023
221093;201312;1788;5402;1700;5234;299;1009;1067;3236;1366;4245
221095;201312;978;2677;853;2505;43;123;759;2253;802;2376
221097;201312;802;2338;707;2171;63;258;539;1625;602;1883
221100;201312;122591;381299;116536;370992;25651;89955;74417;231677;100068;321632
221110;201312;9885;33501;9546;33052;751;3002;8000;27628;8751;30630
221120;201312;4240;14426;4069;14105;1197;4067;2341;8479;3538;12546
221130;201312;4673;14147;4140;13047;1009;3339;2290;7169;3299;10508
221135;201312;1457;4671;1368;4531;184;714;1001;3264;1185;3978
221140;201312;1403;3594;1297;3455;164;364;1017;2793;1181;3157
221150;201312;1224;3217;1016;2837;26;111;829;2285;855;2396
221160;201312;904;2436;853;2354;59;181;656;1815;715;1996
221170;201312;1101;3645;1059;3559;80;325;871;2889;951;3214
230010;201312;3424;9376;2792;8271;201;698;2219;6537;2420;7235
230015;201312;2766;9782;2603;9449;467;1945;1726;6141;2193;8086
230020;201312;14144;47818;13648;46844;1127;4240;11032;38045;12159;42285
230030;201312;12388;37362;11681;36218;1050;3615;9304;28817;10354;32432
230040;201312;4524;13073;3861;11895;350;1237;2981;9105;3331;10342
230050;201312;2535;8854;2181;7943;407;1645;1111;4039;1518;5684
230060;201312;1951;6019;1754;5635;186;697;1294;4129;1480;4826
230070;201312;4655;13013;4132;12265;401;1284;3128;9473;3529;10757
230075;201312;8707;32950;8257;32001;1021;4747;6024;23153;7045;27900
230080;201312;2339;6644;1996;6149;123;430;1641;5045;1764;5475
230090;201312;3353;10516;3014;9901;315;1222;2262;7316;2577;8538
230100;201312;16945;53802;15738;51540;4533;15695;7507;24919;12040;40614
230110;201312;13855;46590;12968;44658;2592;9710;7756;26612;10348;36322
230120;201312;7909;22353;7043;21174;837;2805;5218;15730;6055;18535
230125;201312;2869;8621;2410;7732;206;839;1776;5602;1982;6441
230130;201312;5609;19041;4751;17125;457;1958;3379;12023;3836;13981
230140;201312;3437;11461;3007;10660;491;1844;1925;6970;2416;8814
230150;201312;1749;5632;1538;5197;296;1164;954;3075;1250;4239
230160;201312;6252;19440;5531;18343;587;2166;4131;13751;4718;15917
230170;201312;6438;20949;5634;19461;545;2189;4068;13895;4613;16084
230180;201312;1931;5664;1704;5245;153;576;1192;3589;1345;4165
230185;201312;4130;14132;3830;13543;723;2573;2384;8734;3107;11307
230190;201312;12265;41430;11278;39411;2243;8873;6374;22068;8617;30941
230195;201312;4914;15637;4480;14938;361;1556;3481;11246;3842;12802
230200;201312;5647;16826;5051;15635;677;2219;3556;10997;4233;13216
230205;201312;4346;14054;3902;13294;401;1704;2800;9514;3201;11218
230210;201312;9081;26794;8111;25243;2384;7612;3933;12677;6317;20289
230220;201312;13509;41044;12543;39375;2041;7188;8421;26043;10462;33231
230230;201312;7312;24792;6589;23190;1165;4221;3931;14047;5096;18268
230240;201312;13253;39753;12016;37420;891;3382;9227;28201;10118;31583
230250;201312;10164;31643;9932;31287;571;2159;8398;26326;8969;28485
230260;201312;14760;51226;13738;49045;3187;12107;7248;26484;10435;38591
230270;201312;6650;20765;5946;19536;642;2338;4502;14822;5144;17160
230280;201312;19833;61504;18318;58883;2763;9341;12959;41847;15722;51188
230290;201312;5111;16064;4487;14803;663;2278;2989;9964;3652;12242
230300;201312;4695;14991;4507;14703;543;2051;3334;10763;3877;12814
230310;201312;4901;14971;4352;14042;402;1603;3286;10408;3688;12011
230320;201312;7352;24105;6889;23275;847;3251;5015;16961;5862;20212
230330;201312;4635;14185;4148;13211;423;1554;2933;9201;3356;10755
230340;201312;3374;11960;3168;11496;537;2189;1954;6934;2491;9123
230350;201312;18023;56711;16258;53585;3083;11046;10070;33473;13153;44519
230360;201312;2931;8986;2624;8434;329;1216;1925;6112;2254;7328
230365;201312;2919;8774;2573;8196;209;809;1950;6175;2159;6984
230370;201312;54036;183934;50284;177404;15379;56870;24530;89245;39909;146115
230380;201312;7069;20836;6092;19161;586;2132;4301;13529;4887;15661
230390;201312;3640;11779;3259;11142;432;1776;2236;7544;2668;9320
230393;201312;3370;11459;2893;10433;275;1362;2049;7121;2324;8483
230395;201312;4910;15897;4588;15246;694;2669;3018;9896;3712;12565
230400;201312;5051;16169;4453;15308;431;1866;3474;11683;3905;13549
230410;201312;15785;50931;14248;48016;2514;9171;8585;28997;11099;38168
230420;201312;23720;80841;22344;77961;5783;22032;11058;38299;16841;60331
230423;201312;4781;15890;4410;15209;527;2010;3086;10761;3613;12771
230425;201312;5395;18535;4993;17617;734;2849;3396;11913;4130;14762
230426;201312;2821;8030;2348;7147;144;573;1798;5356;1942;5929
230427;201312;1721;5362;1293;4377;124;462;860;2832;984;3294
230428;201312;9017;30277;8798;29880;1812;6918;5562;18635;7374;25553
230430;201312;4590;15122;4329;14595;446;1830;3161;10464;3607;12294
230435;201312;4904;16573;4418;15697;1098;4260;2228;8108;3326;12368
230440;201312;354896;1127160;335369;1091160;88112;309326;167558;544725;255670;854051
230445;201312;4698;13045;4061;12116;371;1124;3033;9219;3404;10343
230450;201312;3661;12062;3145;11100;476;1892;2006;7121;2482;9013
230460;201312;1912;6484;1756;6176;201;822;1260;4401;1461;5223
230465;201312;4137;12796;3428;11449;345;1483;2245;7291;2590;8774
230470;201312;11228;41732;10820;40911;1544;6235;7786;29917;9330;36152
230480;201312;1451;4781;1290;4467;240;883;824;2870;1064;3753
230490;201312;2956;8789;2591;8103;463;1653;1387;4304;1850;5957
230495;201312;5692;19463;5169;18567;971;4111;3019;10827;3990;14938
230500;201312;10687;36807;10186;35966;909;3462;7952;28609;8861;32071
230510;201312;1508;5502;1284;4930;345;1415;533;2133;878;3548
230520;201312;5003;15508;4387;14401;511;1958;2998;9775;3509;11733
230523;201312;13103;45039;12205;43015;3766;14712;3656;13043;7422;27755
230526;201312;4152;13063;3642;12136;422;1634;2548;8487;2970;10121
230530;201312;5150;17574;4768;17037;1066;3812;3071;11200;4137;15012
230533;201312;3895;11433;3561;10799;307;1053;2771;8350;3078;9403
230535;201312;5404;16382;4759;15188;520;1757;3459;11183;3979;12940
230540;201312;18743;55036;16776;52124;1245;4562;13695;42195;14940;46757
230550;201312;20049;61903;18358;58635;4363;15198;9703;30702;14066;45900
230560;201312;6753;19769;6085;18515;342;1323;4838;14517;5180;15840
230565;201312;3269;9706;2691;8524;276;990;1865;5841;2141;6831
230570;201312;3938;10929;3533;10405;241;893;2927;8501;3168;9394
230580;201312;10347;32436;9899;31804;608;2042;8624;27945;9232;29987
230590;201312;9533;30858;8729;29395;841;3512;6425;21199;7266;24711
230600;201312;3681;10533;2839;8807;221;772;1910;5833;2131;6605
230610;201312;6024;20351;5640;19726;850;3259;4014;14129;4864;17388
230620;201312;2042;5933;1713;5249;169;618;1111;3304;1280;3922
230625;201312;7521;25582;6815;23923;2003;7688;2417;8464;4420;16152
230630;201312;11133;37187;10192;35272;2564;8702;5122;18720;7686;27422
230640;201312;26129;89817;24816;87773;3997;14974;17457;62480;21454;77454
230650;201312;4941;16115;4539;15296;416;1773;3463;11427;3879;13200
230655;201312;8539;32942;8234;32428;790;3224;6823;27229;7613;30453
230660;201312;6320;20231;5558;18827;577;2342;3986;13563;4563;15905
230670;201312;5945;16509;4839;14553;287;1077;3760;10998;4047;12075
230680;201312;2736;8182;2334;7435;378;1328;1432;4549;1810;5877
230690;201312;6374;21390;6221;21091;514;2223;4516;14974;5030;17197
230700;201312;9195;27318;8112;25300;893;3422;5558;16797;6451;20219
230710;201312;7611;25022;6803;23500;920;3187;4884;17288;5804;20475
230720;201312;1923;6106;1655;5586;232;864;1077;3646;1309;4510
230725;201312;3750;12793;3348;11803;671;2567;1931;6679;2602;9246
230730;201312;56730;176576;48534;163649;13215;48560;22556;77168;35771;125728
230740;201312;5255;17064;5014;16612;341;1443;4129;13492;4470;14935
230750;201312;8903;26335;7616;24191;733;2808;5707;17977;6440;20785
230760;201312;10018;31568;9712;30854;1439;5495;6829;20745;8268;26240
230763;201312;4226;13605;3980;13106;333;1516;3034;9601;3367;11117
230765;201312;43325;144641;40562;138903;13645;49727;14289;49728;27934;99455
230770;201312;23389;66733;21787;64369;1942;6759;16616;48642;18558;55401
230780;201312;5929;23993;5668;23348;1356;5661;3048;13243;4404;18904
230790;201312;2525;8812;2422;8633;300;1174;1861;6683;2161;7857
230800;201312;7830;28850;7224;27454;1776;7302;3424;13076;5200;20378
230810;201312;12397;41233;11880;40356;1425;5141;9038;31084;10463;36225
230820;201312;3388;11772;3022;10962;651;2632;1617;5871;2268;8503
230830;201312;7789;24083;7006;22648;740;2763;5007;16116;5747;18879
230835;201312;4112;11446;3543;10668;312;1040;2780;8375;3092;9415
230837;201312;3148;11002;2744;10163;392;1630;1804;6696;2196;8326
230840;201312;9299;31503;8512;30072;1401;5325;5549;19998;6950;25323
230850;201312;11126;34593;10506;33794;1379;4975;7737;24737;9116;29712
230860;201312;5045;15478;4623;14623;413;1558;3496;10929;3909;12487
230870;201312;18826;53334;16936;50147;1731;5908;12730;37381;14461;43289
230880;201312;1911;6762;1789;6514;266;1119;1170;4231;1436;5350
230890;201312;4092;15093;3777;14430;545;2436;2516;9466;3061;11902
230900;201312;3003;10244;2639;9449;507;1862;1481;5403;1988;7265
230910;201312;2980;9188;2440;8133;267;1067;1709;5573;1976;6640
230920;201312;4629;13884;4264;13415;340;1148;3491;11127;3831;12275
230930;201312;7709;24054;7029;22776;927;3235;4880;15884;5807;19119
230940;201312;7619;21998;6784;20765;390;1223;5732;17722;6122;18945
230945;201312;5800;17957;5050;16886;594;2154;3603;12194;4197;14348
230950;201312;6915;19402;5955;18086;413;1402;4642;14137;5055;15539
230960;201312;12151;40152;11259;38325;2689;10087;5416;18412;8105;28499
230970;201312;13255;43393;12088;40999;2652;10260;6106;20224;8758;30484
230980;201312;2804;9507;2587;9043;815;2877;1162;4247;1977;7124
230990;201312;1585;5049;1299;4449;169;712;859;2864;1028;3576
231000;201312;2869;7887;2287;6766;253;892;1506;4317;1759;5209
231010;201312;2953;8746;2577;8159;304;1214;1872;5783;2176;6997
231020;201312;7911;26907;7465;25980;1391;5136;4724;16741;6115;21877
231025;201312;7724;24900;6983;23598;1152;4059;4552;15730;5704;19789
231030;201312;7948;26769;6760;24213;1356;5144;3921;14193;5277;19337
231040;201312;2971;10137;2701;9549;302;1263;1875;6543;2177;7806
231050;201312;11902;35596;10559;33127;1139;3987;7630;23980;8769;27967
231060;201312;2408;7784;2213;7429;210;961;1635;5315;1845;6276
231070;201312;9239;29893;8626;28704;1541;5538;5394;18064;6935;23602
231080;201312;4255;13556;3898;12886;289;1302;2903;9217;3192;10519
231085;201312;4665;15409;4522;15143;747;2679;3262;11027;4009;13706
231090;201312;4088;11725;3437;10400;232;877;2550;7596;2782;8473
231095;201312;2207;7508;1917;6917;229;883;1333;4881;1562;5764
231100;201312;3023;9623;2530;8602;244;935;1839;6205;2083;7140
231110;201312;3738;12708;3634;12513;408;1514;2645;9179;3053;10693
231120;201312;2430;8102;2257;7790;390;1399;1470;5123;1860;6522
231123;201312;2182;6119;1862;5563;146;457;1474;4419;1620;4876
231126;201312;6666;18841;5505;17188;438;1582;4238;13105;4676;14687
231130;201312;20073;64292;18382;61260;4820;16879;9505;32930;14325;49809
231135;201312;4601;13779;3910;12691;407;1566;2842;9081;3249;10647
231140;201312;15257;50940;14296;48951;1553;7144;10041;33018;11594;40162
231150;201312;5887;17661;5044;16009;1027;3660;2641;8149;3668;11809
231160;201312;5672;19773;5415;19282;1465;5450;3120;11148;4585;16598
231170;201312;4738;15478;4396;14790;497;2051;3026;10017;3523;12068
231180;201312;14876;46269;13653;43877;2746;9624;8201;26023;10947;35647
231190;201312;5053;14327;4219;13105;389;1381;3248;9963;3637;11344
231195;201312;4650;16146;4025;14883;393;1723;3017;11166;3410;12889
231200;201312;7537;26873;6700;25147;712;3290;4815;17859;5527;21149
231210;201312;5042;15949;4366;14967;330;1431;3364;11579;3694;13010
231220;201312;14069;41034;11964;37424;1291;4735;7796;24418;9087;29153
231230;201312;9647;34480;9059;33358;1275;5236;6405;23634;7680;28870
231240;201312;11703;38197;10665;36316;1570;6055;6934;23802;8504;29857
231250;201312;2081;6124;1437;4543;302;976;577;1735;879;2711
231260;201312;4037;11621;3663;11088;513;1666;2490;7685;3003;9351
231270;201312;7605;21962;6884;20813;683;2681;5017;14731;5700;17412
231280;201312;1723;5824;1619;5603;168;614;1193;4163;1361;4777
231290;201312;32924;118987;30293;112292;7903;32215;12634;45822;20537;78037
231300;201312;4540;13620;3779;12040;374;1481;2679;8225;3053;9706
231310;201312;7388;21871;6291;19591;1347;4369;3293;10198;4640;14567
231320;201312;6962;21977;6145;20372;434;1738;4673;15405;5107;17143
231325;201312;2557;8025;2299;7556;206;740;1705;5636;1911;6376
231330;201312;14116;44639;11955;40413;2036;7073;7432;25436;9468;32509
231335;201312;5099;14963;4508;13884;334;1323;3596;10817;3930;12140
231340;201312;17788;59263;16734;57724;1573;5224;13418;47594;14991;52818
231350;201312;12206;42142;11983;41783;1437;4824;9630;34371;11067;39195
231355;201312;4301;14187;4159;13950;241;816;3600;12246;3841;13062
231360;201312;7068;23864;6631;23137;1778;6071;3692;13509;5470;19580
231370;201312;2362;6909;1917;6223;132;524;1441;4601;1573;5125
231375;201312;4066;14250;3861;13840;415;1877;2965;10394;3380;12271
231380;201312;5269;17412;4951;16960;832;3055;3416;11936;4248;14991
231390;201312;3403;10891;3224;10616;291;1181;2443;7940;2734;9121
231395;201312;4216;13806;3785;13106;776;2820;2290;8105;3066;10925
231400;201312;10339;31482;9427;29834;1032;3819;6650;21023;7682;24842
231410;201312;14746;49471;13375;47533;1563;5557;9780;35924;11343;41481
240010;201312;2420;7742;2174;7167;559;2075;955;3029;1514;5104
240020;201312;11793;37575;10545;35159;2902;10432;4718;15949;7620;26381
240030;201312;2534;7657;2440;7507;237;919;1937;5775;2174;6694
240040;201312;781;2379;667;2151;50;241;491;1485;541;1726
240050;201312;3585;10099;3191;9421;242;882;2422;7003;2664;7885
240060;201312;1428;4344;1358;4222;127;475;1030;3106;1157;3581
240070;201312;2812;8240;2679;7979;439;1400;1740;5109;2179;6509
240080;201312;3023;8334;2792;7990;274;756;2218;6461;2492;7217
240090;201312;2203;6175;1889;5558;63;263;1498;4314;1561;4577
240100;201312;10302;30083;9584;28646;1271;4520;5976;17641;7247;22161
240110;201312;5202;16027;4649;15025;956;3521;2687;8299;3643;11820
240120;201312;3006;10081;2908;9902;604;2220;1795;6232;2399;8452
240130;201312;2777;7764;2401;7173;214;781;1843;5424;2057;6205
240140;201312;2258;7168;2056;6790;458;1707;1081;3521;1539;5228
240145;201312;6191;19628;5587;18512;1590;5886;2784;9142;4374;15028
240150;201312;1023;3172;842;2805;136;561;496;1581;632;2142
240160;201312;1456;4843;1324;4610;154;620;920;3222;1074;3842
240165;201312;885;2931;800;2766;113;420;522;1833;635;2253
240170;201312;2549;7840;2297;7367;618;2150;1086;3509;1704;5659
240180;201312;2963;9396;2776;9066;738;2549;1430;4839;2168;7388
240185;201312;1496;5033;1446;4948;186;663;1061;3669;1247;4332
240190;201312;940;2914;885;2804;96;377;621;1911;717;2288
240200;201312;14151;37499;11919;34732;2374;7080;7373;22294;9747;29374
240210;201312;2722;7880;2533;7631;241;852;2074;6179;2315;7031
240220;201312;7374;24049;7082;23654;394;1699;6210;20533;6604;22232
240230;201312;5458;15842;5054;15121;473;1670;3898;11493;4371;13163
240240;201312;1789;5704;1369;4568;376;1359;301;887;677;2246
240250;201312;2861;8325;2689;8063;212;780;2167;6354;2379;7134
240260;201312;14859;50503;14154;49308;2491;9854;9231;32073;11722;41927
240270;201312;2338;7827;2222;7627;258;898;1639;5742;1897;6640
240280;201312;1622;4704;1454;4394;134;494;1054;3131;1188;3625
240290;201312;1416;4512;1205;4120;110;527;777;2534;887;3061
240300;201312;2048;5764;1625;4941;396;1327;727;2150;1123;3477
240310;201312;10371;29958;9456;28461;2279;7458;4874;14602;7153;22060
240320;201312;2046;6171;1630;5292;103;452;1195;3697;1298;4149
240325;201312;37038;104908;29505;92070;9335;31636;9393;29736;18728;61372
240330;201312;1536;4695;1301;4212;166;670;797;2467;963;3137
240340;201312;1608;4901;1437;4659;264;917;939;3030;1203;3947
240350;201312;2072;6496;1965;6320;263;1020;1529;4800;1792;5820
240360;201312;7341;22470;6442;21107;1036;3668;4285;14380;5321;18048
240370;201312;1981;5531;1763;5176;129;469;1321;3844;1450;4313
240375;201312;893;2399;798;2270;143;468;464;1274;607;1742
240380;201312;2680;8112;2235;7142;337;1125;1307;4149;1644;5274
240390;201312;901;2607;752;2314;81;307;501;1518;582;1825
240400;201312;1430;3907;1251;3656;136;511;946;2685;1082;3196
240410;201312;543;1790;493;1681;77;310;317;1062;394;1372
240420;201312;4832;18567;4652;18134;1368;5461;2342;9620;3710;15081
240430;201312;3482;10202;3211;9712;356;1235;2311;6904;2667;8139
240440;201312;2645;7250;2476;6934;653;1886;1333;3751;1986;5637
240450;201312;3834;11677;3505;11062;551;2109;2129;6612;2680;8721
240460;201312;2831;9312;2748;9174;301;1209;2131;7036;2432;8245
240470;201312;3760;11549;3113;10206;534;1913;1804;5882;2338;7795
240480;201312;408;1066;374;999;38;88;241;658;279;746
240485;201312;2134;6517;1886;6033;404;1426;1046;3331;1450;4757
240490;201312;1650;4254;1451;3975;87;330;1133;2981;1220;3311
240500;201312;2088;6404;1996;6251;204;720;1533;4804;1737;5524
240510;201312;1781;5545;1656;5300;241;843;1188;3811;1429;4654
240520;201312;1436;4231;1268;3983;227;807;827;2545;1054;3352
240530;201312;2200;7050;1981;6696;274;1002;1396;4704;1670;5706
240540;201312;1854;5682;1760;5524;178;633;1321;4093;1499;4726
240550;201312;769;2253;703;2144;56;213;536;1592;592;1805
240560;201312;3221;9572;3071;9335;307;1024;2473;7486;2780;8510
240570;201312;3104;8978;2528;7667;605;2078;1117;3097;1722;5175
240580;201312;8056;25420;7630;24698;1311;4523;5457;17571;6768;22094
240590;201312;849;2430;754;2264;55;216;554;1625;609;1841
240600;201312;1503;4542;1222;3940;197;732;681;2084;878;2816
240610;201312;4995;14148;4419;13115;496;1653;3045;8895;3541;10548
240615;201312;1047;3039;876;2703;150;474;505;1567;655;2041
240620;201312;1653;5514;1547;5322;244;928;1124;3849;1368;4777
240630;201312;2037;6363;1930;6173;184;565;1480;4908;1664;5473
240640;201312;918;2757;777;2531;92;402;516;1613;608;2015
240650;201312;3675;11572;3429;11232;312;1173;2759;9011;3071;10184
240660;201312;2508;8130;2399;7955;276;968;1808;6094;2084;7062
240670;201312;2744;8320;2359;7525;354;1322;1367;4242;1721;5564
240680;201312;1500;4464;1211;3921;162;540;732;2407;894;2947
240690;201312;1088;3122;955;2898;104;376;688;2068;792;2444
240700;201312;2633;8046;2208;7217;146;657;1698;5389;1844;6046
240710;201312;18565;47649;16482;44979;3090;8548;10171;28639;13261;37187
240720;201312;5553;16321;5308;15934;1340;4448;3027;9014;4367;13462
240725;201312;1077;3252;822;2668;77;262;470;1497;547;1759
240730;201312;2263;7099;2039;6672;207;760;1427;4605;1634;5365
240740;201312;2276;6903;2043;6466;266;909;1342;4251;1608;5160
240750;201312;2234;8360;2056;8022;477;2000;1137;4487;1614;6487
240760;201312;1189;3681;1135;3600;109;313;912;3001;1021;3314
240770;201312;3496;10406;3219;9980;429;1491;2260;7001;2689;8492
240780;201312;5847;16866;4847;15223;924;3111;2701;8682;3625;11793
240790;201312;846;2697;691;2399;48;191;527;1834;575;2025
240800;201312;40087;118285;36768;112391;10675;34943;15487;48014;26162;82957
240810;201312;93346;285109;88064;275185;28986;94318;39489;125384;68475;219702
240820;201312;6873;20748;5945;19254;1092;3948;3282;10963;4374;14911
240830;201312;9300;28907;8827;28213;797;2688;7175;23313;7972;26001
240840;201312;1284;3644;1115;3350;110;402;712;2112;822;2514
240850;201312;1150;3601;903;3076;186;722;453;1453;639;2175
240860;201312;1305;3740;1124;3450;90;322;822;2481;912;2803
240870;201312;1158;3251;1002;2953;129;473;666;1841;795;2314
240880;201312;1176;4063;1117;3979;152;679;786;2748;938;3427
240890;201312;5479;15636;4800;14408;820;2798;2690;7990;3510;10788
240895;201312;2780;9582;2536;9147;397;1527;1721;6302;2118;7829
240910;201312;2596;8431;2429;8104;246;989;1801;5961;2047;6950
240920;201312;857;2799;779;2613;196;739;394;1280;590;2019
240930;201312;3570;9848;3265;9435;308;943;2592;7565;2900;8508
240933;201312;1449;4394;1287;4111;278;979;696;2255;974;3234
240940;201312;6549;18751;5585;17073;1171;3789;2954;9010;4125;12799
240950;201312;1154;3657;1086;3547;111;461;784;2545;895;3006
240960;201312;771;2472;703;2331;76;307;518;1694;594;2001
240970;201312;2027;5788;1714;5224;168;616;1197;3603;1365;4219
240980;201312;3319;11099;3099;10673;722;2730;1819;6230;2541;8960
240990;201312;3057;9262;2870;8879;581;2030;1764;5311;2345;7341
241000;201312;1079;3076;944;2837;97;356;690;2029;787;2385
241010;201312;2975;10124;2703;9627;464;1894;1767;6152;2231;8046
241020;201312;2102;6043;1745;5338;184;665;1075;3140;1259;3805
241025;201312;1510;4731;1405;4536;131;555;990;3136;1121;3691
241030;201312;2540;8456;2341;8103;155;578;1889;6608;2044;7186
241040;201312;2122;7525;1944;7178;220;962;1431;5279;1651;6241
241050;201312;1305;3946;1186;3735;102;416;890;2712;992;3128
241060;201312;999;2908;911;2762;117;373;679;2069;796;2442
241070;201312;909;2670;785;2436;100;375;547;1637;647;2012
241080;201312;1168;3549;1039;3315;87;363;720;2220;807;2583
241090;201312;2150;6258;1867;5759;126;538;1511;4591;1637;5129
241100;201312;1207;3662;1053;3309;105;374;733;2258;838;2632
241105;201312;1142;3511;1076;3392;188;636;666;2161;854;2797
241110;201312;849;2744;722;2478;87;381;430;1431;517;1812
241120;201312;7988;24347;7290;23222;1507;4919;4722;15425;6229;20344
241140;201312;3395;9735;3031;9008;430;1359;1993;5851;2423;7210
241142;201312;698;2107;497;1653;149;573;134;394;283;967
241150;201312;5723;17454;5267;16668;905;3011;3449;10993;4354;14004
241160;201312;1108;3276;1044;3154;166;550;710;2137;876;2687
241170;201312;1334;4000;1217;3779;157;555;750;2413;907;2968
241180;201312;1013;2800;809;2425;114;396;469;1352;583;1748
241190;201312;1014;2858;912;2682;82;332;628;1722;710;2054
241200;201312;20444;62354;19008;60008;5155;17535;9572;30634;14727;48169
241210;201312;1473;4433;1250;3981;269;967;624;1951;893;2918
241220;201312;7918;27067;7563;26373;1835;6824;4132;14713;5967;21537
241230;201312;3044;9325;2760;8890;224;857;2230;7130;2454;7987
241240;201312;1149;3347;860;2717;79;253;508;1651;587;1904
241250;201312;5574;17933;4927;16638;358;1686;3951;13022;4309;14708
241255;201312;1864;7182;1764;6953;484;1987;789;3246;1273;5233
241260;201312;4961;13619;4014;12086;342;1293;2850;8401;3192;9694
241270;201312;2046;6223;1797;5731;267;979;1043;3340;1310;4319
241280;201312;2145;6323;1987;6007;392;1222;1230;3790;1622;5012
241290;201312;3280;9172;2656;8169;498;1663;1552;4762;2050;6425
241300;201312;1387;4081;1263;3885;77;274;1002;3099;1079;3373
241310;201312;1514;4877;1444;4761;209;684;1035;3522;1244;4206
241320;201312;899;3031;838;2906;170;645;450;1580;620;2225
241330;201312;1538;4909;1445;4780;158;619;1157;3786;1315;4405
241335;201312;2582;8111;2463;7898;213;677;2044;6602;2257;7279
241340;201312;1948;6137;1753;5719;457;1641;838;2663;1295;4304
241350;201312;1940;6287;1822;6046;167;708;1387;4477;1554;5185
241355;201312;1272;3588;1132;3342;69;227;978;2855;1047;3082
241360;201312;2097;5889;1881;5463;145;550;1371;3804;1516;4354
241370;201312;1334;4181;1087;3643;202;749;586;1949;788;2698
241380;201312;724;2103;624;1899;97;353;343;1026;440;1379
241390;201312;2886;9808;2730;9511;664;2421;1584;5652;2248;8073
241400;201312;3872;11547;3656;11231;496;1765;2689;8227;3185;9992
241410;201312;2633;7952;2425;7656;447;1558;1643;5141;2090;6699
241415;201312;1554;4912;1433;4670;146;553;1033;3332;1179;3885
241420;201312;2173;7703;1935;7324;611;2574;831;3164;1442;5738
241430;201312;440;1373;415;1305;55;197;274;827;329;1024
241440;201312;6669;23950;6280;23269;1173;4570;4296;16118;5469;20688
241445;201312;1010;3211;961;3140;162;476;717;2472;879;2948
241450;201312;3233;9204;3001;8873;481;1600;2124;6204;2605;7804
241460;201312;3543;10504;3148;9722;290;1107;2274;6894;2564;8001
241470;201312;1338;3842;1167;3626;135;541;860;2586;995;3127
241475;201312;1233;3903;1067;3571;71;339;784;2537;855;2876
241480;201312;3225;10643;2952;10219;1000;3584;1112;4211;2112;7795
241490;201312;636;1732;521;1553;57;232;357;1003;414;1235
241500;201312;717;2329;702;2309;10;44;670;2204;680;2248
250010;201312;2666;8569;2369;8058;244;1034;1717;5699;1961;6733
250020;201312;1670;4863;1294;4157;122;514;866;2687;988;3201
250030;201312;7815;22822;7080;21788;901;2853;5273;16633;6174;19486
250040;201312;4457;15260;4128;14615;787;2996;2613;9305;3400;12301
250050;201312;3596;11523;3326;11132;541;2003;2270;7636;2811;9639
250053;201312;1269;3897;1217;3824;192;674;817;2551;1009;3225
250057;201312;723;2669;700;2640;41;132;609;2395;650;2527
250060;201312;4857;15678;4675;15372;639;2433;3499;11266;4138;13699
250070;201312;4180;13179;3942;12755;438;1806;3054;9567;3492;11373
250073;201312;780;2386;704;2240;84;305;487;1544;571;1849
250077;201312;2233;6629;1866;6013;284;990;1054;3438;1338;4428
250080;201312;4738;13958;4565;13703;595;1891;3350;10077;3945;11968
250090;201312;2611;7937;2529;7810;153;582;2119;6411;2272;6993
250100;201312;3935;13505;3763;13190;454;1796;2866;10016;3320;11812
250110;201312;5712;17630;5452;17255;842;2985;3999;12547;4841;15532
250115;201312;556;1846;485;1687;55;260;298;969;353;1229
250120;201312;2232;6674;1931;6112;182;682;1409;4399;1591;5081
250130;201312;5635;17416;5294;16906;326;1193;4414;14193;4740;15386
250135;201312;1073;3308;982;3148;116;409;683;2212;799;2621
250140;201312;2092;6812;1931;6597;261;911;1431;4985;1692;5896
250150;201312;5081;17311;4691;16587;544;2196;3409;11987;3953;14183
250153;201312;1581;4193;1413;3941;131;454;1105;3043;1236;3497
250157;201312;1616;5717;1482;5424;366;1313;798;3059;1164;4372
250160;201312;3298;10431;3162;10216;222;825;2712;8756;2934;9581
250170;201312;1588;4714;1491;4555;326;1063;911;2826;1237;3889
250180;201312;16495;52499;15977;51571;2676;10001;10887;34171;13563;44172
250190;201312;3930;11893;3652;11402;615;2085;2362;7284;2977;9369
250200;201312;2215;6180;1777;5586;143;522;1473;4599;1616;5121
250205;201312;1008;3366;879;3136;88;413;611;2166;699;2579
250210;201312;1631;5409;1505;5215;187;811;1075;3632;1262;4443
250215;201312;1410;4880;1367;4794;208;847;856;2983;1064;3830
250220;201312;812;2310;678;2145;49;184;577;1801;626;1985
250230;201312;1703;4391;1392;3874;143;448;1072;2904;1215;3352
250240;201312;2638;8516;2335;8041;241;901;1742;6064;1983;6965
250250;201312;4494;13846;4143;13354;406;1403;3313;10761;3719;12164
250260;201312;1898;5891;1673;5519;130;517;1269;4173;1399;4690
250270;201312;1264;4099;1172;3983;152;541;891;3056;1043;3597
250280;201312;3784;11474;3488;10998;737;2391;2164;7095;2901;9486
250290;201312;2143;5724;1773;5237;60;225;1555;4582;1615;4807
250300;201312;5456;16270;5154;15879;634;2581;4046;11932;4680;14513
250310;201312;1149;3738;1044;3565;165;673;745;2505;910;3178
250320;201312;7854;25124;7460;24259;1206;4473;4863;15385;6069;19858
250330;201312;2538;8095;2215;7636;264;1053;1663;5672;1927;6725
250340;201312;1130;3341;1059;3234;61;219;889;2722;950;2941
250350;201312;4530;12478;4131;11978;203;703;3569;10442;3772;11145
250355;201312;2103;6525;1915;6234;131;550;1521;4919;1652;5469
250360;201312;2029;6131;1884;5917;121;460;1471;4638;1592;5098
250370;201312;13643;38946;11908;36847;893;2864;10242;31962;11135;34826
250375;201312;1092;3485;1031;3377;67;277;859;2804;926;3081
250380;201312;1642;4726;1563;4624;105;365;1357;3994;1462;4359
250390;201312;1964;5340;1630;4776;211;684;1099;3213;1310;3897
250400;201312;64918;185925;59006;177192;14750;47167;32172;98148;46922;145315
250403;201312;1500;5063;1453;4994;200;761;1085;3691;1285;4452
250407;201312;1160;3372;1004;3105;65;228;792;2410;857;2638
250410;201312;658;2151;575;2000;70;305;429;1469;499;1774
250415;201312;1825;5814;1670;5487;97;423;1281;4114;1378;4537
250420;201312;1303;4120;1211;3968;103;419;996;3191;1099;3610
250430;201312;6545;18503;6200;17995;507;1798;5068;14399;5575;16197
250435;201312;1634;5013;1458;4678;183;691;896;2938;1079;3629
250440;201312;4501;13665;4296;13376;267;1009;3657;11334;3924;12343
250450;201312;2074;5909;1852;5608;93;349;1646;4955;1739;5304
250460;201312;6236;19209;5820;18626;812;2795;4291;13878;5103;16673
250470;201312;1593;4441;1445;4226;148;533;1055;3015;1203;3548
250480;201312;3947;11921;3556;11343;173;693;3089;9784;3262;10477
250485;201312;616;1648;515;1469;29;112;409;1119;438;1231
250490;201312;4146;13469;4027;13280;799;2832;2637;8743;3436;11575
250500;201312;1914;5923;1771;5680;348;1158;1082;3527;1430;4685
250510;201312;4961;13953;4353;13095;317;1161;3560;10576;3877;11737
250520;201312;1874;5878;1773;5700;360;1334;1022;3184;1382;4518
250523;201312;1786;5751;1702;5637;231;813;1291;4333;1522;5146
250527;201312;1459;4468;1370;4347;60;272;1223;3821;1283;4093
250530;201312;671;2088;593;1986;52;206;482;1613;534;1819
250535;201312;1278;4133;1218;4010;87;371;980;3145;1067;3516
250540;201312;2473;7310;2314;7128;88;291;2121;6559;2209;6850
250550;201312;912;3041;842;2928;72;308;638;2183;710;2491
250560;201312;1731;5663;1693;5605;140;521;1428;4730;1568;5251
250570;201312;2496;8288;2266;7839;215;883;1699;5799;1914;6682
250580;201312;1113;3183;922;2855;137;536;620;1832;757;2368
250590;201312;1052;3249;943;3092;83;356;741;2373;824;2729
250600;201312;7847;22694;7464;22107;756;2259;5916;17759;6672;20018
250610;201312;3365;10121;3151;9803;376;1285;2286;7112;2662;8397
250620;201312;869;2544;800;2406;139;453;519;1546;658;1999
250625;201312;2125;7032;2088;6978;80;224;1925;6521;2005;6745
250630;201312;10282;33591;9751;32627;2289;8292;5321;17749;7610;26041
250640;201312;3882;11581;3620;11266;314;1245;2997;9115;3311;10360
250650;201312;904;2716;853;2617;164;614;444;1382;608;1996
250660;201312;2169;5264;1658;4643;29;84;1576;4423;1605;4507
250670;201312;2673;9128;2530;8851;291;1211;1813;6325;2104;7536
250680;201312;4914;14303;4651;13916;287;1044;3963;11786;4250;12830
250690;201312;6309;17100;6105;16819;634;1973;5106;13862;5740;15835
250700;201312;5315;16175;4980;15668;782;2760;3462;10728;4244;13488
250710;201312;4530;14701;4178;14233;660;2328;2914;10211;3574;12539
250720;201312;2619;8071;2493;7850;197;772;1987;6185;2184;6957
250730;201312;3594;11419;3438;11162;474;1759;2452;7884;2926;9643
250740;201312;2024;6103;1769;5642;217;770;1238;3907;1455;4677
250750;201312;101400;305061;96061;296646;19105;65164;61151;185999;80256;251163
250760;201312;2209;6700;2046;6432;234;911;1470;4540;1704;5451
250770;201312;3765;13275;3576;13005;789;3107;2128;7753;2917;10860
250780;201312;1887;5783;1642;5322;178;720;1144;3623;1322;4343
250790;201312;2469;8147;2334;7945;625;2109;1417;4980;2042;7089
250800;201312;2711;8003;2394;7469;184;673;1792;5465;1976;6138
250810;201312;1360;4055;1187;3800;121;491;939;2935;1060;3426
250820;201312;2011;6310;1956;6221;114;426;1634;5240;1748;5666
250830;201312;5870;19647;5594;19101;747;3046;3812;12731;4559;15777
250840;201312;1041;3355;909;3083;120;465;579;1956;699;2421
250850;201312;2394;7036;2061;6476;210;827;1378;4421;1588;5248
250855;201312;1091;3285;1032;3191;67;237;855;2613;922;2850
250860;201312;2869;9875;2651;9437;642;2505;1148;4084;1790;6589
250870;201312;1194;3471;1035;3213;78;301;747;2241;825;2542
250880;201312;1358;4055;1283;3946;125;422;1009;3100;1134;3522
250890;201312;9229;30261;8586;29348;1604;6407;5496;18463;7100;24870
250900;201312;3062;10272;2729;9627;328;1201;1919;6872;2247;8073
250905;201312;2109;6670;2011;6539;347;1184;1443;4720;1790;5904
250910;201312;5302;15755;4962;15231;532;1786;3750;11534;4282;13320
250915;201312;1735;5194;1584;4960;152;472;1288;4104;1440;4576
250920;201312;3549;10200;3337;9895;457;1351;2361;7224;2818;8575
250930;201312;1931;6388;1854;6254;369;1431;1230;4072;1599;5503
250933;201312;1182;3866;1140;3799;142;542;813;2713;955;3255
250937;201312;870;2721;778;2530;116;470;463;1487;579;1957
250939;201312;1714;5436;1555;5162;259;930;1003;3344;1262;4274
250940;201312;3955;11729;3664;11271;268;965;2899;8903;3167;9868
250950;201312;1349;4247;1237;4105;78;278;1024;3434;1102;3712
250960;201312;1353;4272;1201;4069;73;278;1017;3482;1090;3760
250970;201312;8854;24532;7998;23343;1309;3951;5435;15977;6744;19928
250980;201312;2668;8220;2459;7850;267;1079;1712;5269;1979;6348
250990;201312;2108;7411;1987;7162;295;1252;1357;4774;1652;6026
251000;201312;2571;7386;2117;6733;135;514;1699;5382;1834;5896
251010;201312;2845;8287;2581;7911;220;793;2023;6184;2243;6977
251020;201312;1658;5146;1537;4994;160;572;1251;4102;1411;4674
251030;201312;1314;3745;1192;3540;130;457;762;2254;892;2711
251040;201312;1932;6222;1734;5907;180;849;1250;4084;1430;4933
251050;201312;1134;3405;993;3144;162;553;546;1806;708;2359
251060;201312;1045;2588;850;2342;90;323;641;1682;731;2005
251065;201312;589;1768;516;1654;77;274;310;958;387;1232
251070;201312;598;1737;572;1696;52;214;450;1257;502;1471
251080;201312;21281;59968;19917;57648;5468;16859;10594;30990;16062;47849
251090;201312;3056;9741;2731;9139;312;1199;1954;6472;2266;7671
251100;201312;991;3275;874;3058;130;515;576;1959;706;2474
251110;201312;2113;6171;1902;5831;226;761;1313;4030;1539;4791
251120;201312;5995;20620;5816;20305;828;3408;4481;15326;5309;18734
251130;201312;3970;10372;3569;9922;52;173;3429;9530;3481;9703
251140;201312;4349;13636;4050;13152;263;1066;3142;10164;3405;11230
251150;201312;2820;9307;2604;9010;338;1364;1909;6655;2247;8019
251160;201312;1881;6289;1810;6195;99;394;1594;5468;1693;5862
251170;201312;1426;4466;1381;4408;136;516;1124;3527;1260;4043
251180;201312;2925;8840;2690;8537;633;2102;1551;5018;2184;7120
251190;201312;4306;12599;4179;12435;291;925;3677;10972;3968;11897
251200;201312;4229;13137;4029;12867;249;911;3495;11193;3744;12104
251203;201312;1323;4226;1201;3974;117;491;742;2526;859;3017
251207;201312;1241;3941;1072;3605;91;390;754;2483;845;2873
251210;201312;8036;23410;7086;22088;1051;3291;5062;16121;6113;19412
251220;201312;1289;3530;1129;3267;175;542;714;2132;889;2674
251230;201312;5195;15905;4581;15175;454;1709;3840;12645;4294;14354
251240;201312;3150;10468;3070;10337;330;1340;2412;8004;2742;9344
251250;201312;10338;31671;9672;30599;1684;5768;6600;20744;8284;26512
251260;201312;539;1674;484;1598;40;143;365;1209;405;1352
251270;201312;4160;13009;3929;12705;155;653;3560;11451;3715;12104
251272;201312;1369;4238;1280;4104;118;397;1008;3295;1126;3692
251274;201312;990;3175;934;3064;133;548;531;1785;664;2333
251275;201312;1382;3953;1301;3822;142;532;977;2771;1119;3303
251276;201312;1497;4501;1415;4346;227;756;852;2703;1079;3459
251278;201312;621;2017;536;1815;87;325;310;1093;397;1418
251280;201312;2297;7406;2217;7257;302;1117;1619;5286;1921;6403
251290;201312;6032;17543;5732;17157;887;3078;4071;11883;4958;14961
251300;201312;770;2662;713;2575;72;341;505;1774;577;2115
251310;201312;3195;9532;2921;9127;219;857;2359;7251;2578;8108
251315;201312;1682;6047;1633;5951;322;1274;981;3607;1303;4881
251320;201312;2129;6062;1763;5467;142;523;1281;4017;1423;4540
251330;201312;2046;5390;1699;4936;119;498;1423;3972;1542;4470
251335;201312;987;3454;946;3370;117;478;683;2414;800;2892
251340;201312;3918;11015;3313;10071;341;1303;2336;6902;2677;8205
251350;201312;1629;5067;1476;4842;255;927;962;3167;1217;4094
251360;201312;1827;6036;1731;5925;123;511;1462;5010;1585;5521
251365;201312;898;2683;721;2300;68;273;475;1477;543;1750
251370;201312;21848;75170;21458;74499;4309;16642;14428;49223;18737;65865
251380;201312;1388;4322;1217;4020;95;415;944;3031;1039;3446
251385;201312;870;2459;794;2329;77;291;545;1541;622;1832
251390;201312;5737;20686;5437;20203;1026;4155;3650;13485;4676;17640
251392;201312;1071;3178;991;3045;122;395;702;2193;824;2588
251394;201312;610;1910;515;1721;41;167;361;1197;402;1364
251396;201312;867;2531;794;2399;85;286;598;1778;683;2064
251398;201312;1132;3309;943;2952;90;345;637;1961;727;2306
251400;201312;1370;3965;1259;3809;161;624;877;2555;1038;3179
251410;201312;1624;4311;1472;4060;167;529;1000;2799;1167;3328
251420;201312;2189;6383;1871;6017;194;732;1409;4476;1603;5208
251430;201312;1722;6204;1562;5945;118;525;1284;4893;1402;5418
251440;201312;1465;4472;1252;4065;170;633;866;2778;1036;3411
251445;201312;1555;4931;1480;4812;127;506;1227;3931;1354;4437
251450;201312;4818;15265;4320;14629;175;736;3769;12769;3944;13505
251455;201312;1207;3789;1043;3519;87;377;756;2507;843;2884
251460;201312;881;2804;846;2738;152;501;623;2052;775;2553
251465;201312;504;1603;457;1508;53;209;296;955;349;1164
251470;201312;1298;3768;1068;3332;140;541;620;1926;760;2467
251480;201312;1135;3121;1026;2938;64;244;824;2315;888;2559
251490;201312;2087;6209;1808;5813;310;1180;1150;3607;1460;4787
251500;201312;1743;5825;1694;5747;210;826;1283;4293;1493;5119
251510;201312;2585;8722;2394;8303;436;1619;1430;5012;1866;6631
251520;201312;1092;3051;994;2898;137;422;558;1637;695;2059
251530;201312;11827;35158;11351;34451;839;3221;9604;28643;10443;31864
251540;201312;2839;9433;2621;8959;287;1209;1934;6547;2221;7756
251550;201312;3962;9933;3342;9131;189;662;2739;7260;2928;7922
251560;201312;747;2332;687;2225;113;469;408;1195;521;1664
251570;201312;1033;3121;892;2838;116;455;551;1780;667;2235
251580;201312;2190;6067;2028;5846;337;920;1481;4374;1818;5294
251590;201312;1690;5643;1657;5605;115;405;1443;4941;1558;5346
251593;201312;1016;3263;966;3176;153;574;613;1952;766;2526
251597;201312;1954;6075;1879;5951;211;786;1450;4516;1661;5302
251600;201312;7298;21799;6965;21258;955;3025;5069;15802;6024;18827
251610;201312;3630;11004;3339;10612;365;1258;2541;8146;2906;9404
251615;201312;1223;3577;1045;3261;123;441;662;2118;785;2559
251620;201312;17206;49625;15293;47142;2399;7868;10793;33689;13192;41557
251630;201312;5355;13687;4691;12876;393;1139;3729;10331;4122;11470
251640;201312;2664;7855;2178;6972;269;1023;1479;4677;1748;5700
251650;201312;4373;12511;3937;11956;337;1153;3203;9849;3540;11002
251660;201312;3588;12133;3290;11663;275;1295;2655;9186;2930;10481
251670;201312;4001;11730;3593;11134;159;546;3123;9678;3282;10224
251675;201312;751;2538;714;2475;170;649;390;1310;560;1959
251680;201312;2866;8066;2332;7268;147;626;1900;5800;2047;6426
251690;201312;3420;10857;3179;10411;411;1486;2155;7025;2566;8511
251700;201312;2077;6935;1975;6794;225;875;1546;5287;1771;6162
251710;201312;942;2492;707;2065;101;366;375;1032;476;1398
251720;201312;1378;4305;1278;4139;119;475;984;3142;1103;3617
251740;201312;739;2095;597;1838;119;397;328;1027;447;1424
260005;201312;24709;61742;22022;58152;4880;13337;13412;35618;18292;48955
260010;201312;9592;26484;7779;24213;775;2623;6054;18889;6829;21512
260020;201312;5794;17289;5149;16274;638;1991;3723;12241;4361;14232
260030;201312;5372;16364;4981;15772;539;1890;3837;12132;4376;14022
260040;201312;10181;24734;8438;22742;608;1453;7001;19490;7609;20943
260050;201312;10810;35590;10140;34829;674;2486;8843;30688;9517;33174
260060;201312;4073;11401;3753;10889;344;1041;2958;8678;3302;9719
260070;201312;9364;28969;8943;28355;2312;7905;5295;16828;7607;24733
260080;201312;5406;15863;4820;14982;616;2147;3367;10388;3983;12535
260090;201312;5231;14422;4959;14053;1028;2718;3378;10001;4406;12719
260100;201312;3490;9426;3201;9037;246;918;2579;7278;2825;8196
260105;201312;4458;13617;4303;13334;870;2834;2732;8449;3602;11283
260110;201312;21511;64571;19936;62648;1627;5082;16822;53563;18449;58645
260120;201312;11490;35948;11083;35233;3196;10489;5569;18444;8765;28933
260130;201312;3097;9020;2950;8776;474;1339;2081;6393;2555;7732
260140;201312;13398;34939;11435;32514;1283;4130;8624;24782;9907;28912
260150;201312;3121;9197;2770;8673;243;910;2150;6776;2393;7686
260160;201312;5980;18234;5420;17563;488;1705;4438;14640;4926;16345
260170;201312;17439;48509;16757;47580;1535;4113;13700;39618;15235;43731
260180;201312;3479;10832;3183;10381;236;952;2614;8445;2850;9397
260190;201312;15874;38773;15022;37694;1021;2801;12878;32240;13899;35041
260200;201312;11195;32952;9934;31064;1276;4109;7281;23291;8557;27400
260210;201312;11274;35646;10460;34447;788;2960;8638;28722;9426;31682
260220;201312;8967;28698;8759;28377;787;3212;7367;23376;8154;26588
260230;201312;9694;29083;9267;28504;695;2253;7639;23903;8334;26156
260240;201312;2862;9198;2552;8744;387;1442;1760;6056;2147;7498
260250;201312;2773;7514;2548;7225;187;519;2147;6169;2334;6688
260260;201312;11354;33742;11130;33454;932;3087;9271;28420;10203;31507
260270;201312;3524;10826;3325;10529;411;1556;2591;8061;3002;9617
260280;201312;12594;42543;11629;40997;829;3287;9640;34337;10469;37624
260290;201312;33501;103101;32458;101396;5899;21066;22269;67973;28168;89039
260300;201312;8480;26126;7591;24843;721;2779;5872;19315;6593;22094
260310;201312;5110;15511;4791;15005;1541;4544;2330;7894;3871;12438
260320;201312;6737;23180;6304;22532;564;2179;5050;18286;5614;20465
260330;201312;3111;9758;2845;9301;283;1127;1903;6411;2186;7538
260340;201312;1865;5615;1780;5495;111;405;1560;4779;1671;5184
260345;201312;25793;86125;24794;84059;7697;28408;11337;37070;19034;65478
260350;201312;4373;12954;4187;12662;491;1683;3106;9359;3597;11042
260360;201312;2368;7533;2274;7376;577;1995;1204;3993;1781;5988
260370;201312;6034;18912;5508;17962;796;2694;3889;12954;4685;15648
260380;201312;4975;16463;4644;16037;420;1420;3789;13356;4209;14776
260390;201312;4747;15011;4137;14032;508;1975;2954;9851;3462;11826
260392;201312;3496;11177;3320;10933;185;738;2926;9583;3111;10321
260400;201312;13662;40964;13142;40106;2737;9338;8537;25490;11274;34828
260410;201312;62312;186835;59135;181410;20124;62573;26977;85609;47101;148182
260415;201312;4030;13250;3551;12330;565;2333;2176;7478;2741;9811
260420;201312;11985;28311;10958;27204;779;2201;9196;22775;9975;24976
260430;201312;2705;9172;2479;8803;264;1091;1872;6569;2136;7660
260440;201312;3396;10603;3166;10142;558;2006;1906;6008;2464;8014
260450;201312;5038;15737;4784;15287;452;1627;3725;11918;4177;13545
260460;201312;5851;18278;5523;17770;932;3369;3609;11458;4541;14827
260470;201312;4995;14799;4712;14405;508;1673;3668;11411;4176;13084
260480;201312;3855;11483;3481;10915;667;2275;2319;7233;2986;9508
260490;201312;6045;15983;5323;14839;712;2374;3531;9796;4243;12170
260500;201312;6762;18915;6287;18222;721;2214;4654;13735;5375;15949
260510;201312;10323;27746;9597;26740;863;2573;7516;21546;8379;24119
260515;201312;4704;14844;3694;12697;473;1811;2208;7675;2681;9486
260520;201312;15896;43483;15437;42867;3536;9222;10118;29332;13654;38554
260530;201312;10262;30729;9048;29074;530;1613;7856;25757;8386;27370
260540;201312;5786;15258;5515;14956;705;1654;4356;12224;5061;13878
260545;201312;42;162;28;115;4;19;6;23;10;42
260550;201312;2808;9565;2511;9002;678;2720;1163;4119;1841;6839
260560;201312;6734;17502;6077;16561;351;970;5299;14475;5650;15445
260570;201312;6312;22295;5912;21571;1059;4302;3990;14605;5049;18907
260580;201312;3910;10994;3716;10707;333;1082;3078;8727;3411;9809
260590;201312;5643;15080;5436;14833;258;648;4934;13655;5192;14303
260600;201312;25854;81649;24532;79343;4813;16648;15381;50305;20194;66953
260610;201312;7077;21358;6752;20908;1311;4275;4643;14444;5954;18719
260620;201312;17262;54276;16637;53209;3308;11855;10630;33200;13938;45055
260630;201312;2269;6893;1973;6410;241;930;1434;4620;1675;5550
260640;201312;17273;47990;16441;46774;2330;7233;11986;33938;14316;41171
260650;201312;5515;17736;5238;17277;806;2649;3452;12157;4258;14806
260660;201312;8193;23515;7409;22477;663;2145;6033;18479;6696;20624
260670;201312;2394;6906;2030;6400;285;1036;1346;4253;1631;5289
260680;201312;23195;63979;21909;61819;5017;15184;12361;34434;17378;49618
260690;201312;3539;9943;3073;9182;242;888;2440;7202;2682;8090
260700;201312;5507;16456;5400;16346;90;198;5211;15968;5301;16166
260710;201312;1300;4040;1177;3857;145;570;876;2807;1021;3377
260720;201312;17268;57343;16402;55704;4680;16346;8504;29614;13184;45960
260730;201312;7357;24500;6618;23394;884;3276;4907;17584;5791;20860
260740;201312;1359;4199;1192;3888;177;622;739;2447;916;3069
260750;201312;6769;21871;6382;21329;588;1966;5267;17936;5855;19902
260760;201312;4706;13364;4416;12974;535;1667;3303;9781;3838;11448
260765;201312;7877;28362;7610;27956;1551;6430;4861;17812;6412;24242
260770;201312;4276;11244;3919;10760;241;870;3163;8500;3404;9370
260775;201312;5273;15514;4995;15065;611;2202;3575;10475;4186;12677
260780;201312;3958;13216;3814;12957;921;3438;2179;7379;3100;10817
260790;201312;118659;310263;114220;303763;26899;75327;68301;181591;95200;256918
260795;201312;3018;9826;2838;9541;497;1799;1862;6369;2359;8168
260800;201312;4709;13043;4381;12587;247;1000;3774;10541;4021;11541
260805;201312;4107;12141;3702;11491;596;1981;2478;7710;3074;9691
260810;201312;7415;21592;7209;21309;470;1673;6279;18411;6749;20084
260820;201312;4572;13408;4298;13021;1356;4191;2247;6886;3603;11077
260825;201312;3055;9925;2889;9681;298;1005;2334;7929;2632;8934
260830;201312;3654;12047;3404;11598;1014;3296;1839;6617;2853;9913
260840;201312;4192;12392;3877;11918;259;990;3299;10070;3558;11060
260845;201312;4156;12529;3861;11939;689;2301;2554;7889;3243;10190
260850;201312;4909;17088;4485;16171;1163;4772;2165;7607;3328;12379
260860;201312;2999;10014;2793;9664;356;1267;2039;7169;2395;8436
260870;201312;4159;11762;3789;11288;589;1647;2717;8368;3306;10015
260875;201312;7415;19992;6719;18903;1015;2935;4457;12924;5472;15859
260880;201312;8874;28648;8474;28058;1063;3576;6609;22199;7672;25775
260890;201312;14850;43094;14249;42182;1632;5528;10684;31592;12316;37120
260900;201312;6067;18987;5249;17578;1047;3697;3110;10599;4157;14296
260910;201312;3032;9451;2741;9012;310;1188;2114;6891;2424;8079
260915;201312;4527;15224;4402;15046;111;355;4098;14240;4209;14595
260920;201312;3432;10627;3258;10374;534;1868;2300;7462;2834;9330
260930;201312;4147;13343;3711;12697;540;1850;2643;9260;3183;11110
260940;201312;13825;39925;12725;37983;2549;8902;7160;20787;9709;29689
260950;201312;6104;19901;5816;19313;888;3750;3800;11837;4688;15587
260960;201312;67250;190160;63706;184410;13929;43032;37081;108035;51010;151067
260970;201312;5326;17552;4977;16997;670;2676;3569;12081;4239;14757
260980;201312;3998;12818;3822;12582;264;990;3195;10672;3459;11662
260990;201312;17926;56606;16543;54653;2444;7755;11959;41363;14403;49118
261000;201312;15109;43918;12571;39669;2871;9682;6690;21509;9561;31191
261010;201312;2799;7899;2620;7662;244;547;2185;6713;2429;7260
261020;201312;6189;18640;5699;17862;457;1746;4591;14011;5048;15757
261030;201312;3397;11481;3253;11240;349;1304;2576;8872;2925;10176
261040;201312;5363;17569;4662;16440;603;2439;3336;11725;3939;14164
261050;201312;8725;24978;8154;24067;1313;4054;5323;15659;6636;19713
261060;201312;11245;35417;10853;34750;1907;6773;7565;23855;9472;30628
261070;201312;48448;127980;44329;122250;10476;30287;25279;70504;35755;100791
261080;201312;5717;17805;5427;17328;447;1437;4502;14609;4949;16046
261090;201312;16005;45755;15035;44414;1644;5047;11888;35365;13532;40412
261100;201312;7302;23678;6817;22918;616;2496;5370;17937;5986;20433
261110;201312;66360;192773;60746;184553;15451;48188;33328;106716;48779;154904
261120;201312;3589;9977;3296;9599;154;466;2912;8562;3066;9028
261130;201312;7025;18513;6736;18185;287;793;6138;16571;6425;17364
261140;201312;3229;9268;2987;8878;648;2155;1777;5186;2425;7341
261150;201312;5468;16823;4947;16083;606;2228;3663;11978;4269;14206
261153;201312;1964;5715;1670;5301;115;446;1379;4383;1494;4829
261160;201312;223760;592228;213984;578844;46086;128009;131206;364204;177292;492213
261170;201312;5940;16949;5552;16382;881;2679;4076;12100;4957;14779
261180;201312;9435;27123;9161;26751;1135;3392;7071;20901;8206;24293
261190;201312;5360;17190;5110;16856;816;3565;3526;10948;4342;14513
261200;201312;3914;9775;3691;9470;626;1639;2572;6650;3198;8289
261210;201312;1924;5261;1847;5157;148;412;1578;4466;1726;4878
261220;201312;12489;41555;11036;38310;2207;8451;6018;20692;8225;29143
261230;201312;4033;12667;3812;12388;170;583;3448;11247;3618;11830
261240;201312;4853;14564;4602;14090;832;2514;3129;9751;3961;12265
261245;201312;3842;12257;3333;11390;281;1196;2436;8393;2717;9589
261247;201312;3499;11037;3067;10234;444;1563;2086;7040;2530;8603
261250;201312;19278;52463;18612;51526;3380;9677;13723;38088;17103;47765
261255;201312;4358;13512;3904;12762;337;1235;3025;10019;3362;11254
261260;201312;12149;35469;11212;34365;652;1798;9895;30923;10547;32721
261270;201312;3815;11144;3573;10757;516;1701;2497;7509;3013;9210
261280;201312;2725;8543;2481;8174;274;1040;1839;6033;2113;7073
261290;201312;3001;8708;2703;8322;248;866;2185;6793;2433;7659
261300;201312;10189;34974;9272;33320;1660;6662;5985;21413;7645;28075
261310;201312;8385;25880;7999;25207;1848;6181;4756;14963;6604;21144
261320;201312;5938;18775;5596;18111;692;2234;4125;13675;4817;15909
261330;201312;5479;16632;5337;16425;441;1480;4412;13612;4853;15092
261340;201312;4568;15109;4359;14775;685;2667;2886;9803;3571;12470
261350;201312;7938;27295;7534;26558;669;2895;5944;20714;6613;23609
261360;201312;9449;24753;8677;23694;1263;3592;5982;16688;7245;20280
261370;201312;20789;62830;19734;61252;3759;12405;13125;40935;16884;53340
261380;201312;4141;14506;3869;14025;634;2356;2623;9791;3257;12147
261390;201312;16955;53005;15527;50475;2804;10125;9479;30513;12283;40638
261400;201312;4825;17136;4418;16335;648;2709;3006;11146;3654;13855
261410;201312;8044;24360;7661;23770;1047;3386;5611;17721;6658;21107
261420;201312;7903;26878;7650;26490;2007;7615;4364;15304;6371;22919
261430;201312;3599;11247;3078;10556;427;1491;2230;7846;2657;9337
261440;201312;1655;5076;1543;4899;124;504;1247;3912;1371;4416
261450;201312;14086;41586;13705;41058;1086;3434;11938;35784;13024;39218
261460;201312;8475;24656;7931;23893;821;2344;5883;19102;6704;21446
261470;201312;3939;10814;3625;10430;239;780;3099;8884;3338;9664
261480;201312;3419;12716;3199;12304;418;1776;2359;8945;2777;10721
261485;201312;4923;15525;4580;14925;1083;3784;2512;8288;3595;12072
261500;201312;5917;16552;5284;15694;755;2050;3922;12202;4677;14252
261510;201312;2050;6645;1931;6465;168;565;1554;5270;1722;5835
261520;201312;2575;8509;2288;8019;208;848;1619;5667;1827;6515
261530;201312;12434;40847;11087;38198;2524;9672;5323;18306;7847;27978
261540;201312;7307;23844;7076;23438;1694;5360;4582;15779;6276;21139
261550;201312;3446;10562;3311;10364;470;1831;2521;7597;2991;9428
261560;201312;6815;22460;6289;21775;1334;4464;4284;15440;5618;19904
261570;201312;3500;11076;3180;10558;461;1595;2221;7466;2682;9061
261580;201312;5841;18924;5210;17877;460;1745;4136;14464;4596;16209
261590;201312;2830;7982;2490;7505;361;1172;1721;5261;2082;6433
261600;201312;5042;14369;4331;13325;536;1734;3175;9896;3711;11630
261610;201312;2292;7070;2011;6660;171;684;1634;5326;1805;6010
261618;201312;2554;7383;2412;7187;292;946;1866;5515;2158;6461
261620;201312;4537;14126;4307;13764;480;1652;3143;10235;3623;11887
261630;201312;8117;24126;7185;22482;1387;4962;4011;12231;5398;17193
261640;201312;32706;86290;30447;83461;2385;6834;25256;70272;27641;77106
261650;201312;3813;12396;3601;12079;512;1948;2679;8980;3191;10928
270010;201312;4422;17097;4065;16350;522;2454;2832;11372;3354;13826
270020;201312;3923;12226;3680;11828;554;2075;2639;8313;3193;10388
270030;201312;44820;137336;42916;134377;11891;38154;23919;76849;35810;115003
270040;201312;10349;32443;9934;31969;1570;4586;7541;25203;9111;29789
270050;201312;3976;11731;3681;11314;449;1675;2750;8300;3199;9975
270060;201312;1584;5447;1527;5358;380;1467;902;3138;1282;4605
270070;201312;4114;12965;3877;12621;177;810;3379;10842;3556;11652
270080;201312;1284;4127;1167;3962;257;968;705;2367;962;3335
270090;201312;2051;6574;2004;6516;59;237;1882;6108;1941;6345
270100;201312;6413;20349;6150;19992;1356;4704;3989;12908;5345;17612
270110;201312;3410;9800;3146;9489;593;1851;1983;6419;2576;8270
270120;201312;3034;9014;2738;8611;160;609;2323;7332;2483;7941
270130;201312;4957;15796;4726;15521;670;2150;3605;12231;4275;14381
270135;201312;1708;4997;1632;4908;91;192;1476;4566;1567;4758
270140;201312;9250;24365;8260;23049;871;3484;6393;16667;7264;20151
270150;201312;2603;9160;2539;9069;239;993;2131;7555;2370;8548
270160;201312;4864;16804;4488;16292;347;1245;3746;13793;4093;15038
270170;201312;4000;13433;3697;12966;843;3393;2035;7074;2878;10467
270180;201312;2210;7487;1983;7193;182;831;1571;5646;1753;6477
270190;201312;1885;6338;1793;6183;160;628;1407;4881;1567;5509
270200;201312;2715;9258;2562;9012;244;1101;2043;7018;2287;8119
270210;201312;4157;14453;4050;14299;495;2017;3265;11485;3760;13502
270220;201312;1698;5409;1586;5185;299;1145;864;2878;1163;4023
270230;201312;11083;36838;9838;34853;1560;6496;6656;23260;8216;29756
270235;201312;6464;21698;6165;21194;369;1630;5241;17942;5610;19572
270240;201312;9689;29493;8657;28098;1631;5577;5671;18546;7302;24123
270250;201312;3439;9012;3154;8694;175;486;2848;7872;3023;8358
270255;201312;5069;15712;4231;14242;435;1862;2956;9761;3391;11623
270260;201312;6310;20565;6144;20270;894;3465;4460;14713;5354;18178
270270;201312;1205;3509;1111;3364;191;614;704;2078;895;2692
270280;201312;3640;11089;3445;10798;500;1883;2425;7436;2925;9319
270290;201312;8318;29769;7936;29072;900;3709;6127;22402;7027;26111
270300;201312;3281;11519;3118;11322;194;870;2747;9954;2941;10824
270310;201312;7167;22735;6501;21566;451;2044;5231;16937;5682;18981
270320;201312;6223;20776;5997;20360;1728;6583;2931;10049;4659;16632
270330;201312;4798;16087;4543;15735;396;1474;3759;13142;4155;14616
270340;201312;1775;5573;1612;5363;213;768;1193;4030;1406;4798
270350;201312;2096;5953;1939;5750;342;1054;1242;3912;1584;4966
270360;201312;2086;6570;2039;6513;284;874;1616;5307;1900;6181
270370;201312;1704;5676;1568;5436;196;778;1077;3830;1273;4608
270375;201312;2902;9144;2768;8938;427;1732;1986;6136;2413;7868
270380;201312;6139;18911;5860;18526;609;1983;4553;14729;5162;16712
270390;201312;1440;4016;1300;3837;186;640;882;2522;1068;3162
270400;201312;6109;19057;5646;18381;602;2287;4122;13259;4724;15546
270410;201312;4968;15524;4720;15036;601;2077;3395;10782;3996;12859
270420;201312;5440;18018;5289;17791;304;1417;4508;14901;4812;16318
270430;201312;140198;413096;134830;405527;35960;110892;76357;236017;112317;346909
270440;201312;4980;15677;4710;15257;402;1483;3769;12262;4171;13745
270450;201312;6458;20623;6280;20392;646;2480;4981;16154;5627;18634
270460;201312;3544;10016;3204;9533;268;1019;2569;7452;2837;8471
270470;201312;10746;35257;10268;34374;1652;5589;6820;23526;8472;29115
270480;201312;3086;9956;2856;9534;362;1469;1877;6030;2239;7499
270490;201312;990;3206;934;3120;98;405;695;2270;793;2675
270500;201312;5360;18722;5171;18437;537;1963;4113;15054;4650;17017
270510;201312;6040;18941;5553;18251;957;4012;3940;12279;4897;16291
270520;201312;3687;12102;3477;11750;1037;3737;1706;5868;2743;9605
270530;201312;1530;4602;1356;4372;222;701;917;3078;1139;3779
270540;201312;2019;7150;1863;6905;187;922;1462;5278;1649;6200
270550;201312;6986;21630;6243;20610;1151;3973;4063;13811;5214;17784
270560;201312;2958;9522;2821;9298;567;2140;1866;6011;2433;8151
270570;201312;4299;14278;3951;13708;502;2107;2700;9325;3202;11432
270580;201312;1986;6763;1904;6615;330;1235;1342;4709;1672;5944
270590;201312;1353;4719;1273;4576;104;479;1063;3777;1167;4256
270600;201312;2820;9660;2569;9283;225;1112;1998;7022;2223;8134
270610;201312;3225;10367;3016;10054;339;1218;2341;7797;2680;9015
270620;201312;1454;4983;1319;4781;151;710;992;3494;1143;4204
270630;201312;18143;51207;17226;49817;2534;7383;12763;37447;15297;44830
270640;201312;5847;18443;5337;17821;451;1911;4362;14291;4813;16202
270642;201312;2470;8545;2313;8291;419;1700;1485;5319;1904;7019
270644;201312;2239;6812;2086;6640;247;722;1701;5552;1948;6274
270650;201312;3920;12787;3773;12574;879;3465;2172;7043;3051;10508
270660;201312;2546;6679;2066;5937;173;625;1443;4067;1616;4692
270670;201312;15114;42547;13408;40422;1831;5913;9857;30280;11688;36193
270680;201312;4139;12868;4015;12720;247;738;3589;11489;3836;12227
270690;201312;8693;25230;8098;24473;2671;7934;3801;12493;6472;20427
270700;201312;799;2533;760;2471;133;535;473;1478;606;2013
270710;201312;5422;18689;5209;18399;642;2308;4099;14696;4741;17004
270720;201312;3318;11585;3077;11154;288;1348;2445;8726;2733;10074
270730;201312;6589;20797;6272;20382;1222;4081;4358;14379;5580;18460
270740;201312;2388;7213;2241;6975;372;1298;1458;4512;1830;5810
270750;201312;4700;15498;4419;15064;591;2116;3317;11412;3908;13528
270760;201312;3497;10719;3200;10240;428;1466;2296;7393;2724;8859
270770;201312;17716;48859;15269;45843;2985;9582;9612;29397;12597;38979
270780;201312;1937;6353;1807;6147;277;1006;1260;4340;1537;5346
270790;201312;1618;5210;1480;4979;407;1484;692;2346;1099;3830
270800;201312;11221;34432;10597;33605;1006;3554;8596;27264;9602;30818
270810;201312;3374;10616;2803;9551;402;1613;1728;5848;2130;7461
270820;201312;1890;6491;1741;6226;282;1161;1156;4084;1438;5245
270830;201312;5228;16589;4809;16039;1240;4674;2764;9169;4004;13843
270840;201312;7354;25849;6784;25091;505;2430;5631;20576;6136;23006
270850;201312;7596;25430;7432;25226;1521;6407;5045;16177;6566;22584
270860;201312;11385;35156;10763;34258;1777;6691;7701;23886;9478;30577
270870;201312;2270;6744;1837;5817;300;1018;1111;3517;1411;4535
270880;201312;7745;25609;7370;25054;524;2255;6190;20758;6714;23013
270890;201312;2609;8143;2432;7854;413;1592;1635;5128;2048;6720
270895;201312;3035;11407;2890;11212;275;1092;2376;9401;2651;10493
270900;201312;1912;5324;1574;4830;109;430;1220;3639;1329;4069
270910;201312;3277;11694;3216;11571;350;1585;2583;9019;2933;10604
270915;201312;9864;34320;9012;32720;1970;8141;5023;18072;6993;26213
270920;201312;6183;19972;5800;19407;326;1481;5016;16620;5342;18101
270930;201312;17006;47161;14190;43594;3124;10207;8005;25255;11129;35462
270940;201312;5737;19866;5560;19640;880;3333;4045;14411;4925;17744
280010;201312;720;2150;632;2005;70;278;408;1277;478;1555
280020;201312;4919;15049;4397;14085;916;3092;2653;8498;3569;11590
280030;201312;71326;193489;64352;182964;16399;49424;33639;96723;50038;146147
280040;201312;3147;10053;2863;9667;374;1296;2121;7384;2495;8680
280050;201312;4110;13383;3826;12952;1095;3743;2068;7336;3163;11079
280060;201312;4189;14374;4049;14130;981;3748;2361;8290;3342;12038
280067;201312;7515;21739;6411;20219;714;2497;4784;15047;5498;17544
280070;201312;1806;6433;1738;6332;346;1315;1161;4307;1507;5622
280100;201312;4004;12811;3620;12108;996;3496;1752;5965;2748;9461
280110;201312;1361;4254;1259;4088;101;409;1003;3216;1104;3625
280120;201312;7819;25112;7298;24263;1278;3998;4948;17389;6226;21387
280130;201312;7760;22843;7315;22165;1303;4535;4824;14348;6127;18883
280140;201312;5439;15335;4941;14663;591;1786;3808;11444;4399;13230
280150;201312;3302;10519;3046;10021;491;1936;1927;6077;2418;8013
280160;201312;1537;4447;1398;4220;174;602;1001;3011;1175;3613
280170;201312;4535;14075;4175;13619;513;1679;3206;10806;3719;12485
280190;201312;1108;3272;1012;3119;110;439;715;2113;825;2552
280200;201312;1093;3482;1031;3378;167;691;734;2312;901;3003
280210;201312;12356;40205;11816;39379;2577;9024;7460;25452;10037;34476
280220;201312;1544;4818;1487;4744;101;386;1286;4094;1387;4480
280230;201312;3846;11417;3462;10776;727;2397;2014;6432;2741;8829
280240;201312;3393;10387;3123;9964;273;838;2458;7978;2731;8816
280250;201312;778;2127;690;1989;121;404;413;1118;534;1522
280260;201312;2033;5463;1861;5244;123;361;1596;4512;1719;4873
280270;201312;2197;7033;1927;6563;146;587;1512;5085;1658;5672
280280;201312;4033;13618;3768;13176;948;2934;2022;7947;2970;10881
280290;201312;16417;54093;15247;52039;2860;10539;10267;35319;13127;45858
280300;201312;9989;30737;9337;30000;855;2895;7763;25208;8618;28103
280310;201312;1432;4121;1272;3871;107;414;919;2719;1026;3133
280320;201312;7492;25694;7020;24838;1424;5725;3769;13253;5193;18978
280330;201312;4535;13214;4289;12894;542;1817;3302;9909;3844;11726
280340;201312;3723;11610;3586;11422;331;1094;2908;9530;3239;10624
280350;201312;21104;63653;19911;61822;3100;9989;14022;44414;17122;54403
280360;201312;5792;18728;5471;18219;1238;4628;3258;10726;4496;15354
280370;201312;1931;5602;1772;5336;215;765;1283;3762;1498;4527
280380;201312;977;3089;904;2985;114;449;689;2222;803;2671
280390;201312;3219;9665;2864;9011;774;2281;1612;5248;2386;7529
280400;201312;4395;12825;4035;12341;841;2495;2592;8286;3433;10781
280410;201312;2336;7788;2132;7406;368;1482;1280;4334;1648;5816
280420;201312;4121;12134;3859;11739;256;813;3334;10232;3590;11045
280430;201312;2151;5910;2030;5757;197;665;1641;4619;1838;5284
280440;201312;5033;15058;4709;14646;469;1519;3875;12160;4344;13679
280445;201312;2414;7037;2245;6744;121;482;1845;5423;1966;5905
280450;201312;8859;24390;8231;23644;775;1899;6855;20416;7630;22315
280460;201312;6804;19003;6144;18091;1120;3459;4152;12450;5272;15909
280470;201312;1782;5477;1631;5247;182;640;1230;3954;1412;4594
280480;201312;30548;94187;29497;92617;5311;19407;19619;60056;24930;79463
280490;201312;3691;11556;3422;11036;439;1600;2516;8098;2955;9698
280500;201312;879;2375;832;2317;33;108;738;2032;771;2140
280510;201312;2728;8118;2357;7605;312;1164;1746;5650;2058;6814
280520;201312;1716;4958;1590;4793;204;564;1207;3799;1411;4363
280530;201312;2045;6464;1944;6328;262;909;1482;4912;1744;5821
280540;201312;8858;24835;8375;24174;348;1226;7483;21471;7831;22697
280550;201312;7065;19422;6342;18263;604;2097;4716;13410;5320;15507
280560;201312;7831;23417;7416;22730;546;1918;6079;18531;6625;20449
280570;201312;6525;18741;6025;18091;927;3228;4165;12309;5092;15537
280580;201312;5620;17358;4898;16153;789;2716;3293;11088;4082;13804
280590;201312;2348;7280;2169;7066;293;1138;1614;5238;1907;6376
280600;201312;3998;12476;3760;12049;401;1578;2721;8534;3122;10112
280610;201312;2310;6871;2189;6682;344;1176;1412;4291;1756;5467
280620;201312;4988;15599;4499;14632;810;2812;2863;9389;3673;12201
280630;201312;3774;12614;3636;12396;363;1112;2933;10408;3296;11520
280640;201312;2228;6417;2083;6246;135;319;1844;5657;1979;5976
280650;201312;1100;3494;1020;3341;185;671;655;2153;840;2824
280660;201312;2610;7761;2513;7596;300;981;2045;6130;2345;7111
280670;201312;15687;42258;14958;41320;1783;5249;11455;31671;13238;36920
280680;201312;2738;7436;2397;6993;178;571;2016;5882;2194;6453
280690;201312;964;2847;853;2680;127;461;562;1699;689;2160
280700;201312;1152;3429;1014;3223;87;284;745;2409;832;2693
280710;201312;10289;29165;9722;28476;599;1861;8384;24620;8983;26481
280720;201312;2472;6814;2221;6498;198;621;1741;5167;1939;5788
280730;201312;935;2852;900;2803;84;283;754;2364;838;2647
280740;201312;12605;35216;11034;32837;1754;5153;7533;23090;9287;28243
280750;201312;3510;11130;3269;10693;297;1261;2389;7661;2686;8922
280760;201312;5698;17889;5254;17305;727;2379;3889;13330;4616;15709
290010;201312;2989;6778;2179;5504;86;359;1741;4141;1827;4500
290020;201312;4971;15803;4536;15353;399;1201;3931;13618;4330;14819
290030;201312;3188;10426;3090;10247;505;1802;2231;7357;2736;9159
290035;201312;4516;12492;4084;11921;313;982;3418;10061;3731;11043
290040;201312;3724;11049;3459;10713;291;1118;2834;8646;3125;9764
290050;201312;2723;9019;2551;8755;267;1029;1962;6768;2229;7797
290060;201312;1312;3420;1097;3152;241;793;731;2021;972;2814
290070;201312;30654;81632;26664;76592;5982;17880;14387;43427;20369;61307
290080;201312;5845;18171;5203;17353;668;2301;3897;13331;4565;15632
290090;201312;2277;5124;1828;4647;253;678;1451;3719;1704;4397
290100;201312;10155;29555;8905;27424;1822;5645;5097;16422;6919;22067
290110;201312;5239;16132;5063;15832;926;3132;3379;10503;4305;13635
290115;201312;4777;14640;4253;13935;316;1142;3280;10918;3596;12060
290120;201312;6702;18742;6267;18205;465;1351;5369;15730;5834;17081
290130;201312;4526;12043;3978;11393;354;1013;3327;9651;3681;10664
290135;201312;5104;13407;4460;12348;490;1627;2981;8148;3471;9775
290140;201312;3785;12584;3377;12063;380;1479;2698;9669;3078;11148
290150;201312;2107;6318;2028;6195;201;662;1690;5147;1891;5809
290160;201312;3437;9753;3355;9652;360;714;2865;8603;3225;9317
290170;201312;2828;9576;2607;9220;245;1008;2100;7428;2345;8436
290180;201312;3007;8687;2661;8183;299;1050;1929;5929;2228;6979
290190;201312;4166;13912;4025;13658;441;1603;3058;10465;3499;12068
290195;201312;2200;6228;1899;5780;152;524;1521;4659;1673;5183
290200;201312;3811;12457;3498;11897;439;1577;2577;8812;3016;10389
290205;201312;2856;9218;2657;8917;428;1717;1845;6031;2273;7748
290210;201312;15777;43907;14882;42864;2481;5841;10725;33749;13206;39590
290220;201312;2380;7333;2279;7176;327;1228;1601;4877;1928;6105
290225;201312;3034;8341;2869;8162;227;494;2497;7363;2724;7857
290230;201312;2352;7936;2311;7875;222;795;1917;6611;2139;7406
290240;201312;3861;10416;3484;9892;428;1341;2530;7100;2958;8441
290250;201312;3760;12156;3196;11249;301;1131;2422;8648;2723;9779
290260;201312;4640;14600;4349;14140;476;1659;3398;11057;3874;12716
290265;201312;3324;10975;3152;10664;322;1304;2406;8085;2728;9389
290270;201312;11935;44612;11273;43618;1508;6168;8507;33514;10015;39682
290280;201312;5064;17174;4822;16694;700;2578;3331;11779;4031;14357
290290;201312;9540;31255;8782;30009;1708;6142;5685;19795;7393;25937
290300;201312;4386;12632;3398;10868;340;1159;2388;7807;2728;8966
290310;201312;1521;4678;1435;4560;245;900;982;3063;1227;3963
290320;201312;25934;81866;23417;78437;5221;18639;13919;47275;19140;65914
290323;201312;4030;11056;3336;10320;214;778;2857;8819;3071;9597
290327;201312;3955;12961;3686;12413;520;1862;2557;8619;3077;10481
290330;201312;1872;5089;1796;5004;274;860;1406;3854;1680;4714
290340;201312;5051;16225;4681;15723;1274;4448;2572;8823;3846;13271
290350;201312;4911;15173;4045;13966;574;2024;2821;10033;3395;12057
290360;201312;4097;13274;3731;12770;226;845;3251;11258;3477;12103
290370;201312;4518;13765;4184;13284;553;1755;3302;10651;3855;12406
290380;201312;5600;16569;4982;15688;366;1349;4076;12783;4442;14132
290390;201312;14853;49095;14208;47980;3009;9928;8904;31646;11913;41574
290395;201312;2762;9102;2503;8660;254;1102;1866;6431;2120;7533
290400;201312;3592;11336;3230;10822;553;1849;2241;7644;2794;9493
290405;201312;4382;14241;3833;13277;527;1893;2545;9078;3072;10971
290410;201312;5963;18171;5099;16901;588;2473;3727;11991;4315;14464
290420;201312;3299;9864;2753;9079;253;986;2161;7067;2414;8053
290430;201312;3428;11063;3103;10578;708;2436;1889;6678;2597;9114
290440;201312;2986;8043;2501;7431;205;706;2010;6031;2215;6737
290450;201312;3525;10530;3189;10039;645;1958;2042;6696;2687;8654
290460;201312;12993;41137;12261;39878;3674;12707;5640;18198;9314;30905
290470;201312;4696;13476;3760;12241;895;3294;1960;6492;2855;9786
290475;201312;5036;17975;4582;17146;516;2075;3395;12881;3911;14956
290480;201312;2632;6935;2332;6537;341;1058;1605;4534;1946;5592
290485;201312;4597;15300;4267;14824;473;2147;3307;11313;3780;13460
290490;201312;7776;21621;7527;21276;905;2780;5972;16856;6877;19636
290500;201312;4594;14874;3969;13730;783;2926;2007;6898;2790;9824
290510;201312;3392;10075;2973;9465;252;961;2349;7482;2601;8443
290515;201312;2792;8907;2654;8663;174;547;2152;7198;2326;7745
290520;201312;11605;36395;9518;32473;1160;4648;6060;20599;7220;25247
290530;201312;5234;15333;4503;14266;411;1382;3630;11557;4041;12939
290540;201312;3944;11479;3758;11235;504;1461;2844;8728;3348;10189
290550;201312;4375;11793;3871;11171;185;549;3438;9958;3623;10507
290560;201312;6043;18185;5395;17250;1144;3866;3285;10633;4429;14499
290570;201312;39958;118130;37528;114395;5272;17187;27289;82761;32561;99948
290580;201312;7236;25935;6953;25482;1376;4968;4744;18047;6120;23015
290590;201312;7433;24177;6272;22228;465;1931;5029;17794;5494;19725
290600;201312;17992;56568;16992;55008;2632;8638;11644;38818;14276;47456
290610;201312;2333;8296;1983;7597;203;961;1453;5480;1656;6441
290620;201312;7227;21753;6493;20685;546;1893;5389;17193;5935;19086
290630;201312;8186;22612;7245;21602;881;2636;5744;17347;6625;19983
290640;201312;2697;8076;2257;7303;263;935;1581;5121;1844;6056
290650;201312;11559;34948;10859;33859;3253;10215;5751;18708;9004;28923
290660;201312;3681;10453;3058;9557;207;748;2454;7699;2661;8447
290670;201312;6439;20683;5935;19897;915;2939;4407;15394;5322;18333
290680;201312;10276;30845;9573;29991;589;2033;8144;25677;8733;27710
290682;201312;4321;13140;3918;12562;213;853;3263;10388;3476;11241
290685;201312;3213;8457;2443;7364;324;1059;1493;4613;1817;5672
290687;201312;8243;22523;6621;20577;1149;3862;4210;13298;5359;17160
290689;201312;3085;8992;2606;8221;273;909;1992;6352;2265;7261
290690;201312;5403;16166;4981;15594;624;2105;3837;12060;4461;14165
290700;201312;2228;7142;2142;7018;232;822;1650;5449;1882;6271
290710;201312;7649;25190;7146;24385;408;1403;6247;21531;6655;22934
290720;201312;18340;54957;16448;52598;2308;6904;12684;41967;14992;48871
290730;201312;7359;20788;6740;19992;1408;4050;4313;13267;5721;17317
290740;201312;941;2865;800;2627;140;470;490;1655;630;2125
290750;201312;10015;29187;8682;26796;1621;5897;4837;14060;6458;19957
290755;201312;2416;6963;2041;6328;133;513;1632;5007;1765;5520
290760;201312;4472;13392;3714;12304;401;1323;2748;9218;3149;10541
290770;201312;2543;9022;2373;8791;151;670;1939;7231;2090;7901
290780;201312;8751;23469;7812;22153;989;2515;5848;17212;6837;19727
290790;201312;4612;14093;4318;13671;498;1539;3322;10894;3820;12433
290800;201312;7234;16182;5558;14391;1085;2636;3918;10599;5003;13235
290810;201312;4888;15890;4292;14956;331;1244;3294;11650;3625;12894
290820;201312;5344;15711;4810;14951;570;2023;3567;11047;4137;13070
290830;201312;4010;11937;3813;11596;353;1462;2967;8680;3320;10142
290840;201312;17419;50083;16068;48225;2561;7403;11255;35278;13816;42681
290850;201312;6672;20308;6522;20087;1402;4293;4470;14172;5872;18465
290860;201312;4753;17351;4539;17059;740;2809;3261;12651;4001;15460
290870;201312;4750;14439;4002;13409;478;1911;2912;9615;3390;11526
290880;201312;1389;3935;1135;3530;117;373;764;2417;881;2790
290890;201312;6172;17812;5906;17445;745;2247;4540;13483;5285;15730
290900;201312;2419;7151;1832;6178;286;1090;938;3120;1224;4210
290910;201312;4765;13552;4127;12625;306;1024;3394;10402;3700;11426
290920;201312;4785;14435;4361;13861;361;1010;3563;11592;3924;12602
290930;201312;7382;24209;6724;23029;869;3312;4708;15964;5577;19276
290940;201312;3460;11274;3259;11017;277;1002;2749;9441;3026;10443
290950;201312;1535;4405;1420;4246;214;677;1007;3018;1221;3695
290960;201312;5876;17265;5392;16624;403;1289;4394;13731;4797;15020
290970;201312;3694;12233;3424;11770;497;1772;2279;8021;2776;9793
290980;201312;10531;32057;9370;29751;2748;9124;3802;12079;6550;21203
290990;201312;9144;27839;8250;26379;937;3178;6310;20264;7247;23442
291000;201312;2982;9372;2780;9109;411;1386;2072;6953;2483;8339
291005;201312;12888;37544;11792;35870;2185;7141;7743;23834;9928;30975
291010;201312;3026;10068;2477;8830;386;1500;1472;5247;1858;6747
291020;201312;1374;3734;1052;3137;130;475;626;1809;756;2284
291030;201312;2069;6006;1705;5220;178;597;1110;3363;1288;3960
291040;201312;5395;17364;5016;16800;740;2645;3611;12176;4351;14821
291050;201312;7955;26900;7323;25696;1943;7308;3787;13322;5730;20630
291060;201312;6188;23183;5917;22851;803;3569;4496;17277;5299;20846
291070;201312;16050;48147;14809;46322;1883;5583;11099;35836;12982;41419
291072;201312;20077;64315;17603;59383;6278;22619;5926;20867;12204;43486
291075;201312;5128;15307;4671;14681;328;1046;3629;11721;3957;12767
291077;201312;1536;4568;1307;4202;144;564;901;2843;1045;3407
291080;201312;80834;251684;73060;237685;21448;73304;30039;97100;51487;170404
291085;201312;5633;15384;4911;14400;606;1851;3777;11130;4383;12981
291090;201312;1382;3668;1215;3436;140;526;935;2533;1075;3059
291100;201312;2669;7252;2248;6804;130;530;1922;5764;2052;6294
291110;201312;4962;18076;4503;17341;766;3233;3025;11622;3791;14855
291120;201312;7516;20445;7095;19852;1010;2967;5276;14816;6286;17783
291125;201312;1638;3746;1340;3427;132;327;1038;2774;1170;3101
291130;201312;2995;9285;2626;8665;251;992;1892;6191;2143;7183
291140;201312;4083;12482;3823;12015;558;1833;2645;8400;3203;10233
291150;201312;2003;5277;1919;5176;182;527;1507;4034;1689;4561
291160;201312;5511;17060;4879;16109;1154;3954;2889;9603;4043;13557
291165;201312;2394;7248;1978;6464;144;620;1431;4558;1575;5178
291170;201312;20537;53800;17841;50466;1378;4687;14233;39954;15611;44641
291180;201312;6402;17184;5296;15671;620;2017;3904;11490;4524;13507
291185;201312;3788;10576;3602;10335;294;965;2991;8482;3285;9447
291190;201312;7467;21378;6756;20524;907;2720;5024;15836;5931;18556
291200;201312;3072;9419;2620;8644;331;1273;1819;5961;2150;7234
291210;201312;7429;17890;6540;16895;576;1580;5203;13542;5779;15122
291220;201312;4149;13378;3944;13018;616;2307;2771;9006;3387;11313
291230;201312;3919;10431;3517;9946;172;475;3130;8947;3302;9422
291240;201312;4768;13269;4048;12005;298;928;3163;9313;3461;10241
291250;201312;3755;11444;2986;10151;316;1116;2116;7315;2432;8431
291260;201312;1157;3500;1093;3402;106;356;856;2650;962;3006
291270;201312;4421;15220;4209;14840;328;1292;3411;12103;3739;13395
291280;201312;2358;6087;1801;5432;510;1518;1035;3237;1545;4755
291290;201312;5946;16958;5390;16276;978;3037;3418;10626;4396;13663
291300;201312;4453;13379;3700;12105;489;1760;2475;8076;2964;9836
291310;201312;5304;15539;4694;14527;454;1492;3565;11046;4019;12538
291320;201312;5805;19275;5101;17882;1492;5775;2352;8042;3844;13817
291330;201312;1569;4960;1476;4796;212;810;940;2917;1152;3727
291340;201312;3815;11580;3073;10511;365;1459;2328;7848;2693;9307
291345;201312;3439;11466;3285;11302;258;909;2859;9975;3117;10884
291350;201312;6074;18338;5439;17352;643;2170;3684;12049;4327;14219
291360;201312;35997;106053;33732;102731;8229;25055;21091;66443;29320;91498
291370;201312;9038;26879;8663;26390;1117;3288;6567;20621;7684;23909
291380;201312;3842;11992;3404;11265;340;1145;2429;8283;2769;9428
291390;201312;10503;29633;9636;28606;1404;4097;7242;21882;8646;25979
291400;201312;16800;44739;13671;40493;2235;6839;8814;27066;11049;33905
291410;201312;3255;8566;2403;7309;203;837;1780;5225;1983;6062
291420;201312;2253;6026;2027;5757;93;224;1862;5365;1955;5589
291430;201312;3334;9987;2957;9484;260;1028;2310;7327;2570;8355
291440;201312;5928;19242;5087;17672;587;2176;3837;13519;4424;15695
291450;201312;7316;23114;6844;22319;433;1399;5652;18833;6085;20232
291460;201312;12834;39951;11563;38094;2403;8441;7191;23911;9594;32352
291465;201312;8047;23702;7354;22897;903;3101;5689;17727;6592;20828
291470;201312;15449;43816;13854;41844;1319;4080;10754;33417;12073;37497
291480;201312;34860;96047;31156;90849;5569;18070;19836;57352;25405;75422
291490;201312;4213;14508;4134;14395;522;1807;3312;11749;3834;13556
291500;201312;4153;12275;3636;11558;284;989;2929;9351;3213;10340
291510;201312;3517;11042;3314;10760;145;512;3013;9841;3158;10353
291520;201312;4041;11294;3617;10717;630;1779;2392;7556;3022;9335
291530;201312;2101;6244;1796;5760;499;1727;842;2780;1341;4507
291535;201312;4306;12780;3897;12172;352;1171;2928;9476;3280;10647
291540;201312;2196;5421;1899;5110;185;451;1563;4336;1748;4787
291550;201312;5604;15367;5050;14596;1319;3874;2674;7877;3993;11751
291560;201312;16817;44291;13389;40362;1646;5140;10016;30900;11662;36040
291570;201312;2348;6409;2246;6278;172;452;1958;5559;2130;6011
291580;201312;5845;18159;5208;17167;787;3108;3425;11167;4212;14275
291590;201312;2004;6332;1790;5977;330;1216;1121;3853;1451;5069
291600;201312;5503;15554;4115;13572;1020;3712;1993;6460;3013;10172
291610;201312;5201;15307;5042;15083;445;1517;4175;12405;4620;13922
291620;201312;3032;7304;2526;6761;183;469;2024;5608;2207;6077
291630;201312;3216;8170;2841;7747;279;719;2385;6665;2664;7384
291640;201312;17523;48798;14717;45123;3888;13001;6322;19498;10210;32499
291650;201312;8004;24385;7426;23711;651;1696;6260;20783;6911;22479
291660;201312;2377;6388;2127;6047;267;905;1466;4034;1733;4939
291670;201312;2497;7110;2307;6798;362;1133;1319;4157;1681;5290
291680;201312;4988;14400;4498;13605;1171;4041;2065;6421;3236;10462
291685;201312;4316;11261;3838;10687;416;1178;2917;8427;3333;9605
291690;201312;3966;11047;3288;9983;337;1057;2291;7018;2628;8075
291700;201312;9371;29748;8676;28592;1107;3754;6328;21266;7435;25020
291710;201312;5897;16033;5159;15048;1131;3555;2888;8781;4019;12336
291720;201312;3786;13464;3486;12831;379;1645;2607;9427;2986;11072
291730;201312;5787;18936;5433;18470;1286;4493;3398;11913;4684;16406
291733;201312;2600;7836;2226;7334;295;1020;1504;5032;1799;6052
291735;201312;2337;6899;2035;6443;125;492;1690;5292;1815;5784
291740;201312;3983;11760;3163;10483;330;1280;2237;7383;2567;8663
291750;201312;21755;58215;17362;51650;3941;12239;9367;28319;13308;40558
291760;201312;12112;39268;11254;37697;3976;14518;4880;16509;8856;31027
291770;201312;7992;23432;7310;22269;1259;4183;4787;14419;6046;18602
291780;201312;4265;13425;4060;13035;573;1814;2997;9748;3570;11562
291790;201312;2427;7830;2302;7660;165;672;1929;6372;2094;7044
291800;201312;31181;92606;28318;88440;6283;20507;16921;54151;23204;74658
291810;201312;10585;31016;9206;29365;674;2438;7479;24078;8153;26516
291820;201312;3577;10991;3267;10543;375;1230;2464;8064;2839;9294
291830;201312;4368;12010;4087;11590;571;1784;3049;8627;3620;10411
291835;201312;6081;19343;5094;17707;1198;4448;3092;10771;4290;15219
291840;201312;47219;133600;40977;126907;5279;16394;31863;100888;37142;117282
291845;201312;2999;8830;2714;8517;266;813;2312;7362;2578;8175
291850;201312;4823;13704;4079;12666;467;1408;3092;9874;3559;11282
291855;201312;1631;4464;1407;4175;229;767;988;2889;1217;3656
291860;201312;1985;6059;1737;5582;167;593;1155;3700;1322;4293
291870;201312;1331;3703;1063;3222;111;423;700;2077;811;2500
291875;201312;2815;9206;2553;8766;260;1062;1764;5940;2024;7002
291880;201312;4544;14668;4374;14405;327;1076;3736;12464;4063;13540
291890;201312;1408;3596;1188;3323;172;498;827;2338;999;2836
291900;201312;1280;3742;1137;3533;122;434;861;2636;983;3070
291905;201312;2940;7910;2473;7162;227;773;1762;5149;1989;5922
291910;201312;2557;7139;2275;6778;175;648;1850;5436;2025;6084
291915;201312;6619;20923;5952;19600;535;1845;4859;16249;5394;18094
291920;201312;32446;96126;30013;92480;6310;19952;18130;57512;24440;77464
291930;201312;2545;7626;2316;7287;259;905;1750;5523;2009;6428
291940;201312;3566;10334;2706;8784;415;1528;1559;4900;1974;6428
291950;201312;9159;31428;8328;30043;2162;7934;4348;16154;6510;24088
291955;201312;7709;25618;7533;25338;1668;5694;4808;16592;6476;22286
291960;201312;3342;10092;2881;9457;365;1138;2039;7064;2404;8202
291970;201312;4400;13271;3922;12662;600;2017;2716;8939;3316;10956
291980;201312;11385;33292;8733;29419;1183;4147;6070;20957;7253;25104
291990;201312;2141;7052;1977;6794;212;753;1455;5141;1667;5894
291992;201312;2801;8762;2730;8615;510;1696;1919;6010;2429;7706
291995;201312;2106;6292;1901;6005;243;806;1411;4526;1654;5332
292000;201312;2320;7002;2099;6671;476;1681;1266;3955;1742;5636
292010;201312;6193;16283;4800;14171;483;1489;3663;10847;4146;12336
292020;201312;4443;15365;4092;14777;598;2345;2944;10761;3542;13106
292030;201312;2169;6926;1954;6616;251;944;1277;4362;1528;5306
292040;201312;4601;13010;4106;12482;361;1047;3428;10802;3789;11849
292045;201312;2438;8715;2409;8664;100;342;2242;8110;2342;8452
292050;201312;6310;19998;5597;18575;575;2354;3879;12680;4454;15034
292060;201312;10775;30851;10364;30282;1050;3183;8470;24800;9520;27983
292070;201312;4357;14108;4253;13979;394;1150;3707;12435;4101;13585
292080;201312;3684;9852;3191;9186;291;887;2589;7497;2880;8384
292090;201312;4234;11507;3658;10848;344;1172;2961;8794;3305;9966
292100;201312;11039;31023;9572;29179;2726;8682;5076;16040;7802;24722
292105;201312;3155;9761;2747;9185;211;853;2198;7310;2409;8163
292110;201312;7037;18807;5416;16440;1218;3874;3080;9623;4298;13497
292120;201312;8435;24282;7381;22528;1542;4852;4218;13259;5760;18111
292130;201312;3220;8694;2894;8231;626;1684;1867;5501;2493;7185
292140;201312;5473;14424;4754;13471;580;1659;3367;9847;3947;11506
292145;201312;2677;8310;2445;7948;212;680;1835;6250;2047;6930
292150;201312;13526;41703;12542;40119;932;3426;9864;31857;10796;35283
292160;201312;2702;7881;2323;7364;190;579;1908;6212;2098;6791
292170;201312;8648;26351;7418;24185;1153;4140;4662;15400;5815;19540
292180;201312;3469;10233;2847;9257;432;1455;1824;6055;2256;7510
292190;201312;3200;9227;2819;8677;575;1907;1800;5572;2375;7479
292200;201312;5577;19284;5047;18127;1583;6110;1931;6972;3514;13082
292205;201312;3984;12529;3664;12098;277;1068;2937;9684;3214;10752
292210;201312;6564;19235;5778;18157;532;1784;4566;14651;5098;16435
292220;201312;1913;5516;1817;5377;432;1224;1088;3275;1520;4499
292225;201312;2946;9469;2717;9114;203;726;2212;7513;2415;8239
292230;201312;6235;18954;5965;18532;704;2620;4529;13737;5233;16357
292240;201312;4384;14132;4068;13407;657;2364;2490;8091;3147;10455
292250;201312;5168;16180;4877;15626;1089;3646;2581;8337;3670;11983
292260;201312;3062;9668;2910;9432;334;1145;2268;7340;2602;8485
292265;201312;3060;10128;2795;9643;242;1010;2081;7126;2323;8136
292270;201312;3876;10838;3162;9998;276;1080;2521;7963;2797;9043
292273;201312;2773;6832;2139;6025;305;853;1518;4454;1823;5307
292275;201312;1890;5002;1773;4837;223;693;1340;3624;1563;4317
292280;201312;2049;6213;1873;6020;198;524;1453;4985;1651;5509
292285;201312;2580;7394;2297;6992;239;840;1752;5405;1991;6245
292290;201312;7330;22397;6191;20901;456;1736;4935;16922;5391;18658
292300;201312;8380;26178;7390;25077;2283;7841;4097;14467;6380;22308
292303;201312;2766;8925;2588;8671;116;452;2248;7539;2364;7991
292305;201312;3141;8655;2982;8441;106;329;2694;7639;2800;7968
292310;201312;5825;18059;5341;17398;303;1068;4536;14867;4839;15935
292320;201312;5879;18272;5331;17324;605;2308;4039;12999;4644;15307
292330;201312;1992;5756;1878;5609;238;799;1427;4202;1665;5001
292335;201312;5276;13984;4796;13351;404;1148;4028;11285;4432;12433
292340;201312;6508;19133;5657;17821;557;1883;4190;13229;4747;15112
292350;201312;2061;6517;1929;6360;229;883;1514;4956;1743;5839
292360;201312;4874;14468;4688;13923;188;574;4104;12462;4292;13036
292370;201312;8491;26334;7729;25184;1136;3576;5327;18266;6463;21842
292380;201312;7349;21628;6908;20943;601;1690;5658;17418;6259;19108
292390;201312;3704;8526;3296;8085;107;202;3090;7669;3197;7871
292400;201312;22002;65858;21031;64288;3186;10391;14734;45847;17920;56238
292405;201312;4341;11852;3794;11184;273;827;3179;9477;3452;10304
292410;201312;1876;5141;1792;5044;150;446;1556;4371;1706;4817
292420;201312;3728;12170;3595;12018;175;497;3270;11178;3445;11675
292430;201312;5419;16905;4549;15734;301;1250;3593;12387;3894;13637
292440;201312;8546;28279;7948;27384;301;1183;6966;24314;7267;25497
292450;201312;4382;13216;3601;11966;349;1277;2606;8786;2955;10063
292460;201312;5600;17072;4964;15912;988;3262;3059;9947;4047;13209
292465;201312;2337;7266;2027;6759;244;950;1456;4862;1700;5812
292467;201312;2170;7199;2057;7001;431;1583;1306;4495;1737;6078
292470;201312;3195;8672;2673;7844;230;817;1999;5770;2229;6587
292480;201312;5860;16604;5058;15459;374;1317;4155;12737;4529;14054
292490;201312;2308;6518;1958;5993;206;765;1439;4322;1645;5087
292500;201312;6580;20081;5753;18665;571;2180;4224;13754;4795;15934
292510;201312;13107;38183;11684;36157;1228;4138;9016;28309;10244;32447
292520;201312;5716;17854;5333;17180;1605;5278;2593;8485;4198;13763
292525;201312;5470;14529;4795;13724;414;1248;3846;11151;4260;12399
292530;201312;24866;75905;22921;73536;5199;17356;13898;45973;19097;63329
292540;201312;2804;8407;2547;8024;455;1649;1753;5443;2208;7092
292550;201312;6310;20973;5685;20010;956;3522;3875;13965;4831;17487
292560;201312;4216;11727;3623;10953;313;1147;2936;8730;3249;9877
292570;201312;4011;11969;3864;11812;131;412;3394;10708;3525;11120
292575;201312;5926;20577;5770;20277;1084;3934;3998;14087;5082;18021
292580;201312;7172;21388;6671;20754;575;1815;5536;17436;6111;19251
292590;201312;7184;23192;6872;22679;1018;3364;4927;16533;5945;19897
292593;201312;3246;8648;2762;7930;253;752;2125;6085;2378;6837
292595;201312;5862;16715;5174;15810;515;1705;3916;12044;4431;13749
292600;201312;10523;30083;9927;29330;1270;3006;7955;24616;9225;27622
292610;201312;4316;12669;3591;11447;517;1733;2302;7497;2819;9230
292620;201312;5804;18135;5140;17356;349;1321;4558;15417;4907;16738
292630;201312;9851;25228;8615;23412;824;2343;6536;18032;7360;20375
292640;201312;8238;26955;7278;25667;658;2435;5675;20442;6333;22877
292650;201312;4856;13462;4666;13241;528;1133;3722;11354;4250;12487
292660;201312;10980;34016;10505;33300;1526;4930;7720;25021;9246;29951
292665;201312;2864;8533;2783;8410;95;265;2613;7960;2708;8225
292670;201312;3836;11095;3015;9683;356;1282;1959;6324;2315;7606
292680;201312;3598;11014;3405;10741;313;1022;2803;8848;3116;9870
292690;201312;3334;9227;2446;7861;313;1127;1623;5305;1936;6432
292700;201312;9063;28111;7969;26534;1191;3744;5654;19776;6845;23520
292710;201312;1901;6351;1814;6221;98;373;1602;5508;1700;5881
292720;201312;9460;24802;8399;23593;779;2290;6975;19764;7754;22054
292730;201312;3354;10450;3244;10263;566;1738;2197;7183;2763;8921
292740;201312;348766;998553;332073;973614;81028;251566;196070;575776;277098;827342
292750;201312;5864;16362;5327;15646;401;1186;4327;12932;4728;14118
292760;201312;4208;13722;3884;13126;575;2121;2549;8720;3124;10841
292770;201312;5998;18708;5655;18157;1361;4440;3352;11146;4713;15586
292780;201312;1827;4599;1459;4153;203;703;1044;2911;1247;3614
292790;201312;3325;9053;3181;8895;277;650;2635;7724;2912;8374
292800;201312;9384;28750;8815;27818;950;3257;6789;21454;7739;24711
292805;201312;3133;9409;2892;9050;587;2005;1853;5849;2440;7854
292810;201312;9912;30608;8448;28661;1256;4438;6160;21424;7416;25862
292820;201312;7331;21421;5429;18735;450;1721;4363;15168;4813;16889
292830;201312;1869;5629;1696;5387;125;503;1374;4319;1499;4822
292840;201312;7149;23931;6682;23272;474;1829;5709;19921;6183;21750
292850;201312;3211;8608;2691;7820;348;1075;1887;5439;2235;6514
292860;201312;15142;41866;14571;41155;2021;5715;11216;32128;13237;37843
292870;201312;18748;53253;16728;50010;3392;11154;9596;28209;12988;39363
292880;201312;11628;35334;10557;33597;2007;6538;6526;21022;8533;27560
292890;201312;5491;19282;4959;18244;1023;3943;2815;10629;3838;14572
292895;201312;2710;6971;2226;6215;296;859;1622;4501;1918;5360
292900;201312;3040;9600;2869;9321;438;1696;1914;5985;2352;7681
292905;201312;4160;12452;3539;11659;329;999;2923;9940;3252;10939
292910;201312;5046;15918;4679;15225;838;2921;2962;9593;3800;12514
292920;201312;8438;25382;8013;24659;922;3116;6086;18307;7008;21423
292925;201312;5079;16171;4541;15423;397;1448;3563;12174;3960;13622
292930;201312;6445;21123;6160;20587;853;3490;4419;14386;5272;17876
292935;201312;2110;6069;1787;5707;136;351;1504;5019;1640;5370
292937;201312;3332;8615;2847;8002;317;1030;2193;6073;2510;7103
292940;201312;3040;8594;2435;7752;309;988;1627;5428;1936;6416
292950;201312;8210;25185;7854;24585;1035;3861;5662;17226;6697;21087
292960;201312;4521;12976;4195;12474;487;1609;2962;8717;3449;10326
292970;201312;4219;13388;3905;12982;195;806;3312;11011;3507;11817
292975;201312;3321;9317;3207;9136;365;1072;2616;7491;2981;8563
292980;201312;3550;10117;2917;9342;416;1601;2009;6375;2425;7976
292990;201312;12140;35250;11140;33730;762;2448;9477;28777;10239;31225
293000;201312;2932;7879;2408;7203;132;464;2094;6240;2226;6704
293010;201312;18433;53199;16320;49839;3251;11004;9879;30030;13130;41034
293015;201312;7924;26252;6462;24021;1144;4550;4084;15158;5228;19708
293020;201312;9361;31442;8753;30540;650;2549;7193;25362;7843;27911
293030;201312;5528;16381;4515;14882;473;1712;3127;10600;3600;12312
293040;201312;3774;12135;3621;11965;266;950;3109;10314;3375;11264
293050;201312;19539;56543;17453;53774;2928;9274;11462;36405;14390;45679
293060;201312;4294;11131;3617;10046;418;1273;2455;6735;2873;8008
293070;201312;19883;61515;18444;58980;5315;17700;9332;30418;14647;48118
293075;201312;3474;11152;3169;10788;296;1080;2604;8926;2900;10006
293076;201312;3703;10575;3463;10214;293;837;2892;8690;3185;9527
293077;201312;5076;15829;4420;14992;857;3094;2719;9357;3576;12451
293080;201312;4831;15402;4431;14726;325;1401;3509;11425;3834;12826
293090;201312;3563;11319;2937;10428;312;1109;2249;8141;2561;9250
293100;201312;5649;17604;4866;16225;512;1831;3632;12297;4144;14128
293105;201312;3840;12989;3391;12078;588;2141;2206;8025;2794;10166
293110;201312;1942;5924;1832;5738;113;435;1526;4752;1639;5187
293120;201312;4040;13703;3758;13298;347;1260;3007;10814;3354;12074
293130;201312;3938;11635;3229;10833;196;748;2826;9615;3022;10363
293135;201312;27672;73416;21753;65431;4270;15144;11220;33233;15490;48377
293140;201312;2075;6296;2010;6199;206;794;1553;4657;1759;5451
293150;201312;5836;19287;5236;18133;1106;3871;3034;10908;4140;14779
293160;201312;3439;9567;3274;9359;523;1166;2452;7470;2975;8636
293170;201312;3396;10559;3187;10239;458;1580;2311;7568;2769;9148
293180;201312;5351;15272;4484;13924;391;1448;3515;10731;3906;12179
293190;201312;13674;42126;13039;41124;621;2765;11263;34784;11884;37549
293200;201312;6262;18642;5619;17686;294;1083;4855;15207;5149;16290
293210;201312;4650;14358;4324;13790;557;1869;3051;9866;3608;11735
293220;201312;5150;15791;4663;15035;1245;4243;2335;7691;3580;11934
293230;201312;3907;12451;3622;12051;428;1636;2805;9290;3233;10926
293240;201312;4491;11857;3577;10586;195;586;2825;8364;3020;8950
293245;201312;4358;12877;3984;12253;519;1625;2801;8911;3320;10536
293250;201312;5935;17100;5471;16431;852;2699;3780;11381;4632;14080
293260;201312;4692;14300;3945;13221;364;1345;2960;10078;3324;11423
293270;201312;5801;16131;5515;15819;588;1579;4636;13587;5224;15166
293280;201312;5683;16261;4975;15336;432;1262;3861;12329;4293;13591
293290;201312;16387;55840;15547;54118;3567;12808;8887;31677;12454;44485
293300;201312;6287;16229;5443;15283;491;1351;4349;12371;4840;13722
293305;201312;4669;11971;4157;11264;310;922;3398;9213;3708;10135
293310;201312;2685;7041;2219;6274;252;815;1526;4254;1778;5069
293315;201312;4825;12502;4345;11756;745;1993;2732;7770;3477;9763
293317;201312;2533;7594;2310;7180;325;1042;1517;4751;1842;5793
293320;201312;8136;26788;7940;26518;965;3508;6373;21220;7338;24728
293325;201312;1919;5644;1596;5136;313;1071;994;3239;1307;4310
293330;201312;54552;174747;49095;165393;11308;41381;26693;91061;38001;132442
293340;201312;2714;7825;2153;6841;315;1141;1471;4571;1786;5712
293345;201312;3411;10492;2892;9734;367;1229;2028;7073;2395;8302
293350;201312;6704;18861;6427;18518;501;1362;5576;16353;6077;17715
293360;201312;13688;42021;12541;40498;784;2565;10660;35182;11444;37747
310010;201312;1225;3368;886;2815;240;910;379;1096;619;2006
310020;201312;3825;12250;3167;10773;1082;3977;580;1779;1662;5756
310030;201312;2441;8273;2181;7761;730;2700;911;3275;1641;5975
310040;201312;952;2696;811;2502;110;414;562;1683;672;2097
310050;201312;1895;6742;1671;6185;360;1557;795;2886;1155;4443
310060;201312;3052;10905;2935;10723;364;1373;2272;8468;2636;9841
310070;201312;305;905;223;746;32;138;102;305;134;443
310080;201312;763;2393;618;2101;176;686;198;619;374;1305
310090;201312;4616;14262;4056;13264;727;2677;2432;7933;3159;10610
310100;201312;3261;10260;2789;9483;352;1382;2033;6873;2385;8255
310110;201312;5867;16853;4952;15478;1128;4074;2645;8110;3773;12184
310120;201312;578;1939;547;1882;235;937;196;556;431;1493
310130;201312;456;1452;415;1390;108;409;198;624;306;1033
310140;201312;265;926;230;857;73;313;49;156;122;469
310150;201312;4787;15177;4381;14420;1000;3745;2216;7199;3216;10944
310160;201312;7022;23125;6094;21415;1847;7203;2338;8025;4185;15228
310163;201312;745;2598;681;2452;189;776;254;871;443;1647
310170;201312;9666;28202;8923;27041;1840;5959;5370;16839;7210;22798
310180;201312;1829;5419;1483;4917;397;1492;679;2181;1076;3673
310190;201312;2517;8543;2283;8126;684;2701;328;1194;1012;3895
310200;201312;1871;6433;1578;5822;497;1985;503;1827;1000;3812
310205;201312;941;3039;860;2860;180;602;494;1694;674;2296
310210;201312;2429;7863;2245;7571;390;1453;1533;5145;1923;6598
310220;201312;1252;3620;1010;3299;202;719;618;1998;820;2717
310230;201312;2866;9620;2491;8763;777;3148;908;2918;1685;6066
310240;201312;1014;3623;852;3282;152;667;446;1793;598;2460
310250;201312;960;3378;931;3330;191;792;577;1962;768;2754
310260;201312;3162;10370;2685;9332;751;2944;1009;3403;1760;6347
310270;201312;2323;7112;2094;6767;263;964;1534;4980;1797;5944
310280;201312;2087;6203;1895;5887;651;2348;727;2112;1378;4460
310285;201312;2198;7856;2081;7686;268;951;1582;6040;1850;6991
310290;201312;1315;4166;1223;4022;381;1453;560;1628;941;3081
310300;201312;1877;6517;1770;6294;502;1956;937;3300;1439;5256
310310;201312;399;1124;291;894;60;205;145;436;205;641
310320;201312;360;1280;328;1196;88;357;146;518;234;875
310330;201312;485;1279;365;1062;43;160;211;561;254;721
310340;201312;8285;26785;7372;25257;1508;5446;4336;15283;5844;20729
310350;201312;14246;43016;11643;38134;4283;15174;2958;9735;7241;24909
310360;201312;443;1437;430;1414;94;362;273;843;367;1205
310370;201312;1425;5162;1367;5048;484;1847;594;2230;1078;4077
310375;201312;1267;3502;941;2927;154;574;494;1479;648;2053
310380;201312;395;1131;316;1015;137;489;116;333;253;822
310390;201312;486;1764;409;1584;120;511;65;223;185;734
310400;201312;10109;30878;8068;27135;2760;10205;2150;7103;4910;17308
310410;201312;1024;3340;668;2757;256;1148;110;427;366;1575
310420;201312;5647;16655;3267;10966;834;3165;517;1529;1351;4694
310430;201312;1592;5552;1339;4992;458;1825;343;1260;801;3085
310440;201312;620;1845;544;1724;157;567;197;577;354;1144
310445;201312;1176;4091;1006;3791;157;659;646;2474;803;3133
310450;201312;4391;13216;3681;12139;848;2949;2110;7172;2958;10121
310460;201312;1540;5090;1350;4737;469;1782;307;1138;776;2920
310470;201312;3698;9789;3131;9083;325;1112;2469;7122;2794;8234
310480;201312;1023;3274;886;2987;226;856;370;1172;596;2028
310490;201312;3274;11285;2854;10448;976;3904;1009;3692;1985;7596
310500;201312;1474;5209;1358;4969;443;1778;513;1827;956;3605
310510;201312;2487;8355;2176;7632;830;3165;477;1582;1307;4747
310520;201312;1280;3688;1128;3430;98;311;742;2274;840;2585
310530;201312;837;2725;556;2001;123;492;94;329;217;821
310540;201312;3667;12294;3398;11880;1194;4436;1258;4472;2452;8908
310550;201312;1147;3611;970;3305;317;1248;343;1088;660;2336
310560;201312;15949;50963;13828;46743;4673;17527;4553;14613;9226;32140
310570;201312;1266;3992;1191;3888;168;644;873;2804;1041;3448
310590;201312;4112;12385;3267;10698;673;2550;1186;3667;1859;6217
310600;201312;1616;5507;1518;5284;516;2014;512;1654;1028;3668
310610;201312;547;1906;503;1805;154;651;174;560;328;1211
310620;201312;185114;598858;152146;529809;42776;165894;57091;189717;99867;355611
310630;201312;4114;13758;3896;13341;892;3506;2375;7830;3267;11336
310640;201312;1441;4522;1177;4045;392;1470;350;1124;742;2594
310650;201312;2860;9323;2361;8466;528;2039;1183;4338;1711;6377
310660;201312;1286;4089;1144;3879;201;795;799;2636;1000;3431
310665;201312;1168;3736;1082;3612;209;747;710;2410;919;3157
310670;201312;55911;178808;51495;168669;16170;56136;21433;68897;37603;125033
310680;201312;798;2434;730;2326;179;622;369;1147;548;1769
310690;201312;1203;4190;1003;3748;290;1263;249;881;539;2144
310700;201312;519;1448;443;1334;130;439;208;593;338;1032
310710;201312;7291;24179;5852;21746;1488;6180;2112;7747;3600;13927
310720;201312;840;2650;765;2512;238;897;346;1026;584;1923
310730;201312;9278;30120;8601;29045;2032;7452;5016;16974;7048;24426
310740;201312;4958;17295;4287;15836;1643;6601;1020;3575;2663;10176
310750;201312;1592;4226;1323;3857;252;769;829;2422;1081;3191
310760;201312;606;1954;531;1822;136;509;229;771;365;1280
310770;201312;712;2670;703;2655;307;1271;265;952;572;2223
310780;201312;3573;10528;3252;9980;568;1764;2044;6359;2612;8123
310790;201312;1716;5666;1594;5468;472;1694;803;2817;1275;4511
310800;201312;3035;10099;2468;8923;1050;4120;374;1313;1424;5433
310810;201312;1516;4307;1400;4116;374;1242;653;1804;1027;3046
310820;201312;1471;4276;1082;3576;319;1169;330;1020;649;2189
310825;201312;2350;8251;1934;7506;174;890;1435;5494;1609;6384
310830;201312;1424;4925;1206;4445;447;1761;349;1231;796;2992
310840;201312;2205;7543;2000;7103;771;3006;524;1729;1295;4735
310850;201312;1505;4658;1296;4377;234;910;876;2911;1110;3821
310855;201312;3052;10186;2777;9742;750;2761;1490;5400;2240;8161
310860;201312;7639;24580;6847;23205;1288;4541;3908;13713;5196;18254
310870;201312;1015;2986;869;2726;205;710;395;1220;600;1930
310880;201312;1244;3920;941;3338;197;794;442;1558;639;2352
310890;201312;2713;8825;2130;7675;661;2666;460;1550;1121;4216
310900;201312;4277;14602;3734;13514;1169;4698;1463;5074;2632;9772
310910;201312;1981;5869;1447;4868;437;1646;343;1107;780;2753
310920;201312;1842;5857;1510;5362;412;1668;714;2531;1126;4199
310925;201312;923;3138;835;2979;316;1248;248;880;564;2128
310930;201312;5155;15625;4236;14156;925;3296;2334;8016;3259;11312
310940;201312;6154;18635;5347;17393;1098;3959;2956;9596;4054;13555
310945;201312;1262;3670;1025;3342;248;948;543;1678;791;2626
310950;201312;1890;6528;1572;5854;620;2559;436;1515;1056;4074
310960;201312;456;1595;406;1496;144;584;138;511;282;1095
310970;201312;1463;5241;1113;4255;427;1774;128;436;555;2210
310980;201312;461;1225;324;968;61;219;142;372;203;591
310990;201312;1144;4000;995;3696;224;949;356;1235;580;2184
311000;201312;4576;16183;4071;15076;1333;5484;1383;4853;2716;10337
311010;201312;951;3111;841;2910;267;984;386;1298;653;2282
311020;201312;872;2808;742;2582;141;558;351;1175;492;1733
311030;201312;1808;5618;1442;4841;492;1841;482;1431;974;3272
311040;201312;496;1704;423;1501;120;445;103;352;223;797
311050;201312;2590;8459;2178;7612;722;2748;818;2850;1540;5598
311060;201312;2304;7415;1888;6481;558;2049;445;1486;1003;3535
311070;201312;1706;6182;1502;5739;463;2017;459;1702;922;3719
311080;201312;1191;3249;1058;3040;159;524;701;2017;860;2541
311090;201312;1634;6314;1434;5872;498;2303;258;989;756;3292
311100;201312;2286;8164;2050;7649;954;3705;476;1776;1430;5481
311110;201312;3776;9473;2835;8155;623;2046;1455;4037;2078;6083
311115;201312;1076;3390;929;3160;131;556;595;2026;726;2582
311120;201312;8602;25601;7093;22823;2379;8553;1929;5743;4308;14296
311130;201312;2403;7488;1952;6890;663;2679;776;2608;1439;5287
311140;201312;1229;3678;1065;3474;193;738;718;2296;911;3034
311150;201312;2397;8099;2214;7804;503;1781;1270;4662;1773;6443
311160;201312;4846;16674;4150;15499;1514;6054;1305;4798;2819;10852
311170;201312;747;2353;592;2042;56;217;330;1193;386;1410
311180;201312;1568;4447;1138;3586;366;1272;231;640;597;1912
311190;201312;1091;3344;924;2986;250;938;340;1000;590;1938
311200;201312;2517;7892;2186;7203;900;3239;495;1450;1395;4689
311205;201312;1171;3890;1045;3638;270;1072;387;1395;657;2467
311210;201312;903;3019;835;2910;173;601;572;2052;745;2653
311220;201312;910;2966;727;2542;203;744;233;810;436;1554
311230;201312;8896;27565;7617;25364;1676;6111;3848;13169;5524;19280
311240;201312;1344;4211;1119;3826;379;1457;327;1061;706;2518
311250;201312;1318;4456;1193;4238;383;1484;358;1125;741;2609
311260;201312;2930;8128;2203;6812;724;2466;605;1765;1329;4231
311265;201312;1316;3578;1033;3206;174;652;670;2040;844;2692
311270;201312;3354;11299;3026;10858;639;2678;1867;6555;2506;9233
311280;201312;1374;3916;1044;3300;286;998;326;999;612;1997
311290;201312;2307;7662;2129;7271;409;1370;1234;4398;1643;5768
311300;201312;5000;16911;4551;16209;791;3163;2901;10397;3692;13560
311310;201312;486;1755;467;1721;124;540;179;609;303;1149
311320;201312;4009;13751;3504;12593;992;4032;1159;3923;2151;7955
311330;201312;5483;17096;4692;15798;1727;6262;1495;4994;3222;11256
311340;201312;12001;39625;11008;37705;4030;14882;3158;10753;7188;25635
311350;201312;2275;6913;1957;6355;463;1786;879;2702;1342;4488
311360;201312;1329;3803;1061;3439;467;1601;297;990;764;2591
311370;201312;4454;13630;3976;12796;1016;3983;1665;5028;2681;9011
311380;201312;467;1579;396;1438;134;541;105;343;239;884
311390;201312;1939;7354;1855;7174;814;3502;555;2039;1369;5541
311400;201312;1692;5746;1561;5503;473;1889;664;2154;1137;4043
311410;201312;1997;7365;1872;7180;671;2753;865;3349;1536;6102
311420;201312;2293;8090;1987;7310;738;2883;420;1380;1158;4263
311430;201312;3878;12420;2939;10300;723;2789;563;1911;1286;4700
311440;201312;2201;7806;1861;7246;789;3406;422;1614;1211;5020
311450;201312;2367;8572;2099;7931;766;3096;588;2118;1354;5214
311455;201312;1550;4309;1363;4035;301;1019;759;2177;1060;3196
311460;201312;602;2023;490;1780;128;588;122;410;250;998
311470;201312;590;1902;474;1652;136;564;144;458;280;1022
311480;201312;792;2281;757;2226;270;826;277;760;547;1586
311490;201312;312;1251;300;1205;114;482;93;372;207;854
311500;201312;509;1567;413;1375;159;577;142;457;301;1034
311510;201312;3090;9820;2578;8838;1005;3870;664;2124;1669;5994
311520;201312;686;2398;652;2322;253;971;242;836;495;1807
311530;201312;10899;29697;7497;23529;2199;8198;2064;6099;4263;14297
311535;201312;696;2189;513;1805;135;537;112;380;247;917
311540;201312;698;2561;665;2504;254;971;292;1101;546;2072
311545;201312;2119;6868;2026;6722;347;1274;1358;4509;1705;5783
311547;201312;1652;4681;1401;4284;150;499;948;2913;1098;3412
311550;201312;3263;10893;2875;10096;941;3639;877;3001;1818;6640
311560;201312;276;750;245;712;58;192;132;363;190;555
311570;201312;1961;5110;1683;4788;129;388;1422;4096;1551;4484
311580;201312;2312;5231;1964;4801;585;1409;1098;2751;1683;4160
311590;201312;375;1226;325;1153;91;386;89;310;180;696
311600;201312;1325;4092;1152;3861;244;835;669;2357;913;3192
311610;201312;3499;12279;3246;11865;933;3381;1604;6334;2537;9715
311615;201312;2600;8759;2294;8225;314;1255;1572;5661;1886;6916
311620;201312;443;1450;398;1383;112;459;196;640;308;1099
311630;201312;1450;4389;1237;3984;344;1098;594;1954;938;3052
311640;201312;887;2799;751;2578;131;484;535;1836;666;2320
311650;201312;2426;7045;2031;6404;327;1186;1145;3636;1472;4822
311660;201312;2529;9113;2253;8428;686;2851;452;1468;1138;4319
311670;201312;1373;4370;1216;4079;470;1726;440;1419;910;3145
311680;201312;2258;7219;1919;6726;506;1872;1021;3668;1527;5540
311690;201312;518;1475;437;1378;89;314;277;855;366;1169
311700;201312;2124;6300;1903;5977;203;818;1441;4416;1644;5234
311710;201312;1672;5297;1326;4657;590;2277;348;1176;938;3453
311720;201312;403;1404;376;1351;81;312;229;804;310;1116
311730;201312;4823;13313;3211;10421;1018;3644;1123;3395;2141;7039
311740;201312;1002;2905;875;2755;395;1251;362;1199;757;2450
311750;201312;3801;13163;3560;12827;625;2494;2350;8528;2975;11022
311760;201312;790;2777;736;2655;264;1104;240;730;504;1834
311770;201312;2550;8164;2094;7323;613;2419;678;2273;1291;4692
311780;201312;992;3822;853;3449;298;1329;136;531;434;1860
311783;201312;2056;6868;1840;6464;215;937;1211;4341;1426;5278
311787;201312;658;2314;472;1756;98;385;100;333;198;718
311790;201312;1265;4178;1042;3715;302;1154;231;797;533;1951
311800;201312;3776;13190;2605;9473;661;2621;209;610;870;3231
311810;201312;1039;3532;1002;3459;46;217;869;2949;915;3166
311820;201312;819;2749;698;2456;239;966;308;974;547;1940
311830;201312;10307;37713;9438;35455;3948;15532;2058;7662;6006;23194
311840;201312;3415;10363;2932;9620;1020;3668;1101;3511;2121;7179
311850;201312;315;967;272;896;73;256;126;413;199;669
311860;201312;48140;153553;42119;141606;11646;42966;17653;57535;29299;100501
311870;201312;2291;7051;1875;6241;499;1903;627;1944;1126;3847
311880;201312;6871;21264;6363;20602;983;3223;4477;15042;5460;18265
311890;201312;1595;5105;1345;4572;417;1578;508;1640;925;3218
311900;201312;799;2524;721;2408;156;532;437;1533;593;2065
311910;201312;4659;14019;3824;12835;1204;4382;1521;5157;2725;9539
311920;201312;2036;6808;1777;6418;220;920;1238;4418;1458;5338
311930;201312;4742;14512;4254;13683;1622;5680;1274;4079;2896;9759
311940;201312;12723;40097;11005;36486;3843;14025;2691;8479;6534;22504
311950;201312;2249;6829;1960;6464;137;455;1642;5488;1779;5943
311960;201312;372;1337;340;1267;120;481;115;408;235;889
311970;201312;468;1717;405;1580;138;590;69;246;207;836
311980;201312;743;2133;577;1882;142;498;263;884;405;1382
311990;201312;489;1535;441;1461;186;657;134;413;320;1070
311995;201312;1008;3162;786;2674;228;871;203;576;431;1447
312000;201312;666;2139;639;2098;110;414;366;1192;476;1606
312010;201312;1030;3368;936;3169;193;705;433;1463;626;2168
312015;201312;1581;4957;1373;4594;227;906;800;2684;1027;3590
312020;201312;913;3026;817;2888;223;885;428;1480;651;2365
312030;201312;1763;5401;1592;5178;255;938;1152;3695;1407;4633
312040;201312;668;2591;592;2365;218;976;138;523;356;1499
312050;201312;1505;5242;1299;4784;402;1638;263;907;665;2545
312060;201312;741;2305;662;2197;322;1144;182;541;504;1685
312070;201312;940;2993;633;2299;177;695;225;798;402;1493
312080;201312;2583;7366;2024;6462;479;1851;906;2608;1385;4459
312083;201312;914;2711;775;2512;104;395;494;1575;598;1970
312087;201312;2319;7175;2076;6842;400;1384;1365;4587;1765;5971
312090;201312;9773;32286;8963;30848;2840;10844;3656;12053;6496;22897
312100;201312;1344;4639;1179;4363;276;1144;643;2429;919;3573
312110;201312;1167;4250;1039;3959;375;1567;196;672;571;2239
312120;201312;900;3180;814;2984;264;1095;207;660;471;1755
312125;201312;1163;3856;1036;3566;290;1095;427;1447;717;2542
312130;201312;797;2502;654;2192;167;643;248;782;415;1425
312140;201312;1144;3644;961;3193;217;788;367;1117;584;1905
312150;201312;575;1664;490;1491;58;208;310;916;368;1124
312160;201312;7895;27699;7262;26376;2421;9608;2547;9327;4968;18935
312170;201312;1008;3080;909;2871;129;439;563;1805;692;2244
312180;201312;1583;5015;1463;4810;454;1566;560;1826;1014;3392
312190;201312;645;2164;511;1894;212;881;95;316;307;1197
312200;201312;4650;14450;4081;13452;560;1943;2796;9309;3356;11252
312210;201312;1144;3237;923;2900;253;893;398;1195;651;2088
312220;201312;1858;6242;1693;6049;296;1110;1199;4457;1495;5567
312230;201312;17719;60243;15030;54688;7150;27608;2611;9736;9761;37344
312235;201312;1753;5076;1448;4579;200;778;940;2952;1140;3730
312240;201312;1103;3834;939;3475;293;1156;310;1140;603;2296
312245;201312;2376;7094;2082;6685;182;542;1701;5596;1883;6138
312247;201312;883;2681;692;2377;216;822;320;1114;536;1936
312250;201312;1117;3377;993;3163;219;785;488;1511;707;2296
312260;201312;891;2998;777;2846;114;520;544;1959;658;2479
312270;201312;780;2540;681;2338;184;766;223;637;407;1403
312280;201312;469;1637;427;1531;183;702;47;160;230;862
312290;201312;772;2721;719;2635;298;1205;149;541;447;1746
312300;201312;1107;3740;919;3288;296;1122;114;350;410;1472
312310;201312;938;3639;849;3410;279;1206;342;1341;621;2547
312320;201312;2412;6967;1979;6102;564;1994;558;1438;1122;3432
312330;201312;1113;3485;1007;3323;315;1178;470;1540;785;2718
312340;201312;307;828;288;800;52;192;202;514;254;706
312350;201312;371;981;347;950;51;166;273;710;324;876
312352;201312;1623;5468;1517;5318;529;1882;781;2834;1310;4716
312360;201312;3633;12555;3181;11590;1069;4208;771;2758;1840;6966
312370;201312;1645;5494;1528;5286;526;2019;559;1859;1085;3878
312380;201312;1985;5974;1820;5707;281;952;1234;3962;1515;4914
312385;201312;1200;3859;1132;3729;169;681;770;2437;939;3118
312390;201312;2014;6919;1748;6351;581;2278;358;1245;939;3523
312400;201312;3338;11300;3040;10718;1037;3756;1288;4711;2325;8467
312410;201312;10385;35631;9350;33455;2932;11435;3196;11112;6128;22547
312420;201312;3992;13118;3808;12897;737;2544;2578;9004;3315;11548
312430;201312;8446;25648;7496;24225;1435;4916;4738;15760;6173;20676
312440;201312;590;1979;525;1853;180;685;191;675;371;1360
312450;201312;1110;4187;1024;3994;476;1884;315;1224;791;3108
312460;201312;396;1237;355;1186;90;345;178;565;268;910
312470;201312;747;2182;509;1687;138;540;103;331;241;871
312480;201312;1283;4043;1115;3844;419;1512;461;1575;880;3087
312490;201312;2315;6181;1846;5553;292;1054;1091;3172;1383;4226
312500;201312;591;2121;558;2061;157;680;271;965;428;1645
312510;201312;1985;7019;1751;6478;527;2197;570;1897;1097;4094
312520;201312;392;1360;343;1253;121;475;108;391;229;866
312530;201312;563;1906;536;1846;110;452;292;949;402;1401
312540;201312;1450;4732;1180;4191;204;843;689;2374;893;3217
312550;201312;621;2042;561;1916;72;286;354;1176;426;1462
312560;201312;2113;5799;1879;5487;244;817;1388;4077;1632;4894
312570;201312;2652;8313;2351;7738;750;2648;682;2160;1432;4808
312580;201312;520;1772;425;1579;111;485;172;596;283;1081
312590;201312;1822;6288;1600;5789;551;2252;483;1569;1034;3821
312595;201312;1997;6899;1780;6360;508;1955;772;2684;1280;4639
312600;201312;774;2850;714;2709;219;941;277;976;496;1917
312610;201312;8456;27104;7276;24731;2731;10008;2049;6703;4780;16711
312620;201312;2039;5994;1562;5367;98;313;1297;4635;1395;4948
312630;201312;506;1741;464;1657;134;544;197;667;331;1211
312640;201312;578;1936;475;1709;114;468;196;663;310;1131
312650;201312;2315;7043;1671;5788;203;839;895;3043;1098;3882
312660;201312;1231;3507;1063;3286;199;739;671;2002;870;2741
312670;201312;5864;18628;5457;17971;1385;5280;2792;8859;4177;14139
312675;201312;1436;4655;1280;4329;256;922;674;2309;930;3231
312680;201312;1695;5278;1514;4962;255;966;897;2976;1152;3942
312690;201312;2400;6716;1995;6137;420;1513;1082;3193;1502;4706
312695;201312;890;3243;834;3153;152;583;547;2136;699;2719
312700;201312;2164;6448;1662;5464;335;1271;850;2731;1185;4002
312705;201312;1375;4185;1221;3973;196;673;830;2711;1026;3384
312707;201312;1750;5509;1447;4989;281;1144;747;2514;1028;3658
312710;201312;7932;23005;5973;19495;2337;8478;1359;4086;3696;12564
312720;201312;754;2585;681;2439;202;803;270;905;472;1708
312730;201312;1879;4791;1434;4297;216;768;915;2747;1131;3515
312733;201312;1752;4806;1349;4048;126;477;964;2762;1090;3239
312735;201312;874;2681;774;2524;293;1008;333;1090;626;2098
312737;201312;1030;2555;726;2130;247;761;267;836;514;1597
312738;201312;498;1645;401;1461;140;595;148;482;288;1077
312740;201312;498;1440;339;1229;124;496;92;336;216;832
312750;201312;1272;4735;1218;4622;346;1476;557;2074;903;3550
312760;201312;2392;7886;1902;6922;620;2501;441;1626;1061;4127
312770;201312;43983;124031;34526;109471;10475;36119;11045;34759;21520;70878
312780;201312;2728;9944;2458;9465;560;2354;1347;5307;1907;7661
312790;201312;362;985;231;755;70;247;61;187;131;434
312800;201312;5111;17756;4471;16387;1471;5832;1361;5070;2832;10902
312810;201312;2156;6770;1640;5876;580;2291;336;1114;916;3405
312820;201312;2116;6434;1948;6144;273;1026;1233;3746;1506;4772
312825;201312;1525;4246;1351;4029;150;482;1060;3148;1210;3630
312830;201312;2688;8813;1974;7340;583;2411;306;1111;889;3522
312840;201312;1131;3861;957;3520;239;1022;366;1253;605;2275
312850;201312;693;2302;599;2111;178;720;187;634;365;1354
312860;201312;1305;3822;1007;3367;355;1375;329;958;684;2333
312870;201312;5574;17985;4357;15628;1301;5308;1184;4041;2485;9349
312880;201312;1170;3599;977;3256;250;957;420;1320;670;2277
312890;201312;1548;4871;1243;4308;449;1759;417;1361;866;3120
312900;201312;1364;4681;1320;4612;381;1379;721;2565;1102;3944
312910;201312;1467;3490;1162;3079;332;1050;506;1222;838;2272
312920;201312;985;3304;870;3121;301;1206;346;1191;647;2397
312930;201312;2166;6600;1942;6264;447;1552;1005;3294;1452;4846
312940;201312;915;3131;818;2939;239;1004;255;851;494;1855
312950;201312;3442;10025;2821;9086;992;3492;1120;3567;2112;7059
312960;201312;1891;5882;1701;5624;226;753;1261;4272;1487;5025
312965;201312;1737;5747;1515;5335;355;1362;807;2899;1162;4261
312970;201312;1126;3947;1011;3785;423;1784;172;616;595;2400
312980;201312;20625;73782;19846;71855;7939;30680;6926;24302;14865;54982
312990;201312;397;1251;306;1082;116;460;92;308;208;768
313000;201312;508;1766;455;1661;146;648;141;438;287;1086
313005;201312;2596;8589;2308;8098;398;1538;1406;4939;1804;6477
313010;201312;3971;13579;3563;12844;1127;4465;1368;4666;2495;9131
313020;201312;1043;3619;945;3389;311;1265;298;933;609;2198
313030;201312;1555;4486;1260;4071;365;1353;624;1891;989;3244
313040;201312;956;3429;809;3000;208;850;207;733;415;1583
313050;201312;1846;6193;1545;5697;516;2095;525;1860;1041;3955
313055;201312;1469;5061;1375;4914;151;529;1035;3833;1186;4362
313060;201312;934;3333;875;3202;406;1536;145;523;551;2059
313065;201312;1891;6463;1762;6265;277;1140;1268;4443;1545;5583
313070;201312;1216;3684;1011;3294;267;1015;483;1482;750;2497
313080;201312;465;1492;380;1326;116;466;102;296;218;762
313090;201312;5174;16145;4865;15589;822;2873;3264;10570;4086;13443
313100;201312;1092;3603;1022;3499;174;667;708;2388;882;3055
313110;201312;1671;5094;1322;4424;341;1358;505;1547;846;2905
313115;201312;2845;10183;2711;9896;925;3759;1175;4039;2100;7798
313120;201312;3758;11161;3225;10352;1172;3964;1336;4351;2508;8315
313130;201312;25783;84014;23372;78859;7236;26953;8246;26286;15482;53239
313140;201312;721;1916;529;1608;50;188;337;1002;387;1190
313150;201312;1642;5222;1488;4950;660;2275;395;1371;1055;3646
313160;201312;1173;3601;1055;3412;232;883;614;1887;846;2770
313170;201312;9670;36108;8936;34226;3526;14048;1857;7148;5383;21196
313180;201312;2684;7206;2063;6376;678;2350;677;2012;1355;4362
313190;201312;3481;13114;3292;12620;979;4002;1234;4691;2213;8693
313200;201312;1491;4772;1329;4513;222;911;829;2796;1051;3707
313210;201312;4544;14681;3903;13798;989;3975;2004;6945;2993;10920
313220;201312;1233;3834;947;3208;244;941;237;714;481;1655
313230;201312;2518;9023;2368;8790;429;1672;1483;5725;1912;7397
313240;201312;7921;27662;6875;25625;2098;8533;2700;10054;4798;18587
313250;201312;7627;24377;6960;23287;1267;4326;4253;14670;5520;18996
313260;201312;601;1924;500;1721;146;578;136;439;282;1017
313270;201312;5481;16591;4964;15791;849;2846;3310;10681;4159;13527
313280;201312;513;1755;417;1489;95;388;97;312;192;700
313290;201312;1031;3759;857;3392;281;1197;208;761;489;1958
313300;201312;1941;6797;1678;6125;542;2142;370;1251;912;3393
313310;201312;1049;3761;957;3558;274;1162;212;732;486;1894
313320;201312;2372;7403;2012;6767;466;1677;833;2804;1299;4481
313330;201312;3846;12871;3462;12143;766;3078;1660;5753;2426;8831
313340;201312;2168;5357;1704;4689;370;1082;969;2612;1339;3694
313350;201312;3319;10525;2569;8793;685;2524;503;1544;1188;4068
313360;201312;1179;3658;903;3113;308;1258;369;1126;677;2384
313370;201312;1443;5116;1356;4865;301;1243;583;1929;884;3172
313375;201312;2014;5501;1378;4565;362;1442;523;1678;885;3120
313380;201312;6654;23226;5789;21276;2337;9223;1464;5076;3801;14299
313390;201312;905;3357;871;3298;141;626;562;2088;703;2714
313400;201312;3714;11118;3434;10775;438;1488;2631;8333;3069;9821
313410;201312;1348;3926;1154;3658;266;933;665;2096;931;3029
313420;201312;19071;48342;12350;36106;3141;10389;2952;8238;6093;18627
313430;201312;1305;4312;1173;4075;379;1475;406;1330;785;2805
313440;201312;6476;15943;4942;14150;789;2461;3446;9876;4235;12337
313450;201312;717;2179;585;1908;156;630;206;595;362;1225
313460;201312;2665;9611;2400;9100;878;3619;691;2496;1569;6115
313470;201312;3408;9720;3256;9545;386;1028;2661;8027;3047;9055
313480;201312;1143;3428;877;2947;177;682;381;1221;558;1903
313490;201312;1467;4991;1116;4357;467;1826;240;964;707;2790
313500;201312;446;1436;421;1386;89;343;257;820;346;1163
313505;201312;8749;26408;8270;25819;549;1349;7320;23635;7869;24984
313507;201312;1291;3938;1165;3741;253;938;654;2105;907;3043
313510;201312;15782;47911;14270;46002;2482;8368;9941;32772;12423;41140
313520;201312;15867;49142;13650;45428;2102;8172;8873;29323;10975;37495
313530;201312;531;1881;466;1726;75;317;196;688;271;1005
313535;201312;2510;7671;2252;7235;399;1368;1405;4576;1804;5944
313540;201312;1152;3680;927;3120;289;1039;236;728;525;1767
313545;201312;1368;5108;1217;4836;250;1188;728;2780;978;3968
313550;201312;1944;6785;1864;6610;532;2039;938;3210;1470;5249
313560;201312;2295;5798;2033;5492;246;648;1564;4397;1810;5045
313570;201312;800;2982;697;2770;277;1208;219;803;496;2011
313580;201312;6115;17766;5355;16726;746;2477;3909;12337;4655;14814
313590;201312;1062;3249;869;3021;349;1231;437;1573;786;2804
313600;201312;3819;11972;3393;11282;655;2413;1960;6606;2615;9019
313610;201312;1160;3689;1003;3371;282;1047;407;1338;689;2385
313620;201312;7436;25322;6997;24369;2428;8994;2310;7904;4738;16898
313630;201312;8399;26937;7369;25360;2369;8908;2524;9001;4893;17909
313640;201312;845;2739;743;2597;274;1024;281;983;555;2007
313650;201312;2284;7600;2037;7192;306;1122;1461;5278;1767;6400
313652;201312;1020;3709;933;3532;182;726;550;2106;732;2832
313655;201312;952;3256;804;3006;203;869;466;1685;669;2554
313657;201312;1156;3888;1065;3724;170;776;686;2166;856;2942
313660;201312;895;3148;824;3020;231;975;394;1372;625;2347
313665;201312;3029;10232;2815;9768;704;2778;1326;4426;2030;7204
313670;201312;51698;153679;37174;128578;12303;46568;11210;37614;23513;84182
313680;201312;1103;3361;979;3173;119;404;706;2317;825;2721
313690;201312;906;3335;836;3202;235;910;335;1340;570;2250
313695;201312;1481;4960;1280;4635;189;813;893;3200;1082;4013
313700;201312;3888;13133;3324;12360;529;2079;2329;8768;2858;10847
313710;201312;1383;3968;1173;3661;379;1299;547;1635;926;2934
313720;201312;5285;18085;4590;16567;1298;5219;1367;4441;2665;9660
313730;201312;1266;3558;1016;3239;149;516;665;2144;814;2660
313740;201312;2048;7563;1698;6615;618;2694;219;789;837;3483
313750;201312;2941;9189;2584;8482;838;3018;690;2071;1528;5089
313753;201312;1830;5689;1560;5204;488;1757;588;1988;1076;3745
313760;201312;4447;15125;3831;13802;1310;5204;1088;3744;2398;8948
313770;201312;3644;12472;3461;12045;1260;4662;980;3378;2240;8040
313780;201312;3884;11347;3154;10238;864;3196;1381;4336;2245;7532
313790;201312;552;1954;535;1925;116;444;308;1121;424;1565
313800;201312;1253;3637;1121;3423;187;661;688;2081;875;2742
313810;201312;1479;4633;1418;4541;242;801;962;3147;1204;3948
313820;201312;13037;39103;10896;35207;3233;11588;3939;12638;7172;24226
313830;201312;467;1641;400;1495;143;600;113;408;256;1008
313835;201312;1059;3615;1016;3545;236;903;556;1934;792;2837
313840;201312;7403;22950;6335;21166;1973;7389;2116;6763;4089;14152
313850;201312;1256;3592;1135;3379;263;909;612;1730;875;2639
313860;201312;2625;8372;2256;7570;703;2622;504;1526;1207;4148
313862;201312;1072;2995;768;2499;231;828;206;654;437;1482
313865;201312;2220;7183;2073;6927;339;1280;1403;4627;1742;5907
313867;201312;1037;3686;887;3367;317;1257;294;1130;611;2387
313868;201312;1545;5573;1391;5237;181;802;925;3478;1106;4280
313870;201312;916;2906;812;2731;234;915;333;1034;567;1949
313880;201312;2274;7411;2074;7123;493;2011;1060;3360;1553;5371
313890;201312;1998;5572;1709;5205;305;940;1087;3386;1392;4326
313900;201312;4653;17379;4343;16668;1697;7205;1158;4381;2855;11586
313910;201312;762;2645;650;2392;288;1155;114;378;402;1533
313920;201312;3644;11938;3338;11405;577;2006;2069;7388;2646;9394
313925;201312;2119;5753;1606;4814;136;476;1085;3228;1221;3704
313930;201312;5264;17693;4447;16249;848;3417;2564;9551;3412;12968
313940;201312;7257;25997;6437;24592;2330;9615;2422;9498;4752;19113
313950;201312;4765;14226;4019;12970;1312;4785;1323;4048;2635;8833
313960;201312;6042;16795;5045;15387;1736;5998;1276;3820;3012;9818
313970;201312;1490;4448;1252;4178;259;943;783;2622;1042;3565
313980;201312;1196;4086;1034;3779;328;1344;294;1028;622;2372
313990;201312;2001;7715;1783;7194;676;2947;439;1631;1115;4578
314000;201312;8082;28297;7488;27133;2229;8948;3820;13556;6049;22504
314010;201312;1062;3187;890;2967;181;710;463;1477;644;2187
314015;201312;1594;6066;1470;5776;543;2242;419;1676;962;3918
314020;201312;490;1618;415;1444;146;562;118;377;264;939
314030;201312;830;2730;660;2332;136;550;225;747;361;1297
314040;201312;644;1934;565;1788;195;667;273;824;468;1491
314050;201312;1911;6371;1595;5691;502;1999;451;1479;953;3478
314053;201312;1433;4939;1370;4857;245;846;952;3507;1197;4353
314055;201312;2230;6760;1995;6432;213;703;1488;4913;1701;5616
314060;201312;1079;3555;944;3306;145;605;578;1983;723;2588
314070;201312;3664;12033;2954;10522;924;3593;776;2627;1700;6220
314080;201312;1884;5947;1359;4805;290;1142;327;1057;617;2199
314085;201312;1843;6618;1607;6279;544;2342;564;2205;1108;4547
314090;201312;3483;12154;3176;11551;1058;4174;1174;4355;2232;8529
314100;201312;3488;9608;3058;8987;392;1177;2309;6908;2701;8085
314110;201312;4436;14926;3890;13733;1033;4171;1421;4616;2454;8787
314120;201312;1033;2579;580;1852;199;733;145;427;344;1160
314130;201312;679;1990;420;1403;101;371;85;254;186;625
314140;201312;5036;16099;4506;15074;1083;3920;2169;7327;3252;11247
314150;201312;1719;4662;1353;4099;245;829;772;2320;1017;3149
314160;201312;2388;6561;1988;6022;167;553;1624;4983;1791;5536
314170;201312;1064;3390;904;3042;178;713;467;1484;645;2197
314180;201312;6452;21092;5808;20119;1673;6360;2590;9117;4263;15477
314190;201312;813;2632;722;2476;234;917;271;890;505;1807
314200;201312;3051;10081;2767;9565;455;1805;1822;6207;2277;8012
314210;201312;1951;6254;1751;5864;437;1580;843;2740;1280;4320
314220;201312;1739;5796;1461;5179;505;1982;347;1057;852;3039
314225;201312;1173;3698;1061;3541;72;187;941;3229;1013;3416
314230;201312;700;2474;650;2371;207;837;219;750;426;1587
314240;201312;1128;3666;1011;3477;256;871;602;2147;858;3018
314250;201312;514;1600;414;1384;133;506;142;431;275;937
314260;201312;1302;4782;1244;4650;413;1649;474;1773;887;3422
314270;201312;2716;9574;2550;9273;332;1355;1734;6329;2066;7684
314280;201312;3236;9496;2378;7854;753;2860;632;1841;1385;4701
314290;201312;5407;15490;4637;14251;682;2260;3208;9903;3890;12163
314300;201312;1940;6664;1806;6348;641;2411;659;2239;1300;4650
314310;201312;6524;21328;5737;19637;2354;8601;1347;4433;3701;13034
314315;201312;974;3755;903;3612;162;736;529;2131;691;2867
314320;201312;3320;10382;2757;9583;974;3717;997;3392;1971;7109
314330;201312;53245;176073;50372;170825;16272;60059;22091;73808;38363;133867
314340;201312;2469;7150;1383;4775;373;1452;162;379;535;1831
314345;201312;1284;4456;1150;4245;364;1412;555;2123;919;3535
314350;201312;1411;4230;1145;3781;468;1689;289;942;757;2631
314360;201312;695;2257;514;1878;151;652;122;414;273;1066
314370;201312;564;2023;527;1973;171;697;262;972;433;1669
314380;201312;1083;3421;832;2970;338;1279;226;818;564;2097
314390;201312;15260;47408;12685;42293;4235;15363;3571;11483;7806;26846
314400;201312;5452;15680;4463;14291;1379;4427;2425;8123;3804;12550
314410;201312;2493;8350;2218;7775;749;2935;799;2629;1548;5564
314420;201312;766;2281;631;2091;95;391;469;1528;564;1919
314430;201312;8096;24647;7267;23113;2520;8753;2243;7251;4763;16004
314435;201312;1187;4025;1071;3790;182;790;652;2220;834;3010
314437;201312;1188;3135;1056;2946;101;284;829;2334;930;2618
314440;201312;750;2100;524;1789;197;745;107;340;304;1085
314450;201312;1739;5260;1504;4923;512;1937;628;1891;1140;3828
314460;201312;4605;16281;4101;15134;1442;5804;770;2818;2212;8622
314465;201312;2367;7767;2176;7408;230;955;1626;5435;1856;6390
314467;201312;1082;3173;953;2957;241;753;522;1666;763;2419
314470;201312;2386;7961;1859;6687;565;2349;413;1236;978;3585
314480;201312;7231;25451;5330;20147;1353;5495;536;1814;1889;7309
314490;201312;948;2963;806;2683;239;930;340;1053;579;1983
314500;201312;2784;8100;2269;7097;719;2508;771;2386;1490;4894
314505;201312;1778;5614;1680;5433;392;1411;952;3056;1344;4467
314510;201312;1735;5299;1349;4643;521;1936;349;1164;870;3100
314520;201312;3805;14809;3121;12944;1121;5080;558;2087;1679;7167
314530;201312;7210;26026;6630;25077;1242;4923;4003;15652;5245;20575
314535;201312;2749;8015;2424;7584;387;1321;1611;5091;1998;6412
314537;201312;1421;4430;1199;4033;278;1077;568;1949;846;3026
314540;201312;463;1449;404;1312;123;462;122;360;245;822
314545;201312;1358;4432;1214;4206;279;1051;632;2180;911;3231
314550;201312;519;1666;441;1551;153;626;118;390;271;1016
314560;201312;5303;19197;4606;17333;1287;5332;1114;4062;2401;9394
314570;201312;371;1178;332;1098;101;364;152;478;253;842
314580;201312;459;1621;393;1485;150;638;96;348;246;986
314585;201312;653;2368;545;2144;174;744;144;558;318;1302
314587;201312;1715;5631;1559;5333;289;1043;860;2949;1149;3992
314590;201312;4197;14825;3086;11736;770;3158;390;1350;1160;4508
314600;201312;2111;7373;1760;6733;693;2953;322;1129;1015;4082
314610;201312;8272;30108;7755;28829;2571;10357;2462;8831;5033;19188
314620;201312;1732;5259;1563;5052;232;750;1159;3862;1391;4612
314625;201312;1549;5134;1510;5085;225;827;1077;3678;1302;4505
314630;201312;5108;15454;4468;14390;676;2417;2999;9818;3675;12235
314640;201312;836;2445;710;2214;250;853;190;544;440;1397
314650;201312;1269;3963;1021;3475;277;1089;422;1296;699;2385
314655;201312;1698;5124;1320;4420;276;969;662;2219;938;3188
314660;201312;200;563;159;483;25;90;95;277;120;367
314670;201312;1460;4171;1197;3708;229;790;654;1995;883;2785
314675;201312;1865;5809;1659;5433;223;832;1079;3566;1302;4398
314690;201312;2724;8852;2311;8077;746;2977;674;2168;1420;5145
314700;201312;9981;38553;9020;36452;4190;17733;1959;8208;6149;25941
314710;201312;8311;27257;5840;21503;1461;6027;731;2483;2192;8510
314720;201312;2660;9094;2238;8229;711;2888;882;3174;1593;6062
314730;201312;2446;7774;2089;7235;761;2955;636;2077;1397;5032
314740;201312;2958;10276;2741;9850;915;3584;996;3428;1911;7012
314750;201312;329;1107;299;1038;68;288;141;462;209;750
314760;201312;1825;6563;1381;5367;336;1507;259;822;595;2329
314770;201312;1201;3879;768;2694;107;447;108;301;215;748
314780;201312;305;856;230;750;89;331;84;254;173;585
314790;201312;13383;41929;10319;36293;4166;16673;2376;7686;6542;24359
314795;201312;1525;4730;1355;4454;155;685;1015;3172;1170;3857
314800;201312;17095;53347;14226;47508;5891;20683;2781;9441;8672;30124
314810;201312;12865;39600;10082;34384;3323;12736;2426;8142;5749;20878
314820;201312;1099;3146;777;2666;295;1118;237;740;532;1858
314830;201312;1662;5811;1455;5394;558;2263;501;1852;1059;4115
314840;201312;1132;4034;906;3690;185;877;532;2165;717;3042
314850;201312;2215;6552;1878;5989;394;1459;1015;3170;1409;4629
314860;201312;3275;11477;3027;11060;614;2508;1821;6645;2435;9153
314870;201312;5681;18793;5116;18008;848;3385;3487;12433;4335;15818
314875;201312;1684;5885;1647;5834;316;1090;1225;4440;1541;5530
314880;201312;803;2437;716;2278;83;287;502;1593;585;1880
314890;201312;599;1903;445;1587;140;559;108;325;248;884
314900;201312;407;1316;330;1177;109;408;139;487;248;895
314910;201312;1686;6025;1482;5647;602;2490;310;1118;912;3608
314915;201312;2494;8001;2218;7602;235;945;1769;6047;2004;6992
314920;201312;654;1936;494;1692;104;406;223;714;327;1120
314930;201312;5129;17847;4487;16376;1523;6049;982;3532;2505;9581
314940;201312;405;1228;381;1183;95;307;188;572;283;879
314950;201312;371;1330;327;1232;98;417;73;251;171;668
314960;201312;784;2637;659;2371;207;809;168;577;375;1386
314970;201312;862;3138;772;2933;313;1300;179;634;492;1934
314980;201312;2226;6933;2017;6579;841;2935;291;899;1132;3834
314990;201312;3112;10243;2527;8897;951;3639;423;1333;1374;4972
314995;201312;1537;4944;1411;4765;267;1077;910;2957;1177;4034
315000;201312;1006;3104;863;2897;159;636;536;1759;695;2395
315010;201312;491;1601;402;1406;132;537;135;414;267;951
315015;201312;1864;5899;1732;5741;349;1237;1178;4022;1527;5259
315020;201312;741;2482;667;2343;198;791;258;806;456;1597
315030;201312;1006;3150;873;2902;348;1263;176;570;524;1833
315040;201312;936;2946;858;2811;168;578;537;1744;705;2322
315050;201312;1601;4902;1339;4435;474;1736;414;1310;888;3046
315053;201312;1139;3445;983;3191;265;1035;373;1129;638;2164
315057;201312;1908;6573;1570;6062;253;1004;986;3946;1239;4950
315060;201312;937;3248;783;2840;246;974;192;721;438;1695
315070;201312;675;2088;625;2011;164;585;349;1086;513;1671
315080;201312;3490;12198;3158;11483;863;3393;1398;5079;2261;8472
315090;201312;754;2768;672;2600;195;822;221;896;416;1718
315100;201312;1177;4120;949;3596;278;1170;246;880;524;2050
315110;201312;1651;5119;1452;4775;439;1553;587;1901;1026;3454
315120;201312;13754;33906;9979;29001;1990;6325;5205;15932;7195;22257
315130;201312;1813;6124;1632;5746;597;2310;441;1505;1038;3815
315140;201312;2403;8257;1990;7298;599;2525;564;1806;1163;4331
315150;201312;4701;13295;3567;11208;911;3297;1322;3986;2233;7283
315160;201312;1366;3960;1238;3784;256;873;710;2133;966;3006
315170;201312;1350;4155;1174;3907;281;1033;650;2224;931;3257
315180;201312;13520;43042;10595;36647;3132;12294;2587;8485;5719;20779
315190;201312;2374;6464;1935;5815;629;2026;830;2506;1459;4532
315200;201312;4472;15354;3718;13639;1204;4848;974;3435;2178;8283
315210;201312;8475;26783;7338;24638;2773;10052;2214;7220;4987;17272
315213;201312;1127;3696;1087;3634;100;309;914;3145;1014;3454
315217;201312;2713;9337;2281;8568;396;1681;1313;4963;1709;6644
315220;201312;10077;30387;8991;28918;1832;6052;5605;18476;7437;24528
315230;201312;2426;6676;2258;6478;138;375;1976;5754;2114;6129
315240;201312;3258;10785;2980;10299;619;2353;1744;6015;2363;8368
315250;201312;8988;29730;6963;25876;2456;10179;2117;7760;4573;17939
315260;201312;1065;3614;907;3245;359;1411;143;453;502;1864
315270;201312;870;3153;754;2899;250;1026;164;601;414;1627
315280;201312;3939;12293;3158;10506;1141;4036;744;2311;1885;6347
315290;201312;1259;3659;976;3198;381;1378;160;528;541;1906
315300;201312;496;1479;403;1359;212;763;109;333;321;1096
315310;201312;1214;4148;1105;3959;154;625;740;2628;894;3253
315320;201312;824;2815;708;2641;239;958;310;1185;549;2143
315330;201312;815;2989;665;2656;285;1272;102;382;387;1654
315340;201312;4200;12421;3596;11462;933;3243;1696;5445;2629;8688
315350;201312;1852;5363;1529;4917;200;608;1141;3814;1341;4422
315360;201312;1679;5774;1362;4902;341;1309;432;1467;773;2776
315370;201312;619;1891;545;1777;132;492;293;927;425;1419
315380;201312;280;1015;254;935;86;344;48;155;134;499
315390;201312;1949;7041;1685;6399;612;2505;373;1381;985;3886
315400;201312;4424;14169;4034;13389;1151;4107;1867;6253;3018;10360
315410;201312;1706;4869;1447;4437;325;1208;776;2268;1101;3476
315415;201312;1120;3839;1035;3698;476;1743;364;1353;840;3096
315420;201312;1518;4863;1137;4124;344;1319;207;733;551;2052
315430;201312;4009;11191;3047;9534;805;2866;968;2919;1773;5785
315440;201312;964;3009;866;2848;173;656;483;1579;656;2235
315445;201312;2150;6293;1831;5864;310;1138;1190;3781;1500;4919
315450;201312;2500;8087;2353;7869;474;1604;1534;5288;2008;6892
315460;201312;38803;132222;34571;122976;11782;45332;8866;30514;20648;75846
315470;201312;535;1722;486;1630;93;344;283;920;376;1264
315480;201312;1360;4372;970;3507;220;887;229;771;449;1658
315490;201312;3242;9412;2819;8813;540;2013;1622;4894;2162;6907
315500;201312;454;1484;304;1098;68;292;125;389;193;681
315510;201312;1461;4306;1264;3972;179;637;798;2483;977;3120
315520;201312;1152;3657;969;3401;173;695;585;1982;758;2677
315530;201312;488;1755;462;1712;229;888;132;466;361;1354
315540;201312;1276;3940;1012;3488;222;945;364;1217;586;2162
315550;201312;1671;5062;1450;4764;493;1794;591;1904;1084;3698
315560;201312;7115;23945;6552;23164;975;3860;4488;15875;5463;19735
315570;201312;2384;7613;2229;7374;487;1840;1303;4227;1790;6067
315580;201312;2685;8483;2198;7547;641;2605;798;2526;1439;5131
315590;201312;873;2596;805;2493;122;453;559;1696;681;2149
315600;201312;2590;9482;2166;8777;353;1550;1346;5677;1699;7227
315610;201312;981;2996;843;2694;208;796;295;784;503;1580
315620;201312;338;1215;330;1197;105;395;150;555;255;950
315630;201312;992;3244;853;3005;242;900;228;790;470;1690
315640;201312;732;2377;639;2179;230;898;188;583;418;1481
315645;201312;833;2737;731;2480;297;1108;154;495;451;1603
315650;201312;1800;5540;1682;5376;164;677;1287;4002;1451;4679
315660;201312;2662;7402;2419;7053;440;1404;1493;4329;1933;5733
315670;201312;11525;41948;10602;40048;4039;16418;3175;11719;7214;28137
315680;201312;2843;10167;2351;9192;915;3742;580;2387;1495;6129
315690;201312;3154;10346;2634;9381;963;3771;707;2505;1670;6276
315700;201312;7232;23626;6281;21647;1444;5720;3014;9905;4458;15625
315710;201312;1813;5489;1490;4975;237;933;855;2814;1092;3747
315720;201312;2953;9878;2681;9335;893;3530;960;3089;1853;6619
315725;201312;1628;5089;1318;4683;432;1560;630;2300;1062;3860
315727;201312;654;2123;590;1987;142;518;284;944;426;1462
315730;201312;985;3116;893;2925;212;741;470;1562;682;2303
315733;201312;1144;3759;1053;3558;473;1678;309;1021;782;2699
315737;201312;1360;4251;1155;3896;142;542;722;2461;864;3003
315740;201312;1025;3376;892;3110;267;1071;375;1198;642;2269
315750;201312;1128;3568;1018;3414;109;463;745;2424;854;2887
315760;201312;930;2673;910;2644;24;67;866;2532;890;2599
315765;201312;1446;4605;1350;4446;178;627;1001;3334;1179;3961
315770;201312;1661;5432;1514;5110;474;1731;531;1734;1005;3465
315780;201312;23354;78449;21648;74707;7551;27912;6519;22591;14070;50503
315790;201312;3154;11113;2880;10501;342;1225;1922;7263;2264;8488
315800;201312;1529;6069;1274;5302;411;1873;234;928;645;2801
315810;201312;1469;4315;1260;3975;274;913;733;2258;1007;3171
315820;201312;3055;10253;2631;9623;709;2740;1369;5130;2078;7870
315830;201312;1471;5060;1342;4768;344;1399;424;1434;768;2833
315840;201312;706;1991;554;1697;111;379;169;478;280;857
315850;201312;1337;4846;1292;4743;400;1535;506;1825;906;3360
315860;201312;424;1595;358;1443;120;546;76;306;196;852
315870;201312;466;1427;399;1319;117;433;131;393;248;826
315880;201312;1084;3039;908;2815;281;995;398;1191;679;2186
315890;201312;1642;5736;1495;5506;455;1729;741;2858;1196;4587
315895;201312;5078;16231;4718;15534;1468;5327;1997;6386;3465;11713
315900;201312;763;2509;709;2413;192;768;366;1140;558;1908
315910;201312;604;2204;558;2109;225;881;222;823;447;1704
315920;201312;1418;4328;1045;3516;307;1149;319;977;626;2126
315930;201312;1106;3187;919;2843;292;979;293;870;585;1849
315935;201312;1159;3965;1080;3785;337;1287;335;1134;672;2421
315940;201312;636;2113;584;2019;172;668;265;887;437;1555
315950;201312;1219;3866;1141;3712;344;1142;623;2066;967;3208
315960;201312;2883;10078;2320;8890;1077;4711;192;646;1269;5357
315970;201312;807;2323;656;2099;82;262;485;1605;567;1867
315980;201312;4038;10449;2862;8382;812;2708;865;2206;1677;4914
315990;201312;4326;13245;3830;12446;903;3459;2020;6388;2923;9847
316000;201312;574;1919;502;1789;233;907;135;458;368;1365
316010;201312;450;1678;401;1559;115;519;92;300;207;819
316020;201312;1187;3832;945;3398;185;754;510;1836;695;2590
316030;201312;3624;10500;2644;8887;397;1487;1439;4942;1836;6429
316040;201312;3429;10952;2437;8582;431;1725;299;814;730;2539
316045;201312;2078;6909;1936;6676;284;895;1359;4992;1643;5887
316050;201312;366;1209;321;1136;86;327;149;519;235;846
316060;201312;776;2407;641;2214;124;531;371;1212;495;1743
316070;201312;6022;20508;5590;19600;1866;7209;2320;7764;4186;14973
316080;201312;735;2802;647;2540;164;713;133;529;297;1242
316090;201312;609;1845;455;1512;117;455;122;363;239;818
316095;201312;1285;4342;1170;4116;350;1297;650;2315;1000;3612
316100;201312;2709;9327;2128;7784;616;2530;415;1409;1031;3939
316105;201312;939;2701;713;2329;174;623;310;1045;484;1668
316110;201312;12323;44276;11189;42119;1534;6539;7842;30044;9376;36583
316120;201312;1273;4516;1196;4340;400;1511;473;1724;873;3235
316130;201312;1124;2832;868;2456;198;653;438;1226;636;1879
316140;201312;1063;3219;829;2821;146;543;479;1662;625;2205
316150;201312;1260;4039;1202;3945;318;1219;625;1969;943;3188
316160;201312;1229;3743;991;3268;145;547;544;1791;689;2338
316165;201312;931;2653;795;2433;164;580;443;1316;607;1896
316170;201312;1403;4162;1051;3509;237;921;410;1267;647;2188
316180;201312;1216;3992;996;3554;305;1264;287;947;592;2211
316190;201312;2673;8371;1392;4973;291;1104;239;737;530;1841
316200;201312;3878;12877;3054;11216;926;3929;857;2984;1783;6913
316210;201312;4984;16542;4621;15780;2142;7836;941;3195;3083;11031
316220;201312;657;2062;476;1735;138;570;65;247;203;817
316225;201312;1081;3249;956;3075;147;553;636;1985;783;2538
316230;201312;445;1380;367;1235;77;283;191;649;268;932
316240;201312;6230;20093;5450;19063;708;2528;4081;14510;4789;17038
316245;201312;3017;10882;2845;10592;292;1343;2168;8003;2460;9346
316250;201312;8987;28996;7938;26782;3294;11937;2047;6502;5341;18439
316255;201312;2343;7649;2092;7351;345;1159;1471;5318;1816;6477
316257;201312;1340;3882;1048;3359;288;1047;371;1094;659;2141
316260;201312;1795;5274;1391;4694;352;1311;722;2437;1074;3748
316265;201312;1181;3492;1041;3204;100;354;736;2236;836;2590
316270;201312;5129;16890;4788;16173;1473;5416;1972;6702;3445;12118
316280;201312;3265;11128;2944;10475;639;2539;1508;5346;2147;7885
316290;201312;3126;10631;2897;10179;770;3071;1271;4210;2041;7281
316292;201312;3750;12723;3455;12134;1070;4189;1413;4677;2483;8866
316294;201312;792;2663;504;1937;129;584;71;248;200;832
316295;201312;1944;7015;1820;6746;464;1988;919;3179;1383;5167
316300;201312;955;3041;835;2826;94;336;561;1953;655;2289
316310;201312;692;2225;530;1877;131;521;183;635;314;1156
316320;201312;566;1946;503;1856;147;610;120;423;267;1033
316330;201312;971;2983;815;2696;150;494;456;1551;606;2045
316340;201312;1146;3806;1018;3545;355;1392;266;834;621;2226
316350;201312;1475;4940;1341;4708;282;1020;737;2745;1019;3765
316360;201312;769;2046;610;1832;83;262;443;1341;526;1603
316370;201312;5048;16972;4489;15810;1566;5924;1013;3625;2579;9549
316380;201312;1437;4128;1182;3740;139;496;817;2593;956;3089
316390;201312;907;2799;765;2551;275;1005;291;974;566;1979
316400;201312;1469;5020;1299;4687;358;1417;511;1856;869;3273
316410;201312;1212;4139;1133;4012;251;995;654;2282;905;3277
316420;201312;2004;6926;1858;6724;303;1230;1185;4359;1488;5589
316430;201312;911;2858;781;2633;255;950;276;885;531;1835
316440;201312;610;2092;538;1995;237;998;188;649;425;1647
316443;201312;690;2150;584;1934;152;555;212;677;364;1232
316447;201312;1342;4542;1281;4433;176;688;1006;3448;1182;4136
316450;201312;2201;7852;1958;7347;489;1877;1072;4167;1561;6044
316460;201312;857;2787;804;2696;224;854;438;1380;662;2234
316470;201312;7995;26846;6276;22843;2135;8817;1796;6121;3931;14938
316480;201312;255;897;227;839;65;253;73;259;138;512
316490;201312;364;1197;345;1151;117;416;142;463;259;879
316500;201312;1060;3944;739;2940;203;878;48;173;251;1051
316510;201312;949;3489;855;3295;359;1442;253;976;612;2418
316520;201312;1195;3802;992;3474;286;1173;370;1174;656;2347
316530;201312;1177;3875;990;3465;271;1149;388;1159;659;2308
316540;201312;1015;3381;913;3198;271;1122;313;988;584;2110
316550;201312;1256;4382;1158;4222;257;1060;720;2603;977;3663
316553;201312;2261;8471;1908;7566;679;2884;406;1553;1085;4437
316555;201312;2763;9924;2487;9597;242;944;1982;7815;2224;8759
316556;201312;587;1714;485;1515;52;202;322;957;374;1159
316557;201312;728;2725;703;2682;292;1156;258;986;550;2142
316560;201312;371;1272;306;1117;82;359;79;250;161;609
316570;201312;1409;4569;1264;4257;260;949;650;2179;910;3128
316580;201312;282;843;229;749;72;261;69;203;141;464
316590;201312;1353;4113;1139;3719;221;867;634;1984;855;2851
316600;201312;1173;3913;1062;3681;187;710;631;2140;818;2850
316610;201312;608;2288;568;2213;145;649;319;1213;464;1862
316620;201312;2148;7046;1922;6576;501;1895;873;2950;1374;4845
316630;201312;1516;5164;1346;4799;586;2181;376;1362;962;3543
316640;201312;261;873;235;821;68;279;93;295;161;574
316650;201312;927;3685;828;3506;207;896;441;1965;648;2861
316660;201312;137;424;119;393;33;138;44;122;77;260
316670;201312;1827;5524;1479;4806;564;2093;308;843;872;2936
316680;201312;1938;5943;1712;5583;233;788;1295;4296;1528;5084
316690;201312;1130;3935;1023;3731;393;1608;322;1117;715;2725
316695;201312;1251;3943;1114;3699;113;371;744;2585;857;2956
316700;201312;352;1205;326;1138;80;323;155;503;235;826
316710;201312;3408;13248;2984;12273;1066;4577;892;3882;1958;8459
316720;201312;20105;69250;17297;62793;6414;24565;4336;15557;10750;40122
316730;201312;427;1390;374;1275;101;387;182;567;283;954
316740;201312;749;2641;679;2501;275;1107;178;613;453;1720
316750;201312;415;1487;380;1408;109;463;125;424;234;887
316760;201312;3604;12375;3092;11794;1833;7094;806;3261;2639;10355
316770;201312;1476;4477;1317;4256;228;821;867;2870;1095;3691
316780;201312;699;2463;654;2375;264;1029;171;592;435;1621
316790;201312;843;2526;631;2155;181;712;224;727;405;1439
316800;201312;5857;19874;5335;18861;1182;4874;2725;9201;3907;14075
316805;201312;887;2405;842;2348;143;381;622;1795;765;2176
316810;201312;539;1721;492;1627;137;505;230;732;367;1237
316820;201312;392;1137;266;922;111;419;42;136;153;555
316830;201312;590;2165;570;2124;216;864;204;731;420;1595
316840;201312;3082;9488;2675;8710;803;2960;1049;3228;1852;6188
316850;201312;2109;6819;1951;6530;460;1718;1027;3388;1487;5106
316860;201312;23979;75891;21774;71693;6310;23147;9436;30703;15746;53850
316870;201312;7035;24079;6198;22007;2378;9075;1316;4552;3694;13627
316880;201312;882;3063;850;3007;361;1405;241;802;602;2207
316890;201312;1434;3799;1139;3392;498;1637;387;1101;885;2738
316900;201312;2698;8700;2371;8029;766;2905;733;2241;1499;5146
316905;201312;436;1563;403;1484;177;691;110;384;287;1075
316910;201312;699;2455;574;2178;148;591;216;837;364;1428
316920;201312;1523;4732;1239;4264;205;782;626;2135;831;2917
316930;201312;9464;33361;8300;30874;2630;11042;2073;7308;4703;18350
316935;201312;4792;14670;3591;12527;1271;4922;854;2805;2125;7727
316940;201312;6952;23966;5895;21644;1586;6432;1657;5879;3243;12311
316950;201312;1500;4538;1325;4298;223;851;864;2754;1087;3605
316960;201312;5234;14026;4440;12968;1019;3261;2533;7348;3552;10609
316970;201312;3496;11756;3315;11421;1400;5402;832;2610;2232;8012
316980;201312;932;3009;763;2727;385;1461;188;673;573;2134
316990;201312;9851;33669;8956;31605;3778;14408;1277;4297;5055;18705
317000;201312;2565;9467;2490;9371;284;853;2045;8159;2329;9012
317005;201312;2375;7927;2282;7801;409;1439;1635;5665;2044;7104
317010;201312;29319;82010;19800;65294;5935;21757;4887;16640;10822;38397
317020;201312;47637;144306;32723;112197;8847;33435;7790;24962;16637;58397
317030;201312;875;2519;737;2311;133;508;415;1278;548;1786
317040;201312;12814;40074;11478;37531;4332;14888;4144;13748;8476;28636
317043;201312;814;2384;684;2203;196;679;345;1112;541;1791
317047;201312;1135;3123;895;2711;161;554;428;1281;589;1835
317050;201312;1820;6685;1597;6146;492;2065;520;1912;1012;3977
317052;201312;2403;7920;2150;7535;292;1105;1562;5543;1854;6648
317057;201312;1759;5216;1390;4569;243;957;691;2225;934;3182
317060;201312;384;1165;293;956;82;308;107;320;189;628
317065;201312;1210;4113;1096;3921;167;672;783;2789;950;3461
317070;201312;9434;32046;7462;27506;2394;9692;1675;6229;4069;15921
317075;201312;1252;3983;1092;3685;400;1474;351;1120;751;2594
317080;201312;6907;20451;6367;19544;2103;7022;2359;7251;4462;14273
317090;201312;4806;16778;4509;16226;774;2902;2970;10892;3744;13794
317100;201312;3260;9829;2828;9088;984;3535;1126;3407;2110;6942
317103;201312;1977;7045;1684;6403;372;1733;753;2778;1125;4511
317107;201312;1315;4208;1149;3873;279;1066;553;1778;832;2844
317110;201312;744;2106;526;1680;151;581;195;554;346;1135
317115;201312;1065;3480;948;3224;148;531;610;2078;758;2609
317120;201312;13154;45536;11391;41311;3984;15372;3982;14214;7966;29586
317130;201312;8852;28956;8029;27414;2287;8790;3411;11266;5698;20056
317140;201312;656;2311;615;2225;83;330;391;1416;474;1746
317150;201312;1033;2876;878;2694;116;427;629;1901;745;2328
317160;201312;3804;10448;2912;9300;444;1679;1892;5934;2336;7613
317170;201312;1908;5858;1802;5646;266;976;1074;3212;1340;4188
317180;201312;1788;6250;1436;5428;423;1745;437;1616;860;3361
317190;201312;1257;3908;1154;3767;102;382;926;3016;1028;3398
317200;201312;4399;15092;4078;14360;1451;5562;1019;3424;2470;8986
317210;201312;1072;3448;920;3199;280;1096;403;1379;683;2475
317220;201312;351;1272;341;1259;128;478;165;631;293;1109
320010;201312;5902;18831;5223;17235;938;3393;2682;8774;3620;12167
320013;201312;1966;5902;1462;4998;215;786;841;2948;1056;3734
320016;201312;3437;9835;2970;9170;538;1684;1988;6244;2526;7928
320020;201312;4217;13949;3874;13174;1361;4932;1400;4748;2761;9680
320030;201312;1730;5770;1556;5364;473;1762;623;2087;1096;3849
320035;201312;1682;5430;1527;5144;543;1984;501;1654;1044;3638
320040;201312;3094;10655;2596;9435;700;2762;772;2720;1472;5482
320050;201312;1910;5398;1627;4833;318;1058;893;2585;1211;3643
320060;201312;10870;34976;8634;29731;2284;8713;3029;9836;5313;18549
320070;201312;1817;6210;1593;5663;522;1994;407;1335;929;3329
320080;201312;5461;16564;4446;14474;1410;4962;1444;4609;2854;9571
320090;201312;8460;24933;7047;22281;2106;7182;3088;9445;5194;16627
320100;201312;3244;9916;2681;8768;665;2343;1230;3930;1895;6273
320110;201312;1548;4804;1413;4527;393;1355;467;1459;860;2814
320115;201312;1864;6920;1795;6761;690;2664;833;3200;1523;5864
320120;201312;16981;59029;15194;55419;5689;22087;4209;15402;9898;37489
320130;201312;39725;135376;37243;129963;11607;43874;16379;55687;27986;99561
320140;201312;4094;13542;2886;10447;748;2984;324;1094;1072;4078
320150;201312;17937;52114;13364;43080;4376;15137;2224;7013;6600;22150
320160;201312;5323;16737;4652;15587;1288;4863;2029;6352;3317;11215
320170;201312;1901;6386;1729;6000;605;2165;552;1967;1157;4132
320180;201312;911;3044;819;2898;306;1140;303;1068;609;2208
320190;201312;4295;15827;3925;14803;1444;5688;1100;4096;2544;9784
320200;201312;1128;3771;1010;3517;318;1198;421;1469;739;2667
320210;201312;6007;16734;5213;15365;1289;4293;2660;7585;3949;11878
320220;201312;2842;8852;2235;7748;690;2610;791;2752;1481;5362
320225;201312;1455;5255;1274;4757;464;1842;267;1018;731;2860
320230;201312;4260;14490;3973;13921;1355;5149;1380;4933;2735;10082
320240;201312;9110;28601;7279;24895;2306;8392;1863;6509;4169;14901
320245;201312;4177;14515;3913;13875;1277;4779;1545;5434;2822;10213
320250;201312;1748;5557;1323;4540;353;1340;292;919;645;2259
320255;201312;2019;6865;1750;6391;726;2838;590;2213;1316;5051
320260;201312;1204;3858;968;3225;272;1008;369;1090;641;2098
320265;201312;2501;7805;2119;7329;285;1032;1536;5467;1821;6499
320270;201312;2387;7765;2057;7088;546;2013;945;3236;1491;5249
320280;201312;7225;22206;6645;21221;1390;4830;3783;12081;5173;16911
320290;201312;1531;5338;1386;4921;539;1994;348;1155;887;3149
320300;201312;4364;14995;4047;14301;1260;4738;1566;5521;2826;10259
320305;201312;4721;15813;4321;14861;1137;4321;1945;6491;3082;10812
320310;201312;1982;6134;1781;5772;452;1593;797;2473;1249;4066
320313;201312;2283;7086;1685;5677;493;1916;289;859;782;2775
320316;201312;2229;7124;2105;6830;609;2087;929;2985;1538;5072
320320;201312;18517;61288;16221;56672;5049;19632;6414;21719;11463;41351
320330;201312;2876;9046;2548;8442;582;1931;1418;4867;2000;6798
320332;201312;4908;16999;4484;16203;1524;5801;1804;6689;3328;12490
320334;201312;1461;5199;1201;4544;420;1763;231;789;651;2552
320335;201312;2166;6648;1626;5452;583;2157;296;928;879;3085
320340;201312;5689;16544;4603;14616;1184;4187;2059;6416;3243;10603
320350;201312;5517;14438;4113;12068;880;2933;1919;5479;2799;8412
320360;201312;1765;4809;1352;4042;272;916;660;1854;932;2770
320370;201312;3447;11642;3004;10732;939;3503;1152;4125;2091;7628
320380;201312;2739;8640;2441;8038;609;2136;1203;3875;1812;6011
320390;201312;8185;25378;6912;22801;2105;7724;2398;7600;4503;15324
320400;201312;4145;12114;3525;11220;778;2795;2052;6328;2830;9123
320405;201312;4155;12542;3828;12101;1183;4189;2054;6290;3237;10479
320410;201312;6085;15481;4554;13715;774;2425;3089;9432;3863;11857
320420;201312;2291;7288;1803;6511;790;3067;291;997;1081;4064
320425;201312;2452;6356;2014;5724;333;1143;1216;3394;1549;4537
320430;201312;2339;7064;2109;6604;429;1486;1078;3296;1507;4782
320435;201312;2194;7862;2003;7403;946;3628;632;2373;1578;6001
320440;201312;1488;5122;1332;4654;437;1648;390;1280;827;2928
320450;201312;2473;8157;2166;7489;657;2487;906;3029;1563;5516
320455;201312;4646;16806;3751;14505;1204;4852;728;2746;1932;7598
320460;201312;2918;9876;2434;8799;801;3118;739;2545;1540;5663
320465;201312;1525;5058;1262;4371;286;1046;492;1666;778;2712
320470;201312;4227;13490;3189;11128;1072;4100;474;1516;1546;5616
320480;201312;1940;6005;1614;5351;417;1591;677;2111;1094;3702
320490;201312;17595;57112;14853;51498;5219;19417;4790;16981;10009;36398
320495;201312;1295;4301;1131;3903;482;1796;287;951;769;2747
320500;201312;42967;139310;38517;130686;13258;48574;16008;52980;29266;101554
320501;201312;3572;12005;3318;11550;1172;4582;1407;4708;2579;9290
320503;201312;2267;8397;1976;7590;695;2842;493;1728;1188;4570
320506;201312;3215;10367;2265;7864;712;2692;295;928;1007;3620
320510;201312;8174;26730;7355;25033;2635;9555;2658;8892;5293;18447
320515;201312;2093;6099;1859;5647;541;1761;679;2037;1220;3798
320517;201312;2173;7352;1846;6618;697;2690;409;1375;1106;4065
320520;201312;31517;104326;27439;96155;9268;35787;11349;39304;20617;75091
320530;201312;27498;87898;23750;80117;6733;25717;10030;32135;16763;57852
330010;201312;16028;52078;14932;49741;3444;12961;8505;27235;11949;40196
330015;201312;1960;5613;1716;5130;512;1707;588;1678;1100;3385
330020;201312;16285;50229;14979;48057;3789;13091;8145;25949;11934;39040
330022;201312;1635;5342;1460;4992;331;1308;760;2474;1091;3782
330023;201312;3362;11106;3157;10671;872;3235;1255;4061;2127;7296
330025;201312;3290;10289;3051;9913;778;2721;1817;5844;2595;8565
330030;201312;7471;26430;6873;25121;2085;8377;2855;9909;4940;18286
330040;201312;14312;41669;12205;38256;3431;11556;5995;18451;9426;30007
330045;201312;63670;188326;58580;180386;9335;30989;39726;121910;49061;152899
330050;201312;2935;9560;2604;8866;977;3731;675;2103;1652;5834
330060;201312;5451;17152;4942;16388;1173;4376;2933;9741;4106;14117
330070;201312;25245;79703;23129;75779;6765;23793;10020;32747;16785;56540
330080;201312;8878;26309;8498;25779;2019;6126;5348;16749;7367;22875
330090;201312;3170;9089;2986;8745;894;2830;1389;3986;2283;6816
330093;201312;1962;5829;1721;5422;432;1464;690;2124;1122;3588
330095;201312;1200;4222;1109;4003;437;1750;174;535;611;2285
330100;201312;54586;185530;51195;179415;12658;49233;25832;90787;38490;140020
330110;201312;2648;8543;2419;8100;833;2995;759;2518;1592;5513
330115;201312;2445;7539;2274;7235;761;2643;918;2818;1679;5461
330120;201312;2508;7470;2285;7145;742;2482;936;2859;1678;5341
330130;201312;3963;13302;3598;12568;1213;4592;1342;4646;2555;9238
330140;201312;3389;10506;3087;10077;834;3015;1436;4668;2270;7683
330150;201312;2582;7852;1981;6560;573;2089;431;1368;1004;3457
330160;201312;1377;4904;1295;4719;489;1938;407;1423;896;3361
330170;201312;102118;316027;95974;306213;14726;50438;68136;217517;82862;267955
330180;201312;1697;5335;1545;5032;256;1060;987;2983;1243;4043
330185;201312;7865;25345;7345;24454;1980;6937;3949;13485;5929;20422
330187;201312;4279;12467;3842;11739;842;2917;2235;6753;3077;9670
330190;201312;27833;85735;26564;83595;6926;23244;15426;47763;22352;71007
330200;201312;13401;43171;12192;40745;2917;10064;6534;22220;9451;32284
330205;201312;2566;7126;2326;6731;541;1832;1153;3177;1694;5009
330210;201312;4708;12458;3442;10078;1059;3397;794;2280;1853;5677
330220;201312;11164;35989;10453;34539;3571;12783;3322;10438;6893;23221
330225;201312;4007;12860;3786;12504;633;2453;2620;8605;3253;11058
330227;201312;17555;50685;15912;48368;3881;12631;9148;27237;13029;39868
330230;201312;1508;4523;1379;4288;431;1511;527;1504;958;3015
330240;201312;20170;63504;17975;59580;7067;25565;3272;10524;10339;36089
330245;201312;1216;3971;1015;3543;320;1220;220;764;540;1984
330250;201312;37199;110744;35018;107173;10179;31747;18505;57730;28684;89477
330260;201312;3587;11574;3343;11051;891;3230;1486;4721;2377;7951
330270;201312;13982;41894;11899;38426;3648;12581;4464;14501;8112;27082
330280;201312;1967;6339;1697;5769;399;1562;782;2473;1181;4035
330285;201312;17545;53446;16168;51457;3703;12456;9818;31381;13521;43837
330290;201312;3535;10071;3158;9549;668;2319;1809;5187;2477;7506
330300;201312;4139;13708;3949;13373;972;3557;2043;6973;3015;10530
330310;201312;2767;8235;2521;7807;633;2077;1248;3814;1881;5891
330320;201312;12012;36622;11289;35472;1919;6526;7839;24603;9758;31129
330330;201312;31607;92205;29162;88297;7503;24524;16841;50234;24344;74758
330340;201312;14360;45328;11831;40104;3785;13850;3398;11278;7183;25128
330350;201312;91867;299312;89428;295780;16893;56275;63125;212593;80018;268868
330360;201312;5474;17635;5345;17425;806;2883;3934;12740;4740;15623
330370;201312;3787;14243;3585;13733;1440;5726;1166;4494;2606;10220
330380;201312;4289;14262;3802;13383;1121;4245;1735;6106;2856;10351
330385;201312;4051;14294;3747;13655;1314;5101;1332;4825;2646;9926
330390;201312;24033;82024;22019;77867;5500;21730;11125;38346;16625;60076
330395;201312;3364;10216;3136;9820;531;1823;1976;6208;2507;8031
330400;201312;2574;8753;2353;8317;556;2279;1153;3733;1709;6012
330410;201312;3083;9979;2659;9087;647;2338;1288;4405;1935;6743
330411;201312;2515;8081;2268;7575;500;1930;1168;3660;1668;5590
330412;201312;1382;4833;1099;4260;273;1192;393;1474;666;2666
330414;201312;25642;73871;21974;68836;4610;15354;13358;41932;17968;57286
330415;201312;3676;11759;3260;10983;847;3182;1419;4758;2266;7940
330420;201312;7643;25280;5970;21672;1845;7334;1061;3830;2906;11164
330430;201312;8188;24659;7355;23159;1803;6333;3587;10979;5390;17312
330440;201312;2114;7170;1763;6414;599;2449;407;1364;1006;3813
330450;201312;1609;5703;1514;5498;481;1963;588;2073;1069;4036
330452;201312;10589;33224;8808;29600;2545;9473;3522;11280;6067;20753
330455;201312;464345;1388277;399993;1280163;111171;380785;197666;629366;308837;1010151
330460;201312;1386;4746;1299;4572;366;1456;613;2112;979;3568
330470;201312;4343;14555;4074;14001;1493;5527;1224;4089;2717;9616
330475;201312;8160;26441;7411;25187;2019;7548;3671;12429;5690;19977
330480;201312;6441;19807;6039;19050;1775;6041;2495;7789;4270;13830
330490;201312;99610;284111;92868;274081;13371;41578;69733;206483;83104;248061
330500;201312;6857;21202;6427;20342;1479;5040;3338;10825;4817;15865
330510;201312;41567;136533;39274;132581;13940;47871;18084;62708;32024;110579
330513;201312;1580;4820;1459;4579;580;1916;472;1460;1052;3376
330515;201312;3071;9888;2816;9399;972;3471;1019;3353;1991;6824
330520;201312;13330;40491;12303;38784;3211;10643;6669;21136;9880;31779
330530;201312;1551;4704;1433;4493;395;1384;705;2118;1100;3502
330540;201312;3298;10197;2875;9519;895;3188;1114;3596;2009;6784
330550;201312;8954;30015;7950;28127;3284;12319;1949;6988;5233;19307
330555;201312;10346;32044;9317;30425;1913;6485;5816;19314;7729;25799
330560;201312;4175;13043;3913;12585;871;3258;2195;6853;3066;10111
330570;201312;3666;10718;3187;9910;854;2784;1634;5151;2488;7935
330575;201312;5369;16565;4952;15767;1194;4089;2870;8839;4064;12928
330580;201312;16599;54717;14699;50823;5143;18598;5103;18062;10246;36660
330590;201312;1952;6019;1840;5826;567;1905;883;2794;1450;4699
330600;201312;9524;29128;8225;27025;1285;5209;5249;16437;6534;21646
330610;201312;8876;29256;8163;27880;2236;8476;3847;12922;6083;21398
330615;201312;1671;6015;1536;5645;684;2614;404;1536;1088;4150
330620;201312;3975;14170;3651;13503;1319;5191;1037;3974;2356;9165
330630;201312;20815;69633;18826;65332;5408;20871;8718;28811;14126;49682
350010;201312;2924;9360;2327;8027;727;2688;433;1413;1160;4101
350020;201312;614;1763;471;1496;122;443;178;524;300;967
350030;201312;4720;15340;3973;13641;1417;5331;1175;3938;2592;9269
350040;201312;589;2173;517;2012;176;746;102;356;278;1102
350050;201312;1411;4681;1170;4217;324;1338;380;1242;704;2580
350055;201312;602;2044;580;2006;175;659;275;930;450;1589
350060;201312;85;291;79;281;23;103;28;84;51;187
350070;201312;2662;9012;2142;7721;528;2102;410;1297;938;3399
350075;201312;496;1825;448;1709;159;650;118;419;277;1069
350080;201312;597;1784;475;1531;135;500;172;537;307;1037
350090;201312;597;1741;451;1485;124;442;124;369;248;811
350100;201312;1862;6592;1669;6144;604;2399;485;1715;1089;4114
350110;201312;451;1396;359;1182;107;393;109;318;216;711
350115;201312;1317;4387;1170;4000;277;1086;521;1631;798;2717
350120;201312;692;1968;460;1485;137;487;100;304;237;791
350130;201312;3680;11453;3340;10771;876;3146;1424;4239;2300;7385
350140;201312;689;2190;623;2054;166;626;248;767;414;1393
350150;201312;438;1518;399;1426;155;587;95;330;250;917
350160;201312;6061;19475;4657;16341;1468;5676;1635;5262;3103;10938
350170;201312;2262;8128;2021;7507;744;2872;457;1606;1201;4478
350180;201312;1437;3803;1190;3374;310;925;513;1427;823;2352
350190;201312;3173;11095;2744;10201;896;3784;1101;3675;1997;7459
350200;201312;424;1471;382;1397;131;543;130;451;261;994
350210;201312;7557;21559;5981;18732;2354;7967;1852;5485;4206;13452
350220;201312;3121;10223;2821;9658;1025;3931;803;2468;1828;6399
350230;201312;739;2554;680;2454;237;930;223;799;460;1729
350240;201312;598;1834;517;1706;120;469;279;870;399;1339
350250;201312;2739;10271;2626;10035;1119;4520;832;3155;1951;7675
350260;201312;1054;2858;890;2566;216;646;374;1108;590;1754
350270;201312;5246;16412;4655;15176;1056;3704;2203;7151;3259;10855
350275;201312;2029;6799;1812;6457;558;2189;711;2373;1269;4562
350280;201312;22606;60782;14584;45538;3956;13220;3051;9577;7007;22797
350290;201312;1718;6085;1540;5657;485;1862;448;1696;933;3558
350300;201312;488;1568;452;1486;153;544;144;473;297;1017
350310;201312;1015;3421;944;3249;222;895;410;1353;632;2248
350315;201312;563;1800;458;1573;78;345;153;491;231;836
350320;201312;12035;40203;11016;37786;3571;13070;1953;6506;5524;19576
350330;201312;9540;28696;8419;26316;2051;7145;4432;12935;6483;20080
350335;201312;552;1647;503;1543;132;420;191;644;323;1064
350340;201312;1034;3336;811;2898;226;889;214;746;440;1635
350350;201312;765;2481;671;2327;187;724;223;778;410;1502
350360;201312;816;2914;713;2670;228;898;239;909;467;1807
350370;201312;708;2224;534;1799;109;413;119;358;228;771
350380;201312;3743;12360;3138;11360;1328;5174;676;2302;2004;7476
350390;201312;8611;28343;7726;26690;2055;7666;3821;12769;5876;20435
350395;201312;299;987;242;860;76;288;49;168;125;456
350400;201312;8172;24425;6753;21805;2039;7227;2375;7316;4414;14543
350410;201312;7474;28122;6675;26184;2450;10362;1612;6051;4062;16413
350420;201312;1018;3265;819;2862;391;1447;76;253;467;1700
350430;201312;865;2739;750;2538;202;816;373;1199;575;2015
350440;201312;1388;4514;1309;4369;481;1707;592;1911;1073;3618
350450;201312;8247;25615;6755;22551;2215;7926;1824;5859;4039;13785
350460;201312;1525;4577;1106;3664;335;1218;319;933;654;2151
350470;201312;233;692;199;636;55;202;87;254;142;456
350480;201312;769;2407;508;1758;92;363;86;249;178;612
350490;201312;2102;6191;1796;5768;519;1937;847;2522;1366;4459
350500;201312;613;1837;530;1706;136;495;228;683;364;1178
350510;201312;1102;3586;955;3265;309;1199;340;1032;649;2231
350520;201312;1275;5024;1160;4768;450;1936;290;1162;740;3098
350530;201312;2530;7734;2080;6721;820;2864;496;1436;1316;4300
350535;201312;1469;4397;1432;4346;79;275;1259;3828;1338;4103
350540;201312;2059;6036;1750;5486;510;1760;668;2083;1178;3843
350550;201312;10889;32535;8743;28694;2548;9394;3291;10099;5839;19493
350560;201312;3477;11831;3162;11189;658;2479;1655;6010;2313;8489
350570;201312;20948;73558;19105;69148;6325;24485;6793;23568;13118;48053
350580;201312;1997;6658;1690;5984;521;2041;260;785;781;2826
350590;201312;4014;13435;3227;11636;1052;4200;1078;3506;2130;7706
350600;201312;38563;99888;26828;81018;5836;19216;12883;37729;18719;56945
350610;201312;9025;26895;7319;24021;2044;7547;3339;10452;5383;17999
350620;201312;457;1446;384;1321;89;348;165;542;254;890
350630;201312;1640;5242;1289;4529;422;1672;132;401;554;2073
350635;201312;4996;16509;4034;14538;1247;4707;1517;5515;2764;10222
350640;201312;687;2217;581;1935;179;640;187;580;366;1220
350650;201312;4152;13900;3091;11299;1225;4890;297;1027;1522;5917
350660;201312;3800;12337;3339;11508;973;3584;1527;5211;2500;8795
350670;201312;1860;5863;1750;5671;353;1294;1113;3464;1466;4758
350680;201312;1210;3819;976;3333;294;1195;385;1243;679;2438
350690;201312;1060;3650;908;3307;285;1149;232;772;517;1921
350700;201312;2678;9411;2335;8607;933;3817;854;2784;1787;6601
350710;201312;2165;6943;1974;6639;360;1380;1281;4234;1641;5614
350715;201312;1127;3488;999;3234;269;975;381;1148;650;2123
350720;201312;138;432;126;405;50;178;43;115;93;293
350730;201312;419;1633;400;1573;125;547;110;393;235;940
350740;201312;2385;7346;2146;6803;595;2055;882;2794;1477;4849
350745;201312;353;1141;282;966;68;278;120;354;188;632
350750;201312;9748;30560;7503;25946;2153;8159;1877;6072;4030;14231
350760;201312;12024;39115;10965;37153;3673;13894;4675;14890;8348;28784
350770;201312;905;2739;652;2223;145;567;235;781;380;1348
350775;201312;629;1895;572;1785;138;497;252;775;390;1272
350780;201312;2098;6475;1573;5342;418;1576;251;815;669;2391
350790;201312;2129;7088;1697;6106;548;2075;340;1098;888;3173
350800;201312;3082;10700;2939;10453;669;2653;1741;6075;2410;8728
350810;201312;2604;7755;2280;7157;780;2656;714;2272;1494;4928
350820;201312;537;1501;393;1189;90;308;136;371;226;679
350830;201312;889;2858;631;2190;124;476;126;358;250;834
350840;201312;2339;8557;1937;7467;648;2744;357;1187;1005;3931
350850;201312;6850;23600;5665;20638;1930;7436;1299;4462;3229;11898
350860;201312;3398;11194;3269;10999;533;2042;2406;8044;2939;10086
350870;201312;2407;8377;2171;8013;769;3037;1053;3894;1822;6931
350880;201312;1686;5819;1438;5247;446;1747;281;1023;727;2770
350890;201312;648;1968;521;1692;99;355;171;467;270;822
350900;201312;4584;15578;3814;13813;1069;4212;1136;3852;2205;8064
350910;201312;869;2754;825;2657;374;1257;269;852;643;2109
350920;201312;9626;29522;8962;28387;1752;6173;5651;17234;7403;23407
350925;201312;5331;16885;4777;15761;1463;5279;2005;6379;3468;11658
350930;201312;1549;4357;1297;3930;162;606;910;2640;1072;3246
350940;201312;2303;7810;2106;7477;453;1882;1262;4277;1715;6159
350945;201312;944;3200;838;2973;230;907;339;1146;569;2053
350950;201312;71604;233282;60660;210462;18316;69312;24018;80689;42334;150001
350960;201312;4591;16459;4091;15314;842;3621;2200;7897;3042;11518
350970;201312;4245;15718;3858;14725;1540;6322;1127;4141;2667;10463
350980;201312;682;2245;627;2151;288;1076;128;432;416;1508
350990;201312;1798;6429;1601;6044;582;2383;528;1956;1110;4339
350995;201312;816;2988;771;2898;224;954;366;1302;590;2256
351000;201312;3517;10994;3061;10100;535;2071;1762;5571;2297;7642
351010;201312;422;1301;310;1060;121;455;63;216;184;671
351015;201312;953;3223;823;2977;319;1310;226;728;545;2038
351020;201312;7747;25865;6882;24504;1855;7121;3637;13131;5492;20252
351030;201312;1383;5225;1275;4959;375;1652;413;1529;788;3181
351040;201312;3693;12020;3414;11526;835;3272;1956;6190;2791;9462
351050;201312;9035;29988;7443;26764;2673;10393;2454;8766;5127;19159
351060;201312;32724;104531;27631;94868;9522;34532;9254;31882;18776;66414
351070;201312;1812;5258;1310;4335;464;1679;245;719;709;2398
351080;201312;2774;8512;2189;7784;670;2601;931;3232;1601;5833
351090;201312;387;1367;309;1198;111;491;52;181;163;672
351100;201312;1913;6258;1687;5777;661;2313;488;1703;1149;4016
351110;201312;7851;23137;5753;19202;1966;7189;1651;5200;3617;12389
351120;201312;598;1871;504;1647;73;292;250;730;323;1022
351130;201312;860;2399;442;1525;89;353;112;344;201;697
351140;201312;1999;7026;1816;6623;706;2813;550;1936;1256;4749
351150;201312;2218;7824;1801;6675;506;2058;424;1417;930;3475
351160;201312;1518;5427;1370;5066;475;1951;448;1590;923;3541
351170;201312;1639;5498;1302;4676;376;1450;485;1596;861;3046
351190;201312;867;2883;747;2559;196;711;153;464;349;1175
351200;201312;2216;6780;1910;6197;356;1368;947;2796;1303;4164
351210;201312;1082;3455;914;3116;298;1110;273;865;571;1975
351220;201312;3528;12114;3098;11183;910;3578;1264;4484;2174;8062
351230;201312;1894;6481;1713;6112;562;2223;783;2716;1345;4939
351240;201312;1033;3427;745;2739;220;902;182;592;402;1494
351250;201312;872;2572;651;2108;146;519;305;947;451;1466
351260;201312;1196;3632;1060;3344;303;1043;400;1195;703;2238
351270;201312;391;1428;354;1349;122;533;106;355;228;888
351280;201312;4688;14750;3714;12458;1086;3887;1094;3318;2180;7205
351290;201312;1006;3142;886;2886;284;958;259;796;543;1754
351300;201312;10019;37472;8760;34412;2622;11181;3171;12324;5793;23505
351310;201312;3378;10754;2837;9718;734;2900;1318;4172;2052;7072
351320;201312;1011;3630;888;3336;311;1280;206;677;517;1957
351330;201312;286;843;256;784;105;328;69;204;174;532
351340;201312;6658;23530;6015;22180;1776;6921;2910;10726;4686;17647
351350;201312;7772;25952;6911;24046;2140;7844;2514;8415;4654;16259
351360;201312;4907;15207;4614;14697;1297;4670;2130;6563;3427;11233
351370;201312;1937;6434;1575;5639;552;2194;354;1121;906;3315
351380;201312;37498;119693;34901;114230;9563;34194;16257;50899;25820;85093
351385;201312;250;799;243;787;93;308;85;271;178;579
351390;201312;1238;4267;1103;3974;437;1683;344;1168;781;2851
351400;201312;1230;4017;1156;3857;429;1509;411;1400;840;2909
351410;201312;2937;9110;2608;8516;637;2244;1298;4173;1935;6417
351420;201312;458;1366;319;1050;74;264;54;162;128;426
351430;201312;889;2863;802;2701;174;649;504;1667;678;2316
351440;201312;4694;14606;4080;13269;1585;5398;1028;3142;2613;8540
351450;201312;1812;5239;1595;4950;502;1593;812;2610;1314;4203
351460;201312;830;2666;696;2394;342;1255;193;621;535;1876
351470;201312;1085;3404;968;3181;392;1416;281;898;673;2314
351480;201312;2974;9920;2714;9471;696;2896;1297;4353;1993;7249
351490;201312;1993;6859;1788;6408;388;1638;960;3267;1348;4905
351492;201312;297;1020;219;802;49;214;62;184;111;398
351495;201312;155;544;129;474;40;155;45;156;85;311
351500;201312;20159;66178;18017;61923;5793;21524;7198;24136;12991;45660
351510;201312;7574;25025;6553;23212;1687;6510;3342;11697;5029;18207
351512;201312;401;1231;350;1132;95;330;138;440;233;770
351515;201312;1906;6583;1609;5877;540;2119;435;1496;975;3615
351518;201312;1615;5680;1224;4973;380;1688;232;886;612;2574
351519;201312;782;2603;681;2366;199;799;259;826;458;1625
351520;201312;806;2301;385;1399;65;274;47;154;112;428
351530;201312;466;1489;400;1325;89;317;122;351;211;668
351535;201312;2639;6971;2145;6235;270;904;1443;4111;1713;5015
351540;201312;2122;6911;1894;6477;953;3445;342;1141;1295;4586
351550;201312;5747;17872;4522;15281;1636;5815;1194;3921;2830;9736
351560;201312;426;1430;369;1287;143;543;58;192;201;735
351565;201312;238;816;221;770;67;281;86;261;153;542
351570;201312;12471;41376;10870;38007;3468;12603;4640;16246;8108;28849
351580;201312;399;1137;299;911;47;150;113;318;160;468
351590;201312;456;1302;392;1151;139;440;79;214;218;654
351600;201312;1869;5534;1708;5230;422;1510;802;2220;1224;3730
351610;201312;654;1855;556;1681;119;422;279;792;398;1214
351620;201312;21914;74258;17934;65284;5786;22916;4526;15176;10312;38092
351630;201312;14806;50970;13630;48961;4022;14966;7047;25714;11069;40680
351640;201312;8336;27469;6949;24970;1812;7100;3457;12207;5269;19307
351650;201312;367;1128;237;799;63;236;37;115;100;351
351660;201312;877;2793;686;2348;167;655;201;610;368;1265
351670;201312;4198;13485;3559;12108;761;2967;1734;5574;2495;8541
351680;201312;626;1958;434;1479;101;370;77;231;178;601
351685;201312;442;1365;353;1206;109;394;122;424;231;818
351690;201312;1341;4044;1047;3379;455;1474;256;765;711;2239
351700;201312;1462;4487;1328;4234;454;1514;437;1339;891;2853
351710;201312;802;2547;668;2237;169;577;198;620;367;1197
351720;201312;1662;5365;1268;4311;285;1083;433;1399;718;2482
351730;201312;1110;3371;944;3124;392;1447;283;870;675;2317
351740;201312;4582;13367;3935;11983;1084;3551;1295;3685;2379;7236
351750;201312;1505;5043;1306;4607;409;1571;342;1114;751;2685
351760;201312;3771;12425;3335;11428;901;3370;1462;4808;2363;8178
351770;201312;2254;7442;1956;6884;738;2695;824;2898;1562;5593
351780;201312;1621;4687;1083;3518;303;1088;228;688;531;1776
351790;201312;1125;3434;960;3198;314;1126;431;1400;745;2526
351800;201312;340;845;292;752;45;144;173;404;218;548
351810;201312;1197;3716;1130;3632;299;1119;685;2077;984;3196
351820;201312;2503;7586;1789;6217;678;2528;197;653;875;3181
351830;201312;4056;13552;3664;12656;936;3572;1666;5536;2602;9108
351840;201312;8952;31430;7988;29355;2768;10728;2506;9145;5274;19873
351850;201312;1234;4304;1058;3909;316;1294;207;685;523;1979
351860;201312;3600;11811;3331;11275;802;3071;1809;5829;2611;8900
351870;201312;35178;111014;32403;106127;7732;27368;19043;61940;26775;89308
351880;201312;111781;370284;97949;341453;32582;119910;28949;100321;61531;220231
351885;201312;653;2411;606;2300;171;684;267;981;438;1665
351890;201312;817;2478;641;2089;207;708;142;433;349;1141
351900;201312;1455;4547;1265;4221;409;1472;460;1533;869;3005
351905;201312;380;1374;331;1280;96;426;138;482;234;908
351907;201312;14687;47461;12868;43817;3019;11566;6307;20414;9326;31980
351910;201312;1158;3786;1065;3605;265;1013;359;1125;624;2138
351920;201312;1201;3541;1136;3445;278;962;665;1934;943;2896
351925;201312;967;2855;905;2750;124;476;639;1827;763;2303
351930;201312;3127;10889;2879;10347;853;3460;1222;3983;2075;7443
351940;201312;1012;3146;945;3018;278;978;544;1663;822;2641
351950;201312;1366;3919;997;3170;221;772;433;1286;654;2058
351960;201312;3917;12711;3350;11610;1242;4554;1292;4418;2534;8972
351970;201312;7018;26847;6352;25382;2382;10052;2013;7982;4395;18034
351980;201312;958;3000;805;2696;183;717;325;983;508;1700
351990;201312;1591;4667;1293;4062;376;1382;372;1007;748;2389
352000;201312;2494;8176;2277;7724;574;2098;1012;3296;1586;5394
352010;201312;2284;7920;2078;7400;758;2843;452;1607;1210;4450
352020;201312;1501;4942;1348;4624;435;1565;432;1491;867;3056
352030;201312;4495;14411;4113;13907;969;3522;2354;8094;3323;11616
352040;201312;1815;6478;1551;5788;455;1805;357;1248;812;3053
352042;201312;2298;6697;1744;5520;450;1588;858;2636;1308;4224
352044;201312;1367;4748;1081;3993;279;1102;243;811;522;1913
352050;201312;7695;26502;5609;21474;1776;7449;1000;3333;2776;10782
352060;201312;804;2434;713;2288;210;788;286;826;496;1614
352070;201312;732;2015;674;1920;293;902;196;585;489;1487
352080;201312;534;1680;456;1538;125;480;153;460;278;940
352090;201312;1685;5584;1393;4958;350;1392;470;1539;820;2931
352100;201312;1799;6260;1604;5862;548;2233;570;1865;1118;4098
352110;201312;432;1642;380;1511;113;490;109;411;222;901
352115;201312;378;1254;321;1132;98;378;147;489;245;867
352120;201312;981;2934;852;2753;181;627;490;1620;671;2247
352130;201312;1785;5100;1341;4316;367;1302;527;1541;894;2843
352140;201312;1416;4635;1102;3910;337;1254;437;1542;774;2796
352150;201312;607;1852;497;1650;178;640;179;568;357;1208
352160;201312;1233;3559;1133;3411;259;835;631;1913;890;2748
352170;201312;3171;9911;2899;9434;836;2955;1350;4186;2186;7141
352180;201312;3585;10448;3139;9606;869;2893;1402;4062;2271;6955
352190;201312;1061;3340;969;3168;223;886;491;1475;714;2361
352200;201312;420;1481;345;1327;77;328;158;616;235;944
352210;201312;16012;44391;12900;39736;2675;8746;7695;24225;10370;32971
352215;201312;563;1820;505;1731;81;308;291;1021;372;1329
352220;201312;14953;50710;13884;48462;4774;17699;5269;18292;10043;35991
352230;201312;13674;47783;12087;44722;3851;15547;4569;16551;8420;32098
352240;201312;9964;32338;9173;30865;3174;11971;3584;11375;6758;23346
352250;201312;22642;74034;19887;68317;5365;20147;7913;26789;13278;46936
352260;201312;5322;16727;3805;13508;1052;4163;1188;3837;2240;8000
352265;201312;940;3051;817;2852;142;571;507;1725;649;2296
352270;201312;2588;8914;2230;8074;889;3406;489;1682;1378;5088
352280;201312;2456;7813;2100;7203;610;2333;697;2304;1307;4637
352290;201312;1304;4294;1119;3867;283;1111;330;1014;613;2125
352300;201312;944;2891;790;2615;244;864;331;1090;575;1954
352310;201312;31437;108231;28591;103246;7993;31063;16174;57289;24167;88352
352320;201312;5844;18548;5107;17151;1668;6084;1696;5174;3364;11258
352330;201312;2188;7331;1908;6979;729;2871;647;2361;1376;5232
352340;201312;5785;20117;4745;17512;1647;6532;909;3075;2556;9607
352350;201312;1768;6606;1587;6169;449;1901;526;1950;975;3851
352360;201312;1186;3981;1055;3706;303;1258;558;1794;861;3052
352370;201312;901;3084;815;2888;197;785;377;1310;574;2095
352380;201312;1021;3318;893;3089;358;1386;246;812;604;2198
352390;201312;11468;35377;9140;30792;2174;8441;4291;13421;6465;21862
352400;201312;3186;9732;2155;7640;659;2580;839;2813;1498;5393
352410;201312;3725;11113;2844;9567;951;3465;856;2736;1807;6201
352420;201312;1296;3783;1197;3619;463;1551;425;1256;888;2807
352430;201312;6240;20067;5499;18784;2208;8193;1690;5580;3898;13773
352440;201312;15802;50668;13056;45160;3591;13414;5041;16922;8632;30336
352450;201312;628;1914;439;1543;123;470;92;286;215;756
352460;201312;2680;9159;2419;8656;877;3500;825;2710;1702;6210
352470;201312;4910;14110;3043;10170;633;2290;1310;4271;1943;6561
352480;201312;5399;15486;4423;13659;1211;4319;1826;5166;3037;9485
352490;201312;736;2678;617;2380;154;663;120;440;274;1103
352500;201312;8731;28666;8199;27733;3794;13802;2370;7343;6164;21145
352510;201312;3383;11915;2790;10600;1006;4109;671;2478;1677;6587
352520;201312;2450;8790;2208;8223;581;2343;1203;4402;1784;6745
352530;201312;6315;20712;4719;17145;1386;5520;829;2781;2215;8301
352540;201312;485;1619;391;1403;99;398;131;460;230;858
352550;201312;1070;3680;873;3239;313;1247;207;730;520;1977
352560;201312;550;1711;462;1526;92;363;212;614;304;977
352570;201312;1535;4950;1082;3870;263;1074;275;866;538;1940
352580;201312;923;2835;802;2622;292;1084;329;986;621;2070
352585;201312;215;727;169;629;41;171;57;190;98;361
352590;201312;13636;44968;12197;42114;2939;11346;6479;21619;9418;32965
352600;201312;1890;6200;1745;5875;625;2178;579;1904;1204;4082
352610;201312;3627;11832;3229;11151;1262;4759;1015;3370;2277;8129
352620;201312;5499;17903;5212;17502;1252;4429;3303;11153;4555;15582
352630;201312;849;2848;797;2718;238;895;356;1184;594;2079
352640;201312;3057;9956;2479;8616;585;2254;997;3354;1582;5608
352650;201312;845;2551;633;2111;150;532;192;615;342;1147
352660;201312;1090;3852;886;3358;288;1159;257;955;545;2114
352670;201312;7767;26738;6771;24710;2641;10082;1636;5910;4277;15992
352680;201312;3040;11235;2565;9898;671;2841;729;2489;1400;5330
352690;201312;24128;73730;19464;64667;5292;19266;8133;26092;13425;45358
352700;201312;773;2346;619;2104;188;731;271;870;459;1601
352710;201312;5169;15641;3780;12740;1070;4017;1346;4263;2416;8280
352720;201312;8779;30116;8216;28907;2750;10262;3190;11137;5940;21399
352725;201312;411;1247;278;935;54;217;76;238;130;455
352730;201312;2613;9218;2258;8232;628;2498;670;2187;1298;4685
352740;201312;2249;6793;1922;6185;542;2060;841;2433;1383;4493
352750;201312;385;1216;307;1056;108;410;65;184;173;594
352760;201312;950;3365;881;3227;296;1193;457;1611;753;2804
352770;201312;924;2901;866;2782;242;855;318;1012;560;1867
352780;201312;606;2093;530;1908;162;654;167;535;329;1189
352790;201312;652;1927;523;1705;157;563;99;311;256;874
352800;201312;1104;4237;891;3617;281;1166;150;537;431;1703
352810;201312;1026;2795;777;2330;151;530;311;901;462;1431
352820;201312;552;1714;464;1550;211;753;83;280;294;1033
352830;201312;416;1238;321;1028;87;283;50;140;137;423
352840;201312;3493;12456;3077;11510;956;3823;1051;3912;2007;7735
352850;201312;9911;32752;8691;30520;2549;9547;3277;11612;5826;21159
352860;201312;1041;3512;953;3305;397;1457;240;756;637;2213
352870;201312;1085;2834;866;2403;140;502;477;1188;617;1690
352880;201312;2259;6917;1789;5846;439;1559;447;1325;886;2884
352885;201312;311;1082;294;1042;90;351;113;375;203;726
352890;201312;707;2067;620;1888;149;517;208;570;357;1087
352900;201312;18933;58631;14558;49450;4039;14929;5679;18490;9718;33419
352910;201312;285;937;249;854;81;291;31;85;112;376
352920;201312;3395;10572;2894;9560;980;3586;964;2926;1944;6512
352930;201312;7049;22830;5540;19374;1662;6207;1069;3604;2731;9811
352940;201312;27239;93770;23558;84729;8526;32297;4480;15571;13006;47868
352950;201312;319;1025;229;825;62;266;59;188;121;454
352960;201312;508;1685;381;1358;79;308;60;193;139;501
352965;201312;364;1039;295;909;76;246;45;131;121;377
352970;201312;3355;8952;2980;8452;382;1167;2160;6232;2542;7399
352980;201312;1447;4397;1239;4059;420;1422;488;1669;908;3091
352990;201312;3675;12460;3409;11971;1197;4582;1120;3760;2317;8342
353000;201312;522;1483;395;1218;87;300;109;296;196;596
353010;201312;2912;8476;2205;7007;641;2279;769;2242;1410;4521
353020;201312;4408;12422;3151;9687;542;1901;1324;3685;1866;5586
353030;201312;5011;15329;4317;13881;1577;5487;947;2846;2524;8333
353040;201312;692;2012;594;1855;201;685;214;645;415;1330
353050;201312;5520;19491;4709;17727;1812;7287;1370;4894;3182;12181
353060;201312;33515;110468;31266;106799;5657;22891;20706;67606;26363;90497
353070;201312;8681;30192;6875;25885;2441;9668;1603;6079;4044;15747
353080;201312;4670;16430;3910;14601;1346;5421;1062;3684;2408;9105
353090;201312;594;2023;529;1890;92;396;254;825;346;1221
353100;201312;271;821;223;709;99;324;45;136;144;460
353110;201312;7889;25098;7061;23540;1708;6057;3864;13031;5572;19088
353120;201312;464;1604;398;1447;146;597;94;307;240;904
353130;201312;2990;9467;2641;8838;1005;3682;938;2937;1943;6619
353140;201312;2571;7406;2073;6378;658;2212;640;1776;1298;3988
353150;201312;1931;6242;1595;5576;609;2227;366;1321;975;3548
353160;201312;614;1878;499;1642;152;523;98;294;250;817
353170;201312;520;1881;473;1794;190;803;172;624;362;1427
353180;201312;5384;17413;4744;16174;784;3122;2942;9670;3726;12792
353190;201312;3622;11826;3136;10663;810;3052;1399;4373;2209;7425
353200;201312;857;3076;767;2869;253;1062;280;985;533;2047
353205;201312;537;1746;432;1498;107;371;143;510;250;881
353210;201312;1021;2793;840;2470;127;451;514;1463;641;1914
353215;201312;564;1807;485;1635;107;403;160;552;267;955
353220;201312;906;2828;811;2631;223;800;274;855;497;1655
353230;201312;968;3125;886;2979;229;886;300;929;529;1815
353240;201312;2158;7326;1952;6885;644;2522;776;2513;1420;5035
353250;201312;1222;3538;1024;3167;297;994;357;1039;654;2033
353260;201312;1151;3436;1014;3204;339;1135;377;1145;716;2280
353270;201312;647;2001;556;1823;181;643;149;444;330;1087
353280;201312;561;1877;486;1746;172;656;119;415;291;1071
353282;201312;1759;5951;1702;5857;310;1191;1119;3752;1429;4943
353284;201312;328;951;256;819;78;258;66;204;144;462
353286;201312;146;439;94;311;24;75;12;44;36;119
353290;201312;440;1596;399;1511;169;662;139;520;308;1182
353300;201312;1860;6042;1656;5577;596;2148;521;1598;1117;3746
353310;201312;349;1115;327;1056;140;478;88;262;228;740
353320;201312;526;1505;453;1378;112;407;218;619;330;1026
353325;201312;495;1768;415;1601;117;487;55;212;172;699
353330;201312;498;1550;415;1371;103;387;172;515;275;902
353340;201312;3147;10336;2710;9421;936;3522;932;3111;1868;6633
353350;201312;3414;10587;3026;9865;1015;3564;1391;4385;2406;7949
353360;201312;411;1468;362;1350;100;433;184;630;284;1063
353370;201312;709;2344;637;2163;175;628;295;989;470;1617
353380;201312;420;1407;378;1330;104;411;161;541;265;952
353390;201312;5381;14682;3826;11752;918;3109;1397;3869;2315;6978
353400;201312;615;1943;509;1710;117;428;146;413;263;841
353410;201312;686;2140;581;1969;180;675;292;962;472;1637
353420;201312;696;2069;514;1599;163;550;159;449;322;999
353430;201312;2471;8695;1766;6593;478;1856;120;357;598;2213
353440;201312;59797;199548;53751;184675;17081;61810;17178;57254;34259;119064
353450;201312;457;1415;408;1327;109;417;147;447;256;864
353460;201312;3980;11504;3441;10520;886;2936;1667;5029;2553;7965
353470;201312;11239;36180;8793;30884;2763;10575;1995;6772;4758;17347
353475;201312;1702;5011;1255;4020;330;1168;346;998;676;2166
353480;201312;1522;4627;1368;4344;322;1184;736;2205;1058;3389
353490;201312;1633;4743;1350;4160;374;1277;365;1011;739;2288
353500;201312;1197;3505;1111;3349;480;1545;376;1067;856;2612
353510;201312;1369;4526;1143;3890;330;1248;342;1008;672;2256
353520;201312;1141;3586;968;3252;390;1397;244;829;634;2226
353530;201312;2750;8427;2452;7869;662;2385;1072;3270;1734;5655
353540;201312;1949;6102;1790;5824;674;2277;652;2161;1326;4438
353550;201312;6726;19685;5977;18429;1189;4320;3311;9479;4500;13799
353560;201312;2198;7357;1828;6644;441;1865;702;2424;1143;4289
353570;201312;488;1579;408;1407;103;407;204;623;307;1030
353580;201312;2409;8042;2254;7756;779;3011;1158;3768;1937;6779
353590;201312;800;2340;681;2126;262;889;166;536;428;1425
353600;201312;1871;5478;1705;5189;393;1328;847;2584;1240;3912
353610;201312;590;2118;515;1953;148;633;158;570;306;1203
353620;201312;2356;8315;2130;7877;720;2900;709;2466;1429;5366
353625;201312;372;1044;263;846;104;373;61;163;165;536
353630;201312;1713;5927;1355;5048;345;1433;267;881;612;2314
353640;201312;1567;4603;1428;4323;379;1233;608;1865;987;3098
353650;201312;6659;20498;4660;15887;1050;3870;1752;5606;2802;9476
353657;201312;321;1077;289;1004;69;279;110;361;179;640
353660;201312;1377;3576;1028;3041;456;1494;161;326;617;1820
353670;201312;4822;16157;4217;14831;1374;5248;1349;4478;2723;9726
353680;201312;659;2389;623;2317;327;1266;162;597;489;1863
353690;201312;519;1449;357;1166;104;385;126;378;230;763
353700;201312;2320;7623;2038;6965;509;1963;646;2046;1155;4009
353710;201312;1981;7053;1644;6257;615;2594;517;1887;1132;4481
353715;201312;474;1426;408;1306;79;291;199;621;278;912
353720;201312;2088;6669;1828;6252;386;1354;1061;3753;1447;5107
353730;201312;4439;14110;3576;12083;920;3364;969;3022;1889;6386
353740;201312;2306;7117;1845;6132;634;2206;487;1554;1121;3760
353750;201312;685;2461;572;2172;191;783;143;556;334;1339
353760;201312;7194;23511;5990;21200;1906;7123;2360;8443;4266;15566
353770;201312;793;2527;501;1738;105;389;50;124;155;513
353780;201312;5848;21130;5289;19949;2531;9778;1258;4993;3789;14771
353790;201312;3109;11265;2775;10541;1012;4234;507;1947;1519;6181
353800;201312;14345;46998;11543;41348;3340;13116;4524;15624;7864;28740
353810;201312;1197;4030;1061;3721;330;1220;416;1450;746;2670
353820;201312;1212;4364;1161;4265;417;1746;457;1534;874;3280
353830;201312;793;2197;612;1843;138;462;245;715;383;1177
353850;201312;1843;6199;1724;5982;459;1724;832;2783;1291;4507
353860;201312;2432;8419;2051;7530;725;2861;641;2310;1366;5171
353870;201312;23433;74626;17729;62475;4272;16825;5998;19125;10270;35950
353880;201312;2270;7633;2072;7324;410;1702;1246;4257;1656;5959
353890;201312;2387;6356;1786;5370;528;1779;755;2140;1283;3919
353900;201312;1163;3684;852;2952;210;796;196;591;406;1387
353910;201312;2124;7582;2011;7276;667;2554;815;2986;1482;5540
353920;201312;2572;7794;1942;6427;470;1636;370;1127;840;2763
353930;201312;3767;13713;3284;12634;1208;4915;728;2737;1936;7652
353940;201312;1524;4954;1332;4544;334;1330;527;1638;861;2968
353950;201312;3634;12066;3340;11518;582;2323;2123;7125;2705;9448
353960;201312;588;1919;482;1661;113;435;136;398;249;833
353970;201312;526;1569;461;1481;55;223;332;1035;387;1258
353980;201312;14271;42959;12064;39318;3032;10641;6264;20179;9296;30820
353990;201312;516;1631;465;1501;147;521;169;481;316;1002
354000;201312;1903;5754;1304;4521;307;1194;132;390;439;1584
354010;201312;383;1217;343;1145;156;534;99;333;255;867
354020;201312;4690;14593;4245;13631;1467;5089;1613;4831;3080;9920
354025;201312;1054;3106;833;2686;229;814;198;611;427;1425
354030;201312;627;1700;439;1409;147;531;138;407;285;938
354040;201312;789;2181;629;1881;94;346;369;1027;463;1373
354050;201312;937;3196;858;3018;331;1264;226;773;557;2037
354060;201312;4604;15169;3699;13204;1015;3907;1488;5107;2503;9014
354070;201312;3649;12348;3158;11193;1166;4422;748;2610;1914;7032
354075;201312;2254;8631;2153;8444;766;3245;916;3527;1682;6772
354080;201312;1896;5943;1500;4950;412;1418;466;1425;878;2843
354085;201312;303;861;269;798;33;130;188;512;221;642
354090;201312;1160;3546;1100;3452;162;577;810;2495;972;3072
354100;201312;16822;58393;14524;54027;3993;15851;6470;24007;10463;39858
354105;201312;858;2797;713;2508;184;756;261;806;445;1562
354110;201312;837;2454;687;2221;186;676;221;665;407;1341
354120;201312;2227;6423;1900;5836;561;1921;654;1866;1215;3787
354130;201312;5205;16093;4517;14691;1727;5985;1302;3994;3029;9979
354140;201312;20093;54082;13150;40305;2682;9383;5473;15450;8155;24833
354150;201312;4474;12815;3574;11185;1086;3754;1418;4252;2504;8006
354160;201312;3993;13397;3524;12371;1055;3989;1401;4741;2456;8730
354165;201312;404;1535;370;1447;137;570;84;343;221;913
354170;201312;1620;5358;1320;4621;294;1176;467;1455;761;2631
354180;201312;513;1583;491;1538;54;202;347;1029;401;1231
354190;201312;1637;5581;1417;5057;497;1880;437;1500;934;3380
354200;201312;1147;3386;945;3006;223;839;370;1030;593;1869
354210;201312;851;3021;760;2799;182;794;299;1001;481;1795
354220;201312;3113;9954;2807;9342;970;3416;1080;3492;2050;6908
354230;201312;788;2650;743;2567;239;873;335;1159;574;2032
354240;201312;1321;4553;1079;4002;321;1303;253;876;574;2179
354250;201312;528;1738;441;1588;190;766;122;410;312;1176
354260;201312;9486;29158;8586;27671;2739;9697;3437;10945;6176;20642
354270;201312;1132;4101;1054;3921;333;1377;410;1520;743;2897
354280;201312;902;2704;844;2603;183;651;452;1382;635;2033
354290;201312;1315;4734;1204;4488;400;1593;315;1150;715;2743
354300;201312;3928;13869;3827;13664;1078;4051;1977;7026;3055;11077
354310;201312;790;2667;622;2241;181;707;142;508;323;1215
354320;201312;836;2553;716;2301;214;779;226;661;440;1440
354323;201312;342;1025;279;918;107;376;89;265;196;641
354325;201312;1306;4575;1186;4299;338;1372;423;1400;761;2772
354330;201312;7940;25291;7192;23776;2019;7239;3646;11668;5665;18907
354340;201312;29871;99024;25557;90880;9827;37495;8704;29963;18531;67458
354350;201312;1158;3528;1083;3390;322;1069;544;1639;866;2708
354360;201312;443;1449;363;1304;92;357;36;120;128;477
354370;201312;1153;3904;1016;3608;163;711;691;2370;854;3081
354380;201312;1316;4022;1092;3608;413;1523;181;510;594;2033
354390;201312;11547;38171;8698;31576;2285;9091;2479;8524;4764;17615
354400;201312;2110;7630;1841;6955;486;2019;565;2014;1051;4033
354410;201312;6365;19841;5334;18174;1307;4905;2762;9321;4069;14226
354420;201312;1670;5038;1387;4393;445;1520;446;1330;891;2850
354425;201312;3520;10333;3076;9517;1075;3568;934;2932;2009;6500
354430;201312;1367;4578;1257;4399;330;1305;594;1987;924;3292
354440;201312;534;1645;432;1441;96;358;172;550;268;908
354450;201312;482;1421;322;1060;59;253;93;259;152;512
354460;201312;792;2404;703;2242;263;889;295;928;558;1817
354470;201312;464;1391;374;1205;66;266;169;494;235;760
354480;201312;750;2318;669;2173;147;557;325;946;472;1503
354490;201312;754;2600;581;2148;149;594;183;590;332;1184
354500;201312;2549;8767;2330;8348;867;3395;682;2462;1549;5857
354510;201312;683;2338;614;2186;196;752;246;864;442;1616
354515;201312;350;1242;285;1082;70;301;84;294;154;595
354520;201312;5330;19208;4445;16983;1468;6214;1509;5509;2977;11723
354530;201312;2762;10161;2582;9801;775;3175;1348;5061;2123;8236
354540;201312;1361;4293;1185;3975;395;1406;426;1462;821;2868
354550;201312;532;1838;468;1667;103;386;171;574;274;960
354560;201312;1429;4401;1115;3684;329;1112;344;1101;673;2213
354570;201312;622;1971;514;1705;188;676;114;358;302;1034
354580;201312;8932;26715;7344;23621;1589;5804;3594;10933;5183;16737
354600;201312;1721;6022;1533;5645;509;2173;611;2078;1120;4251
354610;201312;467;1317;325;1022;67;223;97;261;164;484
354620;201312;425;1495;342;1332;101;468;115;405;216;873
354625;201312;276;935;235;847;62;253;58;197;120;450
354630;201312;1908;6771;1725;6321;734;2696;534;1877;1268;4573
354640;201312;4116;14041;3524;12708;1061;4301;798;2643;1859;6944
354650;201312;995;3086;903;2886;187;694;506;1549;693;2243
354660;201312;1961;6013;1537;5185;496;1874;560;1797;1056;3671
354670;201312;1655;5484;1308;4566;393;1511;325;952;718;2463
354680;201312;5316;18118;4860;17091;1432;5392;1821;6171;3253;11563
354690;201312;872;2982;598;2266;128;523;171;586;299;1109
354700;201312;1177;3397;786;2530;137;512;334;932;471;1444
354710;201312;626;1901;535;1714;147;564;175;492;322;1056
354720;201312;193;570;155;489;59;184;39;132;98;316
354730;201312;6675;23964;5943;22418;1833;7401;2455;8960;4288;16361
354740;201312;233;783;197;699;47;171;47;170;94;341
354750;201312;2309;7566;1975;7096;701;2716;718;2545;1419;5261
354760;201312;2197;7473;1870;6709;630;2384;433;1501;1063;3885
354765;201312;279;746;183;578;38;150;29;77;67;227
354770;201312;2803;8364;2246;7424;1016;3633;377;1156;1393;4789
354780;201312;34110;111678;31718;106055;8305;30683;15490;49188;23795;79871
354790;201312;867;2871;755;2668;216;824;312;1019;528;1843
354800;201312;1873;5725;1707;5491;471;1659;968;3116;1439;4775
354805;201312;882;2796;666;2302;110;440;121;379;231;819
354810;201312;681;2303;515;1932;177;728;86;306;263;1034
354820;201312;1046;3800;946;3579;313;1347;228;764;541;2111
354830;201312;434;1360;379;1252;120;458;132;397;252;855
354840;201312;796;2436;731;2309;233;786;259;797;492;1583
354850;201312;14652;48483;11287;41170;3184;12827;3893;13255;7077;26082
354860;201312;1272;4247;1159;4044;316;1328;536;1734;852;3062
354870;201312;42700;140002;40053;134375;12601;45218;18599;60739;31200;105957
354880;201312;4099;13128;3009;10616;904;3495;737;2305;1641;5800
354890;201312;14931;46843;12896;42686;3756;13612;4443;14013;8199;27625
354900;201312;604;1723;489;1559;167;588;177;550;344;1138
354910;201312;6390;20147;3692;13510;903;3628;457;1578;1360;5206
354920;201312;506;1517;385;1283;116;415;94;295;210;710
354925;201312;367;1080;215;752;44;170;36;109;80;279
354930;201312;255;793;234;741;73;266;64;195;137;461
354940;201312;2358;8462;1826;6975;755;3029;298;1080;1053;4109
354950;201312;1462;4982;1343;4812;254;1057;821;2886;1075;3943
354960;201312;787;2542;680;2353;201;772;244;815;445;1587
354970;201312;3946;13407;3486;12443;805;3275;1771;6018;2576;9293
354980;201312;32555;81873;18041;56193;4092;14245;6142;17672;10234;31917
354990;201312;35944;122668;33031;116438;7965;31052;17045;58205;25010;89257
354995;201312;1967;6299;1849;6119;481;1677;937;3137;1418;4814
355000;201312;1616;5551;1412;5171;520;2031;353;1270;873;3301
355010;201312;3669;11898;3117;10619;826;3124;1405;4674;2231;7798
355020;201312;3213;11735;2784;10872;1405;5801;687;2684;2092;8485
355030;201312;849944;2544074;780936;2406985;219157;732942;323469;972215;542626;1705157
355040;201312;2886;9730;2576;9125;918;3570;1157;3909;2075;7479
355050;201312;1245;4056;1024;3592;312;1175;265;920;577;2095
355060;201312;4886;17171;3913;14847;1113;4728;849;2899;1962;7627
355070;201312;6305;20318;5652;19175;1355;5271;2961;9473;4316;14744
355080;201312;1276;4769;1066;4163;348;1521;149;486;497;2007
355090;201312;1077;3950;910;3525;218;937;382;1404;600;2341
355100;201312;29420;97217;26342;91649;9575;35018;8784;31273;18359;66291
355110;201312;1300;4605;1187;4356;417;1664;375;1323;792;2987
355120;201312;655;2138;572;1968;184;686;221;726;405;1412
355130;201312;535;1494;346;1075;93;323;110;286;203;609
355140;201312;1025;3785;977;3672;309;1294;423;1532;732;2826
355150;201312;3440;11778;3005;10910;992;3767;1107;3870;2099;7637
355160;201312;1504;5331;1314;4995;556;2354;353;1181;909;3535
355170;201312;9341;27706;6767;22846;2334;8526;1792;5861;4126;14387
355180;201312;2864;9075;2493;8377;714;2756;940;2979;1654;5735
355190;201312;1273;4586;1171;4354;499;1898;332;1205;831;3103
355200;201312;900;3417;859;3326;434;1763;195;738;629;2501
355210;201312;2764;9729;2516;9181;781;3200;991;3333;1772;6533
355220;201312;29321;101911;26964;97088;12040;44924;7081;26186;19121;71110
355230;201312;1131;3421;728;2492;139;552;173;506;312;1058
355240;201312;21806;68539;16820;57126;4173;15781;6637;20841;10810;36622
355250;201312;24496;84249;22154;79595;6732;25912;9730;34418;16462;60330
355255;201312;890;2535;643;2011;119;406;192;571;311;977
355260;201312;1596;4767;1430;4456;398;1385;542;1563;940;2948
355270;201312;1663;5217;1578;5080;245;996;1114;3386;1359;4382
355280;201312;23211;71655;20352;66037;5238;19140;9136;28273;14374;47413
355290;201312;859;2817;794;2696;176;657;374;1211;550;1868
355300;201312;846;2811;651;2374;162;640;178;583;340;1223
355310;201312;1050;3291;939;3086;249;868;421;1416;670;2284
355320;201312;745;2418;658;2213;190;718;224;633;414;1351
355330;201312;1568;5750;1343;5302;494;2158;368;1331;862;3489
355340;201312;3143;8724;2908;8317;788;2512;1529;4135;2317;6647
355350;201312;1367;4931;1216;4580;418;1681;324;1219;742;2900
355360;201312;1177;4192;1104;4051;282;1160;696;2514;978;3674
355365;201312;310;998;260;893;74;285;66;216;140;501
355370;201312;6948;18557;5177;16470;1942;6751;1903;6063;3845;12814
355380;201312;3674;11344;2824;9329;820;2944;609;1731;1429;4675
355385;201312;985;3277;934;3179;391;1480;226;703;617;2183
355390;201312;1410;4006;1213;3608;338;1079;420;1216;758;2295
355395;201312;1684;5312;1326;4442;240;922;570;1745;810;2667
355400;201312;8774;31058;7998;29354;2828;11370;3005;10560;5833;21930
355410;201312;12792;48084;11964;46223;4845;19831;3238;12623;8083;32454
355420;201312;820;3048;782;2961;330;1318;246;944;576;2262
355430;201312;3619;10942;3151;10086;811;2861;1438;4451;2249;7312
355440;201312;886;2993;720;2551;215;794;181;565;396;1359
355450;201312;2532;8621;2125;7750;647;2608;665;2282;1312;4890
355460;201312;564;1650;439;1413;124;474;128;349;252;823
355465;201312;438;1360;370;1220;117;417;94;303;211;720
355470;201312;956;3018;774;2689;286;1112;245;780;531;1892
355475;201312;138;535;118;470;31;129;37;161;68;290
355480;201312;3219;11979;3024;11526;981;4021;1287;4766;2268;8787
355490;201312;821;2470;657;2133;193;695;150;482;343;1177
355495;201312;723;2456;682;2381;193;754;278;925;471;1679
355500;201312;8359;25761;5808;19943;1475;5611;1161;3601;2636;9212
355510;201312;2067;5893;1448;4644;337;1239;411;1220;748;2459
355520;201312;390;1036;261;787;57;198;71;182;128;380
355530;201312;220;566;115;364;26;92;22;67;48;159
355535;201312;713;2214;577;1931;162;647;177;489;339;1136
355540;201312;10220;33606;9682;32680;2829;10320;4730;15637;7559;25957
355550;201312;710;2281;664;2188;196;712;304;974;500;1686
355560;201312;1430;4293;1085;3605;273;1021;237;665;510;1686
355570;201312;188;644;160;571;43;157;37;123;80;280
355580;201312;1241;3810;1077;3472;407;1471;368;1117;775;2588
355590;201312;255;736;226;678;48;181;112;322;160;503
355600;201312;1049;3488;886;3092;381;1410;206;684;587;2094
355610;201312;1415;4213;1203;3871;367;1287;471;1452;838;2739
355620;201312;3900;12849;3156;11116;776;3112;1285;4103;2061;7215
355630;201312;3228;9595;2047;7019;442;1728;681;2116;1123;3844
355635;201312;991;3369;873;3150;191;767;505;1785;696;2552
355640;201312;3811;12908;3177;11357;1158;4339;581;2022;1739;6361
355645;201312;3387;12433;3215;12094;694;2887;1945;7222;2639;10109
355650;201312;6506;21072;5695;19433;1293;5246;3203;10136;4496;15382
355660;201312;1335;4390;1117;3955;359;1425;391;1288;750;2713
355670;201312;2167;7092;1490;5495;405;1706;476;1517;881;3223
355680;201312;1748;6106;1431;5311;544;2131;287;1016;831;3147
355690;201312;341;1198;305;1126;198;769;25;64;223;833
355695;201312;334;1032;247;823;35;119;19;48;54;167
355700;201312;6394;23221;5868;21894;1819;7366;2428;8649;4247;16015
355710;201312;12323;32482;7871;24078;2636;8614;1942;5691;4578;14305
355715;201312;222;687;157;552;42;160;30;102;72;262
355720;201312;1471;4943;1221;4379;419;1660;365;1171;784;2831
355730;201312;773;2744;703;2601;289;1132;157;588;446;1720
410010;201312;1634;5288;1472;4920;410;1489;439;1440;849;2929
410020;201312;1238;4289;1155;4113;373;1402;402;1410;775;2812
410030;201312;1073;3780;919;3395;288;1157;169;633;457;1790
410040;201312;12891;43817;11802;41513;4189;15781;3294;11410;7483;27191
410045;201312;1084;3167;822;2676;263;931;265;795;528;1726
410050;201312;3061;9026;2154;7260;718;2645;596;1934;1314;4579
410060;201312;1937;6331;1746;5933;558;2115;596;1939;1154;4054
410070;201312;2178;6304;1759;5415;668;2246;350;949;1018;3195
410080;201312;1448;4424;1223;4008;306;1080;617;1923;923;3003
410090;201312;1130;3652;1022;3413;367;1326;315;993;682;2319
410100;201312;2895;8876;2198;7272;670;2558;425;1269;1095;3827
410105;201312;502;1638;397;1381;97;389;74;221;171;610
410110;201312;2588;8210;2279;7546;584;2195;812;2599;1396;4794
410115;201312;558;1592;469;1399;101;347;155;416;256;763
410120;201312;2898;10105;2745;9865;1105;4211;1077;3940;2182;8151
410130;201312;1379;4707;1255;4405;386;1348;570;2026;956;3374
410140;201312;14947;42730;10748;34704;3287;11770;3687;11748;6974;23518
410150;201312;17753;45581;8651;26605;1851;6416;1737;4714;3588;11130
410160;201312;3342;10862;3041;10348;1021;3843;1055;3589;2076;7432
410165;201312;765;2346;637;2060;140;487;300;941;440;1428
410170;201312;1740;5483;1488;4928;590;2108;418;1338;1008;3446
410180;201312;8577;28033;7454;25516;1979;7692;3379;10727;5358;18419
410185;201312;659;1846;598;1738;171;532;336;986;507;1518
410190;201312;2186;6688;1936;6119;632;2163;519;1536;1151;3699
410200;201312;4978;14616;4121;12888;1429;4914;695;2077;2124;6991
410210;201312;2578;7994;2043;6809;509;1925;415;1187;924;3112
410220;201312;619;1830;492;1571;102;364;183;562;285;926
410230;201312;1836;6023;1680;5738;661;2482;563;1842;1224;4324
410240;201312;5183;16501;4759;15579;1592;5611;1685;5423;3277;11034
410250;201312;2469;7150;1830;5848;608;2177;371;1049;979;3226
410260;201312;1696;5378;1490;4979;451;1609;535;1745;986;3354
410270;201312;543;1632;475;1505;147;506;195;623;342;1129
410275;201312;910;2758;652;2208;115;429;354;1197;469;1626
410280;201312;2835;8637;2017;6790;466;1784;356;1126;822;2910
410290;201312;3232;10273;2868;9559;814;2902;1174;3923;1988;6825
410300;201312;613;1797;551;1668;86;318;304;843;390;1161
410302;201312;563;1675;480;1539;56;184;313;1027;369;1211
410304;201312;1451;4846;1322;4575;401;1439;556;1989;957;3428
410305;201312;2189;5946;1875;5485;545;1700;1017;3022;1562;4722
410310;201312;2309;7897;2119;7516;688;2649;751;2734;1439;5383
410315;201312;625;1950;483;1636;115;413;150;466;265;879
410320;201312;1233;3692;818;2804;178;700;70;206;248;906
410322;201312;581;1783;432;1441;120;421;122;397;242;818
410330;201312;1476;4239;1245;3785;360;1197;382;1106;742;2303
410335;201312;1051;3179;893;2883;249;911;328;987;577;1898
410337;201312;788;2170;677;1976;136;470;296;807;432;1277
410340;201312;573;1749;444;1417;87;314;125;331;212;645
410345;201312;1864;5719;1532;5005;502;1798;361;1087;863;2885
410347;201312;824;2397;588;1924;168;606;147;460;315;1066
410350;201312;1013;3270;773;2765;228;915;110;347;338;1262
410360;201312;3356;10542;3043;10012;1022;3640;906;2991;1928;6631
410370;201312;12775;38308;9691;31600;2615;9686;2836;8488;5451;18174
410380;201312;1365;4424;1269;4229;302;1075;687;2270;989;3345
410390;201312;2805;8389;2278;7414;850;2968;613;1840;1463;4808
410395;201312;884;3073;796;2866;219;902;367;1292;586;2194
410400;201312;5089;16863;4515;15720;1466;5698;1328;4458;2794;10156
410405;201312;946;2846;775;2499;217;824;297;873;514;1697
410410;201312;1352;4698;1280;4568;502;1974;294;1007;796;2981
410420;201312;9595;31911;8504;29405;2942;11063;2196;7058;5138;18121
410425;201312;3144;10322;2271;8259;535;2179;360;1246;895;3425
410430;201312;15276;43265;11642;36476;3461;11930;3437;10585;6898;22515
410440;201312;3552;11478;3261;10920;910;3294;1515;5071;2425;8365
410442;201312;2940;10404;2687;9786;942;3624;844;3080;1786;6704
410445;201312;2375;8104;2057;7509;655;2585;747;2850;1402;5435
410450;201312;2639;7659;2115;6624;677;2274;423;1194;1100;3468
410460;201312;2371;7260;1980;6430;542;1935;729;2250;1271;4185
410465;201312;1782;6777;1631;6393;608;2476;494;1829;1102;4305
410470;201312;1904;6178;1663;5600;518;1835;589;1982;1107;3817
410480;201312;29525;88395;24282;78057;9319;32624;6370;19593;15689;52217
410490;201312;11321;37635;9479;33498;3131;12048;3015;10482;6146;22530
410500;201312;1505;4893;1253;4314;482;1820;312;1070;794;2890
410510;201312;2363;6466;1780;5305;492;1600;728;2020;1220;3620
410520;201312;3210;11461;3053;11131;1200;4614;1034;3780;2234;8394
410530;201312;1642;4829;1388;4317;374;1350;528;1518;902;2868
410540;201312;3804;11253;2742;9181;728;2637;970;3212;1698;5849
410550;201312;6475;20532;5101;17343;1668;6253;774;2362;2442;8615
410560;201312;1257;4163;990;3453;238;876;260;782;498;1658
410570;201312;2818;9401;2583;9000;814;2933;1074;4008;1888;6941
410580;201312;25146;81486;22168;75114;7596;28184;6460;20692;14056;48876
410590;201312;1220;3993;836;2869;163;629;203;620;366;1249
410600;201312;1893;5815;1625;5283;477;1630;702;2285;1179;3915
410610;201312;828;2621;724;2420;204;735;307;980;511;1715
410620;201312;1704;6271;1541;5836;524;2094;384;1414;908;3508
410630;201312;2469;7454;2092;6707;574;2033;777;2388;1351;4421
410640;201312;4927;14799;3979;12975;1331;4901;935;2871;2266;7772
410645;201312;1282;4628;1226;4511;540;2145;346;1292;886;3437
410650;201312;2443;7653;2025;6797;717;2557;505;1603;1222;4160
410655;201312;917;2857;767;2545;239;870;216;692;455;1562
410657;201312;621;1926;529;1736;154;592;199;576;353;1168
410660;201312;3812;11277;2994;9476;1105;3755;616;1804;1721;5559
410670;201312;995;2902;764;2427;204;719;195;579;399;1298
410680;201312;2389;8534;2016;7524;566;2147;693;2727;1259;4874
410685;201312;666;2057;624;1982;116;359;408;1319;524;1678
410690;201312;107032;316381;74982;248841;19038;70206;18684;55807;37722;126013
410700;201312;2267;7478;2134;7215;707;2618;858;2767;1565;5385
410710;201312;1077;3438;886;2978;243;910;231;710;474;1620
410712;201312;756;2401;674;2231;314;1124;166;577;480;1701
410715;201312;1044;3367;916;3082;244;895;321;1043;565;1938
410720;201312;4071;12980;3403;11496;1053;3790;939;3016;1992;6806
410725;201312;1125;3306;831;2701;220;777;236;680;456;1457
410730;201312;711;2193;648;2053;285;959;169;519;454;1478
410740;201312;949;2906;681;2340;159;629;296;997;455;1626
410750;201312;1803;5577;1592;5071;539;1914;453;1312;992;3226
410752;201312;262;792;220;712;49;192;102;299;151;491
410753;201312;455;1397;354;1183;75;287;141;439;216;726
410754;201312;995;3100;876;2895;119;435;590;2012;709;2447
410755;201312;722;2043;577;1794;121;443;285;823;406;1266
410760;201312;2438;8081;2327;7863;904;3253;803;2636;1707;5889
410765;201312;15540;47545;11764;39680;2953;11049;2126;6994;5079;18043
410770;201312;890;2584;744;2298;257;869;203;571;460;1440
410773;201312;1185;3766;1063;3532;284;1053;489;1498;773;2551
410775;201312;1818;5468;1749;5348;503;1482;1046;3352;1549;4834
410780;201312;584;1753;463;1533;141;490;151;554;292;1044
410785;201312;921;3058;747;2543;264;934;271;925;535;1859
410790;201312;595;1851;488;1595;132;509;100;261;232;770
410800;201312;2404;6903;2001;6170;812;2756;607;1769;1419;4525
410810;201312;324;1021;260;864;34;130;113;368;147;498
410820;201312;1058;3274;913;2936;265;941;229;723;494;1664
410830;201312;30725;94540;25657;85213;8077;29269;8640;28415;16717;57684
410832;201312;1165;3558;1063;3364;246;924;525;1520;771;2444
410840;201312;7348;23508;6031;20481;2073;7680;1170;3564;3243;11244
410845;201312;1583;4837;1400;4461;276;963;785;2522;1061;3485
410850;201312;2746;8275;2468;7870;560;2069;1323;4184;1883;6253
410855;201312;730;2096;611;1851;170;561;207;617;377;1178
410860;201312;3631;10749;3115;9798;782;2572;1460;4760;2242;7332
410865;201312;1662;5851;1498;5521;416;1654;710;2669;1126;4323
410870;201312;1368;4309;1292;4183;650;2285;324;975;974;3260
410880;201312;4492;13590;3605;11905;992;3811;885;2519;1877;6330
410890;201312;1092;3443;835;2943;274;1059;109;318;383;1377
410895;201312;1070;3831;969;3597;358;1415;310;1102;668;2517
410900;201312;863;2498;677;2189;140;511;212;656;352;1167
410910;201312;317;999;282;935;62;224;136;426;198;650
410920;201312;827;2589;674;2300;211;777;189;595;400;1372
410930;201312;2066;6572;1802;6110;562;2206;644;2075;1206;4281
410940;201312;20664;71241;18560;67210;6260;24666;7405;26876;13665;51542
410950;201312;1896;6359;1724;6032;374;1371;1003;3568;1377;4939
410960;201312;6496;18795;4552;15121;1529;5513;1430;4819;2959;10332
410965;201312;1064;3451;949;3207;270;987;406;1380;676;2367
410970;201312;5142;15939;4257;14089;1478;5488;958;3171;2436;8659
410975;201312;1433;4322;1209;3918;223;853;617;2001;840;2854
410980;201312;5193;15752;3515;12060;946;3612;826;2687;1772;6299
410990;201312;1056;3312;805;2750;253;958;208;634;461;1592
411000;201312;453;1409;331;1131;77;300;50;144;127;444
411005;201312;482;1461;361;1149;97;313;60;166;157;479
411007;201312;2132;7029;2003;6775;633;2274;914;3184;1547;5458
411010;201312;3914;13672;3622;12983;1389;5466;828;2708;2217;8174
411020;201312;2583;8444;2361;8048;804;3075;830;2837;1634;5912
411030;201312;810;2294;705;2100;232;762;193;529;425;1291
411040;201312;384;1259;316;1095;105;386;70;234;175;620
411050;201312;2123;7751;1882;7144;696;2837;355;1278;1051;4115
411060;201312;2080;6722;1814;6151;583;2202;310;927;893;3129
411065;201312;395;1220;317;1059;57;199;108;333;165;532
411070;201312;4312;14317;3271;11864;1063;4259;422;1347;1485;5606
411080;201312;2011;6462;1851;6124;496;1845;788;2582;1284;4427
411090;201312;615;1608;484;1424;90;322;120;316;210;638
411095;201312;1565;4617;1242;3985;313;1125;321;986;634;2111
411100;201312;1488;4364;1109;3601;263;958;259;801;522;1759
411110;201312;924;2833;697;2321;207;734;109;303;316;1037
411120;201312;1700;5451;1493;5014;484;1761;460;1505;944;3266
411125;201312;4669;15450;4531;15166;1619;5732;2111;6941;3730;12673
411130;201312;769;2410;638;2125;189;663;216;724;405;1387
411140;201312;2187;7944;1895;7166;708;2809;384;1536;1092;4345
411150;201312;5928;17041;4920;15055;1461;4852;1245;3451;2706;8303
411155;201312;1158;3534;1042;3274;363;1262;341;981;704;2243
411160;201312;309;950;275;882;107;358;82;250;189;608
411170;201312;796;2748;721;2567;215;818;232;811;447;1629
411180;201312;6161;19243;5379;17725;1657;5987;1636;5306;3293;11293
411190;201312;1779;5343;1495;4798;448;1595;449;1352;897;2947
411200;201312;4004;12742;3463;11815;1241;4652;1273;4191;2514;8843
411210;201312;2780;8161;2276;7223;872;3001;341;1019;1213;4020
411220;201312;1192;3513;966;3081;247;906;401;1155;648;2061
411230;201312;1064;3303;821;2751;271;1005;207;633;478;1638
411240;201312;1391;3479;828;2579;257;888;200;540;457;1428
411250;201312;3120;8836;2553;7776;787;2498;802;2438;1589;4936
411260;201312;264;774;204;668;60;224;86;256;146;480
411270;201312;2026;6551;1866;6264;602;2243;789;2562;1391;4805
411275;201312;1524;4680;1324;4214;389;1274;348;1056;737;2330
411280;201312;1733;5450;1380;4663;408;1571;220;654;628;2225
411290;201312;1026;2935;848;2588;226;749;302;951;528;1700
411295;201312;1041;3171;958;3019;208;735;409;1255;617;1990
411300;201312;1301;3427;903;2642;90;309;377;1008;467;1317
411310;201312;830;2459;665;2167;154;592;293;917;447;1509
411320;201312;5566;17442;4567;15367;1295;4571;1227;4001;2522;8572
411325;201312;1539;5066;1387;4757;205;808;909;3120;1114;3928
411330;201312;3516;11732;3198;11152;1268;4756;938;3234;2206;7990
411340;201312;983;2931;655;2149;154;575;245;791;399;1366
411342;201312;900;2610;722;2211;208;707;191;503;399;1210
411345;201312;1051;3433;975;3287;281;1038;480;1616;761;2654
411350;201312;2572;8236;1952;6908;636;2445;266;846;902;3291
411360;201312;513;1320;325;957;47;187;135;319;182;506
411370;201312;42749;127007;32570;107152;7552;29190;11273;33794;18825;62984
411373;201312;1400;4567;1199;4129;345;1371;293;950;638;2321
411375;201312;1083;3171;909;2793;254;835;282;797;536;1632
411380;201312;1268;3465;793;2460;146;515;241;714;387;1229
411390;201312;1789;5561;1618;5318;363;1345;959;3055;1322;4400
411400;201312;1665;5142;1365;4465;335;1237;441;1388;776;2625
411410;201312;2409;7665;2114;6978;716;2697;552;1535;1268;4232
411420;201312;4471;13174;3486;11047;984;3485;719;1965;1703;5450
411430;201312;2825;9331;2435;8595;753;2860;1031;3516;1784;6376
411435;201312;560;1841;481;1638;130;484;166;544;296;1028
411440;201312;2572;8590;2369;8201;903;3358;684;2428;1587;5786
411450;201312;2005;6260;1839;5990;457;1579;986;3231;1443;4810
411460;201312;4292;13965;3374;11747;1304;4800;614;2010;1918;6810
411470;201312;915;2880;660;2216;181;661;116;348;297;1009
411480;201312;4550;14325;3722;12703;1680;6200;773;2480;2453;8680
411490;201312;1649;5311;1479;5006;636;2424;348;1042;984;3466
411500;201312;1486;4520;1130;3767;359;1310;268;842;627;2152
411510;201312;2438;7309;1932;6284;622;2245;382;1072;1004;3317
411520;201312;27655;80570;18949;62119;6298;22738;3901;12018;10199;34756
411530;201312;893;2617;612;2076;248;950;108;308;356;1258
411535;201312;446;1355;221;806;42;179;21;67;63;246
411540;201312;2981;8260;2387;7161;480;1533;1268;3886;1748;5419
411545;201312;1007;3630;945;3501;224;914;588;2162;812;3076
411550;201312;719;2043;580;1806;254;866;127;362;381;1228
411560;201312;2554;7903;2130;6898;609;2163;483;1467;1092;3630
411570;201312;5886;16671;4475;14239;1348;4798;1107;3664;2455;8462
411573;201312;977;3077;932;2998;234;819;490;1594;724;2413
411575;201312;1427;4725;1246;4313;339;1252;473;1615;812;2867
411580;201312;3498;10676;2677;9003;643;2506;486;1426;1129;3932
411585;201312;478;1700;368;1378;91;365;56;197;147;562
411590;201312;566;1724;511;1606;137;498;148;438;285;936
411600;201312;363;1124;301;999;68;276;76;256;144;532
411605;201312;2291;6542;1707;5415;461;1617;651;1982;1112;3599
411610;201312;2184;6562;2079;6376;519;1712;1311;3948;1830;5660
411620;201312;2690;9069;2536;8801;866;3243;1013;3585;1879;6828
411630;201312;697;1924;429;1478;134;532;80;239;214;771
411640;201312;586;1832;486;1614;138;505;175;536;313;1041
411650;201312;186;611;164;568;43;171;55;170;98;341
411660;201312;787;2363;680;2155;188;628;281;906;469;1534
411670;201312;1680;5006;1499;4658;495;1748;520;1485;1015;3233
411680;201312;1664;5241;1470;4905;384;1275;800;2845;1184;4120
411690;201312;3570;10973;3027;9954;1090;3850;770;2520;1860;6370
411695;201312;818;2671;694;2420;145;520;344;1215;489;1735
411700;201312;1826;5482;1395;4643;383;1440;382;1195;765;2635
411705;201312;2242;7838;1969;7310;481;1833;1136;4331;1617;6164
411710;201312;2151;6761;1703;5704;517;1895;360;1063;877;2958
411720;201312;668;2051;512;1669;107;395;137;420;244;815
411721;201312;714;2181;599;1928;179;634;149;421;328;1055
411722;201312;672;2082;547;1819;143;544;164;495;307;1039
411725;201312;1289;4254;914;3328;241;954;226;823;467;1777
411727;201312;2321;6793;1888;5856;504;1718;771;2273;1275;3991
411729;201312;524;1492;414;1307;77;265;159;465;236;730
411730;201312;5523;16687;4726;15142;1515;5240;1698;5407;3213;10647
411740;201312;518;1562;417;1344;122;462;162;471;284;933
411745;201312;859;2742;705;2354;182;673;172;526;354;1199
411750;201312;4156;13305;3319;11193;1038;3865;591;1818;1629;5683
411760;201312;8614;26487;7823;25124;2911;9931;2466;8236;5377;18167
411770;201312;3792;13682;3385;12663;1333;5204;748;2840;2081;8044
411780;201312;2986;10050;2883;9919;416;1382;2092;7595;2508;8977
411790;201312;2374;7148;1904;6219;627;2345;583;1812;1210;4157
411800;201312;1222;3755;782;2656;143;537;116;290;259;827
411810;201312;1520;4833;1322;4372;382;1445;354;985;736;2430
411820;201312;16271;51987;13652;47068;4809;17086;4164;15140;8973;32226
411830;201312;432;1207;358;1108;114;346;140;472;254;818
411840;201312;8570;26348;7006;23195;2150;7819;1960;6284;4110;14103
411845;201312;508;1664;396;1412;114;437;78;273;192;710
411850;201312;5940;18547;4974;16543;1385;4987;1393;4576;2778;9563
411860;201312;855;2806;721;2497;205;759;202;646;407;1405
411870;201312;1012;3641;804;3060;142;582;203;723;345;1305
411880;201312;2463;7170;2078;6524;493;1733;1031;3226;1524;4959
411885;201312;1422;4005;1155;3572;360;1242;350;972;710;2214
411890;201312;1303;4093;941;3228;263;1011;195;575;458;1586
411900;201312;912;3000;704;2455;225;803;107;366;332;1169
411910;201312;1196;4192;1057;3865;320;1297;349;1194;669;2491
411915;201312;11572;34245;7912;26222;1988;7364;1867;5513;3855;12877
411920;201312;983;3576;883;3305;275;1124;191;676;466;1800
411925;201312;592;1762;470;1536;145;500;152;486;297;986
411930;201312;6058;20509;5382;19107;1869;7072;1882;6781;3751;13853
411940;201312;3566;12221;3212;11428;1060;3975;875;3092;1935;7067
411950;201312;10321;34219;9000;31645;2796;10708;3862;13335;6658;24043
411960;201312;5370;16747;5048;16122;1407;5018;2315;7146;3722;12164
411965;201312;516;1655;407;1443;109;438;112;397;221;835
411970;201312;745;2212;596;1959;210;748;145;450;355;1198
411980;201312;2085;5866;1478;4878;194;713;810;2664;1004;3377
411990;201312;28244;99222;24752;91601;9353;36851;6482;24310;15835;61161
411995;201312;3016;9734;2760;9216;1139;4086;713;2331;1852;6417
412000;201312;2015;5695;1631;5014;360;1278;667;1807;1027;3085
412010;201312;708;2442;623;2240;179;671;186;653;365;1324
412015;201312;638;2025;530;1791;105;392;276;919;381;1311
412020;201312;429;1282;327;1074;115;415;125;381;240;796
412030;201312;589;1881;405;1432;90;380;120;388;210;768
412033;201312;709;2248;545;1854;138;516;96;288;234;804
412035;201312;945;2801;771;2481;199;743;304;901;503;1644
412040;201312;723;2435;653;2252;249;909;193;646;442;1555
412050;201312;1574;4833;1237;4082;318;1170;275;865;593;2035
412060;201312;6735;24091;6193;22792;1983;7779;2357;8601;4340;16380
412065;201312;970;3013;826;2706;243;899;236;713;479;1612
412070;201312;1096;3188;977;2927;212;696;388;1138;600;1834
412080;201312;1924;6217;1404;5016;407;1597;152;468;559;2065
412085;201312;284;811;170;585;49;187;42;132;91;319
412090;201312;4803;16146;4596;15755;1022;3803;2900;10037;3922;13840
412100;201312;2198;7083;1938;6615;650;2351;673;2268;1323;4619
412110;201312;1016;3075;783;2585;268;935;243;785;511;1720
412120;201312;2329;8073;2131;7608;568;2243;1016;3471;1584;5714
412125;201312;963;3031;854;2847;258;938;324;1081;582;2019
412130;201312;744;2169;546;1785;117;439;121;366;238;805
412135;201312;555;1621;419;1329;90;315;182;523;272;838
412140;201312;1817;5663;1531;5077;450;1603;444;1468;894;3071
412150;201312;2778;8478;2446;7804;441;1552;1380;4298;1821;5850
412160;201312;1189;3810;922;3145;279;1071;324;1057;603;2128
412170;201312;4333;14820;3759;13642;1347;5195;1278;4580;2625;9775
412175;201312;1482;5255;1339;4926;396;1590;523;1946;919;3536
412180;201312;1720;5572;1349;4897;529;2120;357;1218;886;3338
412190;201312;2942;9136;2484;8365;966;3440;648;2292;1614;5732
412200;201312;2241;7678;1630;5943;398;1552;495;1774;893;3326
412210;201312;730;2123;449;1491;114;444;91;274;205;718
412215;201312;3156;10557;2868;10008;511;1837;1834;6612;2345;8449
412217;201312;1161;3501;1106;3401;226;800;685;1980;911;2780
412220;201312;5629;19078;5400;18623;1931;7035;2650;9086;4581;16121
412230;201312;2866;10080;2554;9371;835;3353;711;2490;1546;5843
412240;201312;8458;23407;4962;16254;1099;4025;716;2065;1815;6090
412250;201312;2161;6753;1951;6314;741;2605;461;1364;1202;3969
412260;201312;1291;3919;863;2969;204;813;255;755;459;1568
412265;201312;1155;3746;1072;3594;288;1165;494;1577;782;2742
412270;201312;756;2567;595;2155;141;576;100;333;241;909
412280;201312;667;2099;532;1817;166;603;243;804;409;1407
412290;201312;1207;3470;1014;3083;220;752;391;1129;611;1881
412300;201312;1759;5327;1459;4732;474;1743;394;1194;868;2937
412310;201312;1193;3464;1040;3259;217;584;679;2362;896;2946
412320;201312;690;1927;505;1596;137;509;177;532;314;1041
412330;201312;1977;5520;1512;4697;391;1325;670;2048;1061;3373
412340;201312;790;2559;563;1976;115;446;111;360;226;806
412350;201312;2457;8000;2064;7083;656;2441;399;1251;1055;3692
412360;201312;338;1104;291;980;66;236;79;225;145;461
412370;201312;1122;3558;885;3084;314;1142;245;845;559;1987
412380;201312;2007;6173;1741;5604;438;1475;671;2255;1109;3730
412382;201312;700;2047;516;1644;145;534;141;401;286;935
412385;201312;2469;8061;2287;7674;677;2385;865;3009;1542;5394
412390;201312;2404;7340;2230;7048;834;2873;773;2392;1607;5265
412395;201312;965;2732;783;2439;133;437;478;1509;611;1946
412400;201312;1189;3734;1062;3495;339;1198;421;1416;760;2614
412402;201312;2044;6450;1735;5776;549;1986;464;1408;1013;3394
412405;201312;4000;11858;2603;8735;665;2568;277;811;942;3379
412410;201312;6188;20607;5605;19392;2468;9329;1072;3621;3540;12950
412420;201312;522;1584;429;1410;138;503;115;322;253;825
412430;201312;453;1383;380;1225;119;429;154;449;273;878
412440;201312;3982;12199;3513;11377;692;2481;1509;5101;2201;7582
412450;201312;385;1229;315;1056;74;278;64;169;138;447
412460;201312;984;2818;677;2227;172;656;158;483;330;1139
412470;201312;2028;7040;1853;6613;616;2344;661;2339;1277;4683
412480;201312;1323;3983;962;3179;224;809;175;476;399;1285
412490;201312;1276;3854;1141;3540;304;980;328;1007;632;1987
412500;201312;2008;6113;1693;5473;507;1831;428;1227;935;3058
412510;201312;2735;9442;2411;8581;828;3179;782;2677;1610;5856
412520;201312;1801;5179;1394;4483;401;1384;485;1549;886;2933
412530;201312;790;2399;659;2109;212;718;164;503;376;1221
412535;201312;416;1274;293;959;79;281;95;264;174;545
412540;201312;1205;3612;932;3016;179;682;377;1196;556;1878
412545;201312;899;2607;740;2262;145;490;260;708;405;1198
412550;201312;23759;73509;16504;56824;4748;17706;3229;10291;7977;27997
412555;201312;310;987;226;765;50;183;42;115;92;298
412560;201312;4263;14580;3659;13268;1182;4714;760;2455;1942;7169
412570;201312;4297;13456;3338;11197;982;3606;715;2312;1697;5918
412575;201312;1044;3359;866;2923;221;841;273;850;494;1691
412580;201312;1467;4095;1080;3416;258;880;357;1069;615;1949
412590;201312;482;1510;393;1347;157;570;94;323;251;893
412600;201312;1466;4776;1280;4383;433;1636;380;1214;813;2850
412610;201312;762;2500;622;2150;206;796;158;476;364;1272
412620;201312;1246;4189;1074;3812;394;1521;250;851;644;2372
412625;201312;13693;39527;11443;35237;4241;14089;2435;7374;6676;21463
412627;201312;957;3022;686;2427;226;860;81;274;307;1134
412630;201312;3490;11367;3096;10482;861;3132;952;3109;1813;6241
412635;201312;529;1636;386;1311;96;335;54;164;150;499
412640;201312;863;2652;624;2089;143;533;129;392;272;925
412650;201312;2266;6527;1826;5708;505;1729;648;1795;1153;3524
412660;201312;3036;9320;2522;8231;658;2461;621;1882;1279;4343
412665;201312;722;1972;453;1487;139;507;130;399;269;906
412667;201312;1467;4494;1176;3889;307;1175;345;1038;652;2213
412670;201312;648;2072;442;1561;112;457;65;175;177;632
412680;201312;1465;4901;1218;4281;345;1295;329;1051;674;2346
412690;201312;665;2142;534;1838;189;716;84;270;273;986
412700;201312;1835;6141;1615;5755;616;2446;561;1921;1177;4367
412710;201312;8818;28090;7335;24941;2128;7896;1845;5988;3973;13884
412720;201312;1622;5193;1126;3901;270;1005;120;329;390;1334
412730;201312;2789;8563;1964;6769;604;2234;256;786;860;3020
412740;201312;2117;7047;1888;6505;749;2745;260;934;1009;3679
412750;201312;3416;11550;3174;11101;640;2522;2069;7071;2709;9593
412760;201312;2252;7644;2150;7460;675;2603;848;2772;1523;5375
412770;201312;11642;34902;7787;26249;1861;6999;1623;4945;3484;11944
412780;201312;1469;4922;1306;4534;401;1486;389;1273;790;2759
412785;201312;2437;7271;1831;5991;593;2098;712;2257;1305;4355
412788;201312;1335;4531;1254;4374;339;1379;532;1725;871;3104
412790;201312;1124;3626;945;3222;211;797;291;886;502;1683
412795;201312;1031;3105;883;2822;302;1052;272;819;574;1871
412796;201312;2600;8433;2419;8051;644;2378;1096;3503;1740;5881
412800;201312;3504;10646;2808;9272;776;2819;841;2600;1617;5419
412810;201312;9653;27932;6222;20223;1790;6382;1452;4243;3242;10625
412820;201312;6213;19501;4679;16358;1428;5420;991;3477;2419;8897
412830;201312;402;1314;343;1197;102;420;82;236;184;656
412840;201312;2238;6537;1853;5770;550;1911;449;1348;999;3259
412850;201312;2532;7819;2223;7368;426;1631;1137;3630;1563;5261
412853;201312;1632;4958;1453;4641;265;1065;814;2382;1079;3447
412855;201312;1652;4893;1349;4299;467;1709;350;956;817;2665
412860;201312;1254;3895;1102;3617;288;1079;499;1562;787;2641
412862;201312;800;2239;625;1882;176;587;216;604;392;1191
412863;201312;1203;4197;1156;4108;179;688;798;2814;977;3502
412865;201312;660;2093;490;1670;112;419;174;604;286;1023
412870;201312;1024;3020;878;2786;326;1129;279;881;605;2010
412880;201312;1577;4358;1315;3920;388;1271;327;918;715;2189
420005;201312;481;1534;343;1214;74;286;150;501;224;787
420010;201312;3212;10195;2759;9420;446;1626;1914;6607;2360;8233
420020;201312;752;2547;468;1749;82;348;65;208;147;556
420030;201312;500;1500;304;1097;90;369;53;169;143;538
420040;201312;1004;3177;678;2518;226;936;150;488;376;1424
420050;201312;793;2571;649;2230;204;725;238;802;442;1527
420055;201312;318;1038;220;803;58;223;47;151;105;374
420060;201312;378;1350;286;1105;71;297;36;129;107;426
420070;201312;2008;6505;1717;5764;330;1229;748;2603;1078;3832
420075;201312;186;576;113;389;30;119;30;83;60;202
420080;201312;560;1929;499;1795;181;714;104;358;285;1072
420090;201312;683;2458;516;2028;135;545;95;384;230;929
420100;201312;1481;4884;1372;4728;367;1298;820;2862;1187;4160
420110;201312;447;1550;403;1448;130;474;158;582;288;1056
420120;201312;314;1118;259;993;110;454;44;153;154;607
420125;201312;357;1505;343;1471;135;617;94;373;229;990
420127;201312;587;1861;273;1036;94;384;34;123;128;507
420130;201312;2698;9428;2409;8830;758;3145;890;2970;1648;6115
420140;201312;4801;14597;3537;12149;1086;4168;801;2564;1887;6732
420150;201312;739;2284;525;1782;171;625;138;416;309;1041
420160;201312;296;897;191;649;48;193;35;92;83;285
420165;201312;208;694;143;518;24;93;35;131;59;224
420170;201312;233;781;165;637;62;282;18;51;80;333
420180;201312;448;1468;270;995;74;277;69;239;143;516
420190;201312;554;1798;371;1409;136;569;57;191;193;760
420195;201312;1400;4087;1116;3685;294;1065;532;1788;826;2853
420200;201312;2884;9557;1865;7143;627;2682;308;1017;935;3699
420205;201312;1049;3581;944;3373;307;1188;382;1350;689;2538
420207;201312;1297;3945;948;3192;302;1135;252;770;554;1905
420208;201312;549;1729;410;1438;163;605;119;413;282;1018
420209;201312;348;1173;221;825;45;177;53;203;98;380
420210;201312;1738;5804;1169;4564;335;1502;166;575;501;2077
420213;201312;858;3232;819;3144;179;716;531;2047;710;2763
420215;201312;481;1643;363;1288;113;430;64;211;177;641
420220;201312;423;1673;394;1598;168;733;79;278;247;1011
420230;201312;4464;14119;3509;12298;910;3590;1732;5917;2642;9507
420240;201312;12297;38621;8526;30671;1998;8558;3372;10798;5370;19356
420243;201312;571;1830;465;1588;129;510;144;476;273;986
420245;201312;1113;3608;809;2951;218;929;180;563;398;1492
420250;201312;842;2744;788;2656;304;1118;303;1033;607;2151
420253;201312;664;1764;547;1605;124;381;260;842;384;1223
420257;201312;428;1348;331;1155;96;334;149;522;245;856
420260;201312;1353;4625;1216;4355;367;1440;548;1949;915;3389
420270;201312;496;1644;247;926;34;134;26;84;60;218
420280;201312;2318;6746;1565;5383;429;1734;532;1605;961;3339
420285;201312;148;438;52;194;9;38;1;2;10;40
420287;201312;651;2036;559;1852;147;529;222;729;369;1258
420290;201312;6110;18589;3951;13491;1006;3784;1271;4013;2277;7797
420300;201312;5393;17303;3623;13342;978;4098;702;2565;1680;6663
420310;201312;844;2609;807;2543;189;640;486;1473;675;2113
420315;201312;951;3230;755;2805;202;843;305;1130;507;1973
420320;201312;4737;15566;4047;14284;1272;5058;1569;5292;2841;10350
420325;201312;467;1534;448;1483;154;574;138;437;292;1011
420330;201312;1272;4525;1009;3780;354;1451;182;552;536;2003
420340;201312;1483;4716;1178;3963;282;1033;365;1168;647;2201
420350;201312;1589;5204;1381;4771;413;1540;579;1998;992;3538
420360;201312;3622;11919;2812;10043;1045;4072;485;1594;1530;5666
420370;201312;1979;5724;1766;5440;243;772;1409;4319;1652;5091
420380;201312;5404;18592;4587;16622;1487;5839;1186;4215;2673;10054
420390;201312;2058;6286;1254;4509;423;1657;269;864;692;2521
420395;201312;2040;6452;1529;5240;409;1589;330;993;739;2582
420400;201312;1481;4533;1126;3824;348;1366;352;1102;700;2468
420410;201312;788;2253;580;1900;159;584;269;866;428;1450
420415;201312;507;1641;408;1388;122;449;142;473;264;922
420417;201312;799;2641;686;2378;153;539;320;1124;473;1663
420419;201312;423;1401;322;1217;158;635;76;291;234;926
420420;201312;14853;46705;11608;39718;3914;14540;3569;12003;7483;26543
420425;201312;1190;3379;745;2393;108;435;327;949;435;1384
420430;201312;4098;13123;2812;10033;859;3362;746;2579;1605;5941
420435;201312;200;691;147;550;68;283;24;82;92;365
420440;201312;1481;4409;911;3192;340;1291;151;468;491;1759
420445;201312;445;1313;341;1126;94;326;149;498;243;824
420450;201312;1273;3816;744;2686;182;748;149;435;331;1183
420455;201312;2266;7152;2023;6713;624;2381;829;2632;1453;5013
420460;201312;9624;31077;7849;27579;2365;9385;2920;9738;5285;19123
420470;201312;1191;3410;814;2690;246;886;243;786;489;1672
420475;201312;181;595;116;428;42;159;25;97;67;256
420480;201312;6013;18352;4963;16513;2067;7628;807;2574;2874;10202
420490;201312;709;2472;582;2179;178;698;147;516;325;1214
420500;201312;2125;6680;1760;6002;537;1992;871;2966;1408;4958
420510;201312;182;795;177;772;74;333;38;148;112;481
420515;201312;159;586;128;506;41;173;20;77;61;250
420517;201312;947;2958;863;2783;134;458;562;1835;696;2293
420519;201312;409;1191;304;963;62;199;117;382;179;581
420520;201312;727;2206;599;1994;173;626;242;775;415;1401
420530;201312;1360;4811;1117;4171;372;1532;256;833;628;2365
420535;201312;254;781;178;616;57;212;36;112;93;324
420540;201312;18565;57589;14277;48377;5046;18902;4118;13135;9164;32037
420543;201312;493;1355;361;1127;53;181;210;690;263;871
420545;201312;1550;5115;1270;4470;381;1507;374;1229;755;2736
420550;201312;4761;15957;4020;14187;1234;4889;1256;4328;2490;9217
420555;201312;464;1522;383;1337;144;547;110;375;254;922
420560;201312;587;1778;484;1560;87;311;246;800;333;1111
420570;201312;1951;6568;1585;5659;491;1968;460;1529;951;3497
420580;201312;1075;3707;914;3410;284;1155;410;1550;694;2705
420590;201312;3259;10515;2391;8462;620;2407;487;1588;1107;3995
420600;201312;853;3032;767;2817;221;884;311;1148;532;2032
420610;201312;612;2049;442;1644;141;578;73;241;214;819
420620;201312;1203;3851;1068;3595;409;1500;244;794;653;2294
420630;201312;1058;3522;836;2939;266;1034;237;697;503;1731
420640;201312;616;2098;326;1299;84;389;33;137;117;526
420650;201312;2143;6744;1203;4400;245;1013;214;652;459;1665
420660;201312;666;2019;547;1791;113;414;284;906;397;1320
420665;201312;786;2325;507;1715;93;359;179;524;272;883
420670;201312;1723;5645;1302;4651;344;1366;217;702;561;2068
420675;201312;233;763;167;601;41;166;76;249;117;415
420680;201312;508;1293;315;979;64;240;103;297;167;537
420690;201312;779;2747;567;2136;138;593;177;602;315;1195
420700;201312;5929;18472;4900;16279;1667;6159;1294;4054;2961;10213
420710;201312;744;2768;642;2547;245;1040;162;616;407;1656
420720;201312;1982;6214;1710;5837;496;1775;941;3216;1437;4991
420730;201312;4629;14723;4035;13615;1514;5432;1406;4670;2920;10102
420740;201312;748;2558;729;2526;183;678;468;1599;651;2277
420750;201312;2437;8116;1763;6422;412;1728;536;1708;948;3436
420757;201312;115;406;98;376;26;111;26;94;52;205
420760;201312;433;1434;313;1084;73;275;98;333;171;608
420765;201312;571;2018;406;1552;129;536;84;308;213;844
420768;201312;1264;4566;1087;4147;375;1498;376;1484;751;2982
420770;201312;878;2844;582;2140;182;733;151;520;333;1253
420775;201312;653;2137;495;1729;141;509;141;472;282;981
420780;201312;1685;5271;1192;4053;345;1264;343;1096;688;2360
420785;201312;323;1010;224;753;31;122;86;262;117;384
420790;201312;1333;4937;1107;4286;331;1378;424;1586;755;2964
420800;201312;906;2732;566;1945;159;616;123;378;282;994
420810;201312;2541;9054;2062;7893;720;3080;519;1914;1239;4994
420820;201312;7825;27390;6528;25028;2352;10061;2257;8497;4609;18558
420830;201312;2724;9350;2346;8604;921;3653;781;2755;1702;6408
420840;201312;867;2729;552;2060;154;651;157;540;311;1191
420845;201312;1135;3978;951;3600;348;1449;158;550;506;1999
420850;201312;1937;6544;1346;5254;473;2012;272;1053;745;3065
420860;201312;674;2012;455;1591;185;726;158;533;343;1259
420870;201312;1386;4123;1118;3731;442;1627;331;1059;773;2686
420880;201312;1478;5037;1204;4290;326;1206;240;815;566;2021
420890;201312;12521;30275;5856;18656;1205;4528;2281;6528;3486;11056
420895;201312;222;623;106;358;40;142;26;87;66;229
420900;201312;2300;6834;1541;5293;449;1689;369;1193;818;2882
420910;201312;22716;71414;15235;54856;3981;16335;3882;12980;7863;29315
420915;201312;657;2602;603;2460;172;723;268;1141;440;1864
420917;201312;421;1318;240;792;54;213;76;201;130;414
420920;201312;188;555;101;354;37;136;17;60;54;196
420930;201312;19920;62444;17291;57526;5780;20955;5803;19175;11583;40130
420940;201312;4451;13930;3840;12535;1166;4261;1177;3503;2343;7764
420945;201312;241;766;159;558;43;170;44;147;87;317
420950;201312;549;1691;292;1111;76;328;50;177;126;505
420960;201312;1443;4606;1232;4216;424;1611;386;1207;810;2818
420970;201312;2723;8722;2406;8206;676;2490;1226;4270;1902;6760
420980;201312;409;1456;369;1368;125;464;181;706;306;1170
420985;201312;536;1662;346;1245;104;411;92;311;196;722
420990;201312;888;2687;609;2182;153;604;179;590;332;1194
421000;201312;680;2456;482;1918;153;669;57;168;210;837
421003;201312;645;1904;277;985;64;252;42;128;106;380
421005;201312;258;842;215;760;65;256;101;350;166;606
421010;201312;6725;21395;5316;18453;1821;6797;1567;5168;3388;11965
421020;201312;533;1770;421;1537;91;332;214;836;305;1168
421030;201312;1043;3879;952;3634;348;1410;295;1135;643;2545
421040;201312;888;2796;760;2562;259;958;274;856;533;1814
421050;201312;1948;5360;1187;4045;316;1235;403;1275;719;2510
421055;201312;275;917;186;683;46;185;48;155;94;340
421060;201312;542;2043;448;1769;129;541;101;370;230;911
421070;201312;790;2547;536;1929;149;604;155;572;304;1176
421080;201312;676;2236;615;2098;197;725;258;849;455;1574
421085;201312;531;1493;298;1060;79;306;65;249;144;555
421090;201312;416;1256;318;1033;82;278;142;461;224;739
421100;201312;1015;3234;745;2614;206;762;172;538;378;1300
421105;201312;1403;4701;1246;4386;332;1265;515;1872;847;3137
421110;201312;1633;5446;1416;5070;517;2038;441;1485;958;3523
421120;201312;1587;5351;1222;4411;299;1251;368;1204;667;2455
421125;201312;399;1298;324;1123;113;428;109;346;222;774
421130;201312;3428;11637;2838;10510;1070;4351;921;3381;1991;7732
421140;201312;434;1399;351;1207;110;409;122;401;232;810
421145;201312;548;1848;421;1482;75;296;186;624;261;920
421150;201312;537;1832;419;1591;113;460;172;648;285;1108
421160;201312;826;2595;567;2041;129;505;175;592;304;1097
421165;201312;320;1170;263;980;65;257;104;403;169;660
421170;201312;1842;6076;1571;5339;487;1764;730;2418;1217;4182
421175;201312;1360;4179;1075;3686;360;1429;337;1031;697;2460
421180;201312;522;1558;325;1118;103;406;123;382;226;788
421185;201312;450;1332;359;1150;64;196;186;626;250;822
421187;201312;324;1020;257;884;79;282;92;296;171;578
421189;201312;528;1642;469;1519;133;465;167;531;300;996
421190;201312;9815;32430;7608;27624;2463;9531;2195;7919;4658;17450
421200;201312;1070;3660;929;3328;290;1120;307;1061;597;2181
421205;201312;215;704;162;580;34;143;38;111;72;254
421210;201312;2078;6587;1776;5814;589;2047;541;1746;1130;3793
421220;201312;2487;8648;2212;8072;751;2968;673;2450;1424;5418
421223;201312;798;2356;533;1886;169;634;246;863;415;1497
421225;201312;1189;3759;1000;3362;299;1084;375;1244;674;2328
421227;201312;951;3271;869;3139;259;931;499;1874;758;2805
421230;201312;745;2561;673;2377;195;750;235;770;430;1520
421240;201312;547;1881;368;1345;90;350;50;161;140;511
421250;201312;1903;6040;1348;5004;493;1994;344;1245;837;3239
421260;201312;267;833;158;609;39;149;32;117;71;266
421265;201312;198;682;164;581;35;142;44;154;79;296
421270;201312;671;1889;415;1436;147;543;83;310;230;853
421280;201312;1618;5215;1322;4750;467;1927;368;1307;835;3234
421290;201312;1964;5713;1310;4416;442;1575;281;867;723;2442
421300;201312;314;1010;273;926;111;423;97;302;208;725
421310;201312;520;1819;446;1614;152;555;106;380;258;935
421315;201312;371;1151;235;857;50;187;57;191;107;378
421320;201312;538;1870;361;1353;71;299;64;182;135;481
421330;201312;640;2272;548;2073;226;966;64;221;290;1187
421335;201312;568;1909;448;1658;124;492;93;349;217;841
421340;201312;1751;5874;1581;5564;548;2097;643;2239;1191;4336
421350;201312;1078;3729;886;3310;309;1268;241;843;550;2111
421360;201312;3265;10050;2196;7858;514;2120;735;2478;1249;4598
421370;201312;1090;3941;938;3582;324;1367;246;907;570;2274
421380;201312;1038;3072;859;2720;174;598;419;1316;593;1914
421390;201312;198;653;148;519;21;77;41;148;62;225
421400;201312;391;1527;316;1338;135;591;75;292;210;883
421410;201312;365;1166;293;1014;74;263;133;479;207;742
421415;201312;318;1058;205;809;69;282;57;212;126;494
421420;201312;1420;4546;1079;3669;260;945;237;740;497;1685
421430;201312;291;983;229;854;81;348;42;140;123;488
421440;201312;820;2529;578;2065;175;684;213;716;388;1400
421450;201312;615;2167;487;1837;180;732;101;357;281;1089
421460;201312;659;2201;471;1781;120;506;109;377;229;883
421470;201312;503;1940;451;1818;136;578;181;716;317;1294
421480;201312;2815;9087;1978;7309;625;2613;558;1873;1183;4486
421490;201312;286;1015;199;792;92;390;40;156;132;546
421500;201312;2691;9820;2396;9190;1023;4307;521;1912;1544;6219
421505;201312;400;1401;363;1300;132;479;123;444;255;923
421507;201312;612;2110;493;1809;119;450;188;687;307;1137
421510;201312;299;1147;274;1090;87;398;113;387;200;785
421520;201312;806;2226;520;1628;58;228;269;763;327;991
421530;201312;445;1523;316;1239;96;427;110;406;206;833
421535;201312;707;2226;443;1636;104;410;207;759;311;1169
421540;201312;384;1212;331;1104;82;312;119;378;201;690
421545;201312;1229;4347;1004;3866;326;1398;205;740;531;2138
421550;201312;2172;7586;1967;7164;761;3000;585;2046;1346;5046
421555;201312;272;872;132;482;33;132;32;109;65;241
421560;201312;184;581;93;347;24;93;15;60;39;153
421565;201312;1095;3506;993;3326;447;1599;305;979;752;2578
421567;201312;947;3611;815;3245;385;1575;164;655;549;2230
421568;201312;483;1646;397;1457;119;454;124;466;243;920
421569;201312;196;643;110;417;23;96;25;90;48;186
421570;201312;1009;3489;768;2910;274;1140;188;675;462;1815
421575;201312;607;2104;543;1966;117;447;287;1050;404;1497
421580;201312;4247;14390;3413;12478;1328;5386;746;2431;2074;7817
421590;201312;261;838;209;725;47;173;94;308;141;481
421600;201312;597;1848;446;1520;137;497;118;392;255;889
421605;201312;686;2206;482;1773;131;550;113;393;244;943
421610;201312;1850;4881;1450;4297;206;651;927;2751;1133;3402
421620;201312;4910;15478;3588;12644;1299;4896;1125;3980;2424;8876
421625;201312;374;1268;240;891;66;275;75;261;141;536
421630;201312;2610;8099;1696;5967;469;1789;418;1420;887;3209
421635;201312;292;1039;249;956;72;299;91;316;163;615
421640;201312;1092;3602;975;3400;221;784;591;2107;812;2891
421650;201312;2346;8079;2050;7389;815;3222;318;1071;1133;4293
421660;201312;9178;31653;7518;28259;2618;10805;2207;7813;4825;18618
421670;201312;1118;3809;875;3214;260;1047;251;903;511;1950
421680;201312;1447;4875;1292;4489;533;1995;223;696;756;2691
421690;201312;2064;6970;1589;5765;466;1816;270;928;736;2744
421700;201312;721;2312;474;1753;167;679;116;352;283;1031
421710;201312;343;1243;277;1054;108;418;73;268;181;686
421715;201312;301;893;189;656;48;176;57;197;105;373
421720;201312;1705;5470;1344;4786;551;2164;386;1258;937;3422
421725;201312;130;473;125;459;40;158;52;186;92;344
421730;201312;614;1938;325;1220;87;364;74;227;161;591
421740;201312;701;2265;530;1853;160;658;120;324;280;982
421750;201312;1406;4408;1126;3793;343;1267;389;1185;732;2452
421755;201312;434;1456;338;1190;102;393;100;320;202;713
421760;201312;441;1475;299;1123;87;367;126;448;213;815
421770;201312;3713;11541;3028;10138;1306;4562;731;2494;2037;7056
421775;201312;565;1724;380;1359;90;332;120;424;210;756
421780;201312;1729;6123;1399;5364;577;2380;375;1346;952;3726
421790;201312;981;2887;636;2279;202;828;151;487;353;1315
421795;201312;396;1236;280;936;46;164;85;285;131;449
421800;201312;2503;8438;1993;7377;580;2383;642;2172;1222;4555
421810;201312;612;2085;493;1779;152;592;94;316;246;908
421820;201312;1103;3642;914;3222;217;918;312;991;529;1909
421825;201312;1337;4657;1238;4406;221;879;671;2322;892;3201
421830;201312;3079;10798;2884;10394;714;2664;1514;5711;2228;8375
421835;201312;182;589;143;522;55;231;55;176;110;407
421840;201312;515;1862;461;1720;188;771;152;531;340;1302
421850;201312;570;1685;428;1435;143;500;129;458;272;958
421860;201312;454;1523;337;1269;72;294;96;340;168;634
421870;201312;5167;15651;3706;12540;1166;4225;671;2197;1837;6422
421875;201312;335;1054;201;741;48;201;48;153;96;354
421880;201312;1054;3621;849;3097;270;1117;207;674;477;1791
421885;201312;361;1299;323;1189;87;330;133;484;220;814
421890;201312;1085;3784;927;3439;319;1268;281;1023;600;2291
421895;201312;427;1484;406;1445;117;429;208;757;325;1186
421900;201312;887;2944;730;2551;209;776;255;807;464;1583
421910;201312;545;1811;390;1430;109;458;106;330;215;788
421915;201312;618;1926;492;1643;112;414;182;569;294;983
421917;201312;564;1814;448;1594;147;619;140;442;287;1061
421920;201312;774;2447;629;2229;300;1158;179;564;479;1722
421930;201312;3771;11335;2742;9309;858;3223;441;1442;1299;4665
421935;201312;890;3190;712;2761;205;872;248;936;453;1808
421940;201312;303;1197;239;989;88;394;52;190;140;584
421950;201312;4384;12716;2519;8775;786;2907;507;1780;1293;4687
421960;201312;263;863;210;736;55;211;56;190;111;401
421970;201312;2053;6481;1574;5348;548;2041;327;987;875;3028
421985;201312;441;1277;270;916;44;179;88;302;132;481
430003;201312;920;2714;731;2377;208;748;245;779;453;1527
430005;201312;294;1012;256;924;62;244;135;459;197;703
430010;201312;2142;6340;1656;5358;536;1792;588;1966;1124;3758
430020;201312;1115;3050;975;2839;240;805;529;1447;769;2252
430030;201312;1500;4270;1331;3926;396;1231;520;1465;916;2696
430040;201312;13078;34242;11209;31314;3536;10287;4772;13536;8308;23823
430045;201312;733;2061;588;1772;113;388;339;984;452;1372
430047;201312;210;611;167;524;43;139;80;253;123;392
430050;201312;1069;3054;714;2345;150;585;301;921;451;1506
430055;201312;265;785;188;612;45;161;89;277;134;438
430057;201312;78;209;32;106;8;32;11;24;19;56
430060;201312;14841;49661;13281;46782;4377;16026;6022;21770;10399;37796
430063;201312;1094;3335;910;2924;267;900;398;1315;665;2215
430064;201312;1675;5087;1418;4644;383;1279;722;2466;1105;3745
430066;201312;174;460;130;391;33;112;67;192;100;304
430070;201312;540;1791;415;1466;112;429;125;402;237;831
430080;201312;618;2062;489;1759;126;514;131;425;257;939
430085;201312;649;1908;493;1640;152;567;215;672;367;1239
430087;201312;993;3032;950;2951;102;338;761;2348;863;2686
430090;201312;761;2089;275;911;39;142;78;267;117;409
430100;201312;1020;3291;825;2899;305;1173;199;591;504;1764
430105;201312;718;2387;582;2110;214;841;134;465;348;1306
430107;201312;258;876;206;713;44;169;86;280;130;449
430110;201312;2192;6604;2033;6335;677;2303;914;2781;1591;5084
430120;201312;1737;5450;1422;4764;296;1044;843;2799;1139;3843
430130;201312;4564;11777;4164;11247;732;2100;2693;7369;3425;9469
430140;201312;1203;3935;929;3258;304;1087;317;1102;621;2189
430150;201312;919;2531;636;1987;155;519;197;599;352;1118
430155;201312;506;1619;380;1325;104;355;152;540;256;895
430160;201312;18624;55579;17315;53374;3873;13196;9668;30258;13541;43454
430163;201312;1880;5783;1619;5291;395;1464;759;2477;1154;3941
430165;201312;284;1024;241;932;111;439;43;161;154;600
430170;201312;782;2319;398;1402;100;391;85;266;185;657
430175;201312;964;3118;783;2714;180;570;406;1508;586;2078
430180;201312;1144;3175;986;2920;236;764;482;1432;718;2196
430185;201312;752;1920;407;1245;66;236;137;361;203;597
430187;201312;754;2374;678;2243;181;706;285;904;466;1610
430190;201312;2271;6848;2007;6379;519;1899;959;3044;1478;4943
430192;201312;187;592;101;330;17;60;34;104;51;164
430195;201312;249;759;82;303;14;52;14;40;28;92
430200;201312;1823;5996;1538;5407;551;2059;287;1012;838;3071
430205;201312;504;1535;408;1364;49;203;278;906;327;1109
430210;201312;6296;18341;3575;12305;984;3622;665;2111;1649;5733
430215;201312;331;993;250;827;57;207;110;343;167;550
430220;201312;672;1795;325;1107;66;264;52;164;118;428
430222;201312;322;1016;248;852;66;256;104;336;170;592
430223;201312;323;1011;296;963;63;213;195;640;258;853
430225;201312;61;179;37;120;6;14;7;20;13;34
430230;201312;2149;6862;2026;6731;353;1111;1529;5251;1882;6362
430235;201312;258;880;210;764;67;267;52;169;119;436
430237;201312;395;1117;330;1001;49;182;213;617;262;799
430240;201312;1084;3311;854;2842;311;1174;248;721;559;1895
430245;201312;867;2963;728;2637;206;763;312;1162;518;1925
430250;201312;1614;4549;1467;4281;558;1744;525;1551;1083;3295
430258;201312;212;605;145;474;25;87;66;208;91;295
430260;201312;837;2409;559;1813;74;273;322;1051;396;1324
430265;201312;325;1048;262;886;97;347;31;81;128;428
430270;201312;3481;10071;3144;9491;856;2921;1546;4580;2402;7501
430280;201312;5294;15445;4601;14105;1427;4670;1945;5863;3372;10533
430290;201312;2474;6970;2354;6837;327;959;1905;5639;2232;6598
430300;201312;9896;30946;8486;28211;3422;11927;3071;10511;6493;22438
430310;201312;8547;27526;7668;25769;2622;9496;3065;10023;5687;19519
430320;201312;818;2528;598;2067;91;310;312;1121;403;1431
430330;201312;981;2749;844;2482;252;794;328;890;580;1684
430340;201312;717;1923;456;1550;104;405;218;727;322;1132
430350;201312;6139;20028;5283;18077;2028;7308;1772;5947;3800;13255
430355;201312;238;656;153;495;29;114;36;100;65;214
430360;201312;1124;3001;987;2765;175;528;581;1626;756;2154
430367;201312;341;955;232;752;39;141;80;237;119;378
430370;201312;603;1816;496;1589;171;595;131;382;302;977
430380;201312;866;2265;471;1534;138;469;167;558;305;1027
430390;201312;4206;12774;3245;10650;838;3009;1029;3179;1867;6188
430400;201312;1321;3209;930;2644;257;814;447;1192;704;2006
430410;201312;692;1932;549;1690;102;357;284;860;386;1217
430420;201312;4513;13453;3727;11643;1151;3681;1474;4632;2625;8313
430430;201312;760;2174;520;1697;169;593;133;404;302;997
430435;201312;1982;5528;1685;4956;387;1170;935;2785;1322;3955
430440;201312;4595;14450;3832;12995;817;3044;1737;6095;2554;9139
430450;201312;9168;26963;7526;23479;2758;9072;2382;7377;5140;16449
430460;201312;25718;79958;21257;71590;7068;25555;7420;24933;14488;50488
430461;201312;481;1364;164;541;37;126;38;127;75;253
430462;201312;342;1027;287;937;115;403;98;314;213;717
430463;201312;3896;13050;3469;12145;936;3588;1652;5776;2588;9364
430465;201312;632;1776;532;1601;126;422;330;978;456;1400
430466;201312;4327;13027;4078;12571;1275;4260;1894;5812;3169;10072
430467;201312;591;1828;516;1692;134;490;244;773;378;1263
430468;201312;1406;4244;1251;3987;533;1851;256;780;789;2631
430469;201312;131;356;41;160;11;44;11;50;22;94
430470;201312;7276;19787;5493;16793;1885;6243;1693;5145;3578;11388
430471;201312;928;3167;830;2947;306;1140;191;680;497;1820
430480;201312;857;2430;477;1578;77;284;101;290;178;574
430485;201312;239;759;134;494;27;97;45;178;72;275
430490;201312;533;1593;371;1272;108;388;129;450;237;838
430495;201312;417;1278;291;998;76;287;74;240;150;527
430500;201312;1650;4698;1419;4287;412;1384;667;1967;1079;3351
430510;201312;26833;85159;20813;70228;7280;26883;5721;18287;13001;45170
430511;201312;477;1472;270;931;73;245;40;134;113;379
430512;201312;1333;3555;1181;3302;339;982;467;1364;806;2346
430513;201312;667;1916;475;1514;85;273;222;712;307;985
430515;201312;614;1848;496;1590;102;351;211;695;313;1046
430517;201312;1359;4633;1248;4390;248;945;770;2671;1018;3616
430520;201312;1765;5268;1418;4523;474;1601;534;1652;1008;3253
430530;201312;929;2683;530;1744;113;423;140;404;253;827
430535;201312;2379;7895;2043;7086;562;2163;675;2301;1237;4464
430537;201312;614;1796;432;1493;54;180;331;1176;385;1356
430540;201312;741;1839;571;1605;132;416;326;876;458;1292
430543;201312;601;1599;540;1537;136;414;336;973;472;1387
430544;201312;709;2442;622;2201;150;561;309;1056;459;1617
430545;201312;1391;4571;1219;4351;448;1513;598;2384;1046;3897
430550;201312;610;1933;485;1652;123;472;195;638;318;1110
430558;201312;120;361;83;276;32;120;12;26;44;146
430560;201312;386;999;249;754;51;198;108;308;159;506
430570;201312;1179;3171;863;2591;220;750;421;1170;641;1920
430580;201312;1048;3079;738;2434;261;894;204;694;465;1588
430583;201312;118;334;48;161;11;44;4;10;15;54
430585;201312;357;985;246;741;82;290;102;273;184;563
430587;201312;297;940;252;837;110;379;70;229;180;608
430590;201312;1539;4416;1456;4280;333;1114;831;2377;1164;3491
430593;201312;37;148;34;135;14;61;8;26;22;87
430595;201312;168;523;105;381;37;140;13;36;50;176
430597;201312;375;1195;315;1059;62;234;133;427;195;661
430600;201312;1983;5693;1360;4260;317;1050;493;1505;810;2555
430605;201312;1338;4297;1096;3766;278;1041;442;1555;720;2596
430607;201312;696;1932;604;1767;134;446;346;971;480;1417
430610;201312;8152;22440;6508;19765;1570;5292;3005;9088;4575;14380
430613;201312;224;593;134;415;37;115;38;104;75;219
430620;201312;957;3026;805;2677;241;900;304;925;545;1825
430630;201312;462;1404;281;945;84;282;57;173;141;455
430632;201312;718;2035;481;1531;84;318;266;787;350;1105
430635;201312;668;1896;493;1553;109;340;237;763;346;1103
430637;201312;546;1576;496;1477;87;317;320;893;407;1210
430640;201312;1866;5425;1019;3409;231;813;202;561;433;1374
430642;201312;471;1292;345;1091;70;247;186;596;256;843
430645;201312;188;574;111;386;25;96;27;88;52;184
430650;201312;2062;6985;1800;6371;408;1509;986;3576;1394;5085
430655;201312;306;937;269;851;66;233;97;254;163;487
430660;201312;6006;18195;4833;15950;1540;5591;1884;6129;3424;11720
430670;201312;503;1484;455;1391;45;131;344;1089;389;1220
430673;201312;765;1930;454;1411;126;399;208;650;334;1049
430675;201312;189;592;133;459;26;104;61;207;87;311
430676;201312;4489;13954;4136;13367;1284;4482;1882;6227;3166;10709
430680;201312;1263;3814;937;3081;222;835;365;1105;587;1940
430690;201312;4475;13220;3740;11773;1204;3950;1466;4757;2670;8707
430692;201312;279;973;208;816;34;133;134;533;168;666
430693;201312;1773;5127;1368;4203;318;1053;433;1300;751;2353
430695;201312;508;1478;420;1300;98;347;199;573;297;920
430697;201312;438;1268;340;1093;116;375;129;448;245;823
430700;201312;10775;29041;5639;18559;1175;4360;808;2405;1983;6765
430705;201312;409;1305;380;1252;137;494;144;470;281;964
430710;201312;1865;4948;1489;4324;303;967;796;2404;1099;3371
430720;201312;899;2279;587;1820;173;576;228;741;401;1317
430730;201312;1771;4999;1493;4560;365;1112;820;2637;1185;3749
430740;201312;618;1819;388;1310;120;428;55;155;175;583
430745;201312;532;1562;368;1187;70;240;153;481;223;721
430750;201312;1811;5302;1571;4838;395;1350;794;2344;1189;3694
430755;201312;659;1897;467;1457;113;412;202;554;315;966
430760;201312;3682;9517;2913;8559;627;2026;1613;4926;2240;6952
430770;201312;6776;20717;5695;18784;1449;5253;2689;8703;4138;13956
430780;201312;2383;6914;1730;5634;495;1763;664;2010;1159;3773
430781;201312;651;2015;484;1675;146;538;171;577;317;1115
430783;201312;573;1517;444;1289;84;268;202;541;286;809
430786;201312;116;403;101;358;36;141;13;42;49;183
430790;201312;3612;10241;2443;7824;555;2069;1091;3254;1646;5323
430800;201312;773;2438;625;2063;169;597;213;672;382;1269
430805;201312;457;1361;353;1164;36;132;233;787;269;919
430807;201312;322;1010;268;889;61;247;91;262;152;509
430810;201312;585;1727;317;1111;59;245;60;191;119;436
430820;201312;1230;4131;1000;3535;335;1281;298;984;633;2265
430825;201312;458;1310;248;793;46;158;78;232;124;390
430830;201312;2728;8127;2522;7778;397;1272;1636;5323;2033;6595
430840;201312;990;3146;902;2947;239;761;402;1386;641;2147
430843;201312;99;327;76;251;15;49;30;94;45;143
430845;201312;434;1304;360;1164;129;446;60;184;189;630
430850;201312;3302;10317;2969;9672;930;3225;1175;3805;2105;7030
430860;201312;696;2317;552;1968;181;763;129;399;310;1162
430865;201312;717;2015;660;1908;211;618;317;933;528;1551
430870;201312;609;1785;406;1390;139;486;121;399;260;885
430880;201312;1378;4110;1136;3620;464;1586;282;915;746;2501
430885;201312;179;581;152;530;51;194;45;146;96;340
430890;201312;1660;4546;1345;3962;97;343;911;2652;1008;2995
430900;201312;3218;8891;3047;8667;577;1710;2057;5982;2634;7692
430905;201312;1078;3289;775;2615;274;997;192;619;466;1616
430910;201312;1796;5873;1535;5344;592;2213;550;1855;1142;4068
430912;201312;590;1699;464;1488;73;266;252;781;325;1047
430915;201312;404;1450;308;1231;86;373;81;338;167;711
430920;201312;17764;57315;16427;54813;5787;20069;8568;28555;14355;48624
430925;201312;91;264;72;224;21;73;37;112;58;185
430930;201312;9242;29632;7665;26305;2334;8499;2964;10470;5298;18969
430940;201312;1123;3559;901;3109;217;849;282;935;499;1784
430950;201312;1607;4628;1234;3798;364;1184;365;1098;729;2282
430955;201312;96;323;77;272;28;110;19;55;47;165
430957;201312;317;1082;260;955;70;272;107;393;177;665
430960;201312;1738;5140;1485;4686;584;1930;469;1501;1053;3431
430965;201312;1324;4149;1147;3793;199;755;776;2510;975;3265
430970;201312;534;1572;347;1165;94;350;94;307;188;657
430975;201312;639;2117;493;1757;96;365;271;955;367;1320
430980;201312;558;1395;350;1088;96;342;132;364;228;706
430990;201312;640;2134;490;1729;165;605;103;363;268;968
430995;201312;722;2183;651;2044;229;732;240;756;469;1488
431000;201312;1692;4690;991;3202;249;915;144;389;393;1304
431010;201312;2806;8472;1965;6717;561;2121;618;1985;1179;4106
431020;201312;14389;36673;10032;28618;2922;8744;3195;9349;6117;18093
431030;201312;405;1264;252;886;58;212;63;229;121;441
431033;201312;2894;8539;2652;8177;638;2053;1508;4887;2146;6940
431036;201312;198;589;96;330;24;91;25;70;49;161
431040;201312;1012;3019;862;2756;239;839;436;1365;675;2204
431041;201312;589;1661;530;1574;197;624;175;544;372;1168
431043;201312;389;1330;315;1152;149;590;106;350;255;940
431046;201312;114;354;88;295;24;86;34;109;58;195
431050;201312;1826;4679;1555;4278;328;930;968;2728;1296;3658
431053;201312;614;2063;525;1867;169;667;186;640;355;1307
431055;201312;695;1994;643;1896;83;251;460;1379;543;1630
431057;201312;334;976;195;696;57;222;79;274;136;496
431060;201312;6281;18721;5965;18331;1323;3799;3968;12829;5291;16628
431065;201312;444;1383;423;1346;51;175;288;918;339;1093
431070;201312;750;2240;478;1600;112;388;121;357;233;745
431075;201312;284;864;186;642;35;138;61;209;96;347
431080;201312;685;2261;573;2015;164;617;104;347;268;964
431085;201312;933;2526;751;2215;141;441;424;1249;565;1690
431087;201312;620;1798;557;1678;68;186;393;1213;461;1399
431090;201312;524;1374;290;915;97;316;58;169;155;485
431100;201312;4759;13474;4012;12142;1171;3741;1633;5089;2804;8830
431110;201312;1615;4505;1290;3850;344;1097;651;1887;995;2984
431112;201312;662;2136;632;2084;226;744;303;1029;529;1773
431113;201312;631;1946;474;1573;164;537;130;451;294;988
431115;201312;1478;4521;1354;4296;316;1066;787;2469;1103;3535
431120;201312;2661;8776;2406;8264;748;2872;1001;3278;1749;6150
431123;201312;528;1687;447;1524;124;441;214;747;338;1188
431125;201312;1360;4332;1090;3740;330;1158;431;1565;761;2723
431127;201312;121;343;64;205;11;37;11;34;22;71
431130;201312;3887;11483;3273;10428;977;3395;1385;4428;2362;7823
431140;201312;3768;10171;2284;7504;489;1876;713;2044;1202;3920
431142;201312;553;1694;509;1616;65;224;338;1095;403;1319
431150;201312;1330;4097;1078;3600;303;1026;377;1306;680;2332
431160;201312;964;2903;821;2590;169;538;415;1393;584;1931
431162;201312;442;1219;222;759;33;130;38;114;71;244
431164;201312;106;288;37;136;14;49;2;5;16;54
431170;201312;925;2806;753;2450;243;826;217;695;460;1521
431171;201312;869;2677;776;2491;244;830;186;555;430;1385
431173;201312;482;1480;450;1421;105;346;270;859;375;1205
431175;201312;1320;3717;1150;3458;397;1268;461;1368;858;2636
431177;201312;981;3301;886;3087;290;1090;384;1341;674;2431
431179;201312;128;353;81;252;19;65;27;74;46;139
431180;201312;2809;8582;2249;7269;605;2168;665;1984;1270;4152
431190;201312;755;2128;469;1556;137;502;157;516;294;1018
431198;201312;375;1247;328;1145;149;577;64;201;213;778
431200;201312;293;864;120;404;25;88;16;51;41;139
431205;201312;298;1007;235;829;62;233;85;292;147;525
431210;201312;780;2258;679;2046;179;551;342;1033;521;1584
431213;201312;317;996;264;892;73;271;92;293;165;564
431215;201312;344;1033;168;575;30;103;21;61;51;164
431217;201312;244;761;191;639;65;232;49;169;114;401
431220;201312;1218;3171;900;2577;126;429;496;1348;622;1777
431225;201312;1366;4150;1199;3847;282;978;653;2110;935;3088
431230;201312;953;2913;747;2478;123;459;416;1386;539;1845
431235;201312;76;184;37;115;13;44;10;29;23;73
431237;201312;447;1476;391;1391;141;576;157;521;298;1097
431238;201312;50;167;41;145;10;41;13;41;23;82
431240;201312;2802;8840;2391;8082;865;3132;721;2418;1586;5550
431242;201312;429;1411;405;1365;166;632;25;69;191;701
431244;201312;441;1104;339;954;74;252;154;394;228;646
431245;201312;1015;2864;873;2622;178;555;553;1676;731;2231
431247;201312;212;681;179;617;69;256;64;205;133;461
431250;201312;1897;6104;1694;5789;569;2111;655;2287;1224;4398
431260;201312;389;1150;272;908;69;262;61;185;130;447
431261;201312;230;837;198;762;53;235;54;199;107;434
431262;201312;350;1020;158;562;28;130;62;209;90;339
431265;201312;1337;3670;826;2562;206;718;248;648;454;1366
431267;201312;194;601;160;541;44;159;69;215;113;374
431270;201312;2393;6900;2082;6423;697;2303;983;3048;1680;5351
431275;201312;215;715;144;515;46;155;25;77;71;232
431280;201312;162;514;107;380;27;106;27;77;54;183
431290;201312;353;1166;274;955;77;302;59;193;136;495
431295;201312;220;709;126;430;25;100;29;81;54;181
431300;201312;147;523;98;384;34;139;8;31;42;170
431301;201312;246;817;178;635;40;152;43;140;83;292
431303;201312;708;1950;543;1638;139;484;223;645;362;1129
431306;201312;2139;6104;1643;5151;340;1260;590;1637;930;2897
431308;201312;59;206;55;195;40;146;11;36;51;182
431310;201312;764;2483;566;2022;109;413;215;788;324;1201
431320;201312;860;2549;546;1905;167;653;124;394;291;1047
431330;201312;2155;5631;1118;3616;343;1218;192;599;535;1817
431333;201312;289;784;194;595;41;134;62;169;103;303
431335;201312;100;297;85;267;19;59;29;81;48;140
431337;201312;2619;8256;2126;7146;627;2196;609;2030;1236;4226
431339;201312;613;1820;484;1517;112;366;231;738;343;1104
431340;201312;27574;75338;20478;63048;5317;18166;8002;24002;13319;42168
431342;201312;620;1678;539;1530;126;377;329;913;455;1290
431344;201312;369;1068;292;931;28;95;174;561;202;656
431346;201312;300;822;185;554;56;173;49;148;105;321
431349;201312;592;1750;450;1405;92;283;154;476;246;759
431350;201312;3891;11932;3486;11192;621;2295;2124;6598;2745;8893
431360;201312;759;2137;600;1866;176;577;220;680;396;1257
431365;201312;1322;4174;1162;3894;458;1681;420;1375;878;3056
431370;201312;5536;16313;4719;14913;1315;4453;2071;6684;3386;11137
431380;201312;1121;3425;1059;3277;169;566;758;2317;927;2883
431390;201312;3439;10261;2539;8441;843;3073;718;2240;1561;5313
431395;201312;1603;4917;1438;4648;380;1302;595;1977;975;3279
431400;201312;185;618;120;465;36;152;11;29;47;181
431402;201312;1208;3131;790;2340;161;525;378;1076;539;1601
431403;201312;323;969;241;817;88;329;51;167;139;496
431405;201312;4579;13253;3676;11862;853;3221;1787;5531;2640;8752
431406;201312;805;2592;620;2122;217;776;219;736;436;1512
431407;201312;646;2027;493;1656;165;570;116;360;281;930
431410;201312;16741;52859;13605;46549;5426;19851;3253;11566;8679;31417
431413;201312;214;543;105;340;11;41;47;150;58;191
431415;201312;923;2693;779;2423;193;656;393;1189;586;1845
431417;201312;663;1743;533;1536;97;306;287;855;384;1161
431420;201312;1607;4542;1427;4238;353;1134;771;2323;1124;3457
431430;201312;601;1684;451;1431;120;411;166;497;286;908
431440;201312;32646;97442;29421;91950;9988;32703;12963;42022;22951;74725
431442;201312;208;681;161;557;52;203;20;50;72;253
431445;201312;507;1421;353;1079;63;201;137;404;200;605
431446;201312;496;1478;370;1216;99;334;161;522;260;856
431447;201312;850;2447;605;1897;111;377;290;921;401;1298
431449;201312;894;2602;738;2332;128;442;381;1227;509;1669
431450;201312;2273;6104;2090;5813;545;1582;1254;3481;1799;5063
431455;201312;633;1663;418;1219;119;368;143;386;262;754
431460;201312;3676;10597;3202;9670;920;2919;1250;3845;2170;6764
431470;201312;2208;6553;1838;5720;533;1651;782;2570;1315;4221
431475;201312;142;424;57;229;12;52;5;23;17;75
431477;201312;621;1808;498;1555;113;376;258;789;371;1165
431478;201312;201;543;97;299;24;78;36;112;60;190
431480;201312;2656;8000;2092;6905;723;2572;553;1782;1276;4354
431490;201312;108085;313059;95404;293679;17959;63113;61553;185330;79512;248443
431500;201312;1190;3159;954;2718;291;849;330;930;621;1779
431505;201312;376;1081;349;1042;31;83;284;862;315;945
431507;201312;455;1136;367;970;83;212;219;591;302;803
431510;201312;2221;6248;1865;5613;355;1161;1039;3061;1394;4222
431513;201312;166;490;113;369;28;92;52;169;80;261
431514;201312;118;304;52;163;8;28;12;37;20;65
431515;201312;751;2307;577;1874;133;479;275;824;408;1303
431517;201312;90;301;84;286;38;140;21;65;59;205
431520;201312;491;1502;320;1077;66;246;77;258;143;504
431530;201312;4650;11539;3672;10410;1008;2911;2016;6063;3024;8974
431531;201312;289;836;202;655;50;179;80;265;130;444
431532;201312;558;1609;501;1497;173;566;162;469;335;1035
431535;201312;386;1158;268;850;62;219;74;216;136;435
431540;201312;2210;7219;1989;6897;304;990;1277;4772;1581;5762
431545;201312;134;399;57;204;5;18;12;48;17;66
431550;201312;2447;7548;2274;7221;555;2011;1086;3380;1641;5391
431555;201312;773;2075;678;1929;161;452;345;991;506;1443
431560;201312;23883;76041;20785;69623;8830;30144;6304;22163;15134;52307
431570;201312;5718;16585;5200;15798;1638;5094;2834;8714;4472;13808
431575;201312;496;1338;362;1119;60;211;156;466;216;677
431580;201312;715;2313;601;2052;156;595;229;732;385;1327
431590;201312;939;2778;710;2274;79;271;390;1256;469;1527
431595;201312;614;1804;528;1613;130;416;188;590;318;1006
431600;201312;2286;6977;1751;5797;475;1770;371;1033;846;2803
431610;201312;1668;4812;1242;4000;315;1088;609;1957;924;3045
431620;201312;379;1232;246;819;86;304;93;287;179;591
431630;201312;1400;3911;1103;3271;273;851;561;1675;834;2526
431640;201312;6025;18386;5507;17517;1570;5518;2814;8744;4384;14262
431642;201312;517;1581;458;1451;76;289;251;764;327;1053
431643;201312;224;616;190;554;45;154;103;267;148;421
431645;201312;1808;5602;1656;5333;398;1308;951;3164;1349;4472
431647;201312;174;500;125;387;39;121;28;68;67;189
431650;201312;244;784;165;608;37;152;33;99;70;251
431660;201312;1491;4551;1160;3831;404;1387;399;1258;803;2645
431670;201312;1373;3938;1133;3501;336;1164;466;1367;802;2531
431673;201312;231;696;152;516;43;156;38;125;81;281
431675;201312;299;1010;227;782;57;203;62;186;119;389
431680;201312;10188;29452;7987;25419;2533;8649;2758;8827;5291;17476
431690;201312;25620;75348;21121;68163;6815;23563;8051;26268;14866;49831
431695;201312;145;504;105;390;22;84;26;73;48;157
431697;201312;529;1515;470;1404;137;424;200;613;337;1037
431700;201312;1675;4781;1426;4293;294;962;753;2207;1047;3169
431710;201312;13053;39222;10933;35425;3243;11028;4468;15006;7711;26034
431720;201312;7172;20737;6018;18566;1426;4968;3134;9450;4560;14418
431725;201312;39;140;37;135;22;84;5;18;27;102
431730;201312;3774;11884;3127;10629;962;3656;1125;3837;2087;7493
431740;201312;6018;18059;5368;16749;1921;6479;1675;5042;3596;11521
431750;201312;10551;30576;9033;28038;1891;6334;4858;15360;6749;21694
431755;201312;270;713;75;259;21;83;14;40;35;123
431760;201312;4011;12476;3351;11139;989;3570;961;3090;1950;6660
431770;201312;2354;6580;2009;6013;522;1679;1012;2970;1534;4649
431775;201312;251;723;196;616;80;263;50;139;130;402
431780;201312;2611;7225;2052;6146;623;2040;575;1613;1198;3653
431790;201312;1190;3840;1059;3592;291;1070;545;1827;836;2897
431795;201312;477;1455;386;1233;79;267;189;597;268;864
431800;201312;9650;29123;8148;26289;2747;9701;2557;8035;5304;17736
431805;201312;280;697;79;271;18;72;17;54;35;126
431810;201312;3798;10841;3228;9631;815;2646;1512;4454;2327;7100
431820;201312;2778;8927;2484;8340;762;2797;916;2968;1678;5765
431830;201312;10821;29393;9138;26707;3350;10659;3254;9488;6604;20147
431840;201312;3603;10965;3161;10083;990;3287;1371;4445;2361;7732
431842;201312;756;1988;436;1349;97;316;138;412;235;728
431843;201312;347;1041;312;980;78;267;171;517;249;784
431844;201312;170;513;129;432;35;135;41;128;76;263
431845;201312;542;1670;495;1571;55;178;345;1119;400;1297
431846;201312;513;1600;452;1475;84;314;261;844;345;1158
431848;201312;198;539;102;344;19;79;21;63;40;142
431849;201312;367;930;123;387;27;95;33;90;60;185
431850;201312;5031;14945;4489;13910;1079;3664;2285;6908;3364;10572
431860;201312;985;2848;819;2571;207;720;404;1211;611;1931
431861;201312;87;288;59;207;13;47;10;33;23;80
431862;201312;491;1713;415;1541;159;652;103;353;262;1005
431870;201312;26481;76102;22296;68481;6347;21427;9387;27957;15734;49384
431880;201312;4787;15421;4003;13580;1243;4635;1546;5053;2789;9688
431890;201312;5838;17240;5146;15898;2037;6631;1554;4937;3591;11568
431900;201312;1004;3159;805;2763;244;941;308;955;552;1896
431910;201312;911;2239;479;1408;109;360;180;485;289;845
431912;201312;615;1822;486;1550;150;472;174;578;324;1050
431915;201312;1400;3905;1060;3272;308;987;365;1142;673;2129
431920;201312;1550;4448;1426;4275;194;557;1089;3349;1283;3906
431930;201312;1314;3713;1027;3224;153;470;618;2057;771;2527
431935;201312;105;405;96;379;44;187;19;51;63;238
431936;201312;485;1418;442;1341;74;221;289;949;363;1170
431937;201312;323;910;198;635;51;180;53;156;104;336
431940;201312;2800;7845;1917;6097;549;1856;546;1706;1095;3562
431950;201312;1933;6260;1708;5817;514;1902;651;2125;1165;4027
431960;201312;3737;11306;3425;10670;1086;3596;1181;3727;2267;7323
431970;201312;509;1413;278;915;51;188;77;236;128;424
431971;201312;135;408;113;374;31;107;47;151;78;258
431973;201312;478;1712;421;1592;72;274;244;990;316;1264
431975;201312;15;62;11;51;2;12;3;13;5;25
431980;201312;1546;4565;1401;4272;378;1336;570;1603;948;2939
431990;201312;8843;25130;7200;22526;1497;5385;3322;10053;4819;15438
432000;201312;11130;33284;9134;29647;3072;10410;3743;12197;6815;22607
432010;201312;2540;7650;2197;6976;518;1886;1049;3186;1567;5072
432020;201312;2159;5868;1884;5492;336;1041;1182;3441;1518;4482
432023;201312;528;1560;409;1288;106;385;162;468;268;853
432026;201312;1221;3854;1049;3462;252;847;526;1765;778;2612
432030;201312;414;1253;348;1105;97;337;139;412;236;749
432032;201312;522;1425;377;1172;77;268;209;631;286;899
432035;201312;842;2781;774;2629;204;741;428;1429;632;2170
432040;201312;755;2249;527;1753;123;447;128;330;251;777
432045;201312;201;684;175;631;52;204;68;245;120;449
432050;201312;791;2338;707;2173;144;466;406;1274;550;1740
432055;201312;797;2552;707;2363;155;573;425;1388;580;1961
432057;201312;491;1315;397;1135;44;149;252;671;296;820
432060;201312;465;1340;204;723;60;230;49;160;109;390
432065;201312;244;720;187;613;46;173;84;245;130;418
432067;201312;989;3287;740;2679;211;786;317;1136;528;1922
432070;201312;2493;7002;1946;5875;647;2176;626;1790;1273;3966
432080;201312;4278;12646;3764;11700;1223;4022;1484;4541;2707;8563
432085;201312;259;854;222;780;79;318;64;212;143;530
432090;201312;1748;5511;1485;4932;593;2126;413;1194;1006;3320
432100;201312;1213;3674;688;2408;172;629;124;369;296;998
432110;201312;3097;9442;2503;8243;865;3135;477;1499;1342;4634
432120;201312;5296;16369;4543;14890;1656;5840;1353;4367;3009;10207
432130;201312;2373;7014;2047;6559;555;1927;1146;3705;1701;5632
432132;201312;422;1325;262;931;42;151;97;309;139;460
432135;201312;796;2424;754;2348;140;457;489;1530;629;1987
432140;201312;2949;8788;2393;7737;698;2385;896;3169;1594;5554
432143;201312;1359;4241;1188;3957;286;976;688;2366;974;3342
432145;201312;1058;3402;715;2580;246;964;135;424;381;1388
432146;201312;279;887;202;693;68;245;53;175;121;420
432147;201312;833;2688;675;2333;193;688;278;983;471;1671
432149;201312;417;1263;291;951;88;302;93;298;181;600
432150;201312;3712;11115;2885;9488;986;3505;861;2763;1847;6268
432160;201312;4588;15173;4115;14345;1490;5469;1546;5663;3036;11132
432162;201312;332;822;97;317;25;91;24;65;49;156
432163;201312;358;945;100;318;18;58;21;71;39;129
432166;201312;811;2461;659;2135;138;509;312;929;450;1438
432170;201312;826;2790;604;2273;141;582;126;431;267;1013
432180;201312;2829;7641;2061;6357;613;2068;605;1781;1218;3849
432183;201312;405;1372;372;1300;154;557;93;327;247;884
432185;201312;862;2523;576;1899;135;488;216;697;351;1185
432190;201312;3592;10137;2638;7969;716;2313;805;2286;1521;4599
432195;201312;1298;3740;1162;3530;199;648;752;2281;951;2929
432200;201312;3164;9958;2616;8979;836;3069;1084;3810;1920;6879
432210;201312;425;1280;376;1209;107;401;178;526;285;927
432215;201312;896;2852;800;2688;158;508;493;1747;651;2255
432218;201312;315;894;237;732;44;142;105;305;149;447
432220;201312;3871;10658;3270;9662;502;1717;2041;5887;2543;7604
432225;201312;64;222;55;206;31;119;10;39;41;158
432230;201312;1088;3090;885;2709;282;968;375;1026;657;1994
432232;201312;575;1714;457;1487;106;382;243;785;349;1167
432234;201312;550;1555;415;1213;106;326;167;457;273;783
432235;201312;76;237;40;147;14;63;7;23;21;86
432237;201312;506;1426;457;1344;38;142;371;1071;409;1213
432240;201312;15555;52582;13656;49971;3369;13453;7963;29693;11332;43146
432250;201312;5588;19881;5257;19191;2388;9373;1335;4946;3723;14319
432252;201312;477;1443;402;1293;130;446;182;585;312;1031
432253;201312;1269;4315;1003;3606;355;1318;307;1110;662;2428
432254;201312;479;1290;186;618;52;186;23;72;75;258
432255;201312;208;526;116;385;32;108;40;143;72;251
432260;201312;7002;18557;5131;15378;1268;4011;2414;7291;3682;11302
432270;201312;2737;8620;2407;8036;727;2510;1146;3909;1873;6419
432280;201312;1212;3596;775;2632;182;705;205;592;387;1297
432285;201312;140;454;66;222;20;72;13;36;33;108
432290;201312;608;1874;419;1422;99;377;156;499;255;876
432300;201312;23329;72985;21453;69657;5971;20647;11052;35749;17023;56396
432310;201312;993;3165;866;2916;207;781;435;1389;642;2170
432320;201312;275;787;185;599;56;183;61;205;117;388
432330;201312;233;697;97;342;17;59;10;28;27;87
432335;201312;210;618;93;325;26;99;8;23;34;122
432340;201312;301;796;153;475;40;131;40;118;80;249
432345;201312;771;2233;709;2135;158;573;373;1034;531;1607
432350;201312;460;1328;318;1052;81;282;83;258;164;540
432360;201312;44;143;35;124;14;50;12;41;26;91
432370;201312;488;1407;405;1256;39;115;275;873;314;988
432375;201312;872;2267;693;1964;128;370;418;1203;546;1573
432377;201312;79;272;38;126;6;19;11;28;17;47
432380;201312;859;3105;788;2938;357;1466;245;846;602;2312
500020;201312;2084;6915;1642;5956;513;2065;463;1559;976;3624
500025;201312;996;2574;644;1945;131;414;268;788;399;1202
500060;201312;6094;18165;5105;16723;668;2179;3718;12637;4386;14816
500070;201312;3948;12084;3393;11123;820;3060;1587;5067;2407;8127
500080;201312;1805;5426;1348;4580;463;1720;380;1346;843;3066
500085;201312;2062;5635;1546;4802;208;713;936;2818;1144;3531
500090;201312;2304;6979;1817;6084;415;1449;936;3230;1351;4679
500100;201312;2464;7641;2302;7376;805;2934;984;2982;1789;5916
500110;201312;8049;23962;6664;21850;1132;4167;3874;13212;5006;17379
500124;201312;1830;6108;1568;5650;306;1103;861;3371;1167;4474
500150;201312;1318;3632;1105;3304;309;1031;520;1484;829;2515
500190;201312;4793;13041;3783;11770;870;2930;2074;6665;2944;9595
500200;201312;2565;6716;1871;5699;393;1388;1011;2974;1404;4362
500210;201312;4866;14951;4236;13974;1024;3651;2142;7258;3166;10909
500215;201312;1739;5531;1456;4955;360;1391;589;1880;949;3271
500220;201312;2702;8701;2187;7687;559;2140;822;2934;1381;5074
500230;201312;2368;6571;1890;5835;741;2540;635;1907;1376;4447
500240;201312;4709;14822;3512;12438;746;2940;1500;5511;2246;8451
500260;201312;2462;6853;2035;6155;424;1425;1008;2867;1432;4292
500270;201312;103736;278392;71309;221999;21681;73466;18050;56366;39731;129832
500280;201312;1299;3906;1124;3659;215;736;681;2289;896;3025
500290;201312;3849;10135;2580;7925;731;2602;865;2429;1596;5031
500295;201312;2303;7297;1747;5939;442;1735;481;1415;923;3150
500310;201312;769;2105;693;2002;172;532;377;1054;549;1586
500315;201312;2856;9205;2487;8678;575;1949;1449;5411;2024;7360
500320;201312;13184;45307;11694;42582;4070;15671;4210;16280;8280;31951
500325;201312;4071;11098;3122;9541;916;3096;1324;3871;2240;6967
500330;201312;5443;15465;4470;13707;1487;4938;1740;5206;3227;10144
500345;201312;2396;7273;2042;6627;523;1897;1006;3152;1529;5049
500348;201312;2378;7204;2201;6905;290;1027;1621;5055;1911;6082
500350;201312;1229;3822;772;2748;138;511;238;885;376;1396
500370;201312;22684;72538;18173;63580;4841;18820;6881;23957;11722;42777
500375;201312;2642;7416;2010;6255;471;1559;954;3064;1425;4623
500380;201312;2927;8706;2512;7867;806;2710;817;2498;1623;5208
500390;201312;565;1243;371;964;57;185;252;602;309;787
500400;201312;1238;4040;1050;3587;344;1296;299;917;643;2213
500410;201312;2128;6087;1750;5534;483;1671;769;2438;1252;4109
500430;201312;2586;7985;2132;7277;557;2012;960;3422;1517;5434
500440;201312;1327;3941;1126;3610;300;1090;583;1802;883;2892
500450;201312;2134;6768;1682;5798;452;1764;346;1062;798;2826
500460;201312;3589;11127;2922;10069;803;3031;1167;3969;1970;7000
500470;201312;2950;9045;2251;7442;669;2405;421;1280;1090;3685
500480;201312;2010;6598;1860;6367;204;715;1458;5119;1662;5834
500490;201312;1063;3115;896;2835;290;1028;289;916;579;1944
500500;201312;3344;10571;2754;9712;1042;4126;886;3059;1928;7185
500510;201312;877;2409;607;1940;140;536;240;684;380;1220
500515;201312;1885;5184;1522;4684;277;840;927;3071;1204;3911
500520;201312;2708;9710;2404;9271;617;2510;1356;5477;1973;7987
500525;201312;1144;3792;998;3516;232;874;512;1892;744;2766
500540;201312;5018;14997;3334;11608;1019;4018;753;2475;1772;6493
500560;201312;4485;15494;4083;14903;906;3487;2600;9640;3506;13127
500568;201312;3757;10171;2872;8844;690;2265;1326;4153;2016;6418
500570;201312;7383;20887;5384;17335;1667;5762;2007;6487;3674;12249
500580;201312;3393;10183;2701;8891;544;1919;1556;5125;2100;7044
500600;201312;2895;8386;2235;7285;664;2357;832;2684;1496;5041
500620;201312;7993;22718;5938;19354;1456;5400;2872;9209;4328;14609
500625;201312;753;2331;518;1822;140;547;172;562;312;1109
500627;201312;192;530;132;412;31;109;30;98;61;207
500630;201312;6089;17451;4925;15751;1747;6192;1409;4480;3156;10672
500635;201312;2340;9334;2073;8941;314;1300;1350;6317;1664;7617
500640;201312;1402;3674;1135;3290;161;529;749;2110;910;2639
500660;201312;15192;47110;12667;42666;2987;11202;6063;20404;9050;31606
500690;201312;3036;8915;2499;8241;703;2396;1289;4520;1992;6916
500710;201312;3471;10927;3161;10427;843;2975;1645;5442;2488;8417
500720;201312;4513;13860;3536;11858;1153;4256;1064;3475;2217;7731
500730;201312;942;2757;746;2355;186;657;305;928;491;1585
500740;201312;3647;10396;2698;8682;609;2270;1195;3634;1804;5904
500750;201312;811;2482;744;2385;198;683;405;1322;603;2005
500755;201312;1244;3768;960;3228;234;864;368;1176;602;2040
500769;201312;4547;12494;3131;9700;738;2552;1040;2944;1778;5496
500770;201312;1643;5060;1337;4451;394;1416;451;1510;845;2926
500780;201312;1055;3380;936;3142;290;1056;414;1352;704;2408
500790;201312;8582;24850;7198;22361;1484;5415;3858;11403;5342;16818
500793;201312;2393;7068;1903;6225;361;1317;853;2637;1214;3954
500795;201312;2280;6934;2054;6598;274;747;1506;5188;1780;5935
500797;201312;912;2547;706;2205;155;530;334;1052;489;1582
500800;201312;2393;7118;1990;6526;668;2461;800;2617;1468;5078
500830;201312;15457;46616;11526;38331;3498;12672;3231;10415;6729;23087
500840;201312;1317;3973;1031;3402;219;777;468;1545;687;2322
510010;201312;1241;4001;1157;3856;397;1398;499;1704;896;3102
510020;201312;2742;8151;1994;6761;588;2120;508;1642;1096;3762
510025;201312;8910;27525;7872;25770;2510;9124;3153;10019;5663;19143
510030;201312;2086;5736;1756;5222;580;1810;758;2264;1338;4074
510035;201312;895;2712;762;2505;176;591;417;1437;593;2028
510040;201312;1677;4728;1333;4205;293;1047;676;2096;969;3143
510050;201312;1820;5415;1349;4527;386;1439;500;1669;886;3108
510060;201312;1220;3700;956;3190;275;1002;313;1008;588;2010
510080;201312;1300;4097;1085;3719;328;1313;361;1111;689;2424
510100;201312;629;1715;423;1301;95;331;154;447;249;778
510120;201312;289;597;193;492;15;32;167;433;182;465
510125;201312;3001;8111;2374;7007;472;1704;1137;3157;1609;4861
510130;201312;2036;5760;1742;5302;550;1769;705;2168;1255;3937
510140;201312;2933;9827;2457;9069;922;3554;827;3122;1749;6676
510160;201312;1268;4338;1211;4271;88;351;1065;3756;1153;4107
510170;201312;5923;18592;5005;16847;1289;4863;2244;7320;3533;12183
510180;201312;10473;29582;7948;25379;2574;8715;2815;9805;5389;18520
510185;201312;1141;3742;1069;3639;255;840;675;2440;930;3280
510190;201312;1597;5567;1313;5076;334;1445;561;2263;895;3708
510250;201312;13476;43623;11714;41159;3694;13865;5514;19831;9208;33696
510260;201312;2546;9697;2340;9270;728;3051;1029;4270;1757;7321
510263;201312;4171;11874;3167;10126;922;3241;1042;3179;1964;6420
510267;201312;5116;15054;3790;12205;915;3255;1381;4216;2296;7471
510268;201312;859;2549;738;2367;209;744;370;1174;579;1918
510269;201312;806;2659;729;2529;224;810;312;1119;536;1929
510270;201312;2447;7785;2202;7405;398;1329;1335;4764;1733;6093
510279;201312;2047;6711;1877;6420;707;2697;581;1807;1288;4504
510285;201312;1463;4593;1245;4187;364;1335;427;1378;791;2713
510300;201312;3047;9586;2738;9149;403;1515;1997;6641;2400;8156
510305;201312;1599;5195;1316;4633;375;1459;426;1512;801;2971
510310;201312;1095;3227;866;2850;308;1128;251;804;559;1932
510320;201312;3947;12030;3138;10359;989;3768;583;1646;1572;5414
510325;201312;5452;17755;4788;16796;638;2212;3634;13216;4272;15428
510330;201312;2687;9059;2333;8397;640;2558;902;3296;1542;5854
510335;201312;4418;14280;3939;13627;692;2391;2790;10059;3482;12450
510336;201312;493;1598;446;1507;101;366;223;752;324;1118
510337;201312;2217;7552;1949;7037;770;2831;629;2492;1399;5323
510340;201312;59809;180737;48313;162964;19621;72244;10683;37937;30304;110181
510343;201312;1135;3453;1046;3344;122;373;840;2767;962;3140
510345;201312;1659;4994;1411;4556;368;1298;487;1484;855;2782
510350;201312;3298;9889;2759;9139;813;2898;1312;4417;2125;7315
510360;201312;1758;4825;1331;4293;280;975;841;2666;1121;3641
510370;201312;877;3262;788;3108;231;936;391;1601;622;2537
510380;201312;473;1565;377;1356;139;551;65;217;204;768
510385;201312;876;3354;751;3028;133;585;352;1518;485;2103
510390;201312;1128;3585;1032;3468;270;864;588;2134;858;2998
510395;201312;814;2188;631;1950;119;392;371;1196;490;1588
510410;201312;3857;12972;3647;12602;1091;4068;1811;6253;2902;10321
510420;201312;2256;6038;1738;5180;305;1073;907;2673;1212;3746
510450;201312;575;1639;445;1454;148;545;142;450;290;995
510452;201312;606;1975;443;1590;115;462;158;526;273;988
510454;201312;733;2365;644;2236;163;589;345;1247;508;1836
510455;201312;993;3096;766;2659;196;805;292;966;488;1771
510460;201312;1915;5682;1721;5420;364;1325;1105;3371;1469;4696
510480;201312;4004;11224;3126;9550;803;2655;1070;3180;1873;5835
510490;201312;1464;4906;1315;4682;366;1413;729;2559;1095;3972
510500;201312;1390;4309;1038;3640;289;1160;463;1549;752;2709
510510;201312;3019;10802;2673;10190;1042;4205;941;3618;1983;7823
510515;201312;5584;17582;4567;15451;1234;4686;1315;4176;2549;8862
510517;201312;1702;5261;1519;4990;457;1451;895;3091;1352;4542
510520;201312;2142;5666;1680;5006;136;476;1276;3786;1412;4262
510523;201312;1031;3196;875;2936;281;1006;399;1306;680;2312
510525;201312;7761;20055;4978;15565;1258;4281;1800;5521;3058;9802
510530;201312;560;1626;486;1517;89;323;281;876;370;1199
510550;201312;2690;9090;2334;8450;664;2492;1051;3934;1715;6426
510558;201312;2056;6061;1616;5383;506;1844;614;2014;1120;3858
510560;201312;1599;5347;1184;4585;437;1773;272;1117;709;2890
510562;201312;5078;15835;4441;14553;1581;5696;1446;4762;3027;10458
510590;201312;2708;7942;2175;7249;634;2317;954;3219;1588;5536
510600;201312;1477;3846;1023;3135;171;572;528;1563;699;2135
510610;201312;2681;8154;2439;7826;285;1064;1903;6054;2188;7118
510615;201312;2107;7038;1871;6619;641;2444;791;2766;1432;5210
510617;201312;526;1659;468;1571;79;301;341;1149;420;1450
510618;201312;1297;3940;973;3300;253;972;430;1438;683;2410
510619;201312;767;2155;502;1665;105;381;154;511;259;892
510620;201312;1178;3243;803;2685;293;1104;173;530;466;1634
510621;201312;1032;3654;895;3332;276;1125;303;1071;579;2196
510622;201312;3537;11028;2344;8246;588;2321;392;1170;980;3491
510623;201312;3664;10710;3104;9791;1113;3706;1134;3563;2247;7269
510624;201312;1166;3713;949;3304;225;881;402;1315;627;2196
510625;201312;2292;6835;1845;6000;549;2007;502;1558;1051;3565
510626;201312;1245;4019;1029;3671;337;1316;474;1695;811;3011
510627;201312;675;2120;544;1875;205;770;167;573;372;1343
510628;201312;1504;3962;1201;3592;177;597;819;2449;996;3046
510629;201312;1765;5928;1533;5426;558;2170;341;1131;899;3301
510630;201312;2615;8853;2197;8107;743;3076;594;2223;1337;5299
510631;201312;405;1194;360;1116;78;242;231;718;309;960
510637;201312;2548;7941;2317;7513;740;2639;1044;3281;1784;5920
510642;201312;4671;15513;4025;14637;1406;5365;1786;6796;3192;12161
510645;201312;701;1777;559;1599;216;642;168;535;384;1177
510650;201312;5917;20427;5539;19953;1394;5297;3342;12511;4736;17808
510665;201312;1210;3305;855;2729;209;757;377;1190;586;1947
510670;201312;349;875;211;672;49;184;79;233;128;417
510675;201312;6076;20444;5271;18878;1847;7260;1491;5212;3338;12472
510677;201312;2540;6555;1896;5711;281;888;1330;4146;1611;5034
510680;201312;793;2517;674;2313;154;589;291;929;445;1518
510682;201312;2332;7479;1938;6767;527;1967;838;3075;1365;5042
510685;201312;923;2595;789;2426;105;368;571;1758;676;2126
510700;201312;3808;10636;2884;9239;628;2204;1676;5368;2304;7572
510704;201312;7875;22843;6563;20519;1770;6235;3133;9451;4903;15686
510706;201312;1638;5217;1327;4693;415;1542;604;2134;1019;3676
510710;201312;3584;10353;2831;8824;836;2952;930;2585;1766;5537
510715;201312;697;1840;474;1467;122;412;173;497;295;909
510718;201312;1704;5211;1513;4949;405;1367;858;2881;1263;4248
510719;201312;442;1026;268;790;35;145;123;330;158;475
510720;201312;1256;3001;929;2614;88;270;717;2047;805;2317
510724;201312;812;2551;690;2317;158;587;396;1292;554;1879
510726;201312;667;1813;553;1619;162;495;200;561;362;1056
510729;201312;646;1824;523;1629;158;527;213;664;371;1191
510730;201312;2243;7144;2009;6721;495;1915;1108;3507;1603;5422
510735;201312;1055;3688;892;3408;336;1362;350;1333;686;2695
510740;201312;981;2568;799;2306;181;518;473;1403;654;1921
510757;201312;662;2356;608;2235;173;672;291;1065;464;1737
510760;201312;26966;78346;21755;69238;7994;27205;7097;22565;15091;49770
510770;201312;4313;11933;3970;11529;652;1879;2525;8194;3177;10073
510774;201312;378;1109;311;999;71;255;153;477;224;732
510775;201312;851;2409;676;2138;250;895;250;793;500;1688
510776;201312;448;1288;369;1147;87;305;174;525;261;830
510777;201312;1393;4402;1115;4058;273;1128;662;2376;935;3504
510779;201312;617;1875;471;1604;86;313;183;646;269;959
510780;201312;3790;11419;3318;10743;788;2742;1863;6184;2651;8926
510785;201312;1864;5699;1552;5168;533;1887;558;1891;1091;3778
510787;201312;1991;6373;1760;5958;552;2037;676;2232;1228;4269
510788;201312;355;1122;327;1084;148;482;102;354;250;836
510790;201312;14757;43966;10140;35042;3001;11882;1409;4659;4410;16541
510792;201312;5686;18999;4250;15867;1125;4821;813;2840;1938;7661
510794;201312;1360;4278;1074;3806;497;1858;213;682;710;2540
510795;201312;8344;28186;6830;24975;2349;9227;1774;6556;4123;15783
510800;201312;1765;5164;1485;4786;418;1481;702;2169;1120;3650
510805;201312;1801;5176;1489;4721;267;969;991;3101;1258;4070
510810;201312;674;1674;530;1475;152;458;264;718;416;1176
510820;201312;830;2112;640;1824;163;549;250;645;413;1194
510830;201312;551;1958;499;1874;175;695;223;892;398;1587
510835;201312;707;2234;556;1948;198;763;211;681;409;1444
510840;201312;48415;125117;39539;113923;10327;31596;20719;61506;31046;93102
510850;201312;1660;4958;1343;4463;597;2218;206;539;803;2757
510860;201312;2462;8413;2017;7401;705;2795;363;1277;1068;4072
510880;201312;826;2809;720;2612;259;989;255;927;514;1916
510885;201312;545;1584;408;1370;90;339;182;609;272;948
510890;201312;891;3057;766;2813;261;1069;197;648;458;1717
510895;201312;1113;3652;990;3422;307;1182;392;1269;699;2451
520005;201312;1185;3943;1104;3811;361;1310;481;1678;842;2988
520010;201312;1852;6479;1624;5985;719;2960;253;789;972;3749
520013;201312;3938;11176;3033;9574;776;2611;1386;4417;2162;7028
520015;201312;576;1616;463;1447;134;433;174;556;308;989
520017;201312;1177;3762;1033;3518;296;1088;436;1453;732;2541
520020;201312;415;1120;318;964;90;287;156;494;246;781
520025;201312;21830;72694;21281;71996;3396;12174;16345;55472;19741;67646
520030;201312;4484;14854;3991;14024;1360;5159;1476;5292;2836;10451
520050;201312;339;1031;312;972;64;225;205;615;269;840
520055;201312;667;2046;572;1882;149;485;288;982;437;1467
520060;201312;1656;5236;1448;4835;342;1260;588;2000;930;3260
520080;201312;1540;5108;1400;4854;376;1344;718;2551;1094;3895
520082;201312;612;2106;582;2043;149;519;340;1228;489;1747
520085;201312;1001;3212;872;2900;210;774;338;1113;548;1887
520090;201312;881;2252;735;2045;135;347;423;1255;558;1602
520110;201312;38599;119226;30491;106646;12472;47665;7664;27146;20136;74811
520120;201312;262;689;152;492;38;145;37;124;75;269
520130;201312;3647;10947;3380;10529;730;2456;2022;6308;2752;8764
520140;201312;42747;145546;38625;137082;14240;54457;10909;38480;25149;92937
520145;201312;545;1415;395;1202;96;320;160;463;256;783
520150;201312;680;1822;559;1673;163;535;265;779;428;1314
520160;201312;820;2521;735;2396;261;896;276;923;537;1819
520170;201312;3855;9665;3112;8862;606;1860;2128;6176;2734;8036
520180;201312;1690;5383;1479;5031;444;1628;601;2028;1045;3656
520215;201312;1620;4352;1405;4036;281;899;848;2442;1129;3341
520235;201312;811;2242;639;1991;195;667;263;791;458;1458
520250;201312;1104;3778;1027;3643;356;1335;491;1778;847;3113
520260;201312;731;1988;558;1668;97;335;284;817;381;1152
520280;201312;576;1699;514;1608;244;812;131;453;375;1265
520310;201312;983;2544;790;2296;209;637;437;1354;646;1991
520320;201312;1435;4739;1205;4281;218;826;677;2462;895;3288
520330;201312;2811;8918;2166;7718;668;2559;451;1538;1119;4097
520340;201312;1882;4901;1522;4478;223;621;1159;3528;1382;4149
520350;201312;2945;9079;2570;8311;951;3305;1045;3279;1996;6584
520355;201312;1115;3939;1079;3858;432;1625;433;1524;865;3149
520357;201312;882;2442;756;2261;71;240;521;1543;592;1783
520360;201312;593;1660;520;1543;144;434;238;710;382;1144
520380;201312;1094;3070;829;2612;174;609;437;1389;611;1998
520390;201312;1181;3181;831;2703;279;1035;308;910;587;1945
520393;201312;568;1526;513;1433;96;283;336;942;432;1225
520396;201312;707;2316;656;2229;102;387;440;1509;542;1896
520400;201312;1697;4935;1447;4588;280;964;902;2879;1182;3843
520410;201312;1471;4082;1187;3672;362;1228;529;1612;891;2840
520420;201312;340;957;256;800;50;183;115;340;165;523
520425;201312;1413;3992;1321;3828;448;1384;618;1766;1066;3150
520430;201312;1870;5085;1426;4342;314;1100;629;1833;943;2933
520440;201312;3122;8567;2379;7362;878;3003;612;1857;1490;4860
520450;201312;9255;27464;7217;23504;2161;7852;1418;4228;3579;12080
520455;201312;659;2010;541;1817;220;797;149;503;369;1300
520460;201312;809;2413;663;2162;195;705;249;789;444;1494
520465;201312;796;2221;697;2088;172;635;311;847;483;1482
520470;201312;1738;5734;1589;5513;412;1436;942;3427;1354;4863
520480;201312;953;2859;835;2665;194;646;491;1585;685;2231
520485;201312;1133;3952;1055;3809;415;1593;460;1660;875;3253
520490;201312;4304;13599;3489;12321;1507;5735;1095;3860;2602;9595
520495;201312;1391;3809;1160;3532;84;245;1014;3153;1098;3398
520500;201312;2024;5499;1813;5202;626;1913;726;2251;1352;4164
520505;201312;892;2589;771;2403;125;378;532;1722;657;2100
520510;201312;10895;31198;7334;25030;2305;8674;1825;6185;4130;14859
520520;201312;1030;3050;876;2840;341;1184;333;1095;674;2279
520530;201312;2363;7423;2027;6867;486;1678;989;3699;1475;5377
520540;201312;2936;9136;2564;8477;849;2960;1003;3304;1852;6264
520545;201312;1311;4089;1120;3684;342;1216;329;1022;671;2238
520547;201312;783;2518;634;2237;220;859;175;577;395;1436
520549;201312;8424;26334;7381;25004;2135;7734;3785;12872;5920;20606
520551;201312;3696;11406;3543;11212;1101;3626;1942;6389;3043;10015
520552;201312;689;2334;672;2310;125;480;448;1528;573;2008
520570;201312;565;1692;426;1457;185;675;76;255;261;930
520580;201312;1948;5817;1608;5294;500;1853;511;1600;1011;3453
520590;201312;1492;4300;1277;3947;356;1170;498;1452;854;2622
520620;201312;6966;23019;6366;22089;1517;5663;3672;12880;5189;18543
520630;201312;628;1793;543;1688;162;494;297;953;459;1447
520640;201312;2501;7616;2251;7222;813;2718;949;3192;1762;5910
520650;201312;793;2331;686;2135;287;943;251;768;538;1711
520660;201312;361;1160;314;1060;107;396;96;320;203;716
520670;201312;791;2406;766;2368;74;184;661;2099;735;2283
520680;201312;585;1795;506;1680;182;665;187;610;369;1275
520690;201312;312;831;220;703;36;121;121;398;157;519
520710;201312;423;1095;303;875;11;40;196;548;207;588
520725;201312;1752;4710;1378;4166;337;1147;711;2106;1048;3253
520735;201312;661;2005;533;1768;181;647;161;514;342;1161
520740;201312;1670;4935;1405;4548;400;1373;662;2135;1062;3508
520750;201312;683;1869;519;1648;142;509;296;934;438;1443
520753;201312;1135;3401;1105;3352;177;490;836;2641;1013;3131
520760;201312;1134;3214;1001;3043;334;1099;533;1597;867;2696
520780;201312;1960;5033;1682;4654;196;521;1297;3690;1493;4211
520790;201312;2487;7218;2232;6853;356;1198;1580;4895;1936;6093
520800;201312;17077;51609;15292;49454;3680;11740;9034;31479;12714;43219
520810;201312;923;2620;840;2512;146;459;606;1876;752;2335
520815;201312;432;1508;339;1320;168;736;31;112;199;848
520830;201312;1681;4361;1319;3983;61;160;1193;3693;1254;3853
520840;201312;1624;5559;1466;5238;515;1950;499;1823;1014;3773
520850;201312;774;2301;616;2081;194;703;278;921;472;1624
520860;201312;6896;20006;5224;17738;1490;5487;2480;8619;3970;14106
520870;201312;119426;341713;85650;279662;28352;100587;25244;81505;53596;182092
520880;201312;6566;19513;4787;16548;1468;5696;677;2136;2145;7832
520890;201312;3654;10971;3251;10337;791;2702;1708;5415;2499;8117
520910;201312;3186;10135;2628;8949;841;3163;673;2189;1514;5352
520915;201312;907;2616;673;2157;173;572;255;773;428;1345
520920;201312;3110;8584;2230;7119;601;2083;663;2160;1264;4243
520929;201312;442;1322;399;1271;117;388;203;645;320;1033
520940;201312;946;2934;858;2795;132;492;600;1922;732;2414
520945;201312;618;1589;547;1476;214;584;191;495;405;1079
520960;201312;885;2635;727;2391;133;465;413;1353;546;1818
520970;201312;3334;9873;2706;8718;636;2310;1064;3339;1700;5649
520980;201312;1004;2752;932;2657;221;702;615;1722;836;2424
520990;201312;3650;11512;3249;10808;690;2473;1732;6267;2422;8740
520993;201312;1104;3127;897;2737;145;487;529;1587;674;2074
520995;201312;2535;7082;2285;6742;380;1186;1606;4744;1986;5930
521000;201312;7620;23263;6517;21408;1566;5683;3346;10976;4912;16659
521010;201312;3690;11789;3192;10798;854;3121;1310;4439;2164;7560
521015;201312;676;1947;576;1784;141;450;296;931;437;1381
521020;201312;4360;13108;3444;11166;1221;4262;685;1982;1906;6244
521030;201312;806;2193;710;2058;151;458;456;1339;607;1797
521040;201312;5364;16008;4920;15301;1946;6146;2234;7279;4180;13425
521056;201312;978;3050;831;2803;292;1025;341;1181;633;2206
521060;201312;1120;3192;972;2938;249;803;397;1168;646;1971
521080;201312;1163;2983;774;2323;161;569;277;709;438;1278
521090;201312;3069;9303;2638;8680;983;3435;899;2967;1882;6402
521100;201312;1387;3671;1281;3549;255;700;881;2515;1136;3215
521120;201312;4691;13891;4306;13229;1042;3147;2394;7639;3436;10786
521130;201312;1072;3119;903;2831;220;778;441;1388;661;2166
521140;201312;885;3005;795;2789;305;1143;169;564;474;1707
521150;201312;12274;33241;8549;26004;2632;8813;3374;10093;6006;18906
521160;201312;719;1879;499;1429;92;297;290;788;382;1085
521170;201312;1311;3207;1122;2971;345;893;616;1646;961;2539
521180;201312;6283;21647;5735;20496;2156;8240;1570;5580;3726;13820
521190;201312;8412;25562;6393;22015;2286;8300;1988;6909;4274;15209
521200;201312;830;2215;774;2144;110;322;570;1584;680;1906
521205;201312;487;1588;432;1473;74;273;257;886;331;1159
521210;201312;867;2575;628;2088;239;911;209;603;448;1514
521220;201312;3757;10874;3182;10063;1116;3822;1212;3763;2328;7585
521225;201312;380;1000;302;896;48;157;196;595;244;752
521230;201312;1315;4201;1214;3991;481;1670;503;1586;984;3256
521250;201312;25351;86617;24242;84760;9850;36834;9604;33891;19454;70725
521260;201312;797;1993;631;1691;117;405;349;859;466;1264
521270;201312;1720;5626;1605;5416;165;484;1245;4410;1410;4894
521280;201312;1772;5599;1527;5159;489;1770;596;2016;1085;3786
521290;201312;503;1508;380;1294;112;452;144;467;256;919
521295;201312;1095;3113;1023;3014;157;489;778;2299;935;2788
521300;201312;1778;5273;1634;5030;559;1775;709;2268;1268;4043
521305;201312;837;2232;703;2047;178;519;411;1237;589;1756
521308;201312;4941;14986;4012;13414;813;3032;2291;7547;3104;10579
521310;201312;7096;22118;5808;19652;2181;7827;1480;4855;3661;12682
521340;201312;239;778;219;741;73;276;84;265;157;541
521350;201312;2181;5693;1791;5165;253;785;1163;3538;1416;4323
521370;201312;1000;3259;915;3087;328;1178;303;977;631;2155
521375;201312;1338;3925;1163;3630;294;1013;601;1823;895;2836
521377;201312;1005;2959;958;2903;86;247;820;2531;906;2778
521380;201312;3712;11108;2956;9784;722;2644;1131;3631;1853;6275
521385;201312;586;1688;526;1606;175;556;228;698;403;1254
521390;201312;1108;2939;821;2538;256;902;259;778;515;1680
521400;201312;2396;6553;2059;6154;337;1119;1485;4394;1822;5513
521405;201312;1175;3577;1055;3354;311;1088;467;1479;778;2567
521410;201312;736;2411;675;2303;310;1047;240;862;550;1909
521440;201312;1474;4143;1449;4117;151;388;1240;3607;1391;3995
521450;201312;4924;15146;4109;13609;1361;4859;1016;3203;2377;8062
521460;201312;6936;22073;6387;21198;1949;7045;3053;10065;5002;17110
521470;201312;694;1979;520;1645;125;453;107;331;232;784
521480;201312;509;1510;373;1258;126;430;92;310;218;740
521483;201312;3064;8275;2568;7421;723;2229;1059;3002;1782;5231
521486;201312;1567;4510;1422;4226;365;1216;857;2438;1222;3654
521487;201312;551;1532;418;1328;95;304;216;701;311;1005
521490;201312;813;2406;658;2192;118;443;427;1432;545;1875
521500;201312;1204;4029;1107;3822;202;771;666;2202;868;2973
521520;201312;881;2133;780;2015;197;432;433;1259;630;1691
521523;201312;11277;42577;10637;41424;3477;14964;2906;11538;6383;26502
521525;201312;1104;2895;977;2727;135;431;657;1782;792;2213
521530;201312;1992;6031;1389;4804;544;1980;234;760;778;2740
521540;201312;884;2603;648;2121;198;758;174;498;372;1256
521550;201312;949;2424;851;2283;253;734;448;1157;701;1891
521560;201312;4894;15104;3919;13784;1663;6393;1038;3498;2701;9891
521565;201312;697;1862;596;1731;108;314;404;1200;512;1514
521570;201312;4470;12735;3283;10364;1145;3878;1039;3289;2184;7167
521580;201312;665;1652;481;1390;174;543;156;444;330;987
521590;201312;749;2140;621;1922;234;789;116;371;350;1160
521600;201312;620;1652;443;1335;117;389;156;421;273;810
521630;201312;1781;4883;1478;4390;563;1941;256;602;819;2543
521640;201312;1744;5139;1528;4799;521;1892;419;1350;940;3242
521645;201312;646;2020;545;1779;145;530;223;671;368;1201
521680;201312;1442;4666;1245;4237;680;2445;196;619;876;3064
521690;201312;574;1742;512;1626;127;477;239;699;366;1176
521710;201312;2203;6996;1955;6509;416;1489;1157;3831;1573;5320
521720;201312;2050;6166;1882;5931;498;1633;1077;3501;1575;5134
521730;201312;3781;12862;3515;12323;1547;5941;968;3125;2515;9066
521740;201312;3374;9493;2739;8675;1287;4182;958;3174;2245;7356
521760;201312;12088;42006;11405;40948;2128;8527;7589;27355;9717;35882
521770;201312;2711;8388;2297;7537;1031;3622;483;1464;1514;5086
521800;201312;8621;25944;7435;24159;2738;9397;3305;11093;6043;20490
521805;201312;926;2195;780;1951;259;586;376;1086;635;1672
521810;201312;812;2422;709;2238;177;606;355;1100;532;1706
521830;201312;5431;18540;5135;18069;1070;4102;3385;11891;4455;15993
521839;201312;600;1878;506;1673;140;498;203;637;343;1135
521850;201312;6416;18625;5732;17510;1389;4251;3169;9833;4558;14084
521860;201312;1719;5318;1485;4833;424;1512;533;1651;957;3163
521870;201312;550;1949;509;1836;159;622;144;479;303;1101
521878;201312;465;1588;426;1508;134;529;162;549;296;1078
521880;201312;24632;66341;16899;53382;6001;20362;4849;15440;10850;35802
521890;201312;3564;11271;3022;10162;1190;4279;713;2361;1903;6640
521900;201312;1661;4461;1356;4026;360;1186;531;1459;891;2645
521910;201312;1177;3356;1033;3187;268;918;583;1825;851;2743
521920;201312;381;1174;354;1127;136;462;141;433;277;895
521925;201312;625;1948;549;1787;127;463;240;721;367;1184
521930;201312;3834;12576;3482;11874;1327;4804;1068;3646;2395;8450
521935;201312;669;2028;634;1958;198;645;327;984;525;1629
521940;201312;1136;3095;933;2751;352;1108;310;915;662;2023
521945;201312;661;2298;613;2240;132;434;431;1684;563;2118
521950;201312;491;1614;432;1504;149;552;170;596;319;1148
521960;201312;927;2754;788;2505;199;677;371;1160;570;1837
521970;201312;2460;7116;2250;6841;365;1132;1598;4998;1963;6130
521971;201312;936;2614;752;2303;191;656;303;876;494;1532
521973;201312;857;2912;774;2742;229;856;255;891;484;1747
521975;201312;13158;38581;12390;37561;2490;8226;7880;23965;10370;32191
521980;201312;1721;5567;1673;5512;289;925;1299;4413;1588;5338
521990;201312;1022;3260;951;3132;177;634;588;1907;765;2541
522000;201312;2076;6210;1835;5898;401;1379;1088;3623;1489;5002
522005;201312;349;953;279;842;72;232;138;409;210;641
522010;201312;2828;8664;2449;8031;908;3261;709;2225;1617;5486
522015;201312;1000;2969;837;2720;244;884;385;1237;629;2121
522020;201312;4428;12552;3945;11939;980;3247;2316;6872;3296;10119
522026;201312;641;1853;458;1661;210;811;133;495;343;1306
522028;201312;530;1598;478;1511;121;417;283;874;404;1291
522040;201312;3032;7890;2231;6848;812;2675;870;2681;1682;5356
522045;201312;12141;40745;10432;37083;3598;13983;2218;7632;5816;21615
522050;201312;1004;2987;825;2683;280;1008;324;998;604;2006
522060;201312;2882;9274;2491;8653;798;2985;1246;4289;2044;7274
522068;201312;1503;4952;1416;4856;141;425;1162;4195;1303;4620
522070;201312;825;2541;754;2423;122;471;482;1530;604;2001
522100;201312;803;2248;711;2104;266;904;314;849;580;1753
522108;201312;928;2759;813;2586;94;309;596;1942;690;2251
522119;201312;1263;3930;1063;3669;129;436;800;2875;929;3311
522130;201312;506;1479;436;1401;133;465;221;720;354;1185
522140;201312;17338;49901;15238;46769;4794;15964;6351;19108;11145;35072
522145;201312;902;2629;853;2545;445;1400;217;636;662;2036
522150;201312;1256;3340;1025;3026;381;1188;373;1127;754;2315
522155;201312;722;2180;657;2082;147;488;392;1291;539;1779
522157;201312;688;2041;608;1909;71;254;468;1465;539;1719
522160;201312;6086;17742;4546;15082;1910;6975;803;2506;2713;9481
522170;201312;3170;8870;2681;8183;784;2438;1148;3692;1932;6130
522180;201312;434;1281;333;1136;154;586;109;355;263;941
522185;201312;13979;44755;13073;43502;2930;10587;7907;26407;10837;36994
522190;201312;781;2218;688;2035;126;387;404;1210;530;1597
522200;201312;1550;5264;1428;4997;507;1923;427;1440;934;3363
522205;201312;1287;3763;1079;3410;329;1089;471;1496;800;2585
522220;201312;1171;3498;1004;3276;236;849;530;1830;766;2679
522230;201312;1085;3422;998;3281;196;727;629;2077;825;2804
530010;201312;250682;825880;224956;772800;70512;267214;74329;253387;144841;520601
110001;201311;4354;14504;3784;13573;1100;4079;2028;7364;3128;11443
110002;201311;12771;41862;11279;39225;3827;14259;4771;16659;8598;30918
110003;201311;980;3221;915;3115;277;999;376;1246;653;2245
110004;201311;9373;31208;8093;28477;2605;10006;2738;9604;5343;19610
110005;201311;2347;7986;2234;7767;849;3041;934;3291;1783;6332
110006;201311;3411;9244;2142;7455;719;2654;616;2028;1335;4682
110007;201311;1478;4766;1369;4602;321;1149;775;2748;1096;3897
110008;201311;2538;8865;2381;8638;579;2009;1577;6015;2156;8024
110009;201311;5310;15526;4183;13848;1014;3543;2228;7370;3242;10913
110010;201311;8382;24291;7423;23104;1479;4168;4879;16472;6358;20640
110011;201311;10819;33675;8956;30447;3451;12435;3112;10583;6563;23018
110012;201311;16139;51006;14282;47421;5104;17955;5165;17006;10269;34961
110013;201311;5196;16759;4358;15541;1398;5247;1974;7190;3372;12437
110014;201311;4263;12889;3632;11989;860;2968;2132;7133;2992;10101
110015;201311;5041;16591;4173;15024;1654;6339;1391;5024;3045;11363
110018;201311;5106;15251;4196;14051;1343;4987;1881;6062;3224;11049
110020;201311;54240;163056;46478;153218;10850;36892;27612;93846;38462;130738
110025;201311;4399;13142;3723;11895;619;2143;2635;8377;3254;10520
110026;201311;813;2396;688;2247;160;528;447;1512;607;2040
110028;201311;7409;22246;5619;19278;1755;6560;1616;5446;3371;12006
110029;201311;1681;5014;1355;4449;452;1556;566;1888;1018;3444
110030;201311;11280;32959;9287;30393;2579;9051;4808;16290;7387;25341
110032;201311;4054;13454;3652;12553;1074;3841;1571;5443;2645;9284
110033;201311;5433;17594;5073;17033;1714;5844;2304;8274;4018;14118
110034;201311;3835;10142;3235;9436;497;1409;2505;7417;3002;8826
110037;201311;2038;7009;1802;6566;514;1879;960;3565;1474;5444
110040;201311;3483;11588;3255;11166;1080;3972;1509;5131;2589;9103
110045;201311;5168;18147;4809;17709;1426;5561;2783;10251;4209;15812
110050;201311;1823;5910;1524;5518;551;2028;766;2847;1317;4875
110060;201311;989;3486;876;3274;260;1022;456;1700;716;2722
110070;201311;1923;6663;1870;6536;326;1193;1325;4659;1651;5852
110080;201311;3391;11056;3267;10894;680;2146;2422;8327;3102;10473
110090;201311;930;2807;747;2515;234;873;313;978;547;1851
110092;201311;1730;5631;1572;5421;381;1339;889;3228;1270;4567
110094;201311;3044;9961;2802;9604;744;2724;1623;5664;2367;8388
110100;201311;2651;8580;2303;7994;714;2574;1163;4077;1877;6651
110110;201311;1763;5802;1651;5670;745;2591;706;2543;1451;5134
110120;201311;1588;5416;1351;4822;381;1414;513;1837;894;3251
110130;201311;2777;8047;2128;7105;572;2003;1029;3478;1601;5481
110140;201311;2478;8669;2357;8472;535;1944;1522;5595;2057;7539
110143;201311;1540;5120;1247;4615;321;1233;690;2548;1011;3781
110145;201311;982;3058;872;2877;173;610;552;1829;725;2439
110146;201311;444;1447;401;1378;109;385;216;754;325;1139
110147;201311;900;2722;708;2400;204;750;250;765;454;1515
110148;201311;1333;4013;1070;3479;352;1268;359;1098;711;2366
110149;201311;3657;10914;2905;9746;692;2443;1801;6130;2493;8573
110150;201311;2835;8514;2347;7779;404;1471;1504;5008;1908;6479
110155;201311;911;3090;870;2997;300;1097;415;1398;715;2495
110160;201311;2142;6823;1779;6188;606;2161;815;2861;1421;5022
110170;201311;3196;9406;2520;8257;550;1931;1559;5141;2109;7072
110175;201311;1596;5204;1237;4739;119;497;920;3569;1039;4066
110180;201311;1691;5354;1452;4947;350;1219;867;2995;1217;4214
120001;201311;2838;10360;2747;10183;740;2912;1521;5765;2261;8677
120005;201311;1525;6242;1477;6150;182;717;1133;4911;1315;5628
120010;201311;4361;15678;4189;15373;1015;3522;2644;10223;3659;13745
120013;201311;1811;7125;1776;7066;363;1438;1190;4936;1553;6374
120017;201311;2088;7532;1975;7330;554;2151;951;3822;1505;5973
120020;201311;14043;62044;13816;61497;2596;10943;9856;45988;12452;56931
120025;201311;2656;9352;2582;9234;646;2413;1554;5675;2200;8088
120030;201311;5778;23638;5721;23542;569;2191;4787;20182;5356;22373
120032;201311;1355;6614;1303;6478;184;1053;950;4764;1134;5817
120033;201311;3575;13722;3544;13663;218;883;3136;12232;3354;13115
120034;201311;1753;7115;1746;7103;70;325;1638;6654;1708;6979
120035;201311;2657;12996;2631;12929;252;1206;2177;11042;2429;12248
120038;201311;3170;11786;3057;11542;879;3393;1621;6328;2500;9721
120039;201311;1349;7686;1326;7627;185;1112;1035;6062;1220;7174
120040;201311;43492;160709;40520;154196;12624;50255;19272;75381;31896;125636
120042;201311;2719;11975;2622;11726;438;2063;1832;8367;2270;10430
120043;201311;822;3975;801;3922;75;362;671;3363;746;3725
120045;201311;4366;15487;4317;15409;1051;3714;2934;10783;3985;14497
120050;201311;8035;33613;7802;33116;1616;6706;5052;22729;6668;29435
120060;201311;6097;29708;6011;29551;792;3848;4746;24068;5538;27916
120070;201311;2713;10488;2665;10367;582;2146;1695;6962;2277;9108
120080;201311;3624;13820;3480;13582;603;2411;2495;10026;3098;12437
130002;201311;2839;12168;2679;11890;289;1310;2113;9551;2402;10861
130006;201311;1678;7327;1510;7006;187;968;1101;5159;1288;6127
130008;201311;1949;8090;1875;7949;187;861;1485;6428;1672;7289
130010;201311;2708;9179;2353;8760;254;858;1933;7426;2187;8284
130014;201311;3386;11074;2936;10404;454;1752;1978;7075;2432;8827
130020;201311;2392;8536;2378;8520;58;220;2297;8231;2355;8451
130030;201311;6724;26840;6536;26586;571;1975;5641;23631;6212;25606
130040;201311;3636;11568;3430;11268;354;1224;2858;9422;3212;10646
130050;201311;5824;23717;5159;22647;773;3258;3593;16915;4366;20173
130060;201311;5876;25492;5539;25014;642;2833;4480;20707;5122;23540
130063;201311;3183;14150;3161;14108;400;1723;2604;11887;3004;13610
130068;201311;2988;12685;2777;12264;356;1741;2009;8921;2365;10662
130070;201311;6398;21972;5919;21327;711;2523;4654;17192;5365;19715
130080;201311;4940;22175;4806;21966;834;3927;3438;16167;4272;20094
130083;201311;1705;7300;1637;7182;293;1380;1142;5041;1435;6421
130090;201311;2363;8783;2256;8631;201;904;1910;7278;2111;8182
130100;201311;5340;20818;5141;20538;461;1992;4304;17389;4765;19381
130110;201311;6475;21219;6079;20730;865;2832;4737;16732;5602;19564
130115;201311;3556;13435;3395;13218;162;485;3149;12458;3311;12943
130120;201311;12971;50836;12681;50424;1213;4455;10720;43942;11933;48397
130130;201311;3312;14471;3209;14277;482;2104;2454;11212;2936;13316
130140;201311;5697;23132;5656;23079;141;424;5462;22538;5603;22962
130150;201311;3472;12963;3398;12867;229;1086;2963;11166;3192;12252
130160;201311;3850;16031;3789;15941;244;883;3449;14733;3693;15616
130165;201311;2728;11341;2688;11272;486;2040;2065;8786;2551;10826
130170;201311;8420;31858;7418;30543;1446;6004;4917;21295;6363;27299
130180;201311;3316;10647;3250;10555;117;365;3030;9890;3147;10255
130185;201311;8744;31714;8450;31320;1611;5729;6126;23659;7737;29388
130190;201311;16208;58018;14463;55768;3154;11734;9180;37714;12334;49448
130195;201311;1749;7349;1690;7259;96;445;1490;6475;1586;6920
130200;201311;1959;7187;1822;6950;352;1399;1205;4667;1557;6066
130210;201311;1122;4473;1067;4372;176;693;794;3389;970;4082
130220;201311;2006;8340;1832;8014;369;1797;1078;4748;1447;6545
130230;201311;3285;15054;3124;14772;393;1992;2326;11352;2719;13344
130240;201311;8056;31838;7486;30982;527;2444;6337;26647;6864;29091
130250;201311;16992;63220;16505;62491;3019;10966;11969;47345;14988;58311
130255;201311;3902;14366;3695;14002;213;683;3248;12695;3461;13378
130260;201311;242224;794571;220110;759097;62399;219629;115455;413255;177854;632884
130270;201311;7232;30426;6545;29337;1115;4852;4627;21797;5742;26649
130280;201311;3142;12414;3073;12310;155;520;2771;11376;2926;11896
130290;201311;10508;38441;10329;38181;228;681;9758;36621;9986;37302
130300;201311;4289;16932;4051;16584;353;1545;3312;13774;3665;15319
130310;201311;4716;18361;4308;17837;671;2674;3165;13622;3836;16296
130320;201311;2758;9677;2529;9355;370;1427;1799;6837;2169;8264
130330;201311;3335;12636;2979;12141;240;1036;2482;10309;2722;11345
130340;201311;16830;66436;16291;65547;3062;11691;11045;47264;14107;58955
130350;201311;3200;13035;3061;12873;315;1161;2561;11112;2876;12273
130353;201311;5416;17581;4818;16749;1322;4585;2664;9873;3986;14458
130356;201311;4092;15129;3940;14891;518;1850;3092;12203;3610;14053
130360;201311;2705;8030;2439;7718;53;116;2276;7398;2329;7514
130370;201311;4807;19202;4118;18280;273;1487;3437;15324;3710;16811
130380;201311;6700;28377;6462;27988;444;2081;5550;24278;5994;26359
130390;201311;4412;19776;4143;19309;494;2319;3266;15638;3760;17957
130395;201311;1993;7509;1835;7217;316;1356;1183;4662;1499;6018
130400;201311;2134;7807;2065;7703;95;369;1875;7078;1970;7447
130406;201311;9125;35515;8173;33936;2089;8469;4628;20591;6717;29060
130410;201311;4069;15664;3761;15080;910;3776;2103;8790;3013;12566
130420;201311;9617;41669;9337;41045;2836;12203;5144;23957;7980;36160
130423;201311;3032;12039;2881;11838;238;1140;2437;10041;2675;11181
130426;201311;1977;8610;1893;8459;344;1519;1318;6156;1662;7675
130430;201311;3396;12377;3209;12098;399;1628;2348;9042;2747;10670
130440;201311;3692;13570;3401;13251;227;780;2998;12029;3225;12809
140002;201311;1389;4800;1316;4686;200;674;913;3445;1113;4119
140005;201311;2503;7872;2350;7693;136;423;2113;7013;2249;7436
140010;201311;43573;143995;39550;137230;9321;34397;22673;80402;31994;114799
140015;201311;2689;9166;2601;9046;240;596;2224;8077;2464;8673
140017;201311;2825;9172;2708;9020;209;657;2329;7918;2538;8575
140020;201311;4181;14458;3922;14108;520;1826;2955;10998;3475;12824
140023;201311;1875;6675;1735;6455;244;937;1244;4787;1488;5724
140028;201311;2088;5932;2023;5857;108;250;1835;5444;1943;5694
140030;201311;3507;11453;3363;11265;399;999;2818;9937;3217;10936
140040;201311;1463;7127;1408;6953;133;743;1045;5259;1178;6002
140045;201311;2329;8627;2209;8459;287;960;1716;6988;2003;7948
140047;201311;5101;14738;4706;14182;1545;4818;1983;6473;3528;11291
140050;201311;1467;4595;1367;4452;178;591;1039;3461;1217;4052
140060;201311;1359;4390;1246;4233;353;1237;697;2464;1050;3701
140070;201311;1420;7005;1417;6999;58;235;1346;6722;1404;6957
150010;201311;31793;105608;30514;103878;2260;8072;26076;89904;28336;97976
150013;201311;1516;4835;1468;4779;135;466;1218;3994;1353;4460
150020;201311;10574;37672;10339;37314;1451;5225;8057;29742;9508;34967
150030;201311;6188;27348;6029;27072;656;2504;4994;23419;5650;25923
150034;201311;4328;11916;4111;11652;150;339;3898;11205;4048;11544
150040;201311;11872;42294;10488;40534;2247;7915;7000;29098;9247;37013
150050;201311;5914;22881;5777;22621;656;2788;4622;18253;5278;21041
150060;201311;14579;48724;13838;47613;3595;12125;8264;29789;11859;41914
150070;201311;5175;22395;4791;21923;557;2576;3893;18169;4450;20745
150080;201311;58612;162886;52336;154913;7336;20031;38841;118856;46177;138887
150085;201311;4944;17797;4744;17505;736;2371;3649;14185;4385;16556
150090;201311;9666;38114;9147;37386;1235;4821;7118;29989;8353;34810
150095;201311;5012;17664;4664;17111;552;2017;3668;13840;4220;15857
150100;201311;3352;12892;3166;12621;293;1378;2559;10135;2852;11513
150110;201311;3124;15067;3112;15037;161;672;2879;14105;3040;14777
150120;201311;5803;23207;5677;22959;959;3782;4260;17580;5219;21362
150125;201311;782;2461;720;2359;166;580;432;1408;598;1988
150130;201311;19244;62878;18432;61669;1844;6192;14960;50815;16804;57007
150140;201311;138680;424580;134054;418749;18930;59353;105439;333984;124369;393337
150145;201311;4677;15236;4345;14809;667;2357;3159;10980;3826;13337
150150;201311;9113;30637;8575;29770;1894;6843;5456;19202;7350;26045
150157;201311;2763;9001;2527;8670;411;1444;1897;6593;2308;8037
150160;201311;2712;9421;2597;9251;707;2417;1552;5831;2259;8248
150170;201311;21682;81189;20625;79809;3598;13695;15287;60241;18885;73936
150172;201311;2938;10369;2668;9967;324;1233;2154;8187;2478;9420
150175;201311;1970;6305;1905;6228;151;461;1666;5569;1817;6030
150178;201311;10610;33730;9224;32089;559;1692;8254;29412;8813;31104
150180;201311;17345;71147;16841;70456;1648;7151;14078;59766;15726;66917
150190;201311;7045;22862;6669;22335;446;1081;5825;20339;6271;21420
150195;201311;4397;15986;4129;15509;477;1787;3270;12494;3747;14281
150200;201311;4895;16228;4773;16076;142;418;4485;15286;4627;15704
150210;201311;21770;84404;21486;83996;2245;8365;18209;72501;20454;80866
150215;201311;5574;18277;5107;17580;1279;4540;2976;10499;4255;15039
150220;201311;12228;40172;11294;38664;2779;9740;6358;22389;9137;32129
150230;201311;10961;38097;10010;36753;859;3798;8304;30257;9163;34055
150240;201311;32700;102230;29986;97586;8996;30535;14058;47043;23054;77578
150250;201311;3740;15449;3625;15264;719;2862;2523;11230;3242;14092
150260;201311;1821;7761;1753;7635;350;1663;1091;4811;1441;6474
150270;201311;9375;28970;7340;26421;1689;6455;4509;16570;6198;23025
150275;201311;5592;20959;5320;20518;861;3386;3865;15225;4726;18611
150276;201311;2060;6272;1936;6113;295;966;1507;4790;1802;5756
150277;201311;4997;15940;4403;15238;533;1882;3503;12385;4036;14267
150280;201311;5747;25280;5611;24970;796;3487;4288;19566;5084;23053
150285;201311;2598;10663;2571;10603;275;1147;2143;8940;2418;10087
150290;201311;8231;26762;8068;26542;846;2598;6688;22629;7534;25227
150293;201311;8121;26127;7068;24476;2427;8660;3138;11422;5565;20082
150295;201311;5563;19389;4957;18599;1202;4618;3107;11994;4309;16612
150300;201311;1771;6328;1735;6277;124;434;1459;5439;1583;5873
150304;201311;4000;12743;3489;12046;515;1780;2567;9140;3082;10920
150307;201311;6433;22528;6003;21901;491;1727;4995;18773;5486;20500
150309;201311;6344;23189;5937;22620;1639;6193;3646;14548;5285;20741
150310;201311;4882;23042;4799;22901;535;2378;3952;19450;4487;21828
150320;201311;8403;23234;8090;22888;580;1527;7067;20430;7647;21957
150330;201311;12658;47311;12079;46365;1479;5714;9483;37302;10962;43016
150340;201311;2066;7295;1957;7135;417;1616;1261;4652;1678;6268
150345;201311;6313;22659;5924;22124;697;2631;4781;18270;5478;20901
150350;201311;7136;24220;6790;23704;1025;3526;5019;17891;6044;21417
150360;201311;20405;66006;17999;62988;2743;9764;13166;47556;15909;57320
150370;201311;9738;37430;9372;36917;1149;4173;7640;31200;8789;35373
150375;201311;2702;11524;2648;11456;217;740;2289;10355;2506;11095
150380;201311;9103;28993;8323;27908;887;3176;6892;23179;7779;26355
150390;201311;7967;34676;7626;33964;1861;7829;4605;21758;6466;29587
150400;201311;5239;22231;5077;21874;648;2712;3785;16851;4433;19563
150405;201311;8042;25580;7332;24677;1517;4634;4973;17853;6490;22487
150410;201311;1658;6521;1626;6465;312;1255;1054;4337;1366;5592
150420;201311;31935;117661;29179;113086;7746;31462;15837;63702;23583;95164
150430;201311;6359;24058;6176;23722;805;3368;4740;18333;5545;21701
150440;201311;5223;18584;5123;18425;799;2832;3817;14027;4616;16859
150442;201311;21067;61878;19391;59730;3239;10129;13611;43135;16850;53264
150445;201311;5022;18155;4659;17635;710;2536;3549;13870;4259;16406
150450;201311;4149;20034;4021;19860;412;2000;3358;16950;3770;18950
150460;201311;6730;24945;5642;23785;476;2101;4853;20934;5329;23035
150470;201311;16640;52117;16123;51453;1427;3811;13967;45941;15394;49752
150475;201311;136;263;79;196;25;69;22;56;47;125
150480;201311;13792;47846;13261;47094;952;3099;11475;41703;12427;44802
150490;201311;6296;24741;6188;24601;351;1394;5598;22484;5949;23878
150495;201311;4431;16754;4345;16597;388;1507;3734;14365;4122;15872
150497;201311;3248;11466;2978;11012;861;3211;1670;6434;2531;9645
150500;201311;2845;8688;2728;8494;395;1231;2070;6497;2465;7728
150503;201311;3718;11933;3185;11243;1190;4395;1369;5042;2559;9437
150506;201311;11793;43327;11176;42450;2704;9185;7373;30075;10077;39260
150510;201311;9393;37832;8861;36894;1463;6116;6247;27082;7710;33198
150520;201311;5976;24981;5882;24840;505;1697;5181;22529;5686;24226
150530;201311;11021;40693;10110;39304;1444;5136;7499;30332;8943;35468
150540;201311;4548;14342;4168;13767;361;1235;3462;11452;3823;12687
150543;201311;4701;15351;4363;14862;1367;4714;2458;8608;3825;13322
150548;201311;7968;26337;7535;25778;676;2146;6448;22579;7124;24725
150549;201311;2155;6970;2057;6848;111;291;1855;6332;1966;6623
150550;201311;20584;66955;18517;63412;5608;19884;8830;30964;14438;50848
150553;201311;21101;78873;19069;73759;7806;32200;3549;13512;11355;45712
150555;201311;1615;5245;1432;4972;243;912;997;3492;1240;4404
150560;201311;1965;6451;1901;6307;241;881;1432;4710;1673;5591
150563;201311;2812;9491;2633;9162;625;2339;1566;5440;2191;7779
150565;201311;3308;12114;3120;11832;266;1110;2519;9713;2785;10823
150570;201311;5057;19885;4981;19761;414;1594;4200;17091;4614;18685
150580;201311;9180;38183;9028;37985;828;3003;7768;33873;8596;36876
150590;201311;5253;21581;5141;21445;149;657;4847;20345;4996;21002
150600;201311;7316;29344;7160;29082;627;2317;6140;25636;6767;27953
150610;201311;2422;8448;2253;8090;290;1173;1559;5515;1849;6688
150611;201311;2529;9608;2424;9359;298;1218;1778;6952;2076;8170
150613;201311;11080;35235;9782;33362;3362;11750;4564;16404;7926;28154
150616;201311;3001;8787;2417;8121;581;1919;1535;5343;2116;7262
150618;201311;7314;26066;7022;25516;2326;8839;3401;12594;5727;21433
150619;201311;5104;18053;4808;17607;741;2864;3436;12754;4177;15618
150620;201311;5913;21996;5414;21341;804;3193;4091;16717;4895;19910
150630;201311;5166;16723;4950;16438;436;1454;4169;14040;4605;15494
150635;201311;4392;14710;4127;14212;815;2890;2566;9139;3381;12029
150640;201311;1393;4598;1380;4577;38;106;1308;4391;1346;4497
150650;201311;11661;37125;10715;35406;2971;10222;5560;18685;8531;28907
150655;201311;5246;17801;4851;17223;749;2722;3584;12929;4333;15651
150658;201311;3959;13428;3766;13112;387;1619;2940;10145;3327;11764
150660;201311;5496;17847;5044;17259;1375;4654;2926;10430;4301;15084
150670;201311;5975;17989;5228;17087;1737;5745;2730;9544;4467;15289
150680;201311;49443;198867;46714;193744;16507;68210;21044;93955;37551;162165
150690;201311;1776;5971;1660;5757;278;992;1078;3844;1356;4836
150700;201311;5664;18231;5379;17854;1131;3750;3610;12288;4741;16038
150710;201311;3946;13001;3637;12524;387;1138;3006;10668;3393;11806
150715;201311;4877;16340;4433;15713;623;2263;3422;12370;4045;14633
150720;201311;6290;26415;5988;25871;962;3916;4342;19643;5304;23559
150730;201311;8797;31137;8323;30495;1157;4146;6679;25037;7836;29183
150740;201311;3537;11669;3306;11259;504;1800;2251;7829;2755;9629
150745;201311;5857;18783;5448;18229;953;3358;3921;13235;4874;16593
150746;201311;1378;4629;1316;4514;203;769;885;3077;1088;3846
150747;201311;4872;16427;4538;15985;445;1471;3656;13374;4101;14845
150750;201311;2569;9170;2513;9106;116;261;2356;8748;2472;9009
150760;201311;11089;36833;10614;36176;2708;9126;6445;22855;9153;31981
150770;201311;5504;21105;5347;20876;919;3348;3942;16370;4861;19718
150775;201311;1085;3552;987;3355;196;814;600;1950;796;2764
150780;201311;2975;10224;2953;10200;87;216;2792;9804;2879;10020
150790;201311;4855;15917;4579;15558;355;1009;3906;13778;4261;14787
150795;201311;14481;46295;13286;44484;2214;7125;9494;32974;11708;40099
150796;201311;2742;8633;2655;8521;399;1203;2029;6786;2428;7989
150797;201311;3654;12516;3511;12292;174;637;3105;10989;3279;11626
150800;201311;13745;46915;12625;45519;3131;10771;8072;30858;11203;41629
150803;201311;6643;24471;6329;24010;915;3626;4636;18028;5551;21654
150805;201311;2668;9514;2484;9250;368;1293;1822;7021;2190;8314
150808;201311;5774;20110;4985;18593;2179;8573;1194;4652;3373;13225
150810;201311;19037;61298;16225;57851;2775;9478;11423;42974;14198;52452
150812;201311;5120;16242;4759;15748;492;2000;3643;11789;4135;13789
150815;201311;8458;27470;7636;26439;1230;3959;5788;20855;7018;24814
150820;201311;10321;30983;9468;30052;580;1216;8507;27941;9087;29157
150830;201311;12204;47870;11644;46922;870;3545;9508;39657;10378;43202
150835;201311;1923;7217;1791;6904;527;2136;806;3132;1333;5268
150840;201311;7116;21105;5769;19270;1448;5414;3057;9950;4505;15364
160005;201311;692;2685;653;2602;121;557;395;1553;516;2110
160010;201311;1525;5324;1514;5312;171;468;1281;4692;1452;5160
160015;201311;1495;5713;1462;5653;260;950;1048;4283;1308;5233
160020;201311;2271;7683;2120;7475;309;1126;1533;5552;1842;6678
160021;201311;801;3547;780;3513;145;692;534;2485;679;3177
160023;201311;935;3651;922;3630;95;333;787;3180;882;3513
160025;201311;1211;3501;1177;3465;23;76;1134;3339;1157;3415
160027;201311;7877;25311;7429;24772;2243;7502;4257;14824;6500;22326
160030;201311;38665;145779;36127;140078;8512;32561;23039;92198;31551;124759
160040;201311;3615;14704;3550;14596;198;896;3194;13175;3392;14071
160050;201311;3330;12656;3021;12191;1070;4084;1472;6579;2542;10663
160053;201311;2156;9012;2127;8969;590;2525;1305;5635;1895;8160
160055;201311;760;3003;745;2981;142;627;526;2116;668;2743
160060;201311;17290;58634;16305;57524;4810;16076;9802;36826;14612;52902
160070;201311;1944;8508;1925;8463;221;935;1618;7259;1839;8194
160080;201311;2616;9906;2599;9879;131;443;2418;9310;2549;9753
170025;201311;561;1946;511;1864;186;703;221;845;407;1548
170030;201311;1179;3939;1078;3752;305;1100;526;1851;831;2951
170035;201311;1517;4669;1248;4151;450;1620;390;1329;840;2949
170040;201311;1753;5940;1560;5640;309;1290;969;3497;1278;4787
170070;201311;2028;5627;1671;5174;467;1588;834;2611;1301;4199
170100;201311;2482;6984;2196;6481;331;1087;1620;4734;1951;5821
170105;201311;725;2420;618;2204;131;583;332;1134;463;1717
170110;201311;1192;3732;1041;3482;225;766;618;2090;843;2856
170130;201311;1352;4381;1209;4188;194;671;840;3014;1034;3685
170190;201311;1639;4812;1353;4401;625;2054;347;1274;972;3328
170200;201311;1446;4558;1140;4000;316;1233;363;1227;679;2460
170210;201311;27450;87346;23843;80822;9140;33302;7134;24946;16274;58248
170215;201311;1145;3725;1039;3557;135;491;785;2724;920;3215
170220;201311;6385;21464;5896;20694;889;3281;4126;14843;5015;18124
170230;201311;1416;4870;1257;4583;343;1412;593;2096;936;3508
170240;201311;2972;8486;2416;7768;339;1212;1650;5353;1989;6565
170255;201311;3610;11737;3072;10834;1086;3839;1267;4775;2353;8614
170270;201311;1043;2720;756;2325;158;508;451;1402;609;1910
170290;201311;2923;8964;2589;8557;212;630;2164;7454;2376;8084
170300;201311;2023;6535;1794;6151;307;1170;1188;4093;1495;5263
170305;201311;698;2240;587;2026;123;479;350;1177;473;1656
170307;201311;1059;3769;930;3547;273;1067;394;1659;667;2726
170310;201311;1628;4580;1305;4065;365;1193;581;1895;946;3088
170320;201311;972;2895;790;2571;217;718;374;1264;591;1982
170330;201311;821;2524;691;2360;130;459;452;1551;582;2010
170360;201311;455;1623;432;1583;96;378;210;751;306;1129
170370;201311;1365;4135;1157;3834;194;762;702;2310;896;3072
170380;201311;2110;6758;1734;6191;422;1729;922;3224;1344;4953
170382;201311;557;1893;491;1793;100;407;323;1163;423;1570
170384;201311;1511;6376;1438;6249;361;1590;890;3998;1251;5588
170386;201311;882;2706;742;2497;202;750;311;1071;513;1821
170388;201311;653;1979;569;1838;129;488;217;689;346;1177
170389;201311;915;3163;852;3064;99;436;641;2267;740;2703
170390;201311;1321;4000;1153;3787;183;633;843;2834;1026;3467
170410;201311;458;1533;439;1500;66;254;299;1021;365;1275
170460;201311;520;1443;394;1238;106;367;137;425;243;792
170510;201311;756;2638;647;2464;127;553;341;1296;468;1849
170550;201311;5395;17246;4507;15623;1814;6728;1236;4391;3050;11119
170555;201311;1328;3964;1112;3636;283;1017;600;1964;883;2981
170560;201311;1025;3517;869;3333;192;745;575;2303;767;3048
170600;201311;1297;3783;1161;3619;72;251;970;3075;1042;3326
170610;201311;1612;4939;1273;4390;202;777;743;2592;945;3369
170625;201311;399;1300;321;1126;86;314;88;307;174;621
170650;201311;1215;4032;1102;3810;281;1060;564;1956;845;3016
170700;201311;3895;13140;3282;12110;838;3417;1542;5900;2380;9317
170710;201311;1692;5114;1434;4726;204;799;991;3257;1195;4056
170720;201311;1808;4872;1582;4522;311;905;1062;3080;1373;3985
170730;201311;1119;3253;921;2949;289;1044;410;1292;699;2336
170740;201311;2198;7926;1956;7488;325;1348;1312;5062;1637;6410
170755;201311;870;2791;735;2493;206;744;284;943;490;1687
170765;201311;1568;4291;1275;3817;335;1093;539;1661;874;2754
170770;201311;1804;6354;1686;6122;406;1530;977;3658;1383;5188
170820;201311;4144;13376;3728;12709;1100;3973;1566;5450;2666;9423
170825;201311;762;2352;581;2002;142;537;242;834;384;1371
170830;201311;1321;3998;1254;3894;42;91;1167;3668;1209;3759
170900;201311;2831;10167;2717;9949;359;1338;2026;7645;2385;8983
170930;201311;4177;12889;3437;11807;1379;4976;1126;3878;2505;8854
170950;201311;12262;36660;9539;32018;3950;14818;2157;6798;6107;21616
170980;201311;477;1504;399;1369;116;435;178;603;294;1038
171050;201311;1267;4610;1204;4490;59;272;1068;3935;1127;4207
171070;201311;1696;5472;1567;5300;337;1193;969;3370;1306;4563
171090;201311;921;2743;794;2542;139;470;532;1715;671;2185
171110;201311;638;1901;523;1722;169;609;278;874;447;1483
171150;201311;851;2563;637;2155;128;464;358;1222;486;1686
171180;201311;611;1968;478;1685;121;475;196;712;317;1187
171190;201311;1841;6680;1580;6139;398;1628;755;3059;1153;4687
171195;201311;861;3156;785;3015;108;457;495;1970;603;2427
171200;201311;686;2254;566;2033;148;613;262;893;410;1506
171215;201311;458;1424;365;1259;71;273;168;594;239;867
171240;201311;857;2895;811;2817;75;206;659;2396;734;2602
171245;201311;663;2215;554;1950;127;499;242;841;369;1340
171250;201311;1160;3372;1040;3231;63;197;888;2805;951;3002
171270;201311;417;1734;388;1666;98;402;193;911;291;1313
171280;201311;898;2831;794;2649;190;616;402;1491;592;2107
171320;201311;3958;12352;3432;11571;1138;4018;1595;5406;2733;9424
171330;201311;2782;8546;2472;8075;648;2265;1340;4414;1988;6679
171360;201311;1500;4909;1278;4574;323;1221;683;2494;1006;3715
171370;201311;714;2042;638;1917;144;513;339;971;483;1484
171380;201311;1286;4439;1125;4116;333;1222;527;1993;860;3215
171395;201311;882;2810;749;2560;157;613;386;1312;543;1925
171420;201311;2276;7034;1842;6248;495;1805;781;2669;1276;4474
171430;201311;1039;3308;932;3150;216;749;554;1896;770;2645
171488;201311;2432;7619;2243;7339;587;1906;1201;4136;1788;6042
171500;201311;888;2765;781;2548;137;413;444;1503;581;1916
171510;201311;904;3297;822;3166;160;648;506;2044;666;2692
171515;201311;614;1805;487;1613;115;390;237;801;352;1191
171525;201311;589;2007;502;1844;107;435;267;965;374;1400
171550;201311;341;1159;292;1049;119;484;47;175;166;659
171570;201311;1131;3648;1021;3478;225;760;620;2173;845;2933
171575;201311;1950;5683;1546;4932;425;1405;664;2209;1089;3614
171610;201311;6099;21133;5583;20136;1945;7435;1925;6953;3870;14388
171620;201311;2235;7188;2055;6917;192;713;1662;5642;1854;6355
171630;201311;894;3015;750;2761;187;763;315;1149;502;1912
171650;201311;2348;7482;1959;6795;540;2018;829;2821;1369;4839
171660;201311;2621;7371;2104;6448;469;1527;1105;3450;1574;4977
171665;201311;1373;4291;1184;3974;221;822;740;2530;961;3352
171670;201311;2321;6342;1906;5794;454;1486;1104;3300;1558;4786
171700;201311;1111;3744;1016;3583;166;641;643;2289;809;2930
171720;201311;666;2147;590;2001;189;691;260;891;449;1582
171750;201311;1230;4107;1099;3836;399;1459;378;1340;777;2799
171780;201311;1150;3333;850;2889;149;560;492;1654;641;2214
171790;201311;1722;5577;1408;5119;290;1073;837;3189;1127;4262
171800;201311;711;2314;657;2233;98;374;446;1519;544;1893
171820;201311;9517;29980;8765;29052;2200;7860;4988;16771;7188;24631
171830;201311;1629;5999;1492;5700;373;1509;698;2683;1071;4192
171840;201311;759;2280;684;2177;71;243;513;1645;584;1888
171845;201311;799;2194;623;1887;90;316;362;1067;452;1383
171850;201311;1018;3702;912;3470;111;491;589;2243;700;2734
171855;201311;1238;4003;1124;3811;117;492;849;2815;966;3307
171865;201311;479;1580;406;1470;108;447;200;702;308;1149
171870;201311;658;2150;549;1955;121;467;258;945;379;1412
171875;201311;1366;4412;1155;4082;169;668;826;2912;995;3580
171880;201311;995;3565;967;3519;126;480;726;2712;852;3192
171884;201311;894;2605;666;2260;154;588;260;899;414;1487
171886;201311;1437;4990;1317;4736;457;1718;447;1658;904;3376
171888;201311;664;2076;568;1897;104;363;341;1179;445;1542
171889;201311;480;1623;460;1575;104;338;272;974;376;1312
171890;201311;1111;3741;1005;3583;139;594;678;2394;817;2988
171900;201311;432;1743;412;1696;98;402;227;954;325;1356
172000;201311;653;2127;559;1989;86;367;341;1185;427;1552
172010;201311;1157;3998;1095;3880;107;424;873;3115;980;3539
172015;201311;351;1334;307;1265;57;236;182;795;239;1031
172020;201311;2303;7695;2074;7354;312;1217;1473;5275;1785;6492
172025;201311;720;2159;589;1923;102;373;352;1138;454;1511
172030;201311;1082;3748;990;3578;167;706;634;2285;801;2991
172049;201311;1111;3231;1044;3139;140;415;775;2392;915;2807
172065;201311;1195;3625;1010;3387;132;512;789;2621;921;3133
172080;201311;2647;8169;2252;7496;298;1153;1491;4883;1789;6036
172085;201311;502;1400;388;1189;88;291;118;362;206;653
172090;201311;3369;10250;2648;9315;561;2130;1589;5716;2150;7846
172093;201311;565;1875;446;1655;189;805;169;593;358;1398
172097;201311;668;2030;563;1847;164;583;196;628;360;1211
172100;201311;25265;88057;22587;82459;8058;32116;6302;22962;14360;55078
172110;201311;1683;6160;1558;5980;144;522;1242;4934;1386;5456
172120;201311;5489;16620;4595;15482;492;1743;3512;12085;4004;13828
172125;201311;318;987;259;897;59;229;122;435;181;664
172130;201311;506;1491;451;1408;71;238;296;960;367;1198
172208;201311;2141;6734;2021;6533;432;1493;1137;3737;1569;5230
172210;201311;2275;6944;2156;6792;180;623;1832;5752;2012;6375
210005;201311;21411;70688;19309;67344;6196;22907;9316;32878;15512;55785
210010;201311;1620;5773;1462;5561;173;638;1119;4409;1292;5047
210015;201311;3472;10923;3204;10540;228;463;2737;9525;2965;9988
210020;201311;7059;18211;6639;17703;456;1375;5471;14772;5927;16147
210030;201311;5850;19741;5549;19319;451;1864;4631;16056;5082;17920
210040;201311;1938;5689;1762;5473;184;588;1387;4365;1571;4953
210043;201311;5806;18156;5487;17674;426;1404;4612;15094;5038;16498
210047;201311;6677;26405;6246;25627;922;4121;4296;17767;5218;21888
210050;201311;2489;8777;2018;8145;392;1605;1223;5105;1615;6710
210055;201311;1646;5705;1541;5562;197;677;1198;4412;1395;5089
210060;201311;7865;29248;7116;28059;809;3518;5277;21239;6086;24757
210070;201311;6751;20791;6434;20385;314;1089;5760;18360;6074;19449
210080;201311;3670;12670;3601;12565;92;362;3372;11807;3464;12169
210083;201311;3647;13161;3560;13048;211;792;3187;11824;3398;12616
210087;201311;2451;7925;2336;7787;198;712;2015;6728;2213;7440
210090;201311;9629;32332;9303;31788;504;1934;8103;27797;8607;29731
210095;201311;6117;23862;5994;23651;716;2796;4847;19534;5563;22330
210100;201311;7517;22559;7113;22087;295;1127;6419;19891;6714;21018
210110;201311;3154;11012;3056;10872;201;761;2586;9375;2787;10136
210120;201311;24859;74412;21388;70081;2320;8158;16399;54598;18719;62756
210125;201311;3334;11168;3209;11025;215;695;2845;9955;3060;10650
210130;201311;3710;11526;3602;11387;323;988;3004;9628;3327;10616
210135;201311;1644;4897;1466;4632;120;383;1219;3921;1339;4304
210140;201311;16638;54606;14328;51544;3250;11989;8927;33330;12177;45319
210150;201311;4512;11763;4162;11326;156;432;3795;10329;3951;10761
210160;201311;18130;60171;17019;58514;2557;8355;12902;45870;15459;54225
210170;201311;13956;52135;13723;51803;1022;3477;12028;46372;13050;49849
210173;201311;1754;7622;1703;7513;153;698;1456;6486;1609;7184
210177;201311;2906;9641;2756;9449;338;1304;2157;7336;2495;8640
210180;201311;1450;4594;1382;4486;106;365;1163;3784;1269;4149
210190;201311;5053;16491;4752;15961;375;1678;3647;11941;4022;13619
210193;201311;1420;4582;1326;4419;89;343;1089;3675;1178;4018
210197;201311;1698;6273;1625;6189;105;456;1440;5477;1545;5933
210200;201311;9070;31018;8424;30062;1262;4224;6113;22853;7375;27077
210203;201311;6140;21057;5789;20602;506;1649;4942;17969;5448;19618
210207;201311;2934;10041;2779;9765;401;1379;2047;7379;2448;8758
210210;201311;8711;29758;8372;29257;318;1196;7363;26228;7681;27424
210215;201311;1734;6961;1692;6893;177;795;1380;5648;1557;6443
210220;201311;6134;24134;5938;23806;498;1990;4844;19947;5342;21937
210230;201311;5314;18321;4954;17730;481;1785;3961;14352;4442;16137
210232;201311;11808;42483;10778;41153;2256;8546;7269;29216;9525;37762
210235;201311;3444;10987;3137;10600;235;816;2682;9153;2917;9969
210237;201311;2534;9253;2503;9211;50;129;2415;8997;2465;9126
210240;201311;2951;9428;2830;9245;292;827;2268;7639;2560;8466
210250;201311;4938;15589;4745;15348;153;574;4404;14282;4557;14856
210255;201311;2668;8822;2444;8441;597;2228;1441;5016;2038;7244
210260;201311;5189;16835;4813;16278;633;2087;3676;12700;4309;14787
210270;201311;5232;15194;4722;14506;188;639;4203;13034;4391;13673
210275;201311;3309;8773;3096;8544;99;253;2936;8158;3035;8411
210280;201311;5903;17457;5169;16536;366;1254;4397;14225;4763;15479
210290;201311;5842;18767;5391;18199;523;1729;4422;15265;4945;16994
210300;201311;35758;111412;30673;104682;3246;11883;24325;84581;27571;96464
210310;201311;2819;8238;2687;8031;131;390;2358;7083;2489;7473
210312;201311;2094;6920;2060;6866;138;546;1805;6003;1943;6549
210315;201311;2303;8377;2212;8230;131;544;1913;7159;2044;7703
210317;201311;4271;12899;4135;12731;230;644;3733;11675;3963;12319
210320;201311;19307;61488;18158;60094;1237;4082;15867;53446;17104;57528
210325;201311;3550;11441;3210;10923;346;1295;2505;8570;2851;9865
210330;201311;31429;86441;27031;81586;3884;10398;19968;65026;23852;75424
210340;201311;11876;37538;10922;36354;1388;4012;8302;29429;9690;33441
210350;201311;10318;33011;9659;32076;787;2711;7905;26712;8692;29423
210355;201311;3936;14225;3624;13829;139;366;3343;13133;3482;13499
210360;201311;16449;51504;15514;50121;1447;4887;12400;40751;13847;45638
210370;201311;7880;21858;7155;21082;336;858;6434;19376;6770;20234
210375;201311;3214;9991;2816;9518;472;1736;2054;7036;2526;8772
210380;201311;6199;18390;5595;17484;638;1786;4474;14407;5112;16193
210390;201311;2695;9802;2521;9514;108;488;2271;8595;2379;9083
210400;201311;4809;15644;4639;15423;377;1150;3997;13562;4374;14712
210405;201311;8601;24374;7079;22294;2170;6943;3262;11114;5432;18057
210407;201311;2071;7348;1867;7028;200;710;1450;5687;1650;6397
210408;201311;2102;8589;2008;8477;76;303;1842;7964;1918;8267
210409;201311;3854;14119;3668;13825;293;1136;2950;11414;3243;12550
210410;201311;3528;11507;3314;11233;349;1123;2737;9484;3086;10607
210420;201311;4128;13939;3868;13469;366;1255;3128;11120;3494;12375
210430;201311;1990;6489;1943;6429;171;585;1643;5471;1814;6056
210440;201311;4204;13386;4111;13242;206;689;3683;11970;3889;12659
210450;201311;2840;9139;2607;8778;237;859;2106;7093;2343;7952
210455;201311;4119;12531;3530;11613;719;2392;2248;7633;2967;10025
210460;201311;4065;13194;3845;12905;209;802;3343;11305;3552;12107
210462;201311;1759;6410;1699;6295;181;692;1301;4928;1482;5620
210465;201311;2706;8954;2551;8748;399;1176;1973;7097;2372;8273
210467;201311;6063;20714;5680;20193;471;1542;4768;17509;5239;19051
210470;201311;1811;5380;1545;4985;105;407;1235;3991;1340;4398
210480;201311;13226;45573;11845;43671;3566;13195;6246;24566;9812;37761
210490;201311;3372;10449;3157;10120;361;1212;2471;7968;2832;9180
210500;201311;6724;26570;6449;26086;728;2889;5037;21082;5765;23971
210510;201311;6738;22707;6554;22500;302;695;5906;21103;6208;21798
210515;201311;3402;11125;3328;11029;196;583;3006;10124;3202;10707
210520;201311;2664;8576;2517;8375;231;789;2061;6980;2292;7769
210530;201311;39257;133049;34505;125545;11374;44294;17021;63080;28395;107374
210535;201311;3090;11078;3024;10955;153;587;2687;9809;2840;10396
210540;201311;12152;43661;10925;41631;2527;9518;6255;25590;8782;35108
210542;201311;6377;18765;5610;17922;327;966;4954;16223;5281;17189
210545;201311;2192;7539;2102;7391;91;419;1828;6418;1919;6837
210547;201311;3541;12921;3364;12641;225;913;2804;10690;3029;11603
210550;201311;6240;17936;5438;17038;301;752;4901;15766;5202;16518
210560;201311;3920;12835;3609;12337;255;1004;3029;10335;3284;11339
210565;201311;1535;5307;1338;5004;135;627;985;3658;1120;4285
210570;201311;12545;36621;11437;35326;1041;2769;9570;30607;10611;33376
210580;201311;2856;9248;2546;8842;296;932;2044;7317;2340;8249
210590;201311;4460;13810;4216;13513;309;962;3645;11899;3954;12861
210592;201311;2461;7920;2396;7817;107;411;2131;6940;2238;7351
210594;201311;2718;7940;2309;7401;166;513;1972;6466;2138;6979
210596;201311;2830;10764;2694;10510;341;1349;2011;7987;2352;9336
210598;201311;1995;6227;1882;6093;114;479;1690;5393;1804;5872
210600;201311;3289;9814;3059;9486;362;1149;2378;7396;2740;8545
210610;201311;2608;8408;2344;8084;272;982;1894;6571;2166;7553
210620;201311;1803;5624;1672;5449;54;148;1537;5075;1591;5223
210630;201311;3344;12565;2929;11729;542;2169;1750;7310;2292;9479
210632;201311;4787;16670;4413;16138;525;1904;3455;12883;3980;14787
210635;201311;1859;6784;1807;6706;87;288;1644;6219;1731;6507
210637;201311;2701;9352;2599;9208;138;511;2327;8334;2465;8845
210640;201311;4152;14109;4100;14043;26;78;4006;13796;4032;13874
210650;201311;6684;20631;6569;20482;209;627;6199;19468;6408;20095
210660;201311;7312;23273;6889;22598;313;888;6270;20737;6583;21625
210663;201311;2702;8067;2578;7905;134;476;2258;6949;2392;7425
210667;201311;1646;6131;1589;6049;93;411;1370;5251;1463;5662
210670;201311;4708;17814;4555;17543;464;1801;3591;14211;4055;16012
210675;201311;4809;13615;4572;13315;294;792;3978;11815;4272;12607
210680;201311;4360;12883;3941;12378;205;678;3477;10962;3682;11640
210690;201311;6742;23625;6478;23339;322;1121;5868;21422;6190;22543
210700;201311;2593;7418;2317;7096;205;399;1882;6314;2087;6713
210710;201311;4871;16033;4693;15751;189;642;4232;14299;4421;14941
210720;201311;2360;8975;2265;8841;152;653;1974;7723;2126;8376
210725;201311;1170;4389;1005;4086;133;588;638;2623;771;3211
210730;201311;1177;3781;1059;3652;96;305;893;3133;989;3438
210735;201311;3605;13714;3443;13418;647;2554;2385;9549;3032;12103
210740;201311;4877;13513;4561;13193;182;393;4235;12529;4417;12922
210745;201311;3653;11308;3457;11027;358;979;2804;9150;3162;10129
210750;201311;19640;55865;18139;54120;2256;6781;14530;43975;16786;50756
210760;201311;5876;16335;5605;16040;80;243;5447;15607;5527;15850
210770;201311;6142;17011;5278;16025;272;860;4658;14203;4930;15063
210780;201311;8637;29601;8072;28546;1134;4249;5792;20850;6926;25099
210790;201311;4760;14422;4124;13707;307;802;3529;12264;3836;13066
210800;201311;4837;14293;4419;13835;203;741;3827;12330;4030;13071
210805;201311;3692;15748;3594;15550;202;897;3098;13691;3300;14588
210810;201311;5593;17409;5065;16803;502;1249;4291;14913;4793;16162
210820;201311;8883;25848;8389;25185;1424;4267;5952;18352;7376;22619
210825;201311;5499;18650;5353;18467;238;834;4827;16859;5065;17693
210830;201311;8308;26824;7982;26454;328;939;7404;24870;7732;25809
210840;201311;3727;10454;3436;10032;330;804;2716;8081;3046;8885
210845;201311;5495;17714;5287;17468;303;857;4650;15867;4953;16724
210850;201311;5888;22252;5537;21623;982;4272;3781;14800;4763;19072
210860;201311;16892;53685;16038;52490;1381;4899;13190;43360;14571;48259
210870;201311;6264;20779;5721;20048;838;2844;4148;14953;4986;17797
210880;201311;4020;13255;3945;13152;205;666;3561;12020;3766;12686
210890;201311;5316;16271;4973;15828;498;1708;4051;12883;4549;14591
210900;201311;4542;15213;4222;14644;1490;5258;1937;7062;3427;12320
210905;201311;1822;5768;1736;5657;122;310;1525;5123;1647;5433
210910;201311;10520;33521;9891;32544;1945;6892;6512;21547;8457;28439
210920;201311;3446;11548;3344;11409;148;440;3048;10593;3196;11033
210923;201311;1505;5676;1442;5567;199;807;1038;4158;1237;4965
210927;201311;4675;14969;4573;14864;36;97;4502;14687;4538;14784
210930;201311;2606;9677;2516;9543;204;924;2112;7997;2316;8921
210940;201311;2876;11547;2837;11473;318;1172;2302;9578;2620;10750
210945;201311;5849;17320;5660;17127;182;245;5420;16771;5602;17016
210950;201311;5533;17715;4905;16763;700;2442;3486;12257;4186;14699
210955;201311;1880;6386;1708;6093;285;1117;1165;4187;1450;5304
210960;201311;9071;30662;8771;30199;2062;6796;5839;21082;7901;27878
210970;201311;1362;5034;1219;4820;191;829;864;3475;1055;4304
210975;201311;1677;6008;1596;5846;175;667;1250;4634;1425;5301
210980;201311;8877;22708;8659;22456;543;1239;7688;20302;8231;21541
210990;201311;14943;44502;12472;41615;1918;6776;9210;30970;11128;37746
211000;201311;15983;52714;14635;50979;1124;4029;12399;43940;13523;47969
211003;201311;5084;18065;4686;17450;688;2727;3306;12575;3994;15302
211010;201311;6603;22392;6439;22179;149;492;6041;21002;6190;21494
211020;201311;7363;22871;7286;22769;200;410;6982;22092;7182;22502
211023;201311;2384;8249;2295;8092;174;628;1925;6900;2099;7528
211027;201311;3047;11924;2913;11700;290;1089;2335;9743;2625;10832
211030;201311;4204;13079;3802;12611;843;2331;2700;9560;3543;11891
211040;201311;4062;15781;3960;15611;141;609;3526;14153;3667;14762
211050;201311;9928;27632;9785;27463;499;1317;9067;25620;9566;26937
211060;201311;5604;20986;5488;20751;618;2173;4472;17402;5090;19575
211065;201311;1699;5915;1565;5733;76;301;1431;5269;1507;5570
211070;201311;8561;29246;8142;28532;808;2924;6468;23037;7276;25961
211080;201311;1343;4246;1106;3918;88;445;905;3117;993;3562
211085;201311;2003;6831;1743;6487;325;1168;1266;4894;1591;6062
211090;201311;3500;11207;3313;10945;222;875;2791;9167;3013;10042
211100;201311;6762;17886;6596;17685;98;353;6267;16752;6365;17105
211102;201311;3107;11658;3008;11510;364;1326;2425;9544;2789;10870
211105;201311;2769;8873;2492;8512;186;700;2125;7273;2311;7973
211107;201311;4476;13913;4131;13440;181;591;3720;12272;3901;12863
211110;201311;6401;19603;5148;17884;882;2989;3422;12540;4304;15529
211120;201311;31547;88522;27588;83417;3860;11416;20055;62900;23915;74316
211125;201311;2141;7033;1970;6771;184;608;1594;5581;1778;6189
211130;201311;144312;433473;136092;422739;27875;86355;93196;296937;121071;383292
211140;201311;5657;18470;5382;18026;297;1089;4685;15708;4982;16797
211150;201311;9754;30581;9327;30042;752;2396;8022;26227;8774;28623
211153;201311;3198;9690;2929;9369;307;784;2419;8107;2726;8891
211157;201311;1235;4119;1056;3838;142;631;733;2733;875;3364
211160;201311;4151;14473;3626;13588;395;1732;2747;10305;3142;12037
211163;201311;1685;5634;1611;5535;64;230;1460;5075;1524;5305
211167;201311;1458;5071;1361;4913;57;236;1210;4376;1267;4612
211170;201311;6649;18092;6441;17837;152;530;6016;16573;6168;17103
211172;201311;2361;7030;2074;6578;184;698;1668;5177;1852;5875
211174;201311;2827;8490;2604;8203;129;530;2273;7088;2402;7618
211176;201311;5546;16374;4745;15436;563;1537;3753;12783;4316;14320
211178;201311;2994;9754;2932;9689;74;198;2800;9360;2874;9558
211180;201311;4269;15600;4024;15201;412;1702;3178;12089;3590;13791
211190;201311;2748;9438;2510;9090;145;633;2164;7861;2309;8494
211195;201311;1444;4596;1247;4355;116;406;1008;3612;1124;4018
211200;201311;2135;7526;1931;7241;278;966;1406;5589;1684;6555
211210;201311;6742;22593;6569;22300;554;1872;5542;19088;6096;20960
211220;201311;35002;106332;30846;100779;7367;24866;18621;62725;25988;87591
211223;201311;5925;17173;5498;16462;720;2184;3825;12025;4545;14209
211227;201311;1517;5829;1468;5748;168;756;1141;4470;1309;5226
211230;201311;8853;30566;8228;29493;1370;4956;5712;21034;7082;25990
211240;201311;8381;28536;8149;28255;364;1298;7507;26195;7871;27493
211245;201311;5062;15596;4986;15498;204;564;4615;14547;4819;15111
211250;201311;11784;44556;11244;43922;1414;4370;9175;37830;10589;42200
211260;201311;8235;26117;8130;25959;429;1247;7417;23952;7846;25199
211270;201311;9953;35844;9456;35175;658;2705;7929;29896;8587;32601
211280;201311;12140;35549;11717;35047;1290;3141;9802;30508;11092;33649
211285;201311;1986;7091;1734;6623;421;1686;885;3558;1306;5244
211290;201311;7716;25440;7552;25240;584;1613;6585;22619;7169;24232
211300;201311;8417;26397;7616;25178;684;2365;6177;20570;6861;22935
211400;201311;11833;35657;10530;34162;2476;7980;6256;22314;8732;30294
220005;201311;1695;5074;1626;4965;55;262;1444;4279;1499;4541
220010;201311;1719;4626;1313;4121;134;515;1033;3171;1167;3686
220020;201311;3661;11406;3500;11134;594;2051;2385;7544;2979;9595
220025;201311;2130;5397;1996;5198;67;212;1773;4552;1840;4764
220027;201311;1384;3854;1288;3730;105;239;1093;3261;1198;3500
220030;201311;3331;10197;3265;10087;302;981;2718;8448;3020;9429
220040;201311;8310;26181;7941;25577;1534;5229;5016;16226;6550;21455
220045;201311;1441;4685;1312;4473;158;623;948;3182;1106;3805
220050;201311;4785;13906;4249;13151;347;1277;3452;10544;3799;11821
220060;201311;2014;5339;1922;5230;108;296;1725;4711;1833;5007
220070;201311;2571;7713;2292;7315;212;691;1819;5879;2031;6570
220080;201311;824;2578;778;2493;97;391;548;1683;645;2074
220090;201311;1755;4845;1574;4581;147;517;1242;3522;1389;4039
220095;201311;647;1870;627;1830;33;101;573;1659;606;1760
220100;201311;1404;4299;1216;3997;147;464;904;3052;1051;3516
220105;201311;2193;7377;2082;7173;225;807;1532;5321;1757;6128
220110;201311;3555;10400;3149;9813;291;1087;2548;7812;2839;8899
220115;201311;2174;8143;2095;8009;302;1211;1628;6285;1930;7496
220117;201311;1413;3787;1172;3434;85;269;934;2719;1019;2988
220120;201311;12461;36639;11649;35600;392;1487;10614;32406;11006;33893
220130;201311;774;2901;686;2784;62;181;591;2500;653;2681
220140;201311;1577;4291;1471;4159;277;630;1137;3381;1414;4011
220150;201311;7183;22975;6885;22545;466;1825;5854;19062;6320;20887
220155;201311;1045;3347;900;3078;83;354;628;2096;711;2450
220157;201311;1047;2724;958;2580;45;119;821;2212;866;2331
220160;201311;2840;8572;2559;8084;209;808;1944;6071;2153;6879
220170;201311;1271;4176;1181;4016;115;425;929;3184;1044;3609
220173;201311;2091;6395;1695;5612;79;364;1396;4531;1475;4895
220177;201311;1674;5029;1647;4985;83;270;1493;4523;1576;4793
220180;201311;1154;3176;1033;2980;65;225;795;2245;860;2470
220190;201311;4567;15158;4000;14425;492;1815;3075;11235;3567;13050
220191;201311;1419;4877;1361;4779;248;837;957;3397;1205;4234
220192;201311;1742;5121;1425;4578;173;544;1028;3352;1201;3896
220194;201311;1711;5013;1552;4727;195;660;1137;3367;1332;4027
220196;201311;2028;6183;1909;5982;221;796;1447;4496;1668;5292
220198;201311;1330;3710;1128;3439;41;139;1034;3175;1075;3314
220200;201311;4637;16147;4378;15735;756;2952;3014;10778;3770;13730
220202;201311;2034;6504;1859;6182;68;279;1645;5438;1713;5717
220205;201311;2894;7737;2566;7290;101;391;2245;6278;2346;6669
220207;201311;919;2829;799;2618;100;368;592;1928;692;2296
220208;201311;1634;5806;1528;5606;288;1225;991;3591;1279;4816
220209;201311;1561;4976;1436;4760;100;403;1108;3678;1208;4081
220210;201311;1862;5002;1632;4697;99;349;1287;3709;1386;4058
220211;201311;1637;4967;1554;4846;108;473;1282;3967;1390;4440
220213;201311;1802;5291;1679;5060;119;412;1319;3909;1438;4321
220217;201311;1787;5789;1724;5709;79;238;1560;5237;1639;5475
220220;201311;11531;33770;10683;32392;1399;4186;7581;23565;8980;27751
220225;201311;1000;3118;935;3015;39;163;813;2601;852;2764
220230;201311;6051;16191;5043;14815;273;818;4405;13008;4678;13826
220240;201311;2680;8717;2565;8504;209;771;2037;6694;2246;7465
220245;201311;1420;3939;1335;3829;63;170;1190;3447;1253;3617
220250;201311;3365;9112;3058;8706;60;139;2864;8251;2924;8390
220253;201311;1838;5568;1597;5127;122;461;1182;3823;1304;4284
220255;201311;1747;5041;1547;4696;117;460;1247;3675;1364;4135
220260;201311;5217;16950;4742;16053;503;1907;3537;11980;4040;13887
220265;201311;1227;4500;1168;4394;114;532;853;3183;967;3715
220270;201311;6591;22361;6430;22064;414;1908;5464;18294;5878;20202
220271;201311;1498;4318;1442;4239;83;243;1258;3751;1341;3994
220272;201311;1762;5555;1644;5374;113;476;1298;4201;1411;4677
220273;201311;1299;3782;1144;3545;113;377;852;2628;965;3005
220275;201311;2068;5569;1785;5204;83;271;1554;4543;1637;4814
220277;201311;2546;7070;2175;6513;175;569;1678;5064;1853;5633
220280;201311;1773;4657;1551;4340;105;383;1245;3427;1350;3810
220285;201311;1670;4560;1499;4322;104;317;1239;3658;1343;3975
220290;201311;6579;21526;5582;20242;542;2055;4404;16227;4946;18282
220300;201311;1895;6243;1682;5955;97;431;1433;5079;1530;5510
220310;201311;2580;8436;2139;7907;101;326;1938;7339;2039;7665
220320;201311;3384;10117;2863;9240;434;1463;2036;6606;2470;8069
220323;201311;1409;5343;1297;5179;227;974;920;3692;1147;4666
220325;201311;1273;4031;1165;3822;164;585;772;2600;936;3185
220327;201311;1354;4377;1224;4144;77;374;978;3239;1055;3613
220330;201311;3619;10548;3466;10331;280;948;2917;8707;3197;9655
220335;201311;2075;6021;1847;5728;109;391;1596;4935;1705;5326
220340;201311;1788;5172;1590;4898;162;565;1232;3759;1394;4324
220342;201311;1209;4002;1148;3910;119;488;857;3002;976;3490
220345;201311;2849;7967;2432;7283;90;252;2106;6326;2196;6578
220350;201311;4456;12170;3929;11443;304;973;3135;9132;3439;10105
220360;201311;1473;4066;1166;3583;122;414;850;2600;972;3014
220370;201311;9088;26514;8356;25547;473;1364;7459;22970;7932;24334
220375;201311;1544;4843;1438;4699;85;327;1275;4138;1360;4465
220380;201311;1363;3803;1177;3540;76;246;921;2781;997;3027
220385;201311;696;1936;627;1805;41;137;516;1429;557;1566
220390;201311;10310;32903;9426;31158;2363;8341;4523;15037;6886;23378
220400;201311;1443;3516;1303;3325;64;212;1127;2815;1191;3027
220410;201311;1376;4015;1178;3742;108;454;937;2886;1045;3340
220415;201311;879;2391;792;2267;89;249;592;1707;681;1956
220420;201311;2239;6590;2056;6232;157;479;1679;5106;1836;5585
220430;201311;2962;8763;2815;8568;394;1245;2102;6417;2496;7662
220435;201311;1622;4833;1531;4714;80;253;1313;4053;1393;4306
220440;201311;2812;8485;2327;7916;145;398;2069;7179;2214;7577
220450;201311;2715;8126;2358;7636;579;1952;1407;4610;1986;6562
220455;201311;1425;4380;1278;4173;55;185;1151;3797;1206;3982
220460;201311;1025;2887;973;2811;63;189;842;2424;905;2613
220465;201311;2423;8093;2263;7862;410;1535;1593;5573;2003;7108
220470;201311;4012;12258;3654;11617;266;967;2840;8908;3106;9875
220480;201311;2319;7101;2131;6812;159;539;1763;5636;1922;6175
220490;201311;2354;6976;2248;6831;136;512;1938;5826;2074;6338
220500;201311;3418;9327;2962;8576;205;791;2402;6741;2607;7532
220510;201311;2931;8281;2260;7308;103;459;1779;5724;1882;6183
220515;201311;1964;4965;1737;4673;84;239;1475;3972;1559;4211
220520;201311;5003;14342;4702;13906;242;661;4122;12344;4364;13005
220525;201311;1460;4180;1362;4041;108;392;1105;3212;1213;3604
220527;201311;1430;4606;1342;4412;148;468;1056;3541;1204;4009
220530;201311;1164;3468;1086;3349;105;398;889;2657;994;3055
220535;201311;879;2796;849;2750;78;308;680;2168;758;2476
220540;201311;3600;12222;3466;11996;290;1178;2817;9736;3107;10914
220545;201311;1425;4955;1363;4842;218;866;930;3260;1148;4126
220550;201311;9177;30452;8701;29574;1616;5886;5758;19577;7374;25463
220551;201311;1408;4881;1325;4734;134;569;1022;3603;1156;4172
220552;201311;1663;5245;1430;4852;134;621;1048;3408;1182;4029
220553;201311;1622;4869;1409;4557;87;309;1160;3747;1247;4056
220554;201311;929;2633;812;2469;118;362;575;1790;693;2152
220555;201311;2430;7210;2272;6994;98;339;1949;6082;2047;6421
220556;201311;1461;4695;1331;4442;105;441;1005;3308;1110;3749
220557;201311;1610;5390;1460;5100;203;819;995;3435;1198;4254
220558;201311;1023;3246;950;3109;99;387;730;2342;829;2729
220559;201311;1543;4450;1429;4283;80;272;1231;3683;1311;3955
220560;201311;1747;4399;1461;3994;82;235;1241;3372;1323;3607
220570;201311;7444;24060;7019;23491;896;2708;5563;19238;6459;21946
220580;201311;6560;21593;6387;21385;426;1394;5676;19253;6102;20647
220585;201311;1899;7177;1841;7068;137;547;1555;6019;1692;6566
220590;201311;1407;4474;1271;4270;242;853;811;2763;1053;3616
220595;201311;2475;7248;2293;7001;87;294;2068;6333;2155;6627
220600;201311;1318;3319;1137;3100;226;504;741;2158;967;2662
220605;201311;2052;6151;1817;5785;116;395;1440;4595;1556;4990
220610;201311;2757;8737;2668;8605;180;708;2258;7214;2438;7922
220620;201311;7777;26790;7553;26440;413;1673;6596;23100;7009;24773
220630;201311;396;1230;341;1132;84;300;178;598;262;898
220635;201311;1872;6743;1739;6436;157;679;1162;4297;1319;4976
220640;201311;2778;8330;2676;8177;284;968;2073;6330;2357;7298
220650;201311;2469;6964;2220;6581;151;515;1810;5342;1961;5857
220660;201311;2487;8470;2044;7917;172;711;1778;6928;1950;7639
220665;201311;1217;4241;1167;4162;59;252;1020;3615;1079;3867
220667;201311;1748;5946;1659;5816;85;344;1427;4988;1512;5332
220669;201311;1885;6275;1757;6023;261;1013;1212;4136;1473;5149
220670;201311;2150;6544;2029;6396;159;418;1756;5710;1915;6128
220672;201311;2214;6529;2158;6451;228;640;1816;5517;2044;6157
220675;201311;1360;3986;1273;3840;145;391;940;2895;1085;3286
220680;201311;2236;7439;2143;7298;178;600;1773;6125;1951;6725
220690;201311;1717;4979;1547;4693;131;489;1228;3668;1359;4157
220695;201311;858;2670;813;2592;74;246;620;1989;694;2235
220700;201311;9069;26705;8266;25488;793;2705;6409;19758;7202;22463
220710;201311;745;2269;654;2121;72;224;474;1557;546;1781
220720;201311;2139;5817;2024;5656;101;225;1802;5132;1903;5357
220730;201311;1363;3809;1203;3559;53;183;1013;2970;1066;3153
220735;201311;1031;2739;888;2505;80;259;661;1862;741;2121
220740;201311;1319;4428;1150;4196;134;447;916;3461;1050;3908
220750;201311;3942;11875;3750;11588;503;1435;2890;9246;3393;10681
220755;201311;1173;3527;1110;3422;71;214;957;2968;1028;3182
220760;201311;2630;9421;2451;9142;124;492;2148;8088;2272;8580
220770;201311;23132;80958;21841;78558;7609;28382;9322;34589;16931;62971
220775;201311;1169;2967;1149;2945;18;32;1124;2895;1142;2927
220777;201311;1686;4902;1594;4767;140;429;1302;3876;1442;4305
220779;201311;1144;3556;1117;3515;69;265;986;3081;1055;3346
220780;201311;6251;16491;5665;15716;474;1243;4675;13188;5149;14431
220785;201311;1281;3572;1237;3477;73;196;1114;3132;1187;3328
220790;201311;9241;30930;8995;30474;952;3543;7178;24264;8130;27807
220793;201311;907;2645;845;2542;69;229;685;2061;754;2290
220795;201311;1518;4327;1469;4253;115;351;1228;3581;1343;3932
220800;201311;16887;48906;15795;47251;1946;6782;11948;35020;13894;41802
220810;201311;3336;9931;2896;9134;247;962;2266;7044;2513;8006
220820;201311;5546;15924;5091;15323;328;1106;4348;13137;4676;14243
220830;201311;7663;22041;7331;21494;913;2689;5598;16655;6511;19344
220840;201311;14836;48380;13642;45962;3591;12381;6304;22002;9895;34383
220850;201311;2697;9984;2593;9823;356;1462;1975;7544;2331;9006
220855;201311;611;1960;562;1869;72;288;407;1326;479;1614
220860;201311;936;2677;878;2585;56;220;721;2077;777;2297
220865;201311;2660;7591;2222;6875;122;545;1822;5518;1944;6063
220870;201311;2409;8062;2117;7694;145;576;1824;6639;1969;7215
220880;201311;5364;14247;4932;13709;255;861;4329;12025;4584;12886
220885;201311;1334;4742;1179;4460;124;570;864;3272;988;3842
220887;201311;1315;3605;1161;3391;47;149;1033;3032;1080;3181
220890;201311;1603;5783;1443;5526;139;541;1159;4547;1298;5088
220900;201311;1865;5726;1676;5296;124;382;1359;4346;1483;4728
220910;201311;1734;5099;1548;4806;78;278;1350;4218;1428;4496
220915;201311;1041;3050;922;2851;51;227;731;2188;782;2415
220920;201311;1316;4939;1255;4851;126;569;977;3765;1103;4334
220930;201311;1476;4834;1307;4612;106;439;1060;3764;1166;4203
220935;201311;1020;3216;926;3006;70;308;693;2144;763;2452
220937;201311;1539;4319;1334;3955;82;298;1068;3097;1150;3395
220940;201311;1467;4552;1369;4339;103;386;1076;3407;1179;3793
220945;201311;474;1750;441;1648;59;255;305;1132;364;1387
220950;201311;1261;3251;924;2668;49;192;700;1958;749;2150
220955;201311;1619;4540;1377;4165;143;483;1064;3202;1207;3685
220960;201311;816;2329;729;2176;69;269;554;1598;623;1867
220965;201311;1673;5152;1584;5025;69;281;1373;4343;1442;4624
220970;201311;2070;5665;1533;4775;179;557;1012;3184;1191;3741
220975;201311;496;2030;492;2021;58;230;416;1727;474;1957
220980;201311;1491;4511;1319;4206;126;466;905;2952;1031;3418
220985;201311;1357;3931;1299;3849;127;429;999;2948;1126;3377
220987;201311;1465;4893;1381;4738;126;522;1047;3518;1173;4040
220990;201311;1801;5370;1610;5039;93;395;1266;3901;1359;4296
220995;201311;1181;3663;972;3314;84;345;757;2587;841;2932
220997;201311;2098;6768;2005;6606;133;455;1784;5869;1917;6324
221000;201311;4376;13763;4076;13230;491;1722;3015;9772;3506;11494
221005;201311;1410;4542;1333;4397;402;1276;720;2476;1122;3752
221010;201311;1242;3391;1099;3206;60;186;943;2764;1003;2950
221020;201311;1912;6017;1810;5833;136;601;1385;4350;1521;4951
221030;201311;1815;5070;1586;4732;84;340;1297;3817;1381;4157
221035;201311;1555;4270;1413;4088;91;264;1232;3606;1323;3870
221037;201311;637;1977;575;1868;37;162;462;1435;499;1597
221038;201311;632;1843;520;1660;48;167;360;1159;408;1326
221039;201311;922;2762;880;2698;68;229;758;2307;826;2536
221040;201311;5173;16126;4917;15703;411;1443;3888;12546;4299;13989
221050;201311;3728;11690;3457;11295;232;913;2939;9525;3171;10438
221060;201311;9123;25107;7878;23447;880;2728;6075;18187;6955;20915
221062;201311;1278;4540;1221;4459;36;110;1145;4205;1181;4315
221063;201311;1117;3646;1053;3530;370;1202;545;1957;915;3159
221065;201311;2666;8080;2539;7872;275;895;1977;6129;2252;7024
221070;201311;4376;13560;3986;12953;281;1092;3173;10249;3454;11341
221080;201311;3416;9566;3103;9144;229;746;2538;7511;2767;8257
221090;201311;1312;3701;1169;3484;58;232;979;2857;1037;3089
221093;201311;1791;5421;1711;5271;287;980;1105;3354;1392;4334
221095;201311;971;2669;849;2501;43;121;755;2250;798;2371
221097;201311;802;2342;716;2196;63;246;550;1669;613;1915
221100;201311;121969;380235;116152;370362;25650;90105;74333;231808;99983;321913
221110;201311;9816;33442;9531;33047;754;3021;7990;27620;8744;30641
221120;201311;4195;14295;4034;14004;1173;3981;2355;8557;3528;12538
221130;201311;4656;14109;4132;13035;1002;3314;2303;7212;3305;10526
221135;201311;1453;4667;1364;4528;189;733;993;3242;1182;3975
221140;201311;1399;3592;1295;3456;168;368;1014;2798;1182;3166
221150;201311;1223;3220;1031;2870;31;127;832;2296;863;2423
221160;201311;904;2453;854;2373;60;185;657;1829;717;2014
221170;201311;1098;3646;1057;3565;80;327;872;2900;952;3227
230010;201311;3340;9287;2839;8459;184;624;2276;6813;2460;7437
230015;201311;2756;9765;2597;9441;461;1925;1727;6159;2188;8084
230020;201311;14080;47763;13589;46795;1159;4358;10934;37856;12093;42214
230030;201311;12292;37313;11666;36273;1083;3718;9288;28869;10371;32587
230040;201311;4518;13066;3864;11909;358;1270;2992;9138;3350;10408
230050;201311;2531;8841;2186;7954;404;1629;1137;4140;1541;5769
230060;201311;1948;6021;1754;5640;189;711;1298;4143;1487;4854
230070;201311;4648;13008;4125;12261;401;1271;3134;9522;3535;10793
230075;201311;8650;32969;8229;32088;1045;4806;6033;23399;7078;28205
230080;201311;2342;6661;1999;6167;124;438;1643;5053;1767;5491
230090;201311;3330;10507;3009;9931;335;1294;2253;7325;2588;8619
230100;201311;16813;53728;15706;51682;4606;16005;7579;25291;12185;41296
230110;201311;13845;46655;12971;44765;2595;9726;7816;26925;10411;36651
230120;201311;7879;22316;7042;21186;843;2819;5211;15732;6054;18551
230125;201311;2863;8619;2409;7740;201;814;1780;5633;1981;6447
230130;201311;5630;19158;4779;17258;458;1973;3410;12170;3868;14143
230140;201311;3415;11416;3001;10655;502;1889;1914;6933;2416;8822
230150;201311;1742;5625;1534;5198;303;1192;953;3070;1256;4262
230160;201311;6237;19459;5526;18387;591;2178;4151;13865;4742;16043
230170;201311;6436;21003;5640;19529;549;2216;4083;13977;4632;16193
230180;201311;1926;5659;1703;5248;156;591;1186;3580;1342;4171
230185;201311;4132;14169;3840;13595;719;2579;2405;8798;3124;11377
230190;201311;12267;41455;11289;39455;2221;8791;6443;22325;8664;31116
230195;201311;4873;15590;4447;14903;370;1594;3436;11163;3806;12757
230200;201311;5645;16818;5052;15637;675;2212;3558;10998;4233;13210
230205;201311;4325;14109;3887;13361;411;1734;2793;9602;3204;11336
230210;201311;9071;26864;8132;25383;2235;7101;4173;13517;6408;20618
230220;201311;13461;41136;12548;39578;2068;7326;8445;26259;10513;33585
230230;201311;7271;24750;6560;23181;1164;4270;3921;14079;5085;18349
230240;201311;13244;39815;12032;37528;898;3409;9234;28286;10132;31695
230250;201311;10132;31630;9898;31269;570;2137;8393;26436;8963;28573
230260;201311;14700;51256;13691;49104;3209;12257;7211;26470;10420;38727
230270;201311;6660;20803;5962;19592;633;2309;4524;14907;5157;17216
230280;201311;19826;61650;18353;59118;2750;9343;13092;42367;15842;51710
230290;201311;5092;16049;4476;14802;645;2249;3011;10050;3656;12299
230300;201311;4685;15019;4498;14730;554;2079;3329;10809;3883;12888
230310;201311;4879;14935;4342;14031;408;1630;3281;10407;3689;12037
230320;201311;7312;24081;6873;23300;857;3274;5035;17116;5892;20390
230330;201311;4639;14233;4181;13318;442;1628;2980;9342;3422;10970
230340;201311;3355;11939;3156;11485;543;2217;1953;6962;2496;9179
230350;201311;17966;56692;16240;53635;3140;11209;10005;33373;13145;44582
230360;201311;2928;9013;2628;8481;318;1173;1967;6305;2285;7478
230365;201311;2901;8782;2564;8219;217;842;1932;6157;2149;6999
230370;201311;53647;183158;50013;176880;15260;56571;24601;89692;39861;146263
230380;201311;7040;20798;6085;19171;587;2153;4313;13587;4900;15740
230390;201311;3635;11778;3257;11146;442;1816;2227;7526;2669;9342
230393;201311;3361;11459;2897;10459;283;1404;2051;7142;2334;8546
230395;201311;4898;15944;4594;15336;671;2618;3098;10224;3769;12842
230400;201311;5052;16216;4481;15421;416;1818;3572;12032;3988;13850
230410;201311;15812;51134;14291;48256;2510;9159;8650;29306;11160;38465
230420;201311;23633;80732;22316;77989;5817;22212;11121;38616;16938;60828
230423;201311;4784;15936;4421;15273;525;2003;3108;10866;3633;12869
230425;201311;5358;18474;4977;17600;731;2845;3394;11941;4125;14786
230426;201311;2813;8023;2353;7168;144;580;1805;5372;1949;5952
230427;201311;1711;5342;1287;4362;128;478;857;2823;985;3301
230428;201311;8969;30238;8758;29860;1827;7004;5589;18776;7416;25780
230430;201311;4578;15118;4334;14626;443;1821;3171;10514;3614;12335
230435;201311;4860;16528;4395;15697;1120;4333;2193;8074;3313;12407
230440;201311;353618;1126133;334703;1091363;88059;309966;168520;549156;256579;859122
230445;201311;4695;13101;4069;12188;392;1192;3027;9241;3419;10433
230450;201311;3650;12034;3139;11090;483;1935;2005;7106;2488;9041
230460;201311;1907;6480;1759;6194;204;814;1286;4519;1490;5333
230465;201311;4107;12761;3412;11440;350;1499;2250;7350;2600;8849
230470;201311;11166;41586;10781;40820;1546;6255;7764;29911;9310;36166
230480;201311;1441;4758;1282;4450;238;874;820;2867;1058;3741
230490;201311;2947;8788;2594;8129;459;1641;1415;4415;1874;6056
230495;201311;5689;19488;5175;18612;974;4116;3056;10966;4030;15082
230500;201311;10691;36977;10211;36186;895;3371;8062;29150;8957;32521
230510;201311;1502;5474;1288;4933;352;1438;541;2154;893;3592
230520;201311;4981;15501;4369;14403;511;1957;2993;9812;3504;11769
230523;201311;13069;45004;12184;43001;3776;14758;3671;13106;7447;27864
230526;201311;4126;13054;3633;12162;441;1697;2540;8508;2981;10205
230530;201311;5133;17543;4761;17018;1051;3763;3076;11229;4127;14992
230533;201311;3831;11407;3539;10856;308;1083;2763;8418;3071;9501
230535;201311;5384;16381;4757;15218;505;1726;3464;11220;3969;12946
230540;201311;18681;55030;16777;52225;1253;4576;13740;42456;14993;47032
230550;201311;20034;61956;18387;58788;4298;15026;9934;31483;14232;46509
230560;201311;6703;19716;6065;18523;353;1380;4817;14505;5170;15885
230565;201311;3320;9895;2791;8837;291;1064;1925;6016;2216;7080
230570;201311;3917;10915;3528;10412;245;904;2922;8511;3167;9415
230580;201311;10306;32402;9887;31821;601;2041;8613;27950;9214;29991
230590;201311;9530;30941;8765;29556;832;3498;6494;21442;7326;24940
230600;201311;3676;10525;2845;8819;223;784;1910;5814;2133;6598
230610;201311;6027;20375;5644;19750;849;3259;4021;14160;4870;17419
230620;201311;2029;5916;1719;5277;177;646;1120;3341;1297;3987
230625;201311;7466;25461;6777;23849;1987;7622;2488;8761;4475;16383
230630;201311;11106;37170;10195;35316;2537;8641;5194;18940;7731;27581
230640;201311;25994;89809;24741;87852;4081;15295;17339;62354;21420;77649
230650;201311;4933;16136;4538;15332;423;1799;3469;11488;3892;13287
230655;201311;8516;32920;8224;32423;816;3281;6810;27251;7626;30532
230660;201311;6304;20228;5553;18838;578;2357;3988;13586;4566;15943
230670;201311;5939;16533;4844;14595;287;1070;3766;11045;4053;12115
230680;201311;2685;8115;2303;7397;380;1347;1431;4586;1811;5933
230690;201311;6390;21472;6242;21185;535;2303;4527;15021;5062;17324
230700;201311;9167;27319;8125;25391;922;3531;5549;16815;6471;20346
230710;201311;7578;24955;6782;23461;931;3243;4860;17220;5791;20463
230720;201311;1914;6109;1651;5601;242;905;1075;3662;1317;4567
230725;201311;3769;12841;3418;12009;649;2537;2043;7056;2692;9593
230730;201311;56657;176376;48535;163610;13043;47952;23180;79281;36223;127233
230740;201311;5230;17122;5042;16772;350;1486;4184;13741;4534;15227
230750;201311;8887;26367;7625;24267;749;2876;5711;18029;6460;20905
230760;201311;9945;31433;9654;30755;1423;5487;6838;20824;8261;26311
230763;201311;4216;13595;3977;13112;341;1559;3027;9583;3368;11142
230765;201311;43405;145151;40740;139630;13821;50350;14544;50690;28365;101040
230770;201311;23222;66469;21712;64255;1862;6587;16935;49600;18797;56187
230780;201311;5894;23944;5659;23387;1335;5610;3115;13564;4450;19174
230790;201311;2518;8802;2420;8637;304;1197;1871;6731;2175;7928
230800;201311;7803;28823;7215;27468;1756;7287;3486;13296;5242;20583
230810;201311;12353;41160;11844;40294;1432;5173;9030;31112;10462;36285
230820;201311;3386;11759;3021;10956;644;2602;1631;5927;2275;8529
230830;201311;7762;24078;7009;22707;741;2781;5022;16206;5763;18987
230835;201311;4113;11468;3548;10699;315;1052;2789;8420;3104;9472
230837;201311;3148;11016;2745;10179;397;1658;1805;6706;2202;8364
230840;201311;9264;31503;8487;30088;1433;5436;5515;19964;6948;25400
230850;201311;11132;34653;10525;33880;1366;4917;7825;25080;9191;29997
230860;201311;5046;15516;4630;14675;423;1595;3496;10946;3919;12541
230870;201311;18778;53425;16942;50328;1781;6057;12733;37544;14514;43601
230880;201311;1901;6746;1780;6500;266;1113;1166;4243;1432;5356
230890;201311;4090;15150;3801;14547;538;2434;2590;9765;3128;12199
230900;201311;3003;10258;2645;9478;498;1843;1522;5534;2020;7377
230910;201311;2973;9184;2445;8153;273;1092;1708;5580;1981;6672
230920;201311;4606;13849;4254;13401;341;1154;3476;11099;3817;12253
230930;201311;7694;24057;7039;22832;932;3252;4916;16028;5848;19280
230940;201311;7607;21956;6777;20735;391;1224;5732;17715;6123;18939
230945;201311;5953;18120;5134;17014;612;2191;3681;12359;4293;14550
230950;201311;6881;19345;5940;18058;403;1373;4647;14165;5050;15538
230960;201311;11957;39709;11114;37974;2649;9964;5377;18308;8026;28272
230970;201311;13188;43369;12084;41126;2653;10316;6213;20679;8866;30995
230980;201311;2780;9479;2582;9057;777;2778;1222;4454;1999;7232
230990;201311;1580;5051;1302;4479;171;722;853;2853;1024;3575
231000;201311;2869;7874;2297;6775;251;886;1519;4350;1770;5236
231010;201311;2926;8766;2592;8248;321;1273;1866;5803;2187;7076
231020;201311;7888;26826;7449;25915;1378;5091;4734;16762;6112;21853
231025;201311;7719;24971;6998;23719;1009;3557;4805;16687;5814;20244
231030;201311;7935;26770;6767;24267;1365;5173;3970;14393;5335;19566
231040;201311;2951;10104;2695;9547;308;1299;1869;6518;2177;7817
231050;201311;11856;35559;10550;33153;1132;3977;7655;24097;8787;28074
231060;201311;2406;7777;2218;7435;210;957;1654;5380;1864;6337
231070;201311;9199;29826;8623;28725;1493;5394;5540;18554;7033;23948
231080;201311;4254;13570;3901;12912;293;1323;2897;9212;3190;10535
231085;201311;4629;15367;4486;15101;735;2673;3259;11059;3994;13732
231090;201311;4084;11738;3446;10448;233;877;2566;7661;2799;8538
231095;201311;2172;7418;1900;6873;225;878;1325;4854;1550;5732
231100;201311;3014;9587;2524;8582;245;941;1833;6192;2078;7133
231110;201311;3730;12714;3629;12527;411;1539;2652;9218;3063;10757
231120;201311;2429;8107;2258;7798;390;1403;1477;5151;1867;6554
231123;201311;2166;6125;1866;5619;147;477;1483;4476;1630;4953
231126;201311;6658;18878;5513;17263;453;1628;4296;13333;4749;14961
231130;201311;19984;64200;18343;61274;4794;16864;9561;33147;14355;50011
231135;201311;4577;13774;3902;12718;402;1548;2839;9107;3241;10655
231140;201311;15246;50960;14362;49163;1591;7306;10135;33335;11726;40641
231150;201311;5869;17619;5032;15981;1033;3679;2625;8113;3658;11792
231160;201311;5615;19626;5366;19159;1480;5506;3065;10982;4545;16488
231170;201311;4727;15482;4403;14842;514;2136;3043;10098;3557;12234
231180;201311;14776;46155;13593;43834;2749;9712;8190;26069;10939;35781
231190;201311;5046;14333;4223;13128;389;1382;3267;10034;3656;11416
231195;201311;4635;16116;4020;14876;400;1759;3005;11129;3405;12888
231200;201311;7533;26921;6761;25364;757;3444;4827;17926;5584;21370
231210;201311;4967;15817;4317;14872;336;1446;3316;11478;3652;12924
231220;201311;14031;41063;11961;37519;1316;4839;7812;24552;9128;29391
231230;201311;9690;34705;9109;33589;1280;5234;6440;23818;7720;29052
231240;201311;11669;38093;10658;36280;1556;6015;6987;23968;8543;29983
231250;201311;2084;6141;1441;4561;303;983;586;1766;889;2749
231260;201311;4036;11621;3667;11092;505;1640;2524;7789;3029;9429
231270;201311;7586;22006;6892;20909;696;2728;5030;14850;5726;17578
231280;201311;1726;5839;1627;5629;169;618;1204;4197;1373;4815
231290;201311;32716;118736;30193;112373;7942;32553;12764;46508;20706;79061
231300;201311;4511;13564;3765;12004;380;1497;2670;8214;3050;9711
231310;201311;7348;21897;6303;19715;1353;4420;3338;10383;4691;14803
231320;201311;6985;22091;6185;20533;439;1757;4715;15580;5154;17337
231325;201311;2536;7988;2277;7516;206;764;1672;5528;1878;6292
231330;201311;14086;44636;11945;40464;2031;7083;7438;25505;9469;32588
231335;201311;5078;14925;4502;13879;343;1358;3595;10823;3938;12181
231340;201311;17741;59173;16709;57674;1588;5266;13430;47684;15018;52950
231350;201311;12154;42103;11938;41759;1440;4857;9619;34429;11059;39286
231355;201311;4295;14183;4152;13944;241;817;3597;12255;3838;13072
231360;201311;6966;23601;6553;22930;1720;5891;3720;13643;5440;19534
231370;201311;2345;6875;1911;6213;135;529;1443;4622;1578;5151
231375;201311;4030;14223;3837;13849;438;1946;2946;10443;3384;12389
231380;201311;5269;17419;4952;16969;841;3090;3410;11917;4251;15007
231390;201311;3360;10803;3192;10552;283;1160;2443;7979;2726;9139
231395;201311;4205;13813;3783;13131;777;2819;2292;8158;3069;10977
231400;201311;10300;31416;9397;29787;1041;3855;6624;20982;7665;24837
231410;201311;14712;49446;13348;47517;1577;5602;9761;35952;11338;41554
240010;201311;2402;7710;2174;7190;572;2137;958;3050;1530;5187
240020;201311;11796;37613;10556;35221;2919;10503;4754;16086;7673;26589
240030;201311;2747;8246;2648;8091;297;1135;2000;5935;2297;7070
240040;201311;779;2378;667;2152;50;241;490;1484;540;1725
240050;201311;3559;10047;3173;9388;243;891;2410;6983;2653;7874
240060;201311;1425;4342;1355;4220;129;487;1026;3095;1155;3582
240070;201311;2787;8166;2666;7926;435;1391;1737;5084;2172;6475
240080;201311;3015;8321;2788;7981;272;757;2216;6449;2488;7206
240090;201311;2185;6174;1882;5575;69;291;1489;4313;1558;4604
240100;201311;10121;29782;9454;28434;1279;4581;5899;17567;7178;22148
240110;201311;5210;16063;4666;15085;939;3473;2744;8482;3683;11955
240120;201311;2987;10023;2899;9858;611;2234;1789;6221;2400;8455
240130;201311;2756;7746;2386;7163;216;797;1832;5411;2048;6208
240140;201311;2259;7182;2061;6818;464;1735;1082;3520;1546;5255
240145;201311;6185;19597;5590;18501;1569;5802;2822;9267;4391;15069
240150;201311;1022;3172;842;2809;136;562;493;1570;629;2132
240160;201311;1455;4841;1323;4608;155;623;919;3217;1074;3840
240165;201311;883;2927;799;2765;115;429;522;1832;637;2261
240170;201311;2535;7817;2296;7364;616;2129;1104;3586;1720;5715
240180;201311;2950;9413;2771;9107;725;2494;1456;4975;2181;7469
240185;201311;1495;5034;1445;4949;186;665;1064;3677;1250;4342
240190;201311;939;2921;888;2818;103;411;624;1928;727;2339
240200;201311;13930;37236;11876;34662;2377;7104;7362;22286;9739;29390
240210;201311;2713;7861;2524;7611;238;848;2072;6171;2310;7019
240220;201311;7366;24020;7096;23653;388;1670;6280;20711;6668;22381
240230;201311;5429;15811;5049;15137;474;1672;3893;11496;4367;13168
240240;201311;1789;5714;1368;4577;379;1374;305;899;684;2273
240250;201311;2857;8311;2685;8048;210;778;2165;6345;2375;7123
240260;201311;14769;50401;14093;49259;2462;9808;9255;32224;11717;42032
240270;201311;2336;7857;2222;7663;260;910;1640;5777;1900;6687
240280;201311;1621;4706;1452;4395;135;498;1051;3128;1186;3626
240290;201311;1409;4491;1201;4103;109;523;772;2514;881;3037
240300;201311;2046;5730;1651;4999;383;1296;784;2294;1167;3590
240310;201311;10339;29889;9425;28394;2302;7557;4856;14541;7158;22098
240320;201311;2040;6163;1628;5299;109;477;1183;3661;1292;4138
240325;201311;36710;104061;29343;91548;9197;31264;9588;30314;18785;61578
240330;201311;1531;4679;1299;4203;169;677;791;2445;960;3122
240340;201311;1610;4939;1440;4699;282;987;922;2998;1204;3985
240350;201311;2068;6496;1963;6325;274;1060;1521;4777;1795;5837
240360;201311;7310;22376;6425;21035;1037;3674;4282;14372;5319;18046
240370;201311;1961;5486;1750;5149;130;467;1314;3849;1444;4316
240375;201311;889;2380;793;2248;144;474;461;1257;605;1731
240380;201311;2670;8093;2241;7165;342;1132;1309;4173;1651;5305
240390;201311;899;2607;751;2316;82;313;499;1515;581;1828
240400;201311;1427;3905;1250;3658;132;495;950;2707;1082;3202
240410;201311;541;1781;491;1671;72;292;321;1072;393;1364
240420;201311;4838;18576;4666;18180;1331;5288;2456;10080;3787;15368
240430;201311;3450;10142;3195;9690;368;1277;2293;6871;2661;8148
240440;201311;2637;7233;2474;6923;655;1877;1318;3716;1973;5593
240450;201311;3810;11643;3490;11048;550;2102;2124;6631;2674;8733
240460;201311;2815;9322;2733;9185;306;1224;2114;7047;2420;8271
240470;201311;3821;11683;3197;10401;554;1981;1819;5916;2373;7897
240480;201311;388;1018;359;965;41;101;240;658;281;759
240485;201311;2128;6497;1883;6021;384;1359;1059;3373;1443;4732
240490;201311;1648;4259;1455;3994;87;332;1137;3000;1224;3332
240500;201311;2070;6380;1982;6232;198;701;1533;4823;1731;5524
240510;201311;1781;5551;1660;5318;245;853;1185;3810;1430;4663
240520;201311;1431;4232;1267;3995;232;827;836;2580;1068;3407
240530;201311;2199;7094;1986;6756;283;1037;1392;4732;1675;5769
240540;201311;1853;5684;1761;5529;178;633;1323;4103;1501;4736
240550;201311;765;2230;703;2127;56;212;537;1585;593;1797
240560;201311;3197;9538;3053;9310;288;968;2479;7528;2767;8496
240570;201311;3109;8999;2548;7745;598;2071;1132;3141;1730;5212
240580;201311;8050;25458;7633;24760;1323;4577;5465;17634;6788;22211
240590;201311;843;2424;752;2264;55;216;552;1622;607;1838
240600;201311;1479;4499;1215;3930;208;776;677;2084;885;2860
240610;201311;4987;14142;4417;13116;479;1594;3073;8993;3552;10587
240615;201311;1033;3002;870;2692;146;466;509;1579;655;2045
240620;201311;1620;5448;1526;5268;264;1002;1090;3758;1354;4760
240630;201311;2028;6347;1927;6165;183;567;1484;4921;1667;5488
240640;201311;910;2743;775;2528;92;402;516;1615;608;2017
240650;201311;3673;11552;3429;11215;312;1178;2767;9017;3079;10195
240660;201311;2504;8132;2398;7961;277;970;1808;6102;2085;7072
240670;201311;2743;8305;2367;7530;365;1350;1375;4268;1740;5618
240680;201311;1492;4454;1209;3922;163;542;732;2412;895;2954
240690;201311;1082;3117;952;2900;101;363;690;2094;791;2457
240700;201311;2622;8031;2203;7211;151;675;1693;5384;1844;6059
240710;201311;18524;47501;16463;44876;3050;8451;10260;28819;13310;37270
240720;201311;5491;16193;5253;15819;1325;4409;3024;9037;4349;13446
240725;201311;1078;3256;825;2675;81;281;470;1491;551;1772
240730;201311;2259;7096;2037;6672;208;775;1424;4590;1632;5365
240740;201311;2270;6887;2041;6467;263;907;1346;4264;1609;5171
240750;201311;2222;8341;2051;8023;478;2007;1141;4524;1619;6531
240760;201311;1191;3685;1138;3605;112;317;913;3004;1025;3321
240770;201311;3499;10426;3222;10000;436;1524;2259;6994;2695;8518
240780;201311;5807;16834;4840;15242;922;3102;2698;8699;3620;11801
240790;201311;844;2696;691;2404;48;193;528;1840;576;2033
240800;201311;39597;117095;36512;111633;10637;34789;15579;48318;26216;83107
240810;201311;93105;284969;87923;275215;29150;94990;39434;125472;68584;220462
240820;201311;6848;20705;5932;19235;1065;3846;3329;11150;4394;14996
240830;201311;9279;28885;8809;28195;803;2698;7156;23297;7959;25995
240840;201311;1280;3633;1111;3339;107;394;713;2114;820;2508
240850;201311;1140;3591;896;3076;182;710;458;1481;640;2191
240860;201311;1295;3733;1117;3447;90;324;820;2497;910;2821
240870;201311;1153;3247;1001;2956;131;484;666;1842;797;2326
240880;201311;1171;4044;1111;3955;150;662;788;2756;938;3418
240890;201311;5445;15518;4798;14406;789;2691;2747;8184;3536;10875
240895;201311;2771;9567;2538;9155;397;1528;1737;6359;2134;7887
240910;201311;2559;8379;2409;8090;256;1040;1807;6015;2063;7055
240920;201311;855;2790;781;2617;194;735;400;1300;594;2035
240930;201311;3567;9841;3262;9425;305;932;2589;7554;2894;8486
240933;201311;1450;4416;1304;4163;291;1017;696;2262;987;3279
240940;201311;6538;18736;5579;17072;1175;3796;2950;9024;4125;12820
240950;201311;1142;3634;1075;3524;104;433;786;2572;890;3005
240960;201311;767;2468;700;2330;77;311;516;1691;593;2002
240970;201311;2018;5768;1707;5208;163;594;1199;3621;1362;4215
240980;201311;3316;11096;3098;10676;724;2731;1815;6230;2539;8961
240990;201311;3040;9245;2857;8869;588;2050;1764;5338;2352;7388
241000;201311;1066;3054;937;2824;98;364;688;2026;786;2390
241010;201311;2953;10106;2686;9619;452;1850;1763;6190;2215;8040
241020;201311;2088;6011;1736;5322;182;665;1077;3151;1259;3816
241025;201311;1510;4714;1403;4517;132;551;990;3131;1122;3682
241030;201311;2538;8457;2341;8111;159;589;1888;6612;2047;7201
241040;201311;2113;7501;1937;7156;218;951;1436;5300;1654;6251
241050;201311;1303;3944;1185;3734;104;425;890;2710;994;3135
241060;201311;996;2903;912;2763;122;387;682;2081;804;2468
241070;201311;908;2669;784;2435;101;379;545;1632;646;2011
241080;201311;1166;3553;1039;3320;87;361;720;2224;807;2585
241090;201311;2142;6235;1868;5759;128;547;1511;4580;1639;5127
241100;201311;1192;3618;1059;3314;108;387;738;2261;846;2648
241105;201311;1138;3489;1074;3375;177;603;679;2185;856;2788
241110;201311;842;2741;719;2481;102;437;412;1376;514;1813
241120;201311;7994;24334;7301;23221;1519;4953;4737;15438;6256;20391
241140;201311;3362;9713;3015;9028;430;1383;1990;5881;2420;7264
241142;201311;696;2101;497;1650;150;576;138;405;288;981
241150;201311;5710;17436;5269;16687;908;3011;3460;11047;4368;14058
241160;201311;1110;3283;1046;3161;165;547;711;2143;876;2690
241170;201311;1334;3996;1217;3775;157;555;750;2409;907;2964
241180;201311;1012;2791;808;2422;117;403;464;1339;581;1742
241190;201311;1037;2911;941;2750;89;349;640;1751;729;2100
241200;201311;20324;62232;18916;59950;5087;17403;9713;31193;14800;48596
241210;201311;1475;4439;1254;3991;269;971;636;1989;905;2960
241220;201311;7917;27114;7567;26431;1833;6829;4160;14853;5993;21682
241230;201311;3012;9316;2743;8908;226;887;2215;7137;2441;8024
241240;201311;1139;3315;865;2722;81;260;511;1653;592;1913
241250;201311;5527;17824;4916;16614;366;1708;3950;13035;4316;14743
241255;201311;1869;7201;1776;6992;472;1946;825;3385;1297;5331
241260;201311;4915;13571;3987;12073;341;1288;2830;8398;3171;9686
241270;201311;2043;6235;1797;5747;272;1020;1055;3387;1327;4407
241280;201311;2138;6312;1983;6001;397;1243;1221;3767;1618;5010
241290;201311;3261;9121;2651;8155;507;1689;1545;4735;2052;6424
241300;201311;1366;4034;1248;3851;77;277;992;3070;1069;3347
241310;201311;1500;4870;1436;4764;212;703;1040;3552;1252;4255
241320;201311;880;2995;826;2887;170;652;446;1582;616;2234
241330;201311;1527;4887;1437;4762;159;619;1152;3775;1311;4394
241335;201311;2570;8094;2456;7890;214;678;2040;6603;2254;7281
241340;201311;1940;6124;1747;5710;464;1680;842;2680;1306;4360
241350;201311;1940;6281;1823;6044;169;714;1388;4478;1557;5192
241355;201311;1262;3557;1121;3309;72;239;963;2807;1035;3046
241360;201311;2091;5876;1877;5456;147;556;1369;3801;1516;4357
241370;201311;1334;4177;1088;3640;201;758;597;1977;798;2735
241380;201311;721;2097;628;1911;95;350;348;1038;443;1388
241390;201311;2875;9792;2723;9499;677;2464;1574;5634;2251;8098
241400;201311;3829;11454;3625;11156;496;1770;2658;8147;3154;9917
241410;201311;2616;7936;2424;7656;449;1566;1643;5140;2092;6706
241415;201311;1556;4920;1435;4678;148;569;1034;3328;1182;3897
241420;201311;2151;7631;1925;7282;600;2514;851;3250;1451;5764
241430;201311;428;1334;405;1272;55;189;270;812;325;1001
241440;201311;6654;23938;6272;23273;1166;4524;4307;16198;5473;20722
241445;201311;1007;3200;958;3129;165;479;710;2456;875;2935
241450;201311;3217;9206;2990;8881;486;1626;2116;6208;2602;7834
241460;201311;3530;10471;3140;9702;287;1095;2276;6903;2563;7998
241470;201311;1336;3843;1165;3625;136;545;863;2596;999;3141
241475;201311;1233;3898;1067;3570;70;337;785;2538;855;2875
241480;201311;3219;10638;2947;10221;1001;3589;1113;4219;2114;7808
241490;201311;635;1732;520;1553;57;232;356;1002;413;1234
241500;201311;718;2327;703;2307;11;49;671;2200;682;2249
250010;201311;2653;8551;2363;8058;250;1060;1707;5676;1957;6736
250020;201311;1667;4865;1299;4179;123;520;875;2722;998;3242
250030;201311;7761;22752;7033;21726;896;2869;5232;16552;6128;19421
250040;201311;4428;15190;4109;14573;781;2989;2613;9314;3394;12303
250050;201311;3570;11508;3302;11123;546;2046;2241;7581;2787;9627
250053;201311;1255;3881;1205;3813;183;652;822;2589;1005;3241
250057;201311;728;2648;706;2620;49;164;605;2337;654;2501
250060;201311;4822;15615;4647;15325;643;2451;3474;11234;4117;13685
250070;201311;4169;13137;3933;12717;445;1827;3042;9521;3487;11348
250073;201311;772;2370;700;2234;83;302;484;1540;567;1842
250077;201311;2233;6633;1866;6017;283;990;1056;3444;1339;4434
250080;201311;4728;13936;4559;13689;598;1903;3347;10071;3945;11974
250090;201311;2609;7933;2530;7809;157;599;2121;6411;2278;7010
250100;201311;3923;13497;3753;13184;448;1781;2873;10055;3321;11836
250110;201311;5708;17639;5453;17268;854;3008;3997;12575;4851;15583
250115;201311;558;1853;487;1690;58;275;303;985;361;1260
250120;201311;2230;6652;1931;6095;189;710;1403;4361;1592;5071
250130;201311;5440;17116;5105;16616;332;1221;4217;13862;4549;15083
250135;201311;1072;3307;981;3147;121;420;679;2205;800;2625
250140;201311;2072;6766;1916;6561;249;849;1439;5048;1688;5897
250150;201311;5053;17247;4676;16558;539;2191;3434;12096;3973;14287
250153;201311;1577;4182;1411;3933;132;457;1103;3036;1235;3493
250157;201311;1612;5715;1478;5424;369;1349;802;3066;1171;4415
250160;201311;3292;10421;3157;10207;223;825;2706;8747;2929;9572
250170;201311;1588;4719;1493;4562;331;1082;912;2827;1243;3909
250180;201311;16403;52407;15906;51513;2746;10241;10791;34047;13537;44288
250190;201311;3911;11841;3638;11360;619;2100;2348;7236;2967;9336
250200;201311;2208;6175;1777;5597;139;514;1482;4632;1621;5146
250205;201311;1003;3357;874;3127;87;412;609;2162;696;2574
250210;201311;1627;5399;1505;5215;188;818;1077;3632;1265;4450
250215;201311;1412;4893;1370;4810;208;840;866;3029;1074;3869
250220;201311;810;2310;678;2149;47;173;579;1817;626;1990
250230;201311;1695;4377;1385;3863;149;469;1058;2870;1207;3339
250240;201311;2630;8533;2334;8071;252;942;1742;6090;1994;7032
250250;201311;4453;13819;4112;13338;427;1477;3262;10674;3689;12151
250260;201311;1897;5899;1678;5539;133;515;1280;4221;1413;4736
250270;201311;1264;4097;1173;3984;156;558;889;3046;1045;3604
250280;201311;3780;11475;3488;11002;740;2409;2160;7079;2900;9488
250290;201311;2143;5727;1773;5240;58;222;1556;4586;1614;4808
250300;201311;5444;16252;5144;15865;636;2572;4023;11900;4659;14472
250310;201311;1148;3742;1043;3569;166;675;744;2509;910;3184
250320;201311;7832;25079;7436;24209;1212;4494;4833;15311;6045;19805
250330;201311;2527;8076;2209;7623;259;1040;1666;5680;1925;6720
250340;201311;1129;3336;1058;3229;62;221;888;2715;950;2936
250350;201311;4530;12496;4136;12002;200;678;3587;10525;3787;11203
250355;201311;2105;6533;1920;6246;131;550;1523;4924;1654;5474
250360;201311;2025;6117;1882;5905;123;464;1468;4624;1591;5088
250370;201311;13660;39001;11938;36915;881;2812;10291;32099;11172;34911
250375;201311;1086;3466;1029;3366;66;275;858;2796;924;3071
250380;201311;1640;4718;1564;4621;105;371;1358;3989;1463;4360
250390;201311;1963;5343;1629;4778;213;692;1100;3219;1313;3911
250400;201311;64285;184321;58592;176013;14606;46492;32252;98811;46858;145303
250403;201311;1496;5092;1453;5031;163;647;1161;3991;1324;4638
250407;201311;1104;3281;964;3035;74;245;758;2360;832;2605
250410;201311;657;2150;574;1999;69;299;429;1474;498;1773
250415;201311;1816;5792;1664;5477;100;440;1273;4089;1373;4529
250420;201311;1304;4136;1212;3984;103;418;1000;3216;1103;3634
250430;201311;6536;18472;6195;17971;503;1794;5084;14436;5587;16230
250435;201311;1627;4993;1455;4667;186;702;895;2934;1081;3636
250440;201311;4492;13671;4304;13408;271;1014;3674;11404;3945;12418
250450;201311;2069;5898;1852;5605;96;353;1643;4949;1739;5302
250460;201311;6178;19097;5769;18525;820;2817;4248;13795;5068;16612
250470;201311;1589;4434;1442;4219;142;510;1059;3033;1201;3543
250480;201311;3941;11941;3552;11365;174;699;3089;9816;3263;10515
250485;201311;608;1638;511;1464;30;116;404;1108;434;1224
250490;201311;4113;13409;3995;13220;762;2711;2687;8919;3449;11630
250500;201311;1910;5920;1767;5677;351;1172;1078;3520;1429;4692
250510;201311;4950;13975;4348;13129;324;1188;3563;10638;3887;11826
250520;201311;1871;5880;1770;5702;358;1334;1022;3191;1380;4525
250523;201311;1783;5765;1702;5657;229;816;1300;4371;1529;5187
250527;201311;1447;4459;1358;4338;61;275;1208;3802;1269;4077
250530;201311;668;2090;591;1989;53;211;480;1612;533;1823
250535;201311;1262;4108;1209;4000;87;362;972;3146;1059;3508
250540;201311;2466;7309;2309;7129;92;312;2111;6537;2203;6849
250550;201311;913;3046;843;2933;72;308;639;2188;711;2496
250560;201311;1727;5649;1689;5591;133;497;1438;4766;1571;5263
250570;201311;2519;8375;2291;7937;212;872;1728;5906;1940;6778
250580;201311;1107;3185;917;2857;139;550;615;1827;754;2377
250590;201311;1046;3231;941;3084;86;368;738;2361;824;2729
250600;201311;7775;22620;7394;22033;782;2351;5803;17540;6585;19891
250610;201311;3335;10130;3130;9821;389;1315;2261;7128;2650;8443
250620;201311;867;2548;800;2414;137;451;524;1571;661;2022
250625;201311;2108;7020;2071;6966;79;229;1906;6493;1985;6722
250630;201311;10256;33611;9736;32664;2282;8300;5354;17914;7636;26214
250640;201311;3879;11574;3620;11262;318;1249;2994;9108;3312;10357
250650;201311;896;2697;846;2602;164;614;442;1381;606;1995
250660;201311;2179;5273;1668;4653;30;86;1585;4428;1615;4514
250670;201311;2665;9106;2529;8847;289;1186;1824;6375;2113;7561
250680;201311;4908;14293;4645;13906;287;1042;3958;11781;4245;12823
250690;201311;6277;17224;6082;16952;622;2024;5105;13975;5727;15999
250700;201311;5304;16180;4977;15681;771;2720;3480;10809;4251;13529
250710;201311;4463;14587;4121;14138;625;2250;2933;10303;3558;12553
250720;201311;2609;8056;2486;7844;207;814;1979;6163;2186;6977
250730;201311;3558;11354;3403;11098;476;1762;2424;7837;2900;9599
250740;201311;2020;6110;1764;5646;223;807;1227;3877;1450;4684
250750;201311;101145;305235;95912;297005;19146;65449;61325;187170;80471;252619
250760;201311;2193;6691;2032;6422;244;952;1435;4461;1679;5413
250770;201311;3757;13268;3569;13000;789;3078;2135;7827;2924;10905
250780;201311;1880;5771;1637;5313;175;712;1141;3620;1316;4332
250790;201311;2461;8129;2326;7927;623;2101;1417;4977;2040;7078
250800;201311;2702;7984;2387;7459;185;682;1784;5450;1969;6132
250810;201311;1355;4061;1182;3805;118;485;940;2956;1058;3441
250820;201311;2003;6294;1948;6204;113;422;1628;5230;1741;5652
250830;201311;5848;19571;5573;19029;744;3050;3807;12709;4551;15759
250840;201311;1042;3357;910;3085;120;465;580;1958;700;2423
250850;201311;2387;7027;2061;6482;225;884;1371;4411;1596;5295
250855;201311;1088;3276;1028;3181;69;243;856;2619;925;2862
250860;201311;2856;9828;2636;9385;641;2497;1142;4063;1783;6560
250870;201311;1193;3468;1034;3209;78;301;746;2240;824;2541
250880;201311;1336;4018;1278;3935;122;411;1012;3109;1134;3520
250890;201311;9160;30177;8523;29273;1616;6441;5424;18373;7040;24814
250900;201311;3046;10250;2719;9620;326;1199;1917;6893;2243;8092
250905;201311;2107;6655;2011;6526;343;1162;1454;4750;1797;5912
250910;201311;5292;15739;4951;15214;536;1808;3732;11484;4268;13292
250915;201311;1728;5181;1555;4867;159;493;1252;3991;1411;4484
250920;201311;3583;10268;3379;9978;466;1381;2407;7328;2873;8709
250930;201311;1927;6378;1850;6244;367;1427;1230;4068;1597;5495
250933;201311;1165;3835;1123;3768;161;599;778;2624;939;3223
250937;201311;866;2719;776;2533;119;486;461;1484;580;1970
250939;201311;1710;5431;1554;5161;262;936;997;3332;1259;4268
250940;201311;3952;11717;3663;11264;267;959;2898;8897;3165;9856
250950;201311;1343;4255;1232;4112;77;276;1021;3447;1098;3723
250960;201311;1350;4269;1198;4066;74;283;1014;3477;1088;3760
250970;201311;8804;24434;7992;23330;1316;3992;5517;16219;6833;20211
250980;201311;2668;8226;2461;7859;271;1094;1706;5250;1977;6344
250990;201311;2108;7406;1989;7160;297;1261;1355;4759;1652;6020
251000;201311;2565;7382;2115;6738;137;523;1702;5403;1839;5926
251010;201311;2841;8305;2586;7947;226;824;2032;6238;2258;7062
251020;201311;1652;5165;1532;5014;159;568;1248;4126;1407;4694
251030;201311;1314;3748;1192;3543;129;453;764;2265;893;2718
251040;201311;1944;6282;1750;5976;190;894;1250;4091;1440;4985
251050;201311;1131;3404;992;3148;163;558;547;1808;710;2366
251060;201311;1039;2581;849;2341;92;332;644;1688;736;2020
251065;201311;584;1764;513;1652;78;285;309;959;387;1244
251070;201311;593;1722;567;1681;51;213;447;1245;498;1458
251080;201311;21234;59878;19924;57697;5415;16716;10822;31682;16237;48398
251090;201311;3043;9728;2751;9197;328;1258;1957;6468;2285;7726
251100;201311;987;3264;870;3047;135;535;569;1939;704;2474
251110;201311;2110;6175;1904;5843;227;769;1318;4054;1545;4823
251120;201311;5933;20458;5762;20159;826;3413;4440;15216;5266;18629
251130;201311;3940;10306;3548;9865;62;211;3397;9428;3459;9639
251140;201311;4349;13626;4056;13154;271;1101;3150;10168;3421;11269
251150;201311;2812;9282;2596;8985;339;1367;1904;6642;2243;8009
251160;201311;1876;6268;1805;6174;97;385;1590;5453;1687;5838
251170;201311;1428;4483;1385;4429;134;506;1135;3571;1269;4077
251180;201311;2921;8841;2686;8537;635;2115;1551;5024;2186;7139
251190;201311;4282;12575;4157;12416;301;954;3644;10920;3945;11874
251200;201311;4210;13075;4013;12812;252;918;3475;11128;3727;12046
251203;201311;1325;4233;1204;3983;118;491;746;2538;864;3029
251207;201311;1239;3934;1071;3602;92;394;751;2475;843;2869
251210;201311;7997;23329;7067;22035;1059;3320;5041;16058;6100;19378
251220;201311;1283;3530;1141;3307;176;560;718;2138;894;2698
251230;201311;5181;15889;4569;15160;463;1734;3821;12610;4284;14344
251240;201311;3143;10464;3064;10334;329;1347;2408;7994;2737;9341
251250;201311;10271;31593;9620;30543;1680;5777;6577;20747;8257;26524
251260;201311;541;1694;488;1620;39;141;369;1232;408;1373
251270;201311;4149;12977;3918;12668;159;657;3557;11456;3716;12113
251272;201311;1369;4243;1280;4109;121;407;1007;3295;1128;3702
251274;201311;987;3174;934;3068;131;544;531;1782;662;2326
251275;201311;1372;3945;1295;3821;143;535;973;2774;1116;3309
251276;201311;1497;4500;1415;4345;230;767;849;2695;1079;3462
251278;201311;612;1989;527;1785;89;331;298;1051;387;1382
251280;201311;2281;7381;2204;7238;308;1137;1603;5267;1911;6404
251290;201311;6020;17542;5720;17155;881;3090;4098;11975;4979;15065
251300;201311;776;2672;718;2584;72;341;507;1774;579;2115
251310;201311;3168;9475;2901;9079;221;870;2338;7196;2559;8066
251315;201311;1678;6043;1632;5949;326;1288;978;3600;1304;4888
251320;201311;2121;6051;1760;5462;142;524;1282;4023;1424;4547
251330;201311;2056;5377;1711;4928;125;523;1427;3936;1552;4459
251335;201311;981;3429;945;3359;127;492;701;2489;828;2981
251340;201311;3910;10986;3306;10045;340;1307;2330;6882;2670;8189
251350;201311;1623;5058;1470;4833;256;938;958;3156;1214;4094
251360;201311;1823;6038;1728;5928;126;516;1455;5005;1581;5521
251365;201311;899;2683;722;2300;70;279;475;1473;545;1752
251370;201311;21777;75428;21390;74755;4398;16951;14372;49511;18770;66462
251380;201311;1380;4299;1213;4013;100;443;935;2994;1035;3437
251385;201311;866;2458;792;2331;78;295;542;1540;620;1835
251390;201311;5726;20657;5434;20194;1032;4172;3653;13504;4685;17676
251392;201311;1063;3166;986;3037;124;398;692;2170;816;2568
251394;201311;611;1915;516;1726;43;173;361;1199;404;1372
251396;201311;871;2536;798;2404;68;234;624;1846;692;2080
251398;201311;1134;3315;945;2959;92;353;641;1973;733;2326
251400;201311;1363;3959;1257;3817;158;609;881;2587;1039;3196
251410;201311;1617;4301;1466;4052;172;545;996;2793;1168;3338
251420;201311;2182;6369;1865;6006;190;725;1407;4472;1597;5197
251430;201311;1715;6185;1558;5933;120;535;1280;4882;1400;5417
251440;201311;1461;4482;1256;4090;174;660;879;2827;1053;3487
251445;201311;1551;4926;1478;4811;128;507;1225;3934;1353;4441
251450;201311;4810;15261;4316;14632;176;738;3779;12814;3955;13552
251455;201311;1205;3786;1043;3519;89;382;755;2506;844;2888
251460;201311;882;2812;848;2745;154;510;622;2046;776;2556
251465;201311;504;1608;457;1513;54;215;296;958;350;1173
251470;201311;1292;3762;1067;3335;143;547;618;1928;761;2475
251480;201311;1131;3113;1024;2933;63;240;822;2307;885;2547
251490;201311;2079;6195;1802;5806;307;1162;1156;3652;1463;4814
251500;201311;1741;5834;1692;5756;216;851;1276;4279;1492;5130
251510;201311;2571;8708;2388;8306;456;1706;1405;4930;1861;6636
251520;201311;1087;3040;991;2891;135;412;551;1617;686;2029
251530;201311;11749;35112;11288;34435;866;3334;9519;28531;10385;31865
251540;201311;2823;9414;2612;8954;288;1219;1919;6513;2207;7732
251550;201311;3958;9930;3341;9132;195;679;2730;7236;2925;7915
251560;201311;745;2331;685;2224;118;495;410;1209;528;1704
251570;201311;1032;3107;891;2825;117;454;548;1761;665;2215
251580;201311;2192;6062;2030;5841;340;924;1483;4372;1823;5296
251590;201311;1690;5645;1657;5607;113;403;1446;4949;1559;5352
251593;201311;1011;3256;963;3174;149;560;622;1990;771;2550
251597;201311;1956;6086;1882;5963;212;788;1457;4542;1669;5330
251600;201311;7273;21750;6946;21221;963;3057;5049;15759;6012;18816
251610;201311;3610;10967;3319;10578;372;1278;2514;8098;2886;9376
251615;201311;1219;3590;1051;3283;102;327;724;2361;826;2688
251620;201311;17126;49490;15244;47055;2436;7972;10738;33572;13174;41544
251630;201311;5359;13724;4700;12922;404;1185;3733;10349;4137;11534
251640;201311;2654;7844;2173;6976;274;1036;1467;4667;1741;5703
251650;201311;4363;12500;3932;11950;335;1154;3199;9840;3534;10994
251660;201311;3579;12114;3287;11657;274;1289;2651;9182;2925;10471
251670;201311;3972;11671;3569;11080;176;597;3073;9538;3249;10135
251675;201311;752;2539;717;2481;169;646;392;1313;561;1959
251680;201311;2864;8058;2330;7259;149;635;1897;5784;2046;6419
251690;201311;3399;10820;3162;10382;424;1529;2130;6963;2554;8492
251700;201311;2067;6938;1966;6800;233;907;1535;5276;1768;6183
251710;201311;943;2497;710;2074;101;368;378;1038;479;1406
251720;201311;1363;4280;1272;4135;120;471;991;3199;1111;3670
251740;201311;741;2096;599;1839;119;398;329;1027;448;1425
260005;201311;24648;61664;22009;58152;4792;13102;13593;36130;18385;49232
260010;201311;9567;26454;7786;24238;757;2575;6108;19039;6865;21614
260020;201311;5776;17291;5136;16284;653;2035;3709;12248;4362;14283
260030;201311;5353;16323;4970;15748;542;1904;3829;12106;4371;14010
260040;201311;10191;24769;8459;22802;604;1455;7031;19562;7635;21017
260050;201311;10757;35508;10108;34774;679;2512;8826;30664;9505;33176
260060;201311;4080;11463;3792;11021;323;980;3068;9037;3391;10017
260070;201311;9314;28896;8899;28291;2316;7932;5269;16802;7585;24734
260080;201311;5377;15827;4800;14960;607;2134;3353;10377;3960;12511
260090;201311;5194;14315;4930;13956;941;2482;3495;10304;4436;12786
260100;201311;3483;9407;3199;9024;244;903;2575;7271;2819;8174
260105;201311;4417;13530;4268;13258;853;2779;2746;8523;3599;11302
260110;201311;21402;64491;19879;62638;1634;5115;16811;53678;18445;58793
260120;201311;11466;35930;11074;35239;3199;10502;5591;18523;8790;29025
260130;201311;3083;9012;2937;8770;436;1275;2103;6440;2539;7715
260140;201311;13130;34688;11315;32427;1288;4185;8545;24718;9833;28903
260150;201311;3054;9121;2735;8637;251;934;2112;6719;2363;7653
260160;201311;5955;18179;5399;17515;501;1748;4413;14576;4914;16324
260170;201311;17373;48632;16709;47730;1518;4089;13723;39948;15241;44037
260180;201311;3462;10803;3169;10356;227;917;2620;8494;2847;9411
260190;201311;15825;38744;15014;37716;1046;2863;12850;32221;13896;35084
260200;201311;11136;32952;9887;31078;1284;4113;7219;23266;8503;27379
260210;201311;11271;35734;10465;34550;802;2984;8642;28858;9444;31842
260220;201311;8969;28778;8769;28478;783;3185;7394;23550;8177;26735
260230;201311;9695;29134;9294;28587;695;2243;7685;24052;8380;26295
260240;201311;2848;9202;2553;8766;387;1457;1765;6072;2152;7529
260250;201311;2769;7506;2546;7221;186;513;2149;6179;2335;6692
260260;201311;11291;33753;11086;33489;974;3226;9231;28465;10205;31691
260270;201311;3510;10835;3312;10541;408;1558;2583;8072;2991;9630
260280;201311;12480;42427;11540;40926;825;3315;9569;34256;10394;37571
260290;201311;33303;102475;32275;100806;5903;21064;22118;67502;28021;88566
260300;201311;8478;26159;7621;24937;751;2874;5877;19326;6628;22200
260310;201311;5086;15510;4774;15013;1508;4471;2370;8037;3878;12508
260320;201311;6674;23081;6252;22453;556;2159;5018;18258;5574;20417
260330;201311;3102;9752;2839;9302;283;1135;1901;6406;2184;7541
260340;201311;1862;5615;1780;5502;111;411;1561;4784;1672;5195
260345;201311;25685;85953;24720;83968;7721;28549;11370;37270;19091;65819
260350;201311;4350;12939;4170;12656;500;1719;3083;9319;3583;11038
260360;201311;2363;7523;2271;7373;590;2022;1202;4016;1792;6038
260370;201311;6016;18936;5530;18067;812;2749;3896;13026;4708;15775
260380;201311;4965;16486;4643;16074;429;1424;3805;13469;4234;14893
260390;201311;4747;15037;4141;14068;506;1975;2976;9936;3482;11911
260392;201311;3412;11092;3238;10851;183;730;2848;9510;3031;10240
260400;201311;13608;40925;13107;40113;2715;9268;8566;25709;11281;34977
260410;201311;62003;186237;58955;181054;19931;61888;27291;86835;47222;148723
260415;201311;4032;13340;3597;12525;591;2423;2218;7671;2809;10094
260420;201311;11903;28214;10885;27119;787;2223;9113;22658;9900;24881
260430;201311;2701;9167;2478;8807;261;1075;1874;6592;2135;7667
260440;201311;3392;10610;3167;10162;560;2024;1918;6065;2478;8089
260450;201311;4997;15694;4750;15262;460;1647;3687;11882;4147;13529
260460;201311;5919;18539;5621;18090;938;3411;3746;11873;4684;15284
260470;201311;4986;14800;4707;14411;501;1663;3678;11453;4179;13116
260480;201311;3840;11453;3476;10904;675;2285;2315;7233;2990;9518
260490;201311;6043;16016;5329;14889;723;2413;3542;9862;4265;12275
260500;201311;6744;18889;6288;18224;713;2180;4674;13800;5387;15980
260510;201311;10256;27713;9533;26709;879;2667;7437;21422;8316;24089
260515;201311;4700;14961;3851;13205;526;2010;2273;7915;2799;9925
260520;201311;15829;43304;15395;42733;3438;8920;10278;29788;13716;38708
260530;201311;10235;30667;9044;29069;523;1586;7865;25795;8388;27381
260540;201311;5777;15244;5509;14947;704;1655;4350;12212;5054;13867
260545;201311;42;162;28;115;4;19;6;23;10;42
260550;201311;2794;9561;2507;9021;686;2754;1164;4145;1850;6899
260560;201311;6706;17496;6069;16586;361;1009;5299;14511;5660;15520
260570;201311;6275;22200;5883;21491;1063;4317;3968;14545;5031;18862
260580;201311;3906;10984;3718;10708;327;1071;3092;8760;3419;9831
260590;201311;5626;15059;5425;14817;262;663;4924;13631;5186;14294
260600;201311;25708;81271;24419;79029;4869;16828;15225;49874;20094;66702
260610;201311;7051;21294;6731;20852;1320;4317;4636;14432;5956;18749
260620;201311;17210;54140;16604;53108;3247;11681;10796;33720;14043;45401
260630;201311;2267;6896;1971;6413;238;915;1439;4644;1677;5559
260640;201311;17227;47986;16428;46833;2281;7086;12103;34364;14384;41450
260650;201311;5487;17689;5223;17251;793;2613;3452;12164;4245;14777
260660;201311;8129;23476;7354;22453;674;2183;5963;18404;6637;20587
260670;201311;2390;6906;2032;6408;287;1035;1346;4257;1633;5292
260680;201311;23088;63646;21856;61608;4944;14923;12528;34928;17472;49851
260690;201311;3513;9904;3060;9173;242;884;2423;7184;2665;8068
260700;201311;5407;16285;5336;16211;94;212;5144;15817;5238;16029
260710;201311;1298;4034;1177;3854;145;569;875;2804;1020;3373
260720;201311;17290;57461;16437;55863;4681;16350;8612;30007;13293;46357
260730;201311;7346;24488;6619;23408;883;3259;4907;17610;5790;20869
260740;201311;1357;4200;1191;3891;181;637;733;2432;914;3069
260750;201311;6746;21935;6414;21464;583;1975;5315;18093;5898;20068
260760;201311;4685;13340;4398;12955;542;1696;3284;9752;3826;11448
260765;201311;7829;28405;7570;28006;1554;6457;4870;18020;6424;24477
260770;201311;4270;11235;3918;10760;243;880;3161;8491;3404;9371
260775;201311;5263;15549;5017;15149;613;2220;3629;10646;4242;12866
260780;201311;3946;13208;3803;12956;909;3388;2198;7497;3107;10885
260790;201311;118290;309915;113996;303670;26875;75402;68712;183177;95587;258579
260795;201311;3020;9868;2843;9588;497;1801;1873;6427;2370;8228
260800;201311;4695;13013;4374;12572;247;1005;3767;10524;4014;11529
260805;201311;4097;12133;3702;11499;597;1976;2493;7771;3090;9747
260810;201311;7408;21605;7202;21322;472;1686;6270;18410;6742;20096
260820;201311;4566;13437;4310;13073;1358;4208;2258;6932;3616;11140
260825;201311;3041;9903;2882;9669;298;1007;2335;7939;2633;8946
260830;201311;3640;12040;3402;11619;999;3253;1867;6734;2866;9987
260840;201311;4169;12345;3874;11903;254;954;3319;10140;3573;11094
260845;201311;4147;12520;3856;11939;670;2242;2604;8061;3274;10303
260850;201311;4907;17146;4513;16303;1182;4846;2192;7724;3374;12570
260860;201311;2986;9955;2782;9619;357;1269;2028;7130;2385;8399
260870;201311;4152;11744;3784;11273;590;1641;2710;8353;3300;9994
260875;201311;7364;19854;6691;18807;954;2716;4547;13203;5501;15919
260880;201311;8798;28427;8402;27842;1056;3533;6556;22063;7612;25596
260890;201311;14824;43095;14232;42198;1635;5528;10692;31678;12327;37206
260900;201311;6042;18950;5248;17603;1052;3704;3137;10729;4189;14433
260910;201311;3018;9430;2732;9001;309;1182;2113;6902;2422;8084
260915;201311;4505;15199;4386;15030;112;356;4084;14225;4196;14581
260920;201311;3426;10625;3253;10371;536;1872;2292;7447;2828;9319
260930;201311;4165;13425;3734;12794;553;1908;2653;9289;3206;11197
260940;201311;13782;40007;12697;38089;2555;8954;7133;20832;9688;29786
260950;201311;6245;20437;5986;19925;988;4147;3873;12085;4861;16232
260960;201311;67124;190096;63632;184447;13926;43084;37186;108497;51112;151581
260970;201311;5307;17532;4959;16978;672;2685;3550;12052;4222;14737
260980;201311;3973;12795;3802;12567;263;986;3176;10659;3439;11645
260990;201311;17657;56363;16315;54471;2395;7594;11840;41497;14235;49091
261000;201311;15007;43838;12536;39713;2854;9721;6733;21681;9587;31402
261010;201311;2783;7873;2607;7639;241;548;2175;6692;2416;7240
261020;201311;6268;18883;5770;18100;469;1795;4625;14128;5094;15923
261030;201311;3368;11421;3229;11188;343;1286;2565;8861;2908;10147
261040;201311;5323;17521;4638;16433;626;2531;3292;11629;3918;14160
261050;201311;8720;24982;8166;24108;1307;4031;5372;15802;6679;19833
261060;201311;11165;35305;10808;34723;1955;6946;7521;23806;9476;30752
261070;201311;48116;127580;44108;122015;10439;30345;25263;70690;35702;101035
261080;201311;5675;17760;5393;17297;435;1399;4485;14624;4920;16023
261090;201311;15979;45852;15028;44540;1634;5049;11923;35586;13557;40635
261100;201311;7298;23705;6826;22967;621;2502;5378;17998;5999;20500
261110;201311;66147;192509;60641;184488;15076;46995;33943;108864;49019;155859
261120;201311;3555;9918;3279;9561;154;465;2897;8540;3051;9005
261130;201311;6998;18535;6723;18228;282;779;6134;16636;6416;17415
261140;201311;3239;9329;3004;8953;662;2192;1786;5246;2448;7438
261150;201311;5426;16762;4922;16055;571;2143;3721;12159;4292;14302
261153;201311;1950;5678;1662;5274;117;450;1379;4386;1496;4836
261160;201311;223362;592325;214017;579594;45108;125188;133868;372054;178976;497242
261170;201311;5924;16952;5545;16395;863;2639;4106;12212;4969;14851
261180;201311;9365;27014;9120;26693;1067;3167;7190;21335;8257;24502
261190;201311;5323;17139;5088;16821;821;3593;3503;10888;4324;14481
261200;201311;3903;9776;3699;9499;618;1623;2609;6746;3227;8369
261210;201311;1913;5255;1837;5151;145;399;1574;4479;1719;4878
261220;201311;12436;41480;11020;38315;2216;8487;6032;20770;8248;29257
261230;201311;4011;12606;3794;12336;159;548;3459;11289;3618;11837
261240;201311;4841;14541;4597;14084;830;2521;3141;9786;3971;12307
261245;201311;3830;12257;3330;11409;285;1211;2436;8422;2721;9633
261247;201311;3494;11036;3069;10253;451;1592;2080;7027;2531;8619
261250;201311;19129;52210;18521;51356;3056;8770;14102;39182;17158;47952
261255;201311;4340;13506;3895;12773;353;1297;3013;10013;3366;11310
261260;201311;12084;35411;11150;34314;656;1833;9843;30866;10499;32699
261270;201311;3801;11111;3563;10731;509;1676;2495;7513;3004;9189
261280;201311;2719;8540;2475;8172;272;1040;1839;6038;2111;7078
261290;201311;2983;8665;2687;8281;251;893;2165;6723;2416;7616
261300;201311;10156;34949;9254;33325;1642;6584;6014;21621;7656;28205
261310;201311;8349;25834;7969;25173;1834;6152;4771;15034;6605;21186
261320;201311;5931;18754;5592;18102;700;2267;4112;13635;4812;15902
261330;201311;5479;16643;5341;16441;436;1475;4427;13649;4863;15124
261340;201311;4577;15139;4372;14814;696;2685;2907;9896;3603;12581
261350;201311;7903;27248;7510;26529;684;2964;5923;20675;6607;23639
261360;201311;9417;24722;8659;23682;1249;3580;6001;16742;7250;20322
261370;201311;20705;62715;19694;61226;3598;11927;13418;41880;17016;53807
261380;201311;4129;14477;3864;14014;633;2339;2638;9855;3271;12194
261390;201311;16910;53029;15523;50575;2800;10135;9572;30914;12372;41049
261400;201311;4820;17147;4425;16372;647;2699;3009;11185;3656;13884
261410;201311;8012;24367;7653;23804;1035;3330;5629;17841;6664;21171
261420;201311;7888;26843;7640;26467;2002;7595;4388;15418;6390;23013
261430;201311;3590;11235;3070;10541;428;1506;2224;7826;2652;9332
261440;201311;1651;5067;1542;4896;124;504;1247;3911;1371;4415
261450;201311;14044;41554;13665;41026;1092;3470;11894;35731;12986;39201
261460;201311;8449;24567;7912;23816;817;2334;5874;19051;6691;21385
261470;201311;3940;10839;3627;10458;250;823;3093;8881;3343;9704
261480;201311;3400;12643;3191;12264;400;1712;2367;8959;2767;10671
261485;201311;4910;15526;4588;14962;1096;3825;2531;8371;3627;12196
261500;201311;5893;16541;5269;15701;760;2070;3916;12221;4676;14291
261510;201311;2043;6679;1930;6509;157;506;1582;5434;1739;5940
261520;201311;2569;8499;2294;8050;215;876;1613;5649;1828;6525
261530;201311;12423;40859;11107;38287;2558;9804;5361;18432;7919;28236
261540;201311;7265;23711;7050;23341;1787;5640;4490;15493;6277;21133
261550;201311;3423;10540;3290;10346;475;1877;2496;7538;2971;9415
261560;201311;6775;22374;6263;21712;1319;4378;4302;15564;5621;19942
261570;201311;3503;11093;3191;10596;455;1565;2260;7614;2715;9179
261580;201311;5718;18659;5101;17640;452;1733;4050;14274;4502;16007
261590;201311;2833;8037;2496;7563;352;1134;1744;5372;2096;6506
261600;201311;5046;14405;4336;13360;542;1765;3174;9901;3716;11666
261610;201311;2281;7041;2005;6639;181;722;1620;5270;1801;5992
261618;201311;2536;7348;2398;7156;287;926;1856;5502;2143;6428
261620;201311;4525;14100;4300;13743;485;1675;3139;10216;3624;11891
261630;201311;8090;24111;7203;22556;1417;5101;4054;12384;5471;17485
261640;201311;32615;86109;30425;83426;2269;6507;25516;71015;27785;77522
261650;201311;3794;12377;3594;12085;493;1846;2716;9169;3209;11015
270010;201311;4423;17116;4072;16387;522;2453;2842;11422;3364;13875
270020;201311;3893;12190;3660;11803;558;2088;2620;8293;3178;10381
270030;201311;44674;137354;42839;134529;11840;38061;24168;77973;36008;116034
270040;201311;10321;32432;9945;31995;1416;4039;7810;26077;9226;30116
270050;201311;3929;11631;3640;11231;445;1679;2717;8217;3162;9896
270060;201311;1562;5394;1506;5310;381;1477;884;3088;1265;4565
270070;201311;4093;12923;3861;12587;162;729;3395;10944;3557;11673
270080;201311;1280;4125;1164;3962;256;970;704;2370;960;3340
270090;201311;2047;6575;1999;6516;62;246;1873;6095;1935;6341
270100;201311;6417;20426;6160;20076;1334;4640;4047;13145;5381;17785
270110;201311;3399;9769;3137;9460;591;1851;1974;6389;2565;8240
270120;201311;3033;8986;2740;8587;162;614;2321;7299;2483;7913
270130;201311;4955;15799;4725;15527;708;2300;3568;12088;4276;14388
270135;201311;1697;5000;1621;4910;83;184;1473;4576;1556;4760
270140;201311;9320;24768;8358;23489;942;3741;6420;16894;7362;20635
270150;201311;2588;9131;2524;9040;246;1016;2109;7503;2355;8519
270160;201311;4834;16771;4464;16268;344;1189;3763;13955;4107;15144
270170;201311;3995;13434;3694;12972;846;3388;2053;7163;2899;10551
270180;201311;2160;7372;1935;7080;189;861;1516;5499;1705;6360
270190;201311;1880;6336;1792;6185;160;625;1403;4881;1563;5506
270200;201311;2710;9251;2562;9015;241;1097;2051;7046;2292;8143
270210;201311;4144;14484;4041;14337;498;2030;3252;11509;3750;13539
270220;201311;1692;5404;1583;5185;302;1159;864;2882;1166;4041
270230;201311;11019;36811;9816;34912;1528;6319;6735;23714;8263;30033
270235;201311;6435;21676;6141;21182;373;1665;5228;17936;5601;19601
270240;201311;9678;29470;8665;28108;1639;5598;5714;18689;7353;24287
270250;201311;3429;9086;3152;8779;162;460;2860;7982;3022;8442
270255;201311;5061;15717;4228;14257;436;1862;2957;9786;3393;11648
270260;201311;6273;20506;6107;20210;904;3502;4415;14622;5319;18124
270270;201311;1209;3520;1116;3375;197;636;709;2093;906;2729
270280;201311;3644;11120;3453;10838;516;1936;2436;7495;2952;9431
270290;201311;8304;29745;7931;29065;893;3666;6148;22515;7041;26181
270300;201311;3271;11515;3106;11316;199;890;2742;9959;2941;10849
270310;201311;7165;22756;6510;21619;460;2074;5228;16946;5688;19020
270320;201311;6204;20790;5985;20387;1753;6674;2884;9946;4637;16620
270330;201311;4801;16123;4549;15777;396;1472;3764;13185;4160;14657
270340;201311;1770;5593;1616;5400;218;770;1199;4088;1417;4858
270350;201311;2090;5967;1935;5765;363;1128;1217;3862;1580;4990
270360;201311;2078;6553;2032;6497;289;885;1603;5284;1892;6169
270370;201311;1699;5685;1565;5446;196;781;1076;3848;1272;4629
270375;201311;2886;9124;2760;8927;442;1785;1961;6065;2403;7850
270380;201311;6153;18971;5889;18613;605;1990;4589;14827;5194;16817
270390;201311;1438;4022;1304;3859;188;664;883;2516;1071;3180
270400;201311;6097;19031;5639;18363;608;2281;4104;13227;4712;15508
270410;201311;4884;15315;4655;14871;597;2086;3344;10645;3941;12731
270420;201311;5410;17949;5261;17724;305;1427;4489;14856;4794;16283
270430;201311;140181;412973;134902;405561;35797;110259;77204;238449;113001;348708
270440;201311;4930;15633;4671;15229;396;1476;3747;12267;4143;13743
270450;201311;6381;20530;6221;20320;667;2554;4932;16094;5599;18648
270460;201311;3518;9991;3188;9526;273;1045;2548;7414;2821;8459
270470;201311;10694;35288;10265;34510;1398;4557;7477;26069;8875;30626
270480;201311;3092;9992;2870;9586;367;1483;1900;6115;2267;7598
270490;201311;985;3203;930;3118;98;406;694;2274;792;2680
270500;201311;5370;18838;5190;18570;530;1920;4160;15300;4690;17220
270510;201311;6027;18983;5551;18314;965;4076;3961;12388;4926;16464
270520;201311;3665;12113;3460;11765;1044;3773;1686;5834;2730;9607
270530;201311;1527;4599;1354;4370;223;703;916;3082;1139;3785
270540;201311;2004;7129;1851;6889;186;910;1450;5271;1636;6181
270550;201311;6993;21731;6253;20710;1138;3952;4117;14022;5255;17974
270560;201311;2959;9562;2843;9392;596;2248;1866;6029;2462;8277
270570;201311;4277;14219;3932;13656;496;2086;2686;9285;3182;11371
270580;201311;1969;6733;1890;6591;338;1269;1319;4651;1657;5920
270590;201311;1346;4716;1267;4574;105;486;1055;3764;1160;4250
270600;201311;2816;9666;2574;9308;230;1145;1999;7023;2229;8168
270610;201311;3218;10356;3012;10048;347;1250;2337;7784;2684;9034
270620;201311;1450;4971;1315;4768;151;707;990;3493;1141;4200
270630;201311;18123;51183;17241;49875;2499;7251;12878;37831;15377;45082
270640;201311;5820;18388;5319;17783;452;1911;4356;14297;4808;16208
270642;201311;2467;8575;2319;8343;415;1681;1525;5495;1940;7176
270644;201311;2223;6820;2073;6652;271;803;1675;5510;1946;6313
270650;201311;3912;12789;3774;12587;887;3465;2182;7113;3069;10578
270660;201311;2547;6688;2070;5950;174;623;1441;4069;1615;4692
270670;201311;14865;42205;13234;40160;1815;5956;9710;29976;11525;35932
270680;201311;4155;12926;4032;12779;246;724;3611;11577;3857;12301
270690;201311;8655;25188;8071;24437;2572;7620;3892;12803;6464;20423
270700;201311;800;2550;761;2488;133;538;473;1490;606;2028
270710;201311;5406;18667;5197;18384;599;2141;4150;14891;4749;17032
270720;201311;3305;11575;3066;11153;283;1318;2449;8784;2732;10102
270730;201311;6546;20787;6244;20389;1226;4163;4329;14290;5555;18453
270740;201311;2380;7187;2237;6956;372;1311;1467;4515;1839;5826
270750;201311;4696;15518;4414;15085;584;2123;3330;11463;3914;13586
270760;201311;3396;10547;3138;10142;424;1455;2303;7497;2727;8952
270770;201311;17592;48627;15185;45665;2922;9417;9679;29620;12601;39037
270780;201311;1937;6337;1807;6131;272;989;1263;4338;1535;5327
270790;201311;1620;5217;1484;4988;412;1501;690;2339;1102;3840
270800;201311;11153;34335;10546;33532;1000;3537;8570;27261;9570;30798
270810;201311;3354;10588;2797;9554;415;1654;1727;5873;2142;7527
270820;201311;1886;6495;1740;6235;269;1114;1187;4207;1456;5321
270830;201311;5141;16532;4749;16025;1251;4770;2750;9197;4001;13967
270840;201311;7328;25843;6769;25105;513;2466;5617;20576;6130;23042
270850;201311;7586;25415;7431;25222;1529;6423;5072;16284;6601;22707
270860;201311;11320;35050;10710;34175;1764;6630;7684;23915;9448;30545
270870;201311;2248;6686;1825;5793;276;960;1136;3606;1412;4566
270880;201311;7703;25539;7346;25008;524;2233;6191;20811;6715;23044
270890;201311;2603;8141;2432;7860;397;1546;1677;5264;2074;6810
270895;201311;3021;11358;2878;11166;285;1106;2371;9394;2656;10500
270900;201311;1903;5301;1572;4819;110;429;1217;3633;1327;4062
270910;201311;3260;11698;3208;11597;350;1583;2591;9102;2941;10685
270915;201311;9868;34382;9037;32849;2000;8216;5015;18130;7015;26346
270920;201311;6131;19980;5751;19417;352;1602;4944;16521;5296;18123
270930;201311;16877;47017;14135;43540;3102;10171;8030;25371;11132;35542
270940;201311;5725;19862;5550;19638;886;3348;4038;14418;4924;17766
280010;201311;719;2146;634;2010;69;273;411;1285;480;1558
280020;201311;4900;15043;4391;14108;925;3145;2673;8598;3598;11743
280030;201311;71098;193136;64266;182875;16324;49202;33931;97711;50255;146913
280040;201311;3149;10070;2865;9684;374;1277;2126;7440;2500;8717
280050;201311;4096;13347;3827;12944;1090;3720;2081;7380;3171;11100
280060;201311;4171;14355;4032;14113;984;3774;2362;8294;3346;12068
280067;201311;7505;21748;6412;20242;704;2476;4804;15124;5508;17600
280070;201311;1806;6455;1738;6356;349;1349;1164;4320;1513;5669
280100;201311;3991;12863;3624;12201;961;3360;1847;6368;2808;9728
280110;201311;1362;4257;1259;4087;106;437;999;3190;1105;3627
280120;201311;7743;24925;7230;24088;1286;4041;4885;17208;6171;21249
280130;201311;7754;22870;7318;22215;1297;4524;4854;14467;6151;18991
280140;201311;5450;15404;4962;14754;575;1737;3869;11664;4444;13401
280150;201311;3297;10528;3043;10031;494;1960;1922;6063;2416;8023
280160;201311;1536;4453;1398;4227;176;606;998;3012;1174;3618
280170;201311;4530;14080;4176;13637;520;1715;3200;10785;3720;12500
280190;201311;1087;3242;993;3091;113;446;695;2083;808;2529
280200;201311;1096;3484;1035;3382;166;684;740;2326;906;3010
280210;201311;12258;40004;11738;39207;2563;8977;7415;25349;9978;34326
280220;201311;1541;4829;1486;4757;99;385;1295;4130;1394;4515
280230;201311;3845;11411;3466;10781;733;2420;2026;6470;2759;8890
280240;201311;3373;10401;3118;10000;257;787;2492;8142;2749;8929
280250;201311;777;2127;692;1993;118;391;418;1135;536;1526
280260;201311;1986;5433;1822;5223;126;378;1553;4467;1679;4845
280270;201311;2182;7007;1914;6539;140;573;1507;5081;1647;5654
280280;201311;4021;13593;3760;13151;949;2941;2029;7961;2978;10902
280290;201311;16346;54004;15199;51988;2843;10482;10276;35448;13119;45930
280300;201311;9978;30706;9333;29975;849;2873;7781;25260;8630;28133
280310;201311;1430;4123;1272;3875;109;422;919;2717;1028;3139
280320;201311;7417;25627;6990;24847;1379;5578;3914;13878;5293;19456
280330;201311;4504;13136;4261;12821;535;1777;3290;9914;3825;11691
280340;201311;3710;11580;3577;11399;333;1087;2897;9513;3230;10600
280350;201311;20983;63659;19847;61907;3129;10126;13986;44529;17115;54655
280360;201311;5764;18690;5462;18220;1228;4608;3295;10866;4523;15474
280370;201311;1919;5582;1762;5320;214;769;1278;3753;1492;4522
280380;201311;945;3049;885;2958;114;459;671;2185;785;2644
280390;201311;3217;9681;2874;9062;762;2226;1650;5402;2412;7628
280400;201311;4404;12868;4045;12384;830;2456;2618;8372;3448;10828
280410;201311;2335;7816;2142;7475;362;1454;1307;4468;1669;5922
280420;201311;4095;12108;3843;11728;262;834;3317;10213;3579;11047
280430;201311;2128;5888;2010;5738;199;666;1618;4592;1817;5258
280440;201311;5044;15137;4721;14728;462;1514;3897;12258;4359;13772
280445;201311;2424;7084;2258;6796;123;500;1852;5446;1975;5946
280450;201311;8802;24384;8182;23648;769;1893;6854;20531;7623;22424
280460;201311;6743;18912;6098;18023;1125;3511;4114;12348;5239;15859
280470;201311;1765;5469;1628;5259;185;665;1230;3954;1415;4619
280480;201311;30410;93957;29387;92431;5237;19240;19724;60449;24961;79689
280490;201311;3687;11561;3432;11075;435;1605;2535;8146;2970;9751
280500;201311;874;2372;829;2316;33;108;735;2030;768;2138
280510;201311;2716;8094;2349;7586;310;1156;1742;5647;2052;6803
280520;201311;1701;4953;1576;4790;206;608;1193;3757;1399;4365
280530;201311;2040;6457;1940;6322;261;904;1480;4913;1741;5817
280540;201311;8699;24677;8248;24067;353;1242;7376;21410;7729;22652
280550;201311;7023;19428;6327;18303;595;2087;4739;13539;5334;15626
280560;201311;7817;23453;7408;22774;532;1883;6092;18634;6624;20517
280570;201311;6516;18725;6027;18091;925;3227;4181;12350;5106;15577
280580;201311;5618;17365;4899;16169;776;2677;3327;11190;4103;13867
280590;201311;2342;7263;2169;7059;295;1140;1619;5259;1914;6399
280600;201311;3985;12454;3749;12031;401;1592;2720;8530;3121;10122
280610;201311;2311;6880;2190;6691;358;1211;1413;4312;1771;5523
280620;201311;4932;15495;4480;14612;821;2862;2852;9386;3673;12248
280630;201311;3773;12655;3648;12467;374;1150;2942;10452;3316;11602
280640;201311;2218;6384;2073;6211;140;351;1824;5576;1964;5927
280650;201311;1094;3493;1014;3340;182;662;652;2161;834;2823
280660;201311;2603;7757;2505;7591;292;969;2047;6142;2339;7111
280670;201311;15609;42056;14902;41149;1675;4937;11617;32122;13292;37059
280680;201311;2728;7414;2407;7003;183;587;2025;5885;2208;6472
280690;201311;957;2831;848;2666;124;455;559;1687;683;2142
280700;201311;1152;3434;1015;3229;88;292;747;2413;835;2705
280710;201311;10201;29068;9661;28407;592;1861;8339;24580;8931;26441
280720;201311;2469;6803;2217;6485;204;640;1733;5146;1937;5786
280730;201311;932;2837;898;2789;81;271;754;2358;835;2629
280740;201311;12545;35183;11008;32868;1747;5176;7564;23255;9311;28431
280750;201311;3513;11179;3276;10750;305;1294;2390;7692;2695;8986
280760;201311;5704;17912;5263;17332;729;2379;3903;13373;4632;15752
290010;201311;2973;6764;2176;5511;86;356;1744;4173;1830;4529
290020;201311;4960;15779;4525;15329;398;1211;3923;13589;4321;14800
290030;201311;3164;10382;3079;10224;499;1780;2228;7362;2727;9142
290035;201311;4509;12602;4081;12036;278;916;3453;10250;3731;11166
290040;201311;3710;11041;3451;10711;292;1122;2839;8680;3131;9802
290050;201311;2724;9025;2555;8764;265;1023;1968;6783;2233;7806
290060;201311;1297;3394;1088;3138;221;731;752;2094;973;2825
290070;201311;30437;81401;26546;76514;5902;17694;14507;43904;20409;61598
290080;201311;5837;18183;5207;17379;663;2287;3903;13363;4566;15650
290090;201311;2277;5130;1829;4654;254;676;1453;3732;1707;4408
290100;201311;10129;29585;8883;27462;1851;5791;5046;16300;6897;22091
290110;201311;5230;16158;5060;15864;921;3121;3392;10578;4313;13699
290115;201311;4771;14653;4255;13958;324;1167;3272;10912;3596;12079
290120;201311;6688;18728;6263;18204;450;1320;5398;15824;5848;17144
290130;201311;4516;12032;3979;11394;349;997;3330;9653;3679;10650
290135;201311;5077;13383;4438;12326;500;1665;2961;8113;3461;9778
290140;201311;3771;12557;3372;12051;388;1506;2690;9647;3078;11153
290150;201311;2097;6308;2026;6194;197;654;1694;5162;1891;5816
290160;201311;3422;9730;3342;9633;365;731;2852;8586;3217;9317
290170;201311;2822;9561;2602;9206;250;1032;2090;7387;2340;8419
290180;201311;2984;8633;2652;8153;299;1049;1928;5916;2227;6965
290190;201311;4159;13908;4021;13662;452;1630;3078;10556;3530;12186
290195;201311;2194;6223;1901;5786;153;523;1523;4667;1676;5190
290200;201311;3801;12457;3494;11909;433;1573;2580;8830;3013;10403
290205;201311;2829;9205;2648;8926;420;1694;1860;6112;2280;7806
290210;201311;15732;43862;14869;42855;2448;5751;10788;33951;13236;39702
290220;201311;2372;7342;2274;7188;331;1249;1605;4910;1936;6159
290225;201311;3021;8302;2855;8122;228;500;2482;7317;2710;7817
290230;201311;2350;7931;2310;7872;226;813;1918;6614;2144;7427
290240;201311;3847;10389;3479;9886;416;1308;2540;7154;2956;8462
290250;201311;3744;12149;3184;11252;306;1165;2422;8666;2728;9831
290260;201311;4630;14631;4345;14182;478;1664;3401;11119;3879;12783
290265;201311;3324;10980;3155;10677;321;1287;2411;8113;2732;9400
290270;201311;11894;44552;11246;43584;1495;6147;8508;33551;10003;39698
290280;201311;5020;17097;4785;16632;706;2601;3288;11690;3994;14291
290290;201311;9488;31166;8757;29966;1676;6039;5718;19934;7394;25973
290300;201311;4367;12589;3407;10885;337;1165;2420;7896;2757;9061
290310;201311;1516;4684;1436;4575;235;867;1022;3184;1257;4051
290320;201311;25631;81374;23223;78107;5115;18375;14070;47973;19185;66348
290323;201311;4015;11061;3328;10337;214;788;2849;8825;3063;9613
290327;201311;3944;12942;3685;12417;522;1877;2567;8662;3089;10539
290330;201311;1865;5086;1790;5002;273;857;1401;3855;1674;4712
290340;201311;5198;16712;4818;16183;1248;4326;2703;9314;3951;13640
290350;201311;4839;15071;3998;13909;545;1937;2845;10185;3390;12122
290360;201311;4101;13248;3743;12761;231;845;3262;11262;3493;12107
290370;201311;4518;13797;4187;13320;552;1773;3308;10671;3860;12444
290380;201311;5572;16518;4985;15698;362;1316;4109;12903;4471;14219
290390;201311;14819;49126;14194;48046;3016;9972;8919;31767;11935;41739
290395;201311;2755;9090;2501;8658;258;1110;1872;6465;2130;7575
290400;201311;3549;11299;3199;10797;541;1831;2240;7715;2781;9546
290405;201311;4359;14227;3818;13273;528;1930;2529;9042;3057;10972
290410;201311;5937;18157;5092;16916;585;2458;3741;12077;4326;14535
290420;201311;3278;9836;2738;9060;259;1024;2140;7012;2399;8036
290430;201311;3413;11052;3095;10582;700;2421;1893;6710;2593;9131
290440;201311;2950;7997;2480;7404;199;692;2005;6038;2204;6730
290450;201311;3509;10502;3183;10029;653;1978;2031;6673;2684;8651
290460;201311;12952;41173;12235;39939;3591;12458;5768;18712;9359;31170
290470;201311;4673;13494;3752;12285;876;3246;1991;6627;2867;9873
290475;201311;5036;17994;4584;17169;521;2098;3394;12890;3915;14988
290480;201311;2627;6914;2329;6522;342;1053;1613;4553;1955;5606
290485;201311;4542;15192;4236;14746;475;2141;3272;11236;3747;13377
290490;201311;7735;21586;7491;21248;915;2839;5958;16868;6873;19707
290500;201311;4589;14898;3976;13783;777;2902;2074;7187;2851;10089
290510;201311;3396;10125;2978;9517;256;981;2355;7525;2611;8506
290515;201311;2784;8910;2656;8686;172;543;2170;7273;2342;7816
290520;201311;11550;36308;9494;32447;1180;4678;6058;20694;7238;25372
290530;201311;5228;15344;4500;14283;404;1370;3635;11586;4039;12956
290540;201311;3933;11451;3748;11208;498;1443;2841;8726;3339;10169
290550;201311;4341;11739;3850;11132;189;563;3402;9876;3591;10439
290560;201311;6026;18184;5385;17261;1147;3875;3279;10649;4426;14524
290570;201311;39782;117947;37386;114268;5179;16895;27385;83367;32564;100262
290580;201311;7256;26159;6984;25736;1244;4570;4993;18987;6237;23557
290590;201311;7403;24150;6293;22312;467;1953;5049;17860;5516;19813
290600;201311;17935;56562;16961;55046;2612;8579;11705;39136;14317;47715
290610;201311;2317;8255;1972;7567;200;949;1447;5466;1647;6415
290620;201311;7226;21785;6514;20761;551;1912;5422;17305;5973;19217
290630;201311;8162;22663;7237;21673;885;2630;5737;17428;6622;20058
290640;201311;2698;8082;2261;7316;256;902;1601;5194;1857;6096
290650;201311;11529;34986;10844;33930;3320;10449;5699;18632;9019;29081
290660;201311;3671;10454;3054;9568;212;773;2450;7701;2662;8474
290670;201311;6416;20668;5915;19888;910;2921;4399;15421;5309;18342
290680;201311;10223;30741;9547;29929;571;1907;8213;25967;8784;27874
290682;201311;4283;13101;3898;12550;221;882;3241;10360;3462;11242
290685;201311;3198;8453;2448;7393;319;1054;1521;4692;1840;5746
290687;201311;8237;22530;6628;20604;1154;3885;4230;13368;5384;17253
290689;201311;3092;8991;2614;8221;276;919;1994;6327;2270;7246
290690;201311;5361;16096;4948;15532;647;2179;3776;11918;4423;14097
290700;201311;2220;7121;2134;6996;237;837;1640;5421;1877;6258
290710;201311;7625;25166;7132;24367;408;1401;6249;21576;6657;22977
290720;201311;18040;54578;16263;52358;2349;7048;12489;41644;14838;48692
290730;201311;7361;20804;6745;20015;1409;4062;4312;13268;5721;17330
290740;201311;996;3034;861;2807;162;532;502;1695;664;2227
290750;201311;9989;29252;8684;26909;1646;5993;4859;14219;6505;20212
290755;201311;2411;6962;2040;6333;137;526;1645;5056;1782;5582
290760;201311;4441;13354;3699;12299;400;1319;2747;9269;3147;10588
290770;201311;2531;8985;2369;8764;165;710;1942;7227;2107;7937
290780;201311;8639;23357;7740;22109;978;2532;5821;17218;6799;19750
290790;201311;4598;14106;4310;13691;502;1542;3316;10928;3818;12470
290800;201311;7217;16222;5551;14441;1105;2699;3891;10574;4996;13273
290810;201311;4859;15839;4280;14945;333;1247;3287;11660;3620;12907
290820;201311;5301;15690;4770;14934;590;2100;3492;10909;4082;13009
290830;201311;4114;12326;3920;11994;397;1631;3008;8872;3405;10503
290840;201311;17297;49861;16049;48159;2496;7213;11390;35678;13886;42891
290850;201311;6657;20299;6510;20081;1437;4407;4415;14028;5852;18435
290860;201311;4748;17367;4538;17079;741;2819;3265;12667;4006;15486
290870;201311;4727;14436;3991;13430;479;1937;2914;9670;3393;11607
290880;201311;1385;3925;1133;3522;120;377;759;2406;879;2783
290890;201311;6184;17789;5934;17455;707;2141;4670;13831;5377;15972
290900;201311;2413;7151;1835;6199;291;1120;948;3152;1239;4272
290910;201311;4744;13518;4115;12606;319;1070;3370;10339;3689;11409
290920;201311;4781;14428;4359;13856;364;1019;3563;11583;3927;12602
290930;201311;7339;24088;6729;23011;850;3260;4770;16128;5620;19388
290940;201311;3437;11248;3247;11004;277;1004;2738;9422;3015;10426
290950;201311;1532;4412;1428;4269;212;684;1024;3053;1236;3737
290960;201311;5842;17225;5363;16589;403;1294;4365;13693;4768;14987
290970;201311;3694;12261;3430;11810;505;1798;2279;8044;2784;9842
290980;201311;10403;31857;9308;29682;2741;9151;3815;12167;6556;21318
290990;201311;9110;27814;8275;26457;927;3129;6380;20509;7307;23638
291000;201311;2942;9312;2756;9068;414;1402;2050;6906;2464;8308
291005;201311;12830;37451;11753;35811;2174;7120;7751;23899;9925;31019
291010;201311;2984;10070;2541;9079;433;1684;1455;5209;1888;6893
291020;201311;1363;3722;1054;3152;131;479;622;1801;753;2280
291030;201311;2068;6031;1711;5254;184;628;1121;3397;1305;4025
291040;201311;5367;17370;4998;16820;732;2633;3607;12217;4339;14850
291050;201311;7896;26797;7283;25636;1929;7274;3811;13463;5740;20737
291060;201311;6166;23193;5898;22867;793;3531;4505;17404;5298;20935
291070;201311;15995;48120;14790;46360;1886;5577;11143;36092;13029;41669
291072;201311;19722;63501;17397;58877;6280;22658;5819;20612;12099;43270
291075;201311;5123;15317;4671;14697;330;1054;3633;11741;3963;12795
291077;201311;1529;4560;1305;4207;146;569;896;2836;1042;3405
291080;201311;80473;250674;73056;237586;20739;70961;31572;102166;52311;173127
291085;201311;5595;15340;4887;14376;616;1910;3752;11073;4368;12983
291090;201311;1344;3614;1177;3379;149;564;880;2416;1029;2980
291100;201311;2666;7231;2246;6784;130;527;1922;5753;2052;6280
291110;201311;4956;18071;4501;17342;741;3137;3065;11775;3806;14912
291120;201311;7503;20446;7094;19869;1003;2955;5291;14872;6294;17827
291125;201311;1634;3738;1340;3424;134;334;1037;2766;1171;3100
291130;201311;2989;9268;2624;8660;256;1012;1897;6208;2153;7220
291140;201311;4080;12490;3827;12033;557;1837;2666;8454;3223;10291
291150;201311;2000;5280;1919;5182;180;522;1510;4045;1690;4567
291160;201311;5497;17043;4879;16127;1136;3916;2933;9745;4069;13661
291165;201311;2379;7230;1983;6490;151;645;1431;4570;1582;5215
291170;201311;20427;53605;17781;50352;1390;4736;14203;39907;15593;44643
291180;201311;6406;17220;5322;15746;617;2006;3957;11661;4574;13667
291185;201311;3777;10649;3608;10433;263;895;3043;8698;3306;9593
291190;201311;7462;21373;6762;20533;917;2734;5033;15865;5950;18599
291200;201311;3063;9426;2629;8684;341;1316;1826;5994;2167;7310
291210;201311;7385;17850;6522;16890;573;1581;5196;13550;5769;15131
291220;201311;4118;13355;3921;13008;612;2297;2766;9037;3378;11334
291230;201311;3887;10383;3486;9895;187;519;3079;8832;3266;9351
291240;201311;4743;13273;4042;12035;315;982;3147;9305;3462;10287
291250;201311;3727;11385;2976;10136;314;1114;2125;7339;2439;8453
291260;201311;1158;3509;1096;3416;105;359;865;2677;970;3036
291270;201311;4385;15136;4183;14772;315;1247;3403;12085;3718;13332
291280;201311;2336;6039;1784;5397;512;1516;1030;3235;1542;4751
291290;201311;5925;16987;5391;16333;944;2938;3493;10895;4437;13833
291300;201311;4435;13405;3694;12151;497;1809;2474;8126;2971;9935
291310;201311;5293;15542;4696;14553;453;1512;3577;11081;4030;12593
291320;201311;5732;19155;5058;17824;1502;5810;2334;8062;3836;13872
291330;201311;1567;4953;1475;4791;218;832;935;2898;1153;3730
291340;201311;3803;11564;3072;10515;377;1506;2316;7816;2693;9322
291345;201311;3422;11451;3274;11293;253;886;2856;10001;3109;10887
291350;201311;6059;18311;5441;17361;658;2214;3671;12012;4329;14226
291360;201311;35943;106123;33717;102865;8156;24865;21240;67026;29396;91891
291370;201311;9011;26944;8645;26466;1144;3384;6540;20651;7684;24035
291380;201311;3802;11897;3374;11185;334;1138;2417;8257;2751;9395
291390;201311;10448;29624;9598;28623;1356;4004;7293;22105;8649;26109
291400;201311;16759;44718;13667;40534;2200;6755;8870;27253;11070;34008
291410;201311;3247;8551;2399;7306;200;826;1778;5233;1978;6059
291420;201311;2246;6002;2023;5736;95;234;1856;5334;1951;5568
291430;201311;3334;10016;2967;9528;265;1047;2315;7350;2580;8397
291440;201311;5905;19187;5071;17631;587;2168;3821;13479;4408;15647
291450;201311;7266;23028;6830;22280;437;1405;5637;18797;6074;20202
291460;201311;12698;39740;11458;37934;2476;8662;7034;23594;9510;32256
291465;201311;7960;23606;7292;22832;917;3159;5612;17604;6529;20763
291470;201311;15433;43816;13852;41861;1296;4017;10801;33582;12097;37599
291480;201311;34764;96063;31138;90969;5644;18317;19885;57639;25529;75956
291490;201311;4193;14502;4115;14390;551;1923;3263;11630;3814;13553
291500;201311;4127;12249;3622;11548;283;994;2924;9355;3207;10349
291510;201311;3493;10981;3298;10708;148;519;2992;9776;3140;10295
291520;201311;4026;11321;3613;10757;628;1780;2410;7639;3038;9419
291530;201311;2074;6275;1781;5813;505;1766;871;2929;1376;4695
291535;201311;4295;12785;3891;12183;355;1174;2935;9529;3290;10703
291540;201311;2199;5458;1906;5151;186;458;1571;4371;1757;4829
291550;201311;5580;15433;5032;14666;1280;3825;2719;8078;3999;11903
291560;201311;16662;44180;13315;40348;1670;5235;9927;30786;11597;36021
291570;201311;2351;6458;2253;6335;165;432;1975;5646;2140;6078
291580;201311;5858;18252;5224;17260;807;3195;3423;11178;4230;14373
291590;201311;1995;6321;1782;5965;334;1246;1110;3815;1444;5061
291600;201311;5494;15556;4112;13590;1029;3734;1997;6491;3026;10225
291610;201311;5194;15247;5034;15019;464;1590;4145;12249;4609;13839
291620;201311;3030;7312;2527;6772;184;466;2029;5630;2213;6096
291630;201311;3227;8212;2857;7796;285;722;2397;6715;2682;7437
291640;201311;17303;48443;14582;44913;3880;13056;6343;19657;10223;32713
291650;201311;7968;24289;7398;23623;639;1671;6249;20733;6888;22404
291660;201311;2386;6434;2136;6092;269;903;1486;4125;1755;5028
291670;201311;2492;7103;2301;6788;363;1132;1315;4159;1678;5291
291680;201311;4988;14420;4513;13661;1171;4019;2091;6537;3262;10556
291685;201311;4292;11282;3829;10724;387;1083;2975;8644;3362;9727
291690;201311;3960;11062;3285;10000;347;1079;2282;7022;2629;8101
291700;201311;9307;29777;8666;28710;1042;3545;6430;21745;7472;25290
291710;201311;5892;16032;5159;15056;1154;3621;2858;8696;4012;12317
291720;201311;3762;13402;3468;12788;387;1660;2585;9389;2972;11049
291730;201311;5751;18944;5404;18486;1311;4586;3356;11869;4667;16455
291733;201311;2578;7775;2217;7300;289;1014;1513;5042;1802;6056
291735;201311;2310;6836;2022;6402;127;496;1678;5264;1805;5760
291740;201311;3971;11732;3162;10479;332;1289;2234;7369;2566;8658
291750;201311;21648;58190;17376;51818;3894;12064;9543;28977;13437;41041
291760;201311;12059;39198;11242;37705;3922;14309;4976;16907;8898;31216
291770;201311;7995;23445;7326;22315;1246;4112;4825;14556;6071;18668
291780;201311;4248;13422;4058;13066;585;1840;3018;9859;3603;11699
291790;201311;2413;7821;2289;7651;171;697;1915;6352;2086;7049
291800;201311;31083;92685;28269;88595;6326;20702;16896;54309;23222;75011
291810;201311;10524;30993;9179;29403;674;2433;7461;24178;8135;26611
291820;201311;3572;10997;3275;10572;371;1216;2477;8114;2848;9330
291830;201311;4376;12042;4098;11626;581;1813;3049;8632;3630;10445
291835;201311;6084;19366;5108;17757;1167;4351;3147;10955;4314;15306
291840;201311;47040;133365;40923;126821;5258;16309;32004;101380;37262;117689
291845;201311;2984;8834;2700;8524;250;765;2323;7439;2573;8204
291850;201311;4830;13783;4092;12757;454;1375;3152;10104;3606;11479
291855;201311;1622;4463;1399;4172;234;792;981;2879;1215;3671
291860;201311;1962;6017;1733;5576;178;645;1156;3700;1334;4345
291870;201311;1329;3700;1064;3228;113;426;707;2099;820;2525
291875;201311;2811;9211;2554;8783;268;1085;1762;5956;2030;7041
291880;201311;4514;14587;4353;14338;324;1061;3726;12443;4050;13504
291890;201311;1406;3589;1186;3316;170;500;829;2337;999;2837
291900;201311;1278;3737;1138;3530;119;422;866;2649;985;3071
291905;201311;2925;7893;2467;7163;231;783;1755;5145;1986;5928
291910;201311;2542;7111;2266;6756;176;655;1846;5415;2022;6070
291915;201311;6613;20970;5965;19673;538;1854;4897;16410;5435;18264
291920;201311;32355;95948;29977;92410;6218;19637;18327;58213;24545;77850
291930;201311;2543;7650;2321;7333;254;890;1769;5617;2023;6507
291940;201311;3558;10314;2710;8800;421;1557;1582;4965;2003;6522
291950;201311;9115;31381;8303;30037;2172;7997;4349;16193;6521;24190
291955;201311;7551;25162;7390;24914;1600;5491;4796;16554;6396;22045
291960;201311;3329;10127;2886;9522;362;1134;2049;7146;2411;8280
291970;201311;4408;13314;3936;12714;593;1982;2770;9133;3363;11115
291980;201311;11361;33244;8727;29414;1153;4059;6104;21061;7257;25120
291990;201311;2134;7054;1979;6822;212;759;1462;5181;1674;5940
291992;201311;2800;8751;2736;8614;505;1670;1950;6105;2455;7775
291995;201311;2104;6304;1905;6032;239;782;1430;4617;1669;5399
292000;201311;2318;7008;2104;6686;489;1719;1256;3924;1745;5643
292010;201311;6194;16298;4810;14203;479;1490;3676;10877;4155;12367
292020;201311;4443;15398;4096;14818;583;2283;2983;10941;3566;13224
292030;201311;2157;6908;1945;6604;250;935;1277;4380;1527;5315
292040;201311;4590;13009;4102;12488;359;1049;3430;10818;3789;11867
292045;201311;2428;8684;2398;8631;100;338;2231;8080;2331;8418
292050;201311;6258;19928;5585;18588;575;2365;3882;12730;4457;15095
292060;201311;10738;30809;10343;30265;1009;3084;8518;24948;9527;28032
292070;201311;4332;14058;4229;13929;388;1149;3692;12390;4080;13539
292080;201311;3659;9822;3173;9169;292;894;2563;7453;2855;8347
292090;201311;4224;11509;3655;10859;349;1194;2952;8779;3301;9973
292100;201311;10981;30952;9537;29137;2689;8536;5187;16435;7876;24971
292105;201311;3145;9741;2746;9180;213;855;2195;7301;2408;8156
292110;201311;7043;18839;5425;16480;1221;3907;3087;9637;4308;13544
292120;201311;8369;24290;7372;22643;1525;4828;4280;13533;5805;18361
292130;201311;3215;8670;2901;8228;601;1594;1905;5608;2506;7202
292140;201311;5456;14454;4755;13526;556;1608;3400;9972;3956;11580
292145;201311;2681;8320;2449;7958;211;677;1840;6264;2051;6941
292150;201311;13421;41594;12527;40145;936;3471;9876;31888;10812;35359
292160;201311;2702;7897;2324;7381;190;577;1911;6235;2101;6812
292170;201311;8638;26397;7428;24267;1140;4117;4699;15544;5839;19661
292180;201311;3470;10287;2866;9346;412;1407;1900;6304;2312;7711
292190;201311;3180;9154;2801;8613;561;1863;1814;5602;2375;7465
292200;201311;5575;19309;5050;18156;1611;6234;1923;6937;3534;13171
292205;201311;3984;12529;3665;12099;280;1077;2938;9688;3218;10765
292210;201311;6544;19263;5776;18209;540;1807;4556;14688;5096;16495
292220;201311;1905;5505;1809;5365;426;1211;1085;3276;1511;4487
292225;201311;2909;9414;2691;9073;209;747;2184;7465;2393;8212
292230;201311;6211;18901;5940;18475;707;2623;4499;13667;5206;16290
292240;201311;4377;14128;4065;13413;662;2376;2488;8103;3150;10479
292250;201311;5163;16157;4875;15610;1067;3578;2613;8440;3680;12018
292260;201311;3050;9681;2901;9448;347;1201;2242;7289;2589;8490
292265;201311;3082;10242;2819;9758;248;1037;2090;7178;2338;8215
292270;201311;3853;10820;3142;9983;284;1117;2507;7957;2791;9074
292273;201311;2769;6835;2137;6030;307;855;1516;4462;1823;5317
292275;201311;1886;4988;1771;4825;220;684;1341;3623;1561;4307
292280;201311;2049;6246;1879;6060;192;515;1464;5034;1656;5549
292285;201311;2570;7382;2289;6983;248;870;1732;5356;1980;6226
292290;201311;7316;22393;6194;20928;448;1698;4943;16975;5391;18673
292300;201311;8355;26198;7381;25125;2330;8033;4077;14428;6407;22461
292303;201311;2759;8920;2582;8667;113;445;2245;7541;2358;7986
292305;201311;3138;8659;2980;8447;105;326;2691;7643;2796;7969
292310;201311;5826;18150;5353;17501;320;1128;4564;15024;4884;16152
292320;201311;5835;18281;5327;17393;606;2336;4032;13033;4638;15369
292330;201311;1992;5786;1879;5642;247;833;1424;4217;1671;5050
292335;201311;5255;13991;4800;13389;405;1165;4045;11346;4450;12511
292340;201311;6488;19119;5660;17848;550;1871;4214;13312;4764;15183
292350;201311;2042;6505;1922;6361;217;826;1523;5022;1740;5848
292360;201311;4861;14465;4682;13927;190;580;4098;12468;4288;13048
292370;201311;8453;26418;7712;25305;1115;3534;5367;18535;6482;22069
292380;201311;7310;21544;6884;20884;595;1677;5653;17408;6248;19085
292390;201311;3689;8495;3287;8061;109;209;3081;7643;3190;7852
292400;201311;21937;65751;20987;64219;3184;10367;14731;45937;17915;56304
292405;201311;4338;11865;3801;11214;277;838;3190;9521;3467;10359
292410;201311;1865;5123;1783;5028;153;455;1547;4354;1700;4809
292420;201311;3723;12156;3590;12004;175;497;3265;11160;3440;11657
292430;201311;5384;16945;4543;15832;310;1267;3608;12548;3918;13815
292440;201311;8523;28213;7981;27428;312;1211;7026;24447;7338;25658
292450;201311;4357;13175;3582;11933;348;1278;2591;8758;2939;10036
292460;201311;5577;17073;4958;15945;963;3195;3086;10078;4049;13273
292465;201311;2332;7250;2026;6752;243;944;1455;4858;1698;5802
292467;201311;2169;7196;2057;6999;434;1595;1306;4490;1740;6085
292470;201311;3186;8669;2671;7855;234;828;1998;5785;2232;6613
292480;201311;5829;16570;5041;15441;384;1343;4124;12691;4508;14034
292490;201311;2300;6565;1961;6052;210;782;1460;4430;1670;5212
292500;201311;6569;20073;5745;18661;583;2222;4224;13771;4807;15993
292510;201311;13085;38207;11678;36205;1232;4155;9029;28414;10261;32569
292520;201311;5635;17713;5275;17071;1590;5258;2590;8507;4180;13765
292525;201311;5463;14567;4807;13792;429;1313;3859;11198;4288;12511
292530;201311;24820;75734;22915;73450;4995;16601;14336;47413;19331;64014
292540;201311;2789;8380;2535;8000;468;1692;1723;5362;2191;7054
292550;201311;6288;20975;5678;20032;963;3556;3855;13929;4818;17485
292560;201311;4209;11741;3622;10976;317;1165;2939;8756;3256;9921
292570;201311;3999;11941;3854;11786;131;414;3384;10679;3515;11093
292575;201311;5922;20572;5765;20271;1126;4108;3940;13869;5066;17977
292580;201311;7147;21379;6661;20768;591;1877;5505;17366;6096;19243
292590;201311;7151;23169;6857;22683;1031;3404;4900;16507;5931;19911
292593;201311;3246;8660;2769;7954;251;749;2129;6102;2380;6851
292595;201311;5804;16651;5149;15788;507;1688;3916;12076;4423;13764
292600;201311;10509;30093;9938;29381;1301;3076;7967;24683;9268;27759
292610;201311;4309;12665;3595;11453;521;1746;2312;7517;2833;9263
292620;201311;5804;18173;5139;17393;341;1299;4566;15482;4907;16781
292630;201311;9835;25227;8615;23435;802;2294;6589;18181;7391;20475
292640;201311;8211;26886;7257;25610;664;2457;5661;20405;6325;22862
292650;201311;4747;13374;4570;13166;508;1109;3677;11334;4185;12443
292660;201311;10971;34074;10511;33384;1513;4889;7762;25223;9275;30112
292665;201311;2857;8543;2782;8428;97;268;2608;7970;2705;8238
292670;201311;3817;11045;3010;9676;363;1313;1957;6324;2320;7637
292680;201311;3578;10967;3396;10715;296;977;2822;8902;3118;9879
292690;201311;3334;9248;2450;7889;314;1130;1632;5342;1946;6472
292700;201311;9016;28089;7966;26588;1194;3754;5652;19833;6846;23587
292710;201311;1900;6359;1813;6229;99;378;1601;5517;1700;5895
292720;201311;9430;24769;8379;23568;784;2320;6954;19714;7738;22034
292730;201311;3336;10417;3228;10232;571;1741;2182;7165;2753;8906
292740;201311;347102;997722;330818;973379;80833;251867;196323;578803;277156;830670
292750;201311;5815;16285;5306;15621;405;1205;4316;12928;4721;14133
292760;201311;4207;13719;3886;13128;568;2107;2559;8736;3127;10843
292770;201311;5939;18637;5621;18132;1384;4524;3315;11082;4699;15606
292780;201311;1828;4632;1460;4186;210;718;1041;2933;1251;3651
292790;201311;3298;9029;3156;8873;277;653;2608;7694;2885;8347
292800;201311;9371;28763;8806;27840;954;3269;6807;21553;7761;24822
292805;201311;3117;9388;2877;9031;596;2037;1852;5872;2448;7909
292810;201311;9855;30508;8430;28624;1245;4404;6167;21467;7412;25871
292820;201311;7292;21406;5418;18755;447;1723;4377;15261;4824;16984
292830;201311;1867;5633;1694;5391;122;485;1377;4350;1499;4835
292840;201311;7127;23885;6660;23228;479;1840;5681;19859;6160;21699
292850;201311;3162;8527;2674;7791;351;1086;1873;5413;2224;6499
292860;201311;15167;41943;14595;41230;2024;5730;11237;32187;13261;37917
292870;201311;18627;53059;16653;49874;3381;11127;9587;28248;12968;39375
292880;201311;11562;35289;10525;33615;1977;6498;6587;21270;8564;27768
292890;201311;5458;19201;4937;18184;1022;3941;2800;10590;3822;14531
292895;201311;2694;7033;2259;6380;311;928;1673;4707;1984;5635
292900;201311;3043;9618;2873;9342;445;1716;1910;5977;2355;7693
292905;201311;4139;12460;3523;11672;338;1032;2896;9913;3234;10945
292910;201311;5030;15902;4674;15229;835;2903;2990;9717;3825;12620
292920;201311;8356;25085;7981;24512;890;3016;6165;18571;7055;21587
292925;201311;5071;16187;4539;15450;393;1447;3583;12256;3976;13703
292930;201311;6434;21086;6151;20553;868;3549;4394;14303;5262;17852
292935;201311;2106;6060;1789;5708;141;362;1497;4996;1638;5358
292937;201311;3320;8601;2839;7992;319;1036;2187;6068;2506;7104
292940;201311;3029;8574;2435;7754;309;989;1633;5440;1942;6429
292950;201311;8196;25207;7847;24624;1011;3803;5708;17403;6719;21206
292960;201311;4521;13010;4201;12519;504;1664;2946;8692;3450;10356
292970;201311;4211;13408;3900;13004;196;814;3313;11043;3509;11857
292975;201311;3284;9280;3174;9103;355;1055;2592;7468;2947;8523
292980;201311;3545;10142;2923;9384;417;1609;2016;6412;2433;8021
292990;201311;12121;35221;11137;33727;773;2490;9488;28800;10261;31290
293000;201311;2920;7881;2401;7208;134;469;2083;6236;2217;6705
293010;201311;18318;53045;16258;49781;3243;10993;9863;30087;13106;41080
293015;201311;7903;26223;6457;24036;1142;4561;4110;15285;5252;19846
293020;201311;9357;31431;8755;30541;653;2564;7203;25384;7856;27948
293030;201311;5501;16326;4499;14844;481;1734;3109;10553;3590;12287
293040;201311;3766;12118;3616;11951;270;958;3108;10315;3378;11273
293050;201311;19373;56273;17337;53573;2918;9269;11401;36329;14319;45598
293060;201311;4284;11102;3628;10057;423;1279;2474;6773;2897;8052
293070;201311;19830;61417;18438;58972;5304;17624;9385;30622;14689;48246
293075;201311;3489;11222;3184;10858;284;1038;2656;9115;2940;10153
293076;201311;3690;10556;3459;10210;291;828;2900;8714;3191;9542
293077;201311;5071;15806;4415;14966;835;3019;2744;9435;3579;12454
293080;201311;4827;15405;4429;14732;329;1423;3503;11401;3832;12824
293090;201311;3557;11310;2933;10425;311;1117;2253;8155;2564;9272
293100;201311;5632;17620;4858;16254;486;1761;3676;12491;4162;14252
293105;201311;3832;12978;3389;12083;584;2132;2205;8023;2789;10155
293110;201311;1944;5927;1836;5744;111;423;1535;4780;1646;5203
293120;201311;4035;13716;3756;13317;347;1267;3006;10825;3353;12092
293130;201311;3943;11675;3235;10874;196;746;2832;9656;3028;10402
293135;201311;27209;72740;21528;65081;4249;15153;11161;33198;15410;48351
293140;201311;2077;6306;2014;6213;200;781;1564;4688;1764;5469
293150;201311;5824;19295;5248;18193;1102;3870;3075;11054;4177;14924
293160;201311;3428;9554;3268;9353;524;1176;2451;7470;2975;8646
293170;201311;3382;10532;3177;10217;457;1581;2316;7576;2773;9157
293180;201311;5347;15251;4492;13925;399;1475;3522;10740;3921;12215
293190;201311;13642;42061;13024;41089;630;2811;11256;34756;11886;37567
293200;201311;6199;18553;5576;17607;297;1098;4817;15138;5114;16236
293210;201311;4623;14321;4317;13797;555;1849;3053;9911;3608;11760
293220;201311;5130;15808;4651;15058;1245;4230;2336;7752;3581;11982
293230;201311;3908;12478;3625;12081;420;1603;2823;9360;3243;10963
293240;201311;4482;11838;3572;10580;197;593;2835;8406;3032;8999
293245;201311;4352;12902;3982;12287;516;1632;2814;8973;3330;10605
293250;201311;5914;17133;5471;16500;873;2749;3779;11466;4652;14215
293260;201311;4687;14301;3943;13225;366;1351;2953;10063;3319;11414
293270;201311;5784;16125;5502;15818;580;1570;4639;13608;5219;15178
293280;201311;5664;16249;4965;15336;433;1263;3864;12360;4297;13623
293290;201311;16382;56007;15560;54322;3491;12551;9061;32380;12552;44931
293300;201311;6234;16153;5410;15235;497;1370;4312;12316;4809;13686
293305;201311;4671;12009;4183;11343;338;993;3387;9210;3725;10203
293310;201311;2673;7024;2212;6264;260;842;1520;4247;1780;5089
293315;201311;4835;12531;4357;11787;751;2017;2735;7774;3486;9791
293317;201311;2489;7562;2286;7187;318;1049;1498;4742;1816;5791
293320;201311;8124;26758;7927;26487;976;3556;6349;21135;7325;24691
293325;201311;1915;5651;1595;5147;309;1069;995;3246;1304;4315
293330;201311;54216;174101;48883;165006;11285;41386;26710;91294;37995;132680
293340;201311;2702;7806;2147;6839;317;1162;1462;4541;1779;5703
293345;201311;3413;10502;2895;9746;364;1223;2035;7093;2399;8316
293350;201311;6669;18775;6397;18433;509;1392;5545;16272;6054;17664
293360;201311;13650;41983;12532;40498;782;2554;10659;35207;11441;37761
310010;201311;1227;3375;888;2826;247;940;389;1129;636;2069
310020;201311;3806;12208;3164;10781;1106;4079;593;1828;1699;5907
310030;201311;2417;8254;2178;7794;733;2721;934;3385;1667;6106
310040;201311;949;2697;808;2503;111;419;556;1675;667;2094
310050;201311;1896;6770;1673;6216;364;1577;803;2934;1167;4511
310060;201311;3050;10912;2935;10734;366;1384;2275;8483;2641;9867
310070;201311;305;909;223;749;35;153;100;300;135;453
310080;201311;759;2383;618;2101;174;682;197;612;371;1294
310090;201311;4610;14275;4062;13310;724;2660;2453;8036;3177;10696
310100;201311;3243;10244;2793;9515;351;1374;2033;6884;2384;8258
310110;201311;5853;16831;4945;15467;1128;4065;2648;8132;3776;12197
310120;201311;577;1932;547;1880;236;931;197;566;433;1497
310130;201311;457;1457;416;1395;109;414;199;625;308;1039
310140;201311;261;916;227;850;73;311;49;161;122;472
310150;201311;4732;15048;4331;14306;978;3677;2228;7289;3206;10966
310160;201311;6919;22848;6061;21291;1807;7068;2465;8466;4272;15534
310163;201311;716;2520;667;2416;184;769;258;894;442;1663
310170;201311;9637;28215;8914;27084;1879;6094;5341;16794;7220;22888
310180;201311;1816;5394;1471;4897;393;1491;685;2209;1078;3700
310190;201311;2508;8523;2277;8112;683;2702;323;1170;1006;3872
310200;201311;1866;6406;1576;5802;496;1980;509;1848;1005;3828
310205;201311;936;3035;855;2856;179;605;494;1698;673;2303
310210;201311;2414;7853;2232;7563;399;1480;1514;5116;1913;6596
310220;201311;1257;3636;1016;3318;202;712;627;2034;829;2746
310230;201311;2848;9567;2486;8750;782;3173;908;2917;1690;6090
310240;201311;1011;3616;847;3270;150;662;443;1791;593;2453
310250;201311;960;3387;932;3344;189;784;579;1975;768;2759
310260;201311;3269;10796;2822;9855;847;3304;1047;3544;1894;6848
310270;201311;2307;7089;2092;6775;286;1045;1522;4964;1808;6009
310280;201311;2085;6214;1897;5905;661;2391;721;2086;1382;4477
310285;201311;2235;7978;2120;7816;275;972;1605;6131;1880;7103
310290;201311;1313;4168;1223;4028;386;1479;557;1621;943;3100
310300;201311;1866;6517;1762;6299;502;1979;950;3353;1452;5332
310310;201311;395;1114;289;892;59;202;145;438;204;640
310320;201311;360;1281;328;1197;88;357;145;517;233;874
310330;201311;481;1272;363;1059;43;159;210;559;253;718
310340;201311;8273;26794;7381;25307;1506;5442;4388;15517;5894;20959
310350;201311;14158;42776;11590;37980;4269;15149;2968;9769;7237;24918
310360;201311;433;1430;420;1407;99;389;258;811;357;1200
310370;201311;1413;5134;1355;5020;498;1898;573;2162;1071;4060
310375;201311;1264;3491;940;2919;149;550;503;1507;652;2057
310380;201311;393;1134;315;1018;135;487;117;338;252;825
310390;201311;480;1751;404;1573;121;516;67;234;188;750
310400;201311;10052;30721;8043;27057;2760;10227;2126;7003;4886;17230
310410;201311;1032;3378;679;2812;269;1212;119;468;388;1680
310420;201311;5597;16546;3249;10920;849;3229;509;1516;1358;4745
310430;201311;1585;5520;1338;4980;463;1846;342;1257;805;3103
310440;201311;620;1848;546;1732;159;580;202;593;361;1173
310445;201311;1174;4091;1007;3796;154;650;650;2487;804;3137
310450;201311;4358;13171;3666;12117;852;2968;2108;7184;2960;10152
310460;201311;1513;5007;1328;4664;472;1796;309;1145;781;2941
310470;201311;3702;9818;3139;9118;326;1116;2477;7153;2803;8269
310480;201311;999;3245;890;3027;226;883;411;1317;637;2200
310490;201311;3262;11252;2842;10416;986;3925;1006;3713;1992;7638
310500;201311;1446;5163;1345;4950;449;1813;499;1789;948;3602
310510;201311;2484;8340;2176;7629;842;3207;483;1599;1325;4806
310520;201311;1271;3675;1124;3428;97;309;742;2280;839;2589
310530;201311;829;2706;549;1981;125;493;91;322;216;815
310540;201311;3647;12253;3381;11846;1196;4453;1252;4459;2448;8912
310550;201311;1136;3589;962;3292;323;1268;336;1072;659;2340
310560;201311;15861;50733;13786;46645;4697;17626;4554;14655;9251;32281
310570;201311;1271;4006;1196;3902;171;654;876;2811;1047;3465
310590;201311;4100;12347;3263;10675;682;2582;1197;3705;1879;6287
310600;201311;1606;5493;1516;5287;522;2042;506;1637;1028;3679
310610;201311;549;1924;506;1827;163;696;175;562;338;1258
310620;201311;184303;597232;151627;528877;42974;167051;57186;190406;100160;357457
310630;201311;4104;13737;3889;13323;899;3526;2359;7787;3258;11313
310640;201311;1434;4504;1171;4028;387;1450;360;1165;747;2615
310650;201311;2844;9270;2355;8438;531;2050;1179;4320;1710;6370
310660;201311;1267;4057;1135;3868;206;812;791;2627;997;3439
310665;201311;1161;3713;1076;3593;206;730;710;2419;916;3149
310670;201311;55704;178422;51413;168579;16175;56267;21544;69264;37719;125531
310680;201311;798;2437;732;2333;168;591;393;1218;561;1809
310690;201311;1193;4165;996;3731;292;1275;245;871;537;2146
310700;201311;516;1445;440;1331;125;426;213;611;338;1037
310710;201311;7287;24280;5881;21958;1469;6093;2335;8725;3804;14818
310720;201311;834;2630;761;2503;235;885;349;1056;584;1941
310730;201311;9262;30134;8604;29087;2026;7467;5087;17225;7113;24692
310740;201311;4948;17290;4286;15862;1669;6730;1023;3587;2692;10317
310750;201311;1579;4198;1316;3841;253;771;822;2405;1075;3176
310760;201311;604;1952;530;1823;137;509;229;776;366;1285
310770;201311;708;2657;699;2644;312;1288;256;917;568;2205
310780;201311;3563;10527;3251;9995;529;1624;2131;6664;2660;8288
310790;201311;1711;5641;1591;5447;474;1696;800;2810;1274;4506
310800;201311;3023;10061;2470;8921;1067;4182;383;1361;1450;5543
310810;201311;1511;4307;1403;4134;375;1244;668;1867;1043;3111
310820;201311;1465;4262;1084;3580;319;1164;335;1037;654;2201
310825;201311;2337;8221;1943;7522;176;896;1435;5499;1611;6395
310830;201311;1417;4902;1204;4447;455;1801;358;1279;813;3080
310840;201311;2187;7487;1997;7091;767;3006;543;1782;1310;4788
310850;201311;1501;4658;1293;4378;233;917;872;2894;1105;3811
310855;201311;3045;10192;2776;9756;760;2806;1478;5369;2238;8175
310860;201311;7621;24549;6852;23225;1274;4495;3944;13832;5218;18327
310870;201311;1000;2964;869;2722;205;711;394;1218;599;1929
310880;201311;1237;3898;940;3330;197;793;441;1553;638;2346
310890;201311;2699;8776;2126;7656;659;2666;462;1551;1121;4217
310900;201311;4240;14495;3714;13452;1161;4664;1463;5087;2624;9751
310910;201311;1932;5792;1438;4842;439;1641;342;1115;781;2756
310920;201311;1838;5844;1509;5354;412;1664;718;2542;1130;4206
310925;201311;924;3130;836;2973;317;1249;246;866;563;2115
310930;201311;5100;15533;4217;14118;942;3347;2317;7974;3259;11321
310940;201311;6148;18649;5349;17416;1104;4000;2946;9562;4050;13562
310945;201311;1250;3648;1013;3317;246;931;539;1684;785;2615
310950;201311;1869;6472;1558;5817;621;2565;429;1501;1050;4066
310960;201311;449;1579;400;1484;142;580;136;508;278;1088
310970;201311;1463;5244;1115;4264;434;1805;129;436;563;2241
310980;201311;460;1226;323;969;61;219;141;373;202;592
310990;201311;1135;3966;989;3669;224;943;354;1227;578;2170
311000;201311;4581;16238;4083;15148;1354;5573;1397;4923;2751;10496
311010;201311;945;3092;836;2891;272;1006;379;1270;651;2276
311020;201311;869;2793;741;2570;107;424;430;1468;537;1892
311030;201311;1770;5572;1446;4876;496;1864;496;1486;992;3350
311040;201311;479;1656;416;1484;129;478;105;359;234;837
311050;201311;2572;8403;2161;7557;725;2757;801;2793;1526;5550
311060;201311;2291;7374;1884;6464;557;2053;444;1478;1001;3531
311070;201311;1708;6189;1506;5754;468;2025;464;1731;932;3756
311080;201311;1192;3264;1059;3055;161;533;703;2038;864;2571
311090;201311;1631;6317;1431;5874;511;2365;276;1073;787;3438
311100;201311;2268;8110;2040;7619;959;3727;478;1789;1437;5516
311110;201311;3759;9439;2830;8146;633;2076;1467;4090;2100;6166
311115;201311;1071;3374;926;3150;125;528;607;2073;732;2601
311120;201311;8519;25391;7072;22760;2412;8697;1951;5811;4363;14508
311130;201311;2396;7463;1948;6872;665;2677;773;2605;1438;5282
311140;201311;1223;3661;1058;3458;193;740;716;2290;909;3030
311150;201311;2401;8118;2218;7823;504;1785;1287;4727;1791;6512
311160;201311;4832;16646;4148;15503;1517;6066;1330;4900;2847;10966
311170;201311;745;2368;594;2065;61;243;355;1293;416;1536
311180;201311;1570;4455;1141;3595;363;1255;234;657;597;1912
311190;201311;1087;3334;920;2976;236;872;375;1132;611;2004
311200;201311;2510;7872;2184;7196;910;3279;509;1505;1419;4784
311205;201311;1172;3891;1048;3644;271;1078;394;1413;665;2491
311210;201311;908;3034;840;2925;175;606;575;2062;750;2668
311220;201311;906;2958;727;2547;202;746;238;827;440;1573
311230;201311;8878;27543;7610;25366;1683;6163;3883;13289;5566;19452
311240;201311;1343;4207;1119;3824;378;1443;325;1056;703;2499
311250;201311;1310;4427;1185;4207;373;1444;362;1146;735;2590
311260;201311;2916;8110;2205;6822;720;2453;633;1842;1353;4295
311265;201311;1303;3562;1026;3202;169;636;671;2055;840;2691
311270;201311;3349;11327;3025;10895;617;2597;1913;6757;2530;9354
311280;201311;1358;3867;1046;3309;286;1007;325;987;611;1994
311290;201311;2304;7658;2126;7271;409;1363;1231;4406;1640;5769
311300;201311;4989;16956;4567;16310;791;3178;2926;10519;3717;13697
311310;201311;486;1751;467;1717;127;553;176;592;303;1145
311320;201311;3996;13703;3489;12546;1000;4068;1149;3887;2149;7955
311330;201311;5464;17043;4684;15773;1726;6239;1540;5162;3266;11401
311340;201311;11970;39538;10987;37651;4055;14948;3149;10755;7204;25703
311350;201311;2253;6885;1946;6351;470;1833;878;2704;1348;4537
311360;201311;1324;3786;1057;3424;464;1589;295;983;759;2572
311370;201311;4420;13591;3977;12824;1029;4026;1693;5158;2722;9184
311380;201311;462;1573;392;1435;136;555;114;380;250;935
311390;201311;1912;7285;1835;7121;819;3520;545;2017;1364;5537
311400;201311;1689;5756;1559;5516;479;1919;661;2143;1140;4062
311410;201311;1995;7362;1870;7177;678;2783;860;3325;1538;6108
311420;201311;2254;8009;2005;7384;773;3014;430;1423;1203;4437
311430;201311;3841;12343;2930;10284;713;2753;566;1924;1279;4677
311440;201311;2182;7781;1855;7247;847;3662;440;1685;1287;5347
311450;201311;2371;8576;2103;7945;771;3119;588;2121;1359;5240
311455;201311;1542;4285;1357;4014;291;990;765;2194;1056;3184
311460;201311;600;2016;489;1774;130;592;120;405;250;997
311470;201311;591;1918;477;1675;140;582;146;472;286;1054
311480;201311;790;2267;755;2212;271;825;275;754;546;1579
311490;201311;312;1260;301;1218;112;465;96;398;208;863
311500;201311;503;1556;411;1369;162;589;139;447;301;1036
311510;201311;3077;9808;2572;8839;1004;3873;659;2113;1663;5986
311520;201311;690;2403;656;2327;255;980;247;851;502;1831
311530;201311;10694;29263;7425;23349;2219;8268;2051;6062;4270;14330
311535;201311;685;2156;514;1805;140;556;115;394;255;950
311540;201311;696;2559;665;2508;251;971;296;1114;547;2085
311545;201311;2093;6836;2014;6710;350;1295;1347;4488;1697;5783
311547;201311;1646;4689;1399;4300;154;516;946;2928;1100;3444
311550;201311;3246;10878;2879;10146;984;3841;896;3089;1880;6930
311560;201311;257;716;238;692;62;205;134;366;196;571
311570;201311;1959;5098;1684;4780;129;390;1426;4091;1555;4481
311580;201311;2090;4963;1884;4723;595;1441;1069;2761;1664;4202
311590;201311;373;1222;325;1153;92;390;88;306;180;696
311600;201311;1319;4084;1148;3856;246;839;665;2356;911;3195
311610;201311;3521;12346;3267;11933;943;3416;1611;6361;2554;9777
311615;201311;2586;8734;2283;8206;306;1223;1583;5729;1889;6952
311620;201311;444;1451;400;1386;112;459;197;640;309;1099
311630;201311;1445;4381;1232;3976;335;1076;595;1960;930;3036
311640;201311;881;2777;748;2559;111;413;556;1900;667;2313
311650;201311;2411;7072;2025;6435;338;1228;1154;3702;1492;4930
311660;201311;2515;9093;2251;8442;689;2889;471;1530;1160;4419
311670;201311;1355;4342;1205;4064;473;1757;448;1444;921;3201
311680;201311;2249;7233;1917;6759;494;1840;1045;3777;1539;5617
311690;201311;517;1474;437;1381;88;310;276;855;364;1165
311700;201311;2126;6319;1911;6005;204;823;1444;4429;1648;5252
311710;201311;1622;5219;1315;4646;588;2272;348;1193;936;3465
311720;201311;404;1408;379;1363;83;314;239;843;322;1157
311730;201311;4780;13225;3190;10382;1007;3617;1119;3392;2126;7009
311740;201311;1005;2909;878;2759;392;1235;366;1216;758;2451
311750;201311;3778;13122;3539;12789;628;2524;2339;8490;2967;11014
311760;201311;789;2775;736;2655;258;1075;242;739;500;1814
311770;201311;2574;8270;2123;7442;623;2453;696;2345;1319;4798
311780;201311;979;3764;844;3407;296;1322;127;501;423;1823
311783;201311;2038;6834;1826;6435;215;936;1200;4320;1415;5256
311787;201311;659;2324;484;1803;105;410;99;332;204;742
311790;201311;1251;4140;1035;3688;304;1162;226;783;530;1945
311800;201311;3766;13164;2590;9419;662;2627;211;617;873;3244
311810;201311;1035;3537;998;3464;41;201;874;2985;915;3186
311820;201311;815;2737;695;2461;242;975;303;971;545;1946
311830;201311;10274;37645;9439;35492;3949;15583;2081;7738;6030;23321
311840;201311;3410;10369;2928;9628;1028;3691;1091;3493;2119;7184
311850;201311;310;959;268;892;72;256;125;413;197;669
311860;201311;48692;155851;42773;144117;12139;44788;17874;58354;30013;103142
311870;201311;2280;7025;1874;6241;502;1923;640;1997;1142;3920
311880;201311;6831;21249;6332;20601;966;3218;4479;15089;5445;18307
311890;201311;1569;5061;1329;4548;429;1613;524;1730;953;3343
311900;201311;797;2527;720;2412;157;536;437;1539;594;2075
311910;201311;4654;14040;3821;12856;1203;4408;1539;5217;2742;9625
311920;201311;2019;6768;1762;6387;223;935;1224;4383;1447;5318
311930;201311;4735;14547;4260;13749;1618;5678;1314;4237;2932;9915
311940;201311;12778;40379;11126;36947;3920;14340;2784;8810;6704;23150
311950;201311;2231;6802;1953;6455;146;496;1629;5446;1775;5942
311960;201311;371;1336;339;1266;121;489;114;403;235;892
311970;201311;463;1698;400;1560;136;578;66;241;202;819
311980;201311;744;2132;579;1885;138;481;268;901;406;1382
311990;201311;474;1518;439;1458;188;663;130;406;318;1069
311995;201311;1007;3154;788;2673;236;896;211;606;447;1502
312000;201311;668;2147;641;2106;113;428;371;1210;484;1638
312010;201311;1031;3357;937;3176;193;708;435;1472;628;2180
312015;201311;1568;4938;1367;4589;214;856;822;2762;1036;3618
312020;201311;908;3015;815;2882;227;906;423;1458;650;2364
312030;201311;1749;5381;1582;5163;274;1008;1119;3598;1393;4606
312040;201311;669;2596;601;2403;225;995;147;566;372;1561
312050;201311;1500;5220;1294;4766;402;1641;262;908;664;2549
312060;201311;741;2319;664;2214;247;874;282;911;529;1785
312070;201311;924;2938;627;2271;182;722;220;777;402;1499
312080;201311;2573;7339;2020;6446;480;1844;909;2623;1389;4467
312083;201311;903;2696;771;2505;103;389;492;1580;595;1969
312087;201311;2289;7113;2051;6789;404;1413;1335;4497;1739;5910
312090;201311;9738;32187;8940;30772;2827;10833;3674;12088;6501;22921
312100;201311;1343;4656;1186;4401;280;1160;647;2455;927;3615
312110;201311;1162;4238;1039;3965;380;1593;196;673;576;2266
312120;201311;900;3183;815;2990;265;1102;209;670;474;1772
312125;201311;1160;3852;1037;3570;283;1071;421;1425;704;2496
312130;201311;793;2486;652;2189;174;670;248;783;422;1453
312140;201311;1147;3671;977;3258;234;855;373;1142;607;1997
312150;201311;585;1690;504;1530;63;227;319;937;382;1164
312160;201311;7847;27634;7242;26374;2434;9682;2584;9518;5018;19200
312170;201311;1005;3088;909;2883;135;460;563;1816;698;2276
312180;201311;1578;5012;1465;4820;458;1578;571;1869;1029;3447
312190;201311;638;2151;504;1882;207;869;96;321;303;1190
312200;201311;4620;14399;4063;13417;573;1990;2758;9206;3331;11196
312210;201311;1146;3247;926;2913;248;875;409;1237;657;2112
312220;201311;1852;6222;1688;6030;300;1119;1192;4435;1492;5554
312230;201311;17604;60023;14991;54599;7174;27739;2616;9779;9790;37518
312235;201311;1749;5073;1446;4580;194;760;960;3025;1154;3785
312240;201311;1099;3836;938;3488;297;1174;308;1141;605;2315
312245;201311;2373;7090;2079;6680;179;526;1701;5605;1880;6131
312247;201311;877;2674;691;2382;215;811;332;1171;547;1982
312250;201311;1112;3374;993;3168;219;788;495;1536;714;2324
312260;201311;892;3007;779;2857;114;522;547;1971;661;2493
312270;201311;780;2543;680;2339;185;769;220;631;405;1400
312280;201311;466;1627;424;1521;178;685;45;153;223;838
312290;201311;760;2687;710;2608;305;1243;147;534;452;1777
312300;201311;1108;3741;926;3307;303;1145;121;372;424;1517
312310;201311;938;3640;849;3411;283;1230;342;1337;625;2567
312320;201311;2405;6936;1983;6110;567;2012;566;1463;1133;3475
312330;201311;1104;3467;1005;3316;326;1214;459;1499;785;2713
312340;201311;308;835;288;806;52;192;202;520;254;712
312350;201311;371;981;347;950;50;161;274;715;324;876
312352;201311;1623;5475;1519;5327;523;1859;789;2858;1312;4717
312360;201311;3615;12504;3175;11566;1071;4208;764;2738;1835;6946
312370;201311;1646;5501;1531;5295;531;2034;560;1861;1091;3895
312380;201311;1964;5920;1812;5677;284;956;1223;3935;1507;4891
312385;201311;1191;3854;1126;3730;170;684;770;2456;940;3140
312390;201311;2004;6889;1743;6332;589;2296;367;1283;956;3579
312400;201311;3327;11288;3046;10751;1028;3734;1333;4875;2361;8609
312410;201311;10339;35554;9322;33423;2947;11484;3170;11052;6117;22536
312420;201311;3958;13047;3784;12841;725;2519;2587;9039;3312;11558
312430;201311;8411;25654;7467;24237;1434;4917;4736;15851;6170;20768
312440;201311;561;1910;500;1792;174;674;183;641;357;1315
312450;201311;1086;4124;1015;3963;479;1896;306;1195;785;3091
312460;201311;390;1223;350;1173;91;353;172;545;263;898
312470;201311;742;2165;509;1686;139;540;101;325;240;865
312480;201311;1270;4006;1103;3808;413;1494;457;1561;870;3055
312490;201311;2310;6177;1852;5575;301;1083;1093;3180;1394;4263
312500;201311;591;2122;559;2064;159;688;272;965;431;1653
312510;201311;1975;6988;1747;6463;529;2212;570;1895;1099;4107
312520;201311;378;1328;334;1232;121;477;107;397;228;874
312530;201311;560;1900;533;1840;111;457;288;938;399;1395
312540;201311;1452;4742;1184;4206;208;854;691;2388;899;3242
312550;201311;619;2031;559;1906;74;295;352;1169;426;1464
312560;201311;2103;5784;1874;5477;251;827;1377;4066;1628;4893
312570;201311;2644;8313;2346;7747;757;2682;697;2218;1454;4900
312580;201311;522;1783;427;1590;114;494;174;607;288;1101
312590;201311;1815;6278;1594;5784;551;2260;495;1614;1046;3874
312595;201311;1997;6903;1786;6381;490;1884;809;2830;1299;4714
312600;201311;772;2850;712;2711;221;950;274;969;495;1919
312610;201311;8424;27027;7262;24697;2749;10074;2051;6726;4800;16800
312620;201311;2018;5951;1556;5351;98;314;1289;4617;1387;4931
312630;201311;501;1717;459;1633;131;532;194;653;325;1185
312640;201311;569;1921;474;1710;119;492;187;631;306;1123
312650;201311;2317;7049;1675;5802;202;838;894;3040;1096;3878
312660;201311;1222;3491;1057;3273;201;750;660;1974;861;2724
312670;201311;5861;18707;5478;18101;1259;4837;3043;9793;4302;14630
312675;201311;1434;4660;1295;4378;264;959;677;2327;941;3286
312680;201311;1697;5287;1516;4971;256;972;897;2977;1153;3949
312690;201311;2392;6722;1999;6164;429;1547;1081;3204;1510;4751
312695;201311;887;3229;832;3143;153;589;547;2131;700;2720
312700;201311;2157;6442;1657;5461;341;1300;848;2736;1189;4036
312705;201311;1371;4184;1218;3973;204;703;820;2686;1024;3389
312707;201311;1764;5561;1472;5064;296;1178;745;2526;1041;3704
312710;201311;7897;22949;5969;19501;2346;8524;1363;4108;3709;12632
312720;201311;750;2574;680;2436;203;802;267;895;470;1697
312730;201311;1874;4799;1439;4316;217;774;918;2758;1135;3532
312733;201311;1753;4816;1358;4075;127;481;974;2791;1101;3272
312735;201311;868;2669;766;2509;300;1029;321;1060;621;2089
312737;201311;1021;2546;724;2129;249;768;261;822;510;1590
312738;201311;498;1641;404;1463;142;601;149;483;291;1084
312740;201311;498;1440;339;1229;124;501;94;334;218;835
312750;201311;1275;4743;1222;4633;346;1473;561;2089;907;3562
312760;201311;2386;7873;1900;6918;623;2520;443;1624;1066;4144
312770;201311;43678;123257;34373;109047;10485;36156;11148;35244;21633;71400
312780;201311;2691;9842;2430;9384;556;2332;1346;5338;1902;7670
312790;201311;358;980;234;764;72;254;65;198;137;452
312800;201311;5061;17638;4466;16385;1485;5889;1376;5133;2861;11022
312810;201311;2148;6746;1641;5876;586;2316;335;1109;921;3425
312820;201311;2108;6423;1943;6139;272;1026;1238;3770;1510;4796
312825;201311;1519;4236;1349;4023;147;474;1065;3166;1212;3640
312830;201311;2672;8775;1973;7340;600;2510;301;1077;901;3587
312840;201311;1127;3853;953;3513;246;1049;351;1208;597;2257
312850;201311;694;2310;599;2111;188;751;182;619;370;1370
312860;201311;1306;3822;1011;3372;355;1381;339;991;694;2372
312870;201311;5561;17933;4356;15616;1318;5376;1205;4098;2523;9474
312880;201311;1154;3541;963;3206;270;1038;402;1237;672;2275
312890;201311;1543;4859;1243;4302;449;1760;417;1357;866;3117
312900;201311;1355;4654;1315;4599;408;1468;688;2457;1096;3925
312910;201311;1452;3461;1169;3083;337;1068;515;1237;852;2305
312920;201311;983;3303;869;3124;305;1226;343;1184;648;2410
312930;201311;2153;6580;1934;6250;448;1562;1004;3297;1452;4859
312940;201311;914;3136;818;2946;241;1016;252;842;493;1858
312950;201311;3426;9968;2804;9030;993;3478;1130;3620;2123;7098
312960;201311;1891;5885;1702;5628;232;779;1261;4271;1493;5050
312965;201311;1729;5739;1507;5328;361;1386;795;2876;1156;4262
312970;201311;1121;3930;1009;3778;439;1839;171;630;610;2469
312980;201311;20531;73508;19778;71658;7939;30662;6950;24451;14889;55113
312990;201311;394;1238;308;1081;117;461;92;309;209;770
313000;201311;505;1774;459;1684;151;669;138;431;289;1100
313005;201311;2572;8554;2289;8073;371;1470;1436;5051;1807;6521
313010;201311;3865;13285;3472;12584;1109;4410;1312;4507;2421;8917
313020;201311;1035;3582;941;3370;316;1276;301;945;617;2221
313030;201311;1550;4477;1256;4062;358;1330;631;1916;989;3246
313040;201311;955;3422;810;2998;212;866;206;726;418;1592
313050;201311;1835;6147;1541;5665;515;2085;522;1843;1037;3928
313055;201311;1461;5028;1369;4886;149;523;1032;3817;1181;4340
313060;201311;928;3307;872;3184;417;1574;144;517;561;2091
313065;201311;1884;6456;1757;6260;268;1109;1276;4481;1544;5590
313070;201311;1169;3602;1001;3284;270;1042;497;1526;767;2568
313080;201311;461;1479;378;1320;118;472;101;291;219;763
313090;201311;5109;15995;4847;15545;839;2931;3246;10539;4085;13470
313100;201311;1085;3586;1014;3480;173;670;700;2363;873;3033
313110;201311;1664;5086;1323;4432;344;1372;513;1579;857;2951
313115;201311;2856;10232;2722;9945;928;3765;1176;4046;2104;7811
313120;201311;3763;11175;3228;10366;1164;3950;1338;4359;2502;8309
313130;201311;25598;83646;23281;78716;7239;27099;8333;26658;15572;53757
313140;201311;726;1935;534;1625;50;189;336;1000;386;1189
313150;201311;1637;5219;1485;4951;664;2290;403;1403;1067;3693
313160;201311;1171;3602;1055;3422;233;888;614;1894;847;2782
313170;201311;9645;36035;8927;34204;3586;14279;1881;7260;5467;21539
313180;201311;2649;7162;2056;6373;670;2337;684;2049;1354;4386
313190;201311;3464;13087;3302;12686;992;4058;1289;4926;2281;8984
313200;201311;1483;4756;1324;4504;217;895;832;2813;1049;3708
313210;201311;4535;14674;3896;13794;986;3957;1996;6945;2982;10902
313220;201311;1226;3823;967;3278;260;1007;257;779;517;1786
313230;201311;2508;9006;2362;8782;431;1688;1483;5729;1914;7417
313240;201311;7772;27268;6795;25373;2103;8570;2671;9972;4774;18542
313250;201311;7587;24329;6954;23306;1226;4170;4307;14923;5533;19093
313260;201311;598;1924;501;1728;150;593;138;449;288;1042
313270;201311;5444;16548;4949;15786;870;2917;3291;10643;4161;13560
313280;201311;510;1774;443;1615;114;483;162;566;276;1049
313290;201311;1019;3759;861;3411;280;1185;214;789;494;1974
313300;201311;1932;6754;1683;6122;549;2172;390;1316;939;3488
313310;201311;1046;3758;953;3552;284;1202;216;749;500;1951
313320;201311;2358;7374;2009;6758;470;1696;844;2835;1314;4531
313330;201311;3840;12885;3460;12166;771;3102;1657;5762;2428;8864
313340;201311;2158;5327;1697;4671;372;1091;959;2588;1331;3679
313350;201311;3304;10486;2564;8781;703;2602;504;1547;1207;4149
313360;201311;1192;3718;923;3183;319;1292;377;1156;696;2448
313370;201311;1441;5119;1356;4872;304;1261;583;1929;887;3190
313375;201311;1988;5442;1365;4533;358;1433;522;1678;880;3111
313380;201311;6606;23082;5749;21170;2347;9261;1465;5093;3812;14354
313390;201311;895;3337;861;3278;140;624;552;2066;692;2690
313400;201311;3703;11122;3425;10781;442;1492;2619;8329;3061;9821
313410;201311;1346;3928;1153;3661;260;914;681;2153;941;3067
313420;201311;18946;48030;12313;35996;3134;10393;2971;8298;6105;18691
313430;201311;1301;4306;1170;4074;384;1496;408;1355;792;2851
313440;201311;6483;15961;4948;14181;788;2458;3465;9963;4253;12421
313450;201311;711;2170;584;1906;156;631;206;594;362;1225
313460;201311;2654;9602;2394;9100;886;3635;702;2564;1588;6199
313470;201311;3391;9708;3242;9536;387;1035;2646;8009;3033;9044
313480;201311;1139;3418;874;2938;176;683;379;1214;555;1897
313490;201311;1433;4934;1109;4345;465;1813;236;963;701;2776
313500;201311;443;1433;418;1383;92;354;251;806;343;1160
313505;201311;8741;26404;8264;25817;552;1355;7307;23618;7859;24973
313507;201311;1287;3953;1163;3760;270;997;644;2092;914;3089
313510;201311;15730;47827;14234;45944;2494;8437;9906;32672;12400;41109
313520;201311;15850;49158;13688;45574;2104;8167;8971;29697;11075;37864
313530;201311;530;1882;468;1732;75;321;199;692;274;1013
313535;201311;2501;7646;2246;7218;397;1362;1406;4583;1803;5945
313540;201311;1150;3675;928;3130;290;1048;236;728;526;1776
313545;201311;1369;5118;1220;4852;244;1140;739;2850;983;3990
313550;201311;1922;6729;1843;6555;527;2025;942;3239;1469;5264
313560;201311;2293;5811;2036;5512;240;639;1579;4437;1819;5076
313570;201311;797;2988;701;2787;282;1220;216;799;498;2019
313580;201311;6093;17742;5353;16730;730;2437;3932;12407;4662;14844
313590;201311;1059;3252;869;3027;347;1222;447;1618;794;2840
313600;201311;3818;11943;3394;11254;635;2333;2012;6765;2647;9098
313610;201311;1158;3691;1003;3375;282;1048;408;1343;690;2391
313620;201311;7421;25288;6988;24350;2451;9077;2311;7925;4762;17002
313630;201311;8329;26793;7312;25232;2377;8963;2529;9069;4906;18032
313640;201311;838;2721;738;2582;273;1025;280;978;553;2003
313650;201311;2284;7606;2037;7198;307;1128;1459;5276;1766;6404
313652;201311;1018;3700;931;3523;183;733;546;2089;729;2822
313655;201311;945;3238;799;2990;204;877;466;1687;670;2564
313657;201311;1154;3885;1066;3726;172;782;683;2153;855;2935
313660;201311;880;3134;813;3014;232;992;402;1421;634;2413
313665;201311;3019;10216;2809;9765;712;2825;1314;4393;2026;7218
313670;201311;51373;152976;37026;128298;12386;46929;11216;37724;23602;84653
313680;201311;1105;3368;983;3183;122;415;707;2318;829;2733
313690;201311;896;3293;833;3182;233;905;336;1341;569;2246
313695;201311;1475;4965;1279;4650;193;827;893;3222;1086;4049
313700;201311;3864;13098;3304;12330;517;2043;2333;8810;2850;10853
313710;201311;1380;3955;1174;3657;384;1315;545;1630;929;2945
313720;201311;5251;18000;4583;16544;1319;5301;1379;4489;2698;9790
313730;201311;1261;3564;1017;3251;151;525;664;2147;815;2672
313740;201311;2031;7512;1688;6584;627;2738;218;792;845;3530
313750;201311;2929;9168;2585;8491;853;3077;693;2083;1546;5160
313753;201311;1830;5686;1564;5208;489;1753;609;2058;1098;3811
313760;201311;4469;15193;3860;13892;1325;5282;1119;3828;2444;9110
313770;201311;3620;12408;3437;11975;1250;4634;986;3407;2236;8041
313780;201311;3867;11289;3150;10202;883;3252;1386;4346;2269;7598
313790;201311;548;1946;531;1917;113;432;308;1126;421;1558
313800;201311;1249;3628;1118;3415;189;668;690;2088;879;2756
313810;201311;1482;4648;1422;4557;250;829;955;3124;1205;3953
313820;201311;12954;38924;10819;35042;3293;11836;3822;12296;7115;24132
313830;201311;479;1692;413;1547;149;628;119;429;268;1057
313835;201311;1059;3624;1016;3554;236;905;559;1949;795;2854
313840;201311;7356;22844;6318;21120;1988;7460;2117;6790;4105;14250
313850;201311;1249;3584;1136;3385;259;912;624;1756;883;2668
313860;201311;2612;8340;2262;7595;702;2620;512;1562;1214;4182
313862;201311;1004;2880;727;2418;227;831;197;633;424;1464
313865;201311;2206;7168;2064;6920;322;1243;1445;4779;1767;6022
313867;201311;1021;3608;875;3299;309;1221;295;1131;604;2352
313868;201311;1525;5542;1381;5227;183;808;913;3455;1096;4263
313870;201311;916;2906;812;2731;229;896;337;1050;566;1946
313880;201311;2273;7405;2072;7114;497;2024;1057;3352;1554;5376
313890;201311;1993;5562;1706;5198;306;945;1086;3380;1392;4325
313900;201311;4627;17260;4328;16593;1695;7154;1163;4424;2858;11578
313910;201311;761;2642;649;2388;286;1147;119;399;405;1546
313920;201311;3586;11847;3327;11387;561;1956;2101;7516;2662;9472
313925;201311;2113;5743;1602;4808;138;483;1082;3221;1220;3704
313930;201311;5248;17667;4446;16253;858;3453;2577;9605;3435;13058
313940;201311;7902;27909;6845;26178;2543;10479;2432;9582;4975;20061
313950;201311;4735;14189;4016;12988;1306;4761;1321;4056;2627;8817
313960;201311;5962;16606;4991;15241;1738;5983;1270;3834;3008;9817
313970;201311;1489;4448;1257;4185;267;975;783;2614;1050;3589
313980;201311;1195;4070;1036;3768;328;1341;294;1016;622;2357
313990;201311;2001;7721;1798;7255;693;3018;473;1777;1166;4795
314000;201311;8005;28135;7434;27024;2221;8918;3798;13547;6019;22465
314010;201311;1066;3196;894;2976;181;715;468;1486;649;2201
314015;201311;1587;6047;1463;5759;548;2261;422;1692;970;3953
314020;201311;488;1614;420;1462;154;593;126;412;280;1005
314030;201311;831;2732;663;2338;146;598;219;709;365;1307
314040;201311;643;1935;566;1797;195;674;275;832;470;1506
314050;201311;1896;6323;1585;5659;502;2004;449;1469;951;3473
314053;201311;1424;4929;1362;4848;244;832;956;3541;1200;4373
314055;201311;2228;6776;1999;6453;212;696;1493;4941;1705;5637
314060;201311;1079;3553;944;3304;145;605;578;1983;723;2588
314070;201311;3663;12051;2988;10619;932;3640;795;2701;1727;6341
314080;201311;1865;5918;1355;4811;297;1180;329;1071;626;2251
314085;201311;1841;6595;1606;6260;547;2351;558;2184;1105;4535
314090;201311;3470;12131;3169;11545;1070;4216;1168;4350;2238;8566
314100;201311;3476;9567;3050;8951;393;1179;2299;6869;2692;8048
314110;201311;4412;14877;3880;13721;1046;4222;1426;4654;2472;8876
314120;201311;1029;2553;576;1828;200;729;146;431;346;1160
314130;201311;676;1987;418;1407;102;379;82;248;184;627
314140;201311;5031;16111;4531;15159;1108;4013;2197;7406;3305;11419
314150;201311;1693;4650;1355;4136;238;814;798;2417;1036;3231
314160;201311;2367;6529;1981;6024;169;568;1617;4970;1786;5538
314170;201311;1045;3350;899;3034;179;720;469;1496;648;2216
314180;201311;6447;21134;5820;20189;1688;6406;2609;9199;4297;15605
314190;201311;811;2624;720;2470;232;910;274;898;506;1808
314200;201311;3044;10079;2770;9579;456;1801;1827;6238;2283;8039
314210;201311;1942;6255;1747;5875;444;1609;845;2762;1289;4371
314220;201311;1730;5773;1457;5171;509;1999;344;1052;853;3051
314225;201311;1173;3697;1059;3537;72;192;945;3232;1017;3424
314230;201311;695;2466;645;2363;206;820;225;788;431;1608
314240;201311;1123;3650;1009;3466;256;871;603;2146;859;3017
314250;201311;512;1598;417;1393;139;525;144;435;283;960
314260;201311;1293;4758;1238;4636;418;1664;492;1862;910;3526
314270;201311;2695;9542;2535;9253;341;1384;1701;6250;2042;7634
314280;201311;3223;9474;2374;7845;759;2891;647;1893;1406;4784
314290;201311;5366;15421;4611;14209;685;2256;3180;9862;3865;12118
314300;201311;1939;6680;1809;6368;635;2396;671;2288;1306;4684
314310;201311;6500;21272;5725;19610;2371;8661;1320;4361;3691;13022
314315;201311;974;3753;904;3614;163;741;530;2137;693;2878
314320;201311;3307;10360;2751;9569;1003;3827;957;3251;1960;7078
314330;201311;52676;174899;49954;169922;16223;60034;21998;73782;38221;133816
314340;201311;2407;6952;1376;4741;376;1471;165;387;541;1858
314345;201311;1277;4459;1144;4247;375;1443;547;2116;922;3559
314350;201311;1392;4195;1141;3774;464;1673;290;950;754;2623
314360;201311;695;2272;526;1931;161;689;124;426;285;1115
314370;201311;557;2009;522;1963;170;694;260;966;430;1660
314380;201311;1059;3361;821;2940;338;1273;222;807;560;2080
314390;201311;15167;47149;12687;42277;4274;15498;3677;11886;7951;27384
314400;201311;5424;15613;4446;14252;1353;4337;2452;8230;3805;12567
314410;201311;2487;8347;2216;7777;747;2931;812;2689;1559;5620
314420;201311;766;2288;632;2099;98;401;467;1525;565;1926
314430;201311;8102;24687;7275;23151;2534;8800;2249;7279;4783;16079
314435;201311;1183;4029;1069;3797;188;813;641;2188;829;3001
314437;201311;1173;3093;1044;2907;99;278;820;2301;919;2579
314440;201311;745;2081;522;1783;197;748;109;346;306;1094
314450;201311;1723;5233;1490;4897;494;1893;651;1972;1145;3865
314460;201311;4589;16271;4104;15175;1466;5907;779;2880;2245;8787
314465;201311;2365;7781;2177;7430;233;970;1634;5473;1867;6443
314467;201311;1083;3210;960;3004;302;959;472;1528;774;2487
314470;201311;2380;7955;1855;6685;568;2366;408;1219;976;3585
314480;201311;7204;25411;5386;20364;1372;5576;539;1852;1911;7428
314490;201311;932;2935;801;2676;241;939;337;1051;578;1990
314500;201311;2768;8057;2254;7056;708;2466;771;2388;1479;4854
314505;201311;1774;5622;1678;5447;398;1433;950;3060;1348;4493
314510;201311;1632;5094;1318;4542;519;1918;357;1225;876;3143
314520;201311;3780;14751;3118;12944;1137;5144;564;2126;1701;7270
314530;201311;7199;26043;6626;25099;1251;4973;4006;15679;5257;20652
314535;201311;2726;7996;2420;7589;371;1286;1625;5147;1996;6433
314537;201311;1419;4428;1199;4035;272;1042;583;2018;855;3060
314540;201311;461;1453;401;1315;126;476;121;369;247;845
314545;201311;1354;4431;1214;4210;279;1057;632;2185;911;3242
314550;201311;514;1651;436;1535;152;622;116;383;268;1005
314560;201311;5277;19158;4592;17331;1325;5456;1074;3947;2399;9403
314570;201311;373;1190;334;1110;99;358;159;503;258;861
314580;201311;457;1610;395;1485;149;638;97;348;246;986
314585;201311;649;2354;543;2135;175;748;143;554;318;1302
314587;201311;1708;5623;1558;5339;288;1043;867;2974;1155;4017
314590;201311;4166;14751;3081;11723;782;3195;391;1351;1173;4546
314600;201311;2090;7331;1747;6708;681;2920;321;1133;1002;4053
314610;201311;8226;30047;7723;28808;2595;10482;2443;8798;5038;19280
314620;201311;1724;5276;1557;5075;238;767;1150;3873;1388;4640
314625;201311;1541;5088;1501;5038;235;856;1044;3552;1279;4408
314630;201311;5075;15414;4443;14368;673;2412;2997;9855;3670;12267
314640;201311;835;2445;712;2221;253;859;195;564;448;1423
314650;201311;1261;3939;1021;3471;282;1126;427;1297;709;2423
314655;201311;1695;5130;1321;4429;274;966;667;2241;941;3207
314660;201311;181;517;153;459;25;90;90;262;115;352
314670;201311;1446;4142;1189;3690;230;798;653;1995;883;2793
314675;201311;1856;5806;1656;5446;225;838;1085;3609;1310;4447
314690;201311;2723;8859;2315;8098;750;2983;679;2198;1429;5181
314700;201311;9903;38389;8973;36389;4197;17808;1970;8330;6167;26138
314710;201311;8216;27096;5815;21521;1496;6214;729;2503;2225;8717
314720;201311;2652;9064;2233;8210;724;2955;892;3211;1616;6166
314730;201311;2433;7767;2088;7242;760;2955;640;2095;1400;5050
314740;201311;2950;10254;2736;9835;913;3561;995;3448;1908;7009
314750;201311;328;1098;298;1029;68;287;141;460;209;747
314760;201311;1847;6671;1411;5491;346;1539;259;824;605;2363
314770;201311;1201;3893;779;2738;109;451;109;308;218;759
314780;201311;304;862;231;761;86;317;87;276;173;593
314790;201311;13344;41896;10299;36292;4188;16739;2363;7689;6551;24428
314795;201311;1524;4738;1355;4466;155;685;1014;3181;1169;3866
314800;201311;17032;53189;14230;47532;5938;20854;2800;9531;8738;30385
314810;201311;12806;39483;10068;34378;3334;12793;2445;8210;5779;21003
314820;201311;1096;3147;775;2671;302;1149;235;743;537;1892
314830;201311;1663;5813;1456;5396;558;2263;502;1856;1060;4119
314840;201311;1134;4035;908;3691;184;874;534;2167;718;3041
314850;201311;2215;6554;1884;6003;395;1460;1022;3194;1417;4654
314860;201311;3274;11484;3028;11070;614;2505;1821;6656;2435;9161
314870;201311;5660;18772;5104;17995;853;3412;3474;12408;4327;15820
314875;201311;1678;5871;1640;5815;305;1055;1225;4443;1530;5498
314880;201311;800;2430;716;2275;83;287;502;1591;585;1878
314890;201311;597;1892;444;1580;139;552;108;326;247;878
314900;201311;404;1306;330;1175;108;409;147;513;255;922
314910;201311;1677;5997;1475;5628;592;2449;302;1097;894;3546
314915;201311;2474;7961;2204;7572;233;940;1763;6034;1996;6974
314920;201311;654;1940;495;1700;103;405;225;723;328;1128
314930;201311;5109;17795;4478;16364;1536;6122;981;3532;2517;9654
314940;201311;407;1231;383;1186;95;304;195;593;290;897
314950;201311;366;1322;324;1229;98;425;71;246;169;671
314960;201311;778;2612;657;2358;208;814;169;576;377;1390
314970;201311;856;3121;766;2918;317;1314;182;649;499;1963
314980;201311;2227;6934;2020;6583;843;2941;294;906;1137;3847
314990;201311;3095;10214;2522;8886;968;3718;427;1341;1395;5059
314995;201311;1530;4933;1406;4758;268;1085;902;2930;1170;4015
315000;201311;997;3087;858;2890;161;647;532;1751;693;2398
315010;201311;482;1588;403;1413;130;529;137;425;267;954
315015;201311;1845;5840;1721;5692;351;1234;1176;4008;1527;5242
315020;201311;740;2480;667;2343;201;807;259;810;460;1617
315030;201311;1005;3150;872;2902;352;1281;176;567;528;1848
315040;201311;933;2955;860;2832;135;481;586;1920;721;2401
315050;201311;1588;4869;1329;4407;479;1759;404;1279;883;3038
315053;201311;1126;3417;969;3159;266;1051;362;1091;628;2142
315057;201311;1903;6582;1565;6073;251;1009;985;3960;1236;4969
315060;201311;937;3244;783;2836;246;974;193;724;439;1698
315070;201311;667;2062;619;1988;158;562;354;1100;512;1662
315080;201311;3478;12160;3169;11509;874;3450;1414;5121;2288;8571
315090;201311;753;2767;672;2601;194;824;222;899;416;1723
315100;201311;1166;4110;943;3600;281;1190;246;892;527;2082
315110;201311;1644;5103;1447;4763;435;1535;590;1921;1025;3456
315120;201311;13711;33788;9964;28930;1989;6310;5211;15973;7200;22283
315130;201311;1797;6089;1621;5727;595;2324;450;1551;1045;3875
315140;201311;2394;8223;1981;7267;600;2540;550;1743;1150;4283
315150;201311;4658;13176;3566;11193;929;3355;1329;3998;2258;7353
315160;201311;1368;3964;1240;3788;256;873;712;2137;968;3010
315170;201311;1347;4142;1170;3892;284;1051;649;2208;933;3259
315180;201311;13398;42776;10552;36573;3132;12317;2604;8591;5736;20908
315190;201311;2378;6475;1938;5822;626;2023;841;2532;1467;4555
315200;201311;4449;15303;3706;13641;1207;4876;1001;3551;2208;8427
315210;201311;8401;26659;7315;24619;2815;10198;2194;7178;5009;17376
315213;201311;1118;3689;1080;3630;101;311;906;3139;1007;3450
315217;201311;2710;9395;2287;8649;385;1629;1349;5154;1734;6783
315220;201311;10067;30370;8988;28914;1838;6075;5609;18486;7447;24561
315230;201311;2401;6626;2238;6433;143;390;1950;5692;2093;6082
315240;201311;3238;10768;2978;10315;619;2360;1754;6073;2373;8433
315250;201311;8871;29364;6890;25640;2450;10169;2092;7694;4542;17863
315260;201311;1062;3616;912;3273;365;1436;149;485;514;1921
315270;201311;870;3153;755;2900;254;1041;165;602;419;1643
315280;201311;3918;12270;3162;10545;1145;4044;767;2403;1912;6447
315290;201311;1248;3630;972;3183;382;1377;159;522;541;1899
315300;201311;494;1476;401;1356;213;767;106;326;319;1093
315310;201311;1209;4134;1104;3958;157;635;737;2621;894;3256
315320;201311;813;2820;706;2665;249;1004;297;1156;546;2160
315330;201311;830;3046;682;2722;290;1306;114;429;404;1735
315340;201311;4196;12401;3611;11494;860;2964;1852;5979;2712;8943
315350;201311;1842;5342;1535;4925;186;562;1174;3921;1360;4483
315360;201311;1670;5756;1363;4913;346;1323;433;1479;779;2802
315370;201311;619;1892;545;1780;131;487;296;942;427;1429
315380;201311;276;1002;253;934;91;358;49;166;140;524
315390;201311;1946;7027;1682;6383;617;2512;371;1381;988;3893
315400;201311;4407;14189;4041;13471;1165;4165;1909;6446;3074;10611
315410;201311;1693;4842;1441;4423;325;1211;772;2254;1097;3465
315415;201311;1095;3735;1013;3599;465;1690;365;1344;830;3034
315420;201311;1511;4840;1139;4132;337;1303;222;790;559;2093
315430;201311;4000;11186;3069;9596;807;2875;1011;3039;1818;5914
315440;201311;961;3009;870;2869;167;630;506;1666;673;2296
315445;201311;2131;6293;1821;5876;312;1160;1209;3881;1521;5041
315450;201311;2498;8086;2358;7881;469;1590;1553;5349;2022;6939
315460;201311;38749;132143;34584;123060;11839;45551;9056;31197;20895;76748
315470;201311;524;1670;476;1582;94;343;273;881;367;1224
315480;201311;1271;4196;949;3467;220;909;231;782;451;1691
315490;201311;3223;9363;2809;8784;549;2051;1632;4914;2181;6965
315500;201311;453;1491;303;1101;69;296;122;381;191;677
315510;201311;1461;4320;1266;3990;193;700;775;2402;968;3102
315520;201311;1139;3655;967;3419;179;727;591;2021;770;2748
315530;201311;489;1758;463;1715;229;885;134;475;363;1360
315540;201311;1277;3936;1016;3493;223;950;367;1220;590;2170
315550;201311;1647;4996;1439;4716;485;1761;608;1958;1093;3719
315560;201311;7090;23922;6538;23160;986;3894;4473;15862;5459;19756
315570;201311;2384;7635;2231;7400;467;1748;1342;4406;1809;6154
315580;201311;2678;8470;2196;7547;645;2621;792;2511;1437;5132
315590;201311;876;2613;809;2511;117;434;566;1726;683;2160
315600;201311;2555;9401;2153;8745;349;1546;1356;5728;1705;7274
315610;201311;965;2964;839;2687;218;828;292;784;510;1612
315620;201311;338;1216;331;1200;106;404;151;552;257;956
315630;201311;993;3257;855;3019;244;913;230;799;474;1712
315640;201311;735;2380;642;2182;232;906;193;592;425;1498
315645;201311;824;2719;725;2468;295;1102;151;484;446;1586
315650;201311;1795;5544;1685;5393;168;690;1289;4015;1457;4705
315660;201311;2646;7397;2410;7059;435;1380;1505;4396;1940;5776
315670;201311;11452;41769;10551;39930;4048;16467;3198;11844;7246;28311
315680;201311;2834;10145;2348;9189;917;3752;576;2373;1493;6125
315690;201311;3108;10253;2617;9346;965;3794;701;2484;1666;6278
315700;201311;7206;23633;6272;21685;1451;5757;3025;9997;4476;15754
315710;201311;1816;5504;1493;4991;237;938;857;2823;1094;3761
315720;201311;2934;9842;2664;9297;879;3476;955;3098;1834;6574
315725;201311;1617;5073;1309;4671;386;1391;692;2538;1078;3929
315727;201311;654;2123;590;1987;143;521;290;961;433;1482
315730;201311;977;3107;885;2916;216;760;461;1546;677;2306
315733;201311;1137;3745;1047;3546;471;1678;314;1036;785;2714
315737;201311;1351;4236;1154;3901;150;566;716;2453;866;3019
315740;201311;1021;3372;890;3111;266;1076;372;1188;638;2264
315750;201311;1115;3531;1006;3379;112;474;733;2388;845;2862
315760;201311;927;2666;907;2637;24;62;861;2525;885;2587
315765;201311;1444;4608;1350;4451;180;628;1000;3342;1180;3970
315770;201311;1648;5391;1505;5081;470;1721;537;1755;1007;3476
315780;201311;24333;81783;22651;78128;8100;29836;6944;24095;15044;53931
315790;201311;3145;11110;2878;10522;345;1237;1917;7271;2262;8508
315800;201311;1532;6092;1283;5344;420;1916;232;921;652;2837
315810;201311;1463;4308;1260;3977;274;914;733;2259;1007;3173
315820;201311;3029;10226;2613;9607;686;2675;1388;5195;2074;7870
315830;201311;1469;5051;1341;4761;345;1401;422;1429;767;2830
315840;201311;683;1944;546;1668;110;378;164;465;274;843
315850;201311;1333;4831;1288;4728;399;1528;503;1817;902;3345
315860;201311;419;1582;354;1431;121;552;76;304;197;856
315870;201311;467;1434;401;1329;110;406;154;478;264;884
315880;201311;1081;3045;908;2828;276;983;406;1231;682;2214
315890;201311;1624;5669;1477;5437;439;1670;741;2875;1180;4545
315895;201311;5012;16084;4673;15427;1485;5406;1967;6313;3452;11719
315900;201311;764;2508;709;2409;198;792;360;1113;558;1905
315910;201311;604;2204;558;2108;231;903;216;800;447;1703
315920;201311;1335;4124;1032;3467;302;1130;333;1034;635;2164
315930;201311;1100;3171;921;2843;292;981;297;877;589;1858
315935;201311;1155;3966;1079;3798;348;1339;343;1169;691;2508
315940;201311;631;2092;582;2006;170;654;272;909;442;1563
315950;201311;1217;3852;1139;3700;347;1152;619;2048;966;3200
315960;201311;2881;10123;2347;9002;1099;4800;215;730;1314;5530
315970;201311;809;2334;658;2110;82;262;488;1619;570;1881
315980;201311;3982;10361;2864;8405;812;2725;889;2283;1701;5008
315990;201311;4298;13192;3801;12390;900;3449;2027;6439;2927;9888
316000;201311;571;1910;499;1780;237;918;128;434;365;1352
316010;201311;450;1682;402;1564;117;528;92;298;209;826
316020;201311;1173;3832;935;3416;178;735;526;1952;704;2687
316030;201311;3624;10492;2650;8898;400;1503;1437;4922;1837;6425
316040;201311;3408;10875;2433;8568;439;1757;315;865;754;2622
316045;201311;2075;6906;1934;6678;288;898;1358;5010;1646;5908
316050;201311;361;1206;319;1136;70;272;174;616;244;888
316060;201311;775;2404;641;2212;126;539;372;1214;498;1753
316070;201311;6001;20471;5575;19582;1857;7183;2346;7876;4203;15059
316080;201311;723;2763;647;2546;170;750;146;571;316;1321
316090;201311;605;1833;458;1521;120;472;126;372;246;844
316095;201311;1267;4273;1166;4073;339;1241;658;2344;997;3585
316100;201311;2794;9655;2258;8253;689;2800;439;1495;1128;4295
316105;201311;919;2650;701;2304;172;619;313;1051;485;1670
316110;201311;12266;44219;11151;42100;1512;6506;7858;30147;9370;36653
316120;201311;1263;4493;1204;4366;411;1546;478;1754;889;3300
316130;201311;1095;2767;845;2399;209;691;408;1148;617;1839
316140;201311;1063;3232;832;2840;152;566;478;1663;630;2229
316150;201311;1261;4040;1203;3946;322;1227;624;1966;946;3193
316160;201311;1223;3762;996;3309;140;511;575;1941;715;2452
316165;201311;914;2620;790;2419;165;582;437;1297;602;1879
316170;201311;1401;4187;1060;3550;246;952;414;1286;660;2238
316180;201311;1206;3957;997;3544;302;1251;291;954;593;2205
316190;201311;2658;8291;1412;5021;302;1133;245;746;547;1879
316200;201311;4189;13776;3300;12045;981;4142;929;3229;1910;7371
316210;201311;4961;16470;4611;15743;2140;7828;948;3217;3088;11045
316220;201311;642;2038;477;1742;142;589;71;269;213;858
316225;201311;1070;3224;950;3056;150;563;628;1964;778;2527
316230;201311;444;1373;366;1228;76;279;192;654;268;933
316240;201311;6150;20078;5409;19159;685;2401;4130;14947;4815;17348
316245;201311;2987;10823;2827;10557;281;1289;2188;8128;2469;9417
316250;201311;8942;28913;7915;26758;3308;12017;2076;6625;5384;18642
316255;201311;2333;7622;2084;7326;349;1177;1468;5310;1817;6487
316257;201311;1317;3843;1041;3352;292;1075;380;1125;672;2200
316260;201311;1782;5241;1385;4675;372;1387;730;2475;1102;3862
316265;201311;1171;3476;1036;3199;98;348;737;2249;835;2597
316270;201311;5124;16887;4787;16185;1488;5480;1974;6719;3462;12199
316280;201311;3246;11111;2933;10474;655;2608;1490;5303;2145;7911
316290;201311;3105;10579;2892;10158;786;3121;1267;4199;2053;7320
316292;201311;3715;12634;3425;12056;1057;4156;1406;4658;2463;8814
316294;201311;781;2630;499;1919;128;581;69;249;197;830
316295;201311;1932;6977;1809;6711;467;2005;907;3138;1374;5143
316300;201311;934;3031;829;2835;94;343;559;1965;653;2308
316310;201311;692;2237;531;1890;132;521;183;644;315;1165
316320;201311;559;1921;498;1833;139;578;121;425;260;1003
316330;201311;955;2969;819;2717;155;516;465;1587;620;2103
316340;201311;1138;3788;1016;3541;359;1412;260;807;619;2219
316350;201311;1474;4934;1340;4702;281;1014;741;2760;1022;3774
316360;201311;761;2036;611;1835;79;239;459;1404;538;1643
316370;201311;5023;16931;4480;15806;1567;5934;1018;3654;2585;9588
316380;201311;1428;4115;1175;3729;141;502;806;2569;947;3071
316390;201311;899;2783;764;2546;280;1025;293;978;573;2003
316400;201311;1463;4996;1295;4672;356;1381;514;1901;870;3282
316410;201311;1211;4166;1134;4044;234;916;693;2470;927;3386
316420;201311;2003;6946;1858;6743;302;1228;1195;4405;1497;5633
316430;201311;905;2847;776;2623;254;945;276;894;530;1839
316440;201311;610;2095;538;1998;238;1004;188;649;426;1653
316443;201311;689;2146;583;1930;150;549;210;672;360;1221
316447;201311;1328;4518;1269;4412;184;719;987;3397;1171;4116
316450;201311;2194;7838;1955;7346;494;1883;1072;4180;1566;6063
316460;201311;854;2759;803;2676;225;856;443;1388;668;2244
316470;201311;7869;26544;6218;22703;2168;8970;1769;6041;3937;15011
316480;201311;253;895;225;837;66;261;72;256;138;517
316490;201311;361;1189;343;1146;121;431;141;463;262;894
316500;201311;1059;3939;745;2957;209;896;50;179;259;1075
316510;201311;945;3487;858;3315;365;1459;261;1012;626;2471
316520;201311;1191;3789;994;3480;288;1177;368;1176;656;2353
316530;201311;1182;3922;1000;3524;285;1195;399;1230;684;2425
316540;201311;1014;3382;913;3200;274;1135;313;986;587;2121
316550;201311;1255;4377;1158;4220;260;1065;720;2604;980;3669
316553;201311;2241;8410;1894;7518;672;2858;405;1560;1077;4418
316555;201311;2756;9877;2481;9551;246;950;1970;7759;2216;8709
316556;201311;587;1716;486;1519;53;207;324;964;377;1171
316557;201311;741;2781;716;2738;300;1190;265;1014;565;2204
316560;201311;371;1268;306;1113;79;348;83;264;162;612
316570;201311;1397;4546;1261;4256;255;941;654;2191;909;3132
316580;201311;279;836;230;752;70;246;75;224;145;470
316590;201311;1343;4094;1131;3703;218;853;629;1983;847;2836
316600;201311;1170;3887;1062;3660;187;704;632;2129;819;2833
316610;201311;605;2288;566;2215;145;655;322;1235;467;1890
316620;201311;2142;7056;1928;6611;507;1918;876;2978;1383;4896
316630;201311;1507;5140;1343;4784;577;2159;383;1375;960;3534
316640;201311;258;868;232;816;68;279;91;292;159;571
316650;201311;930;3699;831;3520;203;875;449;2007;652;2882
316660;201311;137;424;119;393;33;138;44;122;77;260
316670;201311;1807;5488;1473;4795;566;2092;309;856;875;2948
316680;201311;1931;5935;1707;5578;236;798;1289;4285;1525;5083
316690;201311;1122;3896;1015;3699;398;1624;320;1109;718;2733
316695;201311;1250;3935;1113;3691;114;377;740;2561;854;2938
316700;201311;353;1205;327;1138;80;323;157;506;237;829
316710;201311;3396;13242;2981;12294;1060;4530;902;3938;1962;8468
316720;201311;20081;69231;17299;62860;6418;24626;4379;15729;10797;40355
316730;201311;426;1392;373;1277;100;384;183;576;283;960
316740;201311;740;2619;672;2484;274;1106;179;624;453;1730
316750;201311;416;1487;384;1413;117;500;132;436;249;936
316760;201311;3592;12363;3086;11794;1834;7050;842;3444;2676;10494
316770;201311;1475;4490;1316;4269;228;820;869;2890;1097;3710
316780;201311;696;2451;654;2368;272;1054;169;590;441;1644
316790;201311;838;2516;630;2153;181;716;227;738;408;1454
316800;201311;5849;19885;5334;18894;1187;4907;2744;9297;3931;14204
316805;201311;882;2398;837;2341;143;386;617;1783;760;2169
316810;201311;534;1700;494;1621;141;508;228;724;369;1232
316820;201311;386;1130;266;927;113;432;46;144;159;576
316830;201311;587;2169;564;2119;217;875;203;732;420;1607
316840;201311;3117;9594;2718;8842;825;3050;1072;3285;1897;6335
316850;201311;2102;6822;1946;6537;474;1777;1031;3418;1505;5195
316860;201311;23715;75406;21607;71412;6283;23052;9535;31310;15818;54362
316870;201311;6991;23944;6180;21946;2380;9099;1347;4658;3727;13757
316880;201311;881;3059;851;3008;367;1424;243;810;610;2234
316890;201311;1428;3796;1141;3402;500;1643;386;1103;886;2746
316900;201311;2681;8661;2364;8010;765;2905;746;2275;1511;5180
316905;201311;430;1535;397;1459;172;673;108;378;280;1051
316910;201311;691;2446;578;2201;157;635;237;922;394;1557
316920;201311;1510;4711;1225;4233;199;767;618;2117;817;2884
316930;201311;9445;33300;8318;30913;2656;11215;2179;7654;4835;18869
316935;201311;4775;14627;3579;12505;1281;4993;873;2856;2154;7849
316940;201311;6857;23744;5871;21605;1608;6549;1668;5920;3276;12469
316950;201311;1495;4542;1321;4304;225;865;858;2747;1083;3612
316960;201311;5222;14040;4458;13040;1023;3279;2568;7465;3591;10744
316970;201311;3479;11731;3299;11397;1389;5374;840;2663;2229;8037
316980;201311;923;2985;757;2708;376;1427;193;697;569;2124
316990;201311;9805;33541;8935;31545;3802;14515;1322;4451;5124;18966
317000;201311;2534;9419;2463;9327;286;858;2032;8122;2318;8980
317005;201311;2382;7962;2292;7841;429;1519;1624;5621;2053;7140
317010;201311;29051;81692;19741;65269;5932;21809;4930;16827;10862;38636
317020;201311;46853;142256;32304;110979;8790;33320;7630;24481;16420;57801
317030;201311;876;2527;738;2319;133;509;416;1284;549;1793
317040;201311;12709;39816;11416;37381;4338;14915;4132;13760;8470;28675
317043;201311;812;2371;682;2190;200;692;340;1088;540;1780
317047;201311;1136;3122;897;2712;164;569;428;1275;592;1844
317050;201311;1810;6636;1591;6122;489;2061;516;1902;1005;3963
317052;201311;2372;7846;2121;7464;304;1162;1520;5414;1824;6576
317057;201311;1745;5196;1379;4557;248;984;691;2251;939;3235
317060;201311;383;1164;291;954;82;309;107;323;189;632
317065;201311;1210;4127;1095;3931;166;679;775;2763;941;3442
317070;201311;9340;31783;7444;27459;2416;9808;1702;6339;4118;16147
317075;201311;1243;3977;1099;3716;412;1512;370;1175;782;2687
317080;201311;6870;20375;6347;19508;2097;7005;2388;7368;4485;14373
317090;201311;4781;16738;4489;16196;764;2887;2974;10931;3738;13818
317100;201311;3246;9801;2821;9078;966;3477;1148;3478;2114;6955
317103;201311;1967;7017;1676;6378;374;1740;738;2735;1112;4475
317107;201311;1304;4188;1144;3863;286;1105;545;1744;831;2849
317110;201311;738;2085;521;1668;149;572;195;552;344;1124
317115;201311;1052;3460;939;3209;145;527;603;2059;748;2586
317120;201311;13099;45369;11374;41250;4018;15508;3995;14274;8013;29782
317130;201311;8841;28960;8043;27485;2302;8851;3452;11428;5754;20279
317140;201311;653;2311;612;2225;84;337;392;1420;476;1757
317150;201311;1035;2883;879;2700;115;424;631;1908;746;2332
317160;201311;3789;10437;2907;9301;448;1694;1891;5938;2339;7632
317170;201311;1908;5875;1804;5667;272;999;1072;3218;1344;4217
317180;201311;1782;6239;1436;5428;425;1756;437;1614;862;3370
317190;201311;1257;3910;1160;3777;103;380;933;3039;1036;3419
317200;201311;4327;14937;4038;14278;1481;5706;1014;3438;2495;9144
317210;201311;1068;3443;917;3196;281;1104;397;1364;678;2468
317220;201311;350;1279;342;1268;130;486;164;632;294;1118
320010;201311;5879;18819;5234;17307;921;3317;2783;9187;3704;12504
320013;201311;1950;5874;1457;4990;219;802;837;2941;1056;3743
320016;201311;3426;9809;2960;9143;533;1673;1981;6227;2514;7900
320020;201311;4188;13845;3862;13122;1368;4948;1401;4762;2769;9710
320030;201311;1732;5781;1564;5392;472;1761;640;2133;1112;3894
320035;201311;1672;5433;1524;5156;541;1982;502;1670;1043;3652
320040;201311;3087;10639;2606;9473;719;2832;788;2794;1507;5626
320050;201311;1895;5388;1613;4824;326;1088;869;2537;1195;3625
320060;201311;10755;34648;8586;29603;2314;8840;3013;9793;5327;18633
320070;201311;1802;6163;1581;5619;514;1972;412;1347;926;3319
320080;201311;5469;16580;4471;14552;1416;4976;1464;4675;2880;9651
320090;201311;8434;24901;7042;22307;2085;7118;3160;9711;5245;16829
320100;201311;3241;9902;2679;8765;666;2366;1227;3911;1893;6277
320110;201311;1551;4824;1418;4554;390;1353;471;1478;861;2831
320115;201311;1863;6917;1800;6772;671;2570;880;3385;1551;5955
320120;201311;16878;58743;15142;55259;5736;22273;4209;15428;9945;37701
320130;201311;39356;134394;36981;129218;11596;43843;16386;55841;27982;99684
320140;201311;4076;13498;2894;10477;754;3009;331;1134;1085;4143
320150;201311;17858;51916;13360;43101;4408;15244;2207;6978;6615;22222
320160;201311;5304;16682;4645;15567;1277;4812;2056;6491;3333;11303
320170;201311;1914;6418;1748;6051;622;2222;557;1971;1179;4193
320180;201311;910;3047;820;2905;299;1118;313;1099;612;2217
320190;201311;4256;15735;3923;14826;1474;5807;1105;4143;2579;9950
320200;201311;1121;3744;1006;3497;311;1169;427;1499;738;2668
320210;201311;6039;16873;5253;15521;1303;4366;2696;7725;3999;12091
320220;201311;2812;8802;2213;7714;680;2601;787;2745;1467;5346
320225;201311;1441;5204;1265;4718;465;1856;261;982;726;2838
320230;201311;4251;14491;3972;13949;1352;5146;1425;5122;2777;10268
320240;201311;9245;29089;7421;25421;2401;8760;1869;6554;4270;15314
320245;201311;4165;14488;3914;13884;1269;4732;1572;5568;2841;10300
320250;201311;1740;5545;1325;4552;358;1363;296;933;654;2296
320255;201311;2010;6833;1745;6372;727;2823;594;2246;1321;5069
320260;201311;1226;3935;996;3324;278;1026;380;1130;658;2156
320265;201311;2482;7723;2102;7260;283;1017;1522;5419;1805;6436
320270;201311;2363;7700;2049;7065;546;2009;952;3259;1498;5268
320280;201311;7204;22163;6642;21222;1356;4697;3875;12416;5231;17113
320290;201311;1526;5313;1385;4910;542;1999;348;1153;890;3152
320300;201311;4487;15428;4178;14768;1272;4787;1747;6195;3019;10982
320305;201311;4658;15648;4266;14718;1140;4354;1914;6408;3054;10762
320310;201311;1965;6093;1775;5764;437;1556;860;2693;1297;4249
320313;201311;2271;7067;1687;5686;489;1901;289;856;778;2757
320316;201311;2227;7121;2103;6827;611;2091;929;2994;1540;5085
320320;201311;18416;61057;16178;56597;5033;19595;6473;21999;11506;41594
320330;201311;2847;9001;2528;8416;589;1979;1399;4815;1988;6794
320332;201311;4896;16977;4479;16199;1480;5617;1883;7006;3363;12623
320334;201311;1446;5162;1192;4518;419;1762;229;785;648;2547
320335;201311;2097;6468;1630;5458;595;2194;296;934;891;3128
320340;201311;5650;16439;4593;14576;1180;4176;2068;6450;3248;10626
320350;201311;5502;14408;4117;12081;882;2955;1919;5465;2801;8420
320360;201311;1755;4790;1354;4051;279;942;656;1833;935;2775
320370;201311;3439;11651;2999;10751;935;3500;1172;4226;2107;7726
320380;201311;2706;8584;2423;8012;627;2207;1174;3788;1801;5995
320390;201311;8162;25344;6909;22824;2076;7646;2526;8056;4602;15702
320400;201311;4141;12103;3526;11221;748;2671;2095;6483;2843;9154
320405;201311;4163;12586;3836;12145;1185;4177;2058;6340;3243;10517
320410;201311;6075;15493;4554;13739;772;2412;3100;9491;3872;11903
320420;201311;2277;7255;1794;6487;792;3079;289;994;1081;4073
320425;201311;2456;6376;2022;5756;326;1122;1236;3462;1562;4584
320430;201311;2280;6903;2085;6533;407;1417;1100;3379;1507;4796
320435;201311;2184;7811;2000;7367;929;3553;639;2389;1568;5942
320440;201311;1486;5106;1335;4656;435;1632;394;1297;829;2929
320450;201311;2458;8108;2157;7458;648;2463;908;3041;1556;5504
320455;201311;4615;16718;3738;14472;1215;4910;739;2807;1954;7717
320460;201311;2895;9808;2415;8742;805;3134;728;2514;1533;5648
320465;201311;1521;5058;1272;4409;285;1039;506;1718;791;2757
320470;201311;4185;13325;3172;11055;1075;4092;485;1567;1560;5659
320480;201311;1950;6020;1630;5386;422;1613;685;2129;1107;3742
320490;201311;17545;57036;14829;51485;5207;19362;4871;17342;10078;36704
320495;201311;1293;4314;1145;3964;493;1837;296;988;789;2825
320500;201311;42569;138275;38241;129917;13270;48671;15910;52728;29180;101399
320501;201311;3647;12291;3395;11837;1176;4595;1448;4875;2624;9470
320503;201311;2236;8335;1967;7577;699;2856;481;1689;1180;4545
320506;201311;3197;10302;2253;7814;709;2676;309;988;1018;3664
320510;201311;8176;26726;7377;25082;2664;9677;2655;8863;5319;18540
320515;201311;2089;6069;1860;5627;526;1705;704;2114;1230;3819
320517;201311;2145;7303;1839;6612;690;2674;409;1385;1099;4059
320520;201311;31238;103683;27255;95710;9260;35764;11334;39403;20594;75167
320530;201311;27318;87472;23629;79804;6735;25721;9983;32080;16718;57801
330010;201311;15586;50968;14606;48877;3473;13165;8273;26536;11746;39701
330015;201311;1954;5608;1714;5135;524;1753;580;1658;1104;3411
330020;201311;16211;50122;14928;48009;3810;13192;8092;25845;11902;39037
330022;201311;1611;5277;1448;4956;338;1334;770;2527;1108;3861
330023;201311;3342;11073;3145;10661;878;3274;1272;4151;2150;7425
330025;201311;3267;10237;3034;9878;763;2671;1830;5914;2593;8585
330030;201311;7452;26333;6863;25057;2135;8569;2833;9819;4968;18388
330040;201311;14226;41406;12158;38102;3400;11499;6094;18744;9494;30243
330045;201311;63128;187184;58286;179761;9324;30983;39844;122701;49168;153684
330050;201311;2933;9578;2608;8905;973;3726;687;2153;1660;5879
330060;201311;5402;17105;4912;16382;1151;4331;2949;9859;4100;14190
330070;201311;25066;79263;22990;75422;6752;23816;9976;32639;16728;56455
330080;201311;8746;26186;8402;25710;2111;6512;5174;16295;7285;22807
330090;201311;3149;9068;2976;8747;906;2880;1394;4019;2300;6899
330093;201311;1952;5802;1724;5424;428;1455;751;2334;1179;3789
330095;201311;1191;4201;1103;3988;437;1757;179;553;616;2310
330100;201311;54403;185605;51155;179753;12831;49936;25746;90769;38577;140705
330110;201311;2650;8544;2422;8103;836;3006;759;2518;1595;5524
330115;201311;2442;7547;2274;7246;771;2684;912;2804;1683;5488
330120;201311;2485;7450;2276;7152;731;2440;959;2977;1690;5417
330130;201311;3952;13279;3595;12560;1216;4602;1338;4638;2554;9240
330140;201311;3372;10456;3073;10032;813;2942;1460;4746;2273;7688
330150;201311;2572;7849;1976;6560;584;2140;431;1371;1015;3511
330160;201311;1373;4886;1292;4704;490;1943;405;1416;895;3359
330170;201311;101634;314824;95625;305293;14604;50042;68261;218207;82865;268249
330180;201311;1685;5307;1543;5024;265;1102;985;2977;1250;4079
330185;201311;7824;25279;7332;24452;1974;6910;3964;13584;5938;20494
330187;201311;4247;12353;3819;11641;832;2881;2231;6718;3063;9599
330190;201311;27742;85625;26508;83540;6938;23326;15389;47719;22327;71045
330200;201311;13227;42737;12133;40517;2877;9911;6601;22446;9478;32357
330205;201311;2551;7092;2319;6712;525;1769;1180;3268;1705;5037
330210;201311;4618;12249;3435;10032;1052;3371;813;2335;1865;5706
330220;201311;11126;35854;10458;34535;3639;13031;3428;10827;7067;23858
330225;201311;3991;12819;3773;12470;639;2475;2612;8583;3251;11058
330227;201311;17518;50544;15906;48293;3784;12348;9328;27705;13112;40053
330230;201311;1506;4513;1380;4286;434;1524;528;1503;962;3027
330240;201311;20162;63484;17978;59594;7064;25565;3293;10588;10357;36153
330245;201311;1208;3945;1009;3528;320;1218;222;773;542;1991
330250;201311;37123;110616;34994;107144;10020;31238;18806;58719;28826;89957
330260;201311;3492;11291;3273;10828;882;3196;1453;4630;2335;7826
330270;201311;13873;41696;11875;38388;3643;12567;4551;14813;8194;27380
330280;201311;1951;6312;1686;5754;398;1559;786;2497;1184;4056
330285;201311;17380;53140;16025;51195;3678;12455;9796;31400;13474;43855
330290;201311;3479;9936;3123;9465;659;2295;1793;5154;2452;7449
330300;201311;4117;13670;3935;13348;978;3578;2039;6986;3017;10564
330310;201311;2757;8187;2519;7782;634;2080;1248;3807;1882;5887
330320;201311;11934;36397;11219;35273;1926;6537;7776;24434;9702;30971
330330;201311;31286;91553;28983;87905;7501;24554;16862;50401;24363;74955
330340;201311;14139;44809;11731;39828;3733;13737;3487;11637;7220;25374
330350;201311;91736;299373;89354;295959;16943;56472;63156;213059;80099;269531
330360;201311;5449;17507;5320;17297;825;2951;3888;12532;4713;15483
330370;201311;3758;14178;3558;13667;1434;5719;1178;4563;2612;10282
330380;201311;4221;14039;3751;13207;1131;4285;1720;6049;2851;10334
330385;201311;4033;14236;3730;13606;1300;5038;1333;4841;2633;9879
330390;201311;23659;81088;21763;77222;5450;21635;11247;39022;16697;60657
330395;201311;3316;10123;3103;9748;536;1833;1961;6201;2497;8034
330400;201311;2563;8725;2343;8293;564;2309;1141;3701;1705;6010
330410;201311;3064;9926;2646;9049;648;2327;1275;4379;1923;6706
330411;201311;2497;8024;2254;7526;497;1914;1171;3670;1668;5584
330412;201311;1371;4811;1106;4282;271;1188;413;1549;684;2737
330414;201311;25608;73851;21965;68869;4606;15374;13399;42098;18005;57472
330415;201311;3676;11773;3259;10992;841;3179;1422;4767;2263;7946
330420;201311;7500;24917;5946;21580;1869;7429;1054;3833;2923;11262
330430;201311;8168;24638;7351;23160;1823;6394;3585;10981;5408;17375
330440;201311;2111;7162;1769;6428;605;2460;413;1391;1018;3851
330450;201311;1603;5682;1509;5478;486;1979;576;2032;1062;4011
330452;201311;10592;33234;8816;29623;2538;9448;3545;11363;6083;20811
330455;201311;461127;1382119;398110;1276518;110705;379853;198433;633493;309138;1013346
330460;201311;1389;4765;1306;4600;370;1472;619;2138;989;3610
330470;201311;4298;14451;4046;13925;1497;5546;1214;4063;2711;9609
330475;201311;8141;26476;7416;25285;1960;7366;3796;12911;5756;20277
330480;201311;6430;19770;6035;19027;1778;6048;2481;7739;4259;13787
330490;201311;99268;283596;92630;273718;13467;41940;69492;206017;82959;247957
330500;201311;6820;21095;6401;20257;1482;5059;3326;10796;4808;15855
330510;201311;41507;136520;39268;132708;14024;48216;18206;63202;32230;111418
330513;201311;1578;4812;1458;4574;578;1908;473;1464;1051;3372
330515;201311;3054;9717;2813;9294;976;3469;1018;3315;1994;6784
330520;201311;13311;40450;12309;38800;3192;10592;6745;21376;9937;31968
330530;201311;1537;4678;1422;4476;395;1389;715;2161;1110;3550
330540;201311;3279;10149;2863;9487;907;3247;1104;3550;2011;6797
330550;201311;8932;29994;7960;28185;3313;12433;1947;6992;5260;19425
330555;201311;10308;32001;9296;30407;1902;6459;5825;19381;7727;25840
330560;201311;4162;13008;3905;12571;864;3233;2200;6884;3064;10117
330570;201311;3651;10703;3189;9932;842;2753;1659;5245;2501;7998
330575;201311;5350;16550;4955;15817;1176;4058;2947;9114;4123;13172
330580;201311;16566;54664;14690;50833;5158;18683;5105;18101;10263;36784
330590;201311;1940;5994;1831;5808;569;1909;880;2789;1449;4698
330600;201311;9450;28937;8176;26891;1278;5219;5240;16416;6518;21635
330610;201311;8832;29158;8129;27808;2245;8511;3856;12989;6101;21500
330615;201311;1675;6036;1547;5682;637;2447;534;2016;1171;4463
330620;201311;3943;14086;3626;13440;1320;5156;1067;4130;2387;9286
330630;201311;20634;69150;18727;65046;5406;20897;8664;28689;14070;49586
350010;201311;2874;9296;2322;8014;730;2707;435;1424;1165;4131
350020;201311;594;1725;461;1472;123;450;169;495;292;945
350030;201311;4665;15183;3973;13638;1423;5349;1206;4069;2629;9418
350040;201311;587;2169;516;2011;176;749;104;364;280;1113
350050;201311;1396;4637;1160;4188;319;1316;378;1241;697;2557
350055;201311;603;2057;579;2014;174;659;278;949;452;1608
350060;201311;85;293;79;283;25;111;28;84;53;195
350070;201311;2630;8894;2157;7746;548;2182;447;1426;995;3608
350075;201311;493;1812;446;1699;156;633;117;414;273;1047
350080;201311;588;1771;470;1525;132;493;169;533;301;1026
350090;201311;594;1729;448;1476;125;444;124;372;249;816
350100;201311;1864;6608;1682;6197;616;2441;504;1797;1120;4238
350110;201311;452;1397;360;1185;107;393;110;321;217;714
350115;201311;1305;4355;1159;3969;283;1112;508;1585;791;2697
350120;201311;690;1962;458;1487;136;487;106;326;242;813
350130;201311;3677;11478;3343;10806;885;3183;1416;4238;2301;7421
350140;201311;687;2193;624;2062;161;616;250;771;411;1387
350150;201311;436;1504;398;1414;152;573;97;341;249;914
350160;201311;6055;19501;4670;16412;1482;5732;1641;5315;3123;11047
350170;201311;2239;8068;2010;7474;759;2934;461;1622;1220;4556
350180;201311;1438;3805;1191;3376;304;908;520;1451;824;2359
350190;201311;3134;11013;2704;10117;916;3854;1033;3497;1949;7351
350200;201311;425;1478;383;1404;134;555;130;451;264;1006
350210;201311;7472;21444;5985;18781;2379;8049;1853;5513;4232;13562
350220;201311;3118;10206;2824;9655;1032;3954;808;2477;1840;6431
350230;201311;739;2562;680;2462;239;938;224;805;463;1743
350240;201311;598;1834;518;1709;121;472;280;874;401;1346
350250;201311;2737;10276;2624;10040;1131;4586;829;3139;1960;7725
350260;201311;1045;2846;884;2561;213;634;377;1133;590;1767
350270;201311;5244;16500;4695;15371;1124;3991;2216;7213;3340;11204
350275;201311;2015;6741;1801;6406;552;2152;710;2375;1262;4527
350280;201311;22388;60398;14522;45396;3939;13168;3041;9580;6980;22748
350290;201311;1703;6036;1534;5635;481;1847;454;1714;935;3561
350300;201311;486;1563;451;1483;156;555;141;463;297;1018
350310;201311;1011;3411;947;3274;235;955;412;1357;647;2312
350315;201311;556;1795;456;1584;76;336;153;500;229;836
350320;201311;11991;40069;10971;37654;3577;13113;1944;6470;5521;19583
350330;201311;9522;28680;8422;26345;2040;7130;4465;13026;6505;20156
350335;201311;550;1635;503;1535;129;413;195;650;324;1063
350340;201311;1027;3323;806;2892;226;889;212;747;438;1636
350350;201311;765;2502;673;2352;191;757;229;799;420;1556
350360;201311;812;2890;709;2648;225;887;244;925;469;1812
350370;201311;706;2212;531;1785;109;410;119;358;228;768
350380;201311;3686;12215;3113;11301;1349;5257;661;2274;2010;7531
350390;201311;8575;28271;7710;26652;2003;7521;3875;12938;5878;20459
350395;201311;298;985;241;858;76;286;47;162;123;448
350400;201311;8082;24258;6714;21738;2056;7281;2385;7373;4441;14654
350410;201311;7427;28005;6656;26149;2453;10388;1644;6209;4097;16597
350420;201311;1019;3272;822;2873;394;1462;77;262;471;1724
350430;201311;878;2788;763;2587;210;850;375;1206;585;2056
350440;201311;1384;4505;1306;4359;483;1715;594;1919;1077;3634
350450;201311;8203;25537;6821;22743;2269;8121;1857;5975;4126;14096
350460;201311;1512;4540;1104;3650;335;1214;318;930;653;2144
350470;201311;215;658;191;622;56;207;82;244;138;451
350480;201311;771;2425;511;1773;97;378;91;271;188;649
350490;201311;2097;6180;1799;5773;515;1924;873;2614;1388;4538
350500;201311;612;1836;531;1710;137;491;230;694;367;1185
350510;201311;1103;3585;957;3270;313;1213;340;1031;653;2244
350520;201311;1268;4991;1157;4749;451;1931;291;1165;742;3096
350530;201311;2517;7707;2075;6710;826;2892;498;1446;1324;4338
350535;201311;1470;4395;1433;4344;79;271;1264;3845;1343;4116
350540;201311;2050;6016;1751;5492;508;1741;674;2116;1182;3857
350550;201311;10827;32410;8719;28663;2572;9513;3260;10003;5832;19516
350560;201311;3459;11780;3152;11160;657;2491;1665;6040;2322;8531
350570;201311;20704;72894;18942;68700;6263;24304;6805;23651;13068;47955
350580;201311;1994;6655;1693;5996;527;2066;263;792;790;2858
350590;201311;3993;13388;3225;11645;1055;4230;1100;3578;2155;7808
350600;201311;38033;98968;26657;80817;5889;19492;12816;37700;18705;57192
350610;201311;8990;26801;7329;24065;2072;7650;3370;10594;5442;18244
350620;201311;443;1426;380;1314;88;346;163;539;251;885
350630;201311;1628;5214;1282;4511;410;1634;131;402;541;2036
350635;201311;4958;16407;4018;14485;1247;4712;1527;5557;2774;10269
350640;201311;687;2209;593;1966;195;700;201;630;396;1330
350650;201311;4026;13547;3057;11178;1231;4894;290;1016;1521;5910
350660;201311;3773;12249;3323;11441;971;3563;1508;5139;2479;8702
350670;201311;1856;5882;1747;5692;361;1337;1107;3458;1468;4795
350680;201311;1198;3783;967;3308;297;1203;380;1227;677;2430
350690;201311;1062;3651;912;3314;290;1169;230;765;520;1934
350700;201311;2664;9382;2330;8599;928;3802;851;2771;1779;6573
350710;201311;2152;6897;1962;6594;361;1386;1267;4184;1628;5570
350715;201311;1123;3484;995;3230;266;966;380;1154;646;2120
350720;201311;130;417;122;395;51;183;42;118;93;301
350730;201311;418;1624;401;1574;126;551;110;390;236;941
350740;201311;2376;7330;2142;6795;599;2068;878;2779;1477;4847
350745;201311;349;1129;283;964;69;276;122;358;191;634
350750;201311;9682;30387;7484;25883;2193;8352;1884;6074;4077;14426
350760;201311;11903;38778;10863;36871;3693;13983;4594;14655;8287;28638
350770;201311;897;2715;651;2213;146;570;237;786;383;1356
350775;201311;628;1900;571;1790;139;500;249;774;388;1274
350780;201311;2088;6462;1569;5338;413;1554;258;852;671;2406
350790;201311;2113;7051;1698;6130;565;2152;348;1137;913;3289
350800;201311;3068;10673;2926;10427;682;2725;1715;5977;2397;8702
350810;201311;2604;7777;2283;7181;775;2636;754;2438;1529;5074
350820;201311;526;1485;393;1197;93;324;139;375;232;699
350830;201311;886;2840;629;2174;124;477;126;356;250;833
350840;201311;2332;8529;1930;7423;649;2735;355;1167;1004;3902
350850;201311;6840;23581;5659;20635;1920;7432;1340;4612;3260;12044
350860;201311;3382;11163;3253;10968;538;2057;2385;7997;2923;10054
350870;201311;2402;8362;2168;8000;777;3060;1043;3854;1820;6914
350880;201311;1683;5813;1439;5253;449;1755;279;1017;728;2772
350890;201311;638;1937;511;1658;96;340;168;463;264;803
350900;201311;4580;15579;3843;13929;1098;4339;1187;4022;2285;8361
350910;201311;870;2766;831;2680;379;1274;268;852;647;2126
350920;201311;9596;29498;8945;28389;1758;6198;5633;17221;7391;23419
350925;201311;5307;16846;4785;15793;1468;5309;2038;6510;3506;11819
350930;201311;1541;4358;1297;3945;167;627;904;2631;1071;3258
350940;201311;2304;7805;2112;7483;453;1893;1283;4327;1736;6220
350945;201311;934;3171;828;2944;231;911;333;1130;564;2041
350950;201311;71137;232210;60508;210161;18357;69517;24062;80989;42419;150506
350960;201311;4544;16319;4058;15216;842;3616;2186;7853;3028;11469
350970;201311;4194;15557;3834;14647;1544;6368;1138;4185;2682;10553
350980;201311;671;2207;621;2124;284;1060;122;409;406;1469
350990;201311;1779;6377;1588;6003;578;2364;529;1964;1107;4328
350995;201311;811;2979;769;2895;227;969;362;1293;589;2262
351000;201311;3518;11026;3071;10150;546;2135;1772;5591;2318;7726
351010;201311;422;1305;310;1060;123;460;62;214;185;674
351015;201311;952;3220;823;2975;320;1313;224;720;544;2033
351020;201311;7706;25827;6852;24480;1916;7360;3569;12952;5485;20312
351030;201311;1366;5163;1264;4919;375;1647;416;1544;791;3191
351040;201311;3663;11948;3390;11468;842;3329;1962;6211;2804;9540
351050;201311;8924;29675;7385;26577;2671;10403;2441;8731;5112;19134
351060;201311;32455;103802;27478;94424;9533;34595;9193;31760;18726;66355
351070;201311;1806;5249;1303;4322;474;1723;240;701;714;2424
351080;201311;2759;8471;2179;7754;680;2617;908;3176;1588;5793
351090;201311;386;1365;308;1196;111;491;52;182;163;673
351100;201311;1870;6180;1685;5787;652;2276;510;1782;1162;4058
351110;201311;7694;22850;5737;19169;1985;7274;1679;5306;3664;12580
351120;201311;600;1877;506;1655;77;305;249;731;326;1036
351130;201311;856;2392;443;1527;91;362;112;337;203;699
351140;201311;1997;7036;1823;6652;711;2847;555;1948;1266;4795
351150;201311;2206;7774;1800;6671;514;2094;432;1439;946;3533
351160;201311;1506;5397;1361;5046;478;1968;447;1593;925;3561
351170;201311;1623;5445;1300;4673;379;1463;491;1623;870;3086
351190;201311;866;2886;751;2577;195;709;156;475;351;1184
351200;201311;2216;6782;1909;6198;358;1373;942;2782;1300;4155
351210;201311;1068;3423;911;3106;299;1112;277;880;576;1992
351220;201311;3521;12090;3090;11155;920;3634;1245;4391;2165;8025
351230;201311;1876;6435;1698;6074;566;2239;768;2672;1334;4911
351240;201311;1029;3411;744;2732;220;901;186;603;406;1504
351250;201311;866;2561;652;2111;146;520;305;946;451;1466
351260;201311;1194;3628;1060;3343;301;1037;400;1198;701;2235
351270;201311;384;1405;348;1328;124;544;108;365;232;909
351280;201311;4466;14222;3679;12334;1106;3964;1086;3278;2192;7242
351290;201311;1000;3125;880;2871;285;967;257;791;542;1758
351300;201311;9956;37321;8728;34339;2617;11175;3188;12426;5805;23601
351310;201311;3364;10725;2830;9714;745;2948;1321;4190;2066;7138
351320;201311;1008;3626;891;3348;320;1308;200;665;520;1973
351330;201311;287;846;257;787;104;323;70;208;174;531
351340;201311;6623;23452;6026;22222;1798;7003;2965;10949;4763;17952
351350;201311;7861;26373;7022;24519;2187;8017;2581;8719;4768;16736
351360;201311;4907;15221;4618;14720;1300;4675;2140;6614;3440;11289
351370;201311;1924;6403;1565;5614;544;2174;356;1131;900;3305
351380;201311;37176;118964;34681;113768;9602;34355;16193;50874;25795;85229
351385;201311;251;804;245;794;96;322;87;277;183;599
351390;201311;1230;4233;1101;3960;436;1675;344;1177;780;2852
351400;201311;1228;4010;1153;3847;411;1453;417;1422;828;2875
351410;201311;2916;9067;2596;8490;637;2244;1281;4117;1918;6361
351420;201311;456;1358;317;1042;74;264;52;154;126;418
351430;201311;882;2851;796;2689;178;659;491;1633;669;2292
351440;201311;4670;14546;4074;13260;1603;5467;1036;3173;2639;8640
351450;201311;1804;5226;1589;4942;494;1573;823;2649;1317;4222
351460;201311;829;2665;695;2393;341;1263;195;620;536;1883
351470;201311;1084;3402;968;3182;395;1426;284;908;679;2334
351480;201311;2957;9876;2700;9433;703;2914;1284;4323;1987;7237
351490;201311;1986;6832;1782;6389;389;1642;962;3279;1351;4921
351492;201311;294;1013;216;796;49;214;60;180;109;394
351495;201311;150;535;128;472;42;163;44;155;86;318
351500;201311;19947;65670;17891;61630;5739;21342;7204;24252;12943;45594
351510;201311;7500;24814;6497;23059;1673;6448;3326;11716;4999;18164
351512;201311;391;1204;348;1118;93;319;138;436;231;755
351515;201311;1865;6477;1613;5878;553;2172;432;1486;985;3658
351518;201311;1595;5647;1217;4960;388;1732;226;862;614;2594
351519;201311;779;2600;677;2362;200;806;256;825;456;1631
351520;201311;802;2294;385;1397;66;277;49;162;115;439
351530;201311;466;1493;401;1330;89;317;122;351;211;668
351535;201311;2627;6968;2148;6254;275;922;1444;4118;1719;5040
351540;201311;2106;6874;1894;6483;962;3462;350;1185;1312;4647
351550;201311;5720;17842;4511;15275;1640;5836;1196;3962;2836;9798
351560;201311;428;1440;371;1297;143;544;59;197;202;741
351565;201311;238;816;221;770;67;281;86;261;153;542
351570;201311;13141;43984;11517;40531;3783;13819;4820;16996;8603;30815
351580;201311;400;1146;300;920;47;153;114;324;161;477
351590;201311;454;1302;389;1149;142;451;79;216;221;667
351600;201311;1870;5548;1713;5254;426;1530;818;2273;1244;3803
351610;201311;653;1854;557;1685;124;438;278;786;402;1224
351620;201311;21787;73997;17903;65231;5827;23064;4515;15183;10342;38247
351630;201311;14717;50706;13566;48769;3935;14651;7211;26327;11146;40978
351640;201311;7936;26640;6793;24519;1826;7174;3444;12229;5270;19403
351650;201311;364;1122;239;803;64;240;38;114;102;354
351660;201311;877;2797;688;2356;171;668;197;600;368;1268
351670;201311;4188;13447;3555;12091;770;2988;1739;5601;2509;8589
351680;201311;620;1940;433;1476;103;376;78;236;181;612
351685;201311;442;1363;353;1204;111;397;119;417;230;814
351690;201311;1331;4001;1042;3353;458;1484;257;781;715;2265
351700;201311;1454;4469;1320;4216;446;1494;442;1366;888;2860
351710;201311;797;2541;664;2235;169;579;196;621;365;1200
351720;201311;1634;5296;1253;4271;280;1070;435;1406;715;2476
351730;201311;1108;3382;942;3135;392;1447;282;881;674;2328
351740;201311;4537;13251;3906;11914;1094;3579;1290;3689;2384;7268
351750;201311;1503;5037;1303;4600;409;1571;341;1115;750;2686
351760;201311;3769;12415;3336;11425;888;3326;1484;4871;2372;8197
351770;201311;2248;7438;1951;6885;739;2703;823;2909;1562;5612
351780;201311;1612;4672;1100;3571;311;1117;239;728;550;1845
351790;201311;1132;3452;970;3223;313;1122;453;1469;766;2591
351800;201311;336;835;291;746;42;138;174;398;216;536
351810;201311;1192;3709;1128;3630;294;1104;690;2093;984;3197
351820;201311;2505;7595;1791;6229;686;2557;198;660;884;3217
351830;201311;4045;13559;3669;12703;949;3629;1675;5600;2624;9229
351840;201311;8892;31253;7960;29250;2760;10711;2543;9274;5303;19985
351850;201311;1234;4301;1059;3908;317;1297;207;685;524;1982
351860;201311;3584;11766;3325;11247;778;2986;1868;6025;2646;9011
351870;201311;35130;110980;32390;106166;7663;27157;19200;62536;26863;89693
351880;201311;115014;382110;101456;353922;33886;124473;31006;107727;64892;232200
351885;201311;645;2384;599;2274;170;681;263;968;433;1649
351890;201311;816;2476;640;2087;213;725;142;438;355;1163
351900;201311;1455;4561;1268;4243;412;1486;459;1537;871;3023
351905;201311;372;1358;324;1265;101;451;125;440;226;891
351907;201311;14568;47226;12791;43668;3074;11818;6219;20195;9293;32013
351910;201311;1156;3791;1063;3610;267;1021;354;1118;621;2139
351920;201311;1195;3527;1131;3432;277;963;670;1948;947;2911
351925;201311;969;2850;908;2748;121;461;648;1848;769;2309
351930;201311;3103;10849;2861;10319;866;3522;1196;3919;2062;7441
351940;201311;1006;3121;944;3003;288;1005;546;1664;834;2669
351950;201311;1267;3697;994;3156;233;801;419;1247;652;2048
351960;201311;3877;12599;3337;11533;1247;4580;1273;4296;2520;8876
351970;201311;6922;26685;6359;25457;2440;10308;2029;8046;4469;18354
351980;201311;947;2962;799;2674;188;743;331;996;519;1739
351990;201311;1590;4670;1296;4070;375;1381;374;1009;749;2390
352000;201311;2489;8148;2272;7698;574;2097;1008;3278;1582;5375
352010;201311;2279;7902;2079;7397;763;2850;466;1675;1229;4525
352020;201311;1502;4949;1350;4631;437;1575;430;1484;867;3059
352030;201311;4452;14311;4083;13826;974;3537;2333;8045;3307;11582
352040;201311;1800;6432;1538;5745;450;1791;363;1274;813;3065
352042;201311;2257;6602;1725;5478;452;1596;852;2626;1304;4222
352044;201311;1365;4741;1080;3986;278;1102;243;815;521;1917
352050;201311;7604;26252;5580;21415;1771;7456;997;3329;2768;10785
352060;201311;797;2420;711;2286;214;802;278;803;492;1605
352070;201311;732;2017;672;1918;293;903;196;586;489;1489
352080;201311;532;1672;455;1534;123;473;157;472;280;945
352090;201311;1677;5561;1389;4947;351;1395;474;1551;825;2946
352100;201311;1800;6269;1605;5872;550;2252;570;1864;1120;4116
352110;201311;428;1641;379;1517;111;493;109;410;220;903
352115;201311;378;1253;323;1134;98;378;147;486;245;864
352120;201311;979;2932;851;2752;174;592;499;1657;673;2249
352130;201311;1768;5047;1342;4296;362;1294;549;1600;911;2894
352140;201311;1371;4527;1089;3881;337;1261;426;1502;763;2763
352150;201311;602;1834;492;1632;175;627;178;566;353;1193
352160;201311;1234;3565;1135;3418;264;857;631;1909;895;2766
352170;201311;3155;9868;2887;9404;828;2911;1352;4226;2180;7137
352180;201311;3554;10392;3126;9596;878;2946;1397;4066;2275;7012
352190;201311;1049;3309;959;3140;225;899;477;1428;702;2327
352200;201311;416;1476;344;1329;76;326;155;607;231;933
352210;201311;15966;44318;12876;39720;2663;8756;7725;24337;10388;33093
352215;201311;561;1816;504;1728;81;308;289;1019;370;1327
352220;201311;14946;50732;13901;48530;4791;17754;5337;18543;10128;36297
352230;201311;13654;47776;12103;44799;3903;15783;4597;16642;8500;32425
352240;201311;10859;35304;10036;33778;3476;13091;3979;12695;7455;25786
352250;201311;22614;73984;19930;68442;5337;20060;8052;27227;13389;47287
352260;201311;5229;16474;3783;13459;1068;4227;1160;3748;2228;7975
352265;201311;934;3049;814;2860;139;557;510;1751;649;2308
352270;201311;2582;8899;2230;8070;892;3422;495;1696;1387;5118
352280;201311;2446;7801;2097;7205;611;2338;696;2322;1307;4660
352290;201311;1306;4299;1121;3874;284;1114;331;1021;615;2135
352300;201311;929;2852;782;2590;251;890;327;1075;578;1965
352310;201311;31106;107526;28340;102664;7953;30999;16049;57043;24002;88042
352320;201311;5825;18558;5107;17203;1697;6208;1683;5147;3380;11355
352330;201311;2178;7303;1910;6974;741;2910;657;2379;1398;5289
352340;201311;5749;20002;4734;17476;1679;6651;907;3082;2586;9733
352350;201311;1751;6555;1575;6133;448;1900;527;1962;975;3862
352360;201311;1183;3980;1053;3706;304;1267;555;1786;859;3053
352370;201311;894;3062;813;2879;196;778;379;1315;575;2093
352380;201311;1015;3297;888;3070;359;1385;246;810;605;2195
352390;201311;11356;35102;9053;30596;2149;8379;4226;13256;6375;21635
352400;201311;3144;9599;2141;7588;649;2539;852;2863;1501;5402
352410;201311;3712;11074;2841;9557;966;3537;867;2765;1833;6302
352420;201311;1295;3781;1200;3630;474;1592;421;1240;895;2832
352430;201311;6235;20055;5497;18778;2212;8204;1691;5581;3903;13785
352440;201311;15468;49825;12876;44649;3553;13318;5045;16973;8598;30291
352450;201311;623;1897;434;1525;121;462;91;283;212;745
352460;201311;2664;9106;2416;8647;892;3553;853;2805;1745;6358
352470;201311;4900;14075;3041;10166;635;2297;1317;4298;1952;6595
352480;201311;5453;15718;4483;13899;1260;4502;1844;5253;3104;9755
352490;201311;719;2628;608;2354;157;679;120;450;277;1129
352500;201311;10004;33528;9473;32576;4391;16102;2800;9020;7191;25122
352510;201311;3356;11857;2770;10565;1014;4158;669;2478;1683;6636
352520;201311;2439;8761;2229;8296;578;2326;1293;4741;1871;7067
352530;201311;6623;21891;5001;18248;1475;5902;892;3016;2367;8918
352540;201311;482;1614;390;1405;101;408;129;453;230;861
352550;201311;1066;3672;876;3246;323;1284;210;743;533;2027
352560;201311;554;1730;465;1541;96;386;214;621;310;1007
352570;201311;1552;4994;1101;3926;267;1086;294;919;561;2005
352580;201311;922;2823;802;2614;291;1075;330;990;621;2065
352585;201311;213;720;170;631;41;169;57;190;98;359
352590;201311;13588;44841;12179;42077;2933;11361;6520;21752;9453;33113
352600;201311;1878;6162;1736;5851;622;2176;575;1890;1197;4066
352610;201311;3601;11789;3211;11122;1263;4767;1017;3404;2280;8171
352620;201311;5487;17894;5202;17495;1263;4474;3286;11104;4549;15578
352630;201311;840;2840;792;2723;242;916;356;1194;598;2110
352640;201311;3044;9923;2468;8587;589;2270;981;3302;1570;5572
352650;201311;843;2544;631;2103;149;530;194;619;343;1149
352660;201311;1084;3845;885;3370;287;1157;263;990;550;2147
352670;201311;7737;26650;6765;24687;2647;10110;1683;6099;4330;16209
352680;201311;3035;11235;2564;9914;689;2932;733;2514;1422;5446
352690;201311;23865;73073;19413;64574;5373;19616;8166;26292;13539;45908
352700;201311;771;2347;618;2106;184;717;273;879;457;1596
352710;201311;5123;15508;3772;12702;1057;3972;1373;4346;2430;8318
352720;201311;8764;30084;8211;28908;2771;10331;3196;11175;5967;21506
352725;201311;411;1247;279;938;54;217;75;234;129;451
352730;201311;2579;9100;2236;8149;630;2496;661;2154;1291;4650
352740;201311;2232;6747;1918;6165;532;2034;852;2456;1384;4490
352750;201311;369;1186;309;1067;112;425;62;179;174;604
352760;201311;941;3336;872;3200;294;1184;453;1602;747;2786
352770;201311;919;2886;863;2771;238;840;321;1022;559;1862
352780;201311;602;2083;526;1899;166;672;163;528;329;1200
352790;201311;649;1922;520;1700;157;565;100;314;257;879
352800;201311;1103;4227;898;3647;288;1193;155;563;443;1756
352810;201311;1014;2766;771;2311;149;525;306;881;455;1406
352820;201311;549;1706;461;1541;209;747;84;282;293;1029
352830;201311;414;1229;320;1021;88;288;51;147;139;435
352840;201311;3460;12322;3055;11409;949;3771;1066;3977;2015;7748
352850;201311;9827;32572;8623;30365;2560;9605;3229;11501;5789;21106
352860;201311;1035;3491;948;3289;402;1476;239;747;641;2223
352870;201311;1063;2806;853;2387;141;505;471;1180;612;1685
352880;201311;2253;6914;1787;5847;442;1572;444;1314;886;2886
352885;201311;310;1078;293;1038;91;355;112;371;203;726
352890;201311;708;2067;620;1887;147;507;208;572;355;1079
352900;201311;18845;58413;14552;49445;4056;14987;5682;18540;9738;33527
352910;201311;284;936;248;853;80;288;31;86;111;374
352920;201311;3390;10583;2895;9587;981;3596;963;2938;1944;6534
352930;201311;7018;22775;5534;19383;1681;6296;1069;3610;2750;9906
352940;201311;27342;94347;23732;85528;8647;32767;4647;16230;13294;48997
352950;201311;319;1028;230;832;63;271;58;186;121;457
352960;201311;498;1655;374;1334;78;302;63;207;141;509
352965;201311;362;1027;293;897;75;241;45;130;120;371
352970;201311;3350;8943;2974;8443;376;1142;2170;6275;2546;7417
352980;201311;1482;4511;1275;4175;423;1440;516;1754;939;3194
352990;201311;3667;12451;3403;11963;1196;4581;1118;3772;2314;8353
353000;201311;520;1480;394;1216;87;301;109;297;196;598
353010;201311;2959;8642;2264;7208;677;2406;793;2321;1470;4727
353020;201311;4387;12405;3168;9762;558;1961;1323;3709;1881;5670
353030;201311;4989;15284;4311;13869;1585;5521;946;2850;2531;8371
353040;201311;692;2014;594;1857;200;686;216;652;416;1338
353050;201311;5474;19341;4704;17697;1843;7411;1383;4947;3226;12358
353060;201311;33283;110000;31070;106390;5700;23110;20566;67326;26266;90436
353070;201311;8632;30077;6850;25831;2448;9680;1603;6110;4051;15790
353080;201311;4649;16370;3908;14593;1347;5428;1066;3704;2413;9132
353090;201311;592;2021;528;1890;94;403;255;828;349;1231
353100;201311;269;823;221;711;99;320;43;137;142;457
353110;201311;7890;25113;7068;23562;1685;5975;3886;13120;5571;19095
353120;201311;467;1618;402;1463;149;607;95;313;244;920
353130;201311;2991;9459;2643;8835;1006;3681;943;2948;1949;6629
353140;201311;2500;7231;2018;6234;667;2247;588;1624;1255;3871
353150;201311;1925;6226;1594;5570;614;2246;368;1331;982;3577
353160;201311;604;1853;493;1623;149;516;98;295;247;811
353170;201311;519;1877;472;1790;193;818;167;602;360;1420
353180;201311;5272;17109;4647;15902;792;3170;2855;9406;3647;12576
353190;201311;3612;11791;3128;10632;806;3041;1394;4348;2200;7389
353200;201311;851;3051;764;2855;251;1057;286;1003;537;2060
353205;201311;538;1748;434;1502;111;381;143;511;254;892
353210;201311;1015;2787;838;2472;128;456;505;1443;633;1899
353215;201311;565;1802;486;1634;107;404;164;562;271;966
353220;201311;905;2825;813;2635;226;818;275;855;501;1673
353230;201311;1135;3623;1050;3472;310;1129;330;1017;640;2146
353240;201311;2154;7342;1953;6921;652;2576;783;2547;1435;5123
353250;201311;1204;3488;1015;3134;294;979;352;1023;646;2002
353260;201311;1154;3446;1017;3213;341;1142;378;1147;719;2289
353270;201311;642;1980;551;1801;179;634;147;437;326;1071
353280;201311;557;1861;483;1732;170;644;121;425;291;1069
353282;201311;1763;5959;1706;5865;311;1193;1123;3762;1434;4955
353284;201311;328;954;256;822;78;265;77;241;155;506
353286;201311;146;438;95;315;25;79;12;44;37;123
353290;201311;438;1588;397;1503;166;657;138;510;304;1167
353300;201311;1850;6015;1655;5578;598;2165;529;1622;1127;3787
353310;201311;349;1116;327;1057;142;486;89;265;231;751
353320;201311;503;1457;435;1340;115;418;204;583;319;1001
353325;201311;484;1737;408;1584;122;512;51;201;173;713
353330;201311;496;1547;413;1368;100;378;172;515;272;893
353340;201311;3130;10291;2694;9375;934;3513;917;3065;1851;6578
353350;201311;3393;10525;3012;9824;1017;3561;1380;4362;2397;7923
353360;201311;412;1471;363;1353;101;437;184;629;285;1066
353370;201311;699;2316;629;2145;182;654;287;970;469;1624
353380;201311;419;1402;378;1327;106;424;164;544;270;968
353390;201311;5344;14597;3797;11675;914;3104;1388;3848;2302;6952
353400;201311;610;1928;505;1696;116;429;146;419;262;848
353410;201311;686;2144;582;1977;182;684;294;971;476;1655
353420;201311;694;2057;514;1597;163;547;160;454;323;1001
353430;201311;2471;8697;1792;6679;495;1913;122;365;617;2278
353440;201311;59600;198902;53823;184818;17228;62372;17465;58214;34693;120586
353450;201311;457;1419;409;1332;111;427;146;443;257;870
353460;201311;3972;11496;3446;10541;909;3016;1645;4960;2554;7976
353470;201311;11195;36055;8778;30846;2780;10658;2000;6786;4780;17444
353475;201311;1677;4964;1250;4013;335;1185;345;996;680;2181
353480;201311;1526;4645;1372;4362;323;1189;739;2218;1062;3407
353490;201311;1631;4740;1353;4171;377;1296;374;1034;751;2330
353500;201311;1196;3511;1110;3355;482;1552;374;1067;856;2619
353510;201311;1356;4476;1143;3888;331;1243;344;1019;675;2262
353520;201311;1141;3587;967;3251;391;1402;246;831;637;2233
353530;201311;2742;8400;2445;7842;668;2403;1063;3246;1731;5649
353540;201311;1935;6077;1779;5802;679;2298;637;2119;1316;4417
353550;201311;6698;19657;5971;18439;1209;4413;3310;9485;4519;13898
353560;201311;2197;7353;1828;6641;439;1851;708;2451;1147;4302
353570;201311;485;1575;406;1408;103;409;202;622;305;1031
353580;201311;2353;7925;2222;7684;791;3060;1132;3696;1923;6756
353590;201311;796;2326;678;2116;261;884;168;546;429;1430
353600;201311;1870;5481;1706;5195;398;1337;850;2602;1248;3939
353610;201311;587;2112;517;1964;157;674;156;563;313;1237
353620;201311;2356;8334;2138;7928;735;2968;719;2503;1454;5471
353625;201311;370;1038;261;840;104;376;64;172;168;548
353630;201311;1717;5946;1364;5084;350;1452;274;910;624;2362
353640;201311;1559;4578;1429;4315;389;1257;638;1962;1027;3219
353650;201311;6528;20067;4618;15697;1056;3882;1746;5577;2802;9459
353657;201311;313;1052;284;984;68;276;108;351;176;627
353660;201311;1372;3569;1024;3037;459;1502;157;318;616;1820
353670;201311;4811;16147;4211;14825;1369;5222;1361;4537;2730;9759
353680;201311;645;2339;611;2273;325;1259;159;583;484;1842
353690;201311;510;1434;352;1158;107;401;124;371;231;772
353700;201311;2306;7612;2029;6971;511;1991;641;2035;1152;4026
353710;201311;1933;6954;1642;6261;619;2612;514;1881;1133;4493
353715;201311;474;1428;409;1314;77;287;204;645;281;932
353720;201311;2086;6654;1828;6241;388;1357;1060;3744;1448;5101
353730;201311;4426;14085;3573;12079;923;3369;952;2996;1875;6365
353740;201311;2301;7114;1840;6129;641;2239;492;1570;1133;3809
353750;201311;626;2270;538;2071;187;776;135;527;322;1303
353760;201311;7002;23097;5852;20864;1863;7014;2308;8308;4171;15322
353770;201311;827;2624;532;1843;119;432;51;134;170;566
353780;201311;5808;20981;5259;19851;2541;9820;1254;5004;3795;14824
353790;201311;3103;11252;2778;10555;1010;4217;511;1969;1521;6186
353800;201311;14218;46672;11476;41146;3296;12946;4568;15855;7864;28801
353810;201311;1197;4023;1063;3722;335;1237;416;1445;751;2682
353820;201311;1210;4362;1157;4258;424;1763;452;1533;876;3296
353830;201311;790;2198;611;1848;140;469;242;713;382;1182
353850;201311;1838;6174;1719;5957;460;1729;829;2762;1289;4491
353860;201311;2416;8380;2054;7531;728;2882;654;2346;1382;5228
353870;201311;23210;74122;17683;62441;4271;16935;6098;19485;10369;36420
353880;201311;2281;7681;2083;7372;418;1734;1251;4287;1669;6021
353890;201311;2360;6301;1769;5332;533;1795;752;2128;1285;3923
353900;201311;1154;3663;847;2938;214;810;191;579;405;1389
353910;201311;2108;7580;2003;7292;671;2604;827;3047;1498;5651
353920;201311;2549;7749;1951;6464;485;1694;377;1154;862;2848
353930;201311;3745;13664;3280;12636;1231;5022;741;2785;1972;7807
353940;201311;1514;4921;1329;4535;341;1361;528;1636;869;2997
353950;201311;3624;12064;3335;11526;588;2357;2121;7125;2709;9482
353960;201311;589;1922;486;1676;116;448;137;402;253;850
353970;201311;525;1568;460;1480;53;213;334;1044;387;1257
353980;201311;14166;42677;11990;39109;3027;10663;6229;20059;9256;30722
353990;201311;505;1604;459;1486;151;540;162;464;313;1004
354000;201311;1900;5752;1305;4532;306;1188;135;403;441;1591
354010;201311;380;1212;341;1143;158;549;97;324;255;873
354020;201311;4638;14466;4207;13540;1478;5134;1596;4801;3074;9935
354025;201311;1052;3097;834;2685;230;820;198;606;428;1426
354030;201311;619;1673;434;1392;146;520;137;411;283;931
354040;201311;785;2179;628;1892;96;358;375;1052;471;1410
354050;201311;926;3177;847;2999;340;1302;216;745;556;2047
354060;201311;4464;14826;3664;13099;1017;3941;1503;5166;2520;9107
354070;201311;3634;12277;3156;11169;1180;4473;748;2606;1928;7079
354075;201311;2253;8633;2153;8449;766;3245;914;3522;1680;6767
354080;201311;1896;5925;1509;4962;415;1428;478;1472;893;2900
354085;201311;303;864;270;804;34;135;188;513;222;648
354090;201311;1145;3507;1087;3415;158;562;807;2483;965;3045
354100;201311;16718;58158;14469;53928;3965;15791;6613;24572;10578;40363
354105;201311;854;2785;709;2496;192;798;252;771;444;1569
354110;201311;823;2431;678;2204;186;680;221;667;407;1347
354120;201311;2210;6399;1896;5845;570;1964;651;1871;1221;3835
354130;201311;6295;19633;5575;18166;2100;7250;1679;5235;3779;12485
354140;201311;19741;52998;12995;39758;2660;9311;5414;15316;8074;24627
354150;201311;4432;12720;3580;11207;1093;3780;1425;4285;2518;8065
354160;201311;3982;13380;3522;12379;1054;3992;1413;4788;2467;8780
354165;201311;402;1533;368;1445;134;563;83;339;217;902
354170;201311;1611;5337;1311;4599;293;1169;464;1448;757;2617
354180;201311;510;1571;487;1523;51;188;347;1033;398;1221
354190;201311;1635;5583;1415;5059;494;1870;435;1494;929;3364
354200;201311;1144;3384;944;3009;220;832;369;1030;589;1862
354210;201311;853;3029;764;2812;186;816;303;1015;489;1831
354220;201311;3101;9951;2806;9367;985;3479;1078;3504;2063;6983
354230;201311;786;2646;743;2568;244;898;335;1155;579;2053
354240;201311;1302;4499;1069;3968;321;1307;258;894;579;2201
354250;201311;527;1734;440;1584;189;761;122;411;311;1172
354260;201311;9442;29040;8559;27592;2730;9675;3447;10976;6177;20651
354270;201311;1131;4110;1054;3932;332;1379;413;1541;745;2920
354280;201311;900;2701;843;2603;180;635;452;1390;632;2025
354290;201311;1311;4722;1202;4480;395;1575;318;1162;713;2737
354300;201311;3910;13853;3814;13657;1074;4061;1986;7068;3060;11129
354310;201311;788;2664;621;2241;181;710;140;502;321;1212
354320;201311;833;2549;714;2299;216;790;229;671;445;1461
354323;201311;335;1008;275;906;106;379;88;257;194;636
354325;201311;1305;4562;1188;4295;342;1402;426;1408;768;2810
354330;201311;7919;25265;7200;23822;2010;7196;3724;11988;5734;19184
354340;201311;29734;98759;25508;90790;9857;37686;8756;30126;18613;67812
354350;201311;1163;3539;1088;3401;323;1070;548;1651;871;2721
354360;201311;441;1439;361;1294;92;357;36;120;128;477
354370;201311;1152;3916;1019;3628;173;754;688;2364;861;3118
354380;201311;1311;4012;1092;3607;413;1518;187;532;600;2050
354390;201311;11495;38015;8699;31553;2283;9085;2520;8673;4803;17758
354400;201311;2102;7601;1835;6931;486;2014;566;2018;1052;4032
354410;201311;6328;19773;5322;18156;1296;4852;2809;9518;4105;14370
354420;201311;1670;5044;1390;4406;458;1569;445;1323;903;2892
354425;201311;3516;10338;3076;9533;1077;3579;934;2934;2011;6513
354430;201311;1349;4532;1243;4365;328;1298;587;1969;915;3267
354440;201311;534;1640;433;1437;96;358;173;549;269;907
354450;201311;473;1382;325;1049;58;247;95;255;153;502
354460;201311;788;2399;704;2246;266;897;295;928;561;1825
354470;201311;462;1391;378;1220;66;267;170;498;236;765
354480;201311;746;2307;666;2164;149;568;312;894;461;1462
354490;201311;746;2574;575;2129;151;607;183;584;334;1191
354500;201311;2548;8763;2330;8345;871;3420;694;2506;1565;5926
354510;201311;682;2331;612;2175;195;743;244;860;439;1603
354515;201311;348;1237;285;1083;72;308;88;310;160;618
354520;201311;5177;18751;4427;16966;1475;6256;1500;5498;2975;11754
354530;201311;2745;10131;2568;9778;762;3134;1362;5142;2124;8276
354540;201311;1360;4307;1186;3993;393;1397;430;1494;823;2891
354550;201311;527;1827;466;1661;105;393;170;573;275;966
354560;201311;1412;4360;1103;3655;330;1124;336;1075;666;2199
354570;201311;615;1957;508;1692;184;661;115;361;299;1022
354580;201311;8902;26628;7342;23599;1600;5853;3620;11007;5220;16860
354600;201311;1714;6008;1527;5638;509;2171;607;2075;1116;4246
354610;201311;466;1317;325;1026;67;223;96;260;163;483
354620;201311;421;1482;340;1325;103;473;111;392;214;865
354625;201311;275;930;234;842;61;249;57;196;118;445
354630;201311;1898;6734;1717;6286;726;2667;536;1882;1262;4549
354640;201311;4113;14020;3534;12730;1081;4374;806;2653;1887;7027
354650;201311;996;3091;904;2893;190;706;501;1534;691;2240
354660;201311;1963;6025;1539;5197;497;1876;561;1806;1058;3682
354670;201311;1659;5502;1316;4599;395;1518;335;991;730;2509
354680;201311;5289;18088;4846;17096;1424;5384;1838;6268;3262;11652
354690;201311;868;2966;594;2250;126;518;171;585;297;1103
354700;201311;1174;3395;789;2543;139;522;335;935;474;1457
354710;201311;624;1896;536;1723;148;560;177;510;325;1070
354720;201311;193;570;155;489;57;179;39;131;96;310
354730;201311;6914;24957;6185;23416;1944;7862;2515;9226;4459;17088
354740;201311;232;780;198;704;48;175;47;170;95;345
354750;201311;2301;7541;1968;7074;700;2712;712;2529;1412;5241
354760;201311;2189;7443;1875;6717;634;2410;451;1553;1085;3963
354765;201311;275;732;181;572;37;146;30;79;67;225
354770;201311;2794;8356;2241;7423;1018;3639;380;1172;1398;4811
354780;201311;33691;110813;31409;105461;8300;30773;15492;49492;23792;80265
354790;201311;868;2859;778;2714;223;874;385;1237;608;2111
354800;201311;1857;5690;1692;5457;470;1664;959;3087;1429;4751
354805;201311;884;2789;670;2313;112;450;123;384;235;834
354810;201311;681;2303;520;1949;181;739;82;292;263;1031
354820;201311;1046;3805;948;3586;314;1360;233;791;547;2151
354830;201311;434;1363;381;1259;114;438;137;416;251;854
354840;201311;792;2424;733;2307;235;797;259;787;494;1584
354850;201311;14631;48449;11314;41263;3236;13034;3926;13364;7162;26398
354860;201311;1265;4224;1153;4024;327;1371;519;1674;846;3045
354870;201311;42631;139899;40060;134459;12547;45069;18976;61977;31523;107046
354880;201311;4072;13075;3002;10627;921;3565;733;2311;1654;5876
354890;201311;14878;46737;12872;42630;3782;13731;4493;14203;8275;27934
354900;201311;604;1723;491;1564;165;583;182;566;347;1149
354910;201311;6280;19685;3728;13581;932;3741;466;1614;1398;5355
354920;201311;506;1516;385;1283;117;420;95;299;212;719
354925;201311;365;1072;215;750;44;168;35;106;79;274
354930;201311;254;787;233;735;75;271;62;186;137;457
354940;201311;2373;8506;1853;7072;786;3154;317;1161;1103;4315
354950;201311;1458;4977;1339;4807;257;1073;819;2886;1076;3959
354960;201311;787;2545;681;2360;206;796;249;834;455;1630
354970;201311;3933;13364;3478;12408;829;3379;1758;5949;2587;9328
354980;201311;32506;81736;18054;56250;4110;14318;6145;17700;10255;32018
354990;201311;35609;121980;32896;116192;7926;31049;17202;58861;25128;89910
354995;201311;1958;6273;1844;6099;478;1676;939;3127;1417;4803
355000;201311;1616;5560;1422;5210;534;2093;368;1315;902;3408
355010;201311;3662;11815;3116;10600;813;3080;1422;4725;2235;7805
355020;201311;3197;11689;2776;10848;1408;5819;688;2694;2096;8513
355030;201311;835176;2511142;768835;2379617;219721;737473;317709;958883;537430;1696356
355040;201311;2864;9659;2558;9063;915;3554;1157;3918;2072;7472
355050;201311;1239;4044;1023;3593;310;1176;275;953;585;2129
355060;201311;4861;17096;3903;14812;1123;4754;834;2846;1957;7600
355070;201311;6303;20363;5651;19225;1356;5299;2967;9529;4323;14828
355080;201311;1279;4787;1075;4202;361;1580;153;502;514;2082
355090;201311;1075;3946;909;3529;222;950;384;1418;606;2368
355100;201311;29363;97265;26362;91837;9681;35404;8800;31435;18481;66839
355110;201311;1301;4605;1187;4355;417;1661;375;1327;792;2988
355120;201311;653;2135;572;1968;184;687;223;730;407;1417
355130;201311;529;1472;353;1101;99;340;108;278;207;618
355140;201311;1028;3793;980;3684;309;1291;426;1547;735;2838
355150;201311;3434;11777;3009;10936;1005;3812;1120;3920;2125;7732
355160;201311;1498;5326;1312;4997;559;2368;351;1179;910;3547
355170;201311;9299;27626;6744;22807;2319;8495;1843;6034;4162;14529
355180;201311;2852;9051;2490;8372;714;2759;946;3011;1660;5770
355190;201311;1275;4584;1175;4362;504;1913;335;1213;839;3126
355200;201311;897;3418;859;3335;434;1768;197;745;631;2513
355210;201311;2735;9629;2488;9087;778;3202;972;3261;1750;6463
355220;201311;29113;101396;26841;96802;12055;45022;7181;26633;19236;71655
355230;201311;1112;3372;720;2470;137;550;172;503;309;1053
355240;201311;21645;68086;16757;56919;4164;15786;6678;20938;10842;36724
355250;201311;24357;83919;22121;79561;6699;25803;10158;36030;16857;61833
355255;201311;885;2531;642;2012;125;445;186;546;311;991
355260;201311;1585;4723;1421;4417;395;1368;539;1551;934;2919
355270;201311;1650;5188;1565;5051;244;995;1102;3357;1346;4352
355280;201311;22923;71099;20256;65850;5262;19219;9119;28313;14381;47532
355290;201311;864;2832;798;2710;167;632;393;1275;560;1907
355300;201311;842;2811;654;2390;163;645;167;547;330;1192
355310;201311;1043;3272;934;3070;252;873;416;1402;668;2275
355320;201311;746;2421;659;2216;191;719;226;640;417;1359
355330;201311;1560;5737;1336;5290;496;2175;360;1301;856;3476
355340;201311;3114;8648;2889;8259;786;2508;1529;4143;2315;6651
355350;201311;1359;4914;1216;4578;422;1698;318;1203;740;2901
355360;201311;1173;4172;1100;4031;282;1161;691;2489;973;3650
355365;201311;310;999;260;894;75;287;67;224;142;511
355370;201311;6941;18552;5182;16487;1973;6865;1922;6108;3895;12973
355380;201311;3678;11390;2853;9448;846;3025;609;1757;1455;4782
355385;201311;979;3254;929;3158;388;1467;220;680;608;2147
355390;201311;1405;3999;1210;3601;336;1075;419;1217;755;2292
355395;201311;1643;5208;1325;4430;240;934;582;1769;822;2703
355400;201311;8713;30829;7975;29237;2788;11216;3097;10887;5885;22103
355410;201311;12726;47877;11938;46140;4874;19945;3290;12850;8164;32795
355420;201311;817;3037;780;2953;334;1324;246;950;580;2274
355430;201311;3613;10941;3150;10100;846;2986;1402;4340;2248;7326
355440;201311;884;2992;723;2570;218;805;188;593;406;1398
355450;201311;2525;8591;2126;7742;652;2625;657;2251;1309;4876
355460;201311;563;1637;436;1396;123;471;128;346;251;817
355465;201311;438;1354;370;1213;117;417;93;296;210;713
355470;201311;935;2956;763;2651;285;1098;239;771;524;1869
355475;201311;138;535;118;470;31;129;37;161;68;290
355480;201311;3211;11980;3023;11546;999;4107;1280;4748;2279;8855
355490;201311;804;2432;648;2114;191;692;143;462;334;1154
355495;201311;725;2469;685;2399;196;762;285;959;481;1721
355500;201311;8300;25583;5792;19881;1473;5616;1175;3659;2648;9275
355510;201311;1954;5657;1445;4628;341;1255;407;1206;748;2461
355520;201311;382;1028;261;789;58;202;77;198;135;400
355530;201311;200;526;113;360;27;94;20;63;47;157
355535;201311;736;2291;603;2022;168;672;188;529;356;1201
355540;201311;10190;33559;9667;32658;2828;10308;4767;15779;7595;26087
355550;201311;707;2272;661;2179;196;711;304;974;500;1685
355560;201311;1432;4300;1097;3639;278;1042;243;681;521;1723
355570;201311;188;641;160;568;43;157;35;114;78;271
355580;201311;1228;3781;1069;3451;416;1499;355;1076;771;2575
355590;201311;253;728;225;672;48;181;111;316;159;497
355600;201311;1048;3486;888;3104;375;1387;215;720;590;2107
355610;201311;1398;4150;1195;3828;370;1302;484;1489;854;2791
355620;201311;3865;12759;3145;11089;796;3218;1298;4138;2094;7356
355630;201311;3188;9482;2031;6981;440;1723;678;2118;1118;3841
355635;201311;985;3357;869;3142;195;785;498;1762;693;2547
355640;201311;3812;12916;3177;11362;1160;4347;581;2030;1741;6377
355645;201311;3380;12436;3212;12103;692;2892;1949;7244;2641;10136
355650;201311;6449;20894;5655;19297;1321;5372;3154;9951;4475;15323
355660;201311;1335;4396;1117;3960;360;1429;390;1288;750;2717
355670;201311;2130;7025;1482;5465;401;1688;477;1523;878;3211
355680;201311;1731;6106;1443;5374;557;2177;293;1040;850;3217
355690;201311;335;1179;304;1121;198;768;25;64;223;832
355695;201311;334;1032;248;825;36;123;19;48;55;171
355700;201311;6355;23146;5860;21900;1832;7404;2474;8853;4306;16257
355710;201311;12247;32408;7953;24368;2723;8917;1968;5780;4691;14697
355715;201311;217;667;156;544;43;157;31;109;74;266
355720;201311;1489;5014;1243;4468;437;1738;361;1156;798;2894
355730;201311;772;2740;703;2599;287;1130;163;610;450;1740
410010;201311;1631;5275;1471;4913;412;1494;450;1487;862;2981
410020;201311;1231;4277;1153;4116;373;1400;410;1442;783;2842
410030;201311;1085;3843;933;3460;294;1192;176;656;470;1848
410040;201311;12838;43700;11784;41500;4200;15845;3323;11547;7523;27392
410045;201311;1078;3163;820;2681;264;936;267;808;531;1744
410050;201311;3035;8972;2154;7269;731;2689;603;1973;1334;4662
410060;201311;1927;6292;1739;5900;565;2140;595;1939;1160;4079
410070;201311;2172;6279;1757;5410;674;2273;343;930;1017;3203
410080;201311;1437;4390;1220;3996;300;1052;627;1971;927;3023
410090;201311;1122;3649;1018;3419;373;1356;308;980;681;2336
410100;201311;2852;8733;2194;7272;664;2529;438;1328;1102;3857
410105;201311;498;1627;398;1384;100;402;75;228;175;630
410110;201311;2575;8102;2276;7474;589;2209;805;2561;1394;4770
410115;201311;546;1563;469;1400;116;416;153;401;269;817
410120;201311;2881;10042;2730;9804;1108;4204;1057;3876;2165;8080
410130;201311;1374;4702;1253;4405;376;1306;591;2106;967;3412
410140;201311;14769;42420;10699;34648;3329;11945;3694;11805;7023;23750
410150;201311;16936;44156;8555;26472;1885;6639;1720;4695;3605;11334
410160;201311;3325;10842;3032;10341;1017;3834;1086;3712;2103;7546
410165;201311;763;2347;638;2067;136;474;310;971;446;1445
410170;201311;1727;5436;1476;4889;587;2106;412;1316;999;3422
410180;201311;8501;27817;7395;25340;1964;7645;3360;10665;5324;18310
410185;201311;661;1858;601;1753;164;517;346;1018;510;1535
410190;201311;2221;6799;1979;6259;648;2225;547;1623;1195;3848
410200;201311;4973;14619;4132;12936;1448;4990;705;2116;2153;7106
410210;201311;2568;7970;2042;6812;513;1946;415;1188;928;3134
410220;201311;614;1822;490;1567;102;364;182;559;284;923
410230;201311;1837;6036;1681;5753;660;2475;571;1880;1231;4355
410240;201311;5164;16448;4749;15566;1578;5576;1722;5576;3300;11152
410250;201311;2469;7178;1836;5888;618;2224;372;1055;990;3279
410260;201311;1678;5329;1479;4949;450;1605;531;1742;981;3347
410270;201311;538;1622;474;1505;148;509;197;632;345;1141
410275;201311;912;2758;657;2224;118;441;356;1205;474;1646
410280;201311;2778;8500;1976;6693;482;1843;338;1102;820;2945
410290;201311;3198;10223;2855;9545;820;2946;1157;3866;1977;6812
410300;201311;610;1796;548;1667;84;313;307;862;391;1175
410302;201311;548;1652;479;1544;56;184;314;1038;370;1222
410304;201311;1443;4824;1318;4569;398;1426;559;2008;957;3434
410305;201311;2172;5913;1862;5457;544;1693;1006;3003;1550;4696
410310;201311;2297;7877;2110;7505;689;2658;740;2706;1429;5364
410315;201311;609;1912;474;1618;107;389;150;471;257;860
410320;201311;1224;3672;821;2815;183;728;74;211;257;939
410322;201311;572;1760;431;1435;121;426;123;399;244;825
410330;201311;1462;4208;1243;3778;362;1206;379;1095;741;2301
410335;201311;1051;3169;894;2874;253;924;324;968;577;1892
410337;201311;783;2155;678;1971;137;473;294;795;431;1268
410340;201311;569;1742;439;1404;84;303;122;325;206;628
410345;201311;1840;5646;1523;4970;507;1822;359;1076;866;2898
410347;201311;815;2368;585;1917;174;627;138;426;312;1053
410350;201311;1003;3239;766;2747;225;901;111;358;336;1259
410360;201311;3330;10483;3028;9973;1025;3651;906;3013;1931;6664
410370;201311;12642;37923;9687;31612;2637;9770;2849;8584;5486;18354
410380;201311;1356;4383;1263;4197;307;1093;680;2236;987;3329
410390;201311;2793;8354;2268;7388;840;2932;615;1856;1455;4788
410395;201311;882;3065;797;2864;218;899;370;1295;588;2194
410400;201311;5066;16787;4494;15647;1458;5651;1322;4452;2780;10103
410405;201311;943;2833;773;2488;214;812;314;928;528;1740
410410;201311;1352;4713;1281;4583;503;1982;296;1022;799;3004
410420;201311;9581;31866;8514;29426;2940;11066;2254;7250;5194;18316
410425;201311;3116;10262;2267;8266;536;2199;367;1280;903;3479
410430;201311;15174;43068;11605;36398;3468;11942;3435;10617;6903;22559
410440;201311;3532;11426;3252;10904;892;3209;1540;5182;2432;8391
410442;201311;2925;10364;2673;9749;951;3662;845;3098;1796;6760
410445;201311;2360;8105;2047;7517;665;2638;757;2902;1422;5540
410450;201311;2635;7666;2113;6635;682;2305;428;1210;1110;3515
410460;201311;2365;7249;1978;6423;534;1896;732;2267;1266;4163
410465;201311;1755;6717;1613;6355;603;2478;486;1806;1089;4284
410470;201311;1900;6158;1671;5619;519;1842;594;1990;1113;3832
410480;201311;29341;88011;24213;77960;9361;32855;6428;19833;15789;52688
410490;201311;11269;37542;9468;33510;3131;12043;3050;10656;6181;22699
410500;201311;1481;4812;1249;4298;482;1816;312;1069;794;2885
410510;201311;2341;6448;1781;5333;509;1661;723;2014;1232;3675
410520;201311;3199;11434;3044;11109;1193;4596;1037;3791;2230;8387
410530;201311;1634;4812;1386;4317;372;1345;530;1526;902;2871
410540;201311;3792;11233;2738;9180;728;2628;982;3269;1710;5897
410550;201311;6418;20353;5075;17272;1686;6329;754;2308;2440;8637
410560;201311;1256;4159;994;3471;247;909;255;767;502;1676
410570;201311;2764;9245;2532;8849;782;2829;1066;3974;1848;6803
410580;201311;24972;81110;22107;75013;7633;28320;6505;20948;14138;49268
410590;201311;1193;3905;827;2843;162;633;198;605;360;1238
410600;201311;1888;5809;1625;5287;475;1621;701;2291;1176;3912
410610;201311;826;2620;723;2420;204;738;311;997;515;1735
410620;201311;1700;6254;1537;5820;523;2090;385;1416;908;3506
410630;201311;2496;7556;2146;6880;604;2150;819;2530;1423;4680
410640;201311;4898;14748;3973;12979;1335;4917;947;2926;2282;7843
410645;201311;1280;4633;1224;4516;534;2125;351;1314;885;3439
410650;201311;2444;7659;2030;6810;721;2563;515;1645;1236;4208
410655;201311;898;2807;760;2521;245;883;205;659;450;1542
410657;201311;606;1893;525;1722;160;616;197;573;357;1189
410660;201311;3771;11196;2982;9457;1105;3755;619;1819;1724;5574
410670;201311;990;2895;761;2425;205;725;195;578;400;1303
410680;201311;2361;8454;2006;7501;567;2163;699;2751;1266;4914
410685;201311;657;2038;617;1970;120;378;400;1295;520;1673
410690;201311;106055;313990;74655;248052;19089;70489;18744;56158;37833;126647
410700;201311;2262;7485;2133;7231;707;2625;863;2795;1570;5420
410710;201311;1060;3405;884;2980;239;901;228;710;467;1611
410712;201311;752;2399;671;2230;315;1132;164;573;479;1705
410715;201311;1037;3353;917;3090;249;916;320;1041;569;1957
410720;201311;4023;12877;3380;11444;1041;3769;938;3013;1979;6782
410725;201311;1113;3263;826;2686;220;781;238;687;458;1468
410730;201311;703;2178;644;2049;279;945;172;529;451;1474
410740;201311;943;2891;676;2324;159;628;293;983;452;1611
410750;201311;1792;5548;1585;5053;542;1926;452;1305;994;3231
410752;201311;260;790;221;717;50;195;104;307;154;502
410753;201311;521;1623;417;1403;105;405;150;466;255;871
410754;201311;987;3097;872;2899;118;438;587;2018;705;2456
410755;201311;716;2023;573;1785;119;438;286;828;405;1266
410760;201311;2424;8053;2319;7849;921;3302;804;2667;1725;5969
410765;201311;15408;47209;11761;39670;2999;11219;2198;7276;5197;18495
410770;201311;872;2550;733;2284;260;882;201;572;461;1454
410773;201311;1178;3756;1060;3533;288;1072;485;1487;773;2559
410775;201311;1807;5431;1742;5322;491;1434;1060;3401;1551;4835
410780;201311;612;1847;491;1629;150;522;151;553;301;1075
410785;201311;916;3039;742;2524;262;925;271;925;533;1850
410790;201311;600;1874;494;1621;139;531;103;277;242;808
410800;201311;2374;6833;1993;6147;809;2747;606;1778;1415;4525
410810;201311;316;987;255;841;34;129;110;355;144;484
410820;201311;1049;3266;911;2942;273;973;229;723;502;1696
410830;201311;30460;94065;25549;85035;8070;29284;8655;28560;16725;57844
410832;201311;1161;3555;1064;3369;246;924;527;1534;773;2458
410840;201311;7365;23732;6184;21046;2152;7969;1263;3885;3415;11854
410845;201311;1577;4833;1395;4458;279;977;780;2511;1059;3488
410850;201311;2727;8210;2461;7829;554;2047;1324;4173;1878;6220
410855;201311;723;2086;608;1851;170;564;208;627;378;1191
410860;201311;3601;10684;3094;9754;789;2602;1449;4727;2238;7329
410865;201311;1656;5834;1493;5509;405;1603;715;2696;1120;4299
410870;201311;1373;4334;1296;4209;629;2225;346;1057;975;3282
410880;201311;4482;13568;3601;11915;1006;3875;904;2605;1910;6480
410890;201311;1085;3425;831;2933;275;1065;111;327;386;1392
410895;201311;1131;4032;1021;3772;371;1459;315;1115;686;2574
410900;201311;856;2481;674;2182;142;518;210;651;352;1169
410910;201311;312;991;277;927;60;216;131;416;191;632
410920;201311;817;2566;665;2281;208;770;184;582;392;1352
410930;201311;2056;6573;1805;6141;562;2209;659;2142;1221;4351
410940;201311;20530;70922;18495;67044;6239;24607;7498;27241;13737;51848
410950;201311;1886;6360;1720;6041;367;1350;1013;3622;1380;4972
410960;201311;6154;18108;4484;15001;1547;5587;1433;4867;2980;10454
410965;201311;1061;3469;948;3235;259;953;440;1530;699;2483
410970;201311;5117;15893;4248;14082;1469;5459;972;3229;2441;8688
410975;201311;1421;4295;1201;3898;220;848;617;1998;837;2846
410980;201311;5163;15661;3520;12072;956;3643;841;2740;1797;6383
410990;201311;1054;3302;803;2741;251;953;209;635;460;1588
411000;201311;455;1416;334;1143;78;303;51;148;129;451
411005;201311;483;1465;363;1157;98;317;60;166;158;483
411007;201311;2130;7033;2003;6787;634;2268;923;3244;1557;5512
411010;201311;3888;13566;3606;12909;1393;5475;830;2705;2223;8180
411020;201311;2579;8449;2359;8054;805;3086;841;2870;1646;5956
411030;201311;807;2288;703;2095;237;781;197;542;434;1323
411040;201311;381;1249;314;1087;105;386;70;234;175;620
411050;201311;2138;7827;1909;7268;746;3056;365;1323;1111;4379
411060;201311;2066;6682;1805;6125;586;2216;320;966;906;3182
411065;201311;394;1220;318;1064;57;202;111;343;168;545
411070;201311;4248;14160;3246;11815;1072;4320;411;1299;1483;5619
411080;201311;2008;6464;1852;6135;496;1842;797;2618;1293;4460
411090;201311;620;1645;500;1473;95;341;126;333;221;674
411095;201311;1558;4602;1240;3981;319;1143;317;975;636;2118
411100;201311;1491;4374;1115;3620;267;970;265;825;532;1795
411110;201311;918;2809;698;2318;210;745;110;303;320;1048
411120;201311;1691;5429;1488;4999;486;1766;461;1511;947;3277
411125;201311;4666;15444;4535;15176;1610;5691;2138;7044;3748;12735
411130;201311;762;2384;633;2105;196;682;214;718;410;1400
411140;201311;2182;7908;1894;7138;701;2778;384;1532;1085;4310
411150;201311;5843;16859;4939;15104;1495;4984;1287;3579;2782;8563
411155;201311;1155;3531;1041;3274;364;1265;339;976;703;2241
411160;201311;307;950;275;886;109;364;83;256;192;620
411170;201311;779;2704;714;2545;215;821;229;800;444;1621
411180;201311;6127;19187;5370;17724;1683;6077;1640;5346;3323;11423
411190;201311;1781;5359;1499;4820;452;1617;450;1362;902;2979
411200;201311;3960;12687;3445;11819;1248;4670;1274;4257;2522;8927
411210;201311;2779;8175;2284;7267;882;3040;341;1024;1223;4064
411220;201311;1190;3503;964;3072;250;922;399;1144;649;2066
411230;201311;1049;3257;818;2746;275;1024;208;635;483;1659
411240;201311;1391;3473;827;2573;257;891;199;537;456;1428
411250;201311;3115;8827;2555;7779;786;2480;804;2461;1590;4941
411260;201311;262;772;204;670;62;231;86;255;148;486
411270;201311;2021;6547;1866;6275;613;2298;793;2577;1406;4875
411275;201311;1513;4643;1316;4187;389;1278;351;1067;740;2345
411280;201311;1720;5412;1375;4654;408;1575;219;657;627;2232
411290;201311;1029;2944;851;2597;227;750;304;960;531;1710
411295;201311;1121;3424;1040;3288;226;802;458;1407;684;2209
411300;201311;1286;3396;898;2630;87;298;377;1015;464;1313
411310;201311;828;2457;667;2178;153;591;297;929;450;1520
411320;201311;5602;17639;4638;15658;1320;4668;1255;4118;2575;8786
411325;201311;1526;5034;1380;4743;191;760;918;3162;1109;3922
411330;201311;3471;11610;3176;11094;1257;4723;949;3286;2206;8009
411340;201311;980;2920;655;2146;153;570;244;788;397;1358
411342;201311;903;2625;727;2230;212;724;192;508;404;1232
411345;201311;1044;3419;971;3279;280;1033;481;1627;761;2660
411350;201311;2557;8206;1952;6932;642;2478;269;861;911;3339
411360;201311;514;1327;326;964;48;191;136;323;184;514
411370;201311;42486;126226;32414;106638;7562;29233;11187;33519;18749;62752
411373;201311;1393;4545;1196;4117;347;1372;289;939;636;2311
411375;201311;1328;3736;1066;3225;302;976;308;871;610;1847
411380;201311;1266;3462;796;2472;150;532;241;715;391;1247
411390;201311;1765;5514;1603;5286;332;1256;1007;3194;1339;4450
411400;201311;1651;5108;1363;4465;334;1236;456;1445;790;2681
411410;201311;2406;7643;2124;6998;721;2724;574;1599;1295;4323
411420;201311;4443;13098;3498;11074;1008;3560;752;2097;1760;5657
411430;201311;2796;9253;2418;8549;739;2804;1051;3603;1790;6407
411435;201311;554;1832;479;1640;128;480;167;549;295;1029
411440;201311;2566;8592;2364;8206;897;3358;690;2451;1587;5809
411450;201311;1986;6202;1821;5933;459;1578;971;3193;1430;4771
411460;201311;4252;13854;3363;11722;1319;4855;617;2028;1936;6883
411470;201311;911;2864;661;2221;181;660;119;361;300;1021
411480;201311;4530;14281;3707;12674;1694;6254;773;2500;2467;8754
411490;201311;1637;5301;1471;4999;641;2447;338;1024;979;3471
411500;201311;1483;4504;1130;3765;359;1310;268;842;627;2152
411510;201311;2435;7306;1932;6292;623;2252;387;1092;1010;3344
411520;201311;27523;80307;18938;62151;6359;23008;3906;12066;10265;35074
411530;201311;894;2621;615;2086;249;954;109;309;358;1263
411535;201311;444;1352;221;806;43;180;23;76;66;256
411540;201311;2973;8255;2385;7168;483;1550;1268;3885;1751;5435
411545;201311;997;3624;949;3522;222;911;599;2204;821;3115
411550;201311;713;2030;575;1796;255;873;123;353;378;1226
411560;201311;2548;7887;2131;6899;621;2189;478;1464;1099;3653
411570;201311;5825;16536;4450;14161;1340;4758;1110;3687;2450;8445
411573;201311;974;3081;929;3002;236;829;489;1599;725;2428
411575;201311;1415;4690;1240;4290;341;1253;481;1644;822;2897
411580;201311;3457;10602;2671;9004;650;2537;488;1437;1138;3974
411585;201311;457;1635;363;1354;93;373;53;182;146;555
411590;201311;562;1701;508;1587;142;512;141;409;283;921
411600;201311;360;1118;303;1005;70;283;75;253;145;536
411605;201311;2283;6529;1708;5420;465;1631;646;1968;1111;3599
411610;201311;2177;6543;2073;6361;514;1692;1310;3962;1824;5654
411620;201311;2681;9047;2528;8782;871;3269;1008;3567;1879;6836
411630;201311;693;1912;436;1493;135;534;85;252;220;786
411640;201311;581;1816;486;1617;139;509;177;545;316;1054
411650;201311;280;908;233;809;69;272;70;211;139;483
411660;201311;776;2342;675;2148;185;620;279;905;464;1525
411670;201311;1671;4989;1491;4648;501;1777;509;1459;1010;3236
411680;201311;1659;5242;1466;4910;391;1300;795;2845;1186;4145
411690;201311;3544;10892;3009;9887;1086;3847;785;2585;1871;6432
411695;201311;815;2666;692;2419;140;504;349;1234;489;1738
411700;201311;1808;5431;1382;4612;386;1450;378;1186;764;2636
411705;201311;2234;7823;1963;7303;491;1867;1132;4331;1623;6198
411710;201311;2153;6773;1707;5722;523;1918;362;1063;885;2981
411720;201311;772;2383;606;1980;138;496;156;483;294;979
411721;201311;709;2171;594;1918;181;646;148;418;329;1064
411722;201311;671;2091;550;1839;145;554;164;502;309;1056
411725;201311;1277;4224;910;3321;247;992;231;840;478;1832
411727;201311;2322;6780;1893;5865;509;1741;775;2278;1284;4019
411729;201311;518;1478;409;1294;76;266;156;456;232;722
411730;201311;5492;16639;4699;15109;1475;5105;1729;5552;3204;10657
411740;201311;511;1545;413;1335;124;469;159;466;283;935
411745;201311;852;2721;705;2361;201;744;168;517;369;1261
411750;201311;4081;13074;3283;11091;1040;3873;582;1783;1622;5656
411760;201311;8574;26416;7807;25108;2940;10012;2464;8272;5404;18284
411770;201311;3771;13629;3386;12667;1356;5288;749;2847;2105;8135
411780;201311;2969;10068;2873;9944;425;1418;2083;7598;2508;9016
411790;201311;2450;7444;1986;6531;665;2495;587;1831;1252;4326
411800;201311;1218;3753;782;2658;145;552;114;282;259;834
411810;201311;1505;4804;1309;4349;381;1443;345;963;726;2406
411820;201311;16147;51682;13576;46879;4808;17101;4182;15277;8990;32378
411830;201311;432;1207;358;1108;114;346;140;472;254;818
411840;201311;8452;26032;6950;23026;2157;7828;2001;6448;4158;14276
411845;201311;505;1649;403;1423;112;432;92;306;204;738
411850;201311;5899;18473;4957;16522;1366;4948;1429;4714;2795;9662
411860;201311;852;2818;723;2524;210;783;197;640;407;1423
411870;201311;991;3577;799;3046;143;583;196;706;339;1289
411880;201311;2468;7191;2090;6569;495;1746;1059;3320;1554;5066
411885;201311;1415;3986;1154;3572;361;1250;349;968;710;2218
411890;201311;1290;4065;946;3249;267;1028;205;608;472;1636
411900;201311;902;2964;699;2437;231;822;106;365;337;1187
411910;201311;1193;4190;1058;3872;321;1299;351;1207;672;2506
411915;201311;11482;34068;7904;26217;1999;7406;1874;5528;3873;12934
411920;201311;982;3579;886;3317;288;1179;190;671;478;1850
411925;201311;588;1747;469;1526;146;501;153;488;299;989
411930;201311;6044;20484;5374;19099;1840;6956;1918;6951;3758;13907
411940;201311;3557;12222;3209;11446;1067;4005;878;3125;1945;7130
411950;201311;10175;33784;8893;31299;2772;10605;3864;13381;6636;23986
411960;201311;5344;16684;5027;16072;1404;5028;2312;7137;3716;12165
411965;201311;442;1524;377;1375;107;432;101;371;208;803
411970;201311;723;2185;590;1959;202;706;170;551;372;1257
411980;201311;2085;5859;1478;4872;191;702;820;2695;1011;3397
411990;201311;27904;98266;24535;90953;9349;36913;6464;24301;15813;61214
411995;201311;2991;9670;2747;9186;1131;4060;724;2396;1855;6456
412000;201311;1994;5661;1623;5000;358;1273;669;1812;1027;3085
412010;201311;708;2443;625;2243;178;667;196;685;374;1352
412015;201311;632;2018;526;1788;105;396;273;913;378;1309
412020;201311;420;1267;325;1074;117;424;123;385;240;809
412030;201311;584;1869;402;1426;88;370;117;384;205;754
412033;201311;700;2223;542;1843;139;515;94;287;233;802
412035;201311;929;2770;768;2471;199;740;307;915;506;1655
412040;201311;723;2434;655;2259;253;925;204;690;457;1615
412050;201311;1592;4890;1260;4148;326;1195;284;885;610;2080
412060;201311;7148;25539;6583;24205;2170;8481;2451;8960;4621;17441
412065;201311;957;2992;823;2705;245;908;234;709;479;1617
412070;201311;1086;3153;971;2907;216;707;383;1123;599;1830
412080;201311;1922;6223;1410;5039;416;1639;155;477;571;2116
412085;201311;275;775;167;571;49;187;41;130;90;317
412090;201311;4782;16111;4581;15732;1021;3807;2894;10035;3915;13842
412100;201311;2181;7058;1929;6608;655;2374;665;2253;1320;4627
412110;201311;1010;3062;783;2593;270;944;243;786;513;1730
412120;201311;2332;8112;2137;7656;559;2206;1036;3571;1595;5777
412125;201311;965;3033;858;2855;262;956;333;1104;595;2060
412130;201311;741;2169;543;1785;120;453;123;376;243;829
412135;201311;556;1621;419;1327;91;320;181;520;272;840
412140;201311;1807;5637;1525;5065;447;1594;449;1487;896;3081
412150;201311;2757;8445;2438;7800;449;1593;1374;4276;1823;5869
412160;201311;1184;3790;919;3130;278;1068;324;1055;602;2123
412170;201311;4289;14754;3753;13664;1370;5304;1277;4568;2647;9872
412175;201311;1479;5253;1338;4925;393;1577;524;1953;917;3530
412180;201311;1703;5529;1337;4863;530;2123;351;1199;881;3322
412190;201311;2924;9097;2484;8361;984;3520;651;2292;1635;5812
412200;201311;2196;7592;1638;5977;406;1586;493;1764;899;3350
412210;201311;662;1986;469;1555;138;522;90;269;228;791
412215;201311;3140;10521;2857;9979;506;1834;1832;6595;2338;8429
412217;201311;1158;3510;1104;3413;231;835;685;1983;916;2818
412220;201311;5611;19035;5388;18594;1929;7029;2646;9079;4575;16108
412230;201311;2856;10081;2555;9403;844;3408;716;2518;1560;5926
412240;201311;8177;23081;4915;16227;1110;4100;702;2039;1812;6139
412250;201311;2151;6728;1952;6320;752;2640;488;1455;1240;4095
412260;201311;1274;3890;865;2981;206;819;254;759;460;1578
412265;201311;1144;3709;1063;3562;285;1147;494;1582;779;2729
412270;201311;757;2575;597;2165;145;593;100;330;245;923
412280;201311;715;2227;580;1958;165;603;275;898;440;1501
412290;201311;1202;3450;1015;3083;224;760;399;1166;623;1926
412300;201311;1743;5284;1445;4688;463;1705;411;1249;874;2954
412310;201311;1190;3456;1041;3259;219;590;676;2354;895;2944
412320;201311;689;1934;505;1607;134;497;181;557;315;1054
412330;201311;1967;5510;1509;4712;390;1322;673;2078;1063;3400
412340;201311;794;2593;575;2030;121;480;115;375;236;855
412350;201311;2436;7939;2050;7034;654;2425;397;1247;1051;3672
412360;201311;338;1103;291;979;66;236;79;225;145;461
412370;201311;1115;3538;880;3071;317;1159;244;843;561;2002
412380;201311;1994;6133;1738;5593;420;1395;724;2470;1144;3865
412382;201311;701;2056;519;1654;145;534;144;412;289;946
412385;201311;2446;7987;2270;7616;677;2389;859;2976;1536;5365
412390;201311;2400;7338;2225;7045;835;2869;779;2431;1614;5300
412395;201311;957;2716;777;2428;130;428;475;1509;605;1937
412400;201311;1188;3729;1062;3492;339;1200;424;1425;763;2625
412402;201311;2030;6403;1729;5757;550;1983;456;1379;1006;3362
412405;201311;3962;11788;2589;8714;665;2572;272;799;937;3371
412410;201311;6154;20555;5604;19420;2482;9391;1088;3698;3570;13089
412420;201311;520;1577;431;1415;139;506;121;346;260;852
412430;201311;453;1387;380;1229;120;434;153;447;273;881
412440;201311;3980;12207;3520;11403;696;2505;1518;5133;2214;7638
412450;201311;385;1227;318;1064;76;286;65;170;141;456
412460;201311;982;2815;676;2230;172;658;159;489;331;1147
412470;201311;2025;7036;1851;6616;615;2343;677;2390;1292;4733
412480;201311;1325;3981;966;3185;228;820;176;475;404;1295
412490;201311;1275;3848;1141;3538;307;995;327;1002;634;1997
412500;201311;2003;6103;1689;5464;511;1838;428;1240;939;3078
412510;201311;2733;9445;2416;8608;834;3201;779;2676;1613;5877
412520;201311;1800;5167;1400;4495;407;1405;489;1556;896;2961
412530;201311;787;2381;662;2110;219;750;168;510;387;1260
412535;201311;407;1242;286;937;78;277;94;265;172;542
412540;201311;1208;3619;935;3023;182;691;377;1196;559;1887
412545;201311;900;2609;744;2273;141;481;266;719;407;1200
412550;201311;23482;72726;16428;56565;4768;17750;3215;10257;7983;28007
412555;201311;310;986;228;773;51;187;42;115;93;302
412560;201311;4375;15071;3789;13792;1241;4936;808;2660;2049;7596
412570;201311;4198;13131;3287;11031;1001;3675;732;2381;1733;6056
412575;201311;1039;3351;865;2932;224;864;273;847;497;1711
412580;201311;1465;4084;1079;3406;263;900;360;1074;623;1974
412590;201311;479;1503;392;1344;157;570;94;322;251;892
412600;201311;1461;4766;1280;4386;444;1672;382;1226;826;2898
412610;201311;757;2489;620;2146;207;803;157;469;364;1272
412620;201311;1238;4175;1077;3824;397;1530;251;858;648;2388
412625;201311;13628;39371;11412;35161;4256;14155;2456;7448;6712;21603
412627;201311;950;3003;684;2423;228;868;83;279;311;1147
412630;201311;3488;11362;3097;10486;862;3144;954;3114;1816;6258
412635;201311;515;1618;384;1312;95;334;56;176;151;510
412640;201311;859;2677;650;2201;166;637;146;451;312;1088
412650;201311;2267;6534;1832;5731;506;1731;669;1875;1175;3606
412660;201311;3009;9258;2508;8189;657;2468;624;1887;1281;4355
412665;201311;722;1967;455;1489;140;505;130;398;270;903
412667;201311;1458;4464;1170;3869;307;1177;348;1043;655;2220
412670;201311;643;2058;436;1545;107;441;60;161;167;602
412680;201311;1436;4832;1217;4276;354;1326;333;1067;687;2393
412690;201311;655;2119;524;1812;187;714;83;269;270;983
412700;201311;1828;6116;1611;5735;614;2436;560;1918;1174;4354
412710;201311;8794;28033;7320;24922;2134;7931;1842;5990;3976;13921
412720;201311;1607;5151;1125;3905;278;1033;114;314;392;1347
412730;201311;2782;8557;1964;6783;612;2266;255;791;867;3057
412740;201311;2108;7026;1885;6498;756;2774;258;929;1014;3703
412750;201311;3277;11314;3098;10955;626;2483;2063;7115;2689;9598
412760;201311;2231;7606;2131;7427;676;2614;838;2754;1514;5368
412770;201311;11517;34590;7783;26245;1867;7031;1622;4954;3489;11985
412780;201311;1473;4929;1310;4541;402;1488;390;1273;792;2761
412785;201311;2420;7241;1832;6012;596;2104;717;2289;1313;4393
412788;201311;1331;4528;1252;4374;338;1374;535;1742;873;3116
412790;201311;1115;3606;940;3209;209;786;292;896;501;1682
412795;201311;1023;3092;878;2814;304;1061;275;829;579;1890
412796;201311;2627;8505;2442;8123;650;2399;1111;3547;1761;5946
412800;201311;3470;10577;2794;9253;786;2865;818;2544;1604;5409
412810;201311;9415;27281;6214;20194;1818;6473;1445;4240;3263;10713
412820;201311;6171;19413;4660;16312;1424;5396;996;3511;2420;8907
412830;201311;400;1308;343;1194;103;422;83;237;186;659
412840;201311;2239;6551;1858;5796;558;1942;456;1383;1014;3325
412850;201311;2514;7745;2206;7301;426;1643;1139;3642;1565;5285
412853;201311;1645;5001;1468;4684;274;1099;817;2380;1091;3479
412855;201311;1650;4891;1350;4304;468;1715;353;963;821;2678
412860;201311;1245;3869;1097;3599;288;1070;498;1560;786;2630
412862;201311;792;2222;625;1882;176;590;216;607;392;1197
412863;201311;1200;4203;1157;4122;178;694;800;2826;978;3520
412865;201311;648;2053;483;1643;109;411;175;607;284;1018
412870;201311;1021;3020;880;2795;326;1132;283;894;609;2026
412880;201311;1564;4331;1318;3937;393;1292;329;923;722;2215
420005;201311;476;1523;345;1220;77;296;154;514;231;810
420010;201311;3202;10214;2758;9451;443;1630;1914;6623;2357;8253
420020;201311;748;2543;484;1799;93;390;66;206;159;596
420030;201311;493;1481;300;1083;89;363;54;174;143;537
420040;201311;993;3140;675;2507;227;940;158;519;385;1459
420050;201311;787;2562;643;2218;199;713;238;804;437;1517
420055;201311;315;1029;219;798;58;223;46;146;104;369
420060;201311;378;1348;287;1110;72;302;40;143;112;445
420070;201311;1997;6471;1718;5770;323;1205;761;2656;1084;3861
420075;201311;179;560;113;387;30;119;30;84;60;203
420080;201311;556;1926;499;1798;180;709;103;357;283;1066
420090;201311;678;2439;517;2027;140;563;94;380;234;943
420100;201311;1477;4905;1371;4755;364;1288;828;2914;1192;4202
420110;201311;446;1547;403;1447;130;472;158;583;288;1055
420120;201311;311;1104;258;986;113;464;39;132;152;596
420125;201311;355;1497;341;1463;135;616;91;360;226;976
420127;201311;577;1813;275;1037;94;384;32;118;126;502
420130;201311;2680;9374;2393;8782;757;3147;887;2958;1644;6105
420140;201311;4763;14500;3537;12154;1101;4236;842;2708;1943;6944
420150;201311;715;2237;525;1779;176;644;136;407;312;1051
420160;201311;296;899;192;653;49;198;36;96;85;294
420165;201311;203;674;143;515;24;92;35;131;59;223
420170;201311;232;777;166;636;63;286;18;47;81;333
420180;201311;444;1470;276;1017;78;292;71;251;149;543
420190;201311;540;1765;371;1405;137;576;58;198;195;774
420195;201311;1396;4068;1112;3668;292;1065;533;1780;825;2845
420200;201311;2848;9458;1863;7141;634;2711;315;1050;949;3761
420205;201311;1042;3563;939;3361;300;1170;393;1407;693;2577
420207;201311;1283;3903;947;3180;305;1146;253;773;558;1919
420208;201311;537;1716;410;1439;163;606;118;409;281;1015
420209;201311;349;1182;222;834;46;183;53;203;99;386
420210;201311;1731;5791;1166;4555;336;1509;165;572;501;2081
420213;201311;859;3237;821;3152;170;683;538;2075;708;2758
420215;201311;480;1638;362;1285;111;422;65;216;176;638
420220;201311;422;1672;392;1592;167;729;79;278;246;1007
420230;201311;4433;14040;3514;12317;903;3551;1770;6072;2673;9623
420240;201311;12302;38679;8537;30744;2011;8609;3373;10827;5384;19436
420243;201311;557;1797;457;1573;131;517;141;475;272;992
420245;201311;1103;3578;805;2938;221;942;178;558;399;1500
420250;201311;835;2734;786;2655;301;1102;317;1089;618;2191
420253;201311;663;1766;548;1610;124;383;260;842;384;1225
420257;201311;420;1339;341;1190;98;341;153;537;251;878
420260;201311;1340;4598;1209;4340;366;1441;557;1981;923;3422
420270;201311;475;1560;246;915;33;129;27;88;60;217
420280;201311;2584;7717;1828;6344;571;2242;546;1663;1117;3905
420285;201311;146;432;54;201;9;38;1;2;10;40
420287;201311;650;2035;558;1853;148;532;221;730;369;1262
420290;201311;6081;18507;3956;13514;1008;3787;1293;4096;2301;7883
420300;201311;5713;18575;3968;14684;1176;4949;778;2819;1954;7768
420310;201311;841;2601;804;2535;190;645;483;1462;673;2107
420315;201311;934;3197;751;2802;199;836;310;1154;509;1990
420320;201311;4728;15575;4052;14330;1288;5132;1569;5303;2857;10435
420325;201311;470;1553;451;1502;156;582;139;448;295;1030
420330;201311;1261;4492;1008;3786;360;1476;175;537;535;2013
420340;201311;1477;4693;1190;3996;280;1019;389;1244;669;2263
420350;201311;1564;5153;1369;4745;407;1509;584;2028;991;3537
420360;201311;3580;11825;2820;10094;1061;4136;492;1627;1553;5763
420370;201311;1965;5665;1764;5403;241;766;1408;4287;1649;5053
420380;201311;5363;18496;4569;16577;1496;5890;1183;4205;2679;10095
420390;201311;2048;6237;1253;4498;423;1658;272;875;695;2533
420395;201311;2038;6453;1540;5286;429;1679;335;1016;764;2695
420400;201311;1478;4530;1132;3845;352;1383;362;1146;714;2529
420410;201311;778;2227;578;1893;159;583;269;864;428;1447
420415;201311;500;1627;407;1385;119;439;144;480;263;919
420417;201311;799;2642;689;2387;157;547;325;1142;482;1689
420419;201311;414;1370;321;1207;159;639;76;291;235;930
420420;201311;14707;46403;11549;39569;3926;14582;3539;11931;7465;26513
420425;201311;1244;3565;803;2585;120;482;329;953;449;1435
420430;201311;4064;13032;2792;9973;855;3333;743;2583;1598;5916
420435;201311;198;684;147;547;69;290;25;83;94;373
420440;201311;1477;4405;912;3203;339;1286;152;480;491;1766
420445;201311;441;1304;338;1121;96;339;145;480;241;819
420450;201311;1266;3808;741;2685;181;748;147;431;328;1179
420455;201311;2258;7153;2020;6724;624;2380;831;2658;1455;5038
420460;201311;9480;30772;7814;27489;2377;9449;2937;9796;5314;19245
420470;201311;1170;3346;812;2681;248;899;242;773;490;1672
420475;201311;175;578;115;423;42;159;25;97;67;256
420480;201311;5990;18292;4956;16493;2083;7696;820;2631;2903;10327
420490;201311;708;2480;584;2191;180;707;145;514;325;1221
420500;201311;2104;6640;1766;6022;534;1960;891;3058;1425;5018
420510;201311;181;789;177;770;74;329;37;145;111;474
420515;201311;156;578;127;502;41;173;20;77;61;250
420517;201311;939;2938;855;2758;121;403;583;1911;704;2314
420519;201311;408;1189;304;963;62;199;120;392;182;591
420520;201311;719;2197;598;1994;173;625;240;774;413;1399
420530;201311;1352;4788;1113;4156;379;1560;252;814;631;2374
420535;201311;248;776;178;619;58;218;37;113;95;331
420540;201311;18859;58686;14613;49556;5197;19477;4271;13657;9468;33134
420543;201311;490;1345;359;1118;53;181;208;682;261;863
420545;201311;1532;5052;1262;4439;381;1500;376;1250;757;2750
420550;201311;4739;15960;4021;14237;1249;4960;1264;4382;2513;9342
420555;201311;462;1517;382;1334;144;549;109;369;253;918
420560;201311;587;1786;485;1575;87;312;247;813;334;1125
420570;201311;1933;6526;1569;5621;486;1951;459;1537;945;3488
420580;201311;1036;3596;884;3314;275;1135;394;1494;669;2629
420590;201311;3224;10421;2374;8421;607;2367;489;1599;1096;3966
420600;201311;846;3011;760;2796;223;895;301;1112;524;2007
420610;201311;607;2037;440;1640;141;578;73;243;214;821
420620;201311;1194;3847;1064;3600;410;1510;246;805;656;2315
420630;201311;1051;3499;838;2951;265;1028;240;714;505;1742
420640;201311;630;2154;340;1355;89;410;36;149;125;559
420650;201311;2236;7149;1307;4822;295;1218;228;704;523;1922
420660;201311;669;2034;551;1810;113;414;290;932;403;1346
420665;201311;778;2314;504;1716;90;354;175;517;265;871
420670;201311;1704;5600;1296;4644;346;1380;215;706;561;2086
420675;201311;229;747;165;591;41;164;77;253;118;417
420680;201311;496;1281;317;988;64;240;107;310;171;550
420690;201311;887;3172;673;2564;189;804;196;694;385;1498
420700;201311;5895;18362;4886;16227;1676;6192;1287;4041;2963;10233
420710;201311;736;2734;633;2510;244;1035;156;589;400;1624
420720;201311;1973;6211;1706;5842;487;1740;953;3269;1440;5009
420730;201311;4603;14650;4029;13594;1533;5495;1400;4650;2933;10145
420740;201311;732;2509;713;2477;180;674;455;1553;635;2227
420750;201311;2437;8113;1763;6417;416;1748;539;1717;955;3465
420757;201311;113;403;97;374;26;111;26;94;52;205
420760;201311;432;1434;316;1100;73;281;100;341;173;622
420765;201311;543;1963;399;1533;130;534;85;320;215;854
420768;201311;1261;4594;1092;4195;377;1520;390;1556;767;3076
420770;201311;869;2822;583;2141;184;738;156;540;340;1278
420775;201311;639;2089;496;1725;139;495;152;512;291;1007
420780;201311;1679;5265;1200;4094;351;1291;349;1122;700;2413
420785;201311;322;1013;226;763;33;133;86;261;119;394
420790;201311;1339;4958;1115;4312;337;1390;425;1594;762;2984
420800;201311;896;2710;564;1946;156;607;122;380;278;987
420810;201311;2520;8987;2051;7849;719;3056;530;1959;1249;5015
420820;201311;7586;26995;6479;24907;2340;10039;2274;8612;4614;18651
420830;201311;2675;9190;2310;8475;918;3634;765;2697;1683;6331
420840;201311;864;2720;552;2057;154;649;156;536;310;1185
420845;201311;1118;3927;939;3562;345;1438;159;557;504;1995
420850;201311;1903;6409;1337;5212;470;2003;274;1072;744;3075
420860;201311;666;1982;451;1571;185;726;156;521;341;1247
420870;201311;1381;4107;1112;3720;442;1631;331;1075;773;2706
420880;201311;1463;5013;1204;4302;334;1237;244;833;578;2070
420890;201311;12522;30277;5876;18718;1219;4594;2283;6537;3502;11131
420895;201311;220;620;106;360;39;137;25;85;64;222
420900;201311;2285;6808;1545;5317;455;1716;377;1225;832;2941
420910;201311;22522;71042;15179;54801;4029;16579;3858;12926;7887;29505
420915;201311;654;2587;602;2447;170;708;271;1160;441;1868
420917;201311;412;1295;240;794;53;208;76;202;129;410
420920;201311;184;543;104;366;41;152;17;60;58;212
420930;201311;19833;62280;17251;57455;5798;21038;5789;19166;11587;40204
420940;201311;4501;14293;3927;12989;1239;4564;1242;3801;2481;8365
420945;201311;239;749;158;549;43;169;42;139;85;308
420950;201311;544;1676;300;1139;82;344;58;217;140;561
420960;201311;1443;4616;1230;4221;426;1618;384;1208;810;2826
420970;201311;2680;8660;2374;8160;670;2477;1213;4262;1883;6739
420980;201311;406;1438;367;1351;120;434;185;727;305;1161
420985;201311;500;1591;342;1242;108;426;86;298;194;724
420990;201311;879;2665;600;2157;151;596;179;594;330;1190
421000;201311;677;2453;485;1935;153;672;58;172;211;844
421003;201311;640;1892;277;985;64;252;42;128;106;380
421005;201311;256;844;217;772;66;260;101;357;167;617
421010;201311;6711;21380;5313;18462;1832;6842;1571;5201;3403;12043
421020;201311;518;1745;415;1524;90;331;213;834;303;1165
421030;201311;1043;3876;952;3631;347;1404;295;1133;642;2537
421040;201311;888;2796;760;2564;261;970;271;845;532;1815
421050;201311;1941;5351;1192;4063;318;1239;417;1322;735;2561
421055;201311;271;913;188;693;46;190;50;163;96;353
421060;201311;536;2027;444;1756;130;550;96;345;226;895
421070;201311;787;2542;542;1948;150;609;157;582;307;1191
421080;201311;674;2213;616;2092;198;726;257;845;455;1571
421085;201311;526;1487;298;1064;77;301;65;248;142;549
421090;201311;415;1246;317;1023;82;276;142;460;224;736
421100;201311;1005;3204;745;2610;205;759;175;545;380;1304
421105;201311;1384;4641;1233;4349;338;1278;517;1885;855;3163
421110;201311;1633;5448;1417;5075;522;2045;445;1513;967;3558
421120;201311;1579;5329;1228;4439;311;1315;379;1246;690;2561
421125;201311;382;1264;325;1129;119;449;109;345;228;794
421130;201311;3453;11775;2869;10656;1090;4446;928;3420;2018;7866
421140;201311;433;1405;350;1213;111;416;120;400;231;816
421145;201311;496;1671;415;1459;75;296;188;628;263;924
421150;201311;536;1820;419;1585;113;458;172;648;285;1106
421160;201311;825;2597;569;2050;134;532;177;597;311;1129
421165;201311;320;1170;263;980;64;253;105;407;169;660
421170;201311;1844;6089;1573;5352;490;1774;732;2428;1222;4202
421175;201311;1351;4151;1072;3672;363;1433;331;1022;694;2455
421180;201311;520;1561;326;1126;103;415;129;398;232;813
421185;201311;431;1306;354;1151;66;208;184;629;250;837
421187;201311;324;1028;260;898;78;281;95;307;173;588
421189;201311;529;1647;470;1524;135;471;168;534;303;1005
421190;201311;9711;32180;7586;27570;2478;9592;2224;8055;4702;17647
421200;201311;1061;3635;930;3327;291;1128;312;1071;603;2199
421205;201311;205;680;158;568;33;137;39;117;72;254
421210;201311;2072;6548;1788;5833;606;2097;561;1820;1167;3917
421220;201311;2466;8595;2211;8077;750;2955;686;2516;1436;5471
421223;201311;814;2413;551;1949;174;651;257;903;431;1554
421225;201311;1176;3718;992;3338;297;1084;377;1248;674;2332
421227;201311;941;3260;870;3140;259;934;501;1880;760;2814
421230;201311;745;2567;674;2385;198;764;238;780;436;1544
421240;201311;546;1881;368;1347;89;348;52;169;141;517
421250;201311;1886;5986;1349;4999;497;2010;356;1278;853;3288
421260;201311;258;814;158;609;39;149;32;117;71;266
421265;201311;47;158;36;127;7;25;15;57;22;82
421270;201311;661;1880;414;1443;149;555;81;301;230;856
421280;201311;1612;5217;1326;4768;468;1946;369;1305;837;3251
421290;201311;1946;5682;1311;4429;445;1592;282;871;727;2463
421300;201311;309;996;270;916;111;421;96;298;207;719
421310;201311;513;1796;442;1598;153;559;110;393;263;952
421315;201311;370;1145;235;855;50;187;58;193;108;380
421320;201311;536;1865;360;1350;69;291;63;181;132;472
421330;201311;635;2257;545;2065;224;959;66;232;290;1191
421335;201311;569;1912;450;1666;125;498;92;345;217;843
421340;201311;1720;5778;1554;5482;552;2113;610;2132;1162;4245
421350;201311;1074;3726;884;3312;310;1276;239;837;549;2113
421360;201311;3251;10004;2191;7841;515;2129;730;2468;1245;4597
421370;201311;1091;3942;939;3583;324;1352;252;948;576;2300
421380;201311;1028;3049;852;2703;175;599;415;1310;590;1909
421390;201311;189;627;150;530;23;87;42;152;65;239
421400;201311;376;1486;311;1320;134;584;75;297;209;881
421410;201311;363;1161;291;1009;73;258;131;475;204;733
421415;201311;319;1058;206;813;69;282;58;216;127;498
421420;201311;1416;4535;1080;3672;261;949;237;739;498;1688
421430;201311;284;966;226;847;81;347;47;164;128;511
421440;201311;810;2515;577;2066;177;689;217;736;394;1425
421450;201311;614;2173;497;1880;195;785;107;392;302;1177
421460;201311;651;2173;468;1768;122;515;108;371;230;886
421470;201311;492;1912;447;1804;137;581;179;710;316;1291
421480;201311;2777;9032;1966;7284;623;2612;564;1899;1187;4511
421490;201311;276;994;199;792;93;393;40;156;133;549
421500;201311;2678;9780;2390;9168;1032;4343;524;1917;1556;6260
421505;201311;402;1413;365;1312;134;486;124;453;258;939
421507;201311;606;2109;494;1823;121;457;191;705;312;1162
421510;201311;297;1143;272;1086;87;398;112;387;199;785
421520;201311;791;2183;521;1619;59;231;268;753;327;984
421530;201311;445;1524;316;1240;96;427;110;406;206;833
421535;201311;700;2215;441;1634;106;421;205;751;311;1172
421540;201311;383;1212;331;1106;82;312;120;382;202;694
421545;201311;1219;4316;1005;3860;334;1431;204;727;538;2158
421550;201311;2133;7511;1951;7131;762;3010;583;2054;1345;5064
421555;201311;239;780;132;479;33;132;34;113;67;245
421560;201311;183;579;93;347;24;93;15;60;39;153
421565;201311;1092;3499;990;3319;446;1599;304;977;750;2576
421567;201311;947;3619;818;3262;398;1628;158;630;556;2258
421568;201311;474;1621;393;1444;118;449;125;471;243;920
421569;201311;190;631;110;416;21;87;27;95;48;182
421570;201311;1004;3464;765;2897;271;1125;195;702;466;1827
421575;201311;609;2109;546;1973;119;451;287;1054;406;1505
421580;201311;4230;14376;3410;12505;1352;5494;741;2432;2093;7926
421590;201311;260;832;209;722;46;166;94;308;140;474
421600;201311;764;2449;614;2122;193;716;152;495;345;1211
421605;201311;678;2190;477;1761;135;562;112;390;247;952
421610;201311;1853;4909;1456;4330;211;678;931;2771;1142;3449
421620;201311;4855;15344;3566;12577;1278;4824;1144;4041;2422;8865
421625;201311;369;1254;238;885;65;270;75;262;140;532
421630;201311;2589;8058;1700;5987;481;1852;427;1442;908;3294
421635;201311;288;1024;247;949;72;298;89;311;161;609
421640;201311;1092;3602;976;3402;222;787;591;2106;813;2893
421650;201311;2351;8116;2066;7458;824;3265;330;1127;1154;4392
421660;201311;9111;31482;7474;28144;2610;10783;2197;7808;4807;18591
421670;201311;1106;3791;874;3213;258;1037;252;911;510;1948
421680;201311;1448;4870;1297;4499;530;1978;228;717;758;2695
421690;201311;2053;6959;1584;5771;474;1846;275;958;749;2804
421700;201311;715;2303;481;1791;167;682;119;369;286;1051
421710;201311;334;1207;277;1052;110;424;71;262;181;686
421715;201311;285;856;187;647;49;177;57;196;106;373
421720;201311;1634;5343;1335;4773;553;2175;387;1270;940;3445
421725;201311;129;471;124;457;39;152;51;184;90;336
421730;201311;609;1921;322;1213;87;366;76;233;163;599
421740;201311;685;2215;523;1824;159;644;120;326;279;970
421750;201311;1391;4387;1114;3775;346;1282;374;1146;720;2428
421755;201311;431;1448;337;1187;103;397;98;313;201;710
421760;201311;416;1386;294;1099;86;365;125;442;211;807
421770;201311;3690;11494;3027;10147;1324;4629;735;2515;2059;7144
421775;201311;563;1726;382;1366;91;332;118;422;209;754
421780;201311;1715;6096;1395;5358;581;2400;369;1328;950;3728
421790;201311;970;2861;629;2256;200;820;153;495;353;1315
421795;201311;384;1208;280;934;46;162;85;285;131;447
421800;201311;2460;8328;1958;7286;571;2366;630;2131;1201;4497
421810;201311;607;2069;497;1785;154;602;102;341;256;943
421820;201311;1088;3609;907;3218;215;913;318;1026;533;1939
421825;201311;1329;4630;1232;4386;220;874;671;2326;891;3200
421830;201311;3061;10785;2880;10425;698;2611;1562;5941;2260;8552
421835;201311;181;588;144;526;55;231;55;176;110;407
421840;201311;515;1860;462;1723;192;787;152;530;344;1317
421850;201311;570;1688;430;1446;143;500;131;469;274;969
421860;201311;451;1516;335;1264;73;305;97;341;170;646
421870;201311;5149;15647;3722;12622;1193;4327;678;2238;1871;6565
421875;201311;336;1049;204;746;51;212;49;153;100;365
421880;201311;1046;3590;845;3082;268;1108;204;658;472;1766
421885;201311;360;1294;325;1194;92;349;133;483;225;832
421890;201311;1082;3779;927;3437;326;1295;281;1016;607;2311
421895;201311;427;1482;406;1443;117;430;213;776;330;1206
421900;201311;882;2924;731;2549;207;765;255;805;462;1570
421910;201311;534;1794;390;1443;113;481;103;322;216;803
421915;201311;616;1929;494;1654;109;406;195;621;304;1027
421917;201311;556;1795;445;1581;142;593;141;448;283;1041
421920;201311;773;2447;629;2233;301;1157;178;569;479;1726
421930;201311;3759;11316;2744;9319;867;3261;448;1471;1315;4732
421935;201311;888;3203;712;2776;204;870;251;960;455;1830
421940;201311;291;1168;244;1011;92;410;54;196;146;606
421950;201311;4356;12646;2528;8807;798;2954;508;1790;1306;4744
421960;201311;261;849;210;729;55;210;57;194;112;404
421970;201311;2012;6368;1573;5347;540;2004;359;1098;899;3102
421985;201311;436;1260;266;900;45;185;90;309;135;494
430003;201311;913;2701;728;2375;211;763;249;794;460;1557
430005;201311;291;998;255;918;60;240;135;452;195;692
430010;201311;2083;6284;1640;5364;544;1833;590;1989;1134;3822
430020;201311;1100;3034;965;2831;241;808;521;1435;762;2243
430030;201311;1484;4250;1322;3916;399;1243;510;1446;909;2689
430040;201311;13046;34062;11278;31401;3514;10146;5067;14452;8581;24598
430045;201311;728;2048;587;1770;114;393;338;977;452;1370
430047;201311;207;601;168;526;43;138;81;256;124;394
430050;201311;1042;3002;706;2322;147;574;302;924;449;1498
430055;201311;263;777;191;615;44;156;98;306;142;462
430057;201311;69;183;30;101;7;30;11;24;18;54
430060;201311;14438;48657;13058;46143;4388;16116;5954;21559;10342;37675
430063;201311;1080;3292;907;2901;260;874;403;1329;663;2203
430064;201311;1651;5057;1411;4635;377;1259;737;2523;1114;3782
430066;201311;167;437;125;370;35;117;62;173;97;290
430070;201311;512;1719;402;1436;112;426;123;406;235;832
430080;201311;601;2019;483;1743;126;509;132;440;258;949
430085;201311;634;1886;492;1640;152;562;217;689;369;1251
430087;201311;979;3002;945;2938;100;330;765;2368;865;2698
430090;201311;751;2038;272;902;39;142;79;270;118;412
430100;201311;1009;3270;824;2900;308;1184;204;613;512;1797
430105;201311;669;2260;565;2059;221;859;133;470;354;1329
430107;201311;257;866;206;710;43;159;87;286;130;445
430110;201311;2178;6596;2034;6363;675;2296;940;2898;1615;5194
430120;201311;1726;5411;1421;4761;295;1040;845;2808;1140;3848
430130;201311;4536;11730;4164;11252;731;2089;2736;7524;3467;9613
430140;201311;1185;3886;922;3242;302;1073;316;1114;618;2187
430150;201311;901;2494;636;1988;158;530;200;603;358;1133
430155;201311;501;1604;381;1328;104;355;152;539;256;894
430160;201311;18485;55261;17248;53213;3869;13200;9718;30456;13587;43656
430163;201311;1862;5755;1613;5283;389;1438;757;2490;1146;3928
430165;201311;279;1002;240;921;112;441;43;157;155;598
430170;201311;767;2281;395;1395;101;396;86;270;187;666
430175;201311;954;3087;781;2708;182;575;410;1523;592;2098
430180;201311;1134;3167;987;2935;235;761;498;1485;733;2246
430185;201311;748;1905;407;1243;68;245;140;370;208;615
430187;201311;754;2372;687;2270;185;726;299;944;484;1670
430190;201311;2251;6821;1990;6359;522;1906;953;3056;1475;4962
430192;201311;186;589;103;336;18;63;34;105;52;168
430195;201311;235;702;83;309;14;53;14;42;28;95
430200;201311;1802;5965;1540;5423;561;2101;286;1008;847;3109
430205;201311;491;1507;404;1352;50;208;274;896;324;1104
430210;201311;6150;18055;3570;12340;999;3687;660;2113;1659;5800
430215;201311;318;955;246;807;62;220;105;329;167;549
430220;201311;654;1742;323;1096;69;270;53;167;122;437
430222;201311;317;996;245;839;68;266;100;318;168;584
430223;201311;311;981;288;938;60;201;193;636;253;837
430225;201311;57;169;37;120;6;14;7;20;13;34
430230;201311;2151;6866;2028;6735;354;1106;1532;5266;1886;6372
430235;201311;247;849;207;754;65;261;51;164;116;425
430237;201311;392;1119;331;1009;48;181;217;627;265;808
430240;201311;1029;3218;839;2820;311;1189;242;711;553;1900
430245;201311;839;2900;720;2617;204;761;315;1168;519;1929
430250;201311;1612;4551;1464;4279;545;1707;547;1630;1092;3337
430258;201311;210;597;146;474;24;83;67;210;91;293
430260;201311;831;2400;557;1811;76;280;323;1054;399;1334
430265;201311;323;1041;262;884;98;349;32;83;130;432
430270;201311;3438;10007;3124;9475;866;2981;1536;4586;2402;7567
430280;201311;5213;15307;4587;14107;1440;4731;1962;5942;3402;10673
430290;201311;2438;6924;2323;6799;329;984;1875;5577;2204;6561
430300;201311;9775;30672;8430;28090;3431;11973;3062;10541;6493;22514
430310;201311;8401;27127;7599;25547;2628;9505;3060;10051;5688;19556
430320;201311;812;2526;599;2079;93;319;310;1120;403;1439
430330;201311;979;2750;844;2488;235;747;350;957;585;1704
430340;201311;716;1914;454;1540;107;412;213;711;320;1123
430350;201311;6096;19898;5278;18059;2014;7268;1798;6048;3812;13316
430355;201311;236;654;152;497;28;112;36;101;64;213
430360;201311;1122;2995;985;2759;169;509;594;1659;763;2168
430367;201311;337;949;235;757;38;138;84;246;122;384
430370;201311;592;1786;494;1580;170;592;131;383;301;975
430380;201311;861;2253;473;1542;140;478;166;559;306;1037
430390;201311;4073;12495;3214;10588;833;3020;1031;3182;1864;6202
430400;201311;1296;3155;920;2612;226;740;480;1269;706;2009
430410;201311;685;1914;546;1680;102;359;282;851;384;1210
430420;201311;4449;13296;3712;11615;1147;3677;1489;4686;2636;8363
430430;201311;742;2138;520;1703;170;602;132;402;302;1004
430435;201311;1931;5410;1671;4923;381;1146;961;2895;1342;4041
430440;201311;4410;13938;3771;12856;841;3162;1720;6037;2561;9199
430450;201311;9140;26930;7572;23624;2791;9158;2460;7640;5251;16798
430460;201311;25192;78528;20974;70701;7103;25671;7431;25075;14534;50746
430461;201311;478;1357;164;541;36;123;41;140;77;263
430462;201311;335;1012;283;927;114;396;96;310;210;706
430463;201311;3858;12964;3446;12090;941;3608;1648;5776;2589;9384
430465;201311;623;1759;524;1583;126;424;322;964;448;1388
430466;201311;4268;12894;4032;12462;1286;4308;1849;5693;3135;10001
430467;201311;587;1822;519;1696;136;494;245;778;381;1272
430468;201311;1404;4249;1252;3996;541;1883;251;767;792;2650
430469;201311;126;346;40;159;11;44;11;50;22;94
430470;201311;7145;19488;5472;16735;1896;6310;1787;5417;3683;11727
430471;201311;928;3175;833;2960;309;1152;190;678;499;1830
430480;201311;828;2357;469;1549;79;292;97;274;176;566
430485;201311;236;743;132;485;27;96;45;179;72;275
430490;201311;530;1582;371;1270;108;386;128;447;236;833
430495;201311;401;1236;291;997;75;284;76;249;151;533
430500;201311;1644;4704;1422;4308;412;1381;676;2001;1088;3382
430510;201311;26481;84378;20708;69948;7285;26913;5737;18413;13022;45326
430511;201311;473;1478;288;997;76;261;53;178;129;439
430512;201311;1322;3540;1178;3298;340;983;482;1419;822;2402
430513;201311;658;1898;474;1511;87;280;220;706;307;986
430515;201311;606;1831;497;1594;103;355;213;698;316;1053
430517;201311;1352;4628;1250;4405;245;933;774;2692;1019;3625
430520;201311;1753;5254;1428;4552;473;1614;557;1725;1030;3339
430530;201311;948;2748;564;1841;132;488;158;450;290;938
430535;201311;2352;7824;2037;7064;568;2173;677;2310;1245;4483
430537;201311;607;1774;431;1488;57;191;331;1172;388;1363
430540;201311;732;1827;569;1603;128;406;330;889;458;1295
430543;201311;598;1602;538;1541;136;422;334;969;470;1391
430544;201311;697;2415;614;2181;155;578;301;1038;456;1616
430545;201311;1364;4519;1209;4326;433;1451;618;2468;1051;3919
430550;201311;602;1927;481;1654;122;470;197;654;319;1124
430558;201311;119;368;88;301;32;121;12;30;44;151
430560;201311;367;964;252;767;51;201;112;319;163;520
430570;201311;1157;3148;863;2610;216;716;427;1218;643;1934
430580;201311;1041;3059;735;2424;261;890;208;709;469;1599
430583;201311;117;330;48;161;11;44;4;10;15;54
430585;201311;330;939;244;746;80;287;105;289;185;576
430587;201311;299;961;261;876;120;418;75;246;195;664
430590;201311;1547;4436;1464;4300;326;1098;848;2416;1174;3514
430593;201311;36;143;34;136;14;61;9;30;23;91
430595;201311;167;522;105;381;38;144;13;36;51;180
430597;201311;370;1183;314;1055;59;221;135;435;194;656
430600;201311;1944;5602;1365;4288;322;1073;503;1540;825;2613
430605;201311;1317;4252;1089;3750;278;1040;439;1558;717;2598
430607;201311;683;1906;597;1752;138;464;339;941;477;1405
430610;201311;8040;22259;6479;19727;1520;5141;3117;9469;4637;14610
430613;201311;215;564;133;406;37;116;46;129;83;245
430620;201311;946;3000;799;2667;247;926;301;919;548;1845
430630;201311;454;1383;279;940;83;281;57;174;140;455
430632;201311;718;2043;485;1551;82;307;271;814;353;1121
430635;201311;659;1888;496;1572;108;346;244;782;352;1128
430637;201311;535;1546;488;1454;91;321;320;896;411;1217
430640;201311;1824;5342;1035;3470;238;843;206;580;444;1423
430642;201311;466;1286;347;1095;73;255;185;591;258;846
430645;201311;180;551;109;382;25;96;27;88;52;184
430650;201311;2040;6946;1794;6368;409;1523;986;3580;1395;5103
430655;201311;305;938;270;855;65;230;98;258;163;488
430660;201311;5888;17973;4808;15926;1568;5688;1876;6128;3444;11816
430670;201311;501;1484;454;1393;46;134;343;1091;389;1225
430673;201311;761;1919;452;1404;125;398;208;649;333;1047
430675;201311;186;564;134;444;26;100;64;205;90;305
430676;201311;4462;13912;4137;13379;1287;4502;1907;6322;3194;10824
430680;201311;1244;3766;936;3085;223;850;368;1115;591;1965
430690;201311;4401;13063;3721;11752;1197;3927;1498;4885;2695;8812
430692;201311;275;968;210;821;37;144;132;524;169;668
430693;201311;1770;5130;1379;4241;320;1060;444;1338;764;2398
430695;201311;506;1468;415;1283;97;341;194;559;291;900
430697;201311;434;1258;338;1087;118;385;129;444;247;829
430700;201311;10576;28648;5707;18754;1244;4592;849;2538;2093;7130
430705;201311;409;1307;380;1254;133;483;150;488;283;971
430710;201311;1841;4915;1491;4340;312;997;798;2414;1110;3411
430720;201311;874;2242;576;1802;171;572;227;746;398;1318
430730;201311;1738;4939;1486;4543;363;1108;835;2674;1198;3782
430740;201311;618;1826;393;1326;126;449;55;156;181;605
430745;201311;530;1544;375;1207;67;229;174;548;241;777
430750;201311;1789;5249;1562;4818;403;1388;800;2362;1203;3750
430755;201311;649;1882;467;1468;115;421;201;555;316;976
430760;201311;3657;9470;2903;8537;621;2017;1612;4919;2233;6936
430770;201311;6732;20657;5667;18741;1452;5292;2662;8619;4114;13911
430780;201311;2284;6700;1706;5575;508;1802;657;1998;1165;3800
430781;201311;643;1999;483;1673;146;538;171;577;317;1115
430783;201311;568;1511;441;1286;84;278;204;548;288;826
430786;201311;118;414;104;374;39;152;14;50;53;202
430790;201311;3480;9901;2426;7783;554;2068;1082;3264;1636;5332
430800;201311;756;2400;625;2069;171;603;216;691;387;1294
430805;201311;455;1359;354;1167;32;118;239;805;271;923
430807;201311;313;973;265;871;62;256;96;266;158;522
430810;201311;543;1617;310;1086;58;241;61;192;119;433
430820;201311;1220;4119;1004;3569;337;1288;304;1016;641;2304
430825;201311;453;1304;248;795;48;162;76;227;124;389
430830;201311;2718;8105;2516;7762;407;1301;1628;5299;2035;6600
430840;201311;961;3073;891;2914;240;769;405;1391;645;2160
430843;201311;97;322;76;251;15;49;30;94;45;143
430845;201311;439;1325;367;1188;124;429;69;214;193;643
430850;201311;3280;10297;2957;9672;925;3211;1171;3808;2096;7019
430860;201311;678;2279;546;1964;186;781;122;380;308;1161
430865;201311;717;2011;661;1906;210;616;321;941;531;1557
430870;201311;560;1661;391;1347;139;483;117;388;256;871
430880;201311;1364;4081;1129;3601;467;1600;282;914;749;2514
430885;201311;180;582;153;531;53;204;44;141;97;345
430890;201311;1649;4534;1367;4036;101;349;944;2778;1045;3127
430900;201311;3212;8898;3047;8683;578;1710;2058;6001;2636;7711
430905;201311;1064;3257;770;2600;277;1002;192;626;469;1628
430910;201311;1760;5780;1526;5319;601;2261;547;1846;1148;4107
430912;201311;590;1704;465;1494;72;263;252;788;324;1051
430915;201311;399;1441;307;1229;87;378;82;344;169;722
430920;201311;17085;55761;16076;53977;5781;20113;8479;28498;14260;48611
430925;201311;91;264;72;224;21;73;37;112;58;185
430930;201311;9016;29090;7622;26175;2307;8402;3030;10728;5337;19130
430940;201311;1107;3528;898;3104;215;842;297;983;512;1825
430950;201311;1599;4621;1232;3804;370;1220;389;1167;759;2387
430955;201311;91;304;73;256;28;110;17;51;45;161
430957;201311;317;1085;260;956;73;284;105;386;178;670
430960;201311;1701;5067;1454;4629;582;1920;475;1531;1057;3451
430965;201311;1304;4128;1131;3779;212;826;744;2418;956;3244
430970;201311;525;1550;344;1153;94;350;94;306;188;656
430975;201311;635;2103;501;1783;100;373;284;1010;384;1383
430980;201311;558;1404;351;1099;100;359;128;354;228;713
430990;201311;632;2110;486;1716;166;609;104;367;270;976
430995;201311;712;2167;647;2037;226;717;250;796;476;1513
431000;201311;1660;4610;1006;3253;256;946;151;417;407;1363
431010;201311;2781;8403;1955;6686;566;2154;610;1941;1176;4095
431020;201311;14211;36289;9993;28541;2932;8810;3206;9402;6138;18212
431030;201311;406;1263;256;893;57;205;63;231;120;436
431033;201311;2868;8482;2640;8142;624;1991;1530;4982;2154;6973
431036;201311;194;575;95;328;25;94;25;70;50;164
431040;201311;1006;3013;861;2754;240;841;435;1365;675;2206
431041;201311;587;1653;527;1564;200;632;174;540;374;1172
431043;201311;386;1322;314;1146;145;572;109;361;254;933
431046;201311;113;352;87;293;24;86;33;107;57;193
431050;201311;1813;4631;1563;4290;320;882;1007;2858;1327;3740
431053;201311;608;2049;523;1861;167;656;190;657;357;1313
431055;201311;689;1989;640;1892;83;251;461;1386;544;1637
431057;201311;331;974;196;699;57;222;79;274;136;496
431060;201311;6261;18675;5950;18293;1278;3624;4050;13129;5328;16753
431065;201311;440;1373;420;1339;50;172;288;918;338;1090
431070;201311;750;2242;485;1620;121;416;125;372;246;788
431075;201311;277;849;182;632;35;138;60;206;95;344
431080;201311;674;2230;565;1993;166;629;99;331;265;960
431085;201311;927;2535;755;2245;146;460;419;1244;565;1704
431087;201311;615;1788;560;1690;63;169;410;1266;473;1435
431090;201311;499;1318;289;912;102;332;63;187;165;519
431100;201311;4725;13418;4010;12158;1164;3731;1683;5237;2847;8968
431110;201311;1581;4448;1290;3853;349;1115;663;1923;1012;3038
431112;201311;661;2141;631;2089;226;741;301;1034;527;1775
431113;201311;630;1946;475;1580;164;540;130;452;294;992
431115;201311;1481;4529;1359;4309;317;1067;797;2504;1114;3571
431120;201311;2649;8755;2398;8252;754;2903;1008;3315;1762;6218
431123;201311;529;1687;449;1531;125;441;215;751;340;1192
431125;201311;1346;4304;1094;3752;330;1155;432;1571;762;2726
431127;201311;113;328;64;206;12;40;10;32;22;72
431130;201311;3872;11439;3277;10420;986;3420;1408;4523;2394;7943
431140;201311;3690;9976;2255;7423;483;1855;720;2082;1203;3937
431142;201311;550;1681;509;1613;65;225;340;1098;405;1323
431150;201311;1310;4048;1079;3608;310;1047;378;1313;688;2360
431160;201311;947;2864;811;2567;161;519;424;1415;585;1934
431162;201311;442;1228;234;793;34;139;42;122;76;261
431164;201311;97;259;34;125;13;45;2;5;15;50
431170;201311;920;2793;751;2445;240;822;226;728;466;1550
431171;201311;866;2683;776;2502;243;839;188;557;431;1396
431173;201311;480;1471;450;1417;102;337;274;867;376;1204
431175;201311;1315;3716;1147;3459;390;1237;479;1440;869;2677
431177;201311;977;3298;884;3092;290;1090;389;1368;679;2458
431179;201311;125;341;81;248;18;63;30;78;48;141
431180;201311;2777;8513;2233;7239;601;2158;670;2014;1271;4172
431190;201311;757;2138;479;1591;139;515;171;562;310;1077
431198;201311;367;1224;324;1131;145;565;65;204;210;769
431200;201311;273;813;115;387;25;90;17;53;42;143
431205;201311;296;999;233;821;61;226;82;281;143;507
431210;201311;763;2235;663;2025;167;538;344;1035;511;1573
431213;201311;316;1002;265;905;78;294;98;318;176;612
431215;201311;337;1013;171;592;32;113;24;72;56;185
431217;201311;243;759;190;637;66;237;50;173;116;410
431220;201311;1204;3140;908;2600;131;442;507;1381;638;1823
431225;201311;1346;4124;1187;3835;273;935;664;2176;937;3111
431230;201311;942;2888;748;2479;123;462;416;1378;539;1840
431235;201311;65;166;38;118;13;45;11;31;24;76
431237;201311;435;1443;383;1365;145;596;146;480;291;1076
431238;201311;52;173;43;151;10;41;15;47;25;88
431240;201311;2764;8852;2403;8177;885;3210;731;2489;1616;5699
431242;201311;429;1417;406;1372;168;638;27;79;195;717
431244;201311;435;1100;337;949;73;249;154;397;227;646
431245;201311;994;2810;855;2573;175;547;541;1647;716;2194
431247;201311;205;660;175;602;64;243;67;216;131;459
431250;201311;1894;6121;1700;5827;571;2113;671;2370;1242;4483
431260;201311;380;1128;270;899;69;263;60;181;129;444
431261;201311;233;843;201;768;55;243;55;202;110;445
431262;201311;346;997;160;563;28;130;65;215;93;345
431265;201311;1277;3549;824;2556;207;717;257;678;464;1395
431267;201311;194;601;161;542;46;166;69;213;115;379
431270;201311;2362;6845;2080;6422;696;2293;980;3044;1676;5337
431275;201311;212;706;145;515;47;158;27;80;74;238
431280;201311;149;477;102;363;26;107;27;76;53;183
431290;201311;341;1118;266;922;78;306;56;182;134;488
431295;201311;210;684;124;424;25;100;28;79;53;179
431300;201311;131;485;99;385;36;144;8;34;44;178
431301;201311;239;814;180;651;45;165;42;139;87;304
431303;201311;693;1917;550;1661;142;497;232;676;374;1173
431306;201311;2116;6033;1631;5097;338;1249;604;1688;942;2937
431308;201311;57;198;54;190;39;141;11;36;50;177
431310;201311;749;2458;569;2036;109;417;227;831;336;1248
431320;201311;829;2470;537;1875;170;670;120;374;290;1044
431330;201311;2073;5462;1102;3585;345;1231;200;635;545;1866
431333;201311;288;781;193;592;43;142;62;169;105;311
431335;201311;100;299;86;270;19;59;29;81;48;140
431337;201311;2582;8181;2123;7149;633;2226;613;2048;1246;4274
431339;201311;612;1821;486;1526;112;367;236;755;348;1122
431340;201311;27359;74942;20485;63080;5310;18180;8207;24659;13517;42839
431342;201311;609;1662;534;1525;117;352;340;954;457;1306
431344;201311;368;1064;292;929;27;93;175;565;202;658
431346;201311;289;800;182;545;56;173;50;150;106;323
431349;201311;564;1676;446;1401;93;290;163;510;256;800
431350;201311;3824;11759;3475;11148;587;2144;2224;6948;2811;9092
431360;201311;743;2115;597;1867;178;589;220;677;398;1266
431365;201311;1310;4153;1154;3885;452;1657;421;1394;873;3051
431370;201311;5513;16299;4731;14984;1280;4331;2183;7090;3463;11421
431380;201311;1119;3423;1057;3275;163;549;762;2333;925;2882
431390;201311;3420;10241;2546;8473;851;3116;731;2282;1582;5398
431395;201311;1591;4889;1431;4629;371;1272;609;2030;980;3302
431400;201311;181;605;119;460;36;152;11;29;47;181
431402;201311;1186;3072;786;2338;157;518;384;1100;541;1618
431403;201311;323;971;242;820;89;332;50;164;139;496
431405;201311;4553;13170;3658;11796;856;3238;1776;5482;2632;8720
431406;201311;799;2578;620;2122;218;781;224;755;442;1536
431407;201311;643;2021;490;1649;167;575;117;375;284;950
431410;201311;16628;52659;13635;46705;5559;20328;3289;11730;8848;32058
431413;201311;205;525;103;333;11;41;46;145;57;186
431415;201311;911;2663;776;2413;192;650;397;1202;589;1852
431417;201311;665;1752;536;1547;99;314;288;857;387;1171
431420;201311;1600;4525;1429;4238;349;1114;781;2355;1130;3469
431430;201311;590;1669;453;1445;123;429;178;540;301;969
431440;201311;32418;96983;29336;91776;9959;32626;13025;42250;22984;74876
431442;201311;204;671;158;549;52;203;20;51;72;254
431445;201311;500;1402;352;1073;68;223;145;427;213;650
431446;201311;496;1480;373;1226;99;333;164;533;263;866
431447;201311;841;2427;604;1899;113;381;288;912;401;1293
431449;201311;890;2599;738;2337;125;434;386;1245;511;1679
431450;201311;2242;6044;2074;5780;543;1572;1249;3476;1792;5048
431455;201311;624;1645;426;1243;119;377;154;417;273;794
431460;201311;3670;10582;3207;9688;921;2905;1267;3909;2188;6814
431470;201311;2188;6511;1841;5734;551;1695;787;2595;1338;4290
431475;201311;129;390;57;229;12;52;5;23;17;75
431477;201311;606;1778;494;1551;115;384;254;781;369;1165
431478;201311;202;543;98;301;24;78;37;114;61;192
431480;201311;2592;7888;2064;6853;715;2571;536;1728;1251;4299
431490;201311;107200;311279;94854;292528;18064;63618;61234;184806;79298;248424
431500;201311;1190;3164;954;2723;294;856;327;928;621;1784
431505;201311;367;1065;349;1041;35;96;281;851;316;947
431507;201311;452;1132;368;976;86;225;218;587;304;812
431510;201311;2211;6240;1879;5669;345;1141;1098;3247;1443;4388
431513;201311;223;684;177;571;47;164;71;228;118;392
431514;201311;116;297;52;163;10;33;14;41;24;74
431515;201311;748;2315;589;1930;136;493;290;887;426;1380
431517;201311;89;296;83;281;39;140;20;62;59;202
431520;201311;481;1482;319;1077;74;271;70;237;144;508
431530;201311;4587;11450;3669;10401;952;2705;2108;6389;3060;9094
431531;201311;288;838;204;663;49;175;79;267;128;442
431532;201311;537;1590;502;1516;126;422;245;709;371;1131
431535;201311;381;1140;263;832;59;214;72;207;131;421
431540;201311;2186;7184;1978;6886;281;907;1308;4908;1589;5815
431545;201311;134;403;56;206;5;18;12;48;17;66
431550;201311;2438;7539;2282;7245;559;2026;1099;3420;1658;5446
431555;201311;766;2073;676;1935;151;434;353;1009;504;1443
431560;201311;23625;75521;20840;69826;8907;30420;6444;22685;15351;53105
431570;201311;5676;16548;5225;15868;1481;4539;3083;9540;4564;14079
431575;201311;473;1279;355;1098;56;198;170;514;226;712
431580;201311;696;2265;596;2036;154;588;230;734;384;1322
431590;201311;925;2751;714;2281;78;267;396;1272;474;1539
431595;201311;608;1789;529;1610;131;422;195;609;326;1031
431600;201311;2230;6878;1742;5797;481;1805;376;1054;857;2859
431610;201311;1635;4744;1244;4012;318;1106;610;1958;928;3064
431620;201311;348;1128;247;823;89;318;94;288;183;606
431630;201311;1384;3883;1105;3280;271;843;571;1705;842;2548
431640;201311;5953;18293;5458;17467;1576;5557;2803;8772;4379;14329
431642;201311;507;1553;451;1428;73;274;251;764;324;1038
431643;201311;187;551;170;519;46;158;90;246;136;404
431645;201311;1793;5571;1653;5331;413;1353;954;3181;1367;4534
431647;201311;172;494;137;420;43;132;36;95;79;227
431650;201311;228;736;160;584;38;161;33;96;71;257
431660;201311;1468;4504;1164;3849;409;1413;404;1274;813;2687
431670;201311;1359;3910;1127;3498;339;1187;459;1355;798;2542
431673;201311;225;681;151;514;43;156;41;136;84;292
431675;201311;295;998;225;777;55;197;62;186;117;383
431680;201311;9967;29046;7923;25343;2564;8788;2767;8908;5331;17696
431690;201311;25492;75041;21087;68061;6838;23648;8195;26763;15033;50411
431695;201311;144;507;111;410;24;92;27;75;51;167
431697;201311;523;1504;470;1408;138;434;204;620;342;1054
431700;201311;1661;4756;1423;4294;295;971;757;2222;1052;3193
431710;201311;12980;38999;10952;35419;3242;11037;4663;15645;7905;26682
431720;201311;7061;20490;5981;18487;1422;4957;3140;9488;4562;14445
431725;201311;40;148;39;145;21;80;6;22;27;102
431730;201311;3722;11800;3109;10611;950;3624;1152;3929;2102;7553
431740;201311;6007;18072;5377;16813;1892;6393;1765;5353;3657;11746
431750;201311;10482;30434;9008;27981;1875;6270;4882;15447;6757;21717
431755;201311;262;690;76;264;21;83;14;42;35;125
431760;201311;3948;12299;3316;11037;988;3580;940;3035;1928;6615
431770;201311;2323;6533;2010;6022;527;1715;1028;3011;1555;4726
431775;201311;249;718;195;612;79;262;53;147;132;409
431780;201311;2576;7164;2055;6154;624;2047;579;1627;1203;3674
431790;201311;1172;3797;1052;3569;283;1043;546;1833;829;2876
431795;201311;474;1448;385;1225;80;266;189;600;269;866
431800;201311;9585;28999;8156;26326;2732;9643;2655;8367;5387;18010
431805;201311;279;684;82;283;20;76;21;71;41;147
431810;201311;3768;10784;3233;9657;824;2680;1544;4557;2368;7237
431820;201311;2751;8882;2480;8343;761;2797;919;2983;1680;5780
431830;201311;10631;29152;9070;26636;3352;10711;3244;9510;6596;20221
431840;201311;3589;10962;3159;10100;988;3280;1368;4457;2356;7737
431842;201311;728;1941;435;1353;100;332;140;422;240;754
431843;201311;335;1013;303;957;78;267;163;499;241;766
431844;201311;169;513;129;433;33;124;43;144;76;268
431845;201311;544;1700;507;1624;51;168;366;1194;417;1362
431846;201311;507;1588;451;1471;83;309;262;849;345;1158
431848;201311;190;516;93;319;19;79;21;65;40;144
431849;201311;347;882;123;387;26;93;35;95;61;188
431850;201311;5015;14900;4489;13909;1096;3713;2305;6983;3401;10696
431860;201311;981;2849;825;2593;212;738;405;1213;617;1951
431861;201311;84;276;57;199;14;52;10;30;24;82
431862;201311;489;1705;419;1550;162;661;103;355;265;1016
431870;201311;26358;75846;22276;68436;6348;21411;9490;28321;15838;49732
431880;201311;4752;15372;4003;13607;1249;4678;1561;5110;2810;9788
431890;201311;5800;17187;5170;15986;2044;6653;1583;5033;3627;11686
431900;201311;969;3092;810;2781;244;942;315;975;559;1917
431910;201311;902;2219;474;1396;110;364;178;485;288;849
431912;201311;611;1801;487;1542;152;473;172;565;324;1038
431915;201311;1382;3888;1059;3279;313;1005;356;1121;669;2126
431920;201311;1542;4439;1422;4270;193;551;1095;3375;1288;3926
431930;201311;1306;3695;1023;3213;151;461;616;2057;767;2518
431935;201311;101;397;95;380;44;187;19;57;63;244
431936;201311;484;1411;441;1333;74;222;288;942;362;1164
431937;201311;320;901;201;644;49;172;58;173;107;345
431940;201311;2757;7744;1925;6118;552;1866;553;1724;1105;3590
431950;201311;1910;6213;1698;5797;516;1919;652;2128;1168;4047
431960;201311;3724;11301;3424;10693;1098;3639;1194;3769;2292;7408
431970;201311;508;1417;283;938;51;186;83;259;134;445
431971;201311;136;415;115;382;17;59;65;213;82;272
431973;201311;479;1716;423;1598;69;261;247;1003;316;1264
431975;201311;15;62;11;51;2;12;3;13;5;25
431980;201311;1539;4552;1406;4288;379;1353;596;1695;975;3048
431990;201311;8800;25119;7256;22709;1509;5416;3443;10463;4952;15879
432000;201311;10979;32916;9057;29437;3048;10320;3771;12330;6819;22650
432010;201311;2521;7608;2190;6959;518;1892;1046;3173;1564;5065
432020;201311;2124;5803;1865;5443;331;1038;1181;3434;1512;4472
432023;201311;526;1558;410;1293;107;383;160;466;267;849
432026;201311;1210;3832;1057;3486;251;837;553;1875;804;2712
432030;201311;415;1261;350;1116;95;332;143;426;238;758
432032;201311;504;1367;370;1138;74;250;211;636;285;886
432035;201311;839;2780;775;2638;205;754;433;1440;638;2194
432040;201311;738;2226;527;1766;128;471;127;329;255;800
432045;201311;196;672;172;621;51;201;68;243;119;444
432050;201311;787;2328;704;2164;143;462;406;1276;549;1738
432055;201311;786;2527;707;2363;154;578;431;1405;585;1983
432057;201311;487;1313;397;1142;48;164;250;667;298;831
432060;201311;446;1297;203;726;63;243;48;159;111;402
432065;201311;242;716;187;612;45;168;84;246;129;414
432067;201311;979;3252;730;2650;213;792;308;1108;521;1900
432070;201311;2455;6914;1953;5891;639;2145;651;1891;1290;4036
432080;201311;4226;12529;3740;11640;1198;3941;1539;4725;2737;8666
432085;201311;258;853;220;777;82;329;61;203;143;532
432090;201311;1708;5423;1469;4890;588;2108;406;1174;994;3282
432100;201311;1187;3587;682;2382;173;632;126;378;299;1010
432110;201311;3086;9419;2501;8238;878;3160;489;1547;1367;4707
432120;201311;5244;16263;4519;14843;1610;5701;1362;4408;2972;10109
432130;201311;2208;6762;1990;6428;548;1907;1117;3640;1665;5547
432132;201311;419;1314;263;933;41;147;97;310;138;457
432135;201311;791;2403;750;2328;141;463;485;1512;626;1975
432140;201311;2911;8713;2387;7738;701;2389;902;3218;1603;5607
432143;201311;1353;4237;1189;3974;282;971;729;2508;1011;3479
432145;201311;1010;3259;701;2531;244;954;136;435;380;1389
432146;201311;277;879;201;689;68;245;53;176;121;421
432147;201311;831;2681;678;2344;196;701;278;984;474;1685
432149;201311;414;1257;289;951;88;302;95;307;183;609
432150;201311;3629;10968;2850;9443;1004;3567;851;2792;1855;6359
432160;201311;4529;15056;4086;14280;1485;5465;1550;5702;3035;11167
432162;201311;331;823;97;319;25;91;23;63;48;154
432163;201311;348;910;99;309;19;61;20;66;39;127
432166;201311;803;2438;658;2129;139;515;311;924;450;1439
432170;201311;796;2703;587;2217;140;582;129;429;269;1011
432180;201311;2788;7554;2045;6328;628;2138;597;1758;1225;3896
432183;201311;398;1357;371;1299;156;567;98;346;254;913
432185;201311;840;2467;567;1869;131;480;213;678;344;1158
432190;201311;3547;10040;2646;8026;724;2360;816;2330;1540;4690
432195;201311;1289;3726;1162;3535;196;634;753;2293;949;2927
432200;201311;3133;9907;2594;8954;843;3107;1065;3768;1908;6875
432210;201311;424;1278;376;1208;108;408;178;520;286;928
432215;201311;887;2833;801;2690;160;516;500;1764;660;2280
432218;201311;314;893;239;737;44;142;107;310;151;452
432220;201311;3828;10569;3248;9615;531;1811;2004;5784;2535;7595
432225;201311;60;205;51;189;30;114;8;31;38;145
432230;201311;1071;3055;890;2722;286;977;384;1061;670;2038
432232;201311;573;1705;456;1480;107;386;241;776;348;1162
432234;201311;549;1551;416;1213;106;324;169;463;275;787
432235;201311;77;244;44;164;20;86;10;38;30;124
432237;201311;509;1432;461;1353;38;142;377;1087;415;1229
432240;201311;15334;52323;13566;49917;3412;13625;8012;30039;11424;43664
432250;201311;5528;19753;5235;19135;2420;9504;1328;4925;3748;14429
432252;201311;433;1335;394;1263;129;435;186;604;315;1039
432253;201311;1256;4280;1012;3633;348;1294;317;1150;665;2444
432254;201311;458;1224;184;608;52;181;24;79;76;260
432255;201311;205;518;114;378;33;115;38;133;71;248
432260;201311;6772;18083;5078;15266;1257;4018;2432;7361;3689;11379
432270;201311;2699;8550;2391;8011;721;2510;1163;3982;1884;6492
432280;201311;1129;3383;757;2563;185;716;203;582;388;1298
432285;201311;137;437;67;227;20;72;13;36;33;108
432290;201311;602;1862;423;1440;99;371;161;525;260;896
432300;201311;23113;72507;21337;69391;5955;20568;11048;35882;17003;56450
432310;201311;989;3174;866;2931;206;776;438;1412;644;2188
432320;201311;265;772;189;618;57;189;66;224;123;413
432330;201311;220;674;98;348;16;57;9;25;25;82
432335;201311;208;614;94;330;27;102;9;26;36;128
432340;201311;286;766;158;488;46;148;43;123;89;271
432345;201311;752;2181;695;2095;169;614;370;1030;539;1644
432350;201311;456;1320;319;1056;81;286;84;261;165;547
432360;201311;43;137;34;118;13;47;12;38;25;85
432370;201311;483;1389;406;1249;39;114;274;862;313;976
432375;201311;846;2215;695;1967;126;361;426;1228;552;1589
432377;201311;77;265;36;123;7;24;9;21;16;45
432380;201311;855;3093;784;2924;354;1456;247;849;601;2305
500020;201311;2075;6904;1636;5952;526;2125;443;1476;969;3601
500025;201311;940;2491;633;1933;132;425;262;772;394;1197
500060;201311;6003;17900;5063;16556;608;1977;3797;12863;4405;14840
500070;201311;3795;11748;3289;10886;811;3049;1551;4987;2362;8036
500080;201311;1719;5289;1333;4576;469;1754;389;1384;858;3138
500085;201311;2101;5774;1589;4948;226;774;949;2867;1175;3641
500090;201311;2281;6922;1810;6058;412;1439;939;3232;1351;4671
500100;201311;2443;7569;2291;7331;802;2921;980;2957;1782;5878
500110;201311;8008;23839;6634;21744;1111;4062;3903;13302;5014;17364
500124;201311;1764;5970;1536;5566;308;1117;852;3339;1160;4456
500150;201311;1294;3571;1092;3269;309;1029;516;1481;825;2510
500190;201311;4757;13019;3768;11773;867;2918;2077;6707;2944;9625
500200;201311;2534;6651;1857;5667;395;1396;997;2929;1392;4325
500210;201311;4841;14913;4235;13982;1025;3641;2151;7322;3176;10963
500215;201311;1727;5497;1452;4938;358;1383;603;1929;961;3312
500220;201311;2674;8664;2179;7687;561;2152;825;2956;1386;5108
500230;201311;2266;6424;1833;5762;743;2571;618;1902;1361;4473
500240;201311;4661;14750;3496;12422;756;2994;1500;5517;2256;8511
500260;201311;2451;6852;2042;6193;441;1485;1007;2871;1448;4356
500270;201311;102420;275541;70899;220911;21891;74286;18250;57144;40141;131430
500280;201311;1284;3880;1118;3644;221;764;670;2247;891;3011
500290;201311;3791;10070;2576;7935;731;2609;873;2467;1604;5076
500295;201311;2300;7298;1747;5944;442;1728;480;1420;922;3148
500310;201311;773;2113;700;2014;171;534;389;1073;560;1607
500315;201311;2831;9130;2466;8616;577;1959;1432;5364;2009;7323
500320;201311;13046;44950;11607;42312;4057;15602;4200;16276;8257;31878
500325;201311;4035;11069;3125;9588;938;3185;1315;3846;2253;7031
500330;201311;5341;15264;4450;13663;1476;4928;1783;5332;3259;10260
500345;201311;2354;7229;2037;6634;515;1864;1014;3207;1529;5071
500348;201311;2345;7135;2191;6875;284;999;1630;5097;1914;6096
500350;201311;1223;3796;774;2743;135;499;239;887;374;1386
500370;201311;22479;72021;18138;63436;4841;18822;6997;24350;11838;43172
500375;201311;2622;7382;2005;6251;475;1578;955;3072;1430;4650
500380;201311;2919;8702;2510;7869;796;2675;843;2604;1639;5279
500390;201311;557;1235;368;963;58;192;249;594;307;786
500400;201311;1217;3986;1052;3592;344;1293;300;923;644;2216
500410;201311;2128;6090;1751;5539;479;1649;769;2444;1248;4093
500430;201311;2517;7895;2111;7253;576;2090;960;3427;1536;5517
500440;201311;1315;3913;1121;3598;300;1095;584;1799;884;2894
500450;201311;2128;6757;1681;5795;448;1744;348;1072;796;2816
500460;201311;3597;11143;2935;10107;807;3035;1184;4043;1991;7078
500470;201311;3026;9337;2341;7755;718;2589;436;1324;1154;3913
500480;201311;1981;6544;1838;6323;200;717;1441;5071;1641;5788
500490;201311;1062;3117;897;2839;289;1024;293;930;582;1954
500500;201311;3245;10330;2709;9574;1040;4114;884;3056;1924;7170
500510;201311;870;2393;606;1942;144;553;241;694;385;1247
500515;201311;1749;5003;1451;4579;271;832;926;3103;1197;3935
500520;201311;2702;9717;2410;9308;616;2510;1376;5562;1992;8072
500525;201311;1141;3800;998;3530;241;918;509;1886;750;2804
500540;201311;4928;14832;3326;11609;1022;4022;781;2595;1803;6617
500560;201311;4432;15410;4039;14834;909;3508;2561;9572;3470;13080
500568;201311;3717;10110;2854;8822;685;2268;1310;4114;1995;6382
500570;201311;7354;20827;5403;17372;1657;5728;2060;6642;3717;12370
500580;201311;3347;10077;2680;8844;546;1936;1532;5061;2078;6997
500600;201311;2860;8290;2220;7234;674;2401;818;2635;1492;5036
500620;201311;7896;22533;5880;19244;1452;5401;2849;9187;4301;14588
500625;201311;789;2439;551;1929;150;575;180;582;330;1157
500627;201311;93;226;53;152;10;32;12;35;22;67
500630;201311;6062;17394;4919;15733;1761;6233;1406;4464;3167;10697
500635;201311;2313;9282;2059;8906;315;1300;1343;6312;1658;7612
500640;201311;1359;3595;1103;3224;172;569;705;1996;877;2565
500660;201311;15006;46782;12610;42584;2947;11057;6189;20829;9136;31886
500690;201311;3036;8923;2498;8248;679;2318;1314;4611;1993;6929
500710;201311;3383;10773;3130;10378;864;3050;1617;5383;2481;8433
500720;201311;4474;13754;3516;11793;1148;4238;1092;3594;2240;7832
500730;201311;940;2759;755;2385;187;666;311;947;498;1613
500740;201311;3621;10337;2693;8683;624;2338;1196;3624;1820;5962
500750;201311;813;2490;748;2395;198;684;409;1329;607;2013
500755;201311;1239;3760;961;3237;241;882;370;1192;611;2074
500769;201311;4511;12410;3128;9681;739;2561;1038;2936;1777;5497
500770;201311;1612;4981;1319;4402;395;1427;446;1503;841;2930
500780;201311;1047;3374;938;3151;295;1068;418;1364;713;2432
500790;201311;8484;24673;7145;22272;1490;5436;3838;11396;5328;16832
500793;201311;2393;7071;1905;6233;362;1313;845;2611;1207;3924
500795;201311;2246;6863;2028;6540;269;741;1493;5145;1762;5886
500797;201311;911;2547;706;2205;154;527;334;1056;488;1583
500800;201311;2305;6961;1943;6430;651;2418;813;2677;1464;5095
500830;201311;15277;46286;11454;38203;3496;12684;3194;10350;6690;23034
500840;201311;1242;3839;1013;3373;202;743;495;1634;697;2377
510010;201311;1237;3989;1157;3854;392;1380;508;1736;900;3116
510020;201311;2723;8092;1980;6714;578;2077;513;1661;1091;3738
510025;201311;8873;27466;7864;25768;2516;9140;3169;10079;5685;19219
510030;201311;2072;5693;1753;5215;576;1782;786;2372;1362;4154
510035;201311;901;2737;768;2532;179;607;421;1450;600;2057
510040;201311;1667;4701;1328;4192;293;1051;671;2077;964;3128
510050;201311;1823;5426;1355;4547;389;1457;504;1684;893;3141
510060;201311;1202;3654;941;3147;273;1000;310;998;583;1998
510080;201311;1296;4095;1086;3727;328;1314;365;1132;693;2446
510100;201311;621;1693;416;1281;98;340;157;460;255;800
510120;201311;289;601;194;497;14;31;169;439;183;470
510125;201311;2919;7914;2370;6995;481;1738;1142;3180;1623;4918
510130;201311;2007;5711;1738;5294;549;1762;719;2212;1268;3974
510140;201311;2943;9872;2469;9117;918;3528;857;3252;1775;6780
510160;201311;1270;4346;1213;4279;89;356;1066;3759;1155;4115
510170;201311;5846;18450;4983;16816;1294;4898;2246;7347;3540;12245
510180;201311;10310;29138;7855;25048;2552;8654;2772;9606;5324;18260
510185;201311;1139;3747;1067;3644;250;825;677;2458;927;3283
510190;201311;1580;5502;1303;5030;336;1454;559;2248;895;3702
510250;201311;13403;43551;11679;41148;3674;13778;5569;20108;9243;33886
510260;201311;2526;9624;2339;9245;723;3020;1049;4336;1772;7356
510263;201311;4162;11870;3168;10145;929;3261;1044;3204;1973;6465
510267;201311;5064;14918;3776;12161;911;3248;1413;4328;2324;7576
510268;201311;857;2549;736;2367;212;758;371;1177;583;1935
510269;201311;809;2676;732;2546;230;835;310;1111;540;1946
510270;201311;2481;7841;2219;7440;427;1434;1314;4676;1741;6110
510279;201311;2050;6738;1883;6453;715;2723;602;1880;1317;4603
510285;201311;1456;4591;1241;4190;372;1363;421;1365;793;2728
510300;201311;3023;9547;2732;9140;413;1553;1985;6599;2398;8152
510305;201311;1610;5243;1328;4686;382;1488;430;1535;812;3023
510310;201311;1095;3227;870;2863;310;1130;261;839;571;1969
510320;201311;3925;11965;3134;10339;990;3776;588;1658;1578;5434
510325;201311;5425;17678;4759;16711;636;2207;3601;13114;4237;15321
510330;201311;2676;9033;2325;8381;646;2589;897;3288;1543;5877
510335;201311;4411;14298;3941;13659;687;2374;2797;10107;3484;12481
510336;201311;490;1587;443;1495;100;360;224;756;324;1116
510337;201311;2214;7561;1967;7097;769;2804;680;2689;1449;5493
510340;201311;59366;179841;48163;162603;19542;71952;10844;38632;30386;110584
510343;201311;1128;3437;1038;3325;127;384;827;2737;954;3121
510345;201311;1657;4969;1414;4545;379;1321;518;1614;897;2935
510350;201311;3230;9740;2725;9041;808;2878;1314;4438;2122;7316
510360;201311;1755;4841;1338;4322;285;987;845;2697;1130;3684
510370;201311;883;3278;794;3124;231;937;393;1601;624;2538
510380;201311;466;1545;376;1354;139;556;64;210;203;766
510385;201311;874;3353;752;3034;134;590;356;1535;490;2125
510390;201311;1117;3565;1025;3452;266;871;583;2103;849;2974
510395;201311;815;2195;632;1957;120;397;373;1207;493;1604
510410;201311;3832;12933;3629;12579;1093;4087;1816;6288;2909;10375
510420;201311;2249;6024;1734;5172;306;1082;905;2667;1211;3749
510450;201311;573;1631;445;1449;149;547;140;442;289;989
510452;201311;605;1964;448;1599;118;468;156;512;274;980
510454;201311;724;2355;642;2235;167;609;346;1256;513;1865
510455;201311;956;3031;753;2649;191;792;307;1024;498;1816
510460;201311;1849;5550;1678;5329;370;1348;1067;3282;1437;4630
510480;201311;3961;11119;3100;9474;800;2652;1067;3169;1867;5821
510490;201311;1459;4909;1315;4693;373;1427;730;2584;1103;4011
510500;201311;1366;4248;1036;3637;292;1176;469;1569;761;2745
510510;201311;2976;10720;2649;10153;1027;4139;969;3756;1996;7895
510515;201311;5515;17334;4524;15284;1249;4748;1310;4139;2559;8887
510517;201311;1705;5285;1524;5017;461;1463;900;3113;1361;4576
510520;201311;2148;5695;1686;5034;139;484;1281;3810;1420;4294
510523;201311;1010;3170;858;2917;292;1055;369;1223;661;2278
510525;201311;7741;19995;4964;15529;1262;4291;1789;5502;3051;9793
510530;201311;562;1634;488;1527;89;323;282;884;371;1207
510550;201311;2626;8903;2310;8353;662;2478;1058;3967;1720;6445
510558;201311;2042;6040;1612;5390;514;1869;599;1984;1113;3853
510560;201311;1540;5222;1170;4545;435;1765;268;1105;703;2870
510562;201311;5036;15735;4424;14504;1576;5677;1442;4759;3018;10436
510590;201311;2684;7891;2158;7210;630;2309;943;3197;1573;5506
510600;201311;1457;3796;1019;3120;167;565;529;1563;696;2128
510610;201311;2569;7956;2408;7759;292;1097;1944;6198;2236;7295
510615;201311;2108;7054;1872;6635;640;2449;791;2766;1431;5215
510617;201311;520;1643;464;1559;79;301;337;1139;416;1440
510618;201311;1285;3904;963;3267;247;949;427;1427;674;2376
510619;201311;761;2148;499;1662;109;400;147;492;256;892
510620;201311;1176;3239;804;2685;293;1101;173;530;466;1631
510621;201311;1029;3645;892;3323;275;1120;302;1068;577;2188
510622;201311;3500;10955;2342;8247;593;2346;397;1192;990;3538
510623;201311;3607;10574;3081;9726;1113;3727;1103;3458;2216;7185
510624;201311;1071;3525;916;3220;217;855;411;1352;628;2207
510625;201311;2284;6805;1841;5983;547;2000;508;1575;1055;3575
510626;201311;1208;3961;1015;3644;339;1326;468;1681;807;3007
510627;201311;632;2051;530;1849;208;789;161;555;369;1344
510628;201311;1484;3944;1197;3595;176;597;820;2455;996;3052
510629;201311;1749;5907;1527;5420;566;2205;335;1115;901;3320
510630;201311;2618;8883;2207;8155;750;3100;602;2259;1352;5359
510631;201311;400;1185;358;1113;78;244;228;709;306;953
510637;201311;2522;7888;2296;7470;740;2646;1038;3262;1778;5908
510642;201311;4630;15431;4000;14580;1414;5385;1776;6779;3190;12164
510645;201311;695;1761;555;1586;213;633;167;532;380;1165
510650;201311;5853;20283;5497;19832;1392;5293;3326;12446;4718;17739
510665;201311;1209;3288;863;2741;206;744;397;1258;603;2002
510670;201311;350;877;212;674;51;194;81;237;132;431
510675;201311;6026;20330;5261;18862;1866;7345;1512;5289;3378;12634
510677;201311;2479;6459;1869;5668;278;875;1320;4129;1598;5004
510680;201311;786;2520;675;2338;161;622;285;912;446;1534
510682;201311;2332;7507;1946;6811;532;1999;856;3138;1388;5137
510685;201311;913;2571;783;2411;106;368;567;1754;673;2122
510700;201311;3479;10002;2723;8883;592;2158;1598;5185;2190;7343
510704;201311;7814;22826;6560;20584;1790;6342;3123;9453;4913;15795
510706;201311;1606;5142;1314;4652;408;1524;608;2142;1016;3666
510710;201311;3554;10321;2822;8832;841;2987;938;2619;1779;5606
510715;201311;695;1839;473;1467;121;411;172;494;293;905
510718;201311;1706;5212;1517;4952;398;1342;871;2912;1269;4254
510719;201311;442;1027;268;791;35;145;122;328;157;473
510720;201311;1258;3015;933;2630;87;270;721;2059;808;2329
510724;201311;810;2549;690;2320;155;576;400;1311;555;1887
510726;201311;665;1835;560;1653;168;520;205;582;373;1102
510729;201311;629;1792;520;1617;157;522;214;673;371;1195
510730;201311;2171;7003;1988;6672;492;1904;1110;3527;1602;5431
510735;201311;1055;3693;893;3414;338;1371;348;1329;686;2700
510740;201311;976;2565;799;2319;182;526;473;1403;655;1929
510757;201311;652;2337;605;2229;174;675;292;1068;466;1743
510760;201311;26537;77507;21598;68859;7975;27147;7074;22547;15049;49694
510770;201311;4200;11823;3903;11466;658;1908;2506;8158;3164;10066
510774;201311;370;1079;306;977;71;252;155;481;226;733
510775;201311;846;2411;674;2149;252;904;250;802;502;1706
510776;201311;365;1139;314;1043;79;293;153;482;232;775
510777;201311;1388;4401;1123;4071;269;1121;672;2389;941;3510
510779;201311;615;1868;471;1599;88;323;186;655;274;978
510780;201311;3675;11212;3266;10627;775;2687;1883;6268;2658;8955
510785;201311;1838;5618;1539;5116;528;1861;568;1920;1096;3781
510787;201311;1987;6367;1757;5947;555;2049;667;2192;1222;4241
510788;201311;353;1118;325;1080;143;462;105;372;248;834
510790;201311;14536;43430;10066;34785;3019;11969;1443;4784;4462;16753
510792;201311;5620;18837;4227;15800;1148;4929;800;2792;1948;7721
510794;201311;1341;4243;1070;3806;499;1864;211;682;710;2546
510795;201311;8158;27760;6749;24780;2365;9307;1811;6747;4176;16054
510800;201311;1743;5117;1478;4755;417;1479;705;2171;1122;3650
510805;201311;1764;5075;1457;4624;298;1101;921;2854;1219;3955
510810;201311;652;1641;524;1465;156;474;262;712;418;1186
510820;201311;831;2110;640;1821;167;560;247;636;414;1196
510830;201311;546;1938;494;1854;175;701;217;863;392;1564
510835;201311;688;2200;549;1938;200;770;210;690;410;1460
510840;201311;47907;124058;39224;113146;10212;31196;20670;61523;30882;92719
510850;201311;1650;4931;1341;4451;593;2201;206;541;799;2742
510860;201311;2448;8367;2014;7393;711;2816;367;1299;1078;4115
510880;201311;809;2784;718;2610;262;1002;257;932;519;1934
510885;201311;541;1580;409;1376;92;346;182;610;274;956
510890;201311;895;3080;769;2832;263;1079;198;656;461;1735
510895;201311;1112;3651;992;3424;306;1174;389;1253;695;2427
520005;201311;1191;3969;1110;3837;365;1325;483;1686;848;3011
520010;201311;1800;6381;1597;5918;714;2942;242;760;956;3702
520013;201311;3937;11175;3037;9585;785;2646;1384;4407;2169;7053
520015;201311;576;1614;462;1442;133;429;174;557;307;986
520017;201311;1171;3748;1027;3504;295;1094;434;1442;729;2536
520020;201311;414;1118;318;964;90;287;156;494;246;781
520025;201311;21315;71439;20809;70794;3391;12234;15932;54319;19323;66553
520030;201311;4440;14738;3965;13941;1367;5194;1464;5236;2831;10430
520050;201311;342;1042;317;989;64;223;211;640;275;863
520055;201311;666;2037;571;1873;149;483;287;980;436;1463
520060;201311;1647;5221;1447;4833;349;1294;586;1994;935;3288
520080;201311;1496;5066;1390;4849;367;1314;718;2565;1085;3879
520082;201311;603;2078;575;2017;152;528;336;1214;488;1742
520085;201311;1002;3208;875;2901;213;782;337;1105;550;1887
520090;201311;805;2185;720;2043;133;343;437;1302;570;1645
520110;201311;38254;118366;30277;106021;12427;47504;7661;27181;20088;74685
520120;201311;262;689;152;492;37;141;37;124;74;265
520130;201311;3635;10933;3377;10533;739;2481;2016;6303;2755;8784
520140;201311;42484;145066;38503;136946;14284;54752;11310;40072;25594;94824
520145;201311;533;1405;394;1209;97;325;162;475;259;800
520150;201311;676;1809;555;1660;163;535;262;768;425;1303
520160;201311;818;2515;734;2392;265;912;279;933;544;1845
520170;201311;3773;9586;3078;8834;613;1879;2097;6141;2710;8020
520180;201311;1621;5240;1450;4949;448;1648;606;2047;1054;3695
520215;201311;1556;4214;1355;3915;301;982;792;2280;1093;3262
520235;201311;780;2197;631;1973;194;675;267;807;461;1482
520250;201311;1102;3779;1027;3646;357;1344;492;1778;849;3122
520260;201311;729;1986;564;1683;102;354;286;821;388;1175
520280;201311;574;1694;512;1603;246;815;132;460;378;1275
520310;201311;938;2475;765;2263;210;637;440;1374;650;2011
520320;201311;1431;4716;1206;4276;234;875;653;2386;887;3261
520330;201311;2797;8889;2157;7703;667;2566;465;1584;1132;4150
520340;201311;1869;4870;1513;4451;225;630;1154;3511;1379;4141
520350;201311;2926;9056;2563;8315;947;3312;1055;3316;2002;6628
520355;201311;1100;3899;1067;3823;434;1628;434;1538;868;3166
520357;201311;878;2441;754;2262;73;249;518;1537;591;1786
520360;201311;582;1636;516;1529;143;428;240;714;383;1142
520380;201311;1092;3057;828;2600;169;590;441;1399;610;1989
520390;201311;1171;3171;822;2694;273;1020;306;922;579;1942
520393;201311;568;1529;513;1436;98;290;336;943;434;1233
520396;201311;694;2264;649;2186;94;368;446;1508;540;1876
520400;201311;1701;4951;1448;4599;279;955;913;2925;1192;3880
520410;201311;1418;4004;1164;3628;351;1209;528;1607;879;2816
520420;201311;328;930;250;782;49;184;116;339;165;523
520425;201311;1413;3998;1321;3834;446;1381;624;1785;1070;3166
520430;201311;1867;5086;1428;4355;324;1139;648;1903;972;3042
520440;201311;2912;8238;2302;7231;865;2999;622;1908;1487;4907
520450;201311;9219;27352;7280;23666;2214;8007;1594;4833;3808;12840
520455;201311;654;1993;544;1815;226;814;147;489;373;1303
520460;201311;802;2399;663;2159;195;703;246;776;441;1479
520465;201311;799;2225;701;2093;171;629;319;869;490;1498
520470;201311;1691;5610;1547;5394;396;1396;926;3373;1322;4769
520480;201311;948;2852;832;2662;194;648;490;1588;684;2236
520485;201311;1126;3926;1050;3786;416;1597;454;1635;870;3232
520490;201311;4286;13546;3473;12267;1495;5691;1094;3857;2589;9548
520495;201311;1387;3812;1162;3545;82;235;1026;3199;1108;3434
520500;201311;2017;5496;1805;5197;621;1903;728;2266;1349;4169
520505;201311;887;2573;766;2387;124;377;528;1707;652;2084
520510;201311;10708;30915;7256;24902;2307;8688;1835;6245;4142;14933
520520;201311;1026;3049;874;2843;343;1193;330;1094;673;2287
520530;201311;2352;7415;2041;6900;490;1696;996;3729;1486;5425
520540;201311;2875;9046;2538;8431;845;2960;1015;3349;1860;6309
520545;201311;1295;4066;1113;3677;334;1208;335;1043;669;2251
520547;201311;777;2502;630;2224;218;855;178;586;396;1441
520549;201311;8287;25978;7271;24706;2043;7434;3868;13172;5911;20606
520551;201311;3662;11314;3511;11123;1064;3519;1942;6393;3006;9912
520552;201311;685;2335;670;2313;123;475;453;1548;576;2023
520570;201311;561;1688;423;1454;184;677;77;257;261;934
520580;201311;1932;5780;1595;5259;496;1841;503;1583;999;3424
520590;201311;1450;4221;1264;3920;356;1179;508;1476;864;2655
520620;201311;6896;22897;6318;21997;1506;5630;3643;12838;5149;18468
520630;201311;627;1795;543;1693;164;499;301;970;465;1469
520640;201311;2483;7589;2247;7218;812;2717;945;3187;1757;5904
520650;201311;795;2340;687;2143;288;947;250;770;538;1717
520660;201311;361;1161;314;1061;107;396;96;321;203;717
520670;201311;779;2361;757;2329;77;193;650;2054;727;2247
520680;201311;578;1782;503;1675;181;663;187;610;368;1273
520690;201311;312;831;221;705;36;119;122;402;158;521
520710;201311;409;1061;297;858;13;44;190;527;203;571
520725;201311;1729;4662;1367;4137;335;1136;706;2106;1041;3242
520735;201311;607;1908;512;1733;184;666;162;521;346;1187
520740;201311;1641;4900;1389;4526;395;1365;659;2134;1054;3499
520750;201311;683;1876;520;1658;144;516;297;942;441;1458
520753;201311;1126;3388;1099;3345;178;496;836;2645;1014;3141
520760;201311;1132;3211;999;3040;334;1100;533;1598;867;2698
520780;201311;1894;4961;1656;4641;196;542;1292;3701;1488;4243
520790;201311;2459;7204;2211;6852;347;1180;1566;4904;1913;6084
520800;201311;16890;51198;15138;49084;3620;11579;8978;31365;12598;42944
520810;201311;829;2506;802;2461;131;416;611;1906;742;2322
520815;201311;417;1457;328;1278;168;737;32;113;200;850
520830;201311;1678;4356;1318;3980;62;161;1192;3690;1254;3851
520840;201311;1618;5548;1462;5234;512;1946;511;1871;1023;3817
520850;201311;773;2297;615;2077;192;693;279;926;471;1619
520860;201311;6775;19756;5159;17593;1502;5552;2473;8602;3975;14154
520870;201311;118738;340212;85251;278719;28253;100391;25375;82151;53628;182542
520880;201311;6500;19399;4764;16493;1470;5700;676;2134;2146;7834
520890;201311;3495;10672;3160;10145;783;2694;1687;5390;2470;8084
520910;201311;3238;10519;2760;9497;921;3483;723;2349;1644;5832
520915;201311;888;2579;659;2130;165;561;245;750;410;1311
520920;201311;3027;8421;2208;7067;593;2048;681;2244;1274;4292
520929;201311;438;1318;398;1270;116;385;204;649;320;1034
520940;201311;929;2885;853;2765;127;471;610;1942;737;2413
520945;201311;616;1584;545;1471;217;590;185;481;402;1071
520960;201311;869;2595;718;2369;120;415;433;1427;553;1842
520970;201311;3320;9840;2696;8695;618;2246;1089;3429;1707;5675
520980;201311;1001;2754;933;2662;219;698;626;1754;845;2452
520990;201311;3638;11495;3237;10790;685;2455;1731;6276;2416;8731
520993;201311;1093;3101;891;2719;148;500;522;1561;670;2061
520995;201311;2522;7039;2276;6705;375;1160;1629;4817;2004;5977
521000;201311;7565;23113;6476;21285;1569;5679;3344;11002;4913;16681
521010;201311;3602;11598;3149;10687;869;3188;1314;4475;2183;7663
521015;201311;654;1896;561;1743;143;457;289;912;432;1369
521020;201311;4294;12924;3431;11116;1248;4375;713;2068;1961;6443
521030;201311;807;2195;712;2062;148;450;467;1369;615;1819
521040;201311;5327;15936;4887;15233;1916;6069;2246;7322;4162;13391
521056;201311;977;3043;831;2798;288;1013;346;1197;634;2210
521060;201311;1113;3188;964;2932;241;784;395;1165;636;1949
521080;201311;1139;2924;760;2280;170;605;271;695;441;1300
521090;201311;3065;9308;2638;8690;983;3432;900;2978;1883;6410
521100;201311;1383;3670;1281;3552;251;692;889;2534;1140;3226
521120;201311;4676;13825;4293;13168;1036;3121;2417;7715;3453;10836
521130;201311;1055;3090;897;2821;207;730;451;1432;658;2162
521140;201311;881;3013;796;2809;307;1158;166;558;473;1716
521150;201311;12018;32859;8469;25882;2620;8774;3419;10239;6039;19013
521160;201311;714;1869;499;1434;92;304;294;799;386;1103
521170;201311;1301;3199;1129;2988;330;851;645;1726;975;2577
521180;201311;6224;21554;5705;20467;2173;8327;1592;5686;3765;14013
521190;201311;8298;25352;6358;21922;2294;8338;1981;6896;4275;15234
521200;201311;826;2202;771;2133;110;322;566;1571;676;1893
521205;201311;481;1575;431;1469;74;271;255;882;329;1153
521210;201311;854;2551;617;2071;236;905;210;603;446;1508
521220;201311;3740;10849;3173;10048;1116;3816;1212;3775;2328;7591
521225;201311;374;991;300;893;51;170;194;590;245;760
521230;201311;1312;4203;1217;4003;487;1694;499;1571;986;3265
521250;201311;25227;86375;24174;84600;9900;36963;9511;33631;19411;70594
521260;201311;800;2007;633;1703;119;413;348;861;467;1274
521270;201311;1709;5607;1595;5398;162;476;1247;4424;1409;4900
521280;201311;1724;5497;1502;5106;488;1774;597;2024;1085;3798
521290;201311;501;1500;378;1286;101;412;150;488;251;900
521295;201311;1096;3123;1024;3024;162;509;772;2282;934;2791
521300;201311;1769;5257;1625;5014;556;1774;703;2254;1259;4028
521305;201311;835;2226;701;2044;178;514;413;1242;591;1756
521308;201311;4882;14849;3991;13367;806;3006;2318;7659;3124;10665
521310;201311;7004;21904;5807;19664;2205;7917;1525;5034;3730;12951
521340;201311;239;791;219;754;73;277;84;277;157;554
521350;201311;2161;5669;1786;5169;255;799;1163;3537;1418;4336
521370;201311;997;3241;911;3067;328;1182;313;1015;641;2197
521375;201311;1329;3886;1155;3595;289;986;605;1837;894;2823
521377;201311;962;2913;930;2872;87;250;791;2497;878;2747
521380;201311;3657;10965;2933;9720;697;2551;1166;3754;1863;6305
521385;201311;584;1694;527;1615;174;558;232;714;406;1272
521390;201311;1109;2944;821;2543;266;933;254;773;520;1706
521400;201311;2389;6533;2052;6134;334;1106;1479;4379;1813;5485
521405;201311;1141;3472;1040;3285;282;973;500;1588;782;2561
521410;201311;734;2404;674;2301;316;1069;232;837;548;1906
521440;201311;1461;4134;1436;4108;148;381;1234;3616;1382;3997
521450;201311;4892;15057;4094;13549;1356;4833;1011;3180;2367;8013
521460;201311;6851;21884;6311;21020;1964;7117;2975;9847;4939;16964
521470;201311;694;1979;520;1645;125;452;108;338;233;790
521480;201311;506;1498;376;1266;127;437;95;321;222;758
521483;201311;3020;8191;2547;7387;697;2152;1111;3164;1808;5316
521486;201311;1559;4493;1415;4211;361;1203;859;2446;1220;3649
521487;201311;548;1527;418;1330;99;320;215;695;314;1015
521490;201311;804;2387;656;2188;122;457;424;1426;546;1883
521500;201311;1157;3923;1075;3755;186;733;683;2277;869;3010
521520;201311;883;2140;782;2023;195;425;437;1274;632;1699
521523;201311;11305;42478;10578;41160;3843;16296;3515;13497;7358;29793
521525;201311;1100;2879;974;2712;137;438;653;1763;790;2201
521530;201311;1987;6013;1397;4829;548;1998;233;758;781;2756
521540;201311;888;2626;659;2157;207;785;172;491;379;1276
521550;201311;943;2420;848;2283;249;721;449;1170;698;1891
521560;201311;4880;15104;3912;13798;1671;6438;1029;3473;2700;9911
521565;201311;629;1761;560;1669;93;292;394;1185;487;1477
521570;201311;4453;12691;3285;10378;1148;3888;1043;3307;2191;7195
521580;201311;664;1657;481;1396;174;546;155;445;329;991
521590;201311;728;2099;619;1914;238;804;116;373;354;1177
521600;201311;615;1648;443;1342;114;381;157;429;271;810
521630;201311;1755;4839;1471;4387;587;2031;258;618;845;2649
521640;201311;1750;5149;1534;4811;524;1899;422;1359;946;3258
521645;201311;630;1998;540;1786;145;538;221;673;366;1211
521680;201311;1405;4595;1246;4247;698;2515;199;629;897;3144
521690;201311;568;1717;509;1608;122;457;241;704;363;1161
521710;201311;2170;6916;1937;6465;407;1455;1159;3851;1566;5306
521720;201311;2015;6111;1847;5876;452;1468;1118;3651;1570;5119
521730;201311;3712;12703;3484;12240;1548;5967;985;3192;2533;9159
521740;201311;3278;9314;2666;8525;1279;4196;915;3055;2194;7251
521760;201311;12018;41858;11361;40857;2134;8533;7573;27353;9707;35886
521770;201311;2696;8350;2289;7522;1024;3608;490;1491;1514;5099
521800;201311;8578;25902;7416;24152;2743;9413;3323;11176;6066;20589
521805;201311;915;2165;770;1920;256;573;374;1086;630;1659
521810;201311;810;2407;707;2224;179;614;354;1092;533;1706
521830;201311;5435;18582;5144;18114;1076;4101;3396;11965;4472;16066
521839;201311;595;1858;503;1655;136;483;205;637;341;1120
521850;201311;6352;18482;5714;17471;1387;4236;3220;10027;4607;14263
521860;201311;1714;5296;1482;4816;423;1510;534;1649;957;3159
521870;201311;548;1943;507;1830;159;622;142;473;301;1095
521878;201311;456;1557;419;1484;135;533;160;541;295;1074
521880;201311;24180;65521;16639;52865;6000;20438;4791;15358;10791;35796
521890;201311;3558;11275;3024;10184;1196;4312;713;2369;1909;6681
521900;201311;1655;4447;1354;4018;359;1186;534;1465;893;2651
521910;201311;1170;3356;1028;3189;265;911;585;1838;850;2749
521920;201311;352;1118;344;1100;135;456;144;446;279;902
521925;201311;620;1930;548;1777;126;454;252;766;378;1220
521930;201311;3801;12543;3461;11865;1331;4845;1088;3717;2419;8562
521935;201311;668;2029;633;1959;198;645;327;988;525;1633
521940;201311;1138;3097;941;2771;354;1107;321;950;675;2057
521945;201311;661;2303;613;2245;132;434;431;1689;563;2123
521950;201311;489;1612;430;1502;149;556;167;587;316;1143
521960;201311;921;2727;785;2483;200;678;370;1154;570;1832
521970;201311;2443;7078;2238;6809;370;1153;1588;4970;1958;6123
521971;201311;908;2563;739;2273;186;639;302;878;488;1517
521973;201311;836;2849;761;2699;228;851;248;869;476;1720
521975;201311;13055;38449;12298;37442;2473;8209;7869;24021;10342;32230
521980;201311;1706;5542;1665;5494;288;923;1291;4394;1579;5317
521990;201311;1021;3260;955;3145;181;658;592;1912;773;2570
522000;201311;2072;6215;1838;5913;405;1374;1097;3694;1502;5068
522005;201311;305;885;246;788;62;215;130;399;192;614
522010;201311;2770;8528;2428;7967;899;3230;713;2248;1612;5478
522015;201311;970;2923;813;2676;236;868;384;1246;620;2114
522020;201311;4418;12544;3936;11932;982;3255;2308;6858;3290;10113
522026;201311;625;1809;445;1622;210;814;129;478;339;1292
522028;201311;528;1595;476;1508;120;415;283;875;403;1290
522040;201311;3026;7881;2224;6837;810;2674;865;2670;1675;5344
522045;201311;11945;40245;10310;36701;3520;13672;2219;7656;5739;21328
522050;201311;1004;2993;827;2693;282;1017;325;996;607;2013
522060;201311;2871;9222;2491;8637;793;2969;1296;4461;2089;7430
522068;201311;1465;4893;1390;4809;137;410;1149;4181;1286;4591
522070;201311;825;2543;754;2425;124;476;480;1527;604;2003
522100;201311;798;2235;708;2093;263;892;317;860;580;1752
522108;201311;924;2743;812;2579;92;307;595;1932;687;2239
522119;201311;1236;3876;1047;3632;129;432;811;2906;940;3338
522130;201311;506;1476;437;1399;131;464;223;718;354;1182
522140;201311;17250;49709;15196;46670;4774;15877;6477;19565;11251;35442
522145;201311;902;2628;853;2544;449;1413;214;625;663;2038
522150;201311;1252;3323;1023;3014;376;1174;371;1120;747;2294
522155;201311;715;2174;654;2083;150;501;389;1283;539;1784
522157;201311;686;2047;614;1930;71;252;468;1475;539;1727
522160;201311;5982;17524;4504;14993;1910;6988;804;2511;2714;9499
522170;201311;3179;8896;2693;8219;781;2421;1170;3768;1951;6189
522180;201311;429;1276;332;1135;156;593;109;354;265;947
522185;201311;13873;44583;13018;43398;2924;10567;7882;26378;10806;36945
522190;201311;767;2202;680;2023;131;402;393;1184;524;1586
522200;201311;1549;5269;1427;5001;505;1920;427;1441;932;3361
522205;201311;1288;3760;1082;3413;327;1080;475;1506;802;2586
522220;201311;1070;3337;959;3191;238;861;516;1813;754;2674
522230;201311;1069;3384;988;3251;193;721;622;2060;815;2781
530010;201311;249487;823323;224185;771085;70473;267265;73952;252736;144425;520001
110001;201310;4311;14323;3742;13399;1078;3992;2027;7347;3105;11339
110002;201310;12559;41304;11194;38863;3830;14270;4748;16541;8578;30811
110003;201310;979;3206;915;3102;278;998;378;1254;656;2252
110004;201310;9366;31180;8097;28482;2608;10011;2756;9665;5364;19676
110005;201310;2327;7925;2219;7722;843;3015;938;3319;1781;6334
110006;201310;3408;9168;2146;7398;716;2611;619;2021;1335;4632
110007;201310;1469;4719;1360;4555;319;1136;778;2734;1097;3870
110008;201310;2488;8756;2341;8540;566;1969;1564;5978;2130;7947
110009;201310;5230;15391;4163;13813;991;3449;2297;7650;3288;11099
110010;201310;8367;24265;7416;23086;1453;4074;4926;16640;6379;20714
110011;201310;10788;33642;8954;30464;3460;12478;3128;10644;6588;23122
110012;201310;15984;50558;14163;47061;5100;17943;5175;17066;10275;35009
110013;201310;5176;16655;4354;15480;1372;5114;2030;7380;3402;12494
110014;201310;4152;12460;3538;11604;857;2926;2081;6911;2938;9837
110015;201310;4994;16467;4159;14977;1650;6319;1394;5049;3044;11368
110018;201310;5067;15182;4169;14009;1338;4969;1872;6060;3210;11029
110020;201310;53541;161111;46049;151638;10763;36587;27412;93071;38175;129658
110025;201310;4326;12955;3672;11753;608;2121;2603;8281;3211;10402
110026;201310;806;2391;681;2243;160;530;447;1517;607;2047
110028;201310;7351;22080;5597;19182;1748;6519;1640;5532;3388;12051
110029;201310;1670;4964;1347;4403;448;1535;566;1874;1014;3409
110030;201310;11236;32811;9266;30281;2574;9035;4822;16294;7396;25329
110032;201310;4015;13341;3625;12470;1060;3793;1586;5506;2646;9299
110033;201310;5380;17419;5021;16857;1669;5677;2347;8415;4016;14092
110034;201310;3782;9929;3210;9264;488;1366;2495;7319;2983;8685
110037;201310;2026;6966;1791;6524;512;1866;958;3562;1470;5428
110040;201310;3486;11602;3269;11196;1095;3991;1517;5169;2612;9160
110045;201310;5094;18032;4770;17633;1395;5446;2794;10350;4189;15796
110050;201310;1820;5903;1521;5507;556;2040;764;2848;1320;4888
110060;201310;982;3463;874;3262;261;1022;454;1694;715;2716
110070;201310;1899;6600;1857;6498;325;1186;1326;4669;1651;5855
110080;201310;3373;10960;3256;10809;655;2050;2436;8338;3091;10388
110090;201310;932;2825;758;2550;231;863;323;1012;554;1875
110092;201310;1724;5579;1568;5372;377;1321;892;3209;1269;4530
110094;201310;2893;9661;2677;9338;712;2642;1585;5572;2297;8214
110100;201310;2645;8597;2300;8019;709;2558;1174;4149;1883;6707
110110;201310;1754;5808;1644;5678;732;2552;717;2588;1449;5140
110120;201310;1590;5417;1355;4829;386;1441;516;1838;902;3279
110130;201310;2754;8010;2119;7094;569;1992;1032;3495;1601;5487
110140;201310;2460;8605;2352;8432;554;2009;1502;5499;2056;7508
110143;201310;1525;5110;1239;4618;306;1185;706;2623;1012;3808
110145;201310;966;3015;864;2847;171;604;550;1814;721;2418
110146;201310;443;1446;400;1377;108;384;216;754;324;1138
110147;201310;898;2712;708;2395;203;745;256;790;459;1535
110148;201310;1326;4013;1073;3497;354;1276;361;1109;715;2385
110149;201310;3465;10524;2867;9656;695;2453;1827;6246;2522;8699
110150;201310;2820;8463;2334;7731;407;1481;1508;4999;1915;6480
110155;201310;902;3069;863;2981;305;1115;405;1367;710;2482
110160;201310;2078;6693;1741;6121;596;2157;806;2860;1402;5017
110170;201310;3187;9325;2517;8193;554;1930;1549;5086;2103;7016
110175;201310;1590;5202;1242;4764;116;486;934;3616;1050;4102
110180;201310;1687;5355;1452;4953;349;1218;867;3001;1216;4219
120001;201310;2817;10284;2732;10117;739;2889;1521;5769;2260;8658
120005;201310;1502;6189;1456;6099;185;734;1109;4842;1294;5576
120010;201310;4339;15620;4169;15317;1006;3494;2632;10192;3638;13686
120013;201310;1787;6977;1753;6921;337;1303;1210;4980;1547;6283
120017;201310;2081;7480;1971;7286;555;2141;959;3829;1514;5970
120020;201310;13935;61663;13719;61135;2618;11035;9780;45663;12398;56698
120025;201310;2609;9235;2536;9121;650;2435;1502;5537;2152;7972
120030;201310;5690;23347;5637;23259;594;2313;4684;19790;5278;22103
120032;201310;1343;6425;1295;6301;180;1013;955;4670;1135;5683
120033;201310;3564;13634;3535;13579;210;856;3145;12178;3355;13034
120034;201310;1748;7070;1745;7067;67;291;1642;6660;1709;6951
120035;201310;2542;12288;2516;12221;262;1233;2060;10345;2322;11578
120038;201310;3158;11630;3046;11391;880;3353;1619;6270;2499;9623
120039;201310;1335;7647;1312;7588;182;1094;1025;6039;1207;7133
120040;201310;43064;159320;40263;153196;12548;49848;19454;76132;32002;125980
120042;201310;2697;11892;2599;11640;435;2069;1817;8293;2252;10362
120043;201310;806;3888;791;3851;74;359;664;3301;738;3660
120045;201310;4358;15442;4312;15368;1042;3674;2957;10839;3999;14513
120050;201310;7988;33335;7765;32860;1642;6768;4999;22458;6641;29226
120060;201310;5841;28447;5759;28294;796;3856;4511;22893;5307;26749
120070;201310;2689;10383;2646;10278;589;2172;1677;6891;2266;9063
120080;201310;3611;13785;3470;13552;609;2429;2481;9977;3090;12406
130002;201310;2818;11901;2664;11629;287;1295;2096;9296;2383;10591
130006;201310;1680;7281;1509;6939;189;969;1100;5090;1289;6059
130008;201310;1923;8030;1854;7899;186;860;1463;6372;1649;7232
130010;201310;2711;9191;2356;8772;255;865;1935;7431;2190;8296
130014;201310;3359;11009;2921;10364;453;1748;1972;7051;2425;8799
130020;201310;2342;8402;2328;8386;62;238;2241;8074;2303;8312
130030;201310;6685;26743;6500;26491;568;1978;5605;23530;6173;25508
130040;201310;3612;11500;3416;11213;321;1103;2879;9491;3200;10594
130050;201310;5779;23297;5123;22240;788;3338;3566;16498;4354;19836
130060;201310;5759;24828;5431;24367;634;2776;4385;20156;5019;22932
130063;201310;3156;13776;3133;13730;401;1714;2581;11536;2982;13250
130068;201310;2955;12607;2756;12208;368;1799;1986;8838;2354;10637
130070;201310;6333;21768;5890;21161;672;2365;4672;17209;5344;19574
130080;201310;4863;21879;4737;21686;817;3892;3400;15975;4217;19867
130083;201310;1686;7188;1625;7083;295;1362;1145;5019;1440;6381
130090;201310;2330;8633;2226;8484;198;889;1888;7157;2086;8046
130100;201310;5299;20652;5101;20373;461;1988;4257;17203;4718;19191
130110;201310;6428;20937;6037;20454;910;2970;4647;16310;5557;19280
130115;201310;3514;13379;3352;13156;195;610;3063;12230;3258;12840
130120;201310;12864;50450;12593;50074;1182;4317;10685;43795;11867;48112
130130;201310;3310;14483;3206;14288;475;2065;2461;11270;2936;13335
130140;201310;5692;23097;5651;23044;143;430;5456;22499;5599;22929
130150;201310;3421;12676;3348;12581;242;1156;2897;10809;3139;11965
130160;201310;3845;15882;3785;15793;243;876;3446;14590;3689;15466
130165;201310;2725;11262;2685;11193;495;2066;2058;8701;2553;10767
130170;201310;8269;31284;7294;29992;1437;5959;4819;20842;6256;26801
130180;201310;3315;10624;3248;10530;117;361;3026;9862;3143;10223
130185;201310;8584;31281;8306;30907;1609;5806;6000;23205;7609;29011
130190;201310;16176;57834;14442;55582;3165;11760;9178;37589;12343;49349
130195;201310;1747;7178;1687;7085;96;442;1486;6304;1582;6746
130200;201310;1949;7149;1814;6916;343;1368;1208;4672;1551;6040
130210;201310;1122;4380;1067;4280;178;691;791;3297;969;3988
130220;201310;2003;8228;1835;7917;370;1795;1088;4703;1458;6498
130230;201310;3282;14952;3122;14670;394;2048;2312;11139;2706;13187
130240;201310;8022;31641;7452;30785;533;2474;6302;26439;6835;28913
130250;201310;16860;62906;16428;62253;2893;10527;12091;47769;14984;58296
130255;201310;3871;14301;3672;13951;227;736;3210;12576;3437;13312
130260;201310;239779;785561;218397;751602;61845;216863;115415;412541;177260;629404
130270;201310;7225;30427;6542;29345;1109;4823;4627;21823;5736;26646
130280;201310;3100;12091;3032;11987;158;536;2733;11057;2891;11593
130290;201310;10440;38167;10253;37893;229;682;9668;36285;9897;36967
130300;201310;4255;16794;4024;16456;365;1595;3290;13649;3655;15244
130310;201310;4607;18151;4227;17650;696;2791;3059;13301;3755;16092
130320;201310;2712;9453;2483;9129;363;1390;1765;6648;2128;8038
130330;201310;3331;12367;2977;11876;244;1035;2478;10041;2722;11076
130340;201310;16786;66218;16278;65393;2951;11254;11213;47808;14164;59062
130350;201310;3203;13012;3066;12854;284;976;2630;11399;2914;12375
130353;201310;5241;17248;4697;16491;1303;4563;2603;9719;3906;14282
130356;201310;4047;14945;3897;14713;522;1870;3041;11993;3563;13863
130360;201310;2683;7977;2420;7668;57;135;2253;7326;2310;7461
130370;201310;4782;18853;4096;17936;273;1481;3412;14977;3685;16458
130380;201310;6692;28313;6455;27925;457;2149;5525;24126;5982;26275
130390;201310;4398;19639;4136;19187;495;2295;3276;15611;3771;17906
130395;201310;1976;7515;1821;7225;309;1351;1177;4668;1486;6019
130400;201310;2130;7679;2062;7576;99;390;1864;6918;1963;7308
130406;201310;8970;34801;8039;33246;2070;8372;4541;20089;6611;28461
130410;201310;4061;15625;3757;15046;911;3784;2099;8752;3010;12536
130420;201310;9532;41164;9255;40550;2783;11924;5119;23763;7902;35687
130423;201310;3001;11764;2854;11567;239;1130;2408;9768;2647;10898
130426;201310;1958;8526;1877;8381;336;1476;1309;6118;1645;7594
130430;201310;3370;12341;3185;12057;391;1622;2339;9036;2730;10658
130440;201310;3666;13506;3373;13185;230;787;2971;11977;3201;12764
140002;201310;1282;4635;1234;4552;247;823;810;3241;1057;4064
140005;201310;2375;7646;2234;7481;135;431;1994;6774;2129;7205
140010;201310;43118;142468;39242;135949;9192;33916;22672;80230;31864;114146
140015;201310;2649;9065;2563;8949;231;583;2200;8013;2431;8596
140017;201310;2835;9231;2722;9087;215;678;2342;7982;2557;8660
140020;201310;4140;14215;3881;13863;532;1891;2888;10651;3420;12542
140023;201310;1851;6631;1728;6441;228;855;1297;4984;1525;5839
140028;201310;2084;5924;2018;5848;111;258;1826;5425;1937;5683
140030;201310;3469;11317;3328;11131;384;942;2799;9858;3183;10800
140040;201310;1460;7119;1404;6942;133;740;1040;5245;1173;5985
140045;201310;2335;8657;2214;8487;289;970;1719;7006;2008;7976
140047;201310;5017;14673;4683;14194;1366;4179;2353;7700;3719;11879
140050;201310;1452;4561;1363;4429;159;515;1070;3565;1229;4080
140060;201310;1330;4287;1223;4142;330;1147;711;2509;1041;3656
140070;201310;1420;7016;1417;7010;58;235;1345;6731;1403;6966
150010;201310;31545;104718;30292;103029;2251;8028;25868;89116;28119;97144
150013;201310;1503;4825;1456;4768;136;465;1209;3996;1345;4461
150020;201310;10416;37351;10190;37005;1396;5049;7986;29652;9382;34701
150030;201310;6100;26946;5946;26679;629;2431;4939;23090;5568;25521
150034;201310;4334;11936;4122;11683;152;346;3909;11230;4061;11576
150040;201310;11769;41972;10398;40221;2178;7706;6983;29008;9161;36714
150050;201310;5871;22725;5739;22478;666;2836;4575;18065;5241;20901
150060;201310;14150;47049;13468;46027;3541;11899;8007;28641;11548;40540
150070;201310;5098;22104;4720;21643;572;2608;3800;17819;4372;20427
150080;201310;57928;160885;51757;153092;7105;19322;38717;118343;45822;137665
150085;201310;4804;17302;4620;17035;736;2348;3541;13781;4277;16129
150090;201310;9573;37898;9063;37183;1192;4696;7101;29990;8293;34686
150095;201310;5003;17635;4663;17097;557;2033;3664;13816;4221;15849
150100;201310;3341;12678;3155;12403;294;1376;2551;9941;2845;11317
150110;201310;3125;15076;3113;15046;161;673;2880;14113;3041;14786
150120;201310;5769;23113;5652;22883;892;3543;4312;17750;5204;21293
150125;201310;771;2443;711;2343;167;580;424;1393;591;1973
150130;201310;18945;62191;18184;61051;1840;6242;14763;50268;16603;56510
150140;201310;136782;419408;132365;413856;18862;59384;103980;329379;122842;388763
150145;201310;4656;15156;4324;14728;658;2316;3149;10937;3807;13253
150150;201310;8925;30154;8429;29348;1860;6769;5393;19003;7253;25772
150157;201310;2701;8912;2484;8603;393;1394;1874;6585;2267;7979
150160;201310;2666;9305;2566;9156;698;2400;1536;5766;2234;8166
150170;201310;21590;80940;20552;79609;3446;13119;15464;60990;18910;74109
150172;201310;2920;10314;2656;9924;310;1178;2168;8231;2478;9409
150175;201310;1966;6309;1900;6229;150;461;1662;5570;1812;6031
150178;201310;10549;33382;9183;31769;569;1710;8214;29112;8783;30822
150180;201310;17200;70560;16706;69879;1642;7112;13966;59262;15608;66374
150190;201310;7005;22793;6634;22272;445;1090;5788;20258;6233;21348
150195;201310;4308;15817;4045;15346;476;1779;3195;12357;3671;14136
150200;201310;4797;15990;4690;15857;121;368;4424;15105;4545;15473
150210;201310;21722;83961;21436;83548;2157;8008;18302;72594;20459;80602
150215;201310;5397;17838;4975;17202;1254;4462;2910;10290;4164;14752
150220;201310;12164;40188;11275;38744;2745;9643;6443;22755;9188;32398
150230;201310;10893;38031;9978;36746;843;3764;8327;30391;9170;34155
150240;201310;32479;101597;29868;97128;8882;30128;14256;47609;23138;77737
150250;201310;3668;14935;3558;14758;725;2848;2460;10788;3185;13636
150260;201310;1817;7727;1755;7610;325;1530;1124;4941;1449;6471
150270;201310;9279;28751;7292;26252;1660;6360;4517;16565;6177;22925
150275;201310;5537;20833;5276;20405;855;3364;3845;15183;4700;18547
150276;201310;2044;6192;1935;6055;287;930;1522;4791;1809;5721
150277;201310;4989;15753;4397;15055;530;1867;3506;12242;4036;14109
150280;201310;5728;25119;5604;24829;765;3318;4329;19664;5094;22982
150285;201310;2564;10369;2537;10310;265;1107;2133;8744;2398;9851
150290;201310;7990;26364;7842;26159;829;2632;6503;22216;7332;24848
150293;201310;8348;26953;7319;25342;2521;8992;3292;11965;5813;20957
150295;201310;5894;20500;5304;19717;1299;4913;3271;12549;4570;17462
150300;201310;1773;6266;1738;6216;120;424;1467;5391;1587;5815
150304;201310;3935;12623;3450;11966;500;1747;2573;9154;3073;10901
150307;201310;6409;22486;5994;21885;498;1768;4973;18700;5471;20468
150309;201310;6320;23156;5924;22595;1635;6168;3650;14571;5285;20739
150310;201310;4862;22937;4780;22799;544;2431;3945;19382;4489;21813
150320;201310;8232;23128;7954;22817;582;1570;6956;20346;7538;21916
150330;201310;12524;47185;11985;46300;1476;5729;9435;37311;10911;43040
150340;201310;2038;7212;1929;7053;438;1706;1211;4479;1649;6185
150345;201310;6290;22574;5907;22046;697;2626;4775;18212;5472;20838
150350;201310;7017;23893;6694;23404;1025;3563;4932;17578;5957;21141
150360;201310;20225;65398;17869;62478;2647;9406;13273;47826;15920;57232
150370;201310;9639;37282;9307;36815;1136;4173;7596;31109;8732;35282
150375;201310;2676;11448;2622;11380;220;753;2262;10275;2482;11028
150380;201310;9218;29312;8354;28122;916;3322;6900;23269;7816;26591
150390;201310;7934;34554;7608;33878;1860;7809;4600;21739;6460;29548
150400;201310;5227;22169;5065;21813;650;2709;3773;16800;4423;19509
150405;201310;7993;25430;7294;24538;1521;4651;4938;17707;6459;22358
150410;201310;1619;6382;1588;6327;288;1171;1058;4343;1346;5514
150420;201310;31350;115227;28720;110928;7593;30677;15808;63317;23401;93994
150430;201310;6293;23948;6126;23635;823;3462;4687;18180;5510;21642
150440;201310;5161;18409;5069;18258;784;2785;3784;13917;4568;16702
150442;201310;20966;60986;19310;58882;3146;9754;13713;42948;16859;52702
150445;201310;5035;18151;4678;17642;707;2527;3588;13945;4295;16472
150450;201310;4122;19950;3995;19777;392;1913;3357;16978;3749;18891
150460;201310;6704;24899;5620;23744;471;2074;4834;20918;5305;22992
150470;201310;16205;51364;15736;50752;1460;3962;13560;45104;15020;49066
150475;201310;12;32;12;32;4;10;4;10;8;20
150480;201310;13729;47500;13224;46780;938;3041;11487;41555;12425;44596
150490;201310;6195;24374;6096;24243;368;1449;5504;22106;5872;23555
150495;201310;4394;16655;4309;16497;388;1537;3689;14203;4077;15740
150497;201310;3250;11460;2983;11017;856;3179;1684;6489;2540;9668
150500;201310;2837;8704;2721;8511;390;1236;2070;6515;2460;7751
150503;201310;3678;11798;3150;11117;1196;4407;1348;4963;2544;9370
150506;201310;11751;43053;11172;42230;2696;9076;7416;30075;10112;39151
150510;201310;9328;37631;8817;36733;1454;6085;6230;27005;7684;33090
150520;201310;5887;24764;5797;24629;515;1729;5081;22276;5596;24005
150530;201310;10938;40427;10046;39088;1445;5100;7441;30178;8886;35278
150540;201310;4453;14160;4090;13604;353;1241;3395;11292;3748;12533
150543;201310;4684;15355;4359;14892;1372;4709;2466;8689;3838;13398
150548;201310;7861;25437;7439;24891;689;2187;6336;21642;7025;23829
150549;201310;2145;6954;2050;6837;112;289;1847;6323;1959;6612
150550;201310;20493;66713;18515;63387;5563;19731;9027;31622;14590;51353
150553;201310;20737;77869;18844;73017;7739;31902;3535;13540;11274;45442
150555;201310;1614;5235;1431;4962;244;918;996;3477;1240;4395
150560;201310;1950;6418;1892;6284;233;856;1438;4735;1671;5591
150563;201310;2814;9519;2633;9186;626;2356;1565;5440;2191;7796
150565;201310;3283;12023;3100;11747;264;1109;2509;9650;2773;10759
150570;201310;4961;19613;4895;19501;414;1608;4129;16861;4543;18469
150580;201310;9051;37439;8909;37255;819;2977;7660;33177;8479;36154
150590;201310;5156;21245;5050;21114;152;698;4750;19958;4902;20656
150600;201310;7256;29081;7106;28832;636;2346;6072;25339;6708;27685
150610;201310;2422;8452;2260;8112;286;1164;1577;5582;1863;6746
150611;201310;2524;9656;2433;9436;305;1244;1806;7098;2111;8342
150613;201310;11011;34835;9745;33004;3349;11625;4565;16270;7914;27895
150616;201310;2967;8614;2395;7974;566;1842;1551;5367;2117;7209
150618;201310;7257;25918;6986;25423;2322;8822;3410;12651;5732;21473
150619;201310;5086;17938;4797;17504;748;2882;3415;12625;4163;15507
150620;201310;5893;21928;5404;21288;791;3145;4099;16736;4890;19881
150630;201310;5131;16637;4919;16356;436;1455;4141;13963;4577;15418
150635;201310;4332;14569;4079;14093;837;2978;2534;9061;3371;12039
150640;201310;1397;4596;1384;4575;38;105;1311;4388;1349;4493
150650;201310;11575;36956;10673;35311;2946;10146;5612;18855;8558;29001
150655;201310;5214;17744;4823;17175;758;2764;3556;12880;4314;15644
150658;201310;3928;13317;3748;13029;372;1543;2929;10098;3301;11641
150660;201310;5483;17846;5042;17277;1380;4671;2923;10437;4303;15108
150670;201310;5928;17902;5194;17013;1733;5744;2713;9500;4446;15244
150680;201310;47821;191808;45481;187450;16181;66319;20660;91475;36841;157794
150690;201310;1776;5979;1660;5761;280;990;1074;3839;1354;4829
150700;201310;5594;18078;5329;17723;1126;3744;3586;12199;4712;15943
150710;201310;3812;12652;3561;12285;373;1093;2983;10594;3356;11687
150715;201310;4825;16241;4418;15679;612;2200;3451;12505;4063;14705
150720;201310;6251;26154;5957;25628;952;3867;4337;19523;5289;23390
150730;201310;8737;30947;8266;30306;1150;4123;6628;24864;7778;28987
150740;201310;3489;11552;3274;11171;501;1792;2244;7807;2745;9599
150745;201310;5851;18683;5450;18138;947;3310;3946;13246;4893;16556
150746;201310;1366;4612;1307;4503;204;779;882;3069;1086;3848
150747;201310;4862;16391;4531;15955;449;1489;3653;13343;4102;14832
150750;201310;2541;9107;2484;9041;113;265;2329;8680;2442;8945
150760;201310;10934;36480;10508;35876;2644;8904;6471;22965;9115;31869
150770;201310;5488;21035;5332;20807;912;3305;3932;16327;4844;19632
150775;201310;1072;3538;979;3357;196;820;594;1953;790;2773
150780;201310;2972;10096;2950;10072;84;208;2792;9684;2876;9892
150790;201310;4835;15844;4549;15476;341;992;3885;13698;4226;14690
150795;201310;14224;45701;13110;43998;2163;6985;9448;32807;11611;39792
150796;201310;2687;8458;2609;8359;399;1180;2003;6701;2402;7881
150797;201310;3590;12361;3453;12144;184;679;3040;10807;3224;11486
150800;201310;13464;46312;12393;44976;2999;10356;8080;30939;11079;41295
150803;201310;6579;24271;6269;23812;905;3599;4602;17897;5507;21496
150805;201310;2651;9459;2473;9205;376;1330;1806;6949;2182;8279
150808;201310;5688;19828;4924;18365;2149;8443;1209;4728;3358;13171
150810;201310;18718;60099;15962;56732;2727;9314;11269;42202;13996;51516
150812;201310;4854;15554;4542;15155;480;1949;3495;11439;3975;13388
150815;201310;8351;27156;7551;26171;1190;3794;5767;20844;6957;24638
150820;201310;10179;30701;9342;29788;573;1209;8397;27689;8970;28898
150830;201310;12164;47682;11625;46773;885;3543;9515;39627;10400;43170
150835;201310;1920;7245;1792;6939;521;2119;832;3236;1353;5355
150840;201310;6970;20696;5663;18928;1415;5290;3026;9853;4441;15143
160005;201310;687;2678;649;2596;118;545;391;1547;509;2092
160010;201310;1526;5330;1515;5318;175;486;1279;4681;1454;5167
160015;201310;1494;5685;1462;5627;262;949;1045;4254;1307;5203
160020;201310;2254;7605;2101;7395;310;1132;1528;5510;1838;6642
160021;201310;803;3556;781;3517;145;690;533;2487;678;3177
160023;201310;927;3601;916;3583;99;340;778;3132;877;3472
160025;201310;1199;3459;1165;3423;22;76;1123;3297;1145;3373
160027;201310;7806;25372;7392;24874;2048;6937;4464;15588;6512;22525
160030;201310;37864;143408;35906;139105;8488;32296;23273;93073;31761;125369
160040;201310;3395;14149;3340;14057;203;933;2976;12574;3179;13507
160050;201310;3299;12584;2998;12130;1066;4033;1451;6574;2517;10607
160053;201310;2102;8849;2082;8816;581;2497;1272;5515;1853;8012
160055;201310;761;3005;745;2982;141;622;526;2116;667;2738
160060;201310;17284;58573;16298;57461;4806;16042;9799;36792;14605;52834
160070;201310;1930;8599;1915;8574;201;806;1651;7584;1852;8390
160080;201310;2568;9816;2551;9789;141;490;2360;9170;2501;9660
170025;201310;548;1905;501;1828;185;704;216;823;401;1527
170030;201310;1160;3869;1068;3703;294;1051;543;1903;837;2954
170035;201310;1516;4664;1249;4148;447;1602;394;1343;841;2945
170040;201310;1741;5911;1554;5621;320;1337;952;3435;1272;4772
170070;201310;2012;5593;1660;5149;441;1510;844;2648;1285;4158
170100;201310;2461;6919;2179;6424;316;1050;1637;4769;1953;5819
170105;201310;722;2407;615;2191;130;574;328;1119;458;1693
170110;201310;1193;3733;1047;3493;226;761;628;2117;854;2878
170130;201310;1346;4356;1203;4162;191;658;842;3022;1033;3680
170190;201310;1633;4801;1350;4398;622;2042;350;1286;972;3328
170200;201310;1446;4556;1143;4005;317;1236;366;1236;683;2472
170210;201310;26981;86238;23543;80041;9150;33485;6958;24365;16108;57850
170215;201310;1129;3678;1025;3510;136;487;770;2683;906;3170
170220;201310;6380;21477;5897;20719;865;3194;4160;14986;5025;18180
170230;201310;1400;4846;1248;4577;343;1414;588;2097;931;3511
170240;201310;2970;8493;2423;7798;340;1203;1662;5411;2002;6614
170255;201310;3577;11692;3058;10819;1103;3888;1239;4706;2342;8594
170270;201310;1043;2725;758;2332;164;529;446;1385;610;1914
170290;201310;2903;8936;2572;8531;214;640;2153;7426;2367;8066
170300;201310;2022;6503;1801;6138;309;1178;1204;4106;1513;5284
170305;201310;691;2226;583;2014;124;482;348;1173;472;1655
170307;201310;1055;3744;930;3528;289;1116;383;1618;672;2734
170310;201310;1618;4519;1299;4010;358;1162;575;1860;933;3022
170320;201310;955;2874;786;2573;216;717;381;1289;597;2006
170330;201310;819;2510;689;2346;136;479;448;1531;584;2010
170360;201310;458;1635;435;1595;101;400;213;762;314;1162
170370;201310;1369;4149;1161;3848;194;762;705;2321;899;3083
170380;201310;2104;6765;1735;6209;429;1748;919;3235;1348;4983
170382;201310;556;1883;493;1791;78;309;353;1265;431;1574
170384;201310;1505;6346;1433;6221;358;1578;891;3998;1249;5576
170386;201310;864;2643;728;2439;202;746;297;1020;499;1766
170388;201310;653;1985;570;1845;131;502;218;688;349;1190
170389;201310;911;3168;852;3076;102;445;639;2266;741;2711
170390;201310;1300;3975;1136;3766;187;641;827;2814;1014;3455
170410;201310;452;1511;431;1470;66;250;296;1010;362;1260
170460;201310;520;1447;393;1243;106;366;137;432;243;798
170510;201310;747;2572;642;2411;129;556;339;1267;468;1823
170550;201310;5346;17033;4482;15455;1818;6718;1221;4314;3039;11032
170555;201310;1328;3974;1112;3646;276;998;611;2005;887;3003
170560;201310;1024;3518;871;3343;188;724;598;2387;786;3111
170600;201310;1298;3779;1162;3615;71;247;973;3078;1044;3325
170610;201310;1606;4920;1270;4377;206;794;735;2559;941;3353
170625;201310;396;1296;318;1122;87;320;86;301;173;621
170650;201310;1209;4027;1099;3812;278;1053;566;1969;844;3022
170700;201310;3864;13101;3265;12095;852;3470;1513;5822;2365;9292
170710;201310;1683;5080;1430;4701;196;756;1002;3298;1198;4054
170720;201310;1793;4820;1576;4487;309;894;1075;3106;1384;4000
170730;201310;1116;3225;918;2923;290;1045;408;1276;698;2321
170740;201310;2154;7833;1936;7451;316;1312;1309;5078;1625;6390
170755;201310;871;2798;738;2506;208;756;284;943;492;1699
170765;201310;1566;4287;1273;3814;336;1092;535;1653;871;2745
170770;201310;1808;6377;1691;6146;407;1528;982;3684;1389;5212
170820;201310;4125;13331;3720;12684;1085;3935;1601;5562;2686;9497
170825;201310;759;2328;580;1987;140;527;241;823;381;1350
170830;201310;1311;3934;1248;3836;45;98;1158;3605;1203;3703
170900;201310;2833;10160;2721;9946;364;1352;2025;7625;2389;8977
170930;201310;4150;12789;3416;11729;1387;5011;1127;3891;2514;8902
170950;201310;11848;35820;9374;31601;3926;14763;2139;6747;6065;21510
170980;201310;464;1481;394;1357;124;453;168;583;292;1036
171050;201310;1254;4566;1194;4458;59;277;1058;3894;1117;4171
171070;201310;1692;5468;1568;5302;339;1198;968;3365;1307;4563
171090;201310;904;2707;787;2522;143;477;524;1695;667;2172
171110;201310;627;1865;518;1694;167;599;282;873;449;1472
171150;201310;850;2543;636;2135;127;460;360;1209;487;1669
171180;201310;602;1942;477;1677;122;472;196;708;318;1180
171190;201310;1836;6657;1578;6121;402;1644;745;3015;1147;4659
171195;201310;860;3151;786;3014;108;457;496;1976;604;2433
171200;201310;676;2232;563;2025;147;609;261;890;408;1499
171215;201310;456;1420;363;1253;70;270;168;594;238;864
171240;201310;860;2910;817;2837;72;187;673;2451;745;2638
171245;201310;663;2210;555;1945;125;490;246;847;371;1337
171250;201310;1153;3340;1038;3206;63;196;886;2782;949;2978
171270;201310;417;1729;387;1660;96;402;198;927;294;1329
171280;201310;899;2819;797;2637;194;630;399;1467;593;2097
171320;201310;3922;12266;3409;11511;1137;4027;1585;5359;2722;9386
171330;201310;2765;8520;2463;8060;651;2258;1331;4407;1982;6665
171360;201310;1493;4899;1275;4577;321;1217;693;2547;1014;3764
171370;201310;707;2018;633;1895;144;510;337;965;481;1475
171380;201310;1279;4446;1134;4150;329;1206;538;2041;867;3247
171395;201310;887;2852;757;2606;157;616;400;1369;557;1985
171420;201310;2277;6959;1842;6175;496;1786;778;2623;1274;4409
171430;201310;1029;3277;936;3140;219;752;556;1890;775;2642
171488;201310;2413;7510;2225;7231;583;1886;1193;4070;1776;5956
171500;201310;885;2732;778;2515;139;412;441;1478;580;1890
171510;201310;903;3295;822;3167;158;640;510;2058;668;2698
171515;201310;612;1805;487;1619;116;398;236;798;352;1196
171525;201310;588;2013;501;1850;104;422;268;979;372;1401
171550;201310;342;1163;292;1052;120;488;46;174;166;662
171570;201310;1120;3643;1013;3480;222;765;621;2194;843;2959
171575;201310;1942;5657;1548;4937;432;1425;658;2189;1090;3614
171610;201310;6068;21036;5566;20065;1948;7426;1937;6995;3885;14421
171620;201310;2197;7106;2030;6852;196;729;1643;5588;1839;6317
171630;201310;901;3048;756;2789;192;783;317;1159;509;1942
171650;201310;2326;7422;1951;6763;530;1964;841;2876;1371;4840
171660;201310;2566;7261;2102;6420;477;1547;1098;3421;1575;4968
171665;201310;1353;4258;1182;3966;220;820;744;2541;964;3361
171670;201310;2286;6258;1886;5728;446;1468;1116;3331;1562;4799
171700;201310;1108;3751;1015;3595;162;631;649;2321;811;2952
171720;201310;663;2124;586;1975;185;682;261;879;446;1561
171750;201310;1207;4065;1088;3815;398;1464;380;1348;778;2812
171780;201310;1136;3307;839;2868;148;565;483;1628;631;2193
171790;201310;1724;5597;1411;5138;290;1082;842;3208;1132;4290
171800;201310;711;2314;657;2233;98;374;446;1518;544;1892
171820;201310;9390;29725;8689;28870;2189;7811;4964;16749;7153;24560
171830;201310;1626;5991;1490;5696;374;1519;696;2670;1070;4189
171840;201310;754;2275;680;2173;74;256;507;1628;581;1884
171845;201310;796;2170;623;1869;92;323;361;1053;453;1376
171850;201310;1021;3701;918;3477;111;481;597;2264;708;2745
171855;201310;1238;4004;1126;3816;118;494;851;2822;969;3316
171865;201310;477;1574;406;1468;105;434;197;693;302;1127
171870;201310;655;2136;551;1953;126;480;261;948;387;1428
171875;201310;1355;4380;1151;4062;175;682;819;2889;994;3571
171880;201310;993;3563;966;3521;125;489;727;2709;852;3198
171884;201310;842;2496;655;2213;154;587;250;858;404;1445
171886;201310;1432;4961;1312;4707;450;1685;450;1666;900;3351
171888;201310;658;2062;570;1900;106;369;338;1166;444;1535
171889;201310;478;1620;457;1570;100;325;274;985;374;1310
171890;201310;1108;3762;1005;3610;142;619;680;2403;822;3022
171900;201310;430;1723;413;1685;100;413;226;936;326;1349
172000;201310;649;2108;557;1975;87;376;345;1183;432;1559
172010;201310;1149;3973;1090;3863;110;433;869;3101;979;3534
172015;201310;349;1325;305;1256;58;238;179;785;237;1023
172020;201310;2295;7673;2068;7335;310;1215;1470;5261;1780;6476
172025;201310;721;2153;594;1923;101;360;358;1164;459;1524
172030;201310;1077;3733;987;3564;178;736;629;2266;807;3002
172049;201310;1108;3202;1042;3112;140;417;776;2365;916;2782
172065;201310;1178;3580;1001;3356;135;519;776;2584;911;3103
172080;201310;2647;8176;2259;7513;301;1169;1492;4874;1793;6043
172085;201310;499;1400;388;1196;87;293;119;368;206;661
172090;201310;3347;10222;2641;9313;562;2127;1589;5740;2151;7867
172093;201310;565;1881;449;1666;189;800;171;602;360;1402
172097;201310;669;2023;565;1845;163;578;198;632;361;1210
172100;201310;24854;87031;22357;81805;8012;31905;6312;23103;14324;55008
172110;201310;1679;6078;1561;5912;145;514;1248;4889;1393;5403
172120;201310;5468;16536;4585;15412;485;1721;3526;12101;4011;13822
172125;201310;318;983;259;893;60;231;129;463;189;694
172130;201310;510;1514;458;1438;75;247;303;994;378;1241
172208;201310;2129;6712;2012;6519;435;1505;1133;3741;1568;5246
172210;201310;2264;6903;2158;6774;172;588;1864;5844;2036;6432
210005;201310;21209;70332;19223;67144;6184;22864;9304;32898;15488;55762
210010;201310;1616;5742;1458;5530;174;641;1115;4384;1289;5025
210015;201310;3427;10727;3169;10361;224;456;2717;9381;2941;9837
210020;201310;7019;18094;6608;17598;439;1353;5469;14716;5908;16069
210030;201310;5828;19688;5545;19293;451;1851;4637;16069;5088;17920
210040;201310;1937;5666;1764;5454;182;576;1388;4353;1570;4929
210043;201310;5782;18070;5470;17597;413;1374;4615;15073;5028;16447
210047;201310;6650;26335;6242;25602;927;4137;4288;17720;5215;21857
210050;201310;2487;8732;2025;8129;333;1349;1336;5528;1669;6877
210055;201310;1639;5703;1541;5569;199;690;1201;4422;1400;5112
210060;201310;7846;29204;7119;28068;809;3526;5303;21332;6112;24858
210070;201310;6687;20777;6396;20401;309;1067;5753;18462;6062;19529
210080;201310;3637;12573;3568;12468;92;362;3339;11709;3431;12071
210083;201310;3547;12925;3475;12832;230;866;3081;11519;3311;12385
210087;201310;2432;7898;2324;7767;193;695;2012;6730;2205;7425
210090;201310;9578;31995;9268;31480;526;1981;8055;27461;8581;29442
210095;201310;6100;23878;5984;23671;705;2746;4854;19607;5559;22353
210100;201310;7479;22469;7111;22046;290;1099;6440;19935;6730;21034
210110;201310;3147;11013;3049;10873;197;747;2582;9386;2779;10133
210120;201310;24680;74276;21308;70065;2298;8129;16371;54681;18669;62810
210125;201310;3306;11141;3187;11004;213;686;2821;9927;3034;10613
210130;201310;3652;11342;3560;11228;306;930;2985;9539;3291;10469
210135;201310;1628;4874;1455;4614;117;383;1211;3908;1328;4291
210140;201310;16451;54308;14223;51375;3200;11886;8924;33388;12124;45274
210150;201310;4470;11769;4141;11362;158;432;3777;10376;3935;10808
210160;201310;17947;59917;16879;58334;2422;8060;12940;46091;15362;54151
210170;201310;13920;51703;13691;51374;1013;3474;12011;45953;13024;49427
210173;201310;1748;7582;1697;7473;156;715;1447;6429;1603;7144
210177;201310;2875;9608;2725;9415;352;1353;2111;7246;2463;8599
210180;201310;1438;4573;1371;4467;109;378;1148;3747;1257;4125
210190;201310;5034;16483;4742;15972;379;1693;3657;12008;4036;13701
210193;201310;1410;4555;1319;4405;93;365;1090;3676;1183;4041
210197;201310;1696;6277;1624;6194;107;470;1437;5467;1544;5937
210200;201310;9048;30971;8405;30018;1257;4225;6096;22786;7353;27011
210203;201310;6094;20958;5746;20506;494;1616;4911;17907;5405;19523
210207;201310;2927;10022;2776;9755;407;1398;2041;7361;2448;8759
210210;201310;8609;29650;8326;29208;322;1215;7324;26160;7646;27375
210215;201310;1735;6969;1693;6901;174;780;1387;5681;1561;6461
210220;201310;6115;24017;5924;23695;503;2007;4832;19844;5335;21851
210230;201310;5296;18286;4948;17713;478;1774;3967;14368;4445;16142
210232;201310;11207;41966;10629;41103;2260;8640;7274;29246;9534;37886
210235;201310;3399;10935;3104;10561;212;746;2682;9214;2894;9960
210237;201310;2528;9220;2498;9179;50;129;2409;8963;2459;9092
210240;201310;2910;9363;2797;9189;279;805;2251;7604;2530;8409
210250;201310;4821;15482;4651;15269;155;573;4310;14209;4465;14782
210255;201310;2618;8686;2402;8320;596;2242;1415;4924;2011;7166
210260;201310;5173;16816;4812;16283;644;2096;3699;12829;4343;14925
210270;201310;5237;15295;4731;14618;185;637;4212;13148;4397;13785
210275;201310;3286;8703;3076;8477;97;252;2918;8090;3015;8342
210280;201310;5894;17446;5168;16535;366;1262;4405;14246;4771;15508
210290;201310;5831;18734;5386;18174;518;1713;4421;15257;4939;16970
210300;201310;35402;110877;30498;104388;3249;11965;24251;84475;27500;96440
210310;201310;2799;8217;2674;8018;129;387;2349;7077;2478;7464
210312;201310;2046;6827;2017;6782;137;541;1760;5914;1897;6455
210315;201310;2283;8311;2193;8164;123;517;1900;7108;2023;7625
210317;201310;4278;12888;4171;12763;163;463;3907;12057;4070;12520
210320;201310;19226;61251;18096;59898;1225;4019;15834;53377;17059;57396
210325;201310;3542;11412;3205;10902;347;1295;2500;8548;2847;9843
210330;201310;31176;86094;26852;81317;3962;10682;19734;64457;23696;75139
210340;201310;11814;37429;10874;36265;1358;3955;8304;29448;9662;33403
210350;201310;10295;33024;9653;32119;802;2766;7911;26779;8713;29545
210355;201310;3922;14222;3612;13829;134;362;3342;13143;3476;13505
210360;201310;16446;51539;15526;50177;1458;4948;12427;40830;13885;45778
210370;201310;7775;22052;7107;21334;312;871;6447;19687;6759;20558
210375;201310;3198;9977;2816;9522;476;1751;2058;7044;2534;8795
210380;201310;6150;18318;5564;17430;616;1747;4472;14405;5088;16152
210390;201310;2665;9760;2502;9491;103;463;2265;8622;2368;9085
210400;201310;4800;15635;4629;15412;384;1173;3985;13548;4369;14721
210405;201310;8536;24212;7045;22173;2159;6895;3270;11155;5429;18050
210407;201310;2065;7327;1869;7025;203;713;1443;5668;1646;6381
210408;201310;2077;8526;1984;8415;78;311;1818;7898;1896;8209
210409;201310;3853;14041;3670;13752;295;1134;2951;11350;3246;12484
210410;201310;3524;11460;3312;11191;343;1115;2733;9427;3076;10542
210420;201310;4102;13891;3855;13448;370;1262;3115;11094;3485;12356
210430;201310;1968;6456;1922;6397;165;567;1629;5458;1794;6025
210440;201310;4161;13310;4070;13168;205;680;3642;11898;3847;12578
210450;201310;2818;9105;2593;8756;234;842;2099;7108;2333;7950
210455;201310;4096;12516;3519;11612;696;2321;2261;7707;2957;10028
210460;201310;4057;13194;3849;12923;211;802;3352;11358;3563;12160
210462;201310;1756;6405;1698;6294;180;687;1301;4932;1481;5619
210465;201310;2707;8980;2558;8782;397;1174;1976;7113;2373;8287
210467;201310;6025;20650;5647;20134;478;1569;4733;17426;5211;18995
210470;201310;1790;5335;1534;4954;106;408;1225;3962;1331;4370
210480;201310;13122;45565;11807;43756;3453;12808;6438;25371;9891;38179
210490;201310;3305;10293;3095;9975;358;1216;2415;7825;2773;9041
210500;201310;6725;26548;6452;26061;734;2915;5043;21063;5777;23978
210510;201310;6680;22642;6513;22452;273;667;5915;21118;6188;21785
210515;201310;3357;11015;3292;10930;199;591;2974;10032;3173;10623
210520;201310;2658;8572;2515;8375;232;791;2059;6978;2291;7769
210530;201310;39076;132816;34478;125511;11380;44275;17063;63289;28443;107564
210535;201310;3060;11008;2994;10887;151;593;2660;9739;2811;10332
210540;201310;11995;43354;10836;41434;2476;9365;6305;25811;8781;35176
210542;201310;6366;18777;5606;17940;323;966;4957;16242;5280;17208
210545;201310;2191;7539;2101;7391;92;421;1827;6418;1919;6839
210547;201310;3508;12871;3337;12600;220;906;2797;10704;3017;11610
210550;201310;6221;17903;5420;17006;299;763;4882;15714;5181;16477
210560;201310;3869;12781;3575;12321;255;1013;2994;10304;3249;11317
210565;201310;1523;5301;1341;5026;138;637;983;3661;1121;4298
210570;201310;12487;36606;11407;35339;1025;2752;9573;30671;10598;33423
210580;201310;2811;9168;2508;8773;287;933;2021;7256;2308;8189
210590;201310;4440;13790;4203;13498;296;937;3656;11933;3952;12870
210592;201310;2457;7917;2392;7814;108;417;2127;6932;2235;7349
210594;201310;2682;7896;2289;7385;159;509;1967;6457;2126;6966
210596;201310;2811;10743;2686;10507;343;1359;2007;7988;2350;9347
210598;201310;1995;6189;1888;6066;111;467;1705;5398;1816;5865
210600;201310;3271;9776;3051;9461;349;1119;2389;7422;2738;8541
210610;201310;2605;8389;2342;8064;279;1003;1885;6528;2164;7531
210620;201310;1785;5602;1656;5429;52;139;1522;5054;1574;5193
210630;201310;3334;12548;2925;11722;536;2161;1746;7294;2282;9455
210632;201310;4766;16661;4399;16143;533;1950;3446;12879;3979;14829
210635;201310;1848;6775;1802;6704;84;280;1644;6231;1728;6511
210637;201310;2693;9318;2592;9175;138;511;2320;8303;2458;8814
210640;201310;4159;14096;4111;14034;26;78;4016;13785;4042;13863
210650;201310;6657;20586;6542;20437;223;676;6155;19362;6378;20038
210660;201310;7297;23296;6883;22637;312;894;6263;20763;6575;21657
210663;201310;2704;8177;2591;8037;110;385;2327;7264;2437;7649
210667;201310;1638;6122;1583;6043;98;416;1361;5251;1459;5667
210670;201310;4699;17860;4552;17601;451;1770;3615;14338;4066;16108
210675;201310;4775;13457;4548;13171;295;776;3961;11715;4256;12491
210680;201310;4319;12837;3917;12353;198;667;3463;10948;3661;11615
210690;201310;6698;23610;6441;23331;325;1148;5827;21380;6152;22528
210700;201310;2593;7419;2316;7095;202;395;1886;6319;2088;6714
210710;201310;4869;16025;4694;15748;187;621;4249;14362;4436;14983
210720;201310;2360;8992;2267;8861;151;641;1980;7766;2131;8407
210725;201310;1166;4364;1002;4066;132;591;632;2581;764;3172
210730;201310;1164;3754;1053;3632;96;306;890;3121;986;3427
210735;201310;3581;13624;3431;13348;645;2545;2384;9520;3029;12065
210740;201310;4853;13467;4540;13150;177;372;4221;12515;4398;12887
210745;201310;3605;11272;3415;10996;355;1016;2765;9081;3120;10097
210750;201310;19599;55843;18122;54124;2264;6801;14506;43941;16770;50742
210760;201310;5825;16162;5559;15872;81;242;5402;15446;5483;15688
210770;201310;6095;16936;5252;15975;287;905;4612;14096;4899;15001
210780;201310;8615;29601;8059;28563;1129;4250;5815;20949;6944;25199
210790;201310;4730;14357;4115;13664;309;811;3526;12232;3835;13043
210800;201310;4799;14286;4396;13847;203;750;3816;12357;4019;13107
210805;201310;3672;15724;3577;15533;197;874;3091;13708;3288;14582
210810;201310;5573;17389;5050;16789;505;1281;4277;14870;4782;16151
210820;201310;8865;25838;8385;25194;1415;4237;5973;18443;7388;22680
210825;201310;5483;18501;5339;18321;224;796;4830;16758;5054;17554
210830;201310;8190;26614;7901;26289;325;914;7335;24766;7660;25680
210840;201310;3723;10432;3430;10006;328;793;2708;8048;3036;8841
210845;201310;5488;17717;5283;17473;298;857;4656;15888;4954;16745
210850;201310;5829;22098;5494;21502;969;4221;3764;14766;4733;18987
210860;201310;16760;53545;15959;52423;1384;4922;13150;43394;14534;48316
210870;201310;6251;20701;5713;19976;819;2775;4159;14943;4978;17718
210880;201310;3954;13009;3882;12909;201;653;3528;11863;3729;12516
210890;201310;5291;16205;4963;15776;506;1716;4035;12828;4541;14544
210900;201310;4473;15072;4183;14564;1472;5215;1941;7068;3413;12283
210905;201310;1799;5735;1720;5633;118;297;1516;5115;1634;5412
210910;201310;10513;33543;9895;32578;1960;6927;6496;21529;8456;28456
210920;201310;3456;11575;3357;11444;144;418;3070;10668;3214;11086
210923;201310;1498;5668;1438;5563;199;813;1036;4151;1235;4964
210927;201310;4663;14952;4564;14850;36;97;4493;14673;4529;14770
210930;201310;2584;9561;2502;9436;202;918;2114;7944;2316;8862
210940;201310;2861;11421;2823;11349;314;1164;2291;9463;2605;10627
210945;201310;5813;17277;5624;17084;162;224;5406;16752;5568;16976
210950;201310;5488;17657;4876;16736;700;2464;3452;12185;4152;14649
210955;201310;1862;6343;1702;6068;286;1117;1160;4168;1446;5285
210960;201310;9015;30532;8726;30081;2016;6678;5858;21104;7874;27782
210970;201310;1353;5024;1214;4817;192;820;857;3467;1049;4287
210975;201310;1668;5992;1589;5834;167;649;1256;4653;1423;5302
210980;201310;8715;22561;8506;22320;493;1159;7618;20280;8111;21439
210990;201310;14739;43854;12364;41098;1751;6109;9414;31497;11165;37606
211000;201310;15864;52543;14562;50855;1136;4120;12327;43727;13463;47847
211003;201310;5069;18032;4674;17422;704;2801;3275;12451;3979;15252
211010;201310;6593;22373;6430;22160;148;495;6031;20975;6179;21470
211020;201310;7320;22774;7247;22678;205;419;6939;21988;7144;22407
211023;201310;2337;8174;2252;8026;173;643;1889;6837;2062;7480
211027;201310;3024;11798;2888;11569;290;1076;2311;9620;2601;10696
211030;201310;4179;13023;3781;12562;838;2329;2698;9565;3536;11894
211040;201310;4043;15747;3949;15589;135;560;3551;14269;3686;14829
211050;201310;9776;27364;9646;27212;515;1363;8918;25336;9433;26699
211060;201310;5588;20980;5475;20750;611;2140;4471;17432;5082;19572
211065;201310;1685;5882;1551;5700;81;320;1410;5212;1491;5532
211070;201310;8495;29133;8101;28469;804;2928;6438;22986;7242;25914
211080;201310;1334;4246;1102;3925;90;451;901;3124;991;3575
211085;201310;1994;6803;1734;6458;320;1149;1268;4899;1588;6048
211090;201310;3474;11189;3292;10933;229;901;2773;9152;3002;10053
211100;201310;6706;17819;6558;17636;97;353;6227;16697;6324;17050
211102;201310;3091;11631;2994;11486;372;1362;2405;9489;2777;10851
211105;201310;2751;8818;2489;8475;174;655;2135;7284;2309;7939
211107;201310;4330;13642;4049;13264;165;522;3674;12211;3839;12733
211110;201310;6311;19420;5102;17786;872;2973;3444;12630;4316;15603
211120;201310;31178;87748;27478;82943;3762;11111;20142;62952;23904;74063
211125;201310;2105;7002;1949;6765;160;547;1609;5676;1769;6223
211130;201310;143279;431657;135371;421348;27186;84350;93688;298976;120874;383326
211140;201310;5654;18462;5385;18028;296;1093;4692;15726;4988;16819
211150;201310;9692;30629;9292;30123;747;2399;8027;26402;8774;28801
211153;201310;3194;9684;2925;9363;305;776;2417;8114;2722;8890
211157;201310;1226;4105;1050;3829;142;631;730;2726;872;3357
211160;201310;4115;14437;3612;13584;402;1758;2740;10317;3142;12075
211163;201310;1684;5629;1610;5530;64;235;1462;5070;1526;5305
211167;201310;1456;5062;1359;4902;56;234;1207;4361;1263;4595
211170;201310;6597;18040;6395;17792;150;528;5974;16536;6124;17064
211172;201310;2343;6985;2058;6535;186;697;1648;5128;1834;5825
211174;201310;2818;8490;2597;8206;131;537;2266;7088;2397;7625
211176;201310;5538;16350;4738;15414;555;1520;3757;12783;4312;14303
211178;201310;2961;9680;2898;9614;73;197;2764;9279;2837;9476
211180;201310;4216;15499;3980;15113;403;1691;3152;12032;3555;13723
211190;201310;2733;9408;2503;9072;144;638;2161;7848;2305;8486
211195;201310;1419;4581;1235;4354;112;405;1005;3612;1117;4017
211200;201310;2125;7487;1923;7205;283;980;1396;5548;1679;6528
211210;201310;6730;22685;6563;22404;537;1854;5565;19233;6102;21087
211220;201310;34713;105488;30667;100076;7357;24828;18520;62244;25877;87072
211223;201310;5895;17115;5480;16424;716;2186;3814;11998;4530;14184
211227;201310;1514;5847;1469;5770;168;759;1142;4489;1310;5248
211230;201310;8851;30571;8234;29512;1377;4977;5711;21028;7088;26005
211240;201310;8348;28457;8136;28196;364;1307;7497;26136;7861;27443
211245;201310;5040;15663;4964;15565;211;587;4584;14586;4795;15173
211250;201310;11720;44538;11183;43908;1374;4342;9161;37837;10535;42179
211260;201310;7912;25740;7820;25594;375;1185;7179;23677;7554;24862
211270;201310;9892;35735;9414;35093;655;2722;7897;29806;8552;32528
211280;201310;12041;35216;11666;34772;1285;3137;9776;30303;11061;33440
211285;201310;1981;7077;1731;6613;413;1649;893;3599;1306;5248
211290;201310;7718;25468;7557;25279;576;1581;6608;22719;7184;24300
211300;201310;8388;26310;7586;25088;691;2388;6138;20448;6829;22836
211400;201310;12331;37083;11074;35634;2555;8156;6642;23423;9197;31579
220005;201310;1691;5057;1623;4951;54;259;1442;4269;1496;4528
220010;201310;1712;4596;1307;4092;140;527;1022;3132;1162;3659
220020;201310;3644;11374;3493;11111;611;2103;2370;7499;2981;9602
220025;201310;2124;5414;2008;5247;68;220;1794;4619;1862;4839
220027;201310;1382;3849;1287;3727;104;239;1096;3266;1200;3505
220030;201310;3298;10145;3234;10037;293;964;2705;8441;2998;9405
220040;201310;8273;26064;7913;25476;1511;5171;5026;16242;6537;21413
220045;201310;1438;4685;1311;4477;158;618;948;3189;1106;3807
220050;201310;4776;13852;4265;13142;346;1267;3482;10593;3828;11860
220060;201310;2005;5297;1913;5188;107;296;1714;4663;1821;4959
220070;201310;2559;7731;2286;7344;213;690;1822;5936;2035;6626
220080;201310;822;2586;776;2501;97;392;547;1692;644;2084
220090;201310;1722;4797;1549;4542;150;534;1214;3465;1364;3999
220095;201310;645;1870;626;1831;33;101;573;1664;606;1765
220100;201310;1405;4314;1229;4032;154;488;906;3059;1060;3547
220105;201310;2182;7302;2074;7101;227;818;1523;5242;1750;6060
220110;201310;3540;10380;3142;9810;294;1093;2538;7800;2832;8893
220115;201310;2174;8117;2095;7983;303;1214;1623;6240;1926;7454
220117;201310;1412;3801;1177;3458;93;304;935;2721;1028;3025
220120;201310;12353;36476;11575;35479;396;1500;10537;32281;10933;33781
220130;201310;775;2887;689;2772;67;192;589;2477;656;2669
220140;201310;1576;4294;1472;4164;281;641;1135;3377;1416;4018
220150;201310;7146;22913;6863;22509;473;1841;5822;18990;6295;20831
220155;201310;1039;3325;897;3061;84;359;628;2086;712;2445
220157;201310;1038;2741;955;2613;45;117;825;2272;870;2389
220160;201310;2836;8550;2557;8064;216;832;1942;6053;2158;6885
220170;201310;1261;4141;1187;4007;116;427;933;3173;1049;3600
220173;201310;2087;6384;1695;5607;79;362;1393;4525;1472;4887
220177;201310;1666;5017;1639;4973;86;275;1482;4506;1568;4781
220180;201310;1155;3196;1038;3012;72;252;798;2260;870;2512
220190;201310;4538;15092;3970;14357;484;1801;3056;11187;3540;12988
220191;201310;1415;4844;1358;4748;232;783;975;3438;1207;4221
220192;201310;1737;5142;1429;4614;175;549;1050;3445;1225;3994
220194;201310;1706;5001;1552;4725;199;676;1135;3364;1334;4040
220196;201310;2008;6087;1900;5906;219;788;1442;4429;1661;5217
220198;201310;1333;3694;1136;3431;42;134;1039;3167;1081;3301
220200;201310;4616;16028;4359;15618;755;2956;2994;10656;3749;13612
220202;201310;2024;6488;1854;6179;70;294;1640;5427;1710;5721
220205;201310;2865;7708;2539;7262;106;409;2225;6265;2331;6674
220207;201310;914;2823;794;2612;100;372;589;1926;689;2298
220208;201310;1621;5804;1528;5627;309;1290;977;3566;1286;4856
220209;201310;1558;4979;1434;4764;101;407;1106;3676;1207;4083
220210;201310;1860;4979;1631;4675;101;355;1286;3691;1387;4046
220211;201310;1631;4928;1549;4807;108;472;1276;3929;1384;4401
220213;201310;1782;5244;1663;5021;119;408;1303;3873;1422;4281
220217;201310;1787;5750;1728;5674;84;255;1556;5176;1640;5431
220220;201310;11510;33829;10699;32516;1435;4298;7601;23696;9036;27994
220225;201310;997;3101;937;3004;37;154;820;2610;857;2764
220230;201310;6006;16109;5005;14744;271;813;4366;12930;4637;13743
220240;201310;2667;8701;2564;8511;216;802;2033;6684;2249;7486
220245;201310;1419;3914;1338;3808;64;172;1194;3431;1258;3603
220250;201310;3359;9092;3057;8693;60;139;2869;8261;2929;8400
220253;201310;1824;5541;1591;5113;119;453;1177;3805;1296;4258
220255;201310;1739;5045;1542;4706;117;459;1241;3681;1358;4140
220260;201310;5212;16846;4750;15979;504;1926;3547;11904;4051;13830
220265;201310;1206;4461;1153;4368;108;508;855;3216;963;3724
220270;201310;6473;22147;6318;21866;429;1946;5353;18114;5782;20060
220271;201310;1486;4286;1431;4207;86;254;1242;3705;1328;3959
220272;201310;1757;5540;1641;5362;113;475;1295;4188;1408;4663
220273;201310;1282;3744;1132;3512;111;371;841;2594;952;2965
220275;201310;2050;5532;1769;5170;84;272;1535;4504;1619;4776
220277;201310;2535;7060;2175;6516;177;581;1670;5047;1847;5628
220280;201310;1773;4654;1551;4337;107;397;1248;3423;1355;3820
220285;201310;1664;4528;1496;4293;104;313;1234;3625;1338;3938
220290;201310;6571;21422;5577;20145;537;2026;4423;16235;4960;18261
220300;201310;1885;6210;1676;5930;96;437;1430;5054;1526;5491
220310;201310;2564;8383;2124;7855;104;341;1919;7270;2023;7611
220320;201310;3343;9971;2837;9121;422;1394;2034;6596;2456;7990
220323;201310;1398;5331;1290;5174;225;969;918;3698;1143;4667
220325;201310;1268;3995;1165;3799;164;584;765;2559;929;3143
220327;201310;1345;4343;1216;4112;79;376;976;3234;1055;3610
220330;201310;3609;10509;3458;10294;287;969;2905;8661;3192;9630
220335;201310;2069;6013;1844;5725;113;411;1593;4922;1706;5333
220340;201310;1772;5146;1582;4883;167;585;1222;3733;1389;4318
220342;201310;1211;3973;1148;3879;117;478;861;2983;978;3461
220345;201310;2841;7989;2425;7307;96;271;2084;6306;2180;6577
220350;201310;4445;12144;3922;11422;309;991;3127;9105;3436;10096
220360;201310;1454;4032;1152;3554;123;414;835;2567;958;2981
220370;201310;9039;26408;8340;25504;469;1354;7496;23093;7965;24447
220375;201310;1532;4823;1429;4682;88;338;1264;4112;1352;4450
220380;201310;1339;3778;1154;3514;76;252;900;2748;976;3000
220385;201310;691;1926;625;1798;42;142;514;1421;556;1563
220390;201310;10310;32937;9447;31217;2307;8086;4732;15747;7039;23833
220400;201310;1436;3508;1310;3335;66;216;1135;2832;1201;3048
220410;201310;1379;4047;1186;3783;107;456;942;2914;1049;3370
220415;201310;869;2373;784;2251;91;254;584;1693;675;1947
220420;201310;2213;6525;2050;6214;149;456;1682;5109;1831;5565
220430;201310;2947;8743;2800;8548;403;1270;2079;6371;2482;7641
220435;201310;1608;4840;1523;4729;79;256;1311;4086;1390;4342
220440;201310;2807;8409;2324;7850;147;407;2064;7098;2211;7505
220450;201310;2714;8126;2361;7646;580;1948;1412;4630;1992;6578
220455;201310;1421;4388;1275;4184;58;195;1146;3800;1204;3995
220460;201310;1018;2869;966;2793;62;191;837;2407;899;2598
220465;201310;2419;8055;2261;7831;401;1494;1607;5614;2008;7108
220470;201310;3998;12250;3641;11611;260;960;2840;8927;3100;9887
220480;201310;2310;7088;2125;6802;160;543;1758;5629;1918;6172
220490;201310;2346;7011;2246;6876;130;488;1955;5930;2085;6418
220500;201310;3424;9357;2970;8616;208;795;2418;6810;2626;7605
220510;201310;2923;8260;2258;7300;104;464;1777;5714;1881;6178
220515;201310;1952;4951;1731;4668;82;237;1476;3977;1558;4214
220520;201310;4976;14230;4682;13807;244;679;4102;12229;4346;12908
220525;201310;1455;4166;1361;4035;109;397;1105;3205;1214;3602
220527;201310;1418;4583;1337;4405;143;454;1068;3579;1211;4033
220530;201310;1134;3375;1068;3274;109;411;871;2580;980;2991
220535;201310;848;2728;818;2682;67;290;668;2146;735;2436
220540;201310;3581;12105;3455;11893;290;1174;2808;9649;3098;10823
220545;201310;1423;4957;1364;4850;217;861;926;3256;1143;4117
220550;201310;9115;30246;8653;29395;1629;5912;5701;19380;7330;25292
220551;201310;1408;4879;1326;4733;136;575;1024;3605;1160;4180
220552;201310;1655;5194;1430;4825;136;625;1043;3373;1179;3998
220553;201310;1616;4856;1406;4549;86;306;1160;3747;1246;4053
220554;201310;926;2622;810;2461;120;368;572;1777;692;2145
220555;201310;2413;7197;2265;6993;99;341;1938;6075;2037;6416
220556;201310;1461;4702;1333;4454;104;437;1005;3313;1109;3750
220557;201310;1609;5374;1459;5084;199;807;1005;3462;1204;4269
220558;201310;1020;3205;954;3085;96;361;750;2395;846;2756
220559;201310;1542;4420;1428;4253;83;285;1228;3644;1311;3929
220560;201310;1748;4412;1467;4020;88;259;1241;3375;1329;3634
220570;201310;7361;23831;6956;23305;823;2427;5642;19536;6465;21963
220580;201310;6504;21476;6335;21270;429;1408;5618;19115;6047;20523
220585;201310;1884;7151;1827;7043;131;518;1548;6024;1679;6542
220590;201310;1408;4466;1275;4266;236;828;828;2815;1064;3643
220595;201310;2461;7229;2284;6989;87;296;2059;6318;2146;6614
220600;201310;1304;3295;1123;3076;213;485;742;2161;955;2646
220605;201310;2035;6114;1810;5765;120;406;1431;4569;1551;4975
220610;201310;2695;8692;2609;8561;182;720;2204;7171;2386;7891
220620;201310;7772;26764;7549;26416;415;1676;6590;23071;7005;24747
220630;201310;391;1205;338;1114;85;301;175;582;260;883
220635;201310;1853;6665;1723;6363;160;701;1146;4220;1306;4921
220640;201310;2771;8288;2670;8134;280;964;2066;6277;2346;7241
220650;201310;2458;6945;2214;6570;148;506;1810;5351;1958;5857
220660;201310;2461;8485;2034;7958;157;625;1808;7133;1965;7758
220665;201310;1215;4237;1165;4157;62;264;1014;3594;1076;3858
220667;201310;1746;5951;1657;5821;84;342;1427;4999;1511;5341
220669;201310;1873;6249;1748;6002;248;969;1229;4190;1477;5159
220670;201310;2140;6502;2023;6359;160;426;1756;5687;1916;6113
220672;201310;2194;6469;2139;6392;234;676;1795;5432;2029;6108
220675;201310;1341;3945;1255;3801;135;371;936;2885;1071;3256
220680;201310;2228;7396;2143;7271;162;556;1796;6169;1958;6725
220690;201310;1707;4954;1540;4676;128;483;1227;3667;1355;4150
220695;201310;865;2695;819;2616;71;232;631;2036;702;2268
220700;201310;9019;26656;8233;25475;791;2690;6417;19868;7208;22558
220710;201310;742;2262;652;2115;72;223;472;1552;544;1775
220720;201310;2125;5805;2014;5648;101;226;1792;5123;1893;5349
220730;201310;1344;3785;1196;3557;54;186;1006;2972;1060;3158
220735;201310;1027;2738;888;2513;83;264;659;1870;742;2134
220740;201310;1321;4435;1151;4201;136;459;915;3454;1051;3913
220750;201310;3923;11849;3739;11575;493;1425;2890;9242;3383;10667
220755;201310;1168;3517;1108;3419;69;209;961;2976;1030;3185
220760;201310;2624;9404;2447;9128;124;491;2140;8063;2264;8554
220770;201310;23047;80667;21779;78311;7582;28236;9359;34717;16941;62953
220775;201310;1156;2924;1140;2906;19;33;1114;2855;1133;2888
220777;201310;1680;4891;1595;4766;134;412;1305;3887;1439;4299
220779;201310;1140;3553;1115;3514;70;270;985;3082;1055;3352
220780;201310;6242;16474;5661;15708;484;1258;4659;13163;5143;14421
220785;201310;1280;3566;1237;3473;74;198;1107;3105;1181;3303
220790;201310;9198;30876;8958;30425;953;3557;7153;24252;8106;27809
220793;201310;901;2613;841;2512;70;236;685;2039;755;2275
220795;201310;1510;4324;1462;4251;117;352;1219;3578;1336;3930
220800;201310;16747;48710;15727;47155;1966;6875;11915;34947;13881;41822
220810;201310;3323;9861;2887;9073;248;967;2257;6980;2505;7947
220820;201310;5518;15921;5070;15328;336;1125;4322;13122;4658;14247
220830;201310;7663;22073;7339;21542;892;2613;5649;16857;6541;19470
220840;201310;14725;48062;13553;45690;3590;12379;6254;21835;9844;34214
220850;201310;2650;9833;2549;9673;357;1476;1933;7381;2290;8857
220855;201310;606;1973;562;1889;71;281;416;1380;487;1661
220860;201310;931;2655;873;2563;56;221;717;2056;773;2277
220865;201310;2652;7601;2240;6935;125;557;1828;5548;1953;6105
220870;201310;2394;7985;2103;7616;155;613;1800;6522;1955;7135
220880;201310;5354;14278;4925;13743;257;875;4328;12057;4585;12932
220885;201310;1330;4733;1178;4458;125;569;860;3256;985;3825
220887;201310;1294;3562;1147;3356;46;148;1019;2996;1065;3144
220890;201310;1600;5763;1443;5509;137;525;1167;4569;1304;5094
220900;201310;1840;5681;1664;5267;126;385;1345;4321;1471;4706
220910;201310;1728;5080;1544;4792;79;274;1344;4205;1423;4479
220915;201310;1032;3043;923;2861;50;222;736;2215;786;2437
220920;201310;1279;4859;1224;4779;123;559;947;3690;1070;4249
220930;201310;1466;4806;1300;4589;113;464;1048;3726;1161;4190
220935;201310;1019;3217;925;3007;70;308;692;2143;762;2451
220937;201310;1532;4317;1331;3958;84;302;1066;3105;1150;3407
220940;201310;1464;4550;1370;4344;104;389;1084;3431;1188;3820
220945;201310;475;1748;442;1647;59;253;307;1136;366;1389
220950;201310;1257;3244;924;2667;48;193;699;1951;747;2144
220955;201310;1612;4525;1373;4153;147;495;1058;3186;1205;3681
220960;201310;802;2304;722;2166;73;289;547;1581;620;1870
220965;201310;1664;5139;1575;5012;69;281;1364;4327;1433;4608
220970;201310;2076;5709;1567;4876;191;610;1080;3391;1271;4001
220975;201310;477;1943;474;1936;61;241;394;1627;455;1868
220980;201310;1484;4488;1314;4186;127;464;899;2935;1026;3399
220985;201310;1352;3937;1296;3858;117;396;1012;3002;1129;3398
220987;201310;1464;4907;1385;4761;129;538;1054;3553;1183;4091
220990;201310;1791;5351;1606;5030;94;403;1265;3901;1359;4304
220995;201310;1174;3642;968;3297;84;346;752;2567;836;2913
220997;201310;2091;6754;2003;6605;137;468;1774;5844;1911;6312
221000;201310;4339;13662;4040;13131;491;1721;2990;9701;3481;11422
221005;201310;1408;4538;1336;4408;395;1242;731;2519;1126;3761
221010;201310;1242;3434;1103;3254;63;199;950;2820;1013;3019
221020;201310;1901;6001;1803;5825;138;610;1383;4353;1521;4963
221030;201310;1814;5036;1586;4699;85;342;1298;3793;1383;4135
221035;201310;1542;4273;1403;4095;95;280;1218;3597;1313;3877
221037;201310;637;1985;576;1877;36;157;467;1459;503;1616
221038;201310;626;1837;521;1663;47;164;363;1171;410;1335
221039;201310;913;2743;872;2680;68;231;750;2287;818;2518
221040;201310;5131;16031;4882;15620;415;1456;3854;12459;4269;13915
221050;201310;3649;11486;3387;11103;229;928;2882;9348;3111;10276
221060;201310;9073;25042;7862;23436;872;2698;6164;18497;7036;21195
221062;201310;1277;4502;1222;4426;36;111;1146;4170;1182;4281
221063;201310;1110;3629;1052;3527;370;1200;546;1958;916;3158
221065;201310;2648;8032;2528;7831;272;894;1971;6093;2243;6987
221070;201310;4373;13583;3994;12994;292;1129;3183;10299;3475;11428
221080;201310;3366;9503;3064;9096;236;768;2496;7441;2732;8209
221090;201310;1319;3698;1188;3506;66;258;998;2885;1064;3143
221093;201310;1787;5415;1711;5273;274;954;1130;3418;1404;4372
221095;201310;972;2678;848;2505;44;129;754;2247;798;2376
221097;201310;792;2329;711;2194;64;250;546;1664;610;1914
221100;201310;121059;377185;115730;368282;25622;90018;74340;231156;99962;321174
221110;201310;9634;33170;9413;32846;744;3038;7894;27402;8638;30440
221120;201310;4140;14198;4002;13939;1191;4054;2315;8442;3506;12496
221130;201310;4626;14032;4117;12987;995;3291;2305;7213;3300;10504
221135;201310;1444;4661;1356;4524;187;718;982;3231;1169;3949
221140;201310;1390;3584;1288;3450;167;369;1007;2789;1174;3158
221150;201310;1219;3213;1035;2877;33;135;836;2303;869;2438
221160;201310;899;2453;851;2375;59;182;659;1845;718;2027
221170;201310;1097;3640;1056;3559;82;332;872;2899;954;3231
230010;201310;3287;9291;2830;8542;185;637;2260;6872;2445;7509
230015;201310;2913;10231;2714;9815;476;1987;1737;6186;2213;8173
230020;201310;13972;47549;13497;46607;1214;4572;10775;37405;11989;41977
230030;201310;12226;37233;11624;36224;1124;3851;9232;28762;10356;32613
230040;201310;4500;13050;3855;11908;360;1289;2983;9128;3343;10417
230050;201310;2530;8831;2194;7981;401;1631;1154;4188;1555;5819
230060;201310;1941;5991;1752;5617;189;713;1297;4122;1486;4835
230070;201310;4631;12949;4118;12221;402;1275;3133;9498;3535;10773
230075;201310;8621;32999;8224;32170;1064;4851;6048;23597;7112;28448
230080;201310;2331;6640;1995;6156;123;438;1642;5053;1765;5491
230090;201310;3306;10496;3006;9956;353;1383;2256;7335;2609;8718
230100;201310;16647;53387;15596;51454;4633;16143;7547;25251;12180;41394
230110;201310;13761;46561;12908;44711;2576;9699;7811;27003;10387;36702
230120;201310;7809;22122;7024;21063;842;2825;5210;15651;6052;18476
230125;201310;2845;8583;2397;7714;197;797;1791;5692;1988;6489
230130;201310;5799;19495;4892;17476;465;1997;3440;12147;3905;14144
230140;201310;3386;11392;3003;10691;501;1884;1921;6965;2422;8849
230150;201310;1731;5610;1525;5188;297;1177;952;3075;1249;4252
230160;201310;6213;19320;5512;18263;595;2181;4136;13751;4731;15932
230170;201310;6376;20925;5590;19471;550;2228;4047;13943;4597;16171
230180;201310;1907;5630;1699;5256;156;601;1188;3607;1344;4208
230185;201310;4123;14159;3837;13597;725;2601;2400;8784;3125;11385
230190;201310;12246;41292;11285;39344;2194;8679;6531;22575;8725;31254
230195;201310;4828;15457;4411;14788;382;1642;3396;11023;3778;12665
230200;201310;5643;16811;5051;15634;680;2223;3554;10996;4234;13219
230205;201310;4327;14169;3892;13426;416;1728;2803;9703;3219;11431
230210;201310;9048;26857;8136;25427;2105;6743;4404;14220;6509;20963
230220;201310;13431;41129;12531;39599;2087;7418;8441;26300;10528;33718
230230;201310;7254;24744;6556;23209;1168;4315;3928;14121;5096;18436
230240;201310;13202;39646;12030;37437;896;3424;9339;28598;10235;32022
230250;201310;10150;31660;9915;31296;571;2142;8419;26492;8990;28634
230260;201310;14666;51116;13665;48980;3246;12401;7170;26296;10416;38697
230270;201310;6963;21656;6234;20394;714;2591;4617;15174;5331;17765
230280;201310;19772;61712;18381;59333;2676;9212;13330;43172;16006;52384
230290;201310;5077;16051;4465;14815;641;2238;3014;10083;3655;12321
230300;201310;4639;14884;4461;14610;564;2118;3311;10759;3875;12877
230310;201310;4862;14901;4326;13998;407;1622;3280;10433;3687;12055
230320;201310;7301;24091;6869;23320;863;3296;5026;17112;5889;20408
230330;201310;4637;14254;4201;13385;456;1684;3009;9417;3465;11101
230340;201310;3349;11928;3160;11497;538;2204;1974;7029;2512;9233
230350;201310;17869;56102;16164;53083;3156;11186;9940;32943;13096;44129
230360;201310;2910;8956;2617;8440;311;1153;1970;6302;2281;7455
230365;201310;2895;8800;2563;8248;221;861;1922;6147;2143;7008
230370;201310;53150;181800;49668;175839;15149;56131;24648;89972;39797;146103
230380;201310;7028;20743;6084;19140;591;2171;4313;13555;4904;15726
230390;201310;3624;11759;3253;11135;454;1856;2205;7454;2659;9310
230393;201310;3333;11403;2887;10442;294;1445;2036;7113;2330;8558
230395;201310;4896;15976;4596;15378;656;2601;3130;10341;3786;12942
230400;201310;5028;16159;4463;15375;418;1839;3573;12044;3991;13883
230410;201310;15829;50939;14324;48111;2492;9070;8766;29490;11258;38560
230420;201310;23546;80671;22319;78152;5827;22302;11400;39651;17227;61953
230423;201310;4773;15952;4422;15315;529;2028;3110;10888;3639;12916
230425;201310;5313;18378;4956;17573;729;2835;3404;12013;4133;14848
230426;201310;2797;8001;2351;7178;146;600;1799;5358;1945;5958
230427;201310;1703;5314;1284;4341;131;491;851;2788;982;3279
230428;201310;8924;29984;8721;29626;1827;6997;5574;18619;7401;25616
230430;201310;4570;15089;4337;14620;437;1798;3189;10566;3626;12364
230435;201310;4828;16440;4380;15637;1128;4366;2166;7976;3294;12342
230440;201310;352364;1119452;333969;1085797;88020;309218;168944;548394;256964;857612
230445;201310;4675;13103;4071;12233;402;1237;3047;9351;3449;10588
230450;201310;3631;11965;3124;11031;483;1917;1986;7058;2469;8975
230460;201310;1901;6434;1760;6161;198;785;1292;4524;1490;5309
230465;201310;4075;12743;3391;11439;363;1556;2238;7374;2601;8930
230470;201310;11110;41439;10731;40690;1530;6212;7751;29893;9281;36105
230480;201310;1436;4749;1281;4450;236;866;826;2890;1062;3756
230490;201310;2951;8808;2604;8165;453;1612;1435;4490;1888;6102
230495;201310;5673;19451;5162;18581;976;4128;3060;10988;4036;15116
230500;201310;10662;36881;10188;36103;896;3338;8079;29241;8975;32579
230510;201310;1496;5470;1287;4944;355;1449;549;2188;904;3637
230520;201310;4963;15455;4356;14365;515;1980;2992;9797;3507;11777
230523;201310;12984;44739;12114;42773;3776;14751;3670;13105;7446;27856
230526;201310;4100;13054;3613;12171;460;1759;2513;8495;2973;10254
230530;201310;5099;17440;4737;16926;1016;3649;3093;11268;4109;14917
230533;201310;3770;11324;3516;10836;298;1061;2745;8399;3043;9460
230535;201310;5364;16339;4755;15214;500;1727;3479;11253;3979;12980
230540;201310;18576;54796;16698;52030;1262;4610;13664;42255;14926;46865
230550;201310;20021;61855;18398;58740;4278;14906;10011;31744;14289;46650
230560;201310;6665;19624;6049;18461;349;1360;4804;14470;5153;15830
230565;201310;3420;10130;2915;9128;314;1136;2000;6192;2314;7328
230570;201310;3900;10907;3516;10410;248;913;2909;8508;3157;9421
230580;201310;10252;32295;9859;31751;599;2037;8590;27886;9189;29923
230590;201310;9500;30964;8791;29682;845;3547;6524;21585;7369;25132
230600;201310;3658;10508;2874;8908;249;865;1927;5889;2176;6754
230610;201310;6019;20262;5641;19644;849;3241;4023;14107;4872;17348
230620;201310;2011;5875;1714;5271;178;630;1112;3336;1290;3966
230625;201310;7456;25380;6780;23807;1969;7550;2523;8850;4492;16400
230630;201310;11035;37037;10139;35213;2435;8374;5274;19187;7709;27561
230640;201310;25760;88790;24564;86909;4105;15347;17159;61426;21264;76773
230650;201310;4902;16081;4525;15336;428;1823;3457;11490;3885;13313
230655;201310;8444;32800;8170;32337;828;3327;6740;27103;7568;30430
230660;201310;6297;20206;5550;18825;589;2393;3988;13584;4577;15977
230670;201310;5915;16497;4844;14609;300;1100;3771;11100;4071;12200
230680;201310;2761;8347;2377;7632;400;1409;1449;4640;1849;6049
230690;201310;6410;21567;6259;21273;544;2336;4553;15132;5097;17468
230700;201310;9116;27112;8094;25223;949;3615;5493;16593;6442;20208
230710;201310;7512;24873;6744;23419;931;3283;4834;17157;5765;20440
230720;201310;1911;6122;1646;5609;244;915;1084;3710;1328;4625
230725;201310;3774;12827;3451;12080;639;2498;2127;7338;2766;9836
230730;201310;56343;175615;48353;163135;12913;47515;23556;80582;36469;128097
230740;201310;5149;17013;4993;16720;363;1539;4149;13724;4512;15263
230750;201310;8848;26332;7608;24265;762;2925;5682;17986;6444;20911
230760;201310;9879;31293;9603;30652;1422;5494;6840;20874;8262;26368
230763;201310;4180;13383;3949;12927;343;1547;3011;9454;3354;11001
230765;201310;43341;145379;40762;140040;13864;50597;14663;51254;28527;101851
230770;201310;22949;65825;21568;63755;1800;6444;16950;49488;18750;55932
230780;201310;5899;23925;5664;23364;1341;5638;3133;13592;4474;19230
230790;201310;2510;8763;2414;8601;297;1154;1878;6757;2175;7911
230800;201310;7771;28862;7202;27552;1762;7330;3514;13482;5276;20812
230810;201310;12317;41105;11816;40252;1441;5225;9009;31068;10450;36293
230820;201310;3367;11662;3013;10887;645;2598;1637;5940;2282;8538
230830;201310;7733;23934;7001;22612;750;2828;5029;16152;5779;18980
230835;201310;4103;11466;3546;10712;314;1043;2785;8425;3099;9468
230837;201310;3144;11010;2745;10183;395;1654;1806;6708;2201;8362
230840;201310;9253;31498;8489;30118;1460;5524;5480;19863;6940;25387
230850;201310;11115;34668;10523;33921;1367;4937;7838;25152;9205;30089
230860;201310;5030;15480;4618;14648;425;1615;3476;10884;3901;12499
230870;201310;18661;53203;16895;50199;1814;6175;12681;37357;14495;43532
230880;201310;1900;6740;1783;6501;270;1124;1167;4241;1437;5365
230890;201310;4081;15168;3805;14597;527;2410;2644;9987;3171;12397
230900;201310;2994;10250;2645;9499;479;1801;1549;5612;2028;7413
230910;201310;2968;9176;2447;8151;272;1087;1714;5597;1986;6684
230920;201310;4590;13851;4246;13413;348;1179;3466;11103;3814;12282
230930;201310;7651;23960;7009;22761;935;3270;4905;16011;5840;19281
230940;201310;7563;21789;6739;20574;387;1209;5710;17613;6097;18822
230945;201310;6144;18751;5340;17669;677;2416;3766;12632;4443;15048
230950;201310;6868;19323;5942;18056;404;1382;4647;14141;5051;15523
230960;201310;11896;39447;11076;37761;2674;10030;5362;18211;8036;28241
230970;201310;13116;43183;12047;41022;2664;10367;6247;20794;8911;31161
230980;201310;2769;9453;2577;9043;752;2690;1264;4594;2016;7284
230990;201310;1581;5060;1313;4505;175;736;852;2842;1027;3578
231000;201310;2863;7859;2308;6803;247;872;1551;4450;1798;5322
231010;201310;2907;8724;2583;8223;333;1317;1853;5755;2186;7072
231020;201310;7880;26685;7451;25794;1385;5109;4748;16697;6133;21806
231025;201310;7700;24872;6992;23653;985;3476;4841;16764;5826;20240
231030;201310;7859;26636;6737;24234;1345;5095;3995;14557;5340;19652
231040;201310;2946;10124;2695;9574;310;1323;1871;6537;2181;7860
231050;201310;11839;35540;10552;33178;1138;3992;7662;24139;8800;28131
231060;201310;2398;7776;2213;7442;211;967;1651;5387;1862;6354
231070;201310;9133;29535;8595;28518;1479;5309;5565;18591;7044;23900
231080;201310;4241;13580;3903;12942;292;1331;2904;9245;3196;10576
231085;201310;4605;15266;4461;14998;728;2669;3251;10980;3979;13649
231090;201310;4114;11827;3487;10563;239;900;2603;7760;2842;8660
231095;201310;2159;7319;1896;6794;227;888;1329;4802;1556;5690
231100;201310;3015;9567;2519;8553;245;949;1828;6161;2073;7110
231110;201310;3716;12692;3615;12505;416;1555;2641;9203;3057;10758
231120;201310;2423;8062;2255;7761;385;1391;1483;5149;1868;6540
231123;201310;2165;6156;1877;5680;147;482;1488;4515;1635;4997
231126;201310;6654;18865;5529;17286;471;1699;4325;13390;4796;15089
231130;201310;19918;64049;18311;61187;4788;16864;9557;33069;14345;49933
231135;201310;4557;13746;3890;12701;400;1536;2840;9146;3240;10682
231140;201310;15259;50987;14424;49320;1607;7333;10212;33580;11819;40913
231150;201310;5842;17468;5015;15849;1029;3622;2612;8037;3641;11659
231160;201310;5831;20290;5584;19825;1580;5847;3153;11213;4733;17060
231170;201310;4717;15402;4413;14806;517;2138;3058;10103;3575;12241
231180;201310;14539;45731;13435;43550;2727;9679;8151;26076;10878;35755
231190;201310;5019;14225;4207;13034;391;1386;3254;9946;3645;11332
231195;201310;4601;16046;4005;14862;405;1768;3005;11176;3410;12944
231200;201310;7499;26964;6828;25641;800;3597;4889;18214;5689;21811
231210;201310;4949;15799;4310;14858;339;1461;3300;11431;3639;12892
231220;201310;13966;40849;11925;37368;1334;4905;7775;24380;9109;29285
231230;201310;9610;34636;9062;33572;1290;5271;6404;23821;7694;29092
231240;201310;11586;37668;10601;35922;1480;5682;7114;24307;8594;29989
231250;201310;2069;6109;1431;4539;297;982;585;1758;882;2740
231260;201310;4043;11616;3676;11098;502;1615;2547;7844;3049;9459
231270;201310;7506;21981;6912;21047;736;2880;5015;14855;5751;17735
231280;201310;1718;5815;1623;5613;171;622;1196;4174;1367;4796
231290;201310;32557;118432;30102;112230;8010;32864;12781;46695;20791;79559
231300;201310;4503;13567;3761;12009;382;1506;2671;8221;3053;9727
231310;201310;7277;21782;6308;19774;1382;4541;3333;10390;4715;14931
231320;201310;6984;21980;6200;20461;449;1777;4730;15539;5179;17316
231325;201310;2538;7984;2284;7511;213;803;1670;5492;1883;6295
231330;201310;14034;44333;11913;40207;2038;7081;7397;25241;9435;32322
231335;201310;5045;14849;4483;13828;350;1386;3576;10778;3926;12164
231340;201310;17645;58877;16643;57419;1592;5290;13378;47447;14970;52737
231350;201310;12145;42049;11932;41708;1441;4865;9615;34391;11056;39256
231355;201310;4314;14144;4172;13907;250;831;3606;12198;3856;13029
231360;201310;6841;23332;6452;22716;1634;5661;3807;13975;5441;19636
231370;201310;2337;6874;1920;6258;138;542;1447;4638;1585;5180
231375;201310;4032;14143;3839;13769;439;1938;2940;10347;3379;12285
231380;201310;5258;17288;4943;16841;841;3087;3401;11804;4242;14891
231390;201310;3321;10746;3166;10527;275;1144;2483;8162;2758;9306
231395;201310;4181;13748;3768;13085;783;2850;2282;8130;3065;10980
231400;201310;10266;31370;9377;29767;1051;3896;6603;20949;7654;24845
231410;201310;14645;49255;13297;47346;1584;5653;9728;35837;11312;41490
240010;201310;2387;7622;2164;7116;579;2150;954;3005;1533;5155
240020;201310;11725;37474;10520;35153;2913;10518;4759;16135;7672;26653
240030;201310;2733;8213;2634;8058;296;1136;1990;5911;2286;7047
240040;201310;792;2410;682;2190;51;241;495;1500;546;1741
240050;201310;3544;10034;3172;9396;246;903;2403;6971;2649;7874
240060;201310;1423;4304;1355;4187;131;500;1025;3053;1156;3553
240070;201310;2768;8080;2650;7848;426;1358;1739;5076;2165;6434
240080;201310;3008;8234;2784;7899;272;756;2216;6388;2488;7144
240090;201310;2180;6143;1882;5556;77;320;1485;4286;1562;4606
240100;201310;10065;29732;9426;28442;1289;4660;5895;17615;7184;22275
240110;201310;5260;16198;4728;15248;964;3552;2787;8617;3751;12169
240120;201310;2971;9999;2883;9833;615;2265;1782;6204;2397;8469
240130;201310;2754;7728;2387;7149;218;806;1835;5401;2053;6207
240140;201310;2256;7140;2061;6785;475;1772;1074;3474;1549;5246
240145;201310;6144;19430;5569;18377;1577;5802;2827;9260;4404;15062
240150;201310;1018;3158;838;2797;133;547;490;1564;623;2111
240160;201310;1447;4823;1319;4596;160;636;913;3201;1073;3837
240165;201310;884;2924;800;2762;113;425;524;1830;637;2255
240170;201310;2537;7794;2303;7354;612;2099;1124;3631;1736;5730
240180;201310;2929;9382;2750;9078;713;2471;1469;5034;2182;7505
240185;201310;1490;5019;1442;4941;184;660;1064;3676;1248;4336
240190;201310;928;2869;881;2774;112;451;620;1890;732;2341
240200;201310;13795;36834;11786;34311;2360;7023;7360;22229;9720;29252
240210;201310;2696;7841;2507;7591;237;849;2060;6153;2297;7002
240220;201310;7360;23868;7098;23514;383;1613;6305;20686;6688;22299
240230;201310;5350;15617;4998;14984;476;1690;3849;11347;4325;13037
240240;201310;1771;5629;1370;4556;399;1454;314;933;713;2387
240250;201310;2847;8289;2678;8029;211;782;2153;6307;2364;7089
240260;201310;14679;50186;14023;49075;2449;9787;9223;32139;11672;41926
240270;201310;2336;7824;2226;7638;263;915;1646;5761;1909;6676
240280;201310;1613;4686;1446;4378;139;511;1041;3100;1180;3611
240290;201310;1413;4514;1207;4128;110;527;774;2524;884;3051
240300;201310;2052;5726;1679;5070;369;1235;825;2417;1194;3652
240310;201310;10240;29627;9377;28234;2320;7647;4847;14460;7167;22107
240320;201310;2042;6178;1675;5411;121;529;1180;3634;1301;4163
240325;201310;36269;102999;29132;90869;9077;30974;9685;30520;18762;61494
240330;201310;1525;4655;1295;4190;172;687;781;2409;953;3096
240340;201310;1586;4862;1427;4642;282;996;907;2938;1189;3934
240350;201310;2046;6394;1953;6234;280;1082;1505;4659;1785;5741
240360;201310;7264;22306;6401;20992;1039;3680;4278;14384;5317;18064
240370;201310;1953;5464;1743;5129;132;474;1310;3842;1442;4316
240375;201310;885;2362;796;2238;146;478;463;1245;609;1723
240380;201310;2651;8037;2241;7162;345;1133;1318;4205;1663;5338
240390;201310;894;2606;749;2317;81;309;495;1511;576;1820
240400;201310;1429;3903;1255;3659;134;498;952;2699;1086;3197
240410;201310;535;1739;485;1629;69;279;323;1065;392;1344
240420;201310;4831;18552;4665;18176;1330;5260;2489;10222;3819;15482
240430;201310;3436;10067;3183;9619;376;1305;2274;6779;2650;8084
240440;201310;2627;7238;2468;6930;635;1799;1326;3770;1961;5569
240450;201310;3783;11571;3471;10987;549;2098;2119;6613;2668;8711
240460;201310;2801;9292;2724;9161;303;1211;2105;7023;2408;8234
240470;201310;3835;11716;3242;10522;566;2025;1826;5937;2392;7962
240480;201310;369;973;349;940;44;111;237;655;281;766
240485;201310;2113;6446;1874;5982;361;1283;1084;3450;1445;4733
240490;201310;1650;4276;1460;4013;85;325;1148;3038;1233;3363
240500;201310;2048;6325;1967;6190;189;677;1532;4815;1721;5492
240510;201310;1777;5513;1659;5288;252;872;1177;3760;1429;4632
240520;201310;1420;4209;1256;3972;234;838;831;2569;1065;3407
240530;201310;2164;7033;1961;6709;278;1043;1370;4672;1648;5715
240540;201310;1848;5664;1760;5515;178;633;1319;4079;1497;4712
240550;201310;761;2218;699;2114;54;208;537;1582;591;1790
240560;201310;3187;9466;3046;9243;275;935;2496;7537;2771;8472
240570;201310;3096;8947;2557;7747;600;2063;1134;3141;1734;5204
240580;201310;8020;25307;7607;24615;1331;4578;5436;17523;6767;22101
240590;201310;843;2428;753;2270;56;220;552;1625;608;1845
240600;201310;1472;4490;1215;3944;202;756;679;2097;881;2853
240610;201310;4989;14107;4425;13089;478;1600;3100;9025;3578;10625
240615;201310;1030;3000;877;2718;144;472;517;1597;661;2069
240620;201310;1582;5371;1495;5206;289;1091;1041;3634;1330;4725
240630;201310;2014;6317;1923;6157;175;539;1491;4946;1666;5485
240640;201310;906;2731;774;2521;93;408;517;1612;610;2020
240650;201310;3669;11533;3426;11198;315;1186;2766;9008;3081;10194
240660;201310;2497;8115;2396;7954;280;991;1808;6092;2088;7083
240670;201310;2742;8293;2365;7518;363;1339;1382;4285;1745;5624
240680;201310;1488;4425;1205;3892;159;529;731;2395;890;2924
240690;201310;1076;3098;950;2888;104;373;685;2070;789;2443
240700;201310;2622;8019;2207;7206;150;671;1695;5368;1845;6039
240710;201310;18428;46905;16382;44323;3037;8378;10235;28518;13272;36896
240720;201310;5475;16169;5238;15797;1323;4401;3013;9026;4336;13427
240725;201310;1074;3231;829;2676;77;263;474;1495;551;1758
240730;201310;2253;7096;2038;6684;207;771;1420;4588;1627;5359
240740;201310;2263;6860;2037;6447;267;922;1347;4256;1614;5178
240750;201310;2205;8293;2038;7984;472;1974;1133;4505;1605;6479
240760;201310;1182;3669;1129;3589;111;317;904;2986;1015;3303
240770;201310;3479;10372;3208;9957;432;1506;2245;6950;2677;8456
240780;201310;5734;16737;4805;15201;916;3087;2674;8671;3590;11758
240790;201310;841;2692;705;2448;58;229;538;1869;596;2098
240800;201310;38981;115621;36214;110673;10615;34705;15586;48286;26201;82991
240810;201310;92757;284247;87674;274665;29284;95502;39274;125110;68558;220612
240820;201310;6764;20475;5895;19075;1041;3766;3361;11186;4402;14952
240830;201310;9257;28728;8796;28051;815;2726;7139;23154;7954;25880
240840;201310;1281;3627;1114;3337;107;389;719;2128;826;2517
240850;201310;1137;3562;894;3052;174;677;463;1492;637;2169
240860;201310;1289;3724;1113;3440;90;326;816;2486;906;2812
240870;201310;1131;3227;983;2941;129;482;655;1842;784;2324
240880;201310;1163;4031;1105;3944;153;686;781;2731;934;3417
240890;201310;5484;15576;4854;14501;807;2743;2802;8289;3609;11032
240895;201310;2763;9524;2535;9121;389;1495;1747;6370;2136;7865
240910;201310;2524;8324;2379;8048;260;1062;1784;5985;2044;7047
240920;201310;852;2793;783;2627;199;754;408;1328;607;2082
240930;201310;3556;9811;3254;9400;309;956;2577;7508;2886;8464
240933;201310;1430;4392;1301;4178;295;1037;692;2268;987;3305
240940;201310;6482;18631;5548;17029;1174;3788;2961;9098;4135;12886
240950;201310;1137;3627;1070;3516;100;420;786;2583;886;3003
240960;201310;764;2469;697;2331;81;325;511;1682;592;2007
240970;201310;2015;5777;1708;5223;160;589;1203;3638;1363;4227
240980;201310;3324;11065;3105;10644;731;2742;1820;6210;2551;8952
240990;201310;3041;9236;2862;8868;597;2083;1773;5357;2370;7440
241000;201310;1058;3037;932;2811;98;367;687;2021;785;2388
241010;201310;2938;9986;2669;9494;451;1838;1745;6081;2196;7919
241020;201310;2071;5969;1729;5310;183;680;1080;3152;1263;3832
241025;201310;1501;4705;1397;4516;132;555;981;3114;1113;3669
241030;201310;2532;8449;2339;8111;162;600;1897;6646;2059;7246
241040;201310;2114;7461;1939;7116;219;949;1440;5276;1659;6225
241050;201310;1276;3888;1165;3687;106;433;876;2676;982;3109
241060;201310;996;2894;913;2755;125;391;680;2070;805;2461
241070;201310;909;2677;786;2444;101;379;546;1639;647;2018
241080;201310;1161;3535;1041;3318;88;363;722;2223;810;2586
241090;201310;2136;6205;1869;5743;129;551;1511;4564;1640;5115
241100;201310;1186;3605;1064;3325;109;392;742;2272;851;2664
241105;201310;1132;3477;1070;3368;175;603;690;2219;865;2822
241110;201310;838;2726;715;2465;119;486;396;1329;515;1815
241120;201310;7997;24308;7308;23205;1520;4946;4751;15463;6271;20409
241140;201310;3295;9591;2977;8959;433;1410;1969;5844;2402;7254
241142;201310;695;2088;498;1645;152;578;138;405;290;983
241150;201310;5685;17393;5269;16686;904;2995;3486;11132;4390;14127
241160;201310;1101;3235;1039;3117;166;553;701;2094;867;2647
241170;201310;1334;3984;1218;3767;161;569;750;2400;911;2969
241180;201310;1010;2763;811;2409;115;393;466;1328;581;1721
241190;201310;1037;2907;943;2747;92;361;642;1749;734;2110
241200;201310;20187;62004;18813;59770;5024;17225;9705;31269;14729;48494
241210;201310;1468;4444;1264;4029;268;964;649;2038;917;3002
241220;201310;7911;27154;7567;26483;1829;6831;4184;14970;6013;21801
241230;201310;2970;9311;2723;8937;244;971;2171;7087;2415;8058
241240;201310;1135;3296;868;2733;85;272;519;1674;604;1946
241250;201310;5504;17787;4915;16626;380;1762;3953;13057;4333;14819
241255;201310;1869;7180;1783;6993;461;1877;865;3550;1326;5427
241260;201310;4813;13395;3932;11980;352;1308;2778;8305;3130;9613
241270;201310;2030;6199;1790;5726;265;987;1073;3451;1338;4438
241280;201310;2133;6290;1983;5990;398;1252;1222;3754;1620;5006
241290;201310;3256;9120;2657;8176;504;1678;1550;4758;2054;6436
241300;201310;1363;4017;1247;3838;77;276;992;3062;1069;3338
241310;201310;1500;4862;1441;4764;217;717;1043;3550;1260;4267
241320;201310;868;2945;816;2844;165;636;448;1578;613;2214
241330;201310;1519;4863;1431;4740;163;642;1146;3747;1309;4389
241335;201310;2519;7981;2434;7827;213;669;2021;6560;2234;7229
241340;201310;1927;6066;1749;5690;464;1676;847;2676;1311;4352
241350;201310;1927;6214;1814;5986;172;723;1381;4435;1553;5158
241355;201310;1256;3545;1119;3304;74;248;957;2787;1031;3035
241360;201310;2085;5857;1875;5452;150;565;1367;3796;1517;4361
241370;201310;1325;4146;1083;3621;198;755;606;2000;804;2755
241380;201310;718;2105;626;1922;92;347;348;1042;440;1389
241390;201310;2857;9740;2708;9452;684;2476;1562;5613;2246;8089
241400;201310;3782;11366;3588;11086;492;1762;2633;8107;3125;9869
241410;201310;2606;7913;2416;7637;450;1572;1635;5112;2085;6684
241415;201310;1559;4937;1440;4699;149;573;1034;3331;1183;3904
241420;201310;2123;7493;1915;7177;597;2501;866;3251;1463;5752
241430;201310;426;1324;407;1270;54;188;273;810;327;998
241440;201310;6613;23809;6234;23142;1150;4471;4287;16123;5437;20594
241445;201310;1006;3193;957;3122;167;484;707;2444;874;2928
241450;201310;3206;9202;2983;8880;484;1637;2113;6203;2597;7840
241460;201310;3515;10399;3130;9639;287;1095;2275;6866;2562;7961
241470;201310;1339;3856;1170;3643;138;552;865;2603;1003;3155
241475;201310;1229;3890;1064;3564;70;327;775;2509;845;2836
241480;201310;3209;10574;2943;10166;1003;3591;1111;4182;2114;7773
241490;201310;631;1726;517;1548;58;236;353;995;411;1231
241500;201310;756;2410;740;2388;19;73;695;2240;714;2313
250010;201310;2639;8520;2352;8026;250;1060;1696;5642;1946;6702
250020;201310;1668;4870;1306;4193;120;509;899;2791;1019;3300
250030;201310;7705;22516;6985;21497;892;2855;5190;16342;6082;19197
250040;201310;4416;15158;4102;14554;781;2965;2617;9353;3398;12318
250050;201310;3552;11500;3289;11122;553;2079;2220;7540;2773;9619
250053;201310;1251;3885;1203;3820;182;645;828;2613;1010;3258
250057;201310;735;2618;715;2592;59;195;596;2252;655;2447
250060;201310;4777;15505;4611;15229;644;2473;3462;11190;4106;13663
250070;201310;4165;13111;3929;12689;448;1839;3036;9481;3484;11320
250073;201310;769;2357;698;2222;85;310;480;1520;565;1830
250077;201310;2217;6594;1855;5984;287;1006;1046;3408;1333;4414
250080;201310;4714;13895;4547;13650;601;1928;3338;10028;3939;11956
250090;201310;2584;7908;2511;7796;158;616;2112;6412;2270;7028
250100;201310;3906;13453;3742;13153;446;1770;2862;10026;3308;11796
250110;201310;5683;17590;5430;17222;875;3059;3968;12524;4843;15583
250115;201310;557;1853;487;1687;59;277;301;979;360;1256
250120;201310;2218;6615;1924;6064;190;716;1396;4330;1586;5046
250130;201310;5444;17112;5116;16627;332;1216;4221;13843;4553;15059
250135;201310;1072;3304;982;3145;125;424;682;2218;807;2642
250140;201310;2021;6674;1867;6475;251;870;1402;4985;1653;5855
250150;201310;5041;17215;4679;16562;531;2167;3474;12240;4005;14407
250153;201310;1572;4166;1406;3916;132;457;1099;3020;1231;3477
250157;201310;1599;5654;1465;5362;368;1363;797;3025;1165;4388
250160;201310;3278;10352;3142;10135;224;833;2691;8668;2915;9501
250170;201310;1584;4709;1489;4552;326;1057;913;2838;1239;3895
250180;201310;16250;51934;15792;51094;2793;10365;10627;33507;13420;43872
250190;201310;4305;12845;4009;12329;726;2427;2464;7519;3190;9946
250200;201310;2201;6151;1774;5585;140;520;1482;4623;1622;5143
250205;201310;1001;3359;873;3130;88;417;613;2175;701;2592
250210;201310;1622;5398;1500;5214;195;846;1068;3612;1263;4458
250215;201310;1405;4882;1363;4799;204;832;865;3027;1069;3859
250220;201310;810;2306;679;2148;45;163;582;1827;627;1990
250230;201310;1684;4342;1381;3842;186;591;1024;2763;1210;3354
250240;201310;2618;8550;2331;8113;252;935;1739;6128;1991;7063
250250;201310;4410;13708;4075;13233;447;1558;3204;10478;3651;12036
250260;201310;1895;5913;1680;5555;138;530;1283;4239;1421;4769
250270;201310;1253;4057;1164;3946;160;573;877;2995;1037;3568
250280;201310;3778;11445;3488;10977;752;2443;2150;7027;2902;9470
250290;201310;2138;5708;1770;5223;58;219;1553;4572;1611;4791
250300;201310;5431;16174;5132;15789;635;2552;4010;11835;4645;14387
250310;201310;1140;3740;1042;3579;169;684;743;2516;912;3200
250320;201310;7745;24729;7358;23872;1240;4570;4728;14899;5968;19469
250330;201310;2503;7997;2191;7551;260;1061;1652;5602;1912;6663
250340;201310;1128;3337;1081;3276;70;251;890;2712;960;2963
250350;201310;4525;12460;4142;11982;202;678;3588;10494;3790;11172
250355;201310;2110;6523;1925;6235;134;560;1527;4911;1661;5471
250360;201310;2030;6086;1888;5876;123;464;1472;4592;1595;5056
250370;201310;13623;38588;11943;36559;802;2525;10406;32130;11208;34655
250375;201310;1080;3449;1025;3356;67;280;853;2781;920;3061
250380;201310;1632;4675;1557;4581;103;368;1349;3937;1452;4305
250390;201310;1959;5325;1627;4761;216;703;1095;3193;1311;3896
250400;201310;63730;183193;58223;175180;14516;46198;32232;99022;46748;145220
250403;201310;1475;4964;1438;4911;159;631;1157;3913;1316;4544
250407;201310;1087;3255;959;3028;76;249;751;2348;827;2597
250410;201310;654;2144;571;1993;70;303;425;1463;495;1766
250415;201310;1818;5813;1663;5479;100;445;1272;4086;1372;4531
250420;201310;1299;4124;1210;3975;103;420;998;3202;1101;3622
250430;201310;6515;18434;6179;17943;506;1814;5072;14409;5578;16223
250435;201310;1616;4971;1445;4642;185;698;890;2917;1075;3615
250440;201310;4482;13631;4305;13381;275;1022;3674;11378;3949;12400
250450;201310;2057;5880;1843;5590;93;347;1636;4937;1729;5284
250460;201310;6118;18930;5721;18370;824;2844;4205;13639;5029;16483
250470;201310;1582;4403;1439;4198;137;490;1061;3032;1198;3522
250480;201310;3925;11891;3540;11322;173;699;3078;9768;3251;10467
250485;201310;608;1640;512;1467;30;116;405;1111;435;1227
250490;201310;4094;13435;3984;13260;689;2494;2789;9300;3478;11794
250500;201310;1908;5913;1767;5672;352;1178;1077;3510;1429;4688
250510;201310;4926;13907;4335;13081;324;1197;3553;10597;3877;11794
250520;201310;1869;5867;1770;5694;359;1352;1030;3205;1389;4557
250523;201310;1773;5728;1692;5620;219;793;1311;4396;1530;5189
250527;201310;1445;4449;1356;4324;62;280;1206;3785;1268;4065
250530;201310;669;2097;593;1997;53;211;481;1616;534;1827
250535;201310;1247;4084;1199;3986;98;402;956;3108;1054;3510
250540;201310;2462;7283;2305;7103;91;311;2106;6507;2197;6818
250550;201310;909;3045;840;2934;74;319;634;2173;708;2492
250560;201310;1718;5626;1680;5568;132;490;1430;4748;1562;5238
250570;201310;2510;8361;2287;7933;212;869;1725;5905;1937;6774
250580;201310;1100;3153;911;2828;137;543;606;1792;743;2335
250590;201310;1040;3211;936;3065;86;368;733;2342;819;2710
250600;201310;7712;22568;7329;21968;827;2490;5675;17278;6502;19768
250610;201310;3300;10099;3107;9808;400;1356;2247;7135;2647;8491
250620;201310;860;2541;793;2407;137;452;523;1577;660;2029
250625;201310;2090;6972;2053;6918;74;223;1894;6453;1968;6676
250630;201310;10197;33378;9693;32455;2289;8290;5341;17848;7630;26138
250640;201310;3867;11475;3610;11166;295;1156;3037;9205;3332;10361
250650;201310;894;2702;846;2609;167;622;445;1400;612;2022
250660;201310;2196;5292;1686;4675;28;76;1607;4468;1635;4544
250670;201310;2638;9100;2509;8855;293;1216;1801;6349;2094;7565
250680;201310;4899;14251;4636;13864;291;1062;3942;11709;4233;12771
250690;201310;6255;17235;6062;16965;617;2010;5086;13988;5703;15998
250700;201310;5290;16168;4974;15684;741;2634;3516;10929;4257;13563
250710;201310;4464;14580;4124;14136;624;2249;2935;10295;3559;12544
250720;201310;2606;8099;2484;7883;211;821;1967;6170;2178;6991
250730;201310;3548;11362;3396;11112;477;1772;2439;7916;2916;9688
250740;201310;2017;6110;1767;5658;242;877;1209;3814;1451;4691
250750;201310;100713;303078;95607;295075;19091;65191;61352;186520;80443;251711
250760;201310;2172;6665;2018;6407;253;985;1406;4397;1659;5382
250770;201310;3744;13223;3557;12957;770;2996;2152;7904;2922;10900
250780;201310;1874;5751;1636;5304;177;721;1134;3591;1311;4312
250790;201310;2452;8097;2320;7898;621;2111;1422;4964;2043;7075
250800;201310;2675;7901;2373;7390;182;671;1778;5404;1960;6075
250810;201310;1338;4045;1172;3801;122;506;936;2957;1058;3463
250820;201310;1991;6273;1936;6183;115;440;1616;5205;1731;5645
250830;201310;5839;19551;5565;19008;743;3046;3801;12690;4544;15736
250840;201310;1041;3353;910;3082;121;469;580;1956;701;2425
250850;201310;2371;7017;2067;6510;235;914;1363;4413;1598;5327
250855;201310;1067;3178;1009;3084;67;235;841;2539;908;2774
250860;201310;2860;9855;2646;9421;647;2523;1148;4080;1795;6603
250870;201310;1190;3454;1032;3198;77;297;741;2223;818;2520
250880;201310;1316;3974;1269;3905;121;407;1008;3090;1129;3497
250890;201310;9108;30079;8476;29178;1626;6481;5369;18253;6995;24734
250900;201310;3038;10260;2714;9637;330;1228;1911;6903;2241;8131
250905;201310;2108;6620;2014;6494;347;1176;1456;4717;1803;5893
250910;201310;5289;15728;4944;15192;547;1835;3713;11426;4260;13261
250915;201310;1729;5184;1577;4940;162;501;1276;4072;1438;4573
250920;201310;3580;10243;3378;9956;467;1387;2416;7334;2883;8721
250930;201310;1922;6344;1845;6210;370;1438;1225;4033;1595;5471
250933;201310;1157;3817;1115;3750;168;625;763;2584;931;3209
250937;201310;864;2700;775;2515;117;474;464;1482;581;1956
250939;201310;1709;5429;1555;5163;264;935;988;3304;1252;4239
250940;201310;3937;11699;3649;11243;281;1012;2856;8769;3137;9781
250950;201310;1337;4247;1228;4106;79;283;1015;3432;1094;3715
250960;201310;1350;4254;1198;4051;73;282;1017;3467;1090;3749
250970;201310;8721;24298;7928;23221;1276;3865;5509;16276;6785;20141
250980;201310;2660;8210;2455;7849;278;1125;1691;5201;1969;6326
250990;201310;2092;7368;1978;7134;298;1254;1344;4740;1642;5994
251000;201310;2557;7365;2109;6722;136;523;1695;5377;1831;5900
251010;201310;2835;8277;2583;7925;225;826;2038;6244;2263;7070
251020;201310;1660;5219;1542;5071;165;596;1255;4165;1420;4761
251030;201310;1312;3745;1195;3549;131;467;771;2281;902;2748
251040;201310;1938;6282;1747;5980;192;904;1244;4078;1436;4982
251050;201310;1124;3375;986;3121;162;556;542;1781;704;2337
251060;201310;1030;2586;845;2352;94;341;639;1686;733;2027
251065;201310;578;1747;507;1635;74;273;308;958;382;1231
251070;201310;590;1724;564;1683;51;213;443;1241;494;1454
251080;201310;21182;59595;19962;57581;5335;16386;11097;32361;16432;48747
251090;201310;3028;9686;2741;9162;325;1250;1948;6441;2273;7691
251100;201310;973;3244;861;3037;130;522;563;1932;693;2454
251110;201310;2102;6151;1903;5835;226;770;1321;4059;1547;4829
251120;201310;5892;20327;5724;20035;824;3400;4427;15167;5251;18567
251130;201310;3893;10222;3516;9793;82;281;3339;9260;3421;9541
251140;201310;4345;13616;4056;13150;273;1106;3158;10186;3431;11292
251150;201310;2815;9230;2599;8934;339;1357;1912;6614;2251;7971
251160;201310;1862;6214;1791;6120;99;396;1576;5390;1675;5786
251170;201310;1427;4481;1387;4432;129;488;1144;3602;1273;4090
251180;201310;2907;8811;2674;8509;628;2108;1546;5002;2174;7110
251190;201310;4249;12457;4129;12305;302;955;3610;10798;3912;11753
251200;201310;4193;12984;3997;12722;260;946;3449;10997;3709;11943
251203;201310;1318;4226;1197;3976;119;502;736;2514;855;3016
251207;201310;1228;3912;1062;3582;92;393;747;2469;839;2862
251210;201310;7964;23138;7054;21871;1080;3360;5014;15883;6094;19243
251220;201310;1285;3530;1154;3324;177;557;730;2157;907;2714
251230;201310;5149;15840;4543;15118;468;1755;3798;12565;4266;14320
251240;201310;3114;10385;3037;10257;325;1333;2385;7930;2710;9263
251250;201310;10212;31486;9589;30481;1692;5819;6549;20697;8241;26516
251260;201310;541;1696;488;1622;40;148;369;1235;409;1383
251270;201310;4133;12898;3904;12594;158;639;3549;11415;3707;12054
251272;201310;1368;4255;1279;4121;121;407;1009;3310;1130;3717
251274;201310;982;3160;930;3056;133;555;525;1758;658;2313
251275;201310;1363;3926;1287;3804;146;549;964;2752;1110;3301
251276;201310;1488;4484;1406;4327;234;777;841;2679;1075;3456
251278;201310;608;1972;528;1777;91;337;295;1044;386;1381
251280;201310;2277;7376;2203;7242;315;1157;1597;5256;1912;6413
251290;201310;5997;17482;5699;17097;877;3090;4084;11926;4961;15016
251300;201310;773;2664;716;2579;74;351;506;1769;580;2120
251310;201310;3163;9493;2904;9108;220;851;2349;7268;2569;8119
251315;201310;1643;5976;1602;5889;317;1269;978;3625;1295;4894
251320;201310;2118;6043;1762;5461;141;524;1284;4024;1425;4548
251330;201310;2039;5336;1697;4890;129;540;1402;3857;1531;4397
251335;201310;975;3411;943;3348;124;475;709;2520;833;2995
251340;201310;3897;10964;3324;10110;359;1385;2360;6989;2719;8374
251350;201310;1624;5074;1472;4850;260;958;956;3159;1216;4117
251360;201310;1822;6020;1734;5917;125;512;1461;4998;1586;5510
251365;201310;901;2684;725;2304;70;279;478;1477;548;1756
251370;201310;21559;75006;21183;74354;4381;16894;14257;49411;18638;66305
251380;201310;1359;4260;1202;3996;107;473;918;2953;1025;3426
251385;201310;863;2453;789;2326;80;304;539;1532;619;1836
251390;201310;5717;20631;5429;20181;1032;4171;3655;13519;4687;17690
251392;201310;1048;3131;974;3007;126;410;676;2121;802;2531
251394;201310;609;1909;514;1719;42;169;362;1201;404;1370
251396;201310;862;2515;798;2404;68;234;629;1864;697;2098
251398;201310;1130;3306;941;2949;93;359;639;1968;732;2327
251400;201310;1361;3970;1260;3837;165;636;886;2613;1051;3249
251410;201310;1607;4288;1459;4042;176;556;990;2785;1166;3341
251420;201310;2189;6382;1874;6022;193;740;1410;4465;1603;5205
251430;201310;1697;6163;1543;5914;124;554;1267;4864;1391;5418
251440;201310;1456;4491;1259;4118;176;664;881;2847;1057;3511
251445;201310;1546;4894;1475;4784;132;519;1217;3893;1349;4412
251450;201310;4787;15143;4300;14522;172;715;3769;12743;3941;13458
251455;201310;1206;3784;1043;3516;95;400;763;2534;858;2934
251460;201310;880;2801;850;2740;155;519;623;2035;778;2554
251465;201310;500;1602;455;1510;53;217;295;950;348;1167
251470;201310;1294;3768;1070;3349;146;560;624;1947;770;2507
251480;201310;1127;3106;1021;2927;64;244;819;2300;883;2544
251490;201310;2078;6217;1810;5844;312;1180;1161;3675;1473;4855
251500;201310;1726;5811;1677;5733;221;867;1254;4234;1475;5101
251510;201310;2544;8653;2372;8269;459;1731;1392;4896;1851;6627
251520;201310;1078;3017;985;2871;131;401;569;1670;700;2071
251530;201310;11682;35054;11229;34387;889;3430;9425;28352;10314;31782
251540;201310;2808;9415;2637;9041;309;1308;1899;6456;2208;7764
251550;201310;3932;9858;3327;9078;204;711;2715;7177;2919;7888
251560;201310;916;2767;834;2634;174;663;446;1304;620;1967
251570;201310;1032;3109;897;2840;115;442;552;1771;667;2213
251580;201310;2189;6066;2030;5848;335;913;1493;4404;1828;5317
251590;201310;1690;5645;1657;5607;112;396;1450;4964;1562;5360
251593;201310;1000;3229;954;3151;145;555;624;1996;769;2551
251597;201310;1958;6099;1886;5978;217;806;1456;4536;1673;5342
251600;201310;7219;21697;6898;21176;993;3164;4973;15623;5966;18787
251610;201310;3575;10917;3285;10528;382;1318;2467;7999;2849;9317
251615;201310;1210;3573;1050;3279;80;238;771;2530;851;2768
251620;201310;17028;49378;15200;47006;2451;8013;10690;33498;13141;41511
251630;201310;5355;13716;4705;12930;397;1169;3752;10396;4149;11565
251640;201310;2653;7844;2174;6977;276;1040;1469;4674;1745;5714
251650;201310;4348;12473;3922;11929;339;1181;3187;9804;3526;10985
251660;201310;3565;12067;3275;11612;275;1295;2642;9140;2917;10435
251670;201310;3945;11602;3544;11007;197;684;3006;9305;3203;9989
251675;201310;746;2534;713;2478;163;630;398;1339;561;1969
251680;201310;2861;8028;2332;7236;149;634;1900;5764;2049;6398
251690;201310;3366;10767;3139;10351;436;1584;2119;6968;2555;8552
251700;201310;2064;6937;1965;6801;233;904;1534;5275;1767;6179
251710;201310;936;2500;712;2098;100;371;382;1048;482;1419
251720;201310;1355;4257;1272;4131;119;469;990;3193;1109;3662
251740;201310;741;2091;601;1840;115;391;333;1032;448;1423
260005;201310;24532;61285;21960;57898;4695;12807;13709;36370;18404;49177
260010;201310;9513;26289;7769;24119;743;2547;6125;19003;6868;21550
260020;201310;5761;17294;5141;16319;658;2049;3705;12258;4363;14307
260030;201310;5349;16269;4970;15706;548;1924;3825;12036;4373;13960
260040;201310;10193;24668;8460;22700;619;1478;7000;19407;7619;20885
260050;201310;10713;35366;10080;34649;682;2535;8800;30531;9482;33066
260060;201310;4067;11448;3790;11028;322;1000;3083;9087;3405;10087
260070;201310;9257;28637;8854;28051;2320;7897;5227;16631;7547;24528
260080;201310;5340;15727;4782;14888;600;2136;3339;10289;3939;12425
260090;201310;5188;14237;4929;13888;915;2403;3532;10350;4447;12753
260100;201310;3476;9386;3196;9007;246;911;2570;7244;2816;8155
260105;201310;4355;13406;4214;13143;829;2722;2736;8524;3565;11246
260110;201310;21260;64382;19816;62630;1638;5147;16772;53695;18410;58842
260120;201310;11398;35797;11053;35186;3200;10517;5597;18529;8797;29046
260130;201310;3082;8953;2938;8718;430;1254;2114;6419;2544;7673
260140;201310;13061;34588;11253;32341;1300;4248;8472;24569;9772;28817
260150;201310;3024;9081;2717;8615;259;951;2080;6671;2339;7622
260160;201310;5931;18105;5385;17456;497;1719;4400;14536;4897;16255
260170;201310;17316;48638;16658;47744;1468;3949;13767;40222;15235;44171
260180;201310;3420;10736;3136;10303;208;848;2623;8548;2831;9396
260190;201310;15787;38398;14998;37393;1100;3007;12756;31708;13856;34715
260200;201310;11035;32836;9808;30988;1305;4176;7099;23054;8404;27230
260210;201310;11261;35778;10467;34612;820;3051;8637;28886;9457;31937
260220;201310;8944;28752;8748;28460;779;3175;7399;23614;8178;26789
260230;201310;9666;29057;9278;28527;697;2260;7685;24019;8382;26279
260240;201310;2835;9184;2549;8757;390;1464;1757;6047;2147;7511
260250;201310;2762;7494;2540;7212;185;509;2145;6179;2330;6688
260260;201310;11247;33546;11057;33306;961;3204;9233;28357;10194;31561
260270;201310;3497;10812;3302;10518;412;1578;2572;8041;2984;9619
260280;201310;12379;42156;11455;40678;812;3300;9515;34098;10327;37398
260290;201310;33162;102146;32160;100527;5901;21060;22035;67302;27936;88362
260300;201310;8429;25985;7579;24767;766;2899;5836;19179;6602;22078
260310;201310;5084;15517;4775;15024;1492;4422;2386;8105;3878;12527
260320;201310;6652;22916;6234;22300;566;2194;4990;18064;5556;20258
260330;201310;3090;9723;2832;9280;283;1115;1907;6450;2190;7565
260340;201310;1852;5598;1771;5487;112;420;1551;4765;1663;5185
260345;201310;25559;85691;24624;83775;7717;28582;11332;37242;19049;65824
260350;201310;4377;13025;4199;12747;529;1819;3056;9245;3585;11064
260360;201310;2348;7486;2259;7341;590;2036;1204;4025;1794;6061
260370;201310;6003;18852;5539;18028;831;2793;3889;12952;4720;15745
260380;201310;4916;16377;4601;15972;436;1435;3777;13406;4213;14841
260390;201310;4733;14998;4135;14050;502;1965;2993;9991;3495;11956
260392;201310;3346;10891;3178;10658;185;731;2784;9312;2969;10043
260400;201310;13511;40708;13043;39952;2700;9206;8563;25728;11263;34934
260410;201310;61709;185069;58776;180109;19766;61181;27535;87408;47301;148589
260415;201310;4023;13341;3596;12544;586;2399;2229;7733;2815;10132
260420;201310;11678;27534;10698;26487;818;2320;8896;21938;9714;24258
260430;201310;2699;9181;2478;8823;260;1079;1879;6614;2139;7693
260440;201310;3396;10640;3174;10198;566;2046;1927;6098;2493;8144
260450;201310;4949;15558;4707;15137;470;1675;3632;11712;4102;13387
260460;201310;5901;18393;5612;17963;913;3314;3808;11998;4721;15312
260470;201310;4965;14780;4687;14392;490;1637;3668;11458;4158;13095
260480;201310;3823;11361;3470;10826;676;2266;2302;7157;2978;9423
260490;201310;6045;16049;5338;14932;733;2442;3544;9888;4277;12330
260500;201310;6733;18851;6286;18204;702;2153;4693;13837;5395;15990
260510;201310;10180;27582;9463;26585;896;2750;7342;21198;8238;23948
260515;201310;4743;15124;3911;13411;548;2088;2296;8015;2844;10103
260520;201310;15744;43020;15340;42495;3366;8706;10365;29968;13731;38674
260530;201310;10206;30611;9028;29036;520;1587;7860;25779;8380;27366
260540;201310;5752;15100;5493;14812;703;1650;4337;12088;5040;13738
260545;201310;42;162;28;115;4;19;6;23;10;42
260550;201310;2784;9548;2507;9028;692;2775;1176;4183;1868;6958
260560;201310;6698;17492;6070;16600;363;1002;5300;14534;5663;15536
260570;201310;6211;22006;5837;21326;1066;4323;3923;14373;4989;18696
260580;201310;3902;10941;3718;10669;330;1076;3088;8717;3418;9793
260590;201310;5782;15340;5580;15095;295;757;5020;13768;5315;14525
260600;201310;25454;80743;24211;78575;4876;16876;15044;49438;19920;66314
260610;201310;7049;21248;6731;20811;1321;4296;4644;14453;5965;18749
260620;201310;17144;53992;16552;52984;3200;11566;10856;33883;14056;45449
260630;201310;2270;6921;1980;6450;244;943;1446;4667;1690;5610
260640;201310;17169;47774;16389;46637;2262;7010;12124;34351;14386;41361
260650;201310;5543;17735;5294;17329;795;2613;3504;12201;4299;14814
260660;201310;8081;23451;7321;22445;698;2257;5895;18295;6593;20552
260670;201310;2389;6913;2036;6422;288;1038;1346;4264;1634;5302
260680;201310;22905;63095;21744;61187;4900;14788;12590;35036;17490;49824
260690;201310;3493;9852;3050;9135;240;880;2411;7143;2651;8023
260700;201310;5367;16197;5300;16127;97;223;5103;15721;5200;15944
260710;201310;1294;4050;1174;3871;150;588;869;2807;1019;3395
260720;201310;17269;57366;16425;55786;4689;16386;8665;30158;13354;46544
260730;201310;7345;24375;6624;23306;888;3263;4904;17506;5792;20769
260740;201310;1356;4178;1188;3866;178;626;730;2414;908;3040
260750;201310;6702;21932;6434;21539;585;1990;5335;18159;5920;20149
260760;201310;4651;13220;4373;12846;552;1729;3259;9629;3811;11358
260765;201310;7777;28425;7522;28029;1577;6508;4825;18057;6402;24565
260770;201310;4247;11182;3895;10707;245;888;3142;8442;3387;9330
260775;201310;5264;15555;5028;15178;606;2191;3645;10697;4251;12888
260780;201310;3946;13215;3805;12968;903;3354;2215;7577;3118;10931
260790;201310;117817;309092;113633;303028;26861;75484;68718;183418;95579;258902
260795;201310;3010;9864;2839;9593;487;1767;1887;6491;2374;8258
260800;201310;4664;12916;4352;12486;251;1017;3737;10419;3988;11436
260805;201310;4070;12118;3698;11519;591;1953;2495;7816;3086;9769
260810;201310;7397;21483;7194;21204;477;1701;6261;18284;6738;19985
260820;201310;4514;13420;4294;13106;1315;4081;2292;7110;3607;11191
260825;201310;3029;9895;2875;9667;297;1011;2334;7946;2631;8957
260830;201310;3615;11990;3383;11582;957;3125;1894;6855;2851;9980
260840;201310;4154;12334;3874;11919;253;955;3332;10187;3585;11142
260845;201310;4138;12524;3852;11952;673;2248;2599;8062;3272;10310
260850;201310;4848;17048;4469;16235;1170;4769;2189;7810;3359;12579
260860;201310;2962;9903;2768;9591;353;1255;2035;7176;2388;8431
260870;201310;4155;11721;3791;11256;596;1662;2713;8315;3309;9977
260875;201310;7300;19622;6649;18615;934;2653;4553;13159;5487;15812
260880;201310;8696;28108;8301;27524;1091;3645;6410;21592;7501;25237
260890;201310;14793;42792;14208;41911;1632;5499;10691;31480;12323;36979
260900;201310;6030;18931;5246;17610;1049;3677;3150;10798;4199;14475
260910;201310;2994;9406;2714;8984;306;1175;2099;6893;2405;8068
260915;201310;4471;15065;4360;14910;111;341;4063;14132;4174;14473
260920;201310;3334;10510;3182;10281;545;1913;2223;7312;2768;9225
260930;201310;4132;13370;3713;12760;550;1915;2653;9299;3203;11214
260940;201310;13616;39621;12552;37732;2501;8869;7061;20621;9562;29490
260950;201310;6246;20450;6012;19996;1038;4310;3866;12038;4904;16348
260960;201310;66886;189391;63461;183869;13909;42960;37168;108456;51077;151416
260970;201310;5298;17450;4952;16898;677;2708;3542;11959;4219;14667
260980;201310;3966;12776;3797;12549;269;1017;3171;10632;3440;11649
260990;201310;17407;56027;16095;54186;2369;7559;11657;41256;14026;48815
261000;201310;14813;43530;12484;39611;2869;9820;6743;21700;9612;31520
261010;201310;2783;7873;2607;7638;245;557;2170;6680;2415;7237
261020;201310;6269;18913;5776;18139;468;1803;4644;14209;5112;16012
261030;201310;3348;11254;3215;11030;345;1299;2548;8686;2893;9985
261040;201310;5288;17472;4610;16401;633;2562;3261;11563;3894;14125
261050;201310;8722;24882;8171;24015;1297;3988;5375;15741;6672;19729
261060;201310;11078;35129;10731;34564;2006;7116;7403;23493;9409;30609
261070;201310;47867;127001;43919;121528;10465;30446;25095;70281;35560;100727
261080;201310;5642;17547;5367;17096;446;1419;4452;14419;4898;15838
261090;201310;15965;45584;15022;44279;1631;5048;11931;35360;13562;40408
261100;201310;7271;23671;6809;22944;609;2470;5396;18078;6005;20548
261110;201310;65948;191233;60511;183352;14858;46068;34218;109346;49076;155414
261120;201310;3538;9764;3270;9417;158;471;2888;8405;3046;8876
261130;201310;6942;18242;6674;17944;289;795;6082;16347;6371;17142
261140;201310;3190;9200;2989;8876;661;2187;1794;5239;2455;7426
261150;201310;5390;16644;4895;15952;559;2098;3730;12197;4289;14295
261153;201310;1943;5653;1663;5264;118;452;1381;4381;1499;4833
261160;201310;222657;588858;213560;576561;44411;122730;135102;374181;179513;496911
261170;201310;5904;16875;5539;16332;849;2588;4113;12200;4962;14788
261180;201310;9228;26641;9011;26360;1058;3108;7155;21244;8213;24352
261190;201310;5295;17070;5062;16752;818;3590;3477;10805;4295;14395
261200;201310;3824;9780;3644;9541;581;1534;2616;6940;3197;8474
261210;201310;1904;5213;1828;5109;150;416;1563;4429;1713;4845
261220;201310;12338;41340;10999;38342;2232;8543;6021;20807;8253;29350
261230;201310;3999;12535;3787;12272;151;505;3465;11281;3616;11786
261240;201310;4818;14522;4578;14074;811;2460;3153;9870;3964;12330
261245;201310;3813;12269;3326;11451;293;1243;2437;8469;2730;9712
261247;201310;3475;11020;3063;10260;452;1606;2076;7023;2528;8629
261250;201310;19020;51814;18464;51034;2928;8344;14246;39477;17174;47821
261255;201310;4314;13521;3898;12841;373;1357;2988;10015;3361;11372
261260;201310;12015;35281;11096;34205;648;1838;9815;30776;10463;32614
261270;201310;3797;11046;3560;10670;512;1680;2495;7466;3007;9146
261280;201310;2715;8544;2472;8177;280;1071;1834;6029;2114;7100
261290;201310;2976;8629;2681;8247;253;896;2162;6696;2415;7592
261300;201310;10117;34940;9237;33349;1621;6490;6061;21883;7682;28373
261310;201310;8309;25714;7947;25081;1847;6166;4757;14992;6604;21158
261320;201310;5904;18697;5578;18073;706;2291;4100;13605;4806;15896
261330;201310;5473;16559;5337;16361;440;1482;4426;13591;4866;15073
261340;201310;4554;15091;4355;14775;698;2705;2906;9909;3604;12614
261350;201310;7859;27151;7471;26441;688;2987;5888;20590;6576;23577
261360;201310;9339;24611;8607;23608;1238;3561;5977;16717;7215;20278
261370;201310;20572;62518;19593;61072;3433;11424;13592;42561;17025;53985
261380;201310;4137;14482;3877;14042;641;2366;2652;9904;3293;12270
261390;201310;16865;52987;15503;50574;2825;10236;9589;30985;12414;41221
261400;201310;4813;17150;4421;16385;652;2711;3000;11190;3652;13901
261410;201310;8009;24425;7674;23896;1042;3386;5630;17851;6672;21237
261420;201310;7852;26759;7606;26388;1991;7556;4370;15384;6361;22940
261430;201310;3571;11192;3055;10502;425;1497;2211;7791;2636;9288
261440;201310;1646;5039;1540;4873;123;497;1246;3894;1369;4391
261450;201310;14004;41179;13625;40666;1103;3506;11840;35342;12943;38848
261460;201310;8426;24536;7895;23791;809;2330;5866;19032;6675;21362
261470;201310;3919;10687;3608;10309;251;812;3073;8747;3324;9559
261480;201310;3378;12576;3175;12209;399;1728;2371;8973;2770;10701
261485;201310;4878;15450;4589;14960;1094;3785;2555;8461;3649;12246
261500;201310;5871;16469;5255;15642;754;2060;3924;12215;4678;14275
261510;201310;2024;6699;1934;6562;146;447;1622;5621;1768;6068
261520;201310;2551;8433;2292;8011;228;924;1620;5641;1848;6565
261530;201310;12405;40790;11105;38262;2547;9735;5400;18537;7947;28272
261540;201310;7229;23382;7024;23036;1847;5789;4424;15135;6271;20924
261550;201310;3396;10506;3281;10330;485;1904;2478;7491;2963;9395
261560;201310;6701;22149;6211;21512;1306;4331;4267;15413;5573;19744
261570;201310;3483;11081;3188;10615;452;1564;2281;7687;2733;9251
261580;201310;5683;18605;5085;17617;447;1741;4051;14278;4498;16019
261590;201310;2819;8052;2493;7592;281;922;1809;5609;2090;6531
261600;201310;5021;14326;4316;13288;541;1764;3156;9834;3697;11598
261610;201310;2267;7009;1999;6628;184;740;1617;5258;1801;5998
261618;201310;2491;7306;2360;7126;284;923;1823;5470;2107;6393
261620;201310;4508;14062;4285;13709;483;1673;3127;10188;3610;11861
261630;201310;8073;24010;7205;22500;1440;5172;4060;12367;5500;17539
261640;201310;32588;85979;30423;83341;2165;6229;25716;71485;27881;77714
261650;201310;3717;12299;3570;12078;488;1837;2734;9258;3222;11095
270010;201310;4420;17125;4069;16392;529;2494;2843;11429;3372;13923
270020;201310;3876;12115;3650;11738;558;2086;2607;8224;3165;10310
270030;201310;44549;135475;42754;132734;11804;37555;24201;77098;36005;114653
270040;201310;10336;32190;9987;31799;1367;3823;7944;26215;9311;30038
270050;201310;3886;11543;3611;11162;438;1654;2696;8153;3134;9807
270060;201310;1559;5385;1503;5301;386;1498;874;3054;1260;4552
270070;201310;4067;12878;3838;12549;156;717;3389;10964;3545;11681
270080;201310;1273;4115;1157;3952;254;975;700;2368;954;3343
270090;201310;2039;6566;1991;6507;65;253;1867;6091;1932;6344
270100;201310;6399;20335;6146;19991;1301;4555;4100;13266;5401;17821
270110;201310;3398;9636;3138;9328;594;1850;1972;6267;2566;8117
270120;201310;3043;8992;2749;8592;164;612;2325;7294;2489;7906
270130;201310;4932;15611;4702;15341;714;2307;3532;11871;4246;14178
270135;201310;1698;4993;1621;4902;79;181;1476;4570;1555;4751
270140;201310;9243;24683;8317;23448;942;3745;6377;16838;7319;20583
270150;201310;2589;9107;2525;9016;246;1015;2110;7480;2356;8495
270160;201310;4807;16714;4449;16227;343;1174;3758;13963;4101;15137
270170;201310;3978;13380;3679;12920;847;3374;2053;7169;2900;10543
270180;201310;2151;7355;1930;7070;199;878;1491;5434;1690;6312
270190;201310;1869;6319;1783;6171;160;627;1393;4863;1553;5490
270200;201310;2698;9154;2550;8919;244;1106;2043;6965;2287;8071
270210;201310;4114;14231;4015;14089;496;2022;3226;11252;3722;13274
270220;201310;1685;5364;1579;5151;304;1168;865;2866;1169;4034
270230;201310;10958;36708;9776;34841;1512;6261;6758;23866;8270;30127
270235;201310;6412;21641;6122;21158;369;1653;5214;17921;5583;19574
270240;201310;9657;29421;8679;28099;1625;5545;5747;18766;7372;24311
270250;201310;3423;9046;3149;8743;158;447;2861;7957;3019;8404
270255;201310;5049;15696;4223;14244;443;1890;2958;9788;3401;11678
270260;201310;6230;20255;6065;19960;915;3544;4367;14346;5282;17890
270270;201310;1216;3559;1130;3423;207;680;753;2227;960;2907
270280;201310;3641;11077;3460;10811;542;1996;2455;7546;2997;9542
270290;201310;8293;29707;7934;29060;882;3623;6183;22634;7065;26257
270300;201310;3275;11402;3112;11205;200;890;2744;9845;2944;10735
270310;201310;7111;22620;6467;21504;459;2068;5187;16837;5646;18905
270320;201310;6178;20643;5969;20257;1733;6572;2872;9876;4605;16448
270330;201310;4791;16036;4548;15702;392;1455;3767;13130;4159;14585
270340;201310;1772;5598;1618;5405;221;784;1201;4088;1422;4872
270350;201310;2082;5919;1929;5719;365;1123;1205;3811;1570;4934
270360;201310;2073;6481;2029;6427;290;882;1597;5217;1887;6099
270370;201310;1695;5668;1562;5429;201;794;1071;3829;1272;4623
270375;201310;2882;9125;2757;8929;451;1812;1930;5970;2381;7782
270380;201310;6137;18727;5880;18379;609;1989;4591;14651;5200;16640
270390;201310;1437;4006;1307;3848;191;672;883;2496;1074;3168
270400;201310;6078;18914;5626;18252;600;2259;4106;13169;4706;15428
270410;201310;4832;15142;4627;14737;601;2089;3344;10629;3945;12718
270420;201310;5337;17770;5192;17556;305;1433;4429;14711;4734;16144
270430;201310;140075;411478;134898;404237;35633;109443;77978;239882;113611;349325
270440;201310;4913;15563;4655;15159;398;1484;3742;12230;4140;13714
270450;201310;6351;20294;6206;20105;669;2541;4915;15887;5584;18428
270460;201310;3497;9894;3177;9443;270;1051;2540;7325;2810;8376
270470;201310;10679;35021;10258;34262;1378;4425;7541;26149;8919;30574
270480;201310;3086;9972;2875;9589;371;1512;1932;6212;2303;7724
270490;201310;981;3165;926;3079;99;407;690;2238;789;2645
270500;201310;5373;18801;5197;18540;501;1804;4215;15451;4716;17255
270510;201310;5985;18898;5516;18241;969;4084;3932;12341;4901;16425
270520;201310;3642;12052;3442;11712;1049;3802;1670;5767;2719;9569
270530;201310;1529;4605;1357;4378;225;705;915;3086;1140;3791
270540;201310;1995;7097;1844;6859;186;910;1442;5241;1628;6151
270550;201310;6972;21605;6242;20598;1132;3913;4112;13956;5244;17869
270560;201310;2951;9564;2845;9412;599;2255;1870;6052;2469;8307
270570;201310;4245;13990;3910;13446;495;2059;2666;9100;3161;11159
270580;201310;1960;6695;1881;6552;337;1246;1314;4641;1651;5887
270590;201310;1323;4666;1247;4528;106;487;1032;3708;1138;4195
270600;201310;2822;9647;2582;9291;228;1135;2011;7019;2239;8154
270610;201310;3203;10273;3005;9978;355;1277;2323;7693;2678;8970
270620;201310;1450;4959;1315;4757;155;728;989;3476;1144;4204
270630;201310;18049;50953;17216;49738;2445;7064;12967;38035;15412;45099
270640;201310;5806;18200;5312;17606;454;1922;4357;14148;4811;16070
270642;201310;2464;8505;2315;8271;406;1646;1529;5457;1935;7103
270644;201310;2319;7117;2172;6954;338;1007;1685;5562;2023;6569
270650;201310;3878;12754;3746;12562;901;3518;2157;7095;3058;10613
270660;201310;2523;6655;2048;5920;175;623;1430;4047;1605;4670
270670;201310;14451;41398;12913;39450;1731;5816;9549;29538;11280;35354
270680;201310;4144;12849;4022;12703;252;735;3593;11486;3845;12221
270690;201310;8562;24777;8012;24070;2507;7345;3941;12834;6448;20179
270700;201310;799;2549;762;2491;132;535;475;1494;607;2029
270710;201310;5344;18527;5145;18255;573;2020;4159;15001;4732;17021
270720;201310;3295;11476;3063;11070;288;1331;2446;8701;2734;10032
270730;201310;6514;20635;6215;20241;1235;4241;4286;14042;5521;18283
270740;201310;2373;7174;2232;6950;371;1310;1471;4537;1842;5847
270750;201310;4657;15216;4380;14795;563;2037;3313;11231;3876;13268
270760;201310;3326;10376;3115;10059;433;1482;2283;7407;2716;8889
270770;201310;17436;48044;15068;45133;2863;9236;9675;29434;12538;38670
270780;201310;1913;6227;1782;6019;266;961;1242;4241;1508;5202
270790;201310;1619;5204;1485;4980;416;1506;685;2325;1101;3831
270800;201310;11070;34066;10483;33292;1002;3584;8510;26990;9512;30574
270810;201310;3328;10514;2789;9522;415;1649;1728;5880;2143;7529
270820;201310;1880;6492;1736;6236;266;1105;1194;4241;1460;5346
270830;201310;5065;16488;4699;16006;1310;5066;2670;8953;3980;14019
270840;201310;7290;25639;6738;24911;515;2444;5587;20420;6102;22864
270850;201310;7551;25213;7401;25029;1532;6407;5059;16180;6591;22587
270860;201310;11255;34821;10649;33947;1771;6665;7602;23609;9373;30274
270870;201310;2241;6621;1828;5762;276;955;1148;3624;1424;4579
270880;201310;7672;25298;7323;24779;506;2168;6199;20691;6705;22859
270890;201310;2592;8115;2423;7839;396;1549;1671;5251;2067;6800
270895;201310;3008;11263;2864;11066;285;1087;2366;9349;2651;10436
270900;201310;1910;5290;1582;4813;113;437;1217;3598;1330;4035
270910;201310;3255;11662;3208;11573;354;1600;2598;9109;2952;10709
270915;201310;9888;34192;9092;32739;2029;8244;5006;17910;7035;26154
270920;201310;6092;19806;5718;19251;364;1651;4892;16284;5256;17935
270930;201310;16767;46513;14075;43088;3079;10023;8019;25170;11098;35193
270940;201310;5704;19683;5533;19462;913;3429;4004;14192;4917;17621
280010;201310;711;2129;631;2002;70;280;408;1273;478;1553
280020;201310;4865;15009;4379;14120;929;3174;2665;8601;3594;11775
280030;201310;70478;191369;63874;181505;16135;48502;33987;97840;50122;146342
280040;201310;3136;10058;2857;9679;375;1289;2124;7440;2499;8729
280050;201310;4085;13327;3823;12935;1088;3704;2100;7434;3188;11138
280060;201310;4157;14320;4019;14081;979;3761;2353;8272;3332;12033
280067;201310;7469;21628;6391;20144;692;2439;4816;15125;5508;17564
280070;201310;1787;6391;1719;6290;350;1361;1112;4117;1462;5478
280100;201310;3984;12854;3625;12206;921;3205;1913;6606;2834;9811
280110;201310;1362;4257;1261;4091;107;440;1000;3192;1107;3632
280120;201310;7638;24727;7139;23915;1304;4150;4803;16985;6107;21135
280130;201310;7696;22709;7282;22100;1263;4409;4884;14556;6147;18965
280140;201310;5444;15417;4974;14798;560;1693;3919;11811;4479;13504
280150;201310;3276;10467;3024;9969;491;1956;1909;6012;2400;7968
280160;201310;1531;4428;1397;4211;175;602;998;2998;1173;3600
280170;201310;4506;14068;4157;13633;531;1760;3170;10733;3701;12493
280190;201310;1078;3226;985;3074;118;465;684;2057;802;2522
280200;201310;1073;3417;1015;3324;164;681;721;2276;885;2957
280210;201310;12111;39678;11605;38896;2552;8990;7306;25052;9858;34042
280220;201310;1529;4783;1477;4715;102;395;1288;4097;1390;4492
280230;201310;3841;11413;3464;10785;736;2433;2025;6475;2761;8908
280240;201310;3364;10377;3120;10000;257;792;2496;8148;2753;8940
280250;201310;772;2119;687;1985;110;363;423;1149;533;1512
280260;201310;1980;5421;1818;5215;128;385;1550;4460;1678;4845
280270;201310;2169;6957;1905;6495;137;564;1505;5054;1642;5618
280280;201310;4002;13557;3747;13123;928;2906;2034;7974;2962;10880
280290;201310;16209;53683;15099;51736;2816;10415;10262;35426;13078;45841
280300;201310;9907;30526;9294;29834;842;2876;7783;25189;8625;28065
280310;201310;1423;4084;1266;3838;111;428;916;2692;1027;3120
280320;201310;7305;25429;6911;24700;1346;5431;4052;14466;5398;19897
280330;201310;4476;13059;4236;12753;543;1808;3260;9823;3803;11631
280340;201310;3677;11504;3556;11335;332;1085;2879;9451;3211;10536
280350;201310;20871;63548;19796;61875;3126;10130;13945;44491;17071;54621
280360;201310;5740;18596;5438;18126;1227;4619;3285;10801;4512;15420
280370;201310;1912;5555;1758;5298;213;768;1278;3742;1491;4510
280380;201310;922;2987;863;2897;119;482;649;2116;768;2598
280390;201310;3193;9651;2870;9066;752;2213;1674;5475;2426;7688
280400;201310;4383;12796;4027;12318;822;2425;2615;8362;3437;10787
280410;201310;2324;7793;2139;7472;363;1461;1312;4487;1675;5948
280420;201310;4053;12024;3805;11648;271;865;3271;10102;3542;10967
280430;201310;2069;5815;1961;5674;207;701;1557;4488;1764;5189
280440;201310;5020;15145;4707;14747;462;1555;3889;12252;4351;13807
280445;201310;2445;7153;2284;6872;126;498;1877;5537;2003;6035
280450;201310;8731;24312;8124;23597;771;1927;6815;20491;7586;22418
280460;201310;6680;18841;6044;17960;1140;3585;4053;12221;5193;15806
280470;201310;1755;5433;1617;5222;184;666;1224;3924;1408;4590
280480;201310;30187;93391;29187;91903;5161;19009;19691;60387;24852;79396
280490;201310;3678;11552;3431;11091;430;1592;2553;8218;2983;9810
280500;201310;868;2356;824;2302;34;112;728;2010;762;2122
280510;201310;2695;8068;2334;7566;310;1159;1731;5628;2041;6787
280520;201310;1692;4928;1569;4768;211;616;1180;3723;1391;4339
280530;201310;2025;6457;1925;6322;251;903;1480;4926;1731;5829
280540;201310;8657;24603;8224;24014;353;1247;7355;21360;7708;22607
280550;201310;6977;19396;6311;18320;573;2036;4764;13653;5337;15689
280560;201310;7763;23338;7364;22671;535;1870;6044;18536;6579;20406
280570;201310;6508;18657;6029;18035;927;3228;4180;12292;5107;15520
280580;201310;5605;17321;4896;16141;776;2672;3336;11203;4112;13875
280590;201310;2331;7226;2160;7022;295;1134;1611;5234;1906;6368
280600;201310;3983;12444;3747;12020;404;1603;2716;8512;3120;10115
280610;201310;2308;6849;2187;6660;364;1224;1401;4264;1765;5488
280620;201310;4835;15336;4428;14532;815;2878;2826;9334;3641;12212
280630;201310;3741;12633;3638;12480;374;1168;2945;10476;3319;11644
280640;201310;2197;6329;2049;6150;154;396;1786;5469;1940;5865
280650;201310;1082;3473;1003;3324;190;690;627;2105;817;2795
280660;201310;2590;7699;2492;7533;281;939;2048;6123;2329;7062
280670;201310;15505;41793;14820;40932;1609;4725;11705;32389;13314;37114
280680;201310;2717;7384;2402;6982;184;593;2024;5876;2208;6469
280690;201310;948;2808;845;2650;125;456;562;1691;687;2147
280700;201310;1145;3422;1012;3225;88;292;746;2415;834;2707
280710;201310;10084;28859;9562;28219;588;1863;8253;24394;8841;26257
280720;201310;2473;6812;2223;6496;200;631;1745;5167;1945;5798
280730;201310;929;2829;894;2780;82;271;748;2348;830;2619
280740;201310;12445;34912;10978;32727;1718;5080;7626;23414;9344;28494
280750;201310;3505;11203;3275;10790;299;1254;2411;7827;2710;9081
280760;201310;5694;17770;5258;17196;726;2362;3902;13261;4628;15623
290010;201310;2967;6761;2177;5515;91;370;1725;4124;1816;4494
290020;201310;4928;15654;4496;15206;394;1217;3901;13467;4295;14684
290030;201310;3129;10324;3052;10178;495;1767;2209;7337;2704;9104
290035;201310;4459;12550;4047;12005;268;907;3446;10241;3714;11148
290040;201310;3673;11002;3446;10704;291;1121;2840;8676;3131;9797
290050;201310;2717;9000;2550;8742;264;1023;1965;6769;2229;7792
290060;201310;1272;3363;1074;3119;176;572;799;2273;975;2845
290070;201310;30152;80928;26389;76221;5830;17496;14528;44086;20358;61582
290080;201310;5800;18128;5187;17344;658;2291;3896;13341;4554;15632
290090;201310;2278;5117;1828;4638;252;663;1455;3730;1707;4393
290100;201310;10085;29510;8839;27386;1870;5855;4975;16114;6845;21969
290110;201310;5214;16134;5049;15848;919;3124;3397;10600;4316;13724
290115;201310;4763;14780;4254;14097;342;1227;3256;11007;3598;12234
290120;201310;6642;18679;6241;18188;443;1324;5396;15845;5839;17169
290130;201310;4508;11985;3990;11367;348;973;3346;9663;3694;10636
290135;201310;5040;13317;4410;12275;499;1658;2936;8073;3435;9731
290140;201310;3753;12522;3366;12025;394;1527;2677;9597;3071;11124
290150;201310;2092;6306;2025;6196;191;636;1698;5176;1889;5812
290160;201310;3424;9733;3347;9640;367;735;2855;8592;3222;9327
290170;201310;2807;9539;2592;9189;249;1034;2081;7367;2330;8401
290180;201310;2933;8526;2624;8094;301;1057;1913;5881;2214;6938
290190;201310;4137;13879;3998;13631;449;1622;3075;10586;3524;12208
290195;201310;2179;6177;1894;5752;149;513;1517;4631;1666;5144
290200;201310;3784;12444;3485;11906;445;1615;2563;8797;3008;10412
290205;201310;2784;9126;2619;8877;413;1674;1849;6113;2262;7787
290210;201310;15621;43580;14819;42647;2431;5673;10783;33873;13214;39546
290220;201310;2344;7294;2249;7144;325;1224;1599;4928;1924;6152
290225;201310;3010;8258;2843;8077;232;508;2466;7258;2698;7766
290230;201310;2348;7937;2309;7879;231;825;1916;6619;2147;7444
290240;201310;3837;10355;3479;9864;418;1305;2534;7130;2952;8435
290250;201310;3741;12161;3192;11275;309;1168;2417;8649;2726;9817
290260;201310;4580;14575;4327;14182;479;1684;3402;11162;3881;12846
290265;201310;3316;10957;3152;10662;324;1289;2405;8098;2729;9387
290270;201310;11799;44362;11166;43424;1491;6160;8459;33444;9950;39604
290280;201310;4979;17027;4756;16580;716;2623;3249;11608;3965;14231
290290;201310;9465;31102;8739;29910;1670;6031;5722;19928;7392;25959
290300;201310;4361;12592;3426;10956;324;1104;2458;8036;2782;9140
290310;201310;1516;4700;1437;4596;232;861;1026;3212;1258;4073
290320;201310;25378;80687;23081;77579;5054;18150;14101;48056;19155;66206
290323;201310;4001;11033;3316;10310;214;789;2838;8796;3052;9585
290327;201310;3936;12925;3687;12416;525;1884;2567;8659;3092;10543
290330;201310;1858;5088;1784;5005;280;874;1387;3835;1667;4709
290340;201310;5400;17319;5026;16789;1293;4441;2818;9679;4111;14120
290350;201310;4812;15001;3981;13857;529;1881;2866;10254;3395;12135
290360;201310;4089;13223;3735;12741;237;863;3254;11236;3491;12099
290370;201310;4508;13782;4184;13314;550;1776;3306;10662;3856;12438
290380;201310;5540;16406;4988;15658;359;1303;4126;12914;4485;14217
290390;201310;14730;49037;14128;48004;2989;9917;8938;31940;11927;41857
290395;201310;2748;9067;2495;8637;258;1109;1868;6449;2126;7558
290400;201310;3524;11330;3198;10859;502;1693;2294;7972;2796;9665
290405;201310;4323;14119;3790;13181;528;1921;2514;8997;3042;10918
290410;201310;5894;18112;5062;16892;574;2454;3737;12106;4311;14560
290420;201310;3245;9768;2720;9014;261;1036;2115;6942;2376;7978
290430;201310;3396;11056;3091;10609;700;2431;1894;6742;2594;9173
290440;201310;2902;7904;2441;7319;209;729;1977;5955;2186;6684
290450;201310;3492;10479;3174;10017;656;1991;2018;6645;2674;8636
290460;201310;12883;41127;12189;39929;3489;12148;5893;19163;9382;31311
290470;201310;4665;13540;3763;12362;880;3261;2016;6727;2896;9988
290475;201310;5045;18093;4600;17282;525;2115;3402;12963;3927;15078
290480;201310;2632;6914;2340;6530;350;1074;1617;4545;1967;5619
290485;201310;4484;15114;4202;14701;473;2143;3243;11196;3716;13339
290490;201310;7685;21554;7455;21233;922;2869;5927;16856;6849;19725
290500;201310;4560;14842;3961;13766;762;2859;2099;7304;2861;10163
290510;201310;3398;10143;2987;9543;260;992;2356;7530;2616;8522
290515;201310;2735;8818;2624;8615;165;528;2149;7222;2314;7750
290520;201310;11742;37085;9688;33222;1276;5104;6110;20880;7386;25984
290530;201310;5214;15355;4494;14307;389;1331;3640;11629;4029;12960
290540;201310;3923;11443;3751;11215;505;1465;2841;8732;3346;10197
290550;201310;4313;11589;3828;10992;208;614;3348;9650;3556;10264
290560;201310;5993;18129;5365;17233;1135;3842;3274;10653;4409;14495
290570;201310;39514;117389;37148;113757;5136;16853;27255;83099;32391;99952
290580;201310;7255;26120;6990;25709;1216;4478;5051;19135;6267;23613
290590;201310;7394;24178;6308;22399;485;2015;5065;17951;5550;19966
290600;201310;17829;56538;16904;55101;2562;8466;11740;39450;14302;47916
290610;201310;2315;8269;1974;7590;205;975;1449;5485;1654;6460
290620;201310;7228;21787;6515;20762;550;1914;5433;17331;5983;19245
290630;201310;8141;22631;7227;21660;872;2595;5745;17463;6617;20058
290640;201310;2694;8078;2259;7316;259;916;1596;5183;1855;6099
290650;201310;11509;34979;10837;33945;3333;10499;5688;18643;9021;29142
290660;201310;3657;10451;3048;9576;216;794;2438;7680;2654;8474
290670;201310;6355;20496;5870;19740;900;2883;4385;15378;5285;18261
290680;201310;10182;30601;9532;29825;561;1858;8264;26095;8825;27953
290682;201310;4196;12986;3842;12470;218;875;3192;10300;3410;11175
290685;201310;3177;8443;2447;7419;322;1083;1535;4740;1857;5823
290687;201310;8243;22486;6663;20608;1132;3813;4331;13585;5463;17398
290689;201310;3082;8969;2605;8199;278;935;1985;6292;2263;7227
290690;201310;5334;16041;4929;15488;651;2199;3754;11852;4405;14051
290700;201310;2225;7128;2138;7002;239;843;1636;5407;1875;6250
290710;201310;7587;25080;7105;24302;404;1384;6238;21560;6642;22944
290720;201310;17875;54314;16167;52174;2378;7196;12347;41241;14725;48437
290730;201310;7322;20723;6723;19959;1398;4007;4282;13213;5680;17220
290740;201310;994;3026;858;2798;161;527;498;1685;659;2212
290750;201310;9972;29257;8692;26973;1694;6163;4924;14510;6618;20673
290755;201310;2400;6956;2045;6353;134;525;1658;5089;1792;5614
290760;201310;4417;13313;3691;12290;397;1333;2753;9280;3150;10613
290770;201310;2529;8971;2372;8758;176;748;1962;7280;2138;8028
290780;201310;8524;23218;7668;22041;966;2544;5786;17164;6752;19708
290790;201310;4557;14021;4276;13616;511;1584;3281;10846;3792;12430
290800;201310;7189;16198;5553;14456;1126;2742;3868;10535;4994;13277
290810;201310;4824;15770;4268;14913;338;1268;3282;11646;3620;12914
290820;201310;5271;15673;4746;14915;600;2146;3440;10780;4040;12926
290830;201310;4244;12861;4087;12575;493;1925;3005;8977;3498;10902
290840;201310;17202;49691;16014;48074;2484;7194;11397;35686;13881;42880
290850;201310;6636;20303;6492;20088;1470;4528;4362;13904;5832;18432
290860;201310;4738;17323;4536;17048;746;2825;3258;12625;4004;15450
290870;201310;4726;14477;3991;13478;488;1967;2913;9713;3401;11680
290880;201310;1376;3916;1127;3520;119;376;752;2397;871;2773
290890;201310;6183;17731;5950;17428;660;1980;4786;14159;5446;16139
290900;201310;2402;7138;1837;6212;299;1146;963;3210;1262;4356
290910;201310;4699;13454;4087;12571;333;1107;3324;10252;3657;11359
290920;201310;4763;14367;4343;13793;362;1018;3552;11522;3914;12540
290930;201310;7270;23930;6716;22969;826;3181;4816;16271;5642;19452
290940;201310;3390;11187;3214;10955;283;1039;2707;9349;2990;10388
290950;201310;1568;4520;1471;4391;218;699;1059;3153;1277;3852
290960;201310;5797;17155;5321;16523;410;1314;4312;13592;4722;14906
290970;201310;3717;12311;3463;11874;516;1824;2286;8072;2802;9896
290980;201310;10537;32539;9477;30423;2833;9535;3921;12608;6754;22143
290990;201310;9084;27754;8285;26467;917;3106;6448;20704;7365;23810
291000;201310;2879;9199;2704;8964;426;1421;1990;6794;2416;8215
291005;201310;12759;37200;11709;35605;2185;7144;7688;23676;9873;30820
291010;201310;2951;10028;2526;9075;442;1724;1435;5162;1877;6886
291020;201310;1340;3714;1044;3162;128;484;614;1804;742;2288
291030;201310;2066;6030;1721;5285;189;649;1131;3431;1320;4080
291040;201310;5305;17346;4969;16833;732;2655;3600;12261;4332;14916
291050;201310;7868;26763;7266;25627;1916;7245;3843;13611;5759;20856
291060;201310;6129;23126;5871;22814;793;3519;4502;17429;5295;20948
291070;201310;15899;48003;14716;46278;1906;5634;11061;36017;12967;41651
291072;201310;19414;62745;17182;58302;6280;22702;5720;20361;12000;43063
291075;201310;5109;15300;4661;14683;332;1064;3624;11718;3956;12782
291077;201310;1528;4576;1304;4222;146;570;898;2853;1044;3423
291080;201310;80218;249815;73182;237737;19793;67654;33726;109396;53519;177050
291085;201310;5539;15318;4867;14406;624;1942;3725;11060;4349;13002
291090;201310;1298;3565;1144;3342;158;597;826;2309;984;2906
291100;201310;2665;7252;2247;6808;127;518;1931;5801;2058;6319
291110;201310;4947;18077;4495;17352;717;3063;3108;11943;3825;15006
291120;201310;7473;20394;7078;19835;1003;2959;5278;14845;6281;17804
291125;201310;1636;3741;1344;3430;136;337;1039;2770;1175;3107
291130;201310;2981;9255;2620;8653;259;1023;1886;6179;2145;7202
291140;201310;4046;12428;3806;11996;548;1820;2663;8462;3211;10282
291150;201310;1991;5280;1915;5189;179;519;1517;4080;1696;4599
291160;201310;5474;16999;4868;16099;1136;3913;2944;9781;4080;13694
291165;201310;2352;7197;1972;6478;155;662;1425;4570;1580;5232
291170;201310;20283;53350;17702;50185;1389;4733;14144;39800;15533;44533
291180;201310;6370;17220;5306;15779;612;2017;3989;11813;4601;13830
291185;201310;3744;10598;3583;10395;240;840;3076;8834;3316;9674
291190;201310;7421;21329;6731;20501;910;2703;5016;15885;5926;18588
291200;201310;3059;9438;2634;8711;344;1338;1839;6033;2183;7371
291210;201310;7570;18324;6705;17360;650;1784;5248;13704;5898;15488
291220;201310;4095;13314;3905;12986;611;2303;2760;9052;3371;11355
291230;201310;3818;10260;3420;9773;204;584;2992;8633;3196;9217
291240;201310;4714;13214;4023;11993;317;1002;3127;9251;3444;10253
291250;201310;3703;11346;2967;10124;315;1107;2123;7353;2438;8460
291260;201310;1158;3523;1101;3443;104;356;878;2748;982;3104
291270;201310;4354;15052;4163;14705;308;1222;3405;12091;3713;13313
291280;201310;2336;6032;1788;5402;516;1529;1036;3244;1552;4773
291290;201310;5904;17021;5395;16401;880;2736;3633;11354;4513;14090
291300;201310;4396;13396;3677;12176;494;1789;2469;8196;2963;9985
291310;201310;5266;15515;4677;14544;454;1512;3563;11086;4017;12598
291320;201310;5664;19029;5043;17801;1472;5682;2363;8225;3835;13907
291330;201310;1555;4921;1464;4758;220;839;926;2874;1146;3713
291340;201310;3779;11510;3070;10496;385;1538;2309;7786;2694;9324
291345;201310;3413;11442;3269;11286;255;893;2849;9985;3104;10878
291350;201310;6042;18279;5431;17340;668;2243;3654;11973;4322;14216
291360;201310;35821;106002;33645;102804;8091;24725;21309;67284;29400;92009
291370;201310;8960;27027;8610;26570;1186;3506;6477;20656;7663;24162
291380;201310;3785;11857;3368;11167;337;1146;2400;8207;2737;9353
291390;201310;10359;29474;9523;28489;1318;3944;7285;22096;8603;26040
291400;201310;16649;44562;13602;40448;2158;6674;8876;27302;11034;33976
291410;201310;3228;8524;2392;7294;201;828;1769;5219;1970;6047
291420;201310;2235;5978;2022;5723;95;236;1854;5318;1949;5554
291430;201310;3321;9983;2956;9499;267;1051;2303;7318;2570;8369
291440;201310;5853;19047;5030;17508;585;2179;3798;13396;4383;15575
291450;201310;7229;22984;6812;22266;443;1440;5612;18747;6055;20187
291460;201310;12476;39307;11276;37560;2521;8825;6859;23179;9380;32004
291465;201310;7824;23338;7183;22596;932;3211;5501;17350;6433;20561
291470;201310;15347;43729;13797;41815;1263;3901;10850;33839;12113;37740
291480;201310;34646;95848;31080;90829;5653;18331;19857;57577;25510;75908
291490;201310;4144;14365;4070;14256;558;1945;3204;11455;3762;13400
291500;201310;4118;12258;3624;11574;286;996;2927;9391;3213;10387
291510;201310;3465;10933;3276;10668;151;530;2968;9730;3119;10260
291520;201310;4025;11355;3614;10794;643;1835;2397;7630;3040;9465
291530;201310;2061;6271;1772;5814;505;1768;878;2973;1383;4741
291535;201310;4287;12797;3888;12202;369;1233;2926;9517;3295;10750
291540;201310;2199;5465;1907;5160;176;437;1588;4416;1764;4853
291550;201310;5568;15542;5035;14793;1272;3919;2755;8214;4027;12133
291560;201310;16492;44032;13229;40285;1698;5329;9826;30648;11524;35977
291570;201310;2349;6464;2253;6344;159;414;1985;5677;2144;6091
291580;201310;5832;18232;5209;17248;828;3280;3383;11053;4211;14333
291590;201310;1999;6340;1786;5982;340;1265;1106;3801;1446;5066
291600;201310;5464;15524;4090;13582;1036;3774;1989;6520;3025;10294
291610;201310;5170;15152;5018;14933;474;1622;4108;12095;4582;13717
291620;201310;3017;7207;2518;6671;188;473;2016;5526;2204;5999
291630;201310;3202;8163;2844;7762;272;688;2404;6731;2676;7419
291640;201310;17099;48133;14492;44767;3899;13204;6391;19873;10290;33077
291650;201310;7941;24253;7374;23589;638;1667;6231;20717;6869;22384
291660;201310;2375;6444;2127;6106;263;895;1494;4190;1757;5085
291670;201310;2492;7121;2301;6804;373;1159;1309;4159;1682;5318
291680;201310;4970;14401;4502;13649;1162;3985;2095;6582;3257;10567
291685;201310;4254;11273;3800;10726;338;976;3028;8829;3366;9805
291690;201310;3948;11059;3276;9999;340;1068;2281;7033;2621;8101
291700;201310;9232;29736;8620;28717;1026;3569;6425;21784;7451;25353
291710;201310;5889;15915;5170;14958;1185;3723;2822;8460;4007;12183
291720;201310;3728;13348;3449;12764;395;1696;2567;9362;2962;11058
291730;201310;5726;18927;5379;18467;1325;4642;3318;11791;4643;16433
291733;201310;2504;7717;2205;7308;286;1024;1507;5048;1793;6072
291735;201310;2294;6797;2013;6372;127;496;1673;5239;1800;5735
291740;201310;3962;11713;3160;10471;332;1298;2232;7354;2564;8652
291750;201310;21455;57879;17306;51729;3847;11934;9605;29237;13452;41171
291760;201310;12023;39141;11239;37708;3894;14164;5035;17164;8929;31328
291770;201310;7958;23352;7326;22289;1219;4011;4874;14706;6093;18717
291780;201310;4235;13415;4065;13102;577;1807;3058;10022;3635;11829
291790;201310;2388;7772;2271;7613;178;719;1895;6305;2073;7024
291800;201310;30979;92462;28226;88483;6328;20735;16868;54234;23196;74969
291810;201310;10381;30872;9094;29365;695;2511;7376;24108;8071;26619
291820;201310;3559;10970;3276;10572;375;1232;2483;8119;2858;9351
291830;201310;4374;12030;4098;11619;587;1832;3048;8623;3635;10455
291835;201310;6051;19319;5095;17745;1143;4279;3165;11029;4308;15308
291840;201310;46735;132718;40718;126309;5157;15937;32048;101667;37205;117604
291845;201310;2980;8833;2701;8530;248;756;2334;7474;2582;8230
291850;201310;4823;13832;4108;12843;442;1331;3202;10321;3644;11652
291855;201310;1853;4992;1602;4672;282;958;1107;3150;1389;4108
291860;201310;1940;5969;1723;5562;183;666;1153;3700;1336;4366
291870;201310;1324;3687;1062;3220;113;428;705;2094;818;2522
291875;201310;2785;9183;2532;8762;276;1120;1737;5916;2013;7036
291880;201310;4499;14524;4345;14288;318;1046;3726;12410;4044;13456
291890;201310;1415;3608;1200;3341;162;470;853;2399;1015;2869
291900;201310;1272;3727;1132;3521;115;415;863;2640;978;3055
291905;201310;2910;7880;2465;7172;235;795;1747;5136;1982;5931
291910;201310;2498;7058;2248;6732;179;666;1829;5375;2008;6041
291915;201310;6592;20955;5952;19665;540;1857;4888;16407;5428;18264
291920;201310;32366;95907;30033;92469;6157;19414;18567;58875;24724;78289
291930;201310;2534;7643;2318;7338;255;887;1772;5642;2027;6529
291940;201310;3550;10305;2705;8795;410;1538;1591;4983;2001;6521
291950;201310;9084;31402;8291;30094;2195;8106;4340;16220;6535;24326
291955;201310;7457;24888;7317;24679;1549;5337;4807;16541;6356;21878
291960;201310;3309;10097;2874;9506;365;1154;2036;7116;2401;8270
291970;201310;4405;13302;3940;12722;595;1983;2769;9130;3364;11113
291980;201310;11299;33144;8728;29426;1139;4027;6134;21143;7273;25170
291990;201310;2126;7068;1974;6841;214;773;1450;5169;1664;5942
291992;201310;2788;8721;2725;8588;503;1662;1945;6100;2448;7762
291995;201310;2097;6296;1899;6026;234;769;1435;4641;1669;5410
292000;201310;2301;6989;2095;6677;501;1765;1234;3862;1735;5627
292010;201310;6130;16220;4769;14160;471;1493;3663;10884;4134;12377
292020;201310;4440;15332;4094;14753;571;2234;3000;10952;3571;13186
292030;201310;2130;6882;1935;6596;251;941;1267;4362;1518;5303
292040;201310;4569;12987;4090;12475;363;1064;3417;10797;3780;11861
292045;201310;2416;8670;2385;8616;106;362;2212;8039;2318;8401
292050;201310;6206;19863;5567;18605;584;2398;3874;12761;4458;15159
292060;201310;10721;30784;10329;30245;1001;3073;8524;24956;9525;28029
292070;201310;4310;14012;4209;13885;390;1158;3665;12320;4055;13478
292080;201310;3646;9785;3164;9136;293;887;2555;7422;2848;8309
292090;201310;4214;11566;3657;10929;346;1185;2958;8853;3304;10038
292100;201310;10820;30611;9438;28892;2578;8225;5317;16784;7895;25009
292105;201310;3132;9728;2739;9175;215;866;2187;7282;2402;8148
292110;201310;7004;18744;5407;16436;1212;3860;3098;9694;4310;13554
292120;201310;8317;24221;7364;22664;1527;4857;4288;13562;5815;18419
292130;201310;3219;8702;2918;8286;511;1278;2026;6024;2537;7302
292140;201310;5419;14425;4748;13540;543;1588;3418;10032;3961;11620
292145;201310;2664;8295;2435;7935;208;671;1834;6257;2042;6928
292150;201310;13373;41508;12488;40071;920;3438;9866;31867;10786;35305
292160;201310;2691;7878;2318;7365;189;575;1903;6216;2092;6791
292170;201310;8616;26412;7420;24306;1134;4117;4710;15606;5844;19723
292180;201310;3462;10340;2878;9436;388;1345;1971;6576;2359;7921
292190;201310;3158;9050;2789;8526;561;1874;1803;5519;2364;7393
292200;201310;5523;18882;5014;17763;1613;6152;1892;6683;3505;12835
292205;201310;3985;12534;3667;12105;280;1078;2939;9689;3219;10767
292210;201310;6491;19263;5742;18233;554;1856;4510;14672;5064;16528
292220;201310;1891;5486;1796;5348;422;1202;1079;3272;1501;4474
292225;201310;2864;9340;2655;9011;212;760;2142;7378;2354;8138
292230;201310;6189;18860;5918;18434;706;2619;4476;13624;5182;16243
292240;201310;4370;14099;4062;13394;661;2367;2475;8061;3136;10428
292250;201310;5153;16124;4870;15589;1062;3547;2619;8466;3681;12013
292260;201310;3026;9669;2880;9436;360;1245;2202;7210;2562;8455
292265;201310;3068;10227;2809;9747;246;1019;2081;7172;2327;8191
292270;201310;3825;10781;3124;9952;284;1110;2478;7899;2762;9009
292273;201310;2760;6822;2132;6021;308;856;1508;4445;1816;5301
292275;201310;1884;4980;1769;4817;222;691;1338;3611;1560;4302
292280;201310;2038;6248;1876;6072;187;513;1480;5101;1667;5614
292285;201310;2537;7323;2269;6941;263;902;1694;5272;1957;6174
292290;201310;7320;22430;6208;20982;430;1616;4991;17179;5421;18795
292300;201310;8309;26046;7354;24995;2374;8175;4042;14275;6416;22450
292303;201310;2763;8929;2588;8679;114;453;2249;7543;2363;7996
292305;201310;3135;8657;2977;8445;107;323;2685;7643;2792;7966
292310;201310;5821;18233;5364;17615;332;1164;4577;15154;4909;16318
292320;201310;5776;18157;5306;17333;599;2322;4030;13017;4629;15339
292330;201310;1966;5765;1859;5631;253;849;1401;4186;1654;5035
292335;201310;5243;13991;4793;13399;403;1169;4042;11353;4445;12522
292340;201310;6436;19029;5638;17802;546;1854;4209;13316;4755;15170
292350;201310;2023;6497;1908;6358;212;806;1514;5042;1726;5848
292360;201310;4836;14428;4666;13908;198;604;4076;12423;4274;13027
292370;201310;8357;26303;7627;25201;1101;3517;5315;18501;6416;22018
292380;201310;7266;21464;6865;20844;591;1669;5648;17404;6239;19073
292390;201310;3651;8422;3256;7996;108;208;3049;7572;3157;7780
292400;201310;21878;65648;20939;64136;3175;10331;14718;45980;17893;56311
292405;201310;4331;11867;3801;11224;267;803;3201;9566;3468;10369
292410;201310;1812;5065;1744;4989;143;442;1517;4322;1660;4764
292420;201310;3708;12071;3580;11926;177;501;3255;11079;3432;11580
292430;201310;5278;16946;4500;15924;315;1282;3589;12707;3904;13989
292440;201310;8471;28024;7973;27314;316;1228;7035;24399;7351;25627
292450;201310;4333;13122;3569;11895;349;1275;2576;8711;2925;9986
292460;201310;5564;17014;4962;15923;935;3107;3130;10170;4065;13277
292465;201310;2322;7235;2018;6740;245;958;1455;4865;1700;5823
292467;201310;2162;7150;2049;6952;439;1605;1295;4439;1734;6044
292470;201310;3177;8672;2671;7870;237;844;1998;5791;2235;6635
292480;201310;5786;16503;5014;15399;389;1363;4090;12609;4479;13972
292490;201310;2281;6586;1964;6109;219;822;1463;4471;1682;5293
292500;201310;6544;19994;5730;18594;591;2243;4209;13711;4800;15954
292510;201310;13028;38163;11646;36193;1207;4083;9049;28552;10256;32635
292520;201310;5623;17686;5264;17039;1590;5270;2584;8475;4174;13745
292525;201310;5451;14583;4804;13821;437;1361;3860;11214;4297;12575
292530;201310;24639;75296;22774;73094;4809;15952;14602;48333;19411;64285
292540;201310;2775;8406;2527;8034;489;1777;1687;5289;2176;7066
292550;201310;6171;20648;5606;19767;961;3555;3795;13679;4756;17234
292560;201310;4193;11723;3609;10962;316;1159;2932;8760;3248;9919
292570;201310;3966;11868;3840;11735;133;419;3365;10613;3498;11032
292575;201310;5912;20560;5756;20263;1160;4224;3876;13663;5036;17887
292580;201310;7088;21318;6618;20724;597;1915;5453;17266;6050;19181
292590;201310;7101;23077;6820;22604;1045;3455;4854;16376;5899;19831
292593;201310;3223;8645;2752;7950;255;767;2111;6086;2366;6853
292595;201310;5708;16551;5098;15742;496;1665;3883;12041;4379;13706
292600;201310;10474;30077;9925;29394;1315;3115;7957;24684;9272;27799
292610;201310;4299;12654;3599;11473;541;1812;2299;7471;2840;9283
292620;201310;5800;18268;5141;17493;347;1329;4560;15544;4907;16873
292630;201310;9819;25220;8621;23462;802;2306;6599;18204;7401;20510
292640;201310;8202;26887;7251;25614;665;2455;5663;20445;6328;22900
292650;201310;4696;13323;4531;13126;517;1147;3635;11261;4152;12408
292660;201310;10919;34020;10476;33351;1506;4884;7751;25249;9257;30133
292665;201310;2851;8594;2777;8480;99;276;2600;8009;2699;8285
292670;201310;3805;11029;3009;9685;361;1312;1963;6350;2324;7662
292680;201310;3551;10928;3384;10697;284;956;2825;8907;3109;9863
292690;201310;3332;9255;2455;7905;322;1157;1642;5380;1964;6537
292700;201310;8845;27795;7839;26371;1151;3699;5619;19807;6770;23506
292710;201310;1895;6350;1810;6223;102;393;1596;5497;1698;5890
292720;201310;9409;24735;8367;23545;777;2297;6948;19709;7725;22006
292730;201310;3311;10350;3212;10178;585;1786;2161;7103;2746;8889
292740;201310;345281;995503;329365;971716;80704;252021;195605;578576;276309;830597
292750;201310;5779;16230;5286;15587;414;1237;4297;12897;4711;14134
292760;201310;4188;13692;3870;13106;569;2112;2547;8726;3116;10838
292770;201310;5881;18523;5579;18041;1377;4492;3280;11020;4657;15512
292780;201310;1822;4665;1465;4236;216;751;1043;2957;1259;3708
292790;201310;3240;8956;3113;8817;278;660;2565;7634;2843;8294
292800;201310;9330;28733;8777;27834;961;3304;6779;21538;7740;24842
292805;201310;3085;9383;2858;9050;567;1960;1889;6048;2456;8008
292810;201310;9771;30388;8415;28585;1254;4398;6161;21486;7415;25884
292820;201310;7247;21316;5391;18693;445;1697;4359;15241;4804;16938
292830;201310;1848;5608;1682;5376;125;501;1363;4322;1488;4823
292840;201310;7050;23761;6587;23111;476;1836;5610;19736;6086;21572
292850;201310;3132;8486;2669;7790;365;1138;1865;5387;2230;6525
292860;201310;15051;41778;14513;41114;2017;5715;11208;32203;13225;37918
292870;201310;18427;52709;16545;49660;3400;11215;9517;28082;12917;39297
292880;201310;11559;35332;10525;33662;1999;6592;6573;21244;8572;27836
292890;201310;5399;18932;4893;17950;1032;3956;2766;10414;3798;14370
292895;201310;2684;7044;2269;6431;321;968;1689;4769;2010;5737
292900;201310;3037;9609;2868;9336;451;1744;1898;5943;2349;7687
292905;201310;4050;12321;3457;11554;344;1063;2837;9780;3181;10843
292910;201310;5012;15895;4665;15244;837;2929;2990;9733;3827;12662
292920;201310;8205;24628;7846;24084;807;2779;6198;18711;7005;21490
292925;201310;5050;16175;4523;15449;386;1428;3580;12286;3966;13714
292930;201310;6414;21033;6136;20510;882;3593;4372;14232;5254;17825
292935;201310;2079;5985;1771;5643;149;381;1467;4905;1616;5286
292937;201310;3286;8552;2814;7955;325;1047;2155;6010;2480;7057
292940;201310;3019;8546;2433;7737;306;980;1641;5452;1947;6432
292950;201310;8174;25189;7833;24614;1011;3809;5714;17445;6725;21254
292960;201310;4521;13031;4206;12546;504;1663;2948;8711;3452;10374
292970;201310;4188;13391;3880;12990;195;808;3301;11058;3496;11866
292975;201310;3248;9139;3146;8970;351;1037;2568;7353;2919;8390
292980;201310;3498;10118;2893;9389;411;1622;2002;6428;2413;8050
292990;201310;12017;35041;11082;33624;771;2489;9454;28746;10225;31235
293000;201310;2912;7881;2400;7215;135;474;2080;6235;2215;6709
293010;201310;18192;52819;16196;49654;3239;10988;9815;30028;13054;41016
293015;201310;7854;26156;6416;23993;1137;4550;4096;15311;5233;19861
293020;201310;9307;31333;8714;30462;655;2577;7169;25328;7824;27905
293030;201310;5480;16310;4486;14839;482;1746;3101;10553;3583;12299
293040;201310;3736;12059;3594;11901;263;940;3102;10298;3365;11238
293050;201310;19165;55872;17179;53235;2876;9123;11367;36329;14243;45452
293060;201310;4276;11072;3631;10049;422;1282;2488;6810;2910;8092
293070;201310;19574;60990;18328;58795;5265;17570;9437;30867;14702;48437
293075;201310;3495;11175;3192;10814;276;1012;2680;9126;2956;10138
293076;201310;3677;10562;3451;10221;290;824;2891;8720;3181;9544
293077;201310;5103;15920;4449;15088;800;2907;2839;9738;3639;12645
293080;201310;4827;15284;4432;14616;332;1434;3501;11270;3833;12704
293090;201310;3546;11256;2930;10384;304;1103;2261;8150;2565;9253
293100;201310;5611;17600;4845;16250;488;1765;3669;12511;4157;14276
293105;201310;3811;12943;3383;12079;585;2141;2197;8004;2782;10145
293110;201310;1939;5913;1838;5742;111;423;1538;4781;1649;5204
293120;201310;4021;13675;3748;13285;350;1277;3002;10796;3352;12073
293130;201310;3947;11695;3242;10900;195;744;2840;9684;3035;10428
293135;201310;26539;71872;21214;64693;4150;14999;11189;33529;15339;48528
293140;201310;2066;6303;2006;6213;198;790;1560;4680;1758;5470
293150;201310;5801;19278;5260;18239;1097;3861;3094;11117;4191;14978
293160;201310;3410;9535;3255;9340;526;1180;2438;7442;2964;8622
293170;201310;3372;10504;3172;10195;465;1606;2307;7541;2772;9147
293180;201310;5330;15232;4494;13950;405;1493;3531;10798;3936;12291
293190;201310;13530;41876;12957;40979;641;2856;11197;34648;11838;37504
293200;201310;6162;18491;5547;17553;304;1125;4796;15092;5100;16217
293210;201310;4592;14292;4316;13823;559;1864;3055;9937;3614;11801
293220;201310;5097;15742;4649;15050;1233;4189;2375;7883;3608;12072
293230;201310;3897;12486;3621;12102;417;1610;2838;9427;3255;11037
293240;201310;4474;11830;3572;10586;193;581;2834;8413;3027;8994
293245;201310;4320;12856;3959;12254;515;1642;2795;8933;3310;10575
293250;201310;5884;17182;5463;16586;899;2874;3780;11577;4679;14451
293260;201310;4684;14295;3942;13223;367;1354;2952;10056;3319;11410
293270;201310;5762;16058;5485;15756;576;1556;4629;13557;5205;15113
293280;201310;5635;16198;4947;15300;437;1279;3856;12346;4293;13625
293290;201310;16328;55971;15527;54330;3439;12382;9144;32790;12583;45172
293300;201310;6180;16079;5384;15200;504;1411;4286;12262;4790;13673
293305;201310;4653;11996;4223;11421;362;1059;3379;9179;3741;10238
293310;201310;2669;7029;2214;6281;264;867;1518;4242;1782;5109
293315;201310;4820;12521;4347;11784;765;2051;2715;7743;3480;9794
293317;201310;2482;7562;2280;7189;320;1051;1491;4740;1811;5791
293320;201310;8099;26729;7899;26454;983;3593;6312;21057;7295;24650
293325;201310;1902;5628;1584;5128;303;1058;996;3255;1299;4313
293330;201310;53709;173145;48577;164412;11222;41227;26699;91519;37921;132746
293340;201310;2687;7784;2160;6880;309;1138;1476;4592;1785;5730
293345;201310;3411;10504;2894;9749;364;1223;2034;7094;2398;8317
293350;201310;6603;18683;6350;18367;437;1222;5595;16433;6032;17655
293360;201310;13602;41837;12511;40383;772;2520;10656;35156;11428;37676
310010;201310;1221;3355;885;2811;246;933;391;1137;637;2070
310020;201310;3770;12161;3181;10820;1116;4110;614;1891;1730;6001
310030;201310;2387;8210;2167;7795;739;2758;915;3346;1654;6104
310040;201310;944;2696;804;2503;117;434;546;1655;663;2089
310050;201310;1890;6757;1667;6202;363;1576;798;2914;1161;4490
310060;201310;3051;10934;2941;10765;366;1387;2280;8499;2646;9886
310070;201310;319;961;240;808;37;157;106;320;143;477
310080;201310;757;2384;617;2105;175;691;198;619;373;1310
310090;201310;4578;14223;4042;13283;712;2613;2441;8028;3153;10641
310100;201310;3275;10388;2866;9760;386;1500;2047;6933;2433;8433
310110;201310;5830;16804;4933;15455;1128;4079;2656;8160;3784;12239
310120;201310;569;1897;540;1846;233;912;193;551;426;1463
310130;201310;456;1458;417;1397;111;427;202;632;313;1059
310140;201310;262;920;228;854;74;315;49;161;123;476
310150;201310;4663;14940;4270;14212;967;3673;2222;7318;3189;10991
310160;201310;6818;22558;6007;21111;1789;7006;2550;8757;4339;15763
310163;201310;710;2495;666;2410;180;754;264;918;444;1672
310170;201310;9597;28126;8882;27009;1884;6108;5287;16656;7171;22764
310180;201310;1810;5388;1466;4892;394;1498;690;2232;1084;3730
310190;201310;2501;8517;2271;8108;683;2720;317;1139;1000;3859
310200;201310;1843;6355;1561;5763;494;1978;510;1858;1004;3836
310205;201310;934;3039;852;2859;177;609;497;1710;674;2319
310210;201310;2393;7814;2213;7527;404;1504;1491;5059;1895;6563
310220;201310;1249;3625;1009;3312;187;670;642;2098;829;2768
310230;201310;2836;9553;2478;8746;791;3222;898;2892;1689;6114
310240;201310;1007;3614;844;3271;148;646;444;1811;592;2457
310250;201310;956;3374;928;3331;190;787;574;1959;764;2746
310260;201310;3293;10911;2859;10008;897;3479;1049;3564;1946;7043
310270;201310;2285;7090;2100;6832;310;1141;1513;4951;1823;6092
310280;201310;2068;6211;1885;5908;668;2436;698;2022;1366;4458
310285;201310;2240;7940;2132;7786;273;952;1620;6129;1893;7081
310290;201310;1305;4170;1218;4035;391;1509;548;1602;939;3111
310300;201310;1848;6488;1754;6282;506;2011;952;3352;1458;5363
310310;201310;396;1121;290;899;58;198;147;448;205;646
310320;201310;359;1283;328;1203;90;368;144;516;234;884
310330;201310;481;1270;363;1058;44;157;211;565;255;722
310340;201310;8241;26756;7357;25284;1498;5416;4396;15606;5894;21022
310350;201310;14012;42476;11561;37887;4274;15167;2974;9791;7248;24958
310360;201310;431;1430;420;1410;103;410;250;785;353;1195
310370;201310;1405;5127;1348;5016;509;1945;551;2095;1060;4040
310375;201310;1268;3495;950;2942;147;549;519;1557;666;2106
310380;201310;394;1143;317;1028;142;515;117;340;259;855
310390;201310;475;1747;401;1573;123;532;65;230;188;762
310400;201310;9990;30596;8006;26974;2754;10203;2105;6940;4859;17143
310410;201310;1032;3376;680;2820;275;1239;125;493;400;1732
310420;201310;5574;16502;3238;10892;859;3259;499;1496;1358;4755
310430;201310;1579;5513;1335;4982;469;1866;342;1263;811;3129
310440;201310;621;1845;546;1728;159;579;203;593;362;1172
310445;201310;1159;4054;998;3773;147;630;648;2485;795;3115
310450;201310;4331;13132;3655;12096;856;2987;2096;7151;2952;10138
310460;201310;1512;5019;1330;4684;478;1817;311;1162;789;2979
310470;201310;3705;9852;3142;9153;326;1121;2481;7186;2807;8307
310480;201310;988;3227;889;3031;227;894;411;1320;638;2214
310490;201310;3244;11200;2822;10367;978;3887;993;3686;1971;7573
310500;201310;1443;5163;1343;4948;454;1831;493;1775;947;3606
310510;201310;2480;8328;2173;7619;848;3240;481;1586;1329;4826
310520;201310;1259;3661;1117;3420;96;314;740;2285;836;2599
310530;201310;828;2707;550;1986;127;508;92;319;219;827
310540;201310;3620;12181;3361;11791;1185;4418;1245;4438;2430;8856
310550;201310;1122;3549;956;3266;323;1269;329;1042;652;2311
310560;201310;15729;50442;13694;46421;4660;17534;4553;14676;9213;32210
310570;201310;1271;4010;1198;3908;177;677;874;2799;1051;3476
310590;201310;4085;12322;3264;10680;685;2600;1199;3703;1884;6303
310600;201310;1607;5514;1532;5337;537;2089;509;1658;1046;3747
310610;201310;549;1927;506;1830;164;700;175;565;339;1265
310620;201310;183633;595864;151209;528080;43244;168236;56915;189844;100159;358080
310630;201310;4082;13705;3876;13306;915;3598;2332;7704;3247;11302
310640;201310;1432;4507;1170;4034;386;1450;365;1189;751;2639
310650;201310;2802;9314;2341;8556;459;1862;1318;4882;1777;6744
310660;201310;1263;4053;1132;3863;208;818;792;2637;1000;3455
310665;201310;1156;3710;1072;3591;207;742;704;2401;911;3143
310670;201310;55492;178058;51337;168523;16137;56178;21618;69567;37755;125745
310680;201310;801;2457;735;2353;166;591;401;1245;567;1836
310690;201310;1188;4149;993;3715;289;1264;246;868;535;2132
310700;201310;513;1448;439;1336;116;409;220;628;336;1037
310710;201310;7286;24359;5947;22269;1409;5788;2726;10467;4135;16255
310720;201310;831;2632;760;2511;236;890;350;1067;586;1957
310730;201310;9243;30115;8600;29089;2018;7453;5107;17277;7125;24730
310740;201310;4925;17223;4271;15814;1669;6719;1019;3592;2688;10311
310750;201310;1568;4180;1312;3833;258;798;824;2406;1082;3204
310760;201310;604;1956;530;1827;138;512;230;780;368;1292
310770;201310;674;2581;667;2570;293;1205;252;946;545;2151
310780;201310;3557;10554;3255;10038;504;1531;2200;6911;2704;8442
310790;201310;1681;5595;1569;5416;473;1704;798;2813;1271;4517
310800;201310;3005;10011;2466;8900;1074;4212;380;1355;1454;5567
310810;201310;1507;4292;1400;4120;371;1219;678;1908;1049;3127
310820;201310;1461;4265;1088;3604;328;1181;341;1085;669;2266
310825;201310;2317;8194;1931;7514;176;894;1422;5486;1598;6380
310830;201310;1432;4980;1222;4536;457;1826;378;1359;835;3185
310840;201310;2180;7475;1993;7085;778;3038;550;1814;1328;4852
310850;201310;1493;4660;1288;4383;232;922;864;2878;1096;3800
310855;201310;3038;10189;2773;9760;765;2829;1468;5347;2233;8176
310860;201310;7619;24585;6863;23289;1255;4452;3987;13987;5242;18439
310870;201310;995;2958;864;2716;206;717;392;1213;598;1930
310880;201310;1237;3902;943;3344;199;807;445;1560;644;2367
310890;201310;2690;8770;2123;7657;662;2682;465;1559;1127;4241
310900;201310;4159;14372;3688;13384;1168;4682;1431;5003;2599;9685
310910;201310;1901;5702;1437;4823;442;1639;352;1158;794;2797
310920;201310;1828;5830;1502;5344;407;1652;719;2550;1126;4202
310925;201310;922;3134;834;2977;320;1258;244;864;564;2122
310930;201310;5183;15911;4351;14576;1017;3586;2379;8193;3396;11779
310940;201310;6141;18663;5354;17455;1087;3953;2952;9597;4039;13550
310945;201310;1251;3650;1014;3317;244;926;540;1682;784;2608
310950;201310;1834;6385;1536;5760;623;2572;423;1489;1046;4061
310960;201310;446;1561;396;1463;140;568;137;508;277;1076
310970;201310;1459;5223;1117;4260;442;1830;127;428;569;2258
310980;201310;455;1214;320;963;61;218;140;372;201;590
310990;201310;1127;3952;984;3657;222;935;359;1253;581;2188
311000;201310;4572;16231;4080;15170;1351;5575;1412;4996;2763;10571
311010;201310;940;3090;832;2890;269;1001;379;1276;648;2277
311020;201310;869;2797;748;2588;94;376;472;1609;566;1985
311030;201310;1722;5485;1439;4869;494;1858;505;1519;999;3377
311040;201310;479;1659;416;1487;134;499;104;356;238;855
311050;201310;2561;8367;2152;7524;726;2753;797;2783;1523;5536
311060;201310;2257;7275;1871;6420;557;2053;436;1451;993;3504
311070;201310;1703;6163;1500;5725;470;2023;462;1729;932;3752
311080;201310;1192;3277;1066;3081;165;540;703;2045;868;2585
311090;201310;1625;6339;1434;5933;520;2396;319;1277;839;3673
311100;201310;2265;8134;2045;7666;968;3763;484;1840;1452;5603
311110;201310;3689;9300;2826;8143;645;2123;1474;4106;2119;6229
311115;201310;1068;3372;927;3155;122;517;614;2101;736;2618
311120;201310;8312;25077;7016;22744;2445;8889;2015;6059;4460;14948
311130;201310;2384;7403;1941;6824;669;2682;773;2597;1442;5279
311140;201310;1216;3627;1054;3428;194;742;713;2266;907;3008
311150;201310;2403;8129;2221;7836;484;1704;1321;4864;1805;6568
311160;201310;4814;16493;4132;15357;1512;6012;1339;4908;2851;10920
311170;201310;743;2370;599;2088;65;265;364;1317;429;1582
311180;201310;1564;4443;1134;3580;359;1245;229;639;588;1884
311190;201310;1086;3338;918;2976;232;861;397;1215;629;2076
311200;201310;2501;7850;2183;7192;942;3393;512;1511;1454;4904
311205;201310;1173;3894;1049;3647;271;1078;395;1416;666;2494
311210;201310;908;3028;840;2919;171;586;576;2067;747;2653
311220;201310;903;2949;725;2543;200;739;237;821;437;1560
311230;201310;8759;27326;7567;25285;1687;6183;3899;13348;5586;19531
311240;201310;1332;4182;1115;3809;384;1465;320;1034;704;2499
311250;201310;1309;4438;1186;4222;371;1439;368;1173;739;2612
311260;201310;2899;8033;2188;6748;716;2422;643;1866;1359;4288
311265;201310;1296;3571;1026;3221;163;640;695;2137;858;2777
311270;201310;3322;11321;3010;10903;619;2605;1909;6801;2528;9406
311280;201310;1344;3830;1040;3294;288;1010;320;974;608;1984
311290;201310;2294;7638;2117;7252;407;1359;1229;4410;1636;5769
311300;201310;4969;16941;4557;16312;774;3128;2931;10558;3705;13686
311310;201310;486;1754;467;1720;129;564;171;569;300;1133
311320;201310;3981;13667;3481;12524;1004;4081;1141;3863;2145;7944
311330;201310;5446;17052;4678;15810;1728;6258;1625;5474;3353;11732
311340;201310;11914;39388;10950;37548;4070;15050;3139;10706;7209;25756
311350;201310;2246;6882;1944;6356;478;1850;880;2726;1358;4576
311360;201310;1317;3775;1051;3414;468;1600;287;960;755;2560
311370;201310;4380;13540;3964;12815;1042;4078;1696;5193;2738;9271
311380;201310;456;1560;389;1427;138;571;113;371;251;942
311390;201310;1908;7275;1832;7112;813;3487;547;2026;1360;5513
311400;201310;1680;5705;1554;5473;479;1913;656;2118;1135;4031
311410;201310;1986;7316;1865;7142;686;2813;852;3279;1538;6092
311420;201310;2213;7932;2009;7416;781;3051;428;1418;1209;4469
311430;201310;3815;12307;2926;10307;708;2745;569;1940;1277;4685
311440;201310;2162;7736;1839;7213;856;3710;440;1689;1296;5399
311450;201310;2368;8587;2105;7975;784;3189;604;2195;1388;5384
311455;201310;1536;4279;1356;4015;293;1000;765;2196;1058;3196
311460;201310;597;2013;487;1772;128;580;121;418;249;998
311470;201310;588;1911;479;1678;143;587;147;476;290;1063
311480;201310;776;2269;751;2224;245;780;334;916;579;1696
311490;201310;309;1259;298;1217;108;458;100;412;208;870
311500;201310;501;1555;409;1368;162;590;136;443;298;1033
311510;201310;3054;9785;2564;8853;997;3843;665;2160;1662;6003
311520;201310;685;2381;650;2308;259;991;244;841;503;1832
311530;201310;10338;28681;7347;23211;2237;8331;2049;6094;4286;14425
311535;201310;678;2142;507;1789;138;556;115;391;253;947
311540;201310;690;2546;659;2496;246;954;293;1114;539;2068
311545;201310;2039;6706;1978;6603;358;1334;1313;4364;1671;5698
311547;201310;1635;4674;1399;4303;154;518;951;2943;1105;3461
311550;201310;3216;10819;2860;10111;994;3910;887;3058;1881;6968
311560;201310;256;711;237;687;63;206;133;364;196;570
311570;201310;1920;5047;1675;4771;128;380;1427;4106;1555;4486
311580;201310;2067;4924;1879;4707;596;1445;1066;2745;1662;4190
311590;201310;359;1201;319;1142;92;390;87;303;179;693
311600;201310;1309;4016;1139;3791;247;829;660;2325;907;3154
311610;201310;3516;12351;3265;11940;938;3402;1619;6395;2557;9797
311615;201310;2568;8730;2281;8232;300;1172;1599;5844;1899;7016
311620;201310;442;1454;398;1389;112;463;193;634;305;1097
311630;201310;1446;4383;1233;3978;330;1064;604;1984;934;3048
311640;201310;872;2747;744;2537;106;394;557;1898;663;2292
311650;201310;2406;7090;2023;6463;329;1194;1187;3845;1516;5039
311660;201310;2503;9054;2253;8450;695;2921;479;1556;1174;4477
311670;201310;1335;4309;1188;4036;473;1778;448;1449;921;3227
311680;201310;2243;7225;1912;6752;485;1821;1064;3842;1549;5663
311690;201310;510;1451;434;1366;86;302;274;847;360;1149
311700;201310;2125;6361;1913;6053;210;843;1451;4496;1661;5339
311710;201310;1614;5209;1311;4642;590;2280;348;1199;938;3479
311720;201310;402;1398;378;1356;77;278;246;876;323;1154
311730;201310;4694;13101;3151;10310;989;3561;1108;3384;2097;6945
311740;201310;1002;2924;875;2774;386;1221;373;1258;759;2479
311750;201310;3761;13065;3525;12736;627;2544;2340;8458;2967;11002
311760;201310;787;2776;733;2652;261;1089;236;720;497;1809
311770;201310;2584;8341;2153;7576;653;2561;707;2398;1360;4959
311780;201310;962;3706;831;3358;290;1303;120;470;410;1773
311783;201310;2032;6823;1823;6435;212;927;1199;4325;1411;5252
311787;201310;677;2379;507;1885;118;457;104;347;222;804
311790;201310;1215;4055;1017;3636;301;1156;221;768;522;1924
311800;201310;3843;13483;2697;9827;727;2854;230;662;957;3516
311810;201310;1028;3516;995;3456;43;210;868;2965;911;3175
311820;201310;813;2729;695;2458;241;969;304;975;545;1944
311830;201310;10196;37428;9404;35386;3950;15606;2092;7797;6042;23403
311840;201310;3388;10322;2907;9582;1026;3683;1069;3435;2095;7118
311850;201310;309;963;268;897;71;257;125;415;196;672
311860;201310;54794;179775;48915;168121;15244;56950;19946;66725;35190;123675
311870;201310;2273;7008;1876;6242;501;1913;651;2041;1152;3954
311880;201310;6732;21201;6259;20586;943;3202;4457;15159;5400;18361
311890;201310;1563;5063;1331;4568;435;1643;518;1716;953;3359
311900;201310;792;2525;716;2413;155;529;435;1545;590;2074
311910;201310;4634;14020;3807;12841;1209;4441;1529;5205;2738;9646
311920;201310;2005;6740;1757;6379;221;922;1237;4441;1458;5363
311930;201310;4706;14523;4246;13753;1601;5645;1330;4294;2931;9939
311940;201310;13029;41295;11445;38014;4079;14875;2928;9324;7007;24199
311950;201310;2208;6771;1938;6432;148;502;1615;5420;1763;5922
311960;201310;367;1328;335;1258;123;496;110;396;233;892
311970;201310;453;1682;401;1570;140;594;63;233;203;827
311980;201310;743;2128;579;1882;138;479;269;904;407;1383
311990;201310;469;1511;437;1456;189;661;127;402;316;1063
311995;201310;1003;3153;789;2681;232;884;217;629;449;1513
312000;201310;669;2162;642;2121;118;451;380;1252;498;1703
312010;201310;1021;3326;933;3159;198;732;432;1449;630;2181
312015;201310;1563;4920;1362;4573;212;857;825;2764;1037;3621
312020;201310;899;2991;809;2862;228;909;419;1442;647;2351
312030;201310;1742;5392;1578;5178;290;1086;1099;3536;1389;4622
312040;201310;702;2738;640;2574;253;1100;162;643;415;1743
312050;201310;1489;5192;1281;4728;408;1661;260;906;668;2567
312060;201310;745;2329;672;2238;211;764;364;1174;575;1938
312070;201310;914;2917;620;2256;177;710;222;782;399;1492
312080;201310;2608;7462;2064;6587;505;1950;925;2662;1430;4612
312083;201310;892;2710;765;2528;99;388;487;1593;586;1981
312087;201310;2264;7084;2031;6767;411;1434;1325;4491;1736;5925
312090;201310;9637;31999;8899;30695;2813;10795;3689;12146;6502;22941
312100;201310;1348;4650;1208;4431;283;1166;647;2434;930;3600
312110;201310;1161;4243;1041;3978;384;1603;198;690;582;2293
312120;201310;885;3142;801;2951;266;1112;205;660;471;1772
312125;201310;1157;3836;1035;3556;280;1062;422;1422;702;2484
312130;201310;777;2442;641;2157;172;660;240;764;412;1424
312140;201310;1201;3861;1030;3446;256;935;392;1206;648;2141
312150;201310;590;1721;516;1577;70;259;322;946;392;1205
312160;201310;7817;27575;7226;26336;2435;9681;2583;9545;5018;19226
312170;201310;1001;3097;913;2915;144;496;570;1854;714;2350
312180;201310;1568;5010;1474;4855;465;1604;592;1947;1057;3551
312190;201310;629;2131;502;1881;208;873;98;330;306;1203
312200;201310;4550;14281;4007;13312;577;2030;2702;9047;3279;11077
312210;201310;1143;3238;925;2908;246;866;412;1248;658;2114
312220;201310;1841;6198;1675;6004;302;1113;1182;4427;1484;5540
312230;201310;17438;59715;14932;54495;7206;27912;2616;9782;9822;37694
312235;201310;1740;5075;1439;4589;201;773;952;3039;1153;3812
312240;201310;1097;3823;938;3485;296;1168;309;1149;605;2317
312245;201310;2362;7070;2074;6666;179;524;1693;5583;1872;6107
312247;201310;878;2685;693;2396;216;814;335;1187;551;2001
312250;201310;1116;3390;998;3185;220;793;498;1546;718;2339
312260;201310;888;3001;774;2850;114;525;543;1963;657;2488
312270;201310;775;2532;677;2334;186;775;221;638;407;1413
312280;201310;466;1627;424;1521;178;685;46;158;224;843
312290;201310;741;2624;691;2547;305;1252;138;499;443;1751
312300;201310;1084;3677;921;3302;309;1168;123;386;432;1554
312310;201310;931;3631;844;3407;278;1218;343;1347;621;2565
312320;201310;2393;6890;1981;6095;570;2015;573;1487;1143;3502
312330;201310;1097;3458;1001;3311;348;1299;429;1394;777;2693
312340;201310;308;830;288;801;53;196;200;511;253;707
312350;201310;372;989;348;958;50;161;275;723;325;884
312352;201310;1603;5441;1501;5294;509;1819;789;2866;1298;4685
312360;201310;3597;12465;3167;11550;1073;4206;752;2719;1825;6925
312370;201310;1633;5465;1518;5259;522;2002;564;1884;1086;3886
312380;201310;1951;5884;1807;5655;281;954;1222;3922;1503;4876
312385;201310;1179;3839;1120;3728;166;675;771;2468;937;3143
312390;201310;1987;6840;1746;6337;593;2315;379;1326;972;3641
312400;201310;3308;11254;3049;10761;1042;3779;1363;4982;2405;8761
312410;201310;10290;35427;9296;33353;2956;11516;3141;10967;6097;22483
312420;201310;3930;12993;3756;12789;705;2473;2587;9050;3292;11523
312430;201310;8362;25608;7426;24202;1437;4936;4686;15771;6123;20707
312440;201310;554;1891;493;1774;174;670;180;630;354;1300
312450;201310;1130;4287;1061;4133;507;1981;323;1281;830;3262
312460;201310;385;1214;346;1165;90;353;168;531;258;884
312470;201310;735;2152;508;1687;138;535;104;335;242;870
312480;201310;1263;3999;1100;3805;418;1518;447;1528;865;3046
312490;201310;2308;6170;1852;5574;302;1093;1098;3186;1400;4279
312500;201310;589;2122;557;2064;163;700;269;962;432;1662
312510;201310;1898;6770;1694;6298;516;2180;546;1820;1062;4000
312520;201310;377;1325;334;1230;119;466;111;415;230;881
312530;201310;559;1892;532;1831;111;457;287;929;398;1386
312540;201310;1444;4757;1195;4258;211;859;695;2418;906;3277
312550;201310;612;2019;550;1888;77;306;346;1154;423;1460
312560;201310;2090;5772;1866;5472;261;853;1361;4039;1622;4892
312570;201310;2619;8304;2330;7758;770;2752;694;2237;1464;4989
312580;201310;521;1788;426;1595;115;500;172;605;287;1105
312590;201310;1810;6311;1593;5826;549;2261;512;1696;1061;3957
312595;201310;1994;6924;1791;6423;470;1796;861;3045;1331;4841
312600;201310;758;2816;700;2683;224;963;259;925;483;1888
312610;201310;8386;26959;7247;24673;2752;10099;2051;6722;4803;16821
312620;201310;1979;5902;1540;5335;92;296;1294;4655;1386;4951
312630;201310;500;1710;460;1631;131;532;193;646;324;1178
312640;201310;563;1908;473;1710;119;500;192;644;311;1144
312650;201310;2305;7036;1666;5794;199;830;890;3045;1089;3875
312660;201310;1213;3494;1051;3279;206;770;644;1944;850;2714
312670;201310;5854;18772;5482;18184;1192;4601;3196;10358;4388;14959
312675;201310;1429;4653;1292;4381;266;982;676;2324;942;3306
312680;201310;1691;5265;1511;4950;258;980;891;2948;1149;3928
312690;201310;2374;6681;1994;6151;429;1550;1082;3198;1511;4748
312695;201310;880;3210;828;3133;150;578;545;2123;695;2701
312700;201310;2154;6443;1655;5465;341;1305;842;2721;1183;4026
312705;201310;1364;4173;1212;3963;202;697;822;2703;1024;3400
312707;201310;1804;5656;1512;5159;317;1252;761;2559;1078;3811
312710;201310;7835;22861;5977;19543;2384;8650;1384;4183;3768;12833
312720;201310;752;2578;682;2443;203;806;270;902;473;1708
312730;201310;1838;4777;1433;4325;219;780;916;2765;1135;3545
312733;201310;1752;4817;1372;4106;127;480;982;2815;1109;3295
312735;201310;862;2654;763;2497;296;1014;319;1048;615;2062
312737;201310;996;2498;728;2132;227;694;317;987;544;1681
312738;201310;498;1640;404;1462;146;622;148;474;294;1096
312740;201310;498;1440;339;1229;124;500;94;334;218;834
312750;201310;1270;4744;1217;4634;347;1479;557;2083;904;3562
312760;201310;2385;7884;1910;6961;627;2546;449;1643;1076;4189
312770;201310;43302;122421;34116;108453;10447;36068;11121;35293;21568;71361
312780;201310;2622;9634;2367;9185;538;2272;1318;5256;1856;7528
312790;201310;349;972;239;778;74;259;68;205;142;464
312800;201310;5003;17533;4447;16361;1492;5939;1376;5139;2868;11078
312810;201310;2137;6724;1641;5881;595;2337;349;1184;944;3521
312820;201310;2086;6407;1938;6149;275;1039;1245;3813;1520;4852
312825;201310;1510;4215;1339;4001;145;471;1059;3151;1204;3622
312830;201310;2645;8656;1953;7251;628;2620;284;992;912;3612
312840;201310;1125;3844;949;3498;248;1053;346;1196;594;2249
312850;201310;684;2287;595;2103;192;773;183;623;375;1396
312860;201310;1305;3842;1014;3402;358;1405;345;1020;703;2425
312870;201310;5541;17840;4352;15566;1329;5411;1217;4110;2546;9521
312880;201310;1143;3517;956;3188;290;1113;390;1193;680;2306
312890;201310;1532;4840;1231;4278;453;1768;407;1341;860;3109
312900;201310;1341;4620;1303;4568;447;1595;638;2301;1085;3896
312910;201310;1454;3472;1177;3106;340;1077;523;1260;863;2337
312920;201310;973;3243;862;3071;304;1210;334;1140;638;2350
312930;201310;2144;6579;1934;6265;453;1581;1007;3319;1460;4900
312940;201310;911;3136;816;2947;244;1032;250;837;494;1869
312950;201310;3426;9908;2808;8981;997;3477;1132;3611;2129;7088
312960;201310;1885;5895;1698;5640;236;794;1254;4269;1490;5063
312965;201310;1712;5706;1493;5303;353;1368;794;2881;1147;4249
312970;201310;1109;3890;997;3738;441;1851;171;634;612;2485
312980;201310;20422;73246;19694;71468;7912;30631;7027;24778;14939;55409
312990;201310;389;1233;305;1078;118;469;89;300;207;769
313000;201310;502;1775;464;1703;155;674;137;435;292;1109
313005;201310;2555;8517;2279;8048;348;1409;1476;5184;1824;6593
313010;201310;3866;13297;3480;12611;1116;4446;1344;4591;2460;9037
313020;201310;1035;3582;947;3389;318;1293;313;978;631;2271
313030;201310;1545;4469;1253;4059;347;1291;643;1964;990;3255
313040;201310;952;3414;810;2996;214;873;206;729;420;1602
313050;201310;1808;6102;1530;5648;517;2100;515;1818;1032;3918
313055;201310;1443;4982;1354;4848;145;516;1027;3805;1172;4321
313060;201310;918;3277;869;3171;420;1583;144;523;564;2106
313065;201310;1884;6457;1758;6264;265;1096;1283;4513;1548;5609
313070;201310;1159;3566;996;3263;267;1034;505;1542;772;2576
313080;201310;455;1467;374;1310;118;472;97;282;215;754
313090;201310;5079;15975;4836;15554;844;2954;3230;10522;4074;13476
313100;201310;1076;3553;1006;3448;173;671;690;2317;863;2988
313110;201310;1659;5087;1326;4454;346;1385;516;1592;862;2977
313115;201310;2849;10222;2717;9940;928;3769;1166;4014;2094;7783
313120;201310;3748;11082;3222;10290;1175;3974;1323;4292;2498;8266
313130;201310;25425;83272;23172;78503;7214;27113;8321;26700;15535;53813
313140;201310;738;1960;545;1648;54;201;340;1006;394;1207
313150;201310;1635;5218;1484;4951;667;2296;404;1408;1071;3704
313160;201310;1167;3595;1052;3418;239;907;604;1869;843;2776
313170;201310;9621;35985;8923;34212;3611;14393;1899;7343;5510;21736
313180;201310;2648;7166;2058;6388;666;2328;687;2065;1353;4393
313190;201310;3427;12944;3283;12590;981;3993;1322;5073;2303;9066
313200;201310;1476;4741;1320;4493;212;881;832;2813;1044;3694
313210;201310;4520;14670;3888;13800;992;3991;1987;6945;2979;10936
313220;201310;1201;3777;976;3309;275;1067;242;724;517;1791
313230;201310;2504;8986;2359;8763;427;1674;1485;5723;1912;7397
313240;201310;7657;27081;6723;25254;2103;8579;2631;9892;4734;18471
313250;201310;7561;24387;6977;23498;1144;3887;4518;15752;5662;19639
313260;201310;591;1915;500;1727;150;590;137;445;287;1035
313270;201310;5366;16392;4911;15691;899;3025;3237;10496;4136;13521
313280;201310;510;1773;443;1614;114;483;162;566;276;1049
313290;201310;1020;3761;864;3420;283;1199;215;792;498;1991
313300;201310;1928;6754;1688;6151;556;2196;404;1368;960;3564
313310;201310;1039;3749;952;3551;287;1216;217;751;504;1967
313320;201310;2352;7372;2010;6767;473;1702;845;2858;1318;4560
313330;201310;3833;12888;3454;12158;774;3105;1650;5753;2424;8858
313340;201310;2154;5306;1693;4652;376;1113;958;2568;1334;3681
313350;201310;3292;10466;2563;8801;710;2630;499;1537;1209;4167
313360;201310;1184;3709;922;3189;323;1304;374;1147;697;2451
313370;201310;1438;5121;1359;4894;311;1292;580;1923;891;3215
313375;201310;1971;5391;1357;4503;328;1299;567;1872;895;3171
313380;201310;6586;23059;5744;21178;2350;9277;1465;5099;3815;14376
313390;201310;888;3325;854;3266;139;634;550;2055;689;2689
313400;201310;3690;11124;3413;10784;440;1496;2610;8338;3050;9834
313410;201310;1338;3927;1147;3662;257;911;682;2168;939;3079
313420;201310;18807;47790;12284;35962;3127;10384;3002;8409;6129;18793
313430;201310;1292;4299;1165;4073;384;1496;406;1364;790;2860
313440;201310;6452;15859;4933;14107;782;2432;3481;9988;4263;12420
313450;201310;706;2159;584;1912;159;641;203;587;362;1228
313460;201310;2645;9582;2388;9091;890;3657;705;2576;1595;6233
313470;201310;3389;9700;3243;9531;387;1039;2646;7996;3033;9035
313480;201310;1124;3405;868;2936;175;676;373;1210;548;1886
313490;201310;1388;4868;1101;4335;465;1814;229;943;694;2757
313500;201310;436;1419;415;1382;98;375;243;787;341;1162
313505;201310;8692;26265;8222;25686;553;1360;7259;23469;7812;24829
313507;201310;1281;3941;1157;3749;269;991;652;2131;921;3122
313510;201310;15674;47764;14191;45899;2513;8539;9843;32508;12356;41047
313520;201310;15774;49071;13671;45619;2077;8074;9028;29966;11105;38040
313530;201310;526;1873;466;1725;71;302;200;703;271;1005
313535;201310;2492;7644;2240;7225;399;1382;1401;4582;1800;5964
313540;201310;1146;3674;929;3139;287;1043;244;756;531;1799
313545;201310;1357;5089;1213;4833;236;1109;750;2898;986;4007
313550;201310;1912;6721;1841;6564;523;2023;959;3303;1482;5326
313560;201310;2285;5795;2028;5496;235;622;1580;4445;1815;5067
313570;201310;788;2988;702;2808;276;1218;239;896;515;2114
313580;201310;6039;17663;5368;16765;711;2366;4019;12697;4730;15063
313590;201310;1058;3256;871;3037;350;1230;447;1624;797;2854
313600;201310;3806;11913;3389;11228;647;2377;2011;6756;2658;9133
313610;201310;1148;3676;994;3361;279;1040;406;1340;685;2380
313620;201310;7407;25262;6981;24337;2457;9103;2309;7911;4766;17014
313630;201310;8290;26722;7310;25242;2381;9004;2532;9077;4913;18081
313640;201310;838;2724;739;2589;276;1032;277;970;553;2002
313650;201310;2273;7577;2027;7171;307;1134;1453;5260;1760;6394
313652;201310;1006;3683;929;3519;184;740;548;2094;732;2834
313655;201310;938;3220;797;2981;206;882;464;1682;670;2564
313657;201310;1115;3833;1045;3704;172;789;666;2133;838;2922
313660;201310;872;3120;806;3001;231;993;401;1423;632;2416
313665;201310;2986;10120;2780;9679;705;2796;1290;4309;1995;7105
313670;201310;51164;152628;36977;128352;12505;47460;11269;37978;23774;85438
313680;201310;1102;3355;978;3164;122;415;703;2302;825;2717
313690;201310;899;3302;836;3191;232;900;342;1366;574;2266
313695;201310;1473;4970;1279;4660;194;835;897;3242;1091;4077
313700;201310;3828;13073;3274;12312;508;2028;2317;8813;2825;10841
313710;201310;1379;3953;1174;3657;385;1319;544;1622;929;2941
313720;201310;5190;17861;4547;16461;1322;5337;1393;4560;2715;9897
313730;201310;1246;3542;1015;3246;149;524;673;2175;822;2699
313740;201310;2024;7498;1682;6569;625;2734;216;786;841;3520
313750;201310;2909;9122;2578;8475;854;3073;695;2093;1549;5166
313753;201310;1811;5623;1553;5170;485;1740;612;2060;1097;3800
313760;201310;4482;15255;3878;13971;1343;5367;1121;3828;2464;9195
313770;201310;3618;12421;3441;12008;1260;4670;991;3452;2251;8122
313780;201310;3823;11225;3123;10155;895;3304;1336;4202;2231;7506
313790;201310;551;1959;534;1930;111;426;312;1142;423;1568
313800;201310;1243;3619;1115;3411;189;665;692;2098;881;2763
313810;201310;1464;4603;1408;4517;260;872;923;3014;1183;3886
313820;201310;12834;38663;10687;34743;3341;12046;3650;11805;6991;23851
313830;201310;475;1687;411;1546;148;629;120;431;268;1060
313835;201310;1059;3633;1018;3565;234;893;563;1971;797;2864
313840;201310;7313;22753;6298;21082;1981;7438;2121;6834;4102;14272
313850;201310;1245;3577;1136;3386;255;899;635;1786;890;2685
313860;201310;2582;8283;2255;7581;702;2627;521;1584;1223;4211
313862;201310;995;2842;720;2385;232;846;190;609;422;1455
313865;201310;2195;7158;2055;6912;325;1249;1434;4767;1759;6016
313867;201310;1014;3590;872;3289;309;1221;294;1127;603;2348
313868;201310;1511;5506;1373;5207;184;811;905;3442;1089;4253
313870;201310;915;2903;811;2728;231;899;340;1062;571;1961
313880;201310;2268;7404;2070;7116;503;2052;1052;3335;1555;5387
313890;201310;1981;5541;1701;5185;306;953;1082;3362;1388;4315
313900;201310;4589;17175;4312;16569;1710;7224;1153;4379;2863;11603
313910;201310;758;2637;651;2401;297;1194;121;409;418;1603
313920;201310;3559;11823;3321;11393;541;1902;2135;7638;2676;9540
313925;201310;2111;5753;1601;4818;140;488;1080;3226;1220;3714
313930;201310;5210;17582;4436;16233;857;3456;2571;9607;3428;13063
313940;201310;7825;27760;6802;26086;2551;10522;2392;9457;4943;19979
313950;201310;4682;14110;3981;12934;1302;4774;1295;3990;2597;8764
313960;201310;5871;16496;4957;15198;1727;5954;1289;3934;3016;9888
313970;201310;1475;4440;1252;4188;271;983;779;2623;1050;3606
313980;201310;1189;4047;1031;3748;325;1328;290;1004;615;2332
313990;201310;1998;7717;1800;7265;697;3034;490;1852;1187;4886
314000;201310;7887;27871;7336;26791;2200;8860;3732;13403;5932;22263
314010;201310;1059;3174;887;2957;178;706;460;1466;638;2172
314015;201310;1582;6034;1461;5753;555;2297;421;1677;976;3974
314020;201310;486;1612;418;1460;154;594;125;409;279;1003
314030;201310;839;2754;673;2369;154;627;221;716;375;1343
314040;201310;653;1978;581;1851;192;665;286;872;478;1537
314050;201310;1885;6289;1579;5637;508;2026;440;1434;948;3460
314053;201310;1398;4877;1342;4802;246;845;948;3514;1194;4359
314055;201310;2203;6734;1987;6428;218;713;1486;4928;1704;5641
314060;201310;1078;3553;943;3304;145;605;577;1981;722;2586
314070;201310;3655;12037;2997;10642;946;3712;802;2711;1748;6423
314080;201310;1839;5869;1353;4820;305;1214;329;1075;634;2289
314085;201310;1827;6567;1593;6238;549;2378;574;2251;1123;4629
314090;201310;3456;12099;3157;11520;1069;4212;1162;4345;2231;8557
314100;201310;3463;9570;3043;8963;397;1189;2285;6857;2682;8046
314110;201310;4391;14829;3876;13721;1056;4280;1438;4697;2494;8977
314120;201310;1012;2506;566;1801;205;748;141;415;346;1163
314130;201310;662;1966;412;1396;105;397;78;236;183;633
314140;201310;5010;16115;4549;15247;1119;4021;2230;7549;3349;11570
314150;201310;1678;4627;1350;4129;234;803;806;2440;1040;3243
314160;201310;2294;6428;1948;5984;177;599;1592;4930;1769;5529
314170;201310;1039;3342;897;3033;181;719;465;1491;646;2210
314180;201310;6410;21107;5824;20226;1678;6382;2631;9280;4309;15662
314190;201310;808;2625;717;2471;234;924;272;892;506;1816
314200;201310;3033;10075;2764;9587;452;1788;1830;6264;2282;8052
314210;201310;1936;6273;1745;5897;465;1685;829;2726;1294;4411
314220;201310;1715;5748;1458;5181;508;1995;348;1062;856;3057
314225;201310;1162;3658;1051;3499;68;182;940;3198;1008;3380
314230;201310;694;2469;644;2367;203;808;225;798;428;1606
314240;201310;1120;3638;1010;3460;257;867;601;2135;858;3002
314250;201310;507;1592;422;1413;146;548;143;433;289;981
314260;201310;1295;4774;1241;4657;421;1678;505;1926;926;3604
314270;201310;2698;9566;2542;9284;351;1423;1699;6249;2050;7672
314280;201310;3215;9471;2374;7856;765;2916;648;1887;1413;4803
314290;201310;5310;15319;4574;14141;670;2241;3158;9816;3828;12057
314300;201310;1938;6681;1811;6384;643;2432;674;2303;1317;4735
314310;201310;6416;21094;5662;19477;2370;8694;1280;4241;3650;12935
314315;201310;967;3751;899;3616;164;742;523;2132;687;2874
314320;201310;3301;10347;2750;9561;1021;3894;940;3186;1961;7080
314330;201310;52364;174174;49716;169333;16160;59838;22005;73992;38165;133830
314340;201310;2301;6605;1352;4600;369;1439;172;390;541;1829
314345;201310;1278;4477;1144;4261;374;1450;548;2126;922;3576
314350;201310;1355;4153;1132;3789;476;1738;285;937;761;2675
314360;201310;696;2281;538;1972;168;719;129;439;297;1158
314370;201310;551;1995;518;1953;169;692;258;962;427;1654
314380;201310;1033;3286;814;2906;336;1255;223;811;559;2066
314390;201310;15084;46947;12667;42235;4278;15511;3690;11981;7968;27492
314400;201310;5343;15437;4396;14114;1330;4261;2462;8263;3792;12524
314410;201310;2484;8336;2216;7771;738;2897;831;2740;1569;5637
314420;201310;765;2289;632;2102;98;401;466;1524;564;1925
314430;201310;8097;24710;7277;23188;2545;8836;2256;7325;4801;16161
314435;201310;1169;3987;1056;3757;206;911;603;2036;809;2947
314437;201310;1170;3080;1043;2897;100;283;815;2276;915;2559
314440;201310;743;2085;521;1788;198;755;111;356;309;1111
314450;201310;1716;5214;1485;4882;496;1902;661;2010;1157;3912
314460;201310;4580;16283;4106;15216;1480;5969;777;2894;2257;8863
314465;201310;2359;7734;2171;7384;234;963;1633;5455;1867;6418
314467;201310;1079;3222;961;3029;393;1291;385;1236;778;2527
314470;201310;2378;7967;1856;6703;578;2410;401;1201;979;3611
314480;201310;7190;25369;5412;20444;1388;5644;548;1874;1936;7518
314490;201310;929;2947;805;2701;244;951;336;1057;580;2008
314500;201310;2758;8033;2246;7034;711;2481;761;2354;1472;4835
314505;201310;1765;5623;1670;5449;406;1460;937;3042;1343;4502
314510;201310;1560;4944;1300;4498;532;1966;350;1208;882;3174
314520;201310;3733;14666;3122;12971;1166;5281;569;2149;1735;7430
314530;201310;7177;26017;6609;25082;1253;4979;3993;15665;5246;20644
314535;201310;2676;7975;2407;7616;374;1336;1615;5144;1989;6480
314537;201310;1419;4423;1203;4038;275;1052;584;2013;859;3065
314540;201310;462;1457;403;1323;129;486;126;389;255;875
314545;201310;1342;4414;1211;4206;279;1058;622;2153;901;3211
314550;201310;511;1650;434;1536;153;626;113;378;266;1004
314560;201310;5239;19077;4565;17272;1344;5535;1017;3769;2361;9304
314570;201310;374;1199;335;1119;98;356;160;510;258;866
314580;201310;452;1600;392;1480;157;664;94;343;251;1007
314585;201310;650;2358;545;2141;173;739;146;563;319;1302
314587;201310;1709;5634;1559;5344;281;1030;878;3010;1159;4040
314590;201310;4151;14739;3093;11781;804;3285;393;1351;1197;4636
314600;201310;2081;7314;1742;6698;674;2894;317;1118;991;4012
314610;201310;8174;29941;7680;28732;2607;10543;2409;8722;5016;19265
314620;201310;1640;5161;1532;5027;232;743;1140;3863;1372;4606
314625;201310;1524;5032;1485;4981;242;893;1006;3416;1248;4309
314630;201310;5064;15414;4436;14376;672;2450;2996;9857;3668;12307
314640;201310;827;2423;705;2200;250;851;197;572;447;1423
314650;201310;1261;3950;1022;3483;282;1128;429;1312;711;2440
314655;201310;1686;5109;1314;4408;275;971;657;2205;932;3176
314660;201310;176;504;152;455;26;93;93;271;119;364
314670;201310;1430;4107;1185;3679;231;798;648;1983;879;2781
314675;201310;1899;5913;1693;5548;237;879;1094;3640;1331;4519
314690;201310;2715;8843;2315;8107;740;2949;685;2224;1425;5173
314700;201310;9859;38298;8956;36365;4228;17950;1984;8411;6212;26361
314710;201310;8108;26868;5796;21537;1523;6352;732;2514;2255;8866
314720;201310;2643;9047;2228;8206;730;2977;888;3206;1618;6183
314730;201310;2409;7735;2089;7267;766;2999;665;2175;1431;5174
314740;201310;2948;10250;2737;9842;916;3565;998;3466;1914;7031
314750;201310;318;1078;294;1021;68;293;147;475;215;768
314760;201310;1843;6673;1411;5507;355;1588;258;821;613;2409
314770;201310;1199;3888;785;2756;111;456;108;304;219;760
314780;201310;301;863;229;763;87;319;85;278;172;597
314790;201310;13294;41824;10271;36266;4214;16855;2359;7714;6573;24569
314795;201310;1519;4714;1355;4449;152;666;1023;3208;1175;3874
314800;201310;16977;53073;14231;47554;5955;20913;2840;9690;8795;30603
314810;201310;12746;39420;10054;34402;3334;12834;2445;8241;5779;21075
314820;201310;1095;3143;775;2668;305;1160;232;729;537;1889
314830;201310;1660;5814;1455;5401;564;2288;495;1833;1059;4121
314840;201310;1133;4046;909;3705;183;869;540;2199;723;3068
314850;201310;2210;6571;1893;6054;408;1515;1031;3243;1439;4758
314860;201310;3259;11480;3019;11076;619;2532;1820;6669;2439;9201
314870;201310;5636;18752;5084;17980;864;3455;3434;12310;4298;15765
314875;201310;1664;5847;1628;5792;287;980;1237;4517;1524;5497
314880;201310;784;2400;713;2264;84;293;494;1565;578;1858
314890;201310;592;1880;437;1556;138;549;103;307;241;856
314900;201310;395;1280;325;1159;103;397;146;507;249;904
314910;201310;1651;5922;1461;5571;563;2323;282;1035;845;3358
314915;201310;2471;7933;2202;7548;230;931;1765;6018;1995;6949
314920;201310;652;1938;494;1700;101;397;224;722;325;1119
314930;201310;5083;17722;4461;16321;1550;6189;968;3490;2518;9679
314940;201310;406;1237;382;1192;88;281;207;640;295;921
314950;201310;365;1326;324;1235;97;423;68;237;165;660
314960;201310;782;2628;661;2374;213;833;168;572;381;1405
314970;201310;851;3105;763;2906;310;1282;192;690;502;1972
314980;201310;2215;6918;2018;6589;850;2961;295;918;1145;3879
314990;201310;3078;10174;2511;8859;969;3723;424;1334;1393;5057
314995;201310;1527;4945;1405;4771;274;1108;894;2922;1168;4030
315000;201310;982;3055;851;2874;167;669;532;1751;699;2420
315010;201310;479;1583;402;1412;131;539;139;427;270;966
315015;201310;1816;5776;1699;5636;346;1215;1160;3966;1506;5181
315020;201310;732;2471;662;2336;198;797;258;813;456;1610
315030;201310;1003;3144;870;2896;353;1286;173;557;526;1843
315040;201310;929;2929;858;2812;123;444;602;1956;725;2400
315050;201310;1558;4807;1324;4394;481;1771;403;1274;884;3045
315053;201310;1120;3391;964;3135;271;1064;353;1058;624;2122
315057;201310;1896;6599;1559;6091;243;970;993;4035;1236;5005
315060;201310;939;3249;785;2841;244;965;195;731;439;1696
315070;201310;652;2017;606;1946;153;541;351;1090;504;1631
315080;201310;3445;12122;3158;11523;892;3522;1410;5132;2302;8654
315090;201310;748;2755;669;2595;190;813;220;884;410;1697
315100;201310;1166;4120;946;3617;282;1201;243;876;525;2077
315110;201310;1631;5078;1437;4744;437;1549;577;1881;1014;3430
315120;201310;13660;33703;9950;28906;1974;6271;5228;16035;7202;22306
315130;201310;1789;6056;1617;5704;597;2333;447;1537;1044;3870
315140;201310;2364;8136;1968;7234;594;2530;546;1734;1140;4264
315150;201310;4605;13093;3554;11191;924;3339;1344;4060;2268;7399
315160;201310;1364;3938;1236;3763;260;888;713;2132;973;3020
315170;201310;1348;4144;1170;3893;287;1063;648;2203;935;3266
315180;201310;13307;42615;10529;36567;3157;12435;2609;8637;5766;21072
315190;201310;2368;6471;1935;5824;610;1978;856;2588;1466;4566
315200;201310;4420;15210;3692;13586;1203;4855;1011;3582;2214;8437
315210;201310;8315;26494;7292;24601;2849;10329;2168;7117;5017;17446
315213;201310;1106;3668;1072;3614;98;303;902;3133;1000;3436
315217;201310;2691;9358;2286;8641;383;1623;1347;5141;1730;6764
315220;201310;9990;30235;8934;28818;1796;5962;5624;18565;7420;24527
315230;201310;2368;6577;2210;6389;141;390;1921;5642;2062;6032
315240;201310;3113;10558;2936;10257;627;2405;1730;6041;2357;8446
315250;201310;8698;28930;6792;25376;2426;10117;2086;7706;4512;17823
315260;201310;1053;3598;913;3277;369;1443;149;488;518;1931
315270;201310;865;3149;751;2897;257;1060;163;595;420;1655
315280;201310;3902;12245;3167;10571;1158;4094;772;2417;1930;6511
315290;201310;1316;3850;1041;3415;415;1507;176;565;591;2072
315300;201310;488;1458;396;1340;209;751;106;329;315;1080
315310;201310;1194;4101;1097;3942;154;627;737;2626;891;3253
315320;201310;804;2810;701;2662;245;988;295;1162;540;2150
315330;201310;831;3061;684;2738;293;1324;114;429;407;1753
315340;201310;4174;12349;3614;11491;772;2645;2002;6467;2774;9112
315350;201310;1836;5352;1537;4947;184;553;1184;3968;1368;4521
315360;201310;1657;5728;1363;4916;344;1324;440;1499;784;2823
315370;201310;618;1891;544;1779;132;492;296;941;428;1433
315380;201310;270;991;252;937;94;364;49;181;143;545
315390;201310;1939;7008;1676;6365;618;2518;363;1357;981;3875
315400;201310;4368;14115;4023;13439;1174;4197;1924;6531;3098;10728
315410;201310;1681;4819;1433;4404;319;1194;771;2251;1090;3445
315415;201310;1076;3699;999;3569;447;1635;377;1388;824;3023
315420;201310;1503;4818;1139;4132;345;1362;235;824;580;2186
315430;201310;3980;11148;3089;9645;811;2872;1113;3391;1924;6263
315440;201310;957;2996;873;2875;168;640;519;1711;687;2351
315445;201310;2115;6278;1811;5869;297;1113;1230;3980;1527;5093
315450;201310;2482;8077;2356;7892;463;1590;1570;5400;2033;6990
315460;201310;38459;131433;34419;122676;11794;45505;9252;31877;21046;77382
315470;201310;502;1612;464;1549;94;341;273;888;367;1229
315480;201310;1262;4179;942;3451;221;915;231;779;452;1694
315490;201310;3233;9415;2827;8854;562;2106;1647;4965;2209;7071
315500;201310;451;1485;305;1108;72;311;124;388;196;699
315510;201310;1458;4332;1265;4003;194;708;772;2403;966;3111
315520;201310;1134;3669;964;3436;185;758;592;2039;777;2797
315530;201310;488;1755;462;1712;226;881;136;481;362;1362
315540;201310;1282;3945;1016;3486;221;941;372;1231;593;2172
315550;201310;1628;4941;1429;4676;478;1719;625;2025;1103;3744
315560;201310;7031;23824;6496;23088;982;3883;4450;15839;5432;19722
315570;201310;2377;7626;2222;7385;443;1645;1371;4542;1814;6187
315580;201310;2674;8462;2193;7538;647;2624;793;2527;1440;5151
315590;201310;865;2601;809;2513;122;454;581;1779;703;2233
315600;201310;2552;9405;2153;8755;349;1554;1362;5749;1711;7303
315610;201310;966;2969;840;2692;220;836;292;785;512;1621
315620;201310;339;1217;332;1201;105;397;153;563;258;960
315630;201310;995;3265;857;3027;244;913;230;799;474;1712
315640;201310;730;2371;640;2180;238;934;188;576;426;1510
315645;201310;818;2711;724;2468;300;1119;144;460;444;1579
315650;201310;1802;5578;1692;5427;168;694;1296;4043;1464;4737
315660;201310;2633;7361;2407;7042;424;1358;1525;4435;1949;5793
315670;201310;11431;41710;10539;39889;4058;16507;3222;11930;7280;28437
315680;201310;2829;10137;2348;9196;920;3761;583;2406;1503;6167
315690;201310;3066;10148;2599;9291;968;3810;692;2448;1660;6258
315700;201310;7117;23454;6252;21647;1465;5810;3018;9979;4483;15789
315710;201310;1803;5497;1485;4987;235;945;856;2829;1091;3774
315720;201310;2903;9848;2651;9334;869;3438;940;3084;1809;6522
315725;201310;1616;5081;1311;4686;359;1282;752;2761;1111;4043
315727;201310;649;2120;585;1985;143;525;292;985;435;1510
315730;201310;974;3113;882;2922;224;788;448;1519;672;2307
315733;201310;1134;3726;1044;3527;469;1671;318;1053;787;2724
315737;201310;1348;4247;1155;3921;153;577;715;2460;868;3037
315740;201310;1017;3370;888;3115;267;1081;365;1177;632;2258
315750;201310;1109;3461;999;3308;112;471;725;2321;837;2792
315760;201310;921;2680;901;2651;28;74;849;2521;877;2595
315765;201310;1439;4630;1345;4474;186;656;994;3352;1180;4008
315770;201310;1642;5374;1503;5072;474;1735;537;1750;1011;3485
315780;201310;25692;86383;24041;82811;8731;31853;7646;26775;16377;58628
315790;201310;3127;11067;2872;10510;339;1211;1914;7267;2253;8478
315800;201310;1529;6092;1285;5357;422;1922;231;921;653;2843
315810;201310;1452;4296;1258;3974;274;918;729;2247;1003;3165
315820;201310;3028;10234;2616;9623;679;2644;1398;5237;2077;7881
315830;201310;1476;5073;1347;4780;348;1416;424;1430;772;2846
315840;201310;668;1915;533;1633;108;365;152;441;260;806
315850;201310;1333;4833;1288;4730;399;1529;503;1818;902;3347
315860;201310;415;1565;354;1427;118;540;78;312;196;852
315870;201310;465;1430;400;1326;112;414;156;484;268;898
315880;201310;1071;2997;904;2789;275;972;408;1217;683;2189
315890;201310;1615;5659;1469;5429;429;1627;757;2953;1186;4580
315895;201310;4972;15999;4635;15345;1485;5407;1952;6289;3437;11696
315900;201310;756;2494;698;2388;203;816;347;1075;550;1891
315910;201310;603;2203;557;2107;236;925;210;777;446;1702
315920;201310;1283;3992;1016;3418;324;1207;351;1101;675;2308
315930;201310;1089;3150;918;2837;297;992;291;868;588;1860
315935;201310;1146;3944;1072;3780;358;1385;339;1154;697;2539
315940;201310;622;2073;577;1997;169;642;283;955;452;1597
315950;201310;1208;3842;1130;3690;335;1123;623;2073;958;3196
315960;201310;2867;10130;2361;9056;1123;4901;225;773;1348;5674
315970;201310;809;2340;659;2118;84;270;487;1619;571;1889
315980;201310;3963;10358;2875;8472;826;2796;905;2344;1731;5140
315990;201310;4285;13163;3788;12362;892;3416;2037;6483;2929;9899
316000;201310;567;1910;497;1781;238;923;127;433;365;1356
316010;201310;446;1661;399;1548;118;531;86;275;204;806
316020;201310;1165;3861;936;3464;179;733;537;2033;716;2766
316030;201310;3606;10478;2647;8920;408;1525;1432;4933;1840;6458
316040;201310;3395;10802;2434;8542;449;1791;324;889;773;2680
316045;201310;2062;6874;1923;6652;288;910;1361;5019;1649;5929
316050;201310;354;1188;319;1134;66;263;184;645;250;908
316060;201310;774;2400;642;2216;125;535;377;1233;502;1768
316070;201310;5964;20395;5553;19548;1874;7263;2336;7853;4210;15116
316080;201310;723;2751;651;2551;172;759;149;582;321;1341
316090;201310;601;1827;462;1541;124;482;126;376;250;858
316095;201310;1218;4167;1132;3989;275;993;699;2536;974;3529
316100;201310;2816;9778;2317;8484;745;3010;449;1542;1194;4552
316105;201310;889;2585;690;2277;174;631;310;1040;484;1671
316110;201310;12222;44215;11116;42114;1508;6484;7865;30284;9373;36768
316120;201310;1259;4490;1207;4375;408;1514;497;1840;905;3354
316130;201310;1046;2676;821;2340;218;730;378;1053;596;1783
316140;201310;1059;3228;831;2842;154;576;477;1660;631;2236
316150;201310;1261;4042;1203;3948;323;1235;621;1952;944;3187
316160;201310;1214;3768;1008;3347;140;507;599;2014;739;2521
316165;201310;913;2633;793;2439;166;590;436;1299;602;1889
316170;201310;1360;4140;1056;3551;244;953;421;1298;665;2251
316180;201310;1200;3958;1004;3569;303;1258;304;1001;607;2259
316190;201310;2626;8137;1438;5086;326;1234;274;847;600;2081
316200;201310;4167;13712;3305;12050;983;4159;937;3225;1920;7384
316210;201310;4937;16416;4600;15710;2154;7883;953;3226;3107;11109
316220;201310;640;2037;480;1748;151;619;77;298;228;917
316225;201310;1063;3211;946;3046;153;572;626;1966;779;2538
316230;201310;440;1363;365;1226;68;250;203;690;271;940
316240;201310;6114;20109;5385;19211;675;2363;4164;15197;4839;17560
316245;201310;2949;10759;2802;10519;273;1231;2201;8244;2474;9475
316250;201310;8849;28651;7845;26544;3325;12069;2059;6601;5384;18670
316255;201310;2306;7544;2062;7253;340;1153;1462;5283;1802;6436
316257;201310;1294;3801;1034;3336;299;1099;377;1116;676;2215
316260;201310;1776;5216;1381;4654;380;1425;744;2514;1124;3939
316265;201310;1164;3464;1032;3189;93;336;741;2255;834;2591
316270;201310;5130;16915;4801;16236;1502;5539;1967;6695;3469;12234
316280;201310;3237;11096;2925;10466;652;2597;1485;5305;2137;7902
316290;201310;3083;10433;2890;10060;798;3149;1264;4137;2062;7286
316292;201310;3698;12583;3412;12010;1051;4148;1406;4653;2457;8801
316294;201310;766;2576;486;1867;124;564;65;236;189;800
316295;201310;1903;6902;1780;6636;469;2016;871;3033;1340;5049
316300;201310;913;3015;822;2843;92;339;555;1981;647;2320
316310;201310;688;2236;530;1895;133;533;185;650;318;1183
316320;201310;552;1893;490;1803;137;553;126;449;263;1002
316330;201310;945;2940;815;2697;164;547;470;1612;634;2159
316340;201310;1135;3786;1013;3540;364;1437;268;838;632;2275
316350;201310;1467;4921;1333;4689;283;1027;735;2746;1018;3773
316360;201310;759;2045;610;1847;77;232;461;1424;538;1656
316370;201310;4999;16862;4477;15780;1555;5887;1028;3686;2583;9573
316380;201310;1414;4080;1162;3695;143;508;790;2526;933;3034
316390;201310;892;2779;760;2547;281;1027;290;977;571;2004
316400;201310;1453;4953;1287;4636;360;1380;509;1889;869;3269
316410;201310;1203;4152;1128;4033;234;918;693;2481;927;3399
316420;201310;1993;6904;1853;6710;303;1226;1210;4447;1513;5673
316430;201310;902;2839;774;2618;255;948;275;893;530;1841
316440;201310;599;2076;536;1992;238;1005;191;651;429;1656
316443;201310;685;2134;581;1921;150;548;208;663;358;1211
316447;201310;1316;4507;1258;4401;186;725;973;3375;1159;4100
316450;201310;2190;7844;1955;7361;496;1896;1069;4173;1565;6069
316460;201310;841;2728;792;2651;220;843;437;1376;657;2219
316470;201310;7665;26145;6167;22626;2189;9101;1751;6000;3940;15101
316480;201310;252;894;224;836;67;265;70;251;137;516
316490;201310;360;1183;342;1140;121;433;141;458;262;891
316500;201310;1065;3960;754;3000;213;910;52;190;265;1100
316510;201310;938;3466;852;3296;362;1453;263;1016;625;2469
316520;201310;1167;3717;977;3425;286;1180;363;1154;649;2334
316530;201310;1183;3942;1003;3547;288;1219;401;1231;689;2450
316540;201310;1013;3372;912;3190;270;1119;317;992;587;2111
316550;201310;1254;4380;1157;4223;251;1017;727;2651;978;3668
316553;201310;2199;8234;1865;7378;678;2883;387;1471;1065;4354
316555;201310;2673;9696;2402;9374;250;963;1883;7565;2133;8528
316556;201310;582;1705;483;1511;53;207;321;955;374;1162
316557;201310;813;3041;790;3001;327;1283;320;1219;647;2502
316560;201310;369;1265;305;1113;78;345;83;264;161;609
316570;201310;1392;4537;1264;4262;252;935;659;2203;911;3138
316580;201310;266;810;227;743;74;262;79;231;153;493
316590;201310;1342;4101;1131;3710;219;857;627;1982;846;2839
316600;201310;1161;3871;1053;3644;194;741;613;2059;807;2800
316610;201310;596;2264;557;2191;143;651;316;1215;459;1866
316620;201310;2143;7084;1942;6661;523;1965;882;3006;1405;4971
316630;201310;1480;5099;1324;4753;568;2134;379;1370;947;3504
316640;201310;256;861;230;809;68;280;89;282;157;562
316650;201310;924;3695;826;3519;200;860;452;2034;652;2894
316660;201310;136;419;118;388;33;135;44;122;77;257
316670;201310;1768;5403;1444;4738;563;2093;323;918;886;3011
316680;201310;1922;5913;1703;5568;238;804;1291;4289;1529;5093
316690;201310;1117;3882;1012;3690;394;1609;318;1102;712;2711
316695;201310;1254;3950;1117;3709;114;370;745;2582;859;2952
316700;201310;353;1212;327;1145;81;327;157;513;238;840
316710;201310;3393;13264;2984;12326;1054;4486;921;4022;1975;8508
316720;201310;20010;69066;17260;62786;6413;24625;4420;15931;10833;40556
316730;201310;427;1393;374;1278;100;384;185;581;285;965
316740;201310;739;2615;672;2484;276;1113;179;624;455;1737
316750;201310;414;1487;384;1416;124;528;135;452;259;980
316760;201310;3568;12326;3069;11765;1822;7015;844;3468;2666;10483
316770;201310;1467;4486;1308;4265;228;819;858;2874;1086;3693
316780;201310;689;2430;648;2350;276;1067;162;570;438;1637
316790;201310;832;2491;628;2136;180;714;227;734;407;1448
316800;201310;5824;19889;5314;18907;1172;4893;2758;9394;3930;14287
316805;201310;885;2410;840;2353;142;384;621;1797;763;2181
316810;201310;530;1692;497;1634;149;543;230;737;379;1280
316820;201310;371;1106;266;927;115;436;46;147;161;583
316830;201310;582;2163;561;2116;218;878;201;736;419;1614
316840;201310;3330;9987;2826;9112;854;3142;1120;3409;1974;6551
316850;201310;2086;6798;1938;6532;476;1787;1030;3422;1506;5209
316860;201310;23518;75073;21538;71357;6279;23117;9569;31494;15848;54611
316870;201310;6946;23859;6169;21947;2391;9150;1362;4714;3753;13864
316880;201310;879;3032;851;2986;368;1417;242;798;610;2215
316890;201310;1414;3761;1132;3375;504;1657;374;1062;878;2719
316900;201310;2650;8600;2360;8003;766;2911;745;2276;1511;5187
316905;201310;421;1512;389;1440;172;673;111;397;283;1070
316910;201310;684;2419;574;2190;160;650;246;957;406;1607
316920;201310;1496;4688;1210;4207;194;748;609;2102;803;2850
316930;201310;9445;33312;8329;30957;2670;11279;2192;7697;4862;18976
316935;201310;4761;14572;3571;12462;1282;4983;885;2907;2167;7890
316940;201310;6694;23416;5819;21499;1624;6672;1662;5886;3286;12558
316950;201310;1483;4523;1317;4300;227;870;851;2735;1078;3605
316960;201310;5211;14022;4463;13054;1028;3281;2579;7499;3607;10780
316970;201310;3473;11728;3293;11395;1384;5352;839;2681;2223;8033
316980;201310;921;2981;756;2708;375;1425;194;700;569;2125
316990;201310;9730;33344;8898;31445;3776;14434;1370;4635;5146;19069
317000;201310;2515;9390;2444;9298;289;876;2024;8098;2313;8974
317005;201310;2362;7906;2275;7788;439;1559;1597;5530;2036;7089
317010;201310;28722;81196;19663;65174;5923;21817;4917;16836;10840;38653
317020;201310;44782;137350;31575;108936;8824;33605;7374;23722;16198;57327
317030;201310;870;2523;734;2317;133;514;416;1292;549;1806
317040;201310;12597;39549;11350;37214;4328;14892;4103;13696;8431;28588
317043;201310;806;2318;680;2145;203;697;335;1036;538;1733
317047;201310;1146;3140;906;2733;164;563;433;1293;597;1856
317050;201310;1801;6598;1584;6090;494;2090;509;1872;1003;3962
317052;201310;2339;7797;2092;7422;335;1284;1453;5229;1788;6513
317057;201310;1741;5199;1378;4562;246;978;691;2260;937;3238
317060;201310;385;1169;292;959;83;311;108;330;191;641
317065;201310;1209;4132;1092;3930;165;668;774;2776;939;3444
317070;201310;9230;31494;7400;27347;2414;9824;1706;6366;4120;16190
317075;201310;1232;3974;1102;3734;418;1541;376;1198;794;2739
317080;201310;6803;20251;6307;19444;2085;6981;2415;7489;4500;14470
317090;201310;4757;16709;4467;16158;759;2893;2969;10932;3728;13825
317100;201310;3226;9724;2813;9028;966;3455;1142;3461;2108;6916
317103;201310;1965;7047;1673;6411;379;1756;737;2773;1116;4529
317107;201310;1288;4164;1136;3854;288;1124;540;1735;828;2859
317110;201310;725;2031;516;1643;149;575;191;539;340;1114
317115;201310;1047;3439;938;3202;147;529;601;2057;748;2586
317120;201310;13014;45135;11332;41131;4020;15521;3998;14321;8018;29842
317130;201310;8813;28899;8040;27477;2318;8910;3454;11431;5772;20341
317140;201310;649;2306;609;2219;82;333;387;1406;469;1739
317150;201310;1031;2878;877;2696;120;438;625;1892;745;2330
317160;201310;3777;10430;2904;9303;446;1680;1893;5968;2339;7648
317170;201310;1902;5868;1801;5671;273;1005;1072;3231;1345;4236
317180;201310;1806;6319;1460;5510;437;1791;436;1607;873;3398
317190;201310;1259;3916;1165;3789;109;401;945;3067;1054;3468
317200;201310;4253;14747;4014;14215;1490;5733;1010;3429;2500;9162
317210;201310;1064;3440;913;3194;281;1093;395;1372;676;2465
317220;201310;346;1277;340;1268;129;484;167;645;296;1129
320010;201310;5871;18802;5237;17320;916;3311;2805;9251;3721;12562
320013;201310;1911;5788;1449;4978;217;802;854;2999;1071;3801
320016;201310;3424;9733;2959;9070;527;1640;1991;6215;2518;7855
320020;201310;4178;13828;3857;13119;1368;4957;1404;4787;2772;9744
320030;201310;1729;5780;1564;5396;467;1747;653;2176;1120;3923
320035;201310;1646;5361;1503;5088;543;1983;486;1626;1029;3609
320040;201310;3058;10576;2593;9455;730;2879;784;2801;1514;5680
320050;201310;1888;5367;1607;4804;332;1114;849;2463;1181;3577
320060;201310;10615;34264;8514;29392;2300;8807;2991;9763;5291;18570
320070;201310;1798;6156;1583;5634;518;1985;414;1355;932;3340
320080;201310;5427;16521;4456;14536;1408;4961;1477;4723;2885;9684
320090;201310;8406;24734;7043;22206;2072;7049;3188;9739;5260;16788
320100;201310;3237;9890;2681;8771;661;2348;1239;3959;1900;6307
320110;201310;1547;4782;1415;4519;396;1370;470;1468;866;2838
320115;201310;1891;7062;1831;6920;667;2569;917;3542;1584;6111
320120;201310;16786;58544;15081;55120;5744;22322;4210;15471;9954;37793
320130;201310;39014;133440;36730;128486;11604;43875;16305;55690;27909;99565
320140;201310;4052;13452;2898;10499;760;3030;337;1154;1097;4184
320150;201310;17783;51735;13325;43023;4465;15456;2176;6894;6641;22350
320160;201310;5305;16614;4664;15549;1273;4777;2099;6615;3372;11392
320170;201310;1962;6585;1803;6232;681;2437;555;1975;1236;4412
320180;201310;909;3032;819;2890;296;1107;324;1133;620;2240
320190;201310;4234;15670;3909;14786;1496;5889;1108;4179;2604;10068
320200;201310;1116;3721;1001;3477;310;1165;425;1492;735;2657
320210;201310;6285;17499;5463;16106;1392;4638;2753;7883;4145;12521
320220;201310;2756;8630;2173;7566;673;2574;764;2656;1437;5230
320225;201310;1422;5132;1250;4649;461;1843;252;944;713;2787
320230;201310;4228;14453;3959;13934;1347;5134;1432;5158;2779;10292
320240;201310;9695;30796;7852;27113;2626;9664;1919;6802;4545;16466
320245;201310;4147;14385;3906;13815;1258;4667;1607;5673;2865;10340
320250;201310;1729;5494;1317;4510;359;1371;294;918;653;2289
320255;201310;1997;6781;1734;6324;715;2777;602;2268;1317;5045
320260;201310;1329;4290;1103;3694;310;1152;407;1216;717;2368
320265;201310;2467;7676;2093;7219;279;997;1539;5465;1818;6462
320270;201310;2250;7535;2038;7038;544;2001;952;3265;1496;5266
320280;201310;7148;22007;6620;21157;1328;4584;3964;12771;5292;17355
320290;201310;1509;5268;1378;4891;538;1986;350;1157;888;3143
320300;201310;4464;15404;4171;14792;1223;4612;1857;6623;3080;11235
320305;201310;4594;15505;4214;14595;1150;4391;1897;6390;3047;10781
320310;201310;1955;6060;1781;5779;422;1489;969;3068;1391;4557
320313;201310;2264;7061;1687;5695;493;1918;285;849;778;2767
320316;201310;2220;7106;2104;6826;594;2033;953;3068;1547;5101
320320;201310;18264;60756;16099;56441;5019;19597;6501;22165;11520;41762
320330;201310;2828;8979;2519;8411;590;1979;1387;4787;1977;6766
320332;201310;4825;16794;4431;16063;1457;5541;1894;7056;3351;12597
320334;201310;1431;5094;1179;4453;423;1772;221;754;644;2526
320335;201310;2053;6350;1609;5391;584;2158;302;943;886;3101
320340;201310;5597;16337;4562;14516;1179;4191;2051;6420;3230;10611
320350;201310;5467;14344;4100;12058;882;2956;1913;5461;2795;8417
320360;201310;1730;4746;1348;4044;277;930;657;1857;934;2787
320370;201310;3435;11650;2999;10758;930;3496;1189;4282;2119;7778
320380;201310;2686;8545;2406;7973;614;2151;1179;3847;1793;5998
320390;201310;8104;25212;6878;22738;2036;7491;2585;8257;4621;15748
320400;201310;4125;12047;3522;11191;725;2570;2123;6597;2848;9167
320405;201310;4146;12530;3822;12092;1179;4153;2054;6324;3233;10477
320410;201310;6051;15465;4545;13728;741;2290;3139;9633;3880;11923
320420;201310;2270;7235;1789;6472;786;3054;292;1007;1078;4061
320425;201310;2451;6383;2026;5778;325;1121;1257;3540;1582;4661
320430;201310;2246;6838;2063;6496;401;1403;1110;3427;1511;4830
320435;201310;2149;7689;1972;7261;831;3168;730;2743;1561;5911
320440;201310;1487;5102;1340;4667;437;1640;400;1311;837;2951
320450;201310;2435;8060;2145;7440;646;2455;907;3045;1553;5500
320455;201310;4578;16633;3724;14444;1218;4923;735;2821;1953;7744
320460;201310;2891;9792;2417;8742;816;3182;722;2490;1538;5672
320465;201310;1508;5003;1264;4372;286;1037;503;1699;789;2736
320470;201310;4141;13252;3138;10993;1077;4106;488;1609;1565;5715
320480;201310;1948;5995;1630;5373;421;1605;688;2133;1109;3738
320490;201310;17504;56797;14823;51340;5210;19336;4941;17598;10151;36934
320495;201310;1283;4296;1144;3967;504;1873;309;1045;813;2918
320500;201310;42061;136463;37867;128423;13270;48570;15780;52202;29050;100772
320501;201310;3676;12387;3431;11945;1187;4633;1466;4926;2653;9559
320503;201310;2218;8283;1961;7552;702;2861;481;1699;1183;4560
320506;201310;3152;10180;2225;7743;688;2599;312;1018;1000;3617
320510;201310;8054;26410;7308;24904;2659;9649;2615;8786;5274;18435
320515;201310;2081;6040;1858;5607;516;1664;716;2160;1232;3824
320517;201310;2103;7234;1831;6591;677;2635;407;1389;1084;4024
320520;201310;31100;103346;27228;95645;9293;35870;11381;39623;20674;75493
320530;201310;27063;86927;23462;79469;6761;25865;9928;32027;16689;57892
330010;201310;15179;49469;14261;47516;3422;12940;8035;25586;11457;38526
330015;201310;1953;5580;1716;5118;536;1784;573;1626;1109;3410
330020;201310;16100;49633;14844;47569;3828;13205;8018;25487;11846;38692
330022;201310;1592;5214;1441;4922;339;1339;768;2507;1107;3846
330023;201310;3316;10953;3132;10579;889;3300;1265;4120;2154;7420
330025;201310;3234;10162;3013;9823;752;2643;1833;5936;2585;8579
330030;201310;7393;25997;6817;24762;2148;8546;2798;9667;4946;18213
330040;201310;14133;41095;12091;37859;3326;11250;6176;18984;9502;30234
330045;201310;62385;183885;57832;176990;9360;30811;39586;120989;48946;151800
330050;201310;2922;9458;2596;8790;976;3718;689;2143;1665;5861
330060;201310;5377;17014;4899;16316;1137;4271;2959;9874;4096;14145
330070;201310;24897;78873;22867;75137;6764;23869;9923;32555;16687;56424
330080;201310;8714;26092;8375;25623;2125;6548;5122;16147;7247;22695
330090;201310;3099;8948;2938;8645;921;2915;1353;3910;2274;6825
330093;201310;1933;5723;1716;5368;423;1436;779;2419;1202;3855
330095;201310;1186;4177;1101;3967;441;1762;182;564;623;2326
330100;201310;53636;183560;50599;178084;12789;49812;25514;90064;38303;139876
330110;201310;2631;8493;2406;8062;838;3021;742;2465;1580;5486
330115;201310;2422;7519;2262;7226;780;2725;904;2786;1684;5511
330120;201310;2467;7364;2267;7079;716;2377;978;3017;1694;5394
330130;201310;3917;13136;3570;12432;1218;4592;1318;4550;2536;9142
330140;201310;3372;10411;3077;10001;809;2920;1470;4758;2279;7678
330150;201310;2907;8938;2318;7669;807;2876;521;1661;1328;4537
330160;201310;1363;4837;1281;4652;491;1950;398;1382;889;3332
330170;201310;100538;311214;94689;301975;14385;49346;67924;216762;82309;266108
330180;201310;1649;5154;1510;4887;270;1119;958;2862;1228;3981
330185;201310;7780;25039;7305;24249;1973;6898;3979;13543;5952;20441
330187;201310;4199;12084;3781;11391;830;2882;2204;6500;3034;9382
330190;201310;27496;84766;26302;82751;6929;23253;15234;47099;22163;70352
330200;201310;12996;42097;12029;40105;2834;9756;6602;22404;9436;32160
330205;201310;2539;7042;2312;6668;526;1763;1184;3259;1710;5022
330210;201310;4639;12325;3460;10115;1065;3428;850;2437;1915;5865
330220;201310;11049;35644;10405;34381;3676;13142;3445;10900;7121;24042
330225;201310;3964;12759;3750;12419;645;2503;2586;8508;3231;11011
330227;201310;17411;50001;15856;47848;3708;12028;9417;27780;13125;39808
330230;201310;1503;4512;1382;4306;440;1544;524;1503;964;3047
330240;201310;20007;62884;17859;59079;7051;25438;3281;10551;10332;35989
330245;201310;1196;3903;999;3492;322;1226;219;772;541;1998
330250;201310;36931;109222;34903;105957;9878;30434;19036;58995;28914;89429
330260;201310;3460;11172;3244;10717;879;3180;1444;4594;2323;7774
330270;201310;13702;41381;11845;38315;3655;12592;4635;15136;8290;27728
330280;201310;1935;6288;1679;5749;404;1591;785;2497;1189;4088
330285;201310;17235;52716;15935;50867;3690;12471;9758;31255;13448;43726
330290;201310;3459;9856;3107;9393;652;2262;1791;5131;2443;7393
330300;201310;4114;13663;3935;13350;992;3616;2055;7062;3047;10678
330310;201310;2735;8146;2506;7755;635;2091;1234;3764;1869;5855
330320;201310;14421;43462;13681;42305;3108;9958;8591;26944;11699;36902
330330;201310;30964;90030;28804;86660;7509;24426;16771;49663;24280;74089
330340;201310;14004;44382;11687;39593;3745;13771;3551;11843;7296;25614
330350;201310;91160;297875;88861;294599;16916;56314;62809;212278;79725;268592
330360;201310;5394;17229;5271;17028;829;2959;3827;12237;4656;15196
330370;201310;3727;14094;3534;13600;1431;5736;1186;4593;2617;10329
330380;201310;4161;13899;3698;13071;1142;4320;1683;5974;2825;10294
330385;201310;3986;14010;3688;13387;1271;4901;1322;4787;2593;9688
330390;201310;23249;79591;21479;76007;5367;21263;11161;38603;16528;59866
330395;201310;3273;10020;3064;9651;537;1842;1928;6108;2465;7950
330400;201310;2543;8662;2324;8230;571;2319;1128;3670;1699;5989
330410;201310;3047;9815;2634;8954;647;2297;1262;4311;1909;6608
330411;201310;2489;7988;2251;7504;499;1922;1169;3653;1668;5575
330412;201310;1369;4807;1106;4286;268;1185;419;1564;687;2749
330414;201310;25409;72870;21808;67960;4589;15287;13312;41512;17901;56799
330415;201310;3669;11706;3253;10930;841;3167;1430;4762;2271;7929
330420;201310;7304;24206;5871;21147;1877;7405;1052;3816;2929;11221
330430;201310;8123;24433;7321;22984;1831;6413;3556;10826;5387;17239
330440;201310;2104;7156;1763;6419;599;2438;414;1403;1013;3841
330450;201310;1596;5621;1502;5418;488;1983;568;1976;1056;3959
330452;201310;10569;33064;8810;29500;2539;9412;3541;11323;6080;20735
330455;201310;456993;1368842;395497;1266190;110096;377228;197928;630927;308024;1008155
330460;201310;1383;4739;1302;4580;375;1493;615;2115;990;3608
330470;201310;4274;14300;4027;13791;1506;5538;1188;3962;2694;9500
330475;201310;8102;26374;7400;25239;1938;7266;3849;13126;5787;20392
330480;201310;6421;19732;6028;18996;1775;6031;2472;7711;4247;13742
330490;201310;97975;278720;91800;269630;13429;41598;68873;202849;82302;244447
330500;201310;6762;20884;6344;20049;1479;5026;3276;10641;4755;15667
330510;201310;40855;135017;38717;131369;13938;48054;17895;62466;31833;110520
330513;201310;1577;4784;1458;4549;580;1920;485;1486;1065;3406
330515;201310;3037;9597;2801;9188;977;3446;1008;3254;1985;6700
330520;201310;13194;39968;12236;38418;3113;10263;6849;21663;9962;31926
330530;201310;1538;4658;1423;4456;397;1390;717;2154;1114;3544
330540;201310;3264;10108;2854;9460;908;3247;1100;3539;2008;6786
330550;201310;8890;29824;7933;28051;3295;12354;1981;7095;5276;19449
330555;201310;10236;31730;9255;30183;1879;6387;5837;19321;7716;25708
330560;201310;4143;12899;3887;12467;849;3169;2208;6883;3057;10052
330570;201310;3628;10626;3195;9923;835;2718;1707;5398;2542;8116
330575;201310;5333;16543;4955;15841;1160;4007;2981;9246;4141;13253
330580;201310;16400;53981;14563;50270;5131;18594;5069;17890;10200;36484
330590;201310;1929;5963;1823;5783;564;1883;876;2786;1440;4669
330600;201310;9365;28669;8115;26685;1278;5246;5212;16271;6490;21517
330610;201310;8776;28840;8085;27522;2264;8555;3801;12722;6065;21277
330615;201310;1675;5997;1546;5641;645;2458;548;2055;1193;4513
330620;201310;3912;13904;3605;13283;1310;5071;1089;4219;2399;9290
330630;201310;20413;68697;18582;64750;5411;20964;8588;28541;13999;49505
350010;201310;2868;9269;2324;8014;737;2736;443;1449;1180;4185
350020;201310;582;1703;460;1463;124;453;166;479;290;932
350030;201310;4576;14963;3958;13587;1417;5302;1265;4315;2682;9617
350040;201310;580;2154;513;2005;178;756;103;365;281;1121
350050;201310;1386;4602;1153;4160;321;1318;374;1229;695;2547
350055;201310;589;2023;566;1982;175;665;266;915;441;1580
350060;201310;85;292;79;282;25;110;28;84;53;194
350070;201310;2619;8859;2160;7753;558;2224;454;1458;1012;3682
350075;201310;495;1820;448;1707;158;638;119;420;277;1058
350080;201310;586;1760;474;1533;132;495;169;530;301;1025
350090;201310;596;1734;452;1486;128;450;127;382;255;832
350100;201310;1812;6443;1644;6062;617;2443;500;1782;1117;4225
350110;201310;446;1381;355;1171;107;396;111;324;218;720
350115;201310;1300;4341;1154;3959;282;1110;500;1553;782;2663
350120;201310;678;1927;453;1469;134;474;107;332;241;806
350130;201310;3666;11430;3335;10769;893;3218;1396;4164;2289;7382
350140;201310;685;2170;622;2040;150;574;256;790;406;1364
350150;201310;401;1388;368;1309;149;562;93;324;242;886
350160;201310;6141;19759;4762;16701;1532;5932;1638;5263;3170;11195
350170;201310;2202;7934;1979;7358;759;2927;458;1607;1217;4534
350180;201310;1439;3807;1192;3379;303;901;521;1456;824;2357
350190;201310;3089;10855;2657;9957;941;3938;974;3304;1915;7242
350200;201310;417;1460;377;1394;138;581;133;464;271;1045
350210;201310;7322;21193;5993;18833;2423;8185;1885;5619;4308;13804
350220;201310;3118;10193;2824;9642;1039;3968;805;2465;1844;6433
350230;201310;738;2552;680;2454;240;939;223;796;463;1735
350240;201310;597;1844;518;1720;123;480;278;875;401;1355
350250;201310;2726;10227;2613;9991;1132;4592;825;3110;1957;7702
350260;201310;1044;2837;884;2558;209;619;382;1152;591;1771
350270;201310;5240;16550;4730;15517;1170;4169;2211;7222;3381;11391
350275;201310;2001;6707;1789;6378;553;2165;702;2351;1255;4516
350280;201310;22102;59912;14392;45150;3905;13095;3028;9570;6933;22665
350290;201310;1630;5772;1489;5449;491;1886;461;1740;952;3626
350300;201310;482;1558;447;1478;157;562;136;451;293;1013
350310;201310;1003;3392;941;3260;240;982;405;1323;645;2305
350315;201310;558;1797;457;1583;76;337;155;502;231;839
350320;201310;11965;39987;10946;37570;3583;13138;1944;6463;5527;19601
350330;201310;9487;28605;8415;26331;2030;7080;4490;13120;6520;20200
350335;201310;542;1606;498;1515;132;426;186;617;318;1043
350340;201310;1023;3321;806;2894;230;910;209;734;439;1644
350350;201310;766;2505;676;2361;192;770;237;814;429;1584
350360;201310;794;2832;691;2591;220;869;244;931;464;1800
350370;201310;701;2197;527;1774;109;411;120;363;229;774
350380;201310;3666;12012;3095;11111;1362;5261;649;2200;2011;7461
350390;201310;8552;28233;7695;26636;1963;7416;3917;13088;5880;20504
350395;201310;297;980;241;855;75;280;47;161;122;441
350400;201310;8049;24206;6718;21759;2078;7349;2378;7357;4456;14706
350410;201310;7312;27589;6575;25848;2437;10311;1669;6339;4106;16650
350420;201310;1019;3269;823;2874;394;1462;77;262;471;1724
350430;201310;880;2797;766;2596;213;855;377;1214;590;2069
350440;201310;1376;4496;1300;4355;482;1726;591;1907;1073;3633
350450;201310;8130;25269;6879;22780;2333;8326;1900;6063;4233;14389
350460;201310;1493;4489;1098;3630;334;1219;316;919;650;2138
350470;201310;210;651;188;619;57;209;77;235;134;444
350480;201310;765;2401;505;1747;97;377;86;255;183;632
350490;201310;2089;6164;1798;5765;511;1907;883;2647;1394;4554
350500;201310;612;1841;531;1715;135;486;234;710;369;1196
350510;201310;1103;3592;962;3288;314;1211;345;1053;659;2264
350520;201310;1266;4969;1156;4729;454;1941;291;1165;745;3106
350530;201310;2499;7665;2065;6689;828;2898;494;1439;1322;4337
350535;201310;1465;4383;1428;4332;78;268;1262;3841;1340;4109
350540;201310;2047;6000;1757;5494;507;1734;683;2134;1190;3868
350550;201310;10754;32214;8692;28558;2596;9575;3246;9959;5842;19534
350560;201310;3431;11674;3130;11076;644;2444;1660;6020;2304;8464
350570;201310;20518;72297;18801;68230;6236;24212;6779;23561;13015;47773
350580;201310;1978;6614;1690;5980;527;2064;267;806;794;2870
350590;201310;3974;13347;3217;11637;1053;4224;1110;3635;2163;7859
350600;201310;37585;97438;26417;79798;5887;19420;12656;37175;18543;56595
350610;201310;8993;26833;7334;24101;2065;7624;3390;10680;5455;18304
350620;201310;432;1419;383;1324;90;354;162;535;252;889
350630;201310;1623;5189;1283;4501;419;1664;130;403;549;2067
350635;201310;4805;15877;3942;14171;1242;4679;1499;5482;2741;10161
350640;201310;670;2146;592;1951;195;701;214;663;409;1364
350650;201310;3907;13239;3014;11055;1228;4891;286;1005;1514;5896
350660;201310;3734;12179;3306;11405;965;3544;1488;5099;2453;8643
350670;201310;1849;5860;1740;5670;364;1350;1096;3422;1460;4772
350680;201310;1190;3760;963;3294;299;1211;375;1210;674;2421
350690;201310;1056;3638;906;3301;287;1159;227;760;514;1919
350700;201310;2827;9970;2497;9200;963;3918;901;2930;1864;6848
350710;201310;2128;6834;1942;6540;368;1410;1241;4104;1609;5514
350715;201310;1118;3446;989;3191;266;956;377;1140;643;2096
350720;201310;124;403;119;388;51;181;43;123;94;304
350730;201310;414;1628;397;1578;128;562;105;379;233;941
350740;201310;2362;7281;2129;6747;597;2060;874;2763;1471;4823
350745;201310;348;1125;286;976;70;282;122;359;192;641
350750;201310;9618;30292;7468;25873;2228;8466;1879;6096;4107;14562
350760;201310;11752;38376;10745;36557;3670;13893;4514;14479;8184;28372
350770;201310;891;2694;648;2201;150;582;235;773;385;1355
350775;201310;628;1882;570;1770;140;500;247;758;387;1258
350780;201310;2072;6422;1568;5336;387;1460;278;921;665;2381
350790;201310;2102;6968;1709;6114;582;2198;355;1150;937;3348
350800;201310;3013;10357;2875;10117;687;2737;1658;5678;2345;8415
350810;201310;2581;7676;2265;7090;764;2586;764;2466;1528;5052
350820;201310;523;1481;401;1223;90;324;152;405;242;729
350830;201310;880;2828;629;2181;125;482;126;367;251;849
350840;201310;2306;8412;1915;7348;648;2724;359;1186;1007;3910
350850;201310;6838;23512;5666;20612;1906;7370;1363;4677;3269;12047
350860;201310;3350;11105;3221;10910;546;2088;2345;7908;2891;9996
350870;201310;2375;8310;2149;7957;768;3024;1033;3835;1801;6859
350880;201310;1649;5697;1408;5137;450;1750;267;981;717;2731
350890;201310;632;1918;506;1642;99;350;168;458;267;808
350900;201310;4572;15563;3857;13988;1108;4379;1215;4121;2323;8500
350910;201310;868;2761;830;2677;382;1284;265;841;647;2125
350920;201310;9493;29269;8869;28214;1715;6102;5630;17242;7345;23344
350925;201310;5286;16780;4780;15766;1468;5304;2044;6522;3512;11826
350930;201310;1531;4349;1288;3937;168;629;892;2616;1060;3245
350940;201310;2298;7765;2107;7445;452;1885;1282;4306;1734;6191
350945;201310;930;3147;825;2923;237;925;323;1092;560;2017
350950;201310;70448;230142;60193;208879;18348;69408;24007;80786;42355;150194
350960;201310;4505;16193;4027;15112;841;3605;2153;7738;2994;11343
350970;201310;4143;15435;3801;14567;1548;6395;1129;4170;2677;10565
350980;201310;665;2179;616;2098;279;1030;122;413;401;1443
350990;201310;1771;6331;1585;5966;574;2335;545;2021;1119;4356
350995;201310;805;2968;763;2884;225;967;357;1277;582;2244
351000;201310;3518;10965;3073;10094;551;2144;1778;5552;2329;7696
351010;201310;421;1306;309;1061;123;460;61;213;184;673
351015;201310;939;3181;820;2949;322;1313;224;719;546;2032
351020;201310;7643;25552;6807;24230;1921;7356;3532;12757;5453;20113
351030;201310;1336;5069;1239;4841;381;1659;418;1569;799;3228
351040;201310;3635;11895;3367;11424;848;3372;1946;6168;2794;9540
351050;201310;8677;28940;7250;26081;2698;10480;2398;8557;5096;19037
351060;201310;32231;103295;27321;94059;9535;34669;9101;31573;18636;66242
351070;201310;1798;5236;1300;4322;481;1742;236;693;717;2435
351080;201310;2752;8399;2173;7687;687;2640;888;3060;1575;5700
351090;201310;382;1352;305;1186;111;491;51;177;162;668
351100;201310;1837;6053;1691;5750;641;2206;585;2022;1226;4228
351110;201310;7497;22568;5734;19219;2014;7412;1697;5367;3711;12779
351120;201310;594;1864;502;1646;79;319;248;722;327;1041
351130;201310;853;2381;441;1520;92;367;109;324;201;691
351140;201310;1989;7025;1818;6649;701;2810;559;1979;1260;4789
351150;201310;2184;7691;1787;6609;516;2100;424;1411;940;3511
351160;201310;1500;5375;1357;5030;473;1948;446;1595;919;3543
351170;201310;1507;5140;1280;4592;381;1474;490;1616;871;3090
351190;201310;869;2887;759;2596;197;718;167;512;364;1230
351200;201310;2198;6695;1895;6118;364;1394;925;2695;1289;4089
351210;201310;1058;3380;906;3076;301;1113;280;889;581;2002
351220;201310;3491;11970;3061;11037;917;3623;1218;4287;2135;7910
351230;201310;1872;6398;1694;6037;567;2231;762;2642;1329;4873
351240;201310;1026;3384;747;2706;221;904;186;595;407;1499
351250;201310;858;2522;649;2083;146;514;299;918;445;1432
351260;201310;1191;3613;1057;3327;294;1016;399;1194;693;2210
351270;201310;383;1402;347;1325;125;543;107;360;232;903
351280;201310;4285;13845;3678;12330;1125;4036;1102;3327;2227;7363
351290;201310;985;3090;866;2840;285;966;247;763;532;1729
351300;201310;9868;37058;8683;34193;2617;11176;3198;12480;5815;23656
351310;201310;3355;10687;2826;9691;749;2960;1323;4190;2072;7150
351320;201310;1001;3618;892;3356;325;1326;199;661;524;1987
351330;201310;287;850;258;793;102;316;73;220;175;536
351340;201310;6533;23199;5953;22016;1766;6914;2960;10949;4726;17863
351350;201310;9056;30763;8219;28910;2714;9967;2991;10269;5705;20236
351360;201310;4866;15125;4583;14641;1295;4643;2162;6719;3457;11362
351370;201310;1911;6359;1558;5585;546;2174;355;1129;901;3303
351380;201310;36867;118313;34491;113387;9572;34379;16177;50930;25749;85309
351385;201310;250;799;244;789;96;322;87;277;183;599
351390;201310;1220;4211;1095;3946;439;1687;340;1168;779;2855
351400;201310;1220;3994;1146;3833;398;1410;421;1441;819;2851
351410;201310;2904;9060;2590;8492;650;2284;1263;4086;1913;6370
351420;201310;457;1359;318;1043;75;267;52;152;127;419
351430;201310;875;2833;791;2676;182;671;481;1603;663;2274
351440;201310;4650;14502;4075;13275;1613;5501;1050;3225;2663;8726
351450;201310;1799;5223;1585;4941;495;1580;823;2653;1318;4233
351460;201310;825;2641;691;2371;336;1242;195;613;531;1855
351470;201310;1076;3388;960;3167;393;1421;283;909;676;2330
351480;201310;2935;9831;2685;9398;707;2943;1270;4283;1977;7226
351490;201310;1971;6800;1773;6377;386;1642;961;3285;1347;4927
351492;201310;290;1005;213;791;51;223;57;170;108;393
351495;201310;148;530;127;468;41;157;46;168;87;325
351500;201310;19857;65445;17843;61491;5719;21286;7237;24392;12956;45678
351510;201310;7396;24521;6427;22845;1640;6325;3342;11791;4982;18116
351512;201310;376;1164;343;1098;91;313;136;424;227;737
351515;201310;1850;6436;1618;5889;554;2172;429;1485;983;3657
351518;201310;1601;5659;1217;4966;391;1746;228;866;619;2612
351519;201310;777;2595;674;2356;204;821;257;835;461;1656
351520;201310;803;2294;387;1399;65;271;51;167;116;438
351530;201310;466;1487;404;1333;90;320;125;358;215;678
351535;201310;2588;6872;2113;6157;267;892;1426;4076;1693;4968
351540;201310;2095;6836;1891;6459;975;3499;354;1203;1329;4702
351550;201310;5698;17800;4502;15271;1648;5881;1192;3951;2840;9832
351560;201310;426;1438;370;1296;144;545;60;201;204;746
351565;201310;236;813;219;767;65;272;86;266;151;538
351570;201310;12956;43513;11416;40249;3798;13845;4764;16883;8562;30728
351580;201310;400;1150;300;924;47;153;114;324;161;477
351590;201310;449;1269;386;1121;139;438;85;230;224;668
351600;201310;1865;5556;1711;5268;429;1549;814;2264;1243;3813
351610;201310;651;1836;555;1667;129;447;273;771;402;1218
351620;201310;21636;73628;17852;65071;5846;23158;4487;15116;10333;38274
351630;201310;14611;50329;13468;48409;3852;14327;7254;26494;11106;40821
351640;201310;7755;26278;6716;24359;1806;7110;3439;12295;5245;19405
351650;201310;359;1101;240;799;66;245;42;129;108;374
351660;201310;881;2829;694;2391;167;650;199;614;366;1264
351670;201310;4208;13551;3589;12234;820;3180;1741;5614;2561;8794
351680;201310;618;1958;439;1510;104;387;79;242;183;629
351685;201310;442;1362;353;1203;107;379;120;421;227;800
351690;201310;1322;3977;1042;3347;463;1498;258;781;721;2279
351700;201310;1451;4463;1320;4213;446;1494;441;1368;887;2862
351710;201310;791;2518;661;2218;168;572;194;615;362;1187
351720;201310;1607;5236;1243;4254;282;1085;426;1391;708;2476
351730;201310;1111;3388;945;3141;392;1453;283;879;675;2332
351740;201310;4525;13245;3913;11945;1100;3600;1304;3719;2404;7319
351750;201310;1501;5027;1304;4598;406;1565;343;1114;749;2679
351760;201310;3769;12406;3350;11449;881;3300;1519;4977;2400;8277
351770;201310;2265;7507;1964;6947;752;2748;822;2915;1574;5663
351780;201310;1610;4666;1111;3600;318;1138;239;731;557;1869
351790;201310;1126;3443;967;3221;298;1077;466;1517;764;2594
351800;201310;335;829;291;743;41;139;173;386;214;525
351810;201310;1190;3705;1127;3627;294;1103;690;2096;984;3199
351820;201310;2499;7568;1783;6193;685;2555;205;681;890;3236
351830;201310;4012;13422;3642;12581;963;3680;1656;5503;2619;9183
351840;201310;8850;31152;7955;29220;2781;10792;2572;9360;5353;20152
351850;201310;1235;4299;1064;3917;322;1320;206;670;528;1990
351860;201310;3551;11563;3309;11094;768;2936;1890;6018;2658;8954
351870;201310;34933;110546;32266;105881;7546;26815;19322;62986;26868;89801
351880;201310;115102;382976;101848;355543;34056;125149;31791;110531;65847;235680
351885;201310;639;2370;594;2262;169;684;260;953;429;1637
351890;201310;806;2443;636;2060;214;734;145;446;359;1180
351900;201310;1458;4580;1283;4287;442;1582;474;1591;916;3173
351905;201310;357;1329;310;1237;108;480;106;386;214;866
351907;201310;14427;46922;12661;43374;3075;11838;6077;19826;9152;31664
351910;201310;1140;3741;1047;3560;262;1003;336;1063;598;2066
351920;201310;1191;3515;1128;3421;276;958;670;1953;946;2911
351925;201310;973;2846;916;2748;117;448;663;1876;780;2324
351930;201310;3096;10850;2856;10323;871;3544;1187;3903;2058;7447
351940;201310;1004;3087;943;2970;286;994;548;1647;834;2641
351950;201310;1101;3372;938;3055;230;810;400;1227;630;2037
351960;201310;3834;12472;3304;11417;1254;4590;1227;4143;2481;8733
351970;201310;6857;26533;6334;25390;2444;10343;2028;8042;4472;18385
351980;201310;940;2959;799;2679;189;744;331;1005;520;1749
351990;201310;1575;4644;1287;4058;379;1401;374;1014;753;2415
352000;201310;2470;8053;2256;7608;572;2076;1004;3246;1576;5322
352010;201310;2271;7885;2075;7394;769;2879;470;1696;1239;4575
352020;201310;1482;4882;1339;4586;440;1566;426;1492;866;3058
352030;201310;4388;14073;4024;13600;968;3523;2293;7880;3261;11403
352040;201310;1769;6293;1522;5650;454;1802;368;1268;822;3070
352042;201310;2200;6433;1711;5402;437;1540;858;2636;1295;4176
352044;201310;1332;4628;1075;3935;281;1109;245;804;526;1913
352050;201310;7484;25863;5508;21158;1744;7366;1004;3362;2748;10728
352060;201310;795;2416;710;2285;215;807;279;804;494;1611
352070;201310;727;2004;668;1907;290;895;194;580;484;1475
352080;201310;530;1668;452;1528;123;474;155;468;278;942
352090;201310;1675;5554;1394;4960;352;1406;477;1555;829;2961
352100;201310;1775;6198;1586;5811;543;2233;570;1847;1113;4080
352110;201310;420;1606;375;1493;110;487;105;398;215;885
352115;201310;373;1240;319;1122;97;375;142;474;239;849
352120;201310;986;2944;860;2767;180;610;515;1701;695;2311
352130;201310;1754;5005;1339;4288;357;1271;555;1622;912;2893
352140;201310;1268;4251;1062;3781;342;1277;418;1485;760;2762
352150;201310;602;1829;494;1632;176;625;180;572;356;1197
352160;201310;1238;3591;1139;3444;271;877;633;1925;904;2802
352170;201310;3130;9801;2868;9350;818;2872;1342;4196;2160;7068
352180;201310;3522;10308;3104;9535;886;2987;1385;4029;2271;7016
352190;201310;1047;3304;957;3135;227;910;464;1375;691;2285
352200;201310;412;1439;345;1301;76;321;154;586;230;907
352210;201310;15875;44046;12809;39478;2643;8704;7692;24194;10335;32898
352215;201310;562;1821;504;1731;81;308;289;1022;370;1330
352220;201310;14891;50662;13883;48544;4769;17662;5395;18818;10164;36480
352230;201310;13596;47508;12067;44589;3901;15720;4595;16607;8496;32327
352240;201310;12276;39598;11377;37977;3965;14767;4424;14074;8389;28841
352250;201310;25806;84929;22892;79200;6432;24167;9646;33205;16078;57372
352260;201310;5129;16215;3766;13406;1070;4230;1146;3718;2216;7948
352265;201310;928;3037;811;2854;139;557;510;1758;649;2315
352270;201310;2575;8866;2221;8034;895;3429;499;1701;1394;5130
352280;201310;2438;7762;2097;7179;606;2301;703;2335;1309;4636
352290;201310;1298;4282;1114;3859;286;1120;330;1013;616;2133
352300;201310;923;2805;782;2558;253;885;327;1063;580;1948
352310;201310;30850;107012;28160;102283;7945;31037;15933;56763;23878;87800
352320;201310;6601;21136;5840;19707;2059;7540;1858;5745;3917;13285
352330;201310;2168;7285;1906;6968;736;2892;665;2421;1401;5313
352340;201310;5720;19924;4726;17454;1682;6667;912;3100;2594;9767
352350;201310;1711;6440;1550;6049;447;1903;509;1906;956;3809
352360;201310;1168;3952;1040;3682;302;1261;538;1751;840;3012
352370;201310;888;3046;813;2878;194;780;384;1327;578;2107
352380;201310;1018;3307;891;3080;360;1393;248;813;608;2206
352390;201310;12003;37049;9552;32386;2386;9329;4336;13616;6722;22945
352400;201310;3107;9472;2117;7494;641;2506;851;2860;1492;5366
352410;201310;3702;11055;2832;9543;965;3543;869;2778;1834;6321
352420;201310;1290;3760;1196;3610;478;1600;414;1213;892;2813
352430;201310;6211;19931;5484;18670;2200;8139;1697;5574;3897;13713
352440;201310;15349;49532;12812;44486;3539;13303;5055;17000;8594;30303
352450;201310;617;1906;429;1535;118;451;92;308;210;759
352460;201310;2652;9087;2406;8640;893;3561;858;2850;1751;6411
352470;201310;4888;13998;3035;10115;643;2325;1328;4329;1971;6654
352480;201310;5413;15646;4471;13874;1268;4516;1836;5252;3104;9768
352490;201310;719;2629;608;2355;156;674;119;450;275;1124
352500;201310;9967;33416;9441;32471;4358;15961;2823;9125;7181;25086
352510;201310;3340;11826;2763;10554;1020;4183;667;2474;1687;6657
352520;201310;2441;8789;2233;8329;577;2336;1306;4783;1883;7119
352530;201310;6573;21778;4985;18224;1456;5830;922;3138;2378;8968
352540;201310;480;1607;392;1410;104;412;127;446;231;858
352550;201310;1061;3647;873;3229;329;1311;211;754;540;2065
352560;201310;552;1728;466;1545;94;381;217;634;311;1015
352570;201310;1574;5059;1117;3980;265;1068;304;948;569;2016
352580;201310;922;2807;802;2598;291;1064;329;984;620;2048
352585;201310;207;683;165;601;39;161;52;172;91;333
352590;201310;13550;44768;12165;42072;2935;11362;6543;21911;9478;33273
352600;201310;1859;6116;1721;5812;620;2174;580;1911;1200;4085
352610;201310;3579;11724;3201;11078;1265;4772;1022;3439;2287;8211
352620;201310;5472;17755;5188;17357;1266;4483;3271;10962;4537;15445
352630;201310;830;2819;782;2701;239;912;354;1188;593;2100
352640;201310;3022;9875;2450;8548;586;2264;965;3263;1551;5527
352650;201310;842;2545;631;2110;159;577;182;569;341;1146
352660;201310;1085;3832;888;3359;291;1169;267;997;558;2166
352670;201310;7721;26667;6776;24798;2643;10111;1804;6642;4447;16753
352680;201310;3034;11223;2574;9939;695;2960;758;2588;1453;5548
352690;201310;23600;72158;19290;64037;5376;19600;8159;26258;13535;45858
352700;201310;767;2320;614;2084;183;705;271;879;454;1584
352710;201310;5068;15359;3741;12624;1046;3937;1364;4314;2410;8251
352720;201310;8710;29795;8177;28672;2747;10196;3227;11269;5974;21465
352725;201310;412;1253;280;939;56;225;72;223;128;448
352730;201310;2568;9051;2229;8106;632;2508;665;2162;1297;4670
352740;201310;2206;6717;1917;6177;531;2034;854;2465;1385;4499
352750;201310;367;1176;312;1082;115;432;63;186;178;618
352760;201310;932;3293;865;3161;290;1164;448;1578;738;2742
352770;201310;913;2867;860;2761;235;827;322;1031;557;1858
352780;201310;598;2075;522;1891;164;667;161;514;325;1181
352790;201310;646;1906;518;1690;161;581;98;309;259;890
352800;201310;1106;4240;902;3663;296;1236;156;573;452;1809
352810;201310;1014;2760;769;2302;149;520;303;873;452;1393
352820;201310;538;1682;457;1527;208;745;82;275;290;1020
352830;201310;408;1218;315;1010;89;294;51;150;140;444
352840;201310;3431;12169;3031;11270;953;3766;1066;3975;2019;7741
352850;201310;9676;32082;8521;29983;2576;9647;3174;11324;5750;20971
352860;201310;1031;3481;945;3282;403;1486;238;746;641;2232
352870;201310;1052;2778;845;2364;143;515;462;1149;605;1664
352880;201310;2235;6882;1790;5868;445;1593;443;1303;888;2896
352885;201310;305;1058;288;1018;92;353;107;355;199;708
352890;201310;704;2058;617;1881;149;517;206;566;355;1083
352900;201310;18680;58062;14483;49311;4067;15068;5704;18666;9771;33734
352910;201310;283;933;248;853;79;286;34;95;113;381
352920;201310;3389;10584;2898;9599;986;3611;971;2969;1957;6580
352930;201310;7000;22745;5539;19419;1708;6406;1060;3571;2768;9977
352940;201310;27636;95515;24092;86886;8865;33590;4851;16988;13716;50578
352950;201310;319;1026;230;830;64;274;59;190;123;464
352960;201310;496;1647;377;1339;76;291;66;220;142;511
352965;201310;361;1015;292;886;74;238;45;128;119;366
352970;201310;3344;8922;2969;8423;377;1152;2166;6251;2543;7403
352980;201310;1471;4409;1266;4078;421;1411;512;1700;933;3111
352990;201310;3647;12389;3391;11906;1202;4601;1113;3743;2315;8344
353000;201310;519;1480;393;1216;86;299;110;300;196;599
353010;201310;2987;8697;2318;7328;720;2534;806;2347;1526;4881
353020;201310;4383;12418;3181;9818;568;1990;1327;3730;1895;5720
353030;201310;4966;15223;4311;13850;1605;5589;967;2900;2572;8489
353040;201310;689;1995;590;1836;199;681;214;644;413;1325
353050;201310;5437;19308;4706;17752;1856;7505;1408;5048;3264;12553
353060;201310;32977;109165;30802;105614;5708;23071;20357;66802;26065;89873
353070;201310;8581;29941;6817;25750;2440;9690;1601;6098;4041;15788
353080;201310;4620;16252;3901;14531;1363;5470;1070;3735;2433;9205
353090;201310;587;2006;524;1880;94;408;253;821;347;1229
353100;201310;267;817;221;709;100;322;41;125;141;447
353110;201310;7847;24942;7033;23410;1627;5776;3906;13155;5533;18931
353120;201310;469;1633;404;1478;152;625;94;311;246;936
353130;201310;2980;9418;2635;8802;997;3642;953;2977;1950;6619
353140;201310;2480;7156;2004;6172;672;2252;583;1598;1255;3850
353150;201310;1919;6143;1593;5503;615;2238;370;1308;985;3546
353160;201310;603;1851;492;1621;150;516;99;303;249;819
353170;201310;514;1872;469;1788;193;820;163;589;356;1409
353180;201310;5118;16663;4516;15498;799;3216;2728;8964;3527;12180
353190;201310;3580;11697;3112;10587;816;3081;1384;4326;2200;7407
353200;201310;856;3066;771;2880;252;1056;287;1013;539;2069
353205;201310;537;1748;434;1507;111;386;143;508;254;894
353210;201310;1015;2790;839;2476;131;468;505;1438;636;1906
353215;201310;564;1813;488;1648;105;403;165;563;270;966
353220;201310;899;2805;812;2624;225;812;289;888;514;1700
353230;201310;1146;3654;1064;3509;316;1153;338;1039;654;2192
353240;201310;2147;7338;1952;6930;656;2597;781;2546;1437;5143
353250;201310;1200;3471;1011;3119;293;976;350;1016;643;1992
353260;201310;1151;3448;1016;3219;339;1135;378;1156;717;2291
353270;201310;636;1960;545;1781;180;639;148;438;328;1077
353280;201310;552;1850;479;1723;169;638;124;437;293;1075
353282;201310;1761;5916;1704;5821;313;1194;1115;3713;1428;4907
353284;201310;325;950;253;819;77;264;78;246;155;510
353286;201310;146;438;95;315;26;82;12;44;38;126
353290;201310;426;1552;387;1470;166;665;136;500;302;1165
353300;201310;1883;6098;1688;5657;605;2181;553;1689;1158;3870
353310;201310;346;1107;324;1048;142;485;85;253;227;738
353320;201310;488;1402;428;1299;109;399;201;555;310;954
353325;201310;477;1712;402;1560;125;525;50;199;175;724
353330;201310;495;1536;412;1358;100;378;171;507;271;885
353340;201310;3118;10264;2684;9352;937;3527;902;3021;1839;6548
353350;201310;3371;10428;2992;9731;1017;3572;1372;4315;2389;7887
353360;201310;414;1476;364;1357;101;437;185;633;286;1070
353370;201310;697;2304;626;2129;182;652;288;974;470;1626
353380;201310;405;1364;366;1294;115;450;153;525;268;975
353390;201310;4994;13924;3782;11643;949;3232;1436;4005;2385;7237
353400;201310;608;1927;507;1709;116;433;159;469;275;902
353410;201310;682;2133;582;1973;184;690;292;958;476;1648
353420;201310;680;2011;513;1591;162;548;157;443;319;991
353430;201310;2472;8673;1820;6745;513;1964;125;375;638;2339
353440;201310;59295;197613;53695;184077;17251;62387;17541;58436;34792;120823
353450;201310;455;1420;407;1333;111;427;146;448;257;875
353460;201310;3958;11468;3442;10534;919;3053;1631;4926;2550;7979
353470;201310;11137;35913;8741;30755;2786;10711;1995;6790;4781;17501
353475;201310;1655;4929;1239;3994;338;1194;334;974;672;2168
353480;201310;1528;4656;1374;4373;326;1203;739;2219;1065;3422
353490;201310;1630;4739;1351;4167;380;1306;373;1031;753;2337
353500;201310;1191;3510;1107;3357;482;1555;376;1077;858;2632
353510;201310;1346;4449;1151;3917;333;1240;348;1039;681;2279
353520;201310;1136;3568;965;3241;388;1392;247;830;635;2222
353530;201310;2721;8335;2431;7791;669;2415;1060;3224;1729;5639
353540;201310;1910;6003;1755;5729;681;2309;621;2074;1302;4383
353550;201310;6671;19635;5959;18448;1228;4490;3299;9484;4527;13974
353560;201310;2195;7340;1833;6640;441;1857;713;2445;1154;4302
353570;201310;478;1550;399;1383;101;402;197;606;298;1008
353580;201310;2352;7882;2222;7642;797;3063;1130;3673;1927;6736
353590;201310;797;2333;680;2126;261;885;173;563;434;1448
353600;201310;1857;5458;1698;5181;402;1354;846;2591;1248;3945
353610;201310;586;2121;516;1974;155;678;164;597;319;1275
353620;201310;2349;8322;2138;7933;734;2961;729;2542;1463;5503
353625;201310;363;1012;254;814;101;365;68;193;169;558
353630;201310;1719;5963;1373;5120;353;1474;283;959;636;2433
353640;201310;1545;4530;1421;4283;393;1267;651;1994;1044;3261
353650;201310;6257;19351;4539;15412;1068;3922;1757;5619;2825;9541
353657;201310;310;1047;283;985;70;284;104;345;174;629
353660;201310;1347;3503;1017;3028;470;1537;152;308;622;1845
353670;201310;4795;16101;4197;14775;1342;5102;1384;4637;2726;9739
353680;201310;640;2334;607;2269;329;1275;153;568;482;1843
353690;201310;509;1440;353;1167;110;414;124;371;234;785
353700;201310;2279;7539;2013;6919;500;1959;646;2043;1146;4002
353710;201310;1917;6873;1639;6216;618;2595;514;1879;1132;4474
353715;201310;476;1435;417;1336;72;267;216;686;288;953
353720;201310;2080;6651;1826;6247;385;1346;1060;3760;1445;5106
353730;201310;4389;14008;3550;12027;933;3415;932;2944;1865;6359
353740;201310;2304;7128;1846;6151;646;2266;498;1595;1144;3861
353750;201310;617;2237;534;2051;186;768;135;524;321;1292
353760;201310;6865;22698;5742;20498;1833;6908;2233;8042;4066;14950
353770;201310;830;2627;540;1874;133;493;64;173;197;666
353780;201310;5748;20867;5214;19772;2540;9861;1233;4935;3773;14796
353790;201310;3097;11254;2778;10573;1024;4275;509;1977;1533;6252
353800;201310;14121;46357;11439;40967;3258;12802;4680;16247;7938;29049
353810;201310;1192;4010;1059;3712;334;1240;416;1446;750;2686
353820;201310;1204;4347;1153;4247;425;1763;444;1513;869;3276
353830;201310;786;2200;610;1855;140;472;240;709;380;1181
353850;201310;1825;6112;1707;5895;462;1727;816;2715;1278;4442
353860;201310;2404;8359;2054;7547;731;2909;677;2437;1408;5346
353870;201310;23049;73683;17598;62186;4237;16815;6130;19652;10367;36467
353880;201310;2439;8245;2239;7937;497;2026;1287;4433;1784;6459
353890;201310;2352;6281;1762;5313;535;1805;745;2108;1280;3913
353900;201310;1153;3672;854;2970;224;856;191;584;415;1440
353910;201310;2093;7507;1990;7225;665;2578;828;3037;1493;5615
353920;201310;2575;7820;1986;6559;499;1724;391;1202;890;2926
353930;201310;3707;13473;3255;12491;1235;5025;742;2774;1977;7799
353940;201310;1514;4916;1333;4545;343;1362;526;1631;869;2993
353950;201310;3621;12083;3336;11552;600;2397;2115;7125;2715;9522
353960;201310;586;1915;485;1675;120;463;133;389;253;852
353970;201310;525;1560;460;1472;55;218;333;1033;388;1251
353980;201310;14080;42354;11940;38886;3021;10621;6233;20046;9254;30667
353990;201310;506;1617;461;1502;151;547;163;467;314;1014
354000;201310;1885;5715;1299;4517;312;1201;131;397;443;1598
354010;201310;381;1219;342;1150;163;570;95;317;258;887
354020;201310;4597;14365;4177;13470;1485;5164;1587;4780;3072;9944
354025;201310;1049;3090;832;2676;230;818;199;608;429;1426
354030;201310;615;1659;434;1384;146;518;136;402;282;920
354040;201310;782;2171;626;1886;95;356;375;1050;470;1406
354050;201310;924;3169;845;2988;337;1280;221;769;558;2049
354060;201310;4379;14617;3645;13061;1020;3969;1507;5196;2527;9165
354070;201310;3577;12035;3114;10984;1174;4453;739;2537;1913;6990
354075;201310;2256;8644;2156;8460;774;3282;915;3517;1689;6799
354080;201310;1883;5861;1510;4944;416;1425;483;1487;899;2912
354085;201310;302;864;270;805;35;139;187;510;222;649
354090;201310;1119;3437;1064;3354;158;563;789;2430;947;2993
354100;201310;16652;58036;14452;53922;3954;15782;6665;24775;10619;40557
354105;201310;850;2747;703;2453;197;826;244;728;441;1554
354110;201310;813;2407;671;2183;184;673;219;664;403;1337
354120;201310;2195;6388;1890;5845;579;1999;645;1853;1224;3852
354130;201310;6245;19562;5554;18145;2077;7195;1727;5437;3804;12632
354140;201310;19455;52476;12868;39510;2634;9242;5372;15291;8006;24533
354150;201310;4410;12690;3579;11215;1106;3827;1415;4265;2521;8092
354160;201310;3973;13376;3526;12409;1063;4025;1432;4863;2495;8888
354165;201310;397;1502;363;1414;131;546;80;321;211;867
354170;201310;1601;5305;1308;4585;292;1165;465;1454;757;2619
354180;201310;509;1573;486;1525;48;177;350;1049;398;1226
354190;201310;1629;5546;1409;5024;489;1840;428;1460;917;3300
354200;201310;1138;3370;940;2998;225;854;361;1001;586;1855
354210;201310;851;3032;764;2826;198;869;302;1016;500;1885
354220;201310;3080;9903;2789;9329;991;3499;1061;3457;2052;6956
354230;201310;783;2637;742;2568;245;902;336;1160;581;2062
354240;201310;1286;4459;1060;3952;319;1308;258;903;577;2211
354250;201310;527;1736;440;1586;190;767;121;407;311;1174
354260;201310;9399;28903;8529;27484;2727;9675;3429;10913;6156;20588
354270;201310;1126;4063;1049;3886;335;1384;412;1516;747;2900
354280;201310;896;2687;839;2589;175;623;451;1384;626;2007
354290;201310;1311;4721;1203;4483;399;1590;310;1128;709;2718
354300;201310;3885;13674;3793;13489;1066;4021;1986;7000;3052;11021
354310;201310;791;2678;626;2261;183;709;142;516;325;1225
354320;201310;829;2545;713;2303;214;783;232;689;446;1472
354323;201310;334;1007;275;909;104;373;91;269;195;642
354325;201310;1296;4507;1184;4252;346;1417;422;1379;768;2796
354330;201310;7916;25226;7206;23798;2014;7174;3725;11989;5739;19163
354340;201310;29628;98442;25445;90581;9852;37659;8755;30167;18607;67826
354350;201310;1155;3531;1080;3393;320;1063;551;1671;871;2734
354360;201310;441;1442;362;1298;93;362;37;123;130;485
354370;201310;1155;3919;1029;3644;174;747;703;2411;877;3158
354380;201310;1302;3985;1089;3598;415;1523;187;536;602;2059
354390;201310;11331;37444;8612;31183;2294;9153;2555;8798;4849;17951
354400;201310;2093;7530;1829;6869;487;2006;570;2021;1057;4027
354410;201310;6299;19688;5308;18109;1297;4858;2822;9571;4119;14429
354420;201310;1665;5010;1390;4394;461;1568;440;1311;901;2879
354425;201310;3516;10350;3076;9547;1088;3613;935;2952;2023;6565
354430;201310;1342;4491;1237;4325;332;1311;581;1936;913;3247
354440;201310;522;1617;428;1428;103;388;162;513;265;901
354450;201310;460;1353;328;1055;59;250;100;273;159;523
354460;201310;781;2378;701;2234;264;885;305;967;569;1852
354470;201310;458;1391;384;1242;73;294;169;496;242;790
354480;201310;734;2279;658;2144;154;593;297;843;451;1436
354490;201310;746;2575;577;2135;149;597;184;589;333;1186
354500;201310;2542;8725;2332;8332;878;3440;706;2540;1584;5980
354510;201310;680;2334;609;2173;197;756;237;835;434;1591
354515;201310;345;1223;285;1081;73;311;89;313;162;624
354520;201310;5122;18620;4404;16922;1484;6305;1491;5472;2975;11777
354530;201310;2713;9993;2540;9642;745;3049;1354;5101;2099;8150
354540;201310;1354;4290;1182;3979;396;1404;426;1484;822;2888
354550;201310;520;1786;459;1620;105;390;165;549;270;939
354560;201310;1395;4278;1095;3600;330;1118;331;1046;661;2164
354570;201310;611;1945;504;1680;183;660;115;360;298;1020
354580;201310;8760;26117;7309;23297;1596;5807;3614;10879;5210;16686
354600;201310;1706;5988;1519;5618;513;2180;600;2061;1113;4241
354610;201310;469;1330;328;1040;69;231;97;267;166;498
354620;201310;416;1470;342;1332;104;479;110;389;214;868
354625;201310;275;929;234;841;58;237;57;196;115;433
354630;201310;1885;6695;1705;6249;724;2672;532;1855;1256;4527
354640;201310;4110;14028;3539;12766;1087;4393;819;2721;1906;7114
354650;201310;988;3071;898;2876;191;714;492;1505;683;2219
354660;201310;1953;5996;1532;5172;499;1884;551;1764;1050;3648
354670;201310;1656;5499;1314;4595;396;1512;334;999;730;2511
354680;201310;5242;17991;4814;17046;1417;5351;1832;6299;3249;11650
354690;201310;866;2967;593;2254;124;512;179;620;303;1132
354700;201310;1158;3314;790;2504;138;506;331;902;469;1408
354710;201310;621;1887;534;1714;148;561;181;528;329;1089
354720;201310;193;561;155;481;57;174;39;130;96;304
354730;201310;7261;26388;6531;24838;2113;8539;2573;9505;4686;18044
354740;201310;229;767;195;691;47;173;46;164;93;337
354750;201310;2276;7456;1946;6994;688;2670;698;2462;1386;5132
354760;201310;2179;7401;1866;6678;640;2422;458;1575;1098;3997
354765;201310;275;734;184;583;37;144;36;91;73;235
354770;201310;2784;8337;2236;7414;1022;3657;384;1185;1406;4842
354780;201310;33099;109386;30965;104336;8248;30620;15298;49045;23546;79665
354790;201310;870;2859;787;2738;218;856;413;1335;631;2191
354800;201310;1911;5915;1746;5684;526;1881;959;3095;1485;4976
354805;201310;880;2766;669;2300;116;463;124;385;240;848
354810;201310;668;2281;522;1960;189;769;82;293;271;1062
354820;201310;1041;3806;945;3592;314;1352;234;802;548;2154
354830;201310;432;1356;379;1252;112;433;136;410;248;843
354840;201310;793;2432;734;2315;239;807;253;773;492;1580
354850;201310;14540;48262;11282;41218;3257;13175;3901;13280;7158;26455
354860;201310;1260;4213;1146;4007;324;1351;514;1673;838;3024
354870;201310;42448;139528;39949;134264;12505;45014;19074;62396;31579;107410
354880;201310;4036;13009;2986;10594;923;3580;732;2316;1655;5896
354890;201310;14773;46459;12792;42404;3760;13717;4502;14198;8262;27915
354900;201310;602;1719;488;1557;167;592;180;561;347;1153
354910;201310;6092;19244;3737;13642;959;3843;494;1717;1453;5560
354920;201310;502;1504;385;1279;116;411;94;296;210;707
354925;201310;364;1069;214;747;43;164;35;106;78;270
354930;201310;251;769;231;720;73;263;62;181;135;444
354940;201310;2396;8578;1882;7166;800;3208;326;1191;1126;4399
354950;201310;1453;4959;1334;4788;256;1071;815;2856;1071;3927
354960;201310;786;2525;683;2349;210;806;258;851;468;1657
354970;201310;3936;13454;3483;12499;844;3449;1743;5937;2587;9386
354980;201310;32359;81350;17988;56059;4091;14234;6100;17569;10191;31803
354990;201310;35088;120771;32649;115572;7897;31015;17233;59081;25130;90096
354995;201310;1946;6243;1835;6076;475;1668;935;3119;1410;4787
355000;201310;1621;5581;1429;5240;547;2137;378;1360;925;3497
355010;201310;3635;11716;3100;10532;811;3065;1437;4762;2248;7827
355020;201310;3185;11686;2773;10860;1401;5792;702;2760;2103;8552
355030;201310;816427;2464163;752531;2337959;217339;731343;310297;939862;527636;1671205
355040;201310;2849;9604;2544;9009;917;3567;1150;3882;2067;7449
355050;201310;1237;4008;1022;3554;302;1141;277;948;579;2089
355060;201310;4815;16941;3886;14731;1131;4758;828;2832;1959;7590
355070;201310;6270;20327;5629;19213;1374;5425;2961;9519;4335;14944
355080;201310;1275;4779;1080;4232;382;1681;151;493;533;2174
355090;201310;1071;3933;909;3526;217;927;390;1450;607;2377
355100;201310;29256;96981;26304;91645;9684;35315;8810;31553;18494;66868
355110;201310;1304;4614;1192;4369;423;1684;381;1348;804;3032
355120;201310;649;2127;567;1958;186;697;219;719;405;1416
355130;201310;524;1453;351;1095;100;344;106;270;206;614
355140;201310;1011;3727;967;3624;302;1256;425;1533;727;2789
355150;201310;3385;11630;2978;10831;1007;3831;1110;3877;2117;7708
355160;201310;1487;5270;1303;4950;562;2376;349;1173;911;3549
355170;201310;9070;27151;6701;22710;2329;8542;1867;6141;4196;14683
355180;201310;2839;9026;2488;8368;723;2792;935;2974;1658;5766
355190;201310;1271;4534;1172;4313;503;1902;336;1193;839;3095
355200;201310;898;3418;861;3338;437;1776;197;741;634;2517
355210;201310;2713;9574;2469;9038;773;3184;970;3279;1743;6463
355220;201310;28873;100775;26670;96322;12000;44905;7224;26827;19224;71732
355230;201310;1083;3306;709;2445;136;550;167;493;303;1043
355240;201310;21447;67587;16638;56606;4139;15774;6653;20860;10792;36634
355250;201310;24212;83501;22044;79271;6674;25696;10176;36080;16850;61776
355255;201310;878;2503;638;1983;128;457;186;538;314;995
355260;201310;1585;4723;1422;4421;401;1391;536;1540;937;2931
355270;201310;1647;5160;1562;5023;241;981;1101;3340;1342;4321
355280;201310;22476;69834;20009;65013;5261;19200;9037;28070;14298;47270
355290;201310;863;2829;797;2707;168;634;394;1277;562;1911
355300;201310;837;2784;652;2369;165;650;160;526;325;1176
355310;201310;1040;3257;933;3059;251;864;417;1402;668;2266
355320;201310;732;2394;645;2189;193;727;218;630;411;1357
355330;201310;1549;5721;1325;5274;499;2195;348;1269;847;3464
355340;201310;3065;8467;2869;8128;789;2510;1518;4057;2307;6567
355350;201310;1351;4900;1213;4578;430;1740;310;1180;740;2920
355360;201310;1164;4153;1094;4016;279;1152;689;2482;968;3634
355365;201310;310;999;260;894;75;287;67;224;142;511
355370;201310;6916;18458;5170;16419;1981;6895;1908;6025;3889;12920
355380;201310;3660;11364;2849;9450;843;3014;605;1765;1448;4779
355385;201310;980;3267;929;3170;387;1463;222;695;609;2158
355390;201310;1403;3999;1209;3603;333;1066;419;1218;752;2284
355395;201310;1586;5071;1301;4361;233;918;578;1760;811;2678
355400;201310;8638;30554;7930;29032;2730;10976;3159;11129;5889;22105
355410;201310;12583;47272;11838;45656;4865;19858;3299;12845;8164;32703
355420;201310;814;3035;778;2952;335;1331;246;949;581;2280
355430;201310;3589;10887;3136;10061;863;3053;1367;4234;2230;7287
355440;201310;880;2984;719;2561;215;803;190;602;405;1405
355450;201310;2512;8517;2118;7687;667;2670;647;2200;1314;4870
355460;201310;563;1636;436;1393;123;470;129;346;252;816
355465;201310;435;1340;367;1199;111;397;95;301;206;698
355470;201310;926;2943;758;2645;285;1099;236;771;521;1870
355475;201310;139;537;119;472;31;129;37;161;68;290
355480;201310;3197;11878;3009;11444;999;4097;1275;4693;2274;8790
355490;201310;802;2418;646;2100;194;696;142;458;336;1154
355495;201310;719;2449;681;2382;197;769;289;960;486;1729
355500;201310;8252;25489;5786;19885;1474;5609;1180;3702;2654;9311
355510;201310;1780;5339;1447;4633;341;1252;399;1195;740;2447
355520;201310;362;980;259;774;64;225;72;179;136;404
355530;201310;187;497;112;360;28;100;22;67;50;167
355535;201310;745;2327;612;2059;173;692;195;555;368;1247
355540;201310;10164;33534;9645;32636;2837;10348;4775;15847;7612;26195
355550;201310;705;2269;660;2178;199;725;303;969;502;1694
355560;201310;1432;4309;1102;3660;278;1043;243;687;521;1730
355570;201310;184;633;161;575;44;166;36;113;80;279
355580;201310;1224;3779;1064;3447;416;1499;350;1068;766;2567
355590;201310;249;705;221;649;50;182;108;303;158;485
355600;201310;1034;3448;879;3084;376;1393;208;697;584;2090
355610;201310;1402;4172;1199;3850;372;1312;485;1495;857;2807
355620;201310;3842;12670;3132;11022;801;3232;1294;4114;2095;7346
355630;201310;3185;9441;2030;6956;437;1708;688;2145;1125;3853
355635;201310;978;3333;863;3120;201;802;485;1714;686;2516
355640;201310;3798;12895;3190;11413;1176;4411;594;2085;1770;6496
355645;201310;3375;12377;3211;12051;695;2897;1945;7197;2640;10094
355650;201310;6404;20778;5622;19210;1347;5473;3121;9862;4468;15335
355660;201310;1287;4252;1073;3816;358;1437;359;1182;717;2619
355670;201310;2099;6922;1464;5387;403;1694;476;1521;879;3215
355680;201310;1719;6084;1447;5396;569;2224;291;1034;860;3258
355690;201310;330;1160;299;1104;198;762;23;59;221;821
355695;201310;327;1007;242;803;35;122;22;54;57;176
355700;201310;6312;23023;5841;21825;1836;7429;2491;8909;4327;16338
355710;201310;12141;32214;7947;24382;2748;9005;1951;5767;4699;14772
355715;201310;195;622;149;530;45;168;29;102;74;270
355720;201310;1517;5147;1287;4659;472;1880;368;1200;840;3080
355730;201310;772;2739;703;2598;286;1126;164;614;450;1740
410010;201310;1628;5281;1473;4932;411;1498;461;1531;872;3029
410020;201310;1228;4290;1157;4150;380;1419;406;1447;786;2866
410030;201310;1091;3874;946;3515;322;1297;184;695;506;1992
410040;201310;12700;43330;11693;41262;4199;15875;3329;11602;7528;27477
410045;201310;1070;3156;815;2679;263;933;270;832;533;1765
410050;201310;2998;8907;2143;7260;742;2746;625;2056;1367;4802
410060;201310;1903;6223;1725;5853;550;2099;599;1942;1149;4041
410070;201310;2162;6259;1755;5407;676;2288;346;938;1022;3226
410080;201310;1432;4387;1223;4012;300;1057;636;2002;936;3059
410090;201310;1113;3619;1013;3400;373;1354;308;977;681;2331
410100;201310;2809;8661;2245;7484;686;2622;462;1423;1148;4045
410105;201310;497;1631;400;1394;104;418;76;231;180;649
410110;201310;2554;8060;2260;7433;585;2194;803;2555;1388;4749
410115;201310;543;1536;467;1375;112;401;157;400;269;801
410120;201310;2853;9981;2709;9753;1108;4239;1038;3799;2146;8038
410130;201310;1364;4689;1246;4400;376;1306;597;2142;973;3448
410140;201310;14576;41875;10595;34301;3335;11998;3661;11693;6996;23691
410150;201310;16895;44126;8537;26478;1887;6662;1711;4708;3598;11370
410160;201310;3301;10786;3009;10283;1017;3826;1080;3711;2097;7537
410165;201310;762;2347;639;2075;136;479;311;979;447;1458
410170;201310;1700;5365;1460;4839;580;2079;412;1319;992;3398
410180;201310;8389;27542;7309;25121;1934;7564;3338;10645;5272;18209
410185;201310;663;1863;607;1769;159;492;354;1041;513;1533
410190;201310;2198;6737;1972;6241;646;2224;551;1634;1197;3858
410200;201310;4962;14622;4141;12993;1466;5062;714;2152;2180;7214
410210;201310;2557;7942;2041;6821;521;1976;409;1174;930;3150
410220;201310;611;1818;494;1578;101;360;185;566;286;926
410230;201310;1830;6034;1676;5754;662;2486;570;1882;1232;4368
410240;201310;5099;16270;4708;15448;1566;5546;1711;5550;3277;11096
410250;201310;2453;7136;1821;5848;611;2198;369;1048;980;3246
410260;201310;1658;5240;1469;4892;455;1628;530;1721;985;3349
410270;201310;534;1613;470;1496;147;507;195;626;342;1133
410275;201310;915;2772;665;2250;122;460;360;1215;482;1675
410280;201310;2745;8407;1954;6638;486;1864;321;1046;807;2910
410290;201310;3160;10133;2834;9495;844;3049;1111;3729;1955;6778
410300;201310;605;1778;547;1657;88;330;311;870;399;1200
410302;201310;547;1654;478;1546;56;184;317;1049;373;1233
410304;201310;1439;4822;1315;4571;397;1427;564;2035;961;3462
410305;201310;2157;5884;1850;5435;545;1691;995;2987;1540;4678
410310;201310;2282;7835;2100;7474;693;2675;724;2650;1417;5325
410315;201310;608;1920;487;1664;120;433;160;512;280;945
410320;201310;1213;3643;827;2838;201;804;73;202;274;1006
410322;201310;569;1729;430;1415;119;418;126;402;245;820
410330;201310;1453;4193;1238;3772;361;1211;377;1088;738;2299
410335;201310;1045;3159;892;2871;254;929;320;959;574;1888
410337;201310;776;2142;676;1969;139;479;293;795;432;1274
410340;201310;565;1736;437;1402;87;315;113;300;200;615
410345;201310;1812;5559;1506;4913;514;1839;352;1054;866;2893
410347;201310;828;2398;606;1972;184;662;145;433;329;1095
410350;201310;994;3212;762;2738;228;914;116;387;344;1301
410360;201310;3295;10415;3006;9923;1021;3642;899;2997;1920;6639
410370;201310;12571;37796;9655;31576;2662;9895;2817;8509;5479;18404
410380;201310;1346;4344;1254;4161;311;1112;672;2206;983;3318
410390;201310;2787;8361;2278;7437;840;2940;625;1894;1465;4834
410395;201310;871;3033;799;2876;214;871;389;1388;603;2259
410400;201310;5029;16661;4461;15516;1459;5660;1301;4355;2760;10015
410405;201310;937;2830;771;2491;209;800;320;947;529;1747
410410;201310;1349;4677;1280;4549;493;1927;305;1049;798;2976
410420;201310;9564;31828;8525;29480;2971;11187;2285;7388;5256;18575
410425;201310;3104;10217;2274;8274;544;2233;376;1303;920;3536
410430;201310;15023;42802;11543;36285;3496;12069;3402;10521;6898;22590
410440;201310;3507;11376;3249;10909;884;3182;1574;5299;2458;8481
410442;201310;2907;10328;2666;9741;958;3705;851;3124;1809;6829
410445;201310;2349;8081;2042;7505;667;2652;768;2934;1435;5586
410450;201310;2600;7612;2110;6634;689;2328;430;1220;1119;3548
410460;201310;2337;7198;1972;6423;530;1884;743;2309;1273;4193
410465;201310;1722;6618;1581;6258;599;2471;477;1782;1076;4253
410470;201310;1890;6123;1668;5607;503;1777;619;2077;1122;3854
410480;201310;29078;87397;24087;77630;9353;32845;6422;19845;15775;52690
410490;201310;11177;37371;9427;33458;3126;12029;3073;10790;6199;22819
410500;201310;1464;4783;1246;4300;479;1809;313;1085;792;2894
410510;201310;2319;6389;1769;5300;510;1671;721;2008;1231;3679
410520;201310;3180;11363;3031;11059;1188;4572;1031;3772;2219;8344
410530;201310;1621;4762;1377;4278;372;1345;530;1515;902;2860
410540;201310;3778;11196;2753;9224;731;2645;1010;3345;1741;5990
410550;201310;6338;20154;5054;17213;1692;6356;744;2283;2436;8639
410560;201310;1241;4104;985;3430;247;908;250;747;497;1655
410570;201310;2752;9230;2522;8839;781;2833;1069;3984;1850;6817
410580;201310;24757;80530;21996;74722;7643;28389;6519;21063;14162;49452
410590;201310;1196;3920;832;2864;163;638;202;615;365;1253
410600;201310;1857;5722;1609;5232;473;1604;700;2301;1173;3905
410610;201310;822;2616;723;2422;208;755;309;988;517;1743
410620;201310;1689;6217;1534;5808;518;2064;395;1456;913;3520
410630;201310;2495;7560;2157;6917;606;2169;838;2599;1444;4768
410640;201310;4856;14671;3962;12971;1349;4974;950;2954;2299;7928
410645;201310;1265;4594;1213;4487;518;2057;357;1348;875;3405
410650;201310;2420;7612;2029;6818;735;2615;530;1699;1265;4314
410655;201310;891;2810;762;2546;245;885;206;672;451;1557
410657;201310;598;1880;519;1708;165;643;198;583;363;1226
410660;201310;3765;11191;2979;9461;1105;3754;617;1826;1722;5580
410670;201310;988;2909;766;2454;205;734;200;596;405;1330
410680;201310;2327;8362;1985;7445;560;2137;707;2785;1267;4922
410685;201310;656;2037;617;1970;121;389;402;1295;523;1684
410690;201310;104997;311377;74266;247012;19164;70870;18828;56634;37992;127504
410700;201310;2230;7438;2109;7196;707;2633;854;2779;1561;5412
410710;201310;1056;3390;882;2969;237;895;240;752;477;1647
410712;201310;746;2371;665;2202;314;1132;162;554;476;1686
410715;201310;1067;3423;942;3153;267;971;322;1047;589;2018
410720;201310;3948;12703;3335;11339;1020;3693;928;3001;1948;6694
410725;201310;1097;3200;819;2655;218;764;245;707;463;1471
410730;201310;694;2151;636;2024;278;944;169;517;447;1461
410740;201310;920;2823;671;2303;161;632;290;974;451;1606
410750;201310;1785;5542;1586;5065;544;1933;448;1299;992;3232
410752;201310;249;774;223;726;53;205;106;318;159;523
410753;201310;514;1610;414;1398;107;416;148;461;255;877
410754;201310;981;3111;866;2913;122;456;582;2026;704;2482
410755;201310;712;2016;568;1776;120;447;280;811;400;1258
410760;201310;2417;8050;2311;7843;919;3296;802;2677;1721;5973
410765;201310;15249;46862;11738;39620;3013;11298;2251;7473;5264;18771
410770;201310;868;2539;731;2278;258;875;210;603;468;1478
410773;201310;1169;3749;1055;3530;283;1055;480;1486;763;2541
410775;201310;1801;5414;1738;5307;488;1422;1070;3432;1558;4854
410780;201310;603;1834;489;1627;151;526;146;537;297;1063
410785;201310;913;3032;743;2529;266;936;271;931;537;1867
410790;201310;738;2330;633;2083;227;841;132;368;359;1209
410800;201310;2353;6782;1986;6122;806;2731;603;1767;1409;4498
410810;201310;310;973;251;832;35;135;106;345;141;480
410820;201310;1048;3261;914;2944;276;982;245;775;521;1757
410830;201310;30230;93903;25566;85327;8102;29403;8660;28682;16762;58085
410832;201310;1156;3550;1062;3368;247;926;525;1538;772;2464
410840;201310;7259;23551;6210;21189;2169;8039;1333;4146;3502;12185
410845;201310;1568;4813;1387;4441;280;983;773;2491;1053;3474
410850;201310;2715;8161;2451;7785;556;2060;1321;4152;1877;6212
410855;201310;713;2071;604;1849;170;573;203;613;373;1186
410860;201310;3546;10550;3055;9655;787;2608;1424;4662;2211;7270
410865;201310;1643;5795;1483;5475;392;1557;718;2701;1110;4258
410870;201310;1374;4358;1297;4233;631;2241;348;1074;979;3315
410880;201310;4603;13886;3730;12250;1094;4108;957;2792;2051;6900
410890;201310;1087;3452;840;2969;282;1091;111;333;393;1424
410895;201310;1120;4020;1020;3783;370;1456;317;1130;687;2586
410900;201310;852;2476;671;2181;141;517;202;627;343;1144
410910;201310;308;980;273;916;61;219;126;403;187;622
410920;201310;812;2551;663;2272;208;764;181;572;389;1336
410930;201310;2036;6527;1799;6127;564;2223;661;2156;1225;4379
410940;201310;20338;70540;18424;66911;6222;24544;7613;27708;13835;52252
410950;201310;1872;6328;1710;6018;368;1357;1014;3632;1382;4989
410960;201310;6069;17855;4441;14868;1559;5621;1405;4793;2964;10414
410965;201310;1055;3466;947;3239;249;923;453;1573;702;2496
410970;201310;5069;15813;4238;14105;1478;5505;962;3217;2440;8722
410975;201310;1401;4201;1187;3818;224;853;608;1943;832;2796
410980;201310;5108;15541;3513;12043;981;3757;847;2751;1828;6508
410990;201310;1050;3287;802;2740;257;978;205;616;462;1594
411000;201310;459;1432;340;1164;80;306;52;158;132;464
411005;201310;481;1456;367;1170;100;322;64;178;164;500
411007;201310;2117;7001;1991;6755;629;2250;926;3268;1555;5518
411010;201310;3824;13319;3557;12707;1394;5460;841;2752;2235;8212
411020;201310;2571;8445;2352;8053;804;3079;846;2901;1650;5980
411030;201310;806;2291;706;2110;235;778;201;557;436;1335
411040;201310;374;1229;309;1073;107;394;65;220;172;614
411050;201310;2136;7834;1909;7284;756;3099;368;1355;1124;4454
411060;201310;2046;6630;1795;6104;595;2273;328;1002;923;3275
411065;201310;391;1205;314;1046;55;196;110;337;165;533
411070;201310;4156;13938;3191;11692;1066;4317;393;1257;1459;5574
411080;201310;1997;6431;1845;6113;492;1835;798;2622;1290;4457
411090;201310;1047;2931;899;2720;250;876;251;703;501;1579
411095;201310;1558;4611;1242;3997;322;1152;316;975;638;2127
411100;201310;1495;4387;1128;3654;267;966;270;843;537;1809
411110;201310;909;2777;700;2324;213;760;114;312;327;1072
411120;201310;1674;5386;1476;4966;486;1759;462;1525;948;3284
411125;201310;4643;15380;4515;15117;1609;5671;2141;7099;3750;12770
411130;201310;759;2383;634;2113;202;708;215;725;417;1433
411140;201310;2197;8016;1926;7290;712;2834;389;1551;1101;4385
411150;201310;5758;16685;4938;15117;1527;5115;1334;3710;2861;8825
411155;201310;1146;3515;1035;3262;369;1281;332;950;701;2231
411160;201310;306;927;277;873;113;367;83;252;196;619
411170;201310;779;2704;715;2548;214;821;230;802;444;1623
411180;201310;6071;19063;5343;17671;1697;6142;1629;5331;3326;11473
411190;201310;1777;5365;1498;4835;458;1643;446;1356;904;2999
411200;201310;3895;12558;3415;11755;1263;4734;1243;4195;2506;8929
411210;201310;2769;8150;2277;7250;883;3056;328;979;1211;4035
411220;201310;1189;3511;965;3087;249;920;405;1172;654;2092
411230;201310;1028;3218;823;2763;278;1024;216;669;494;1693
411240;201310;1387;3451;822;2547;258;897;199;525;457;1422
411250;201310;3102;8798;2548;7767;786;2486;811;2480;1597;4966
411260;201310;261;761;207;670;64;235;88;259;152;494
411270;201310;1998;6493;1850;6235;615;2308;783;2550;1398;4858
411275;201310;1513;4647;1324;4216;393;1297;360;1093;753;2390
411280;201310;1719;5406;1375;4658;409;1580;218;659;627;2239
411290;201310;1028;2947;854;2606;229;758;300;949;529;1707
411295;201310;1104;3391;1028;3263;226;805;460;1419;686;2224
411300;201310;1283;3387;896;2626;86;293;380;1024;466;1317
411310;201310;828;2462;667;2183;157;609;298;933;455;1542
411320;201310;5647;17841;4694;15891;1341;4766;1275;4186;2616;8952
411325;201310;1516;5016;1371;4726;189;758;909;3141;1098;3899
411330;201310;3455;11581;3169;11090;1260;4752;951;3300;2211;8052
411340;201310;972;2905;653;2139;129;473;269;888;398;1361
411342;201310;899;2621;727;2238;211;718;192;516;403;1234
411345;201310;1029;3394;962;3265;278;1030;487;1655;765;2685
411350;201310;2546;8193;1995;7073;671;2576;273;870;944;3446
411360;201310;510;1302;325;951;48;190;136;323;184;513
411370;201310;42117;125364;32200;106123;7565;29295;11091;33305;18656;62600
411373;201310;1383;4520;1188;4095;348;1375;279;900;627;2275
411375;201310;1320;3720;1065;3220;301;965;304;864;605;1829
411380;201310;1261;3431;795;2455;153;537;237;702;390;1239
411390;201310;1753;5492;1602;5281;274;1048;1122;3600;1396;4648
411400;201310;1639;5074;1357;4449;332;1229;465;1478;797;2707
411410;201310;2398;7633;2122;7005;720;2724;579;1621;1299;4345
411420;201310;4416;13044;3508;11115;1026;3618;776;2200;1802;5818
411430;201310;2771;9193;2401;8504;720;2743;1051;3608;1771;6351
411435;201310;550;1828;473;1625;130;488;161;533;291;1021
411440;201310;2553;8540;2348;8151;888;3337;688;2426;1576;5763
411450;201310;1968;6148;1802;5873;459;1580;947;3126;1406;4706
411460;201310;4235;13837;3369;11765;1339;4938;615;2029;1954;6967
411470;201310;910;2845;672;2240;188;679;123;370;311;1049
411480;201310;4511;14230;3707;12681;1700;6270;773;2511;2473;8781
411490;201310;1616;5226;1455;4933;636;2418;331;1005;967;3423
411500;201310;1452;4451;1117;3733;364;1340;263;832;627;2172
411510;201310;2421;7260;1941;6322;637;2297;392;1113;1029;3410
411520;201310;27325;79799;18852;61916;6383;23125;3883;12015;10266;35140
411530;201310;892;2634;622;2114;261;996;113;322;374;1318
411535;201310;442;1341;222;806;40;162;22;71;62;233
411540;201310;2956;8220;2377;7152;486;1569;1256;3862;1742;5431
411545;201310;982;3599;940;3507;218;893;601;2229;819;3122
411550;201310;708;2013;580;1804;259;880;120;344;379;1224
411560;201310;2541;7865;2138;6915;627;2210;485;1477;1112;3687
411570;201310;5649;16188;4382;14003;1339;4759;1106;3704;2445;8463
411573;201310;969;3078;927;3006;239;839;485;1598;724;2437
411575;201310;1409;4641;1236;4245;340;1232;482;1647;822;2879
411580;201310;3412;10508;2662;8999;648;2551;487;1432;1135;3983
411585;201310;445;1573;356;1311;93;364;51;173;144;537
411590;201310;559;1695;505;1581;140;507;140;409;280;916
411600;201310;355;1099;299;987;70;282;72;239;142;521
411605;201310;2270;6518;1710;5434;464;1626;650;1984;1114;3610
411610;201310;2159;6499;2057;6322;511;1687;1307;3964;1818;5651
411620;201310;2671;8994;2522;8737;874;3276;997;3509;1871;6785
411630;201310;687;1898;434;1486;137;541;86;257;223;798
411640;201310;575;1798;482;1601;137;498;174;539;311;1037
411650;201310;270;891;226;791;67;268;69;210;136;478
411660;201310;768;2310;674;2131;186;617;281;903;467;1520
411670;201310;1669;4990;1490;4649;508;1795;507;1461;1015;3256
411680;201310;1648;5233;1460;4908;393;1313;786;2824;1179;4137
411690;201310;3523;10816;2999;9844;1079;3813;801;2637;1880;6450
411695;201310;808;2657;689;2418;142;508;351;1250;493;1758
411700;201310;1805;5414;1378;4599;385;1447;383;1207;768;2654
411705;201310;2226;7752;1960;7245;485;1839;1145;4334;1630;6173
411710;201310;2138;6705;1701;5678;519;1905;357;1033;876;2938
411720;201310;818;2536;652;2135;151;547;163;497;314;1044
411721;201310;709;2177;596;1930;181;645;152;437;333;1082
411722;201310;661;2067;546;1834;144;555;164;505;308;1060
411725;201310;1266;4195;913;3333;249;1009;237;862;486;1871
411727;201310;2314;6764;1907;5915;515;1768;794;2343;1309;4111
411729;201310;510;1453;411;1284;78;272;158;454;236;726
411730;201310;5438;16522;4653;15007;1433;4989;1737;5589;3170;10578
411740;201310;511;1546;413;1336;127;483;158;459;285;942
411745;201310;849;2722;706;2374;202;751;173;539;375;1290
411750;201310;3939;12611;3225;10896;1030;3830;562;1707;1592;5537
411760;201310;8506;26211;7766;24962;2950;10031;2458;8287;5408;18318
411770;201310;3706;13501;3399;12748;1374;5375;760;2890;2134;8265
411780;201310;2927;10021;2845;9910;431;1441;2057;7553;2488;8994
411790;201310;2559;7890;2110;7011;713;2679;609;1927;1322;4606
411800;201310;1201;3713;780;2652;147;559;116;288;263;847
411810;201310;1485;4748;1291;4295;369;1402;337;938;706;2340
411820;201310;16040;51357;13518;46694;4789;17030;4237;15482;9026;32512
411830;201310;437;1233;362;1131;116;364;141;474;257;838
411840;201310;8378;25852;6936;22995;2177;7934;2049;6592;4226;14526
411845;201310;499;1631;400;1415;114;440;91;303;205;743
411850;201310;5810;18249;4926;16446;1382;5015;1445;4781;2827;9796
411860;201310;840;2781;725;2520;214;800;197;640;411;1440
411870;201310;980;3547;797;3037;142;572;196;708;338;1280
411880;201310;2455;7169;2089;6565;494;1744;1063;3342;1557;5086
411885;201310;1402;3955;1162;3590;368;1275;345;952;713;2227
411890;201310;1268;4011;937;3227;274;1058;207;617;481;1675
411900;201310;891;2923;698;2426;225;808;118;405;343;1213
411910;201310;1180;4169;1059;3872;323;1298;355;1229;678;2527
411915;201310;11391;33947;7979;26480;2074;7699;1907;5653;3981;13352
411920;201310;965;3537;881;3313;295;1210;187;667;482;1877
411925;201310;582;1720;467;1510;146;502;165;528;311;1030
411930;201310;6013;20418;5351;19049;1833;6954;1938;7044;3771;13998
411940;201310;3542;12193;3201;11434;1080;4054;880;3145;1960;7199
411950;201310;10123;33589;8852;31162;2775;10645;3855;13335;6630;23980
411960;201310;5505;17233;5169;16602;1471;5295;2343;7277;3814;12572
411965;201310;424;1483;374;1366;112;448;104;378;216;826
411970;201310;713;2155;582;1933;197;689;172;559;369;1248
411980;201310;2074;5817;1475;4853;184;672;828;2718;1012;3390
411990;201310;27501;97178;24276;90200;9335;36952;6400;24168;15735;61120
411995;201310;2955;9592;2729;9141;1130;4065;730;2416;1860;6481
412000;201310;1961;5612;1601;4970;361;1301;663;1805;1024;3106
412010;201310;712;2460;633;2276;196;737;203;707;399;1444
412015;201310;626;2008;523;1787;100;382;276;929;376;1311
412020;201310;421;1270;326;1077;117;424;124;388;241;812
412030;201310;583;1856;402;1417;90;378;118;381;208;759
412033;201310;694;2205;541;1836;141;526;93;288;234;814
412035;201310;924;2758;769;2467;200;741;310;919;510;1660
412040;201310;721;2431;654;2259;258;945;201;682;459;1627
412050;201310;1580;4853;1262;4150;320;1172;290;906;610;2078
412060;201310;7138;25546;6586;24246;2185;8531;2487;9121;4672;17652
412065;201310;952;2993;829;2736;248;928;235;713;483;1641
412070;201310;1077;3126;964;2887;211;691;388;1140;599;1831
412080;201310;1918;6224;1419;5081;426;1684;163;503;589;2187
412085;201310;270;759;163;557;46;173;42;137;88;310
412090;201310;4763;16091;4565;15721;1016;3802;2886;10028;3902;13830
412100;201310;2170;7049;1930;6621;655;2382;668;2269;1323;4651
412110;201310;990;3012;780;2585;270;944;258;839;528;1783
412120;201310;2328;8077;2138;7636;556;2182;1051;3620;1607;5802
412125;201310;954;3010;856;2851;262;956;333;1110;595;2066
412130;201310;748;2184;552;1803;122;456;138;429;260;885
412135;201310;548;1600;414;1312;87;308;183;526;270;834
412140;201310;1793;5598;1518;5037;452;1600;444;1471;896;3071
412150;201310;2725;8386;2417;7761;443;1581;1371;4276;1814;5857
412160;201310;1166;3724;912;3101;274;1052;323;1054;597;2106
412170;201310;4225;14611;3722;13598;1398;5426;1257;4526;2655;9952
412175;201310;1463;5216;1331;4909;383;1549;528;1966;911;3515
412180;201310;1688;5515;1331;4858;534;2139;345;1188;879;3327
412190;201310;2888;9052;2477;8368;996;3560;662;2354;1658;5914
412200;201310;2151;7511;1629;5985;411;1626;494;1757;905;3383
412210;201310;654;1980;468;1560;146;554;89;264;235;818
412215;201310;3103;10461;2837;9952;510;1854;1812;6553;2322;8407
412217;201310;1147;3485;1095;3391;235;850;675;1953;910;2803
412220;201310;5594;19005;5373;18569;1927;7035;2644;9079;4571;16114
412230;201310;2822;9995;2532;9352;859;3466;697;2461;1556;5927
412240;201310;8017;22876;4852;16123;1102;4080;686;2028;1788;6108
412250;201310;2129;6679;1939;6291;762;2666;480;1441;1242;4107
412260;201310;1272;3886;871;2989;210;827;256;762;466;1589
412265;201310;1136;3701;1061;3563;286;1154;490;1577;776;2731
412270;201310;731;2517;582;2124;144;597;100;330;244;927
412280;201310;783;2464;652;2209;180;655;299;989;479;1644
412290;201310;1199;3457;1021;3116;224;773;417;1224;641;1997
412300;201310;1738;5276;1443;4681;450;1670;428;1295;878;2965
412310;201310;1188;3457;1042;3264;220;589;675;2356;895;2945
412320;201310;713;1987;524;1655;136;509;198;602;334;1111
412330;201310;1955;5486;1508;4711;392;1329;671;2069;1063;3398
412340;201310;819;2681;605;2134;129;508;116;381;245;889
412350;201310;2410;7881;2041;7016;655;2434;396;1244;1051;3678
412360;201310;338;1111;297;999;69;246;80;227;149;473
412370;201310;1112;3524;877;3058;316;1157;247;849;563;2006
412380;201310;1957;6056;1728;5580;407;1364;745;2536;1152;3900
412382;201310;698;2039;520;1649;143;527;148;419;291;946
412385;201310;2439;7992;2267;7628;678;2399;859;2989;1537;5388
412390;201310;2383;7302;2209;7010;825;2853;774;2414;1599;5267
412395;201310;955;2719;776;2430;125;412;486;1548;611;1960
412400;201310;1183;3718;1058;3482;335;1187;433;1455;768;2642
412402;201310;2011;6396;1714;5753;548;1973;439;1343;987;3316
412405;201310;3928;11710;2569;8657;670;2596;261;766;931;3362
412410;201310;6110;20460;5587;19379;2493;9429;1080;3665;3573;13094
412420;201310;519;1570;432;1415;140;508;122;351;262;859
412430;201310;453;1388;381;1232;121;438;153;446;274;884
412440;201310;3969;12098;3519;11316;697;2485;1530;5148;2227;7633
412450;201310;413;1321;347;1158;88;327;78;211;166;538
412460;201310;975;2790;671;2210;169;648;160;492;329;1140
412470;201310;2024;7031;1851;6613;609;2325;694;2444;1303;4769
412480;201310;1321;3962;963;3169;227;817;180;485;407;1302
412490;201310;1273;3838;1141;3535;315;1027;327;1004;642;2031
412500;201310;1992;6074;1685;5451;523;1861;416;1224;939;3085
412510;201310;2696;9365;2404;8580;833;3205;776;2662;1609;5867
412520;201310;1804;5170;1403;4502;405;1392;496;1580;901;2972
412530;201310;782;2368;662;2107;218;749;170;516;388;1265
412535;201310;398;1216;282;920;78;276;97;271;175;547
412540;201310;1212;3648;944;3063;188;716;376;1194;564;1910
412545;201310;898;2610;749;2289;142;484;268;727;410;1211
412550;201310;23311;72372;16433;56616;4810;17907;3255;10414;8065;28321
412555;201310;310;984;230;777;57;205;42;113;99;318
412560;201310;4475;15520;3914;14308;1309;5191;860;2905;2169;8096
412570;201310;4112;12872;3258;10944;1020;3719;741;2420;1761;6139
412575;201310;1027;3304;860;2905;225;864;269;829;494;1693
412580;201310;1457;4066;1078;3405;264;899;358;1073;622;1972
412590;201310;479;1502;392;1343;158;576;94;319;252;895
412600;201310;1453;4752;1279;4391;448;1697;385;1252;833;2949
412610;201310;747;2454;612;2117;204;783;156;468;360;1251
412620;201310;1269;4266;1119;3942;419;1595;265;897;684;2492
412625;201310;13528;39094;11373;35032;4279;14220;2488;7567;6767;21787
412627;201310;945;2987;682;2409;227;861;83;279;310;1140
412630;201310;3465;11302;3082;10450;859;3147;946;3094;1805;6241
412635;201310;506;1593;385;1314;97;339;55;170;152;509
412640;201310;877;2756;674;2306;191;738;160;502;351;1240
412650;201310;2261;6537;1833;5750;504;1727;686;1941;1190;3668
412660;201310;2998;9224;2503;8169;661;2468;626;1904;1287;4372
412665;201310;716;1954;459;1502;140;507;131;401;271;908
412667;201310;1447;4448;1166;3872;302;1168;356;1074;658;2242
412670;201310;638;2042;432;1532;106;429;59;168;165;597
412680;201310;1405;4753;1200;4235;355;1335;332;1065;687;2400
412690;201310;636;2055;508;1760;185;704;73;237;258;941
412700;201310;1827;6140;1610;5755;616;2443;557;1927;1173;4370
412710;201310;8772;27998;7310;24934;2138;7939;1838;6029;3976;13968
412720;201310;1582;5063;1121;3887;283;1051;113;309;396;1360
412730;201310;2774;8548;1967;6807;621;2305;253;782;874;3087
412740;201310;2085;6958;1871;6457;764;2803;252;908;1016;3711
412750;201310;3280;11362;3112;11031;635;2510;2073;7165;2708;9675
412760;201310;2204;7539;2109;7370;680;2636;832;2748;1512;5384
412770;201310;11426;34350;7784;26235;1880;7069;1617;4931;3497;12000
412780;201310;1459;4902;1305;4531;400;1475;399;1308;799;2783
412785;201310;2383;7139;1817;5967;587;2071;720;2307;1307;4378
412788;201310;1331;4538;1253;4387;336;1371;537;1748;873;3119
412790;201310;1104;3573;936;3192;216;820;303;932;519;1752
412795;201310;1017;3080;874;2808;308;1073;276;842;584;1915
412796;201310;3127;9882;2929;9496;836;2974;1322;4170;2158;7144
412800;201310;3435;10514;2781;9238;796;2907;800;2497;1596;5404
412810;201310;9141;26582;6190;20122;1846;6575;1439;4243;3285;10818
412820;201310;6102;19143;4624;16159;1428;5408;1002;3538;2430;8946
412830;201310;399;1304;342;1190;105;429;82;233;187;662
412840;201310;2272;6659;1887;5904;573;1986;475;1463;1048;3449
412850;201310;2497;7702;2197;7275;431;1664;1149;3675;1580;5339
412853;201310;1637;4984;1461;4668;283;1129;805;2344;1088;3473
412855;201310;1647;4894;1347;4307;468;1714;354;977;822;2691
412860;201310;1240;3873;1101;3626;295;1092;502;1584;797;2676
412862;201310;788;2227;629;1909;179;603;216;608;395;1211
412863;201310;1202;4228;1159;4147;179;691;803;2859;982;3550
412865;201310;644;2050;480;1639;111;417;175;601;286;1018
412870;201310;1019;3027;877;2800;327;1136;281;895;608;2031
412880;201310;1564;4331;1320;3945;392;1294;348;985;740;2279
420005;201310;491;1583;370;1310;84;325;163;547;247;872
420010;201310;3190;10217;2750;9456;443;1648;1905;6603;2348;8251
420020;201310;742;2548;486;1818;97;409;67;211;164;620
420030;201310;490;1464;297;1067;88;362;56;179;144;541
420040;201310;992;3130;676;2506;228;929;166;549;394;1478
420050;201310;772;2522;640;2208;200;715;236;798;436;1513
420055;201310;291;990;220;806;56;213;47;157;103;370
420060;201310;378;1349;288;1114;71;298;42;151;113;449
420070;201310;1969;6415;1715;5785;319;1204;768;2687;1087;3891
420075;201310;174;543;113;387;30;119;30;84;60;203
420080;201310;550;1914;496;1789;184;727;100;347;284;1074
420090;201310;675;2429;516;2023;141;570;94;375;235;945
420100;201310;1466;4895;1366;4755;362;1277;842;2990;1204;4267
420110;201310;442;1528;398;1426;127;457;158;587;285;1044
420120;201310;310;1101;257;983;113;464;39;132;152;596
420125;201310;354;1496;340;1462;136;622;91;362;227;984
420127;201310;566;1784;273;1032;92;376;31;116;123;492
420130;201310;2675;9364;2393;8783;764;3171;886;2952;1650;6123
420140;201310;4811;14693;3592;12365;1126;4338;877;2843;2003;7181
420150;201310;697;2195;518;1754;179;652;134;403;313;1055
420160;201310;296;895;192;653;49;198;36;94;85;292
420165;201310;197;657;142;513;24;92;35;131;59;223
420170;201310;229;771;165;634;64;288;18;47;82;335
420180;201310;433;1443;275;1014;80;299;70;249;150;548
420190;201310;525;1724;366;1392;138;583;60;211;198;794
420195;201310;1393;4060;1110;3663;294;1075;530;1771;824;2846
420200;201310;2823;9392;1853;7119;635;2722;314;1052;949;3774
420205;201310;1012;3469;916;3281;302;1175;387;1398;689;2573
420207;201310;1243;3796;928;3134;301;1144;247;768;548;1912
420208;201310;529;1697;412;1445;169;626;119;416;288;1042
420209;201310;345;1166;221;826;47;186;52;198;99;384
420210;201310;1719;5754;1158;4528;330;1481;164;564;494;2045
420213;201310;851;3223;813;3138;169;680;529;2052;698;2732
420215;201310;478;1640;362;1292;111;426;65;218;176;644
420220;201310;421;1675;391;1595;166;727;78;275;244;1002
420230;201310;4415;14016;3510;12321;898;3520;1780;6139;2678;9659
420240;201310;12219;38546;8497;30690;2011;8610;3334;10758;5345;19368
420243;201310;549;1788;454;1570;132;523;143;482;275;1005
420245;201310;1082;3497;799;2900;217;922;177;552;394;1474
420250;201310;835;2734;786;2655;301;1102;317;1089;618;2191
420253;201310;651;1735;541;1586;121;375;258;833;379;1208
420257;201310;413;1329;341;1191;99;345;156;549;255;894
420260;201310;1311;4540;1202;4324;376;1480;556;1986;932;3466
420270;201310;469;1548;246;913;34;131;27;88;61;219
420280;201310;2576;7718;1832;6365;583;2288;550;1684;1133;3972
420285;201310;143;428;54;201;9;38;1;2;10;40
420287;201310;645;2019;555;1843;149;533;216;715;365;1248
420290;201310;5996;18224;3951;13477;1032;3885;1322;4217;2354;8102
420300;201310;5673;18481;3944;14628;1176;4940;771;2813;1947;7753
420310;201310;839;2582;803;2517;190;640;483;1457;673;2097
420315;201310;923;3191;751;2816;201;853;318;1190;519;2043
420320;201310;4697;15503;4036;14284;1289;5132;1557;5258;2846;10390
420325;201310;472;1559;453;1508;158;588;140;449;298;1037
420330;201310;1257;4481;1010;3792;361;1483;179;547;540;2030
420340;201310;1473;4690;1200;4044;286;1044;408;1318;694;2362
420350;201310;1557;5153;1373;4770;406;1505;589;2049;995;3554
420360;201310;3528;11672;2806;10051;1076;4204;490;1633;1566;5837
420370;201310;1934;5594;1753;5369;238;750;1406;4279;1644;5029
420380;201310;5343;18453;4555;16546;1495;5904;1183;4207;2678;10111
420390;201310;2038;6214;1251;4490;426;1676;273;878;699;2554
420395;201310;2099;6657;1613;5531;457;1779;359;1096;816;2875
420400;201310;1459;4480;1131;3841;356;1397;360;1137;716;2534
420410;201310;771;2224;578;1900;147;541;275;890;422;1431
420415;201310;497;1616;406;1381;118;431;144;483;262;914
420417;201310;803;2667;696;2420;155;544;333;1172;488;1716
420419;201310;412;1370;320;1208;159;640;76;292;235;932
420420;201310;14601;46237;11518;39559;3942;14637;3520;11929;7462;26566
420425;201310;1232;3541;798;2571;113;457;327;949;440;1406
420430;201310;4053;13000;2787;9951;855;3322;749;2608;1604;5930
420435;201310;193;675;146;546;69;290;23;77;92;367
420440;201310;1472;4403;911;3208;334;1275;155;489;489;1764
420445;201310;439;1303;338;1123;95;336;147;486;242;822
420450;201310;1257;3787;740;2683;181;747;147;427;328;1174
420455;201310;2247;7126;2014;6705;622;2368;835;2681;1457;5049
420460;201310;9422;30660;7844;27574;2385;9486;2960;9859;5345;19345
420470;201310;1155;3296;808;2661;243;881;239;761;482;1642
420475;201310;174;575;114;420;42;160;25;97;67;257
420480;201310;5977;18272;4953;16493;2087;7715;820;2638;2907;10353
420490;201310;689;2444;582;2188;180;708;144;513;324;1221
420500;201310;2104;6648;1774;6047;531;1938;911;3132;1442;5070
420510;201310;180;786;176;767;75;333;35;138;110;471
420515;201310;155;576;127;501;40;168;21;80;61;248
420517;201310;935;2942;855;2768;119;399;587;1936;706;2335
420519;201310;408;1181;303;956;63;201;118;386;181;587
420520;201310;707;2187;594;1995;169;616;237;773;406;1389
420530;201310;1351;4795;1118;4177;382;1571;256;832;638;2403
420535;201310;257;803;188;649;60;225;41;127;101;352
420540;201310;18738;58609;14578;49658;5208;19546;4276;13821;9484;33367
420543;201310;476;1333;353;1115;54;189;203;670;257;859
420545;201310;1505;4920;1245;4343;376;1476;369;1208;745;2684
420550;201310;4696;15881;4009;14241;1265;5053;1260;4370;2525;9423
420555;201310;461;1518;385;1344;149;566;108;365;257;931
420560;201310;579;1766;484;1568;84;305;249;815;333;1120
420570;201310;1917;6464;1565;5592;484;1934;471;1560;955;3494
420580;201310;1011;3537;867;3268;269;1130;380;1441;649;2571
420590;201310;3192;10353;2359;8385;604;2362;486;1599;1090;3961
420600;201310;836;2982;750;2772;225;907;295;1094;520;2001
420610;201310;602;2013;438;1627;142;585;73;240;215;825
420620;201310;1189;3842;1062;3599;410;1511;245;805;655;2316
420630;201310;1048;3490;835;2943;270;1050;239;709;509;1759
420640;201310;645;2222;357;1431;92;420;39;160;131;580
420650;201310;2247;7223;1340;4949;308;1280;245;756;553;2036
420660;201310;670;2043;554;1823;112;412;292;940;404;1352
420665;201310;769;2298;501;1710;92;362;176;531;268;893
420670;201310;1686;5557;1291;4634;352;1410;211;693;563;2103
420675;201310;230;750;167;596;41;166;77;251;118;417
420680;201310;485;1265;317;991;66;247;105;306;171;553
420690;201310;874;3129;672;2553;187;797;203;715;390;1512
420700;201310;6067;18925;5058;16800;1776;6575;1296;4048;3072;10623
420710;201310;733;2719;630;2495;245;1041;155;581;400;1622
420720;201310;1970;6195;1703;5827;482;1720;958;3287;1440;5007
420730;201310;4581;14584;4017;13555;1532;5492;1397;4638;2929;10130
420740;201310;729;2507;710;2475;182;686;451;1541;633;2227
420750;201310;2427;8095;1762;6421;421;1772;541;1727;962;3499
420757;201310;113;403;97;374;26;111;26;94;52;205
420760;201310;429;1425;314;1093;73;281;98;335;171;616
420765;201310;534;1940;403;1551;132;544;88;331;220;875
420768;201310;1246;4570;1088;4197;370;1489;393;1585;763;3074
420770;201310;863;2787;587;2139;187;747;158;538;345;1285
420775;201310;630;2059;503;1741;142;501;182;624;324;1125
420780;201310;1678;5266;1205;4113;357;1316;356;1144;713;2460
420785;201310;324;1024;230;777;35;140;88;268;123;408
420790;201310;1332;4957;1114;4328;337;1388;425;1613;762;3001
420800;201310;894;2708;563;1946;160;620;122;381;282;1001
420810;201310;2513;8977;2051;7855;724;3098;534;1969;1258;5067
420820;201310;7489;26769;6447;24806;2342;10042;2289;8661;4631;18703
420830;201310;2658;9139;2300;8438;907;3596;763;2693;1670;6289
420840;201310;791;2565;541;2026;165;693;156;533;321;1226
420845;201310;1100;3869;928;3516;339;1408;152;531;491;1939
420850;201310;1864;6305;1323;5166;457;1946;278;1086;735;3032
420860;201310;661;1977;450;1572;187;730;152;514;339;1244
420870;201310;1372;4097;1106;3715;442;1628;327;1075;769;2703
420880;201310;1450;4980;1207;4319;346;1281;251;868;597;2149
420890;201310;12452;30071;5885;18721;1227;4611;2290;6580;3517;11191
420895;201310;218;615;106;359;38;131;26;90;64;221
420900;201310;2268;6762;1535;5295;457;1727;380;1240;837;2967
420910;201310;22385;70832;15150;54849;4088;16833;3849;12988;7937;29821
420915;201310;655;2595;604;2458;169;697;273;1177;442;1874
420917;201310;401;1259;234;773;51;200;76;202;127;402
420920;201310;183;540;105;367;41;152;17;60;58;212
420930;201310;19673;62018;17189;57352;5817;21141;5783;19199;11600;40340
420940;201310;4477;14275;3925;13014;1244;4589;1253;3849;2497;8438
420945;201310;236;747;157;549;43;169;41;139;84;308
420950;201310;545;1687;301;1148;82;344;59;221;141;565
420960;201310;1440;4599;1226;4199;424;1611;383;1196;807;2807
420970;201310;2654;8626;2356;8140;665;2454;1205;4266;1870;6720
420980;201310;404;1434;365;1347;114;416;189;741;303;1157
420985;201310;485;1558;342;1240;108;427;86;299;194;726
420990;201310;872;2653;597;2153;153;608;177;584;330;1192
421000;201310;671;2435;485;1935;155;678;57;175;212;853
421003;201310;621;1849;271;968;63;252;41;128;104;380
421005;201310;239;813;216;769;67;263;102;361;169;624
421010;201310;6691;21375;5311;18490;1826;6828;1587;5276;3413;12104
421020;201310;513;1735;415;1530;86;318;222;873;308;1191
421030;201310;1044;3878;953;3633;345;1390;297;1145;642;2535
421040;201310;855;2741;759;2572;263;986;271;847;534;1833
421050;201310;1909;5286;1190;4064;318;1237;423;1346;741;2583
421055;201310;264;903;189;697;46;187;50;166;96;353
421060;201310;528;2013;438;1746;134;572;92;337;226;909
421070;201310;777;2519;541;1953;148;599;167;620;315;1219
421080;201310;664;2192;615;2088;207;753;251;828;458;1581
421085;201310;520;1472;295;1054;78;308;64;241;142;549
421090;201310;415;1253;318;1031;83;280;141;462;224;742
421100;201310;975;3134;740;2593;207;763;178;552;385;1315
421105;201310;1378;4636;1233;4356;336;1270;524;1919;860;3189
421110;201310;1629;5436;1415;5070;523;2050;447;1521;970;3571
421120;201310;1576;5326;1228;4444;313;1325;377;1250;690;2575
421125;201310;373;1247;325;1134;123;463;110;352;233;815
421130;201310;4528;15402;3887;14206;1589;6256;1162;4334;2751;10590
421140;201310;434;1410;351;1218;112;421;120;400;232;821
421145;201310;491;1657;414;1462;72;287;189;639;261;926
421150;201310;525;1791;412;1564;112;456;167;629;279;1085
421160;201310;826;2603;570;2055;135;538;177;596;312;1134
421165;201310;319;1172;262;978;64;255;104;404;168;659
421170;201310;1838;6083;1572;5358;494;1795;732;2423;1226;4218
421175;201310;1339;4128;1064;3655;362;1424;329;1036;691;2460
421180;201310;518;1565;328;1141;106;428;129;400;235;828
421185;201310;430;1314;354;1160;69;217;183;633;252;850
421187;201310;318;1018;263;909;78;284;95;307;173;591
421189;201310;527;1648;469;1529;134;467;167;533;301;1000
421190;201310;9620;31932;7543;27435;2475;9602;2230;8065;4705;17667
421200;201310;1055;3616;923;3305;286;1114;308;1053;594;2167
421205;201310;196;658;152;554;32;135;37;113;69;248
421210;201310;2050;6509;1788;5845;609;2109;564;1844;1173;3953
421220;201310;2464;8602;2212;8089;751;2947;701;2594;1452;5541
421223;201310;810;2418;554;1968;174;658;261;922;435;1580
421225;201310;1167;3701;989;3331;297;1085;376;1251;673;2336
421227;201310;938;3270;877;3170;260;936;505;1900;765;2836
421230;201310;745;2567;674;2385;198;767;237;775;435;1542
421240;201310;543;1863;368;1353;90;354;51;163;141;517
421250;201310;1865;5917;1347;4972;494;1993;364;1294;858;3287
421260;201310;254;812;158;615;40;158;33;123;73;281
421265;201310;12;48;7;32;3;14;3;15;6;29
421270;201310;656;1875;416;1451;150;561;81;301;231;862
421280;201310;1592;5135;1314;4700;471;1964;349;1209;820;3173
421290;201310;1933;5648;1306;4416;446;1599;282;871;728;2470
421300;201310;300;988;268;922;115;438;96;303;211;741
421310;201310;512;1793;441;1595;152;555;110;394;262;949
421315;201310;367;1137;237;861;51;191;59;196;110;387
421320;201310;535;1866;359;1351;70;297;62;180;132;477
421330;201310;631;2251;544;2066;230;986;67;240;297;1226
421335;201310;567;1895;449;1651;127;513;91;331;218;844
421340;201310;1690;5703;1536;5426;543;2079;589;2059;1132;4138
421350;201310;1065;3697;880;3298;311;1282;236;827;547;2109
421360;201310;3227;9974;2182;7834;510;2114;729;2489;1239;4603
421370;201310;1091;3952;941;3602;334;1404;254;952;588;2356
421380;201310;1021;3040;850;2702;172;593;416;1316;588;1909
421390;201310;187;622;148;525;23;87;42;152;65;239
421400;201310;376;1485;311;1319;134;583;75;297;209;880
421410;201310;364;1165;292;1013;73;258;132;479;205;737
421415;201310;319;1058;206;813;69;282;58;216;127;498
421420;201310;1412;4530;1081;3681;266;968;232;728;498;1696
421430;201310;275;940;219;825;78;339;45;160;123;499
421440;201310;803;2516;575;2075;182;706;221;770;403;1476
421450;201310;615;2195;508;1936;209;844;116;444;325;1288
421460;201310;644;2157;469;1769;127;538;108;366;235;904
421470;201310;486;1909;447;1809;140;595;178;706;318;1301
421480;201310;2694;8858;1939;7205;623;2604;554;1863;1177;4467
421490;201310;270;977;198;793;96;403;39;156;135;559
421500;201310;2638;9652;2362;9070;1029;4327;521;1913;1550;6240
421505;201310;400;1407;363;1306;133;484;123;450;256;934
421507;201310;605;2114;495;1831;120;456;196;723;316;1179
421510;201310;293;1129;268;1072;85;389;111;387;196;776
421520;201310;778;2155;522;1623;60;232;266;747;326;979
421530;201310;445;1529;316;1245;97;433;109;405;206;838
421535;201310;674;2161;438;1633;101;402;209;772;310;1174
421540;201310;378;1206;331;1110;81;308;122;392;203;700
421545;201310;1217;4307;1004;3853;331;1415;203;729;534;2144
421550;201310;2124;7513;1952;7155;769;3059;586;2061;1355;5120
421555;201310;227;753;131;477;33;132;34;113;67;245
421560;201310;173;555;87;332;23;94;13;51;36;145
421565;201310;1082;3479;985;3307;447;1611;300;964;747;2575
421567;201310;947;3625;818;3268;400;1636;155;622;555;2258
421568;201310;469;1606;390;1433;116;437;126;473;242;910
421569;201310;174;597;110;408;21;87;29;94;50;181
421570;201310;983;3392;757;2859;271;1123;194;689;465;1812
421575;201310;603;2083;540;1949;116;437;282;1037;398;1474
421580;201310;4226;14348;3421;12532;1369;5550;748;2462;2117;8012
421590;201310;260;833;209;723;46;166;94;309;140;475
421600;201310;759;2439;613;2127;201;748;164;542;365;1290
421605;201310;667;2154;471;1739;139;578;108;380;247;958
421610;201310;1841;4865;1446;4291;212;681;921;2742;1133;3423
421620;201310;4775;15128;3527;12466;1275;4847;1141;4041;2416;8888
421625;201310;370;1256;239;887;67;277;76;262;143;539
421630;201310;2556;7981;1687;5950;477;1841;427;1454;904;3295
421635;201310;283;1008;242;935;69;287;91;322;160;609
421640;201310;1092;3613;977;3415;221;784;591;2115;812;2899
421650;201310;2401;8316;2120;7672;865;3408;345;1192;1210;4600
421660;201310;9032;31296;7420;28013;2606;10792;2198;7835;4804;18627
421670;201310;1093;3768;873;3215;257;1033;254;927;511;1960
421680;201310;1432;4831;1292;4482;530;1977;227;710;757;2687
421690;201310;2038;6951;1588;5813;481;1894;287;1008;768;2902
421700;201310;719;2327;490;1833;171;701;118;373;289;1074
421710;201310;334;1208;277;1053;110;424;71;263;181;687
421715;201310;276;838;185;638;50;181;56;192;106;373
421720;201310;1599;5275;1319;4736;542;2142;386;1281;928;3423
421725;201310;127;464;122;450;39;150;51;184;90;334
421730;201310;600;1914;325;1234;88;377;79;246;167;623
421740;201310;687;2229;530;1853;159;643;126;353;285;996
421750;201310;1349;4286;1112;3770;348;1284;372;1148;720;2432
421755;201310;427;1444;336;1188;102;390;97;317;199;707
421760;201310;401;1334;290;1085;87;367;127;443;214;810
421770;201310;3657;11411;3018;10129;1332;4667;736;2528;2068;7195
421775;201310;545;1709;387;1390;93;335;120;433;213;768
421780;201310;1716;6115;1397;5380;585;2417;367;1332;952;3749
421790;201310;948;2812;623;2237;200;823;145;466;345;1289
421795;201310;383;1207;281;933;50;175;83;276;133;451
421800;201310;2420;8231;1936;7226;571;2385;620;2088;1191;4473
421810;201310;703;2409;593;2124;185;713;129;433;314;1146
421820;201310;1065;3546;904;3202;215;909;319;1029;534;1938
421825;201310;1312;4590;1221;4355;219;874;669;2329;888;3203
421830;201310;3047;10767;2873;10422;701;2616;1573;6012;2274;8628
421835;201310;180;585;143;523;55;231;54;173;109;404
421840;201310;514;1856;462;1723;193;792;154;531;347;1323
421850;201310;571;1688;430;1444;143;499;131;469;274;968
421860;201310;442;1501;336;1268;73;307;95;340;168;647
421870;201310;5131;15613;3722;12632;1206;4394;682;2244;1888;6638
421875;201310;323;1017;201;732;50;208;51;154;101;362
421880;201310;1029;3538;832;3036;266;1104;201;646;467;1750
421885;201310;357;1282;321;1181;91;348;131;475;222;823
421890;201310;1069;3767;922;3445;324;1298;282;1025;606;2323
421895;201310;425;1473;405;1436;118;432;214;776;332;1208
421900;201310;872;2894;726;2531;205;759;254;801;459;1560
421910;201310;516;1747;388;1433;111;474;104;323;215;797
421915;201310;614;1931;501;1681;116;439;200;631;316;1070
421917;201310;550;1784;441;1573;143;598;135;429;278;1027
421920;201310;769;2433;625;2221;299;1158;176;560;475;1718
421930;201310;3758;11318;2746;9325;866;3246;455;1507;1321;4753
421935;201310;864;3172;713;2791;207;887;250;954;457;1841
421940;201310;290;1163;243;1006;91;405;55;200;146;605
421950;201310;4309;12532;2538;8847;812;3013;511;1806;1323;4819
421960;201310;259;843;209;724;55;209;59;197;114;406
421970;201310;1989;6314;1562;5324;544;2020;354;1094;898;3114
421985;201310;413;1212;264;895;46;186;90;313;136;499
430003;201310;921;2732;734;2404;212;783;258;828;470;1611
430005;201310;287;990;251;910;59;237;134;454;193;691
430010;201310;2002;6144;1596;5278;537;1809;581;1976;1118;3785
430020;201310;1096;3032;964;2832;242;809;518;1431;760;2240
430030;201310;1467;4233;1319;3919;401;1252;504;1432;905;2684
430040;201310;12926;33667;11298;31337;3492;10023;5282;15061;8774;25084
430045;201310;722;2028;585;1765;109;372;346;1004;455;1376
430047;201310;203;590;167;520;42;137;84;262;126;399
430050;201310;995;2911;684;2276;141;550;304;939;445;1489
430055;201310;256;761;194;622;47;166;101;314;148;480
430057;201310;69;182;29;97;7;30;11;24;18;54
430060;201310;14073;47607;12859;45456;4364;16010;5910;21360;10274;37370
430063;201310;1049;3216;890;2852;261;878;392;1293;653;2171
430064;201310;1646;5020;1408;4600;368;1218;747;2543;1115;3761
430066;201310;165;435;123;368;35;117;59;168;94;285
430070;201310;501;1696;403;1442;113;435;123;411;236;846
430080;201310;592;1993;482;1731;126;510;134;441;260;951
430085;201310;613;1854;488;1630;149;549;218;692;367;1241
430087;201310;955;2941;929;2890;98;325;754;2329;852;2654
430090;201310;733;1996;270;906;40;148;82;282;122;430
430100;201310;994;3241;819;2890;307;1186;203;613;510;1799
430105;201310;662;2257;567;2070;220;849;135;478;355;1327
430107;201310;258;867;208;716;40;147;93;307;133;454
430110;201310;2158;6556;2019;6333;670;2285;944;2914;1614;5199
430120;201310;1713;5393;1421;4774;294;1048;845;2816;1139;3864
430130;201310;4500;11674;4166;11250;740;2122;2768;7600;3508;9722
430140;201310;1179;3879;920;3244;309;1094;310;1107;619;2201
430150;201310;881;2447;631;1972;157;527;202;611;359;1138
430155;201310;498;1601;378;1324;104;355;150;534;254;889
430160;201310;18240;54730;17092;52860;3867;13220;9662;30372;13529;43592
430163;201310;1840;5689;1596;5222;386;1428;747;2453;1133;3881
430165;201310;275;982;237;909;109;428;41;157;150;585
430170;201310;754;2254;395;1398;99;395;87;270;186;665
430175;201310;946;3083;776;2708;184;592;409;1529;593;2121
430180;201310;1135;3182;994;2964;218;696;534;1612;752;2308
430185;201310;748;1898;409;1240;68;246;140;364;208;610
430187;201310;752;2365;686;2264;183;720;303;954;486;1674
430190;201310;2241;6804;1985;6349;521;1907;948;3040;1469;4947
430192;201310;185;585;102;332;18;63;35;108;53;171
430195;201310;213;650;81;306;13;51;13;41;26;92
430200;201310;1770;5891;1528;5405;560;2106;282;995;842;3101
430205;201310;490;1503;404;1349;51;214;273;887;324;1101
430210;201310;5998;17787;3585;12444;1015;3725;671;2180;1686;5905
430215;201310;320;968;257;849;65;231;114;362;179;593
430220;201310;640;1708;316;1077;68;267;54;169;122;436
430222;201310;310;982;243;835;69;269;99;315;168;584
430223;201310;304;966;283;929;61;205;186;617;247;822
430225;201310;57;169;37;120;6;14;7;20;13;34
430230;201310;2153;6872;2031;6742;354;1099;1537;5281;1891;6380
430235;201310;244;836;205;743;66;264;49;154;115;418
430237;201310;388;1110;332;1007;47;179;227;657;274;836
430240;201310;1002;3154;836;2806;311;1184;238;695;549;1879
430245;201310;815;2848;713;2598;201;757;309;1146;510;1903
430250;201310;1607;4556;1465;4297;535;1665;563;1697;1098;3362
430258;201310;175;543;138;459;22;79;69;215;91;294
430260;201310;812;2356;552;1804;76;284;321;1048;397;1332
430265;201310;323;1044;262;887;100;357;32;83;132;440
430270;201310;3409;9956;3114;9463;873;3025;1529;4554;2402;7579
430280;201310;5120;15096;4567;14054;1442;4745;1967;5947;3409;10692
430290;201310;2407;6854;2294;6731;325;982;1850;5506;2175;6488
430300;201310;9576;30214;8363;27902;3457;12070;3034;10469;6491;22539
430310;201310;8264;26741;7540;25342;2622;9495;3060;10040;5682;19535
430320;201310;803;2514;602;2094;97;332;308;1115;405;1447
430330;201310;966;2710;841;2474;230;734;353;958;583;1692
430340;201310;705;1897;454;1543;112;433;212;709;324;1142
430350;201310;6112;19936;5304;18121;2035;7349;1812;6069;3847;13418
430355;201310;225;629;146;480;26;109;36;101;62;210
430360;201310;1110;2971;983;2752;168;516;594;1649;762;2165
430367;201310;333;942;234;755;38;138;83;243;121;381
430370;201310;584;1766;491;1573;167;582;134;392;301;974
430380;201310;856;2242;473;1538;139;475;166;560;305;1035
430390;201310;4038;12437;3200;10581;828;3029;1029;3188;1857;6217
430400;201310;1276;3112;916;2599;206;698;494;1304;700;2002
430410;201310;680;1906;546;1681;105;371;281;846;386;1217
430420;201310;4414;13188;3705;11576;1162;3734;1477;4633;2639;8367
430430;201310;703;2048;513;1690;170;602;131;399;301;1001
430435;201310;1894;5311;1669;4901;380;1141;991;2955;1371;4096
430440;201310;4344;13767;3752;12799;854;3226;1702;5970;2556;9196
430450;201310;9068;26807;7585;23678;2774;9091;2541;7901;5315;16992
430460;201310;24490;76786;20558;69585;7115;25804;7313;24810;14428;50614
430461;201310;475;1347;160;524;37;126;37;125;74;251
430462;201310;333;1002;282;917;117;401;90;291;207;692
430463;201310;3802;12780;3398;11928;930;3579;1627;5691;2557;9270
430465;201310;613;1743;513;1563;127;430;308;929;435;1359
430466;201310;4223;12803;4003;12405;1289;4332;1823;5633;3112;9965
430467;201310;574;1793;509;1673;140;511;238;760;378;1271
430468;201310;1398;4230;1253;3990;547;1901;250;759;797;2660
430469;201310;125;344;40;159;11;44;11;50;22;94
430470;201310;7004;19216;5482;16750;1924;6395;1857;5633;3781;12028
430471;201310;922;3160;829;2950;310;1156;187;669;497;1825
430480;201310;802;2293;457;1508;78;295;90;248;168;543
430485;201310;228;726;133;494;28;101;45;181;73;282
430490;201310;528;1587;371;1280;110;397;125;439;235;836
430495;201310;402;1244;292;1005;75;290;79;260;154;550
430500;201310;1634;4684;1425;4321;411;1380;677;2005;1088;3385
430510;201310;26129;83588;20549;69537;7253;26796;5725;18447;12978;45243
430511;201310;469;1464;293;1012;79;264;59;204;138;468
430512;201310;1308;3515;1169;3283;339;982;483;1415;822;2397
430513;201310;647;1879;473;1520;88;285;219;705;307;990
430515;201310;595;1815;494;1591;101;345;213;701;314;1046
430517;201310;1335;4561;1244;4360;248;935;770;2662;1018;3597
430520;201310;1733;5218;1428;4560;467;1597;563;1751;1030;3348
430530;201310;961;2793;589;1920;143;538;171;488;314;1026
430535;201310;2334;7778;2024;7038;566;2163;675;2324;1241;4487
430537;201310;601;1749;431;1472;58;195;332;1162;390;1357
430540;201310;729;1825;568;1602;128;406;329;888;457;1294
430543;201310;595;1596;535;1535;135;417;334;970;469;1387
430544;201310;689;2411;610;2183;156;586;298;1036;454;1622
430545;201310;1343;4400;1198;4220;430;1404;616;2441;1046;3845
430550;201310;602;1927;481;1649;123;473;200;663;323;1136
430558;201310;117;354;87;291;30;110;13;34;43;144
430560;201310;330;919;253;766;51;200;114;324;165;524
430570;201310;1143;3117;862;2611;215;713;432;1239;647;1952
430580;201310;1025;3019;730;2411;261;892;210;711;471;1603
430583;201310;116;328;56;184;5;19;13;43;18;62
430585;201310;329;941;247;758;84;301;108;300;192;601
430587;201310;300;969;263;887;119;417;78;258;197;675
430590;201310;1546;4440;1463;4304;318;1068;860;2456;1178;3524
430593;201310;37;146;35;139;14;60;10;37;24;97
430595;201310;164;513;105;385;38;146;15;44;53;190
430597;201310;366;1180;312;1057;56;207;134;437;190;644
430600;201310;1864;5461;1365;4319;331;1113;496;1539;827;2652
430605;201310;1297;4216;1083;3749;272;1029;441;1569;713;2598
430607;201310;664;1865;586;1721;137;459;338;938;475;1397
430610;201310;7834;21884;6402;19565;1476;5012;3166;9638;4642;14650
430613;201310;214;565;135;415;40;129;46;131;86;260
430620;201310;944;2983;799;2655;250;931;299;909;549;1840
430630;201310;447;1383;282;960;80;274;61;193;141;467
430632;201310;715;2038;486;1557;84;317;273;823;357;1140
430635;201310;647;1866;488;1557;109;357;243;778;352;1135
430637;201310;515;1488;479;1425;91;316;315;884;406;1200
430640;201310;1783;5242;1042;3495;248;879;208;592;456;1471
430642;201310;465;1284;347;1095;73;255;184;588;257;843
430645;201310;171;529;108;378;27;103;26;83;53;186
430650;201310;2029;6934;1792;6372;410;1531;983;3579;1393;5110
430655;201310;300;931;267;852;66;235;95;255;161;490
430660;201310;5801;17823;4767;15855;1584;5762;1843;6052;3427;11814
430670;201310;504;1490;457;1399;48;138;345;1095;393;1233
430673;201310;751;1902;450;1399;125;399;207;650;332;1049
430675;201310;184;554;132;436;25;95;62;200;87;295
430676;201310;4430;13833;4127;13333;1281;4466;1927;6386;3208;10852
430680;201310;1217;3681;932;3040;224;846;369;1097;593;1943
430690;201310;4352;12945;3708;11710;1195;3910;1523;4981;2718;8891
430692;201310;282;985;216;837;37;150;136;531;173;681
430693;201310;1764;5114;1382;4250;317;1046;448;1352;765;2398
430695;201310;509;1482;417;1294;95;337;194;561;289;898
430697;201310;432;1257;337;1090;117;381;132;459;249;840
430700;201310;10480;28480;5730;18843;1265;4671;866;2603;2131;7274
430705;201310;409;1297;381;1247;134;476;151;490;285;966
430710;201310;1806;4851;1481;4325;314;1000;807;2461;1121;3461
430720;201310;852;2208;569;1791;166;562;230;755;396;1317
430730;201310;1701;4891;1481;4549;358;1098;836;2687;1194;3785
430740;201310;606;1802;392;1325;126;451;55;156;181;607
430745;201310;534;1555;385;1237;67;225;189;593;256;818
430750;201310;1735;5140;1537;4766;425;1475;786;2313;1211;3788
430755;201310;647;1880;475;1493;117;421;203;571;320;992
430760;201310;3559;9281;2881;8457;624;2015;1601;4865;2225;6880
430770;201310;6683;20557;5636;18675;1443;5266;2634;8541;4077;13807
430780;201310;2126;6339;1674;5459;517;1833;635;1924;1152;3757
430781;201310;635;1992;483;1680;148;544;167;569;315;1113
430783;201310;563;1518;447;1316;92;303;205;554;297;857
430786;201310;116;409;103;370;40;157;13;44;53;201
430790;201310;3360;9630;2387;7679;554;2057;1059;3223;1613;5280
430800;201310;736;2359;623;2077;165;589;228;741;393;1330
430805;201310;445;1335;351;1154;29;110;242;807;271;917
430807;201310;289;922;253;842;63;263;94;263;157;526
430810;201310;514;1567;310;1094;62;260;60;188;122;448
430820;201310;1201;4082;1002;3576;336;1291;305;1024;641;2315
430825;201310;450;1301;250;810;48;160;72;220;120;380
430830;201310;2718;8121;2517;7779;405;1298;1627;5306;2032;6604
430840;201310;940;3007;881;2871;243;769;397;1363;640;2132
430843;201310;98;326;77;255;15;48;31;99;46;147
430845;201310;439;1326;367;1189;122;420;73;228;195;648
430850;201310;3257;10257;2951;9670;925;3212;1171;3817;2096;7029
430860;201310;632;2175;545;1963;188;783;124;393;312;1176
430865;201310;712;2011;661;1916;208;614;326;961;534;1575
430870;201310;526;1554;376;1277;140;480;114;373;254;853
430880;201310;1350;4049;1125;3593;467;1595;279;916;746;2511
430885;201310;178;580;152;530;53;204;43;140;96;344
430890;201310;1850;5176;1580;4711;196;666;1026;3046;1222;3712
430900;201310;3205;8881;3042;8667;579;1710;2055;5993;2634;7703
430905;201310;1050;3225;773;2606;278;1000;194;637;472;1637
430910;201310;1736;5733;1520;5321;605;2282;542;1837;1147;4119
430912;201310;569;1675;455;1478;76;289;242;759;318;1048
430915;201310;388;1414;303;1214;88;386;80;327;168;713
430920;201310;16744;54876;15888;53420;5753;19998;8429;28389;14182;48387
430925;201310;90;260;72;224;21;73;37;112;58;185
430930;201310;8883;28802;7600;26134;2314;8430;3074;10886;5388;19316
430940;201310;1097;3502;902;3112;218;857;304;1002;522;1859
430950;201310;1595;4623;1231;3812;371;1220;399;1208;770;2428
430955;201310;91;303;73;255;28;110;17;50;45;160
430957;201310;316;1085;260;957;76;295;102;375;178;670
430960;201310;1690;5034;1445;4602;578;1903;474;1530;1052;3433
430965;201310;1260;4027;1100;3699;222;871;698;2268;920;3139
430970;201310;506;1502;342;1145;94;349;95;307;189;656
430975;201310;631;2098;511;1821;106;391;302;1081;408;1472
430980;201310;555;1396;350;1097;100;357;125;345;225;702
430990;201310;632;2102;487;1714;167;611;104;364;271;975
430995;201310;697;2141;646;2045;224;719;268;871;492;1590
431000;201310;1597;4480;1006;3250;264;973;150;419;414;1392
431010;201310;2723;8274;1938;6632;568;2166;613;1954;1181;4120
431020;201310;14026;35889;9975;28486;2952;8851;3208;9430;6160;18281
431030;201310;410;1273;263;908;56;198;68;247;124;445
431033;201310;2849;8443;2624;8109;618;1979;1528;4981;2146;6960
431036;201310;190;558;95;324;25;94;25;70;50;164
431040;201310;999;3006;860;2757;243;861;430;1350;673;2211
431041;201310;583;1644;525;1559;201;635;172;534;373;1169
431043;201310;378;1297;313;1140;142;562;110;362;252;924
431046;201310;112;349;86;290;24;86;33;107;57;193
431050;201310;1795;4580;1568;4292;312;853;1039;2943;1351;3796
431053;201310;601;2035;520;1856;165;654;187;648;352;1302
431055;201310;645;1898;610;1831;84;259;441;1344;525;1603
431057;201310;325;961;196;697;58;223;79;277;137;500
431060;201310;6207;18524;5913;18172;1236;3461;4120;13354;5356;16815
431065;201310;432;1351;412;1315;49;168;285;909;334;1077
431070;201310;755;2257;506;1678;135;461;139;417;274;878
431075;201310;272;837;181;628;36;139;59;205;95;344
431080;201310;666;2206;559;1975;164;621;101;338;265;959
431085;201310;918;2514;749;2229;145;454;417;1246;562;1700
431087;201310;604;1773;554;1683;54;150;417;1294;471;1444
431090;201310;491;1318;297;941;93;314;80;235;173;549
431100;201310;4646;13198;3992;12054;1169;3748;1700;5242;2869;8990
431110;201310;1571;4416;1299;3868;352;1120;671;1940;1023;3060
431112;201310;661;2146;631;2094;225;738;302;1044;527;1782
431113;201310;628;1943;475;1579;164;538;129;449;293;987
431115;201310;1463;4499;1346;4287;318;1081;785;2468;1103;3549
431120;201310;2643;8737;2398;8249;758;2909;1017;3349;1775;6258
431123;201310;515;1673;443;1526;127;447;210;747;337;1194
431125;201310;1327;4267;1100;3782;337;1204;456;1658;793;2862
431127;201310;114;329;66;211;12;40;12;38;24;78
431130;201310;3850;11372;3273;10394;998;3462;1421;4556;2419;8018
431140;201310;3627;9865;2244;7401;473;1829;727;2129;1200;3958
431142;201310;550;1680;509;1614;63;214;349;1128;412;1342
431150;201310;1299;4026;1077;3604;312;1059;378;1307;690;2366
431160;201310;902;2776;769;2485;161;528;425;1418;586;1946
431162;201310;431;1208;238;807;34;141;45;130;79;271
431164;201310;97;262;34;128;13;45;1;4;14;49
431170;201310;905;2757;745;2427;240;830;223;717;463;1547
431171;201310;859;2675;778;2514;248;861;195;576;443;1437
431173;201310;478;1474;449;1422;102;337;274;874;376;1211
431175;201310;1309;3713;1148;3466;384;1219;488;1469;872;2688
431177;201310;966;3275;881;3090;290;1091;389;1374;679;2465
431179;201310;122;337;86;263;20;69;33;86;53;155
431180;201310;2733;8423;2219;7207;601;2167;659;1985;1260;4152
431190;201310;756;2137;487;1617;142;525;174;572;316;1097
431198;201310;352;1177;315;1099;143;563;60;186;203;749
431200;201310;264;786;117;395;24;88;18;57;42;145
431205;201310;295;990;232;812;64;235;79;262;143;497
431210;201310;749;2201;652;1996;168;539;340;1027;508;1566
431213;201310;316;1003;266;910;79;298;102;332;181;630
431215;201310;331;999;170;589;37;133;24;72;61;205
431217;201310;241;756;190;638;66;239;50;171;116;410
431220;201310;1202;3137;911;2607;130;430;516;1411;646;1841
431225;201310;1336;4107;1189;3850;280;963;667;2194;947;3157
431230;201310;939;2881;751;2483;125;468;421;1389;546;1857
431235;201310;63;164;38;118;13;45;11;31;24;76
431237;201310;419;1418;375;1349;146;603;139;463;285;1066
431238;201310;51;170;43;153;10;41;15;49;25;90
431240;201310;2776;8996;2440;8362;910;3294;745;2566;1655;5860
431242;201310;423;1401;402;1360;169;641;27;79;196;720
431244;201310;433;1098;339;954;73;249;155;400;228;649
431245;201310;969;2764;833;2532;169;537;525;1612;694;2149
431247;201310;201;650;172;594;64;240;65;213;129;453
431250;201310;1892;6124;1700;5833;576;2132;685;2421;1261;4553
431260;201310;341;1043;270;898;69;263;63;193;132;456
431261;201310;231;832;199;758;53;231;60;220;113;451
431262;201310;344;992;163;577;25;118;68;232;93;350
431265;201310;1219;3438;822;2550;211;738;258;679;469;1417
431267;201310;193;603;161;545;45;164;69;214;114;378
431270;201310;2313;6755;2067;6385;691;2264;985;3071;1676;5335
431275;201310;212;703;150;534;46;151;31;96;77;247
431280;201310;148;476;103;367;27;110;27;76;54;186
431290;201310;319;1058;251;881;75;293;54;181;129;474
431295;201310;205;675;124;426;25;100;26;72;51;172
431300;201310;128;476;99;385;36;144;8;34;44;178
431301;201310;236;817;180;655;50;186;36;119;86;305
431303;201310;676;1871;553;1668;148;517;238;691;386;1208
431306;201310;2088;5946;1618;5065;341;1284;607;1688;948;2972
431308;201310;54;190;52;185;39;141;10;33;49;174
431310;201310;738;2450;568;2037;105;404;234;859;339;1263
431320;201310;824;2455;534;1866;168;662;120;373;288;1035
431330;201310;1952;5188;1070;3490;329;1180;223;715;552;1895
431333;201310;285;783;196;606;48;157;58;163;106;320
431335;201310;99;293;85;264;19;59;29;81;48;140
431337;201310;2543;7998;2123;7071;640;2240;620;2062;1260;4302
431339;201310;607;1816;480;1519;113;371;232;750;345;1121
431340;201310;27017;74273;20445;63034;5320;18266;8360;25138;13680;43404
431342;201310;578;1609;533;1525;118;354;339;954;457;1308
431344;201310;366;1061;289;923;25;84;174;562;199;646
431346;201310;282;790;180;544;56;175;48;140;104;315
431349;201310;541;1618;440;1381;90;280;188;596;278;876
431350;201310;3770;11601;3447;11048;566;2085;2266;7067;2832;9152
431360;201310;726;2088;589;1857;181;601;217;676;398;1277
431365;201310;1301;4142;1148;3879;446;1648;424;1407;870;3055
431370;201310;5461;16230;4729;15019;1277;4330;2229;7270;3506;11600
431380;201310;1123;3437;1063;3295;162;550;767;2349;929;2899
431390;201310;3372;10149;2544;8477;862;3150;723;2274;1585;5424
431395;201310;1586;4866;1428;4609;368;1269;613;2033;981;3302
431400;201310;181;607;120;464;37;156;12;32;49;188
431402;201310;1177;3046;788;2338;154;508;389;1110;543;1618
431403;201310;318;957;241;813;85;316;50;165;135;481
431405;201310;4509;13054;3626;11707;857;3236;1763;5466;2620;8702
431406;201310;786;2554;614;2108;216;773;224;759;440;1532
431407;201310;640;2023;492;1661;167;574;119;384;286;958
431410;201310;16442;52318;13613;46704;5605;20482;3294;11796;8899;32278
431413;201310;203;518;102;329;10;37;45;143;55;180
431415;201310;885;2594;767;2381;194;654;394;1192;588;1846
431417;201310;669;1766;539;1559;94;295;298;891;392;1186
431420;201310;1594;4509;1430;4237;350;1110;784;2361;1134;3471
431430;201310;579;1623;450;1419;122;423;178;530;300;953
431440;201310;31917;96055;29173;91425;9918;32506;13123;42621;23041;75127
431442;201310;203;670;158;550;52;203;20;51;72;254
431445;201310;494;1389;358;1086;66;223;160;469;226;692
431446;201310;492;1470;372;1221;99;329;164;532;263;861
431447;201310;835;2430;608;1921;111;374;293;939;404;1313
431449;201310;869;2554;740;2332;127;443;394;1252;521;1695
431450;201310;2212;5992;2054;5747;539;1564;1235;3451;1774;5015
431455;201310;619;1640;432;1264;117;372;161;438;278;810
431460;201310;3656;10542;3217;9695;902;2850;1327;4078;2229;6928
431470;201310;2193;6525;1867;5793;559;1710;802;2640;1361;4350
431475;201310;124;382;58;233;15;64;5;23;20;87
431477;201310;595;1758;491;1539;118;391;249;761;367;1152
431478;201310;196;524;99;302;25;81;37;113;62;194
431480;201310;2526;7703;2031;6730;702;2525;520;1668;1222;4193
431490;201310;104983;306673;93415;289254;18032;63689;60246;182687;78278;246376
431500;201310;1191;3157;955;2716;295;859;328;924;623;1783
431505;201310;354;1042;340;1024;36;105;275;837;311;942
431507;201310;453;1132;369;976;85;222;220;591;305;813
431510;201310;2197;6192;1890;5684;340;1118;1132;3335;1472;4453
431513;201310;221;688;182;592;46;160;75;248;121;408
431514;201310;105;267;56;171;11;40;21;62;32;102
431515;201310;747;2316;599;1963;140;506;299;916;439;1422
431517;201310;87;290;81;275;39;140;20;60;59;200
431520;201310;463;1457;321;1094;85;305;74;255;159;560
431530;201310;4516;11387;3681;10445;929;2603;2196;6706;3125;9309
431531;201310;283;828;202;658;48;170;80;272;128;442
431532;201310;512;1529;485;1473;98;325;283;848;381;1173
431535;201310;379;1131;261;823;60;219;68;190;128;409
431540;201310;2164;7181;1965;6896;249;816;1372;5138;1621;5954
431545;201310;133;401;56;208;4;14;12;48;16;62
431550;201310;2433;7517;2284;7232;558;2009;1101;3422;1659;5431
431555;201310;763;2076;675;1940;145;415;360;1036;505;1451
431560;201310;23374;74917;20876;69840;8987;30660;6500;22854;15487;53514
431570;201310;5512;16216;5173;15693;1329;4055;3220;9939;4549;13994
431575;201310;371;1082;316;992;54;195;176;528;230;723
431580;201310;692;2251;599;2038;155;589;231;734;386;1323
431590;201310;912;2736;713;2288;79;273;393;1266;472;1539
431595;201310;609;1797;532;1625;131;426;200;632;331;1058
431600;201310;2200;6811;1744;5796;486;1823;379;1063;865;2886
431610;201310;1618;4713;1234;3995;314;1102;609;1957;923;3059
431620;201310;323;1042;243;794;90;313;92;283;182;596
431630;201310;1364;3840;1102;3270;269;835;576;1715;845;2550
431640;201310;5857;18074;5387;17280;1583;5580;2756;8634;4339;14214
431642;201310;501;1545;451;1426;72;270;252;765;324;1035
431643;201310;187;550;170;518;46;158;90;245;136;403
431645;201310;1779;5545;1644;5313;413;1361;949;3166;1362;4527
431647;201310;171;491;137;419;45;136;37;98;82;234
431650;201310;223;722;158;576;40;165;34;104;74;269
431660;201310;1444;4446;1157;3831;407;1407;410;1293;817;2700
431670;201310;1354;3887;1126;3481;333;1161;460;1346;793;2507
431673;201310;214;662;150;514;42;152;38;131;80;283
431675;201310;293;987;225;773;56;201;60;176;116;377
431680;201310;9768;28720;7865;25287;2575;8889;2790;9046;5365;17935
431690;201310;25165;74248;20984;67744;6855;23699;8226;26878;15081;50577
431695;201310;144;508;114;415;25;94;28;75;53;169
431697;201310;511;1477;467;1394;136;422;208;634;344;1056
431700;201310;1636;4719;1428;4320;301;990;755;2222;1056;3212
431710;201310;12861;38694;10921;35287;3221;10970;4768;16002;7989;26972
431720;201310;6997;20398;5974;18514;1426;4998;3149;9533;4575;14531
431725;201310;40;148;39;145;21;80;6;22;27;102
431730;201310;3690;11723;3095;10579;942;3588;1170;3993;2112;7581
431740;201310;5977;18022;5368;16802;1871;6325;1795;5462;3666;11787
431750;201310;10367;30260;8967;27929;1865;6258;4860;15409;6725;21667
431755;201310;261;687;85;294;23;89;17;51;40;140
431760;201310;3892;12185;3290;10982;984;3568;939;3040;1923;6608
431770;201310;2303;6495;2002;6001;523;1709;1035;3031;1558;4740
431775;201310;248;722;196;619;77;258;56;159;133;417
431780;201310;2528;7052;2047;6122;619;2016;586;1662;1205;3678
431790;201310;1149;3726;1037;3517;284;1045;537;1804;821;2849
431795;201310;472;1445;385;1226;77;257;192;609;269;866
431800;201310;9464;28730;8127;26266;2721;9626;2743;8686;5464;18312
431805;201310;269;665;74;268;17;67;19;70;36;137
431810;201310;3753;10764;3232;9665;826;2686;1559;4596;2385;7282
431820;201310;2723;8799;2465;8285;764;2813;906;2940;1670;5753
431830;201310;10473;28786;9019;26445;3353;10685;3219;9423;6572;20108
431840;201310;3571;10925;3146;10074;996;3302;1349;4405;2345;7707
431842;201310;718;1918;432;1345;98;331;144;435;242;766
431843;201310;326;998;300;951;78;267;160;493;238;760
431844;201310;169;512;130;435;35;134;43;142;78;276
431845;201310;539;1691;507;1626;53;176;363;1184;416;1360
431846;201310;509;1591;453;1474;83;309;264;852;347;1161
431848;201310;191;520;93;319;19;79;21;65;40;144
431849;201310;340;871;127;396;24;84;35;97;59;181
431850;201310;4988;14869;4472;13889;1112;3802;2287;6927;3399;10729
431860;201310;977;2844;824;2594;211;737;403;1211;614;1948
431861;201310;84;276;57;199;14;52;10;30;24;82
431862;201310;492;1718;423;1566;160;651;106;366;266;1017
431870;201310;26286;75624;22263;68358;6347;21385;9571;28598;15918;49983
431880;201310;4721;15311;3985;13579;1248;4673;1551;5107;2799;9780
431890;201310;5784;17192;5179;16036;2064;6725;1586;5036;3650;11761
431900;201310;937;3045;804;2787;250;972;313;981;563;1953
431910;201310;883;2187;471;1393;112;372;178;485;290;857
431912;201310;601;1776;480;1522;149;467;171;559;320;1026
431915;201310;1342;3797;1038;3216;308;994;351;1099;659;2093
431920;201310;1516;4413;1416;4273;197;572;1096;3384;1293;3956
431930;201310;1271;3624;1023;3207;148;451;617;2055;765;2506
431935;201310;96;377;90;360;43;179;17;54;60;233
431936;201310;488;1413;445;1335;72;211;293;953;365;1164
431937;201310;310;878;201;643;51;176;59;177;110;353
431940;201310;2689;7615;1926;6146;568;1929;543;1698;1111;3627
431950;201310;1891;6177;1691;5785;511;1914;649;2115;1160;4029
431960;201310;3712;11294;3416;10696;1100;3651;1200;3802;2300;7453
431970;201310;507;1417;286;948;52;190;84;261;136;451
431971;201310;133;408;115;382;18;65;64;205;82;270
431973;201310;478;1718;422;1599;70;264;245;1000;315;1264
431975;201310;15;62;11;51;2;12;3;13;5;25
431980;201310;1529;4528;1410;4293;376;1338;621;1773;997;3111
431990;201310;8758;25095;7296;22815;1504;5407;3530;10742;5034;16149
432000;201310;10785;32449;8951;29124;2999;10127;3786;12445;6785;22572
432010;201310;2495;7574;2189;6976;521;1902;1053;3207;1574;5109
432020;201310;2058;5717;1837;5407;343;1078;1146;3352;1489;4430
432023;201310;525;1553;410;1290;111;399;159;462;270;861
432026;201310;1209;3827;1061;3503;252;846;558;1894;810;2740
432030;201310;413;1271;353;1138;96;337;145;442;241;779
432032;201310;472;1292;352;1090;67;223;209;638;276;861
432035;201310;836;2774;771;2631;208;772;428;1421;636;2193
432040;201310;702;2159;520;1742;124;457;127;332;251;789
432045;201310;193;660;169;609;50;195;69;246;119;441
432050;201310;778;2305;700;2156;143;463;403;1270;546;1733
432055;201310;781;2504;703;2342;156;578;428;1393;584;1971
432057;201310;491;1321;401;1151;50;168;249;667;299;835
432060;201310;443;1289;203;725;63;243;48;159;111;402
432065;201310;232;692;189;613;48;174;83;241;131;415
432067;201310;973;3231;727;2640;219;816;296;1061;515;1877
432070;201310;2392;6794;1962;5935;649;2180;685;2035;1334;4215
432080;201310;4138;12373;3741;11671;1198;3950;1595;4932;2793;8882
432085;201310;252;834;219;770;79;316;60;195;139;511
432090;201310;1674;5350;1451;4853;586;2110;399;1149;985;3259
432100;201310;1148;3489;684;2387;187;683;130;395;317;1078
432110;201310;3074;9396;2503;8245;882;3169;498;1587;1380;4756
432120;201310;5203;16200;4493;14805;1608;5713;1341;4349;2949;10062
432130;201310;2059;6507;1931;6284;548;1926;1092;3570;1640;5496
432132;201310;409;1286;264;932;42;150;100;322;142;472
432135;201310;786;2400;746;2329;143;473;483;1512;626;1985
432140;201310;2895;8700;2393;7770;708;2400;909;3266;1617;5666
432143;201310;1342;4213;1181;3957;277;953;733;2530;1010;3483
432145;201310;959;3128;685;2474;244;956;138;444;382;1400
432146;201310;262;854;201;692;68;245;54;182;122;427
432147;201310;833;2673;679;2330;200;713;275;965;475;1678
432149;201310;405;1236;285;941;86;296;95;309;181;605
432150;201310;3373;10354;2723;9146;1017;3633;821;2806;1838;6439
432160;201310;4484;14961;4055;14217;1489;5505;1538;5673;3027;11178
432162;201310;326;821;97;325;24;90;25;71;49;161
432163;201310;336;874;101;318;19;61;20;63;39;124
432166;201310;798;2429;656;2128;142;528;310;924;452;1452
432170;201310;787;2683;581;2207;143;604;126;425;269;1029
432180;201310;2778;7536;2046;6327;631;2160;608;1791;1239;3951
432183;201310;395;1340;370;1287;152;547;103;365;255;912
432185;201310;825;2443;562;1863;131;480;210;674;341;1154
432190;201310;3489;9916;2644;8022;724;2359;819;2328;1543;4687
432195;201310;1273;3692;1155;3515;196;637;750;2282;946;2919
432200;201310;3112;9900;2578;8953;856;3167;1039;3710;1895;6877
432210;201310;424;1276;377;1210;107;401;181;535;288;936
432215;201310;874;2802;796;2679;156;502;504;1782;660;2284
432218;201310;313;889;238;733;46;150;104;299;150;449
432220;201310;3783;10482;3225;9563;544;1861;1976;5698;2520;7559
432225;201310;59;204;52;194;31;118;7;29;38;147
432230;201310;1057;3020;889;2715;285;973;388;1075;673;2048
432232;201310;569;1702;453;1478;108;392;238;770;346;1162
432234;201310;549;1552;417;1216;106;322;169;463;275;785
432235;201310;77;244;44;164;20;86;10;38;30;124
432237;201310;502;1418;458;1346;37;140;381;1101;418;1241
432240;201310;15166;51994;13463;49693;3402;13596;7962;29944;11364;43540
432250;201310;5492;19677;5209;19080;2424;9530;1302;4858;3726;14388
432252;201310;434;1337;395;1265;132;444;184;597;316;1041
432253;201310;1250;4284;1016;3663;345;1294;326;1184;671;2478
432254;201310;455;1210;186;615;50;174;26;83;76;257
432255;201310;189;488;108;362;31;112;37;131;68;243
432260;201310;6618;17823;5068;15275;1239;3991;2469;7468;3708;11459
432270;201310;2644;8463;2373;7997;716;2489;1175;4049;1891;6538
432280;201310;1089;3297;748;2555;189;739;201;574;390;1313
432285;201310;118;379;68;234;22;82;13;37;35;119
432290;201310;600;1859;425;1445;98;368;164;534;262;902
432300;201310;22849;71777;21184;68895;5931;20489;11009;35752;16940;56241
432310;201310;987;3176;866;2937;206;776;441;1429;647;2205
432320;201310;262;769;193;629;58;189;68;230;126;419
432330;201310;216;668;96;347;16;59;9;28;25;87
432335;201310;209;617;95;333;27;102;9;26;36;128
432340;201310;287;769;159;491;47;151;43;123;90;274
432345;201310;732;2149;684;2082;177;648;369;1041;546;1689
432350;201310;434;1279;321;1059;84;300;86;268;170;568
432360;201310;43;137;34;118;13;47;12;38;25;85
432370;201310;481;1385;404;1245;38;114;271;849;309;963
432375;201310;835;2200;698;1973;127;364;427;1230;554;1594
432377;201310;74;258;36;123;7;24;9;21;16;45
432380;201310;845;3057;775;2889;355;1454;241;829;596;2283
500020;201310;1993;6658;1595;5802;523;2105;425;1432;948;3537
500025;201310;927;2461;624;1913;127;415;259;763;386;1178
500060;201310;5878;17519;4999;16301;558;1813;3880;13067;4438;14880
500070;201310;3708;11544;3241;10752;812;3062;1526;4893;2338;7955
500080;201310;1712;5270;1336;4586;467;1733;396;1415;863;3148
500085;201310;2121;5789;1603;4959;227;779;964;2881;1191;3660
500090;201310;2247;6821;1796;5993;416;1443;927;3181;1343;4624
500100;201310;2392;7419;2248;7199;791;2875;962;2903;1753;5778
500110;201310;7933;23680;6586;21633;1099;4051;3879;13224;4978;17275
500124;201310;1731;5877;1525;5524;300;1072;853;3358;1153;4430
500150;201310;1268;3526;1072;3239;308;1023;508;1486;816;2509
500190;201310;4679;12851;3725;11656;856;2885;2067;6678;2923;9563
500200;201310;2533;6654;1865;5684;405;1421;1000;2940;1405;4361
500210;201310;4760;14776;4185;13899;1022;3650;2117;7266;3139;10916
500215;201310;1732;5513;1460;4960;361;1396;614;1963;975;3359
500220;201310;2647;8588;2164;7639;552;2121;833;2985;1385;5106
500230;201310;2085;6053;1718;5506;725;2545;574;1804;1299;4349
500240;201310;4542;14539;3455;12339;764;3035;1489;5491;2253;8526
500260;201310;2445;6874;2052;6251;465;1574;1000;2857;1465;4431
500270;201310;100519;271462;70236;219119;21968;74631;18114;56921;40082;131552
500280;201310;1277;3851;1118;3625;223;762;669;2235;892;2997
500290;201310;3627;9767;2544;7849;732;2617;880;2503;1612;5120
500295;201310;2290;7312;1752;5990;451;1759;476;1424;927;3183
500310;201310;782;2140;708;2040;175;550;393;1083;568;1633
500315;201310;2810;9055;2458;8568;568;1928;1432;5344;2000;7272
500320;201310;12853;44368;11474;41855;4039;15517;4172;16196;8211;31713
500325;201310;3962;10891;3089;9480;932;3180;1270;3698;2202;6878
500330;201310;5230;15053;4444;13645;1468;4925;1848;5529;3316;10454
500345;201310;2379;7368;2073;6796;535;1935;1023;3270;1558;5205
500348;201310;2339;7155;2191;6902;282;984;1638;5158;1920;6142
500350;201310;1218;3796;776;2758;139;513;233;870;372;1383
500370;201310;22165;71353;18080;63300;4843;18852;7072;24665;11915;43517
500375;201310;2583;7311;1989;6229;475;1575;957;3104;1432;4679
500380;201310;2888;8631;2487;7804;766;2580;862;2675;1628;5255
500390;201310;548;1223;365;957;56;189;249;594;305;783
500400;201310;1214;4009;1050;3614;347;1315;299;935;646;2250
500410;201310;2118;6066;1752;5532;482;1647;776;2473;1258;4120
500430;201310;2449;7730;2073;7135;586;2123;934;3338;1520;5461
500440;201310;1312;3911;1121;3600;305;1112;587;1808;892;2920
500450;201310;2119;6737;1678;5792;453;1756;344;1069;797;2825
500460;201310;3575;11096;2930;10091;797;3017;1221;4175;2018;7192
500470;201310;3098;9675;2460;8184;805;2904;472;1426;1277;4330
500480;201310;1978;6479;1840;6263;198;712;1448;5023;1646;5735
500490;201310;1050;3103;896;2846;291;1033;295;942;586;1975
500500;201310;3161;10097;2647;9385;1019;4051;886;3067;1905;7118
500510;201310;841;2324;595;1916;151;577;237;685;388;1262
500515;201310;1731;4947;1436;4528;273;834;916;3068;1189;3902
500520;201310;2709;9754;2421;9349;619;2529;1402;5644;2021;8173
500525;201310;1109;3738;978;3487;238;909;497;1857;735;2766
500540;201310;4748;14393;3263;11428;1012;3998;791;2645;1803;6643
500560;201310;4342;15236;3983;14713;912;3540;2508;9425;3420;12965
500568;201310;3667;10011;2831;8777;687;2281;1274;4011;1961;6292
500570;201310;7325;20762;5402;17383;1652;5714;2078;6715;3730;12429
500580;201310;3298;10007;2658;8816;549;1955;1500;4987;2049;6942
500600;201310;2800;8155;2192;7164;679;2409;798;2585;1477;4994
500620;201310;7706;22104;5766;18932;1451;5401;2781;8990;4232;14391
500625;201310;858;2613;597;2067;164;618;194;626;358;1244
500627;201310;32;78;16;47;1;2;5;16;6;18
500630;201310;6018;17287;4895;15660;1765;6265;1393;4412;3158;10677
500635;201310;2274;9156;2032;8795;323;1334;1319;6197;1642;7531
500640;201310;1336;3564;1089;3204;175;580;687;1962;862;2542
500660;201310;14593;45767;12366;41847;2873;10777;6232;21048;9105;31825
500690;201310;2935;8734;2455;8137;652;2236;1327;4654;1979;6890
500710;201310;3292;10638;3088;10320;875;3093;1586;5337;2461;8430
500720;201310;4400;13541;3473;11651;1142;4212;1106;3656;2248;7868
500730;201310;932;2755;755;2406;188;673;310;955;498;1628
500740;201310;3552;10198;2674;8651;631;2359;1189;3624;1820;5983
500750;201310;803;2483;744;2396;196;681;411;1336;607;2017
500755;201310;1233;3753;967;3252;241;878;376;1215;617;2093
500769;201310;4435;12258;3088;9608;734;2575;1021;2901;1755;5476
500770;201310;1591;4926;1311;4369;391;1409;445;1498;836;2907
500780;201310;1023;3325;929;3129;301;1097;406;1321;707;2418
500790;201310;8377;24472;7084;22165;1491;5463;3795;11318;5286;16781
500793;201310;2387;7069;1910;6250;366;1339;843;2594;1209;3933
500795;201310;2225;6785;2009;6467;262;718;1487;5109;1749;5827
500797;201310;902;2543;709;2227;159;557;329;1043;488;1600
500800;201310;2224;6792;1901;6325;632;2346;823;2724;1455;5070
500830;201310;14967;45673;11331;37915;3501;12711;3147;10250;6648;22961
500840;201310;1237;3822;1016;3378;202;745;506;1664;708;2409
510010;201310;1240;4009;1161;3875;392;1384;510;1744;902;3128
510020;201310;2653;7878;1946;6588;578;2083;506;1653;1084;3736
510025;201310;8817;27366;7837;25721;2520;9155;3163;10097;5683;19252
510030;201310;2059;5675;1753;5224;552;1702;820;2484;1372;4186
510035;201310;897;2738;765;2537;176;594;423;1472;599;2066
510040;201310;1627;4590;1298;4099;293;1058;661;2048;954;3106
510050;201310;1772;5299;1342;4506;381;1420;510;1709;891;3129
510060;201310;1186;3612;940;3141;278;1029;304;973;582;2002
510080;201310;1295;4109;1086;3745;330;1323;368;1149;698;2472
510100;201310;602;1638;406;1249;100;346;152;451;252;797
510120;201310;288;602;194;499;14;31;169;441;183;472
510125;201310;2884;7827;2367;6984;484;1750;1146;3193;1630;4943
510130;201310;1997;5719;1743;5326;551;1774;728;2239;1279;4013
510140;201310;2930;9858;2467;9121;912;3516;893;3398;1805;6914
510160;201310;1274;4361;1217;4294;90;357;1068;3770;1158;4127
510170;201310;5728;18234;4942;16768;1302;4947;2238;7355;3540;12302
510180;201310;10176;28862;7777;24858;2523;8583;2776;9612;5299;18195
510185;201310;1141;3730;1069;3627;255;834;673;2429;928;3263
510190;201310;1555;5393;1292;4951;337;1448;562;2238;899;3686
510250;201310;13335;43334;11656;41021;3699;13805;5607;20207;9306;34012
510260;201310;2523;9586;2339;9218;732;3053;1064;4357;1796;7410
510263;201310;4132;11685;3168;10055;928;3214;1059;3262;1987;6476
510267;201310;4729;14210;3680;11933;918;3318;1433;4421;2351;7739
510268;201310;849;2516;734;2349;215;765;366;1155;581;1920
510269;201310;805;2673;728;2542;231;846;305;1095;536;1941
510270;201310;2484;7836;2224;7434;450;1533;1288;4550;1738;6083
510279;201310;2037;6719;1874;6445;709;2703;611;1928;1320;4631
510285;201310;1446;4576;1240;4188;368;1349;429;1387;797;2736
510300;201310;2999;9510;2725;9128;410;1535;1995;6651;2405;8186
510305;201310;1607;5245;1331;4703;394;1536;431;1541;825;3077
510310;201310;1087;3191;867;2835;312;1140;264;837;576;1977
510320;201310;3895;11873;3128;10289;978;3721;599;1684;1577;5405
510325;201310;5399;17585;4745;16635;636;2197;3591;13063;4227;15260
510330;201310;2614;8882;2298;8305;644;2594;892;3271;1536;5865
510335;201310;4374;14243;3918;13624;687;2382;2790;10103;3477;12485
510336;201310;490;1578;444;1489;102;367;225;755;327;1122
510337;201310;2212;7564;1986;7134;784;2868;725;2821;1509;5689
510340;201310;58472;177946;47730;161497;19412;71517;10942;39087;30354;110604
510343;201310;1083;3348;1012;3258;120;372;811;2686;931;3058
510345;201310;1631;4864;1411;4501;388;1338;557;1753;945;3091
510350;201310;3190;9639;2706;8973;807;2865;1314;4438;2121;7303
510360;201310;1735;4815;1347;4327;285;984;859;2725;1144;3709
510370;201310;876;3261;788;3110;224;913;394;1611;618;2524
510380;201310;472;1564;383;1376;140;558;65;213;205;771
510385;201310;868;3339;747;3025;132;578;357;1546;489;2124
510390;201310;1090;3486;998;3373;256;847;563;2040;819;2887
510395;201310;819;2209;644;1984;124;404;393;1268;517;1672
510410;201310;3774;12636;3584;12315;1095;4082;1798;6114;2893;10196
510420;201310;2225;5978;1720;5137;304;1073;910;2687;1214;3760
510450;201310;571;1626;444;1446;145;536;142;450;287;986
510452;201310;598;1930;444;1575;113;443;159;526;272;969
510454;201310;719;2345;638;2226;166;603;344;1258;510;1861
510455;201310;947;2989;758;2655;186;765;314;1056;500;1821
510460;201310;1734;5337;1618;5181;358;1323;1039;3201;1397;4524
510480;201310;3944;11069;3090;9437;797;2634;1075;3205;1872;5839
510490;201310;1450;4882;1309;4672;378;1436;721;2563;1099;3999
510500;201310;1227;3942;1016;3585;299;1198;476;1604;775;2802
510510;201310;2931;10502;2622;9981;1016;4064;993;3805;2009;7869
510515;201310;5374;16851;4448;14953;1240;4679;1297;4061;2537;8740
510517;201310;1679;5219;1503;4958;457;1460;884;3059;1341;4519
510520;201310;2145;5703;1688;5048;141;492;1284;3820;1425;4312
510523;201310;1006;3127;855;2875;289;1032;370;1215;659;2247
510525;201310;7675;19743;4913;15311;1258;4280;1760;5387;3018;9667
510530;201310;561;1634;489;1531;87;316;285;894;372;1210
510550;201310;2585;8775;2284;8250;658;2460;1068;4004;1726;6464
510558;201310;2023;6005;1603;5378;507;1855;592;1971;1099;3826
510560;201310;1476;5048;1154;4467;431;1735;266;1085;697;2820
510562;201310;4970;15446;4412;14333;1575;5612;1440;4717;3015;10329
510590;201310;2675;7860;2149;7182;630;2324;938;3168;1568;5492
510600;201310;1427;3743;1016;3109;177;596;530;1561;707;2157
510610;201310;2519;7866;2379;7701;283;1064;1934;6191;2217;7255
510615;201310;2108;7025;1872;6613;638;2435;791;2762;1429;5197
510617;201310;497;1616;454;1553;83;315;330;1129;413;1444
510618;201310;1281;3885;960;3248;250;962;421;1402;671;2364
510619;201310;758;2162;503;1689;111;411;149;510;260;921
510620;201310;1168;3237;804;2695;294;1109;171;527;465;1636
510621;201310;1056;3742;918;3418;289;1169;311;1107;600;2276
510622;201310;3410;10738;2331;8212;595;2344;404;1227;999;3571
510623;201310;3474;10254;3041;9596;1125;3754;1080;3384;2205;7138
510624;201310;1028;3430;899;3167;219;860;401;1317;620;2177
510625;201310;2287;6825;1843;6002;549;2012;516;1598;1065;3610
510626;201310;1193;3913;1004;3600;338;1319;458;1647;796;2966
510627;201310;635;2069;533;1867;210;798;166;577;376;1375
510628;201310;1412;3866;1179;3576;171;606;830;2473;1001;3079
510629;201310;1739;5875;1523;5411;571;2208;337;1139;908;3347
510630;201310;2608;8822;2202;8107;744;3070;613;2281;1357;5351
510631;201310;398;1190;361;1124;77;245;233;722;310;967
510637;201310;2503;7846;2282;7435;732;2631;1044;3285;1776;5916
510642;201310;4577;15327;3962;14506;1421;5393;1754;6741;3175;12134
510645;201310;688;1749;551;1577;212;631;166;532;378;1163
510650;201310;5703;19967;5392;19567;1359;5228;3273;12259;4632;17487
510665;201310;1201;3241;867;2746;204;735;439;1391;643;2126
510670;201310;352;878;215;678;52;196;85;244;137;440
510675;201310;5992;20263;5246;18835;1871;7369;1519;5320;3390;12689
510677;201310;2469;6443;1866;5667;281;886;1317;4121;1598;5007
510680;201310;769;2465;664;2298;165;633;281;897;446;1530
510682;201310;2311;7466;1932;6781;537;2007;855;3154;1392;5161
510685;201310;819;2446;750;2359;114;397;529;1682;643;2079
510700;201310;3190;9421;2604;8576;570;2101;1556;5078;2126;7179
510704;201310;7699;22600;6516;20492;1818;6445;3079;9347;4897;15792
510706;201310;1590;5072;1310;4609;409;1523;610;2123;1019;3646
510710;201310;3542;10271;2837;8849;847;3003;958;2685;1805;5688
510715;201310;686;1820;466;1451;120;416;168;479;288;895
510718;201310;1668;5116;1488;4866;347;1206;915;3025;1262;4231
510719;201310;438;1024;268;793;35;145;124;334;159;479
510720;201310;1245;2989;927;2612;88;275;716;2042;804;2317
510724;201310;810;2544;691;2317;150;549;413;1363;563;1912
510726;201310;654;1814;562;1657;168;521;218;617;386;1138
510729;201310;627;1784;521;1615;157;523;215;668;372;1191
510730;201310;2134;6903;1971;6606;475;1842;1118;3555;1593;5397
510735;201310;1059;3743;901;3478;343;1402;352;1357;695;2759
510740;201310;969;2556;800;2320;182;529;474;1407;656;1936
510757;201310;648;2323;603;2221;169;659;296;1080;465;1739
510760;201310;26036;76488;21406;68401;7933;27071;7053;22505;14986;49576
510770;201310;4040;11645;3784;11330;652;1925;2471;8086;3123;10011
510774;201310;371;1079;308;981;69;245;159;494;228;739
510775;201310;850;2411;679;2152;256;909;253;810;509;1719
510776;201310;354;1112;307;1027;79;291;146;460;225;751
510777;201310;1385;4420;1122;4092;252;1073;684;2449;936;3522
510779;201310;619;1870;475;1605;90;328;185;646;275;974
510780;201310;3660;11187;3263;10623;767;2659;1893;6298;2660;8957
510785;201310;1799;5448;1504;4958;509;1772;560;1880;1069;3652
510787;201310;1946;6267;1729;5869;534;1987;662;2172;1196;4159
510788;201310;348;1108;321;1071;138;437;106;387;244;824
510790;201310;14314;42988;10021;34698;3018;11992;1500;4973;4518;16965
510792;201310;5512;18606;4199;15726;1170;5032;790;2751;1960;7783
510794;201310;1327;4211;1057;3778;512;1920;208;679;720;2599
510795;201310;8009;27445;6691;24665;2363;9304;1802;6758;4165;16062
510800;201310;1694;5042;1468;4733;421;1504;699;2163;1120;3667
510805;201310;1739;5036;1439;4596;300;1110;897;2800;1197;3910
510810;201310;646;1639;525;1473;161;491;263;720;424;1211
510820;201310;826;2106;640;1828;166;555;247;641;413;1196
510830;201310;543;1923;493;1842;172;693;217;855;389;1548
510835;201310;675;2169;542;1916;196;763;212;689;408;1452
510840;201310;47297;122842;38862;112297;10179;31121;20529;61241;30708;92362
510850;201310;1647;4938;1342;4465;599;2226;205;543;804;2769
510860;201310;2427;8289;2011;7359;721;2852;375;1338;1096;4190
510880;201310;801;2758;713;2591;263;1002;252;920;515;1922
510885;201310;531;1549;401;1349;91;340;179;603;270;943
510890;201310;895;3080;771;2838;269;1104;198;658;467;1762
510895;201310;1103;3630;990;3417;305;1174;393;1264;698;2438
520005;201310;1180;3938;1101;3806;368;1331;471;1646;839;2977
520010;201310;1785;6347;1585;5888;711;2931;232;729;943;3660
520013;201310;3921;11138;3050;9606;781;2634;1419;4511;2200;7145
520015;201310;578;1603;462;1429;135;438;172;542;307;980
520017;201310;1160;3725;1019;3485;298;1109;428;1430;726;2539
520020;201310;410;1105;315;952;91;292;152;478;243;770
520025;201310;20796;69854;20320;69254;3399;12263;15466;52814;18865;65077
520030;201310;4406;14672;3949;13906;1371;5210;1442;5182;2813;10392
520050;201310;339;1031;315;982;63;222;210;634;273;856
520055;201310;663;2000;567;1835;146;469;287;962;433;1431
520060;201310;1618;5164;1431;4805;350;1307;579;1977;929;3284
520080;201310;1484;5042;1383;4832;362;1308;715;2550;1077;3858
520082;201310;599;2083;572;2024;153;537;339;1233;492;1770
520085;201310;994;3183;868;2878;217;797;335;1101;552;1898
520090;201310;768;2113;698;1986;127;336;444;1312;571;1648
520110;201310;37570;116277;29890;104489;12269;46866;7699;27235;19968;74101
520120;201310;262;688;153;495;37;141;38;127;75;268
520130;201310;3619;10912;3373;10532;755;2549;2006;6268;2761;8817
520140;201310;42169;144296;38331;136481;14253;54619;11546;40990;25799;95609
520145;201310;533;1400;394;1206;95;317;163;476;258;793
520150;201310;672;1789;553;1642;164;533;259;755;423;1288
520160;201310;808;2475;726;2356;261;898;280;931;541;1829
520170;201310;3729;9432;3046;8698;622;1902;2057;5989;2679;7891
520180;201310;1558;5075;1405;4808;444;1641;596;2016;1040;3657
520215;201310;1527;4142;1332;3851;301;980;777;2246;1078;3226
520235;201310;775;2188;629;1968;196;683;269;815;465;1498
520250;201310;1095;3737;1020;3605;357;1338;487;1758;844;3096
520260;201310;723;1958;560;1664;102;351;286;819;388;1170
520280;201310;548;1650;499;1572;242;795;132;460;374;1255
520310;201310;928;2461;760;2257;212;643;442;1375;654;2018
520320;201310;1452;4811;1245;4415;275;1020;651;2373;926;3393
520330;201310;2772;8827;2150;7676;668;2569;480;1634;1148;4203
520340;201310;1860;4850;1513;4440;226;636;1156;3501;1382;4137
520350;201310;2888;8979;2542;8275;943;3294;1046;3305;1989;6599
520355;201310;1093;3871;1064;3798;427;1593;439;1558;866;3151
520357;201310;876;2437;755;2264;74;253;518;1534;592;1787
520360;201310;575;1606;511;1501;142;420;238;704;380;1124
520380;201310;1062;2980;819;2576;172;605;441;1393;613;1998
520390;201310;1167;3166;819;2689;273;1021;305;922;578;1943
520393;201310;564;1519;510;1427;95;278;338;949;433;1227
520396;201310;697;2279;651;2199;95;369;451;1527;546;1896
520400;201310;1709;4974;1456;4622;284;972;920;2948;1204;3920
520410;201310;1407;3962;1155;3587;351;1204;518;1566;869;2770
520420;201310;326;921;253;790;52;194;116;337;168;531
520425;201310;1402;3964;1323;3815;442;1371;632;1784;1074;3155
520430;201310;1868;5106;1432;4379;328;1157;656;1933;984;3090
520440;201310;2846;8113;2267;7171;859;2985;620;1917;1479;4902
520450;201310;9130;27130;7300;23697;2242;8091;1709;5194;3951;13285
520455;201310;657;2000;547;1822;226;809;149;498;375;1307
520460;201310;802;2396;663;2156;194;699;243;768;437;1467
520465;201310;801;2222;703;2090;174;631;318;864;492;1495
520470;201310;1674;5543;1530;5328;383;1343;926;3371;1309;4714
520480;201310;948;2849;832;2659;195;647;490;1590;685;2237
520485;201310;1120;3873;1048;3747;418;1582;449;1601;867;3183
520490;201310;4277;13477;3470;12213;1498;5682;1089;3829;2587;9511
520495;201310;1382;3800;1164;3540;60;150;1056;3299;1116;3449
520500;201310;2018;5456;1806;5159;624;1905;727;2244;1351;4149
520505;201310;889;2575;768;2389;124;374;531;1713;655;2087
520510;201310;10666;30807;7233;24837;2305;8687;1841;6270;4146;14957
520520;201310;1020;3007;871;2804;346;1190;327;1071;673;2261
520530;201310;2354;7407;2044;6897;489;1691;999;3732;1488;5423
520540;201310;2846;8980;2526;8398;846;2954;1026;3399;1872;6353
520545;201310;1287;4054;1111;3685;339;1226;337;1053;676;2279
520547;201310;775;2488;628;2214;218;851;182;597;400;1448
520549;201310;8109;25538;7146;24324;1929;7087;3976;13503;5905;20590
520551;201310;3622;11211;3478;11027;1061;3498;1922;6349;2983;9847
520552;201310;684;2325;669;2303;125;481;452;1538;577;2019
520570;201310;565;1698;426;1465;181;662;85;297;266;959
520580;201310;1896;5675;1563;5161;487;1814;489;1531;976;3345
520590;201310;1440;4209;1267;3931;361;1196;515;1496;876;2692
520620;201310;6798;22573;6241;21703;1486;5557;3620;12744;5106;18301
520630;201310;616;1747;533;1647;161;486;302;966;463;1452
520640;201310;2464;7516;2236;7162;812;2701;947;3187;1759;5888
520650;201310;787;2331;682;2137;293;967;242;751;535;1718
520660;201310;360;1160;314;1064;108;402;94;314;202;716
520670;201310;766;2311;748;2285;77;191;640;2011;717;2202
520680;201310;572;1772;500;1670;182;668;184;603;366;1271
520690;201310;309;821;218;695;33;113;122;397;155;510
520710;201310;374;987;291;837;11;33;203;567;214;600
520725;201310;1713;4650;1364;4142;336;1147;706;2107;1042;3254
520735;201310;594;1864;506;1702;189;677;157;506;346;1183
520740;201310;1629;4890;1387;4533;395;1365;655;2134;1050;3499
520750;201310;680;1859;518;1642;145;517;294;924;439;1441
520753;201310;1128;3395;1101;3352;178;497;839;2652;1017;3149
520760;201310;1128;3204;998;3036;332;1095;534;1599;866;2694
520780;201310;1842;4842;1620;4545;183;513;1282;3661;1465;4174
520790;201310;2412;7152;2184;6827;339;1166;1543;4877;1882;6043
520800;201310;16747;50899;15017;48812;3564;11450;8955;31309;12519;42759
520810;201310;813;2477;795;2442;128;410;607;1893;735;2303
520815;201310;399;1403;317;1238;170;744;34;124;204;868
520830;201310;1673;4362;1313;3986;61;162;1189;3697;1250;3859
520840;201310;1616;5533;1460;5221;509;1932;520;1905;1029;3837
520850;201310;774;2292;616;2072;192;690;280;924;472;1614
520860;201310;6935;20428;5349;18321;1604;5941;2532;8821;4136;14762
520870;201310;118286;338664;85041;277664;28189;99967;25336;82075;53525;182042
520880;201310;6351;18783;4687;16018;1460;5578;660;2027;2120;7605
520890;201310;3446;10605;3136;10118;778;2684;1676;5386;2454;8070
520910;201310;3570;11669;3119;10713;1119;4176;837;2723;1956;6899
520915;201310;881;2544;653;2094;165;560;243;739;408;1299
520920;201310;2873;8159;2160;6969;594;2061;689;2270;1283;4331
520929;201310;437;1305;397;1257;117;384;202;637;319;1021
520940;201310;924;2874;855;2767;123;451;625;1994;748;2445
520945;201310;616;1586;547;1477;214;580;187;487;401;1067
520960;201310;866;2581;719;2361;119;407;443;1459;562;1866
520970;201310;3315;9786;2693;8646;616;2228;1099;3444;1715;5672
520980;201310;1001;2761;935;2672;197;622;658;1857;855;2479
520990;201310;3622;11461;3223;10762;687;2467;1731;6288;2418;8755
520993;201310;1048;2986;861;2622;148;500;494;1464;642;1964
520995;201310;2508;6989;2267;6661;373;1150;1630;4807;2003;5957
521000;201310;7471;22842;6438;21138;1568;5637;3396;11204;4964;16841
521010;201310;3525;11426;3111;10586;865;3186;1312;4485;2177;7671
521015;201310;648;1875;558;1729;142;454;288;905;430;1359
521020;201310;4229;12793;3432;11112;1285;4501;723;2093;2008;6594
521030;201310;788;2155;704;2038;145;440;471;1382;616;1822
521040;201310;5250;15756;4812;15054;1866;5921;2239;7304;4105;13225
521056;201310;972;3029;828;2789;284;1007;351;1209;635;2216
521060;201310;1112;3189;963;2933;240;783;395;1167;635;1950
521080;201310;1122;2893;752;2264;169;606;271;701;440;1307
521090;201310;3049;9246;2625;8635;972;3386;936;3112;1908;6498
521100;201310;1375;3643;1275;3531;246;678;892;2535;1138;3213
521120;201310;4658;13722;4275;13067;1026;3060;2421;7710;3447;10770
521130;201310;1037;3039;891;2792;197;693;462;1471;659;2164
521140;201310;874;2987;790;2789;305;1142;166;560;471;1702
521150;201310;11553;31901;8420;25780;2635;8830;3523;10572;6158;19402
521160;201310;712;1859;500;1427;89;288;296;802;385;1090
521170;201310;1302;3202;1131;2992;326;840;653;1745;979;2585
521180;201310;6178;21460;5662;20376;2158;8270;1599;5734;3757;14004
521190;201310;8228;25170;6311;21795;2290;8320;1968;6877;4258;15197
521200;201310;812;2190;761;2126;111;322;557;1562;668;1884
521205;201310;485;1593;440;1501;76;278;261;904;337;1182
521210;201310;848;2540;618;2072;237;911;213;607;450;1518
521220;201310;3704;10781;3155;10007;1129;3858;1185;3693;2314;7551
521225;201310;373;988;301;892;50;168;195;587;245;755
521230;201310;1282;4139;1212;3978;479;1670;505;1580;984;3250
521250;201310;25067;85886;24047;84157;9928;37008;9382;33202;19310;70210
521260;201310;784;1976;627;1688;114;395;346;860;460;1255
521270;201310;1691;5577;1578;5365;153;454;1247;4432;1400;4886
521280;201310;1667;5357;1457;4991;483;1763;591;2020;1074;3783
521290;201310;500;1501;379;1291;103;422;151;491;254;913
521295;201310;1077;3072;1008;2976;176;561;739;2173;915;2734
521300;201310;1744;5201;1600;4959;552;1777;678;2183;1230;3960
521305;201310;832;2223;700;2044;176;511;411;1239;587;1750
521308;201310;4811;14644;3952;13233;779;2926;2339;7699;3118;10625
521310;201310;6857;21512;5758;19516;2251;8111;1562;5202;3813;13313
521340;201310;240;793;220;756;75;283;84;274;159;557
521350;201310;2090;5578;1727;5098;246;823;1122;3461;1368;4284
521370;201310;997;3243;912;3071;332;1194;312;1013;644;2207
521375;201310;1301;3810;1131;3527;288;976;586;1794;874;2770
521377;201310;933;2889;909;2855;90;268;772;2471;862;2739
521380;201310;3561;10709;2894;9586;681;2500;1188;3815;1869;6315
521385;201310;578;1679;521;1600;167;535;239;737;406;1272
521390;201310;1107;2936;826;2546;280;973;247;747;527;1720
521400;201310;2378;6517;2044;6123;334;1103;1473;4372;1807;5475
521405;201310;1090;3344;1020;3220;211;703;604;1963;815;2666
521410;201310;732;2389;673;2288;328;1101;221;799;549;1900
521440;201310;1444;4073;1419;4047;146;374;1220;3558;1366;3932
521450;201310;4849;14920;4076;13460;1338;4761;1003;3126;2341;7887
521460;201310;6809;21715;6279;20870;1993;7165;2927;9690;4920;16855
521470;201310;693;1975;519;1641;123;446;110;344;233;790
521480;201310;510;1512;382;1290;130;450;91;312;221;762
521483;201310;2980;8074;2542;7347;701;2151;1160;3295;1861;5446
521486;201310;1543;4430;1402;4155;364;1212;843;2381;1207;3593
521487;201310;549;1532;420;1339;101;328;215;696;316;1024
521490;201310;798;2376;657;2188;125;463;419;1412;544;1875
521500;201310;1146;3889;1071;3745;174;678;704;2364;878;3042
521520;201310;875;2105;776;1990;194;411;433;1261;627;1672
521523;201310;11101;41900;10401;40644;3794;16196;3806;14603;7600;30799
521525;201310;1081;2806;961;2648;130;407;651;1744;781;2151
521530;201310;1941;5841;1369;4708;549;1992;230;749;779;2741
521540;201310;874;2598;651;2136;207;784;165;474;372;1258
521550;201310;926;2364;836;2233;245;709;446;1147;691;1856
521560;201310;4874;15110;3904;13799;1671;6448;1023;3463;2694;9911
521565;201310;599;1716;545;1642;90;292;386;1167;476;1459
521570;201310;4312;12210;3269;10227;1155;3895;1051;3314;2206;7209
521580;201310;606;1580;466;1375;174;547;158;465;332;1012
521590;201310;713;2072;618;1912;238;797;124;403;362;1200
521600;201310;615;1652;443;1345;115;388;156;427;271;815
521630;201310;1744;4844;1470;4407;597;2064;263;641;860;2705
521640;201310;1744;5119;1530;4788;525;1901;419;1345;944;3246
521645;201310;629;2004;552;1831;153;568;224;681;377;1249
521680;201310;1320;4426;1220;4184;714;2565;197;627;911;3192
521690;201310;565;1711;510;1607;122;457;244;707;366;1164
521710;201310;2120;6775;1903;6356;406;1448;1137;3780;1543;5228
521720;201310;2004;6089;1841;5863;452;1468;1116;3648;1568;5116
521730;201310;3650;12515;3455;12122;1545;5925;995;3224;2540;9149
521740;201310;3246;9191;2646;8413;1278;4170;895;2963;2173;7133
521760;201310;11916;41583;11312;40652;2116;8416;7588;27409;9704;35825
521770;201310;2685;8276;2291;7478;1028;3594;493;1490;1521;5084
521800;201310;8439;25628;7352;24001;2755;9451;3311;11149;6066;20600
521805;201310;921;2161;776;1917;257;569;378;1090;635;1659
521810;201310;812;2413;712;2237;180;614;358;1107;538;1721
521830;201310;5405;18499;5122;18045;1082;4123;3392;11941;4474;16064
521839;201310;610;1906;516;1697;144;506;206;643;350;1149
521850;201310;6276;18265;5691;17374;1388;4235;3302;10292;4690;14527
521860;201310;1703;5269;1479;4800;421;1510;537;1645;958;3155
521870;201310;544;1917;504;1808;158;617;142;466;300;1083
521878;201310;447;1500;410;1433;138;540;146;492;284;1032
521880;201310;23706;64411;16422;52224;5984;20407;4720;15142;10704;35549
521890;201310;3532;11217;3020;10176;1189;4290;709;2362;1898;6652
521900;201310;1651;4433;1352;4006;364;1200;533;1458;897;2658
521910;201310;1169;3379;1029;3214;265;915;588;1860;853;2775
521920;201310;408;1313;398;1289;166;566;169;538;335;1104
521925;201310;619;1928;547;1773;127;457;253;772;380;1229
521930;201310;3785;12496;3453;11831;1336;4862;1100;3746;2436;8608
521935;201310;669;2033;634;1963;196;643;331;997;527;1640
521940;201310;1148;3133;949;2804;358;1122;327;973;685;2095
521945;201310;663;2312;614;2253;133;435;433;1700;566;2135
521950;201310;486;1610;429;1503;154;578;162;567;316;1145
521960;201310;921;2719;786;2477;200;671;371;1156;571;1827
521970;201310;2420;7033;2232;6784;373;1168;1584;4948;1957;6116
521971;201310;905;2562;743;2290;188;647;309;900;497;1547
521973;201310;821;2813;751;2676;227;854;243;858;470;1712
521975;201310;12773;37796;12049;36840;2415;8063;7778;23833;10193;31896
521980;201310;1687;5511;1649;5466;286;921;1282;4377;1568;5298
521990;201310;1013;3241;949;3127;185;674;587;1896;772;2570
522000;201310;2070;6218;1839;5919;400;1352;1106;3732;1506;5084
522005;201310;303;881;244;784;63;219;126;390;189;609
522010;201310;2744;8463;2423;7943;910;3258;715;2258;1625;5516
522015;201310;969;2921;815;2678;241;881;385;1249;626;2130
522020;201310;4344;12411;3861;11796;994;3300;2219;6670;3213;9970
522026;201310;618;1791;441;1608;209;808;128;475;337;1283
522028;201310;524;1583;475;1500;122;424;279;857;401;1281
522040;201310;2934;7598;2145;6571;781;2595;835;2537;1616;5132
522045;201310;12003;40427;10450;37052;3603;13896;2253;7782;5856;21678
522050;201310;990;2949;820;2660;279;1005;328;1006;607;2011
522060;201310;2808;9127;2498;8646;785;2911;1322;4567;2107;7478
522068;201310;1419;4799;1344;4715;127;389;1126;4122;1253;4511
522070;201310;824;2539;753;2421;124;476;479;1521;603;1997
522100;201310;790;2208;702;2070;262;883;316;858;578;1741
522108;201310;923;2734;813;2573;92;306;600;1940;692;2246
522119;201310;1217;3810;1031;3571;127;419;804;2874;931;3293
522130;201310;506;1477;437;1400;134;474;221;712;355;1186
522140;201310;16663;48216;14752;45494;4568;15219;6951;21253;11519;36472
522145;201310;905;2640;856;2556;452;1423;215;629;667;2052
522150;201310;1247;3306;1022;3002;366;1140;372;1124;738;2264
522155;201310;704;2138;647;2055;153;507;385;1267;538;1774
522157;201310;676;2025;608;1915;72;253;463;1463;535;1716
522160;201310;5886;17278;4475;14894;1928;7060;809;2535;2737;9595
522170;201310;3182;8882;2706;8224;770;2378;1216;3902;1986;6280
522180;201310;428;1275;333;1137;158;596;111;362;269;958
522185;201310;13786;44537;12984;43415;2918;10585;7882;26483;10800;37068
522190;201310;751;2160;668;1989;130;401;383;1155;513;1556
522200;201310;1539;5241;1424;4989;508;1924;428;1439;936;3363
522205;201310;1288;3768;1085;3427;329;1083;478;1519;807;2602
522220;201310;1031;3267;942;3145;231;829;515;1820;746;2649
522230;201310;1045;3284;978;3173;202;737;612;1998;814;2735
530010;201310;247961;819518;223161;768280;70253;266626;73339;251207;143592;517833
110001;201309;4284;14265;3723;13365;1079;4005;2027;7370;3106;11375
110002;201309;12480;41082;11142;38699;3764;14007;4813;16794;8577;30801
110003;201309;978;3200;913;3095;277;993;379;1259;656;2252
110004;201309;9243;30952;8091;28515;2647;10166;2841;9995;5488;20161
110005;201309;2317;7923;2214;7727;844;3021;940;3334;1784;6355
110006;201309;3409;9177;2152;7419;714;2605;624;2039;1338;4644
110007;201309;1452;4712;1344;4551;328;1164;777;2741;1105;3905
110008;201309;2467;8697;2322;8485;568;1983;1546;5917;2114;7900
110009;201309;5197;15300;4155;13775;962;3336;2368;7923;3330;11259
110010;201309;8320;24165;7384;23005;1411;3956;4954;16726;6365;20682
110011;201309;10719;33539;8920;30432;3457;12493;3117;10635;6574;23128
110012;201309;15832;50176;14056;46772;5079;17888;5222;17288;10301;35176
110013;201309;5163;16648;4348;15489;1352;5048;2060;7513;3412;12561
110014;201309;4142;12443;3532;11591;858;2932;2080;6911;2938;9843
110015;201309;4958;16391;4142;14935;1640;6295;1404;5082;3044;11377
110018;201309;5043;15115;4153;13960;1339;4982;1855;6003;3194;10985
110020;201309;52938;160084;45833;151093;10723;36470;27428;93201;38151;129671
110025;201309;4270;12850;3641;11695;603;2107;2598;8301;3201;10408
110026;201309;803;2385;679;2238;162;534;443;1506;605;2040
110028;201309;7309;21957;5579;19126;1752;6534;1684;5714;3436;12248
110029;201309;1663;4950;1341;4392;457;1559;563;1869;1020;3428
110030;201309;11178;32694;9237;30218;2602;9132;4802;16248;7404;25380
110032;201309;4013;13346;3628;12485;1061;3793;1595;5540;2656;9333
110033;201309;5369;17381;5013;16821;1644;5585;2378;8514;4022;14099
110034;201309;3754;9864;3187;9203;489;1370;2476;7273;2965;8643
110037;201309;2019;6963;1792;6540;512;1869;965;3594;1477;5463
110040;201309;3467;11606;3265;11219;1113;4071;1494;5119;2607;9190
110045;201309;5050;17947;4740;17565;1350;5274;2833;10531;4183;15805
110050;201309;1780;5835;1501;5474;551;2036;765;2864;1316;4900
110060;201309;983;3464;875;3263;262;1021;454;1696;716;2717
110070;201309;1891;6578;1851;6484;319;1166;1332;4690;1651;5856
110080;201309;3306;10804;3204;10674;604;1903;2436;8351;3040;10254
110090;201309;927;2824;755;2551;234;882;322;1017;556;1899
110092;201309;1713;5551;1559;5344;377;1315;888;3199;1265;4514
110094;201309;2802;9457;2605;9168;700;2624;1561;5516;2261;8140
110100;201309;2639;8574;2293;7994;699;2516;1193;4220;1892;6736
110110;201309;1742;5793;1635;5666;717;2513;721;2614;1438;5127
110120;201309;1668;5643;1435;5085;409;1524;557;1963;966;3487
110130;201309;2744;8003;2118;7100;567;2001;1042;3523;1609;5524
110140;201309;2432;8514;2332;8361;558;2027;1485;5427;2043;7454
110143;201309;1521;5113;1240;4628;308;1203;708;2624;1016;3827
110145;201309;957;2994;858;2831;167;591;549;1814;716;2405
110146;201309;447;1463;404;1394;111;397;217;757;328;1154
110147;201309;897;2723;710;2412;203;745;258;807;461;1552
110148;201309;1321;4013;1079;3527;361;1298;364;1131;725;2429
110149;201309;3419;10454;2860;9675;696;2462;1836;6307;2532;8769
110150;201309;2791;8411;2309;7684;412;1501;1493;4963;1905;6464
110155;201309;890;3030;852;2944;303;1104;394;1330;697;2434
110160;201309;2059;6669;1746;6154;583;2118;834;2967;1417;5085
110170;201309;3158;9277;2507;8184;558;1940;1545;5091;2103;7031
110175;201309;1592;5241;1250;4812;115;487;941;3646;1056;4133
110180;201309;1687;5364;1456;4974;348;1222;873;3018;1221;4240
120001;201309;2794;10224;2720;10077;738;2881;1525;5791;2263;8672
120005;201309;1482;6153;1438;6068;185;737;1095;4817;1280;5554
120010;201309;4286;15465;4117;15162;987;3438;2591;10070;3578;13508
120013;201309;1784;6969;1752;6915;335;1289;1213;4995;1548;6284
120017;201309;2056;7431;1954;7251;552;2131;957;3838;1509;5969
120020;201309;13851;61370;13649;60885;2617;11025;9756;45573;12373;56598
120025;201309;2568;9134;2496;9022;653;2463;1477;5455;2130;7918
120030;201309;5572;23070;5521;22985;609;2387;4561;19464;5170;21851
120032;201309;1341;6422;1296;6307;178;1002;964;4719;1142;5721
120033;201309;3545;13619;3516;13564;209;859;3137;12188;3346;13047
120034;201309;1796;7282;1794;7280;62;245;1695;6926;1757;7171
120035;201309;2503;12187;2482;12130;271;1275;2008;10175;2279;11450
120038;201309;3151;11613;3039;11374;872;3327;1624;6293;2496;9620
120039;201309;1332;7636;1310;7581;182;1097;1023;6030;1205;7127
120040;201309;42673;158250;39958;152292;12449;49480;19441;76226;31890;125706
120042;201309;2689;11851;2595;11614;396;1884;1860;8480;2256;10364
120043;201309;794;3822;781;3792;73;353;658;3257;731;3610
120045;201309;4353;15463;4310;15393;1037;3656;2973;10926;4010;14582
120050;201309;7977;33372;7762;32906;1662;6830;4992;22502;6654;29332
120060;201309;5626;27645;5557;27514;805;3902;4310;22105;5115;26007
120070;201309;2679;10365;2637;10263;595;2193;1668;6889;2263;9082
120080;201309;3585;13696;3450;13481;613;2437;2467;9927;3080;12364
130002;201309;2805;11846;2651;11571;293;1320;2080;9228;2373;10548
130006;201309;1680;7295;1518;6967;190;970;1105;5105;1295;6075
130008;201309;1914;8007;1850;7884;195;892;1448;6319;1643;7211
130010;201309;2714;9207;2359;8788;255;865;1938;7447;2193;8312
130014;201309;3312;10928;2881;10294;454;1772;1938;6979;2392;8751
130020;201309;2343;8407;2329;8391;62;238;2242;8079;2304;8317
130030;201309;6582;26448;6396;26195;562;1952;5509;23264;6071;25216
130040;201309;3601;11463;3414;11186;252;868;2953;9722;3205;10590
130050;201309;5647;23142;5042;22133;795;3383;3505;16374;4300;19757
130060;201309;5761;24772;5437;24313;614;2647;4433;20324;5047;22971
130063;201309;3089;13561;3067;13516;406;1726;2516;11327;2922;13053
130068;201309;2939;12550;2746;12155;368;1790;1980;8822;2348;10612
130070;201309;6276;21656;5864;21086;639;2248;4686;17277;5325;19525
130080;201309;4835;21775;4714;21591;817;3903;3382;15887;4199;19790
130083;201309;1675;7110;1614;7007;295;1332;1143;5004;1438;6336
130090;201309;2322;8586;2220;8441;197;880;1884;7127;2081;8007
130100;201309;5250;20534;5055;20258;468;2016;4202;17047;4670;19063
130110;201309;6393;20828;6001;20345;937;3072;4577;16084;5514;19156
130115;201309;3448;13249;3288;13028;212;665;2977;12028;3189;12693
130120;201309;12751;50105;12492;49745;1176;4290;10603;43510;11779;47800
130130;201309;3318;14540;3214;14345;481;2096;2463;11296;2944;13392
130140;201309;5704;23116;5663;23063;142;429;5469;22519;5611;22948
130150;201309;3323;12505;3252;12412;257;1237;2779;10530;3036;11767
130160;201309;3837;15817;3777;15727;246;884;3436;14517;3682;15401
130165;201309;2719;11219;2679;11150;502;2101;2045;8620;2547;10721
130170;201309;8078;30896;7148;29651;1397;5846;4756;20720;6153;26566
130180;201309;3308;10593;3240;10498;120;368;3011;9814;3131;10182
130185;201309;8348;30746;8094;30399;1616;5853;5781;22606;7397;28459
130190;201309;16164;57792;14446;55559;3162;11750;9207;37679;12369;49429
130195;201309;1746;7161;1685;7067;96;442;1485;6292;1581;6734
130200;201309;1943;7127;1809;6895;339;1348;1207;4669;1546;6017
130210;201309;1118;4366;1063;4266;178;690;787;3284;965;3974
130220;201309;2003;8228;1837;7920;358;1735;1110;4806;1468;6541
130230;201309;3271;14901;3113;14621;393;2052;2290;11005;2683;13057
130240;201309;7990;31537;7423;30686;536;2491;6274;26328;6810;28819
130250;201309;16831;62907;16430;62304;2823;10266;12185;48125;15008;58391
130255;201309;3840;14218;3643;13871;233;757;3176;12474;3409;13231
130260;201309;236644;776470;216287;744610;61265;214529;115360;412745;176625;627274
130270;201309;7219;30405;6539;29327;1106;4824;4632;21821;5738;26645
130280;201309;3048;11914;2983;11819;156;529;2691;10916;2847;11445
130290;201309;10365;37975;10164;37670;227;691;9573;36022;9800;36713
130300;201309;4240;16778;4012;16445;365;1584;3284;13669;3649;15253
130310;201309;4498;17934;4159;17485;708;2872;2988;13098;3696;15970
130320;201309;2700;9429;2473;9106;368;1405;1753;6620;2121;8025
130330;201309;3328;12359;2977;11868;249;1055;2476;10022;2725;11077
130340;201309;16611;65823;16215;65186;2876;10889;11473;48809;14349;59698
130350;201309;3192;12934;3055;12774;260;865;2653;11473;2913;12338
130353;201309;5111;16985;4615;16298;1272;4478;2589;9699;3861;14177
130356;201309;3997;14782;3848;14550;532;1926;2981;11775;3513;13701
130360;201309;2681;8109;2417;7799;71;191;2227;7376;2298;7567
130370;201309;4744;18723;4060;17810;280;1523;3367;14802;3647;16325
130380;201309;6652;28128;6418;27737;478;2246;5452;23779;5930;26025
130390;201309;4394;19594;4136;19154;494;2261;3287;15662;3781;17923
130395;201309;1922;7424;1783;7156;305;1362;1140;4566;1445;5928
130400;201309;2125;7651;2057;7548;100;392;1856;6882;1956;7274
130406;201309;8878;34518;7973;32999;2039;8256;4530;20013;6569;28269
130410;201309;4058;15616;3758;15046;914;3794;2103;8769;3017;12563
130420;201309;9418;40791;9141;40174;2755;11824;5044;23490;7799;35314
130423;201309;2966;11672;2822;11478;243;1149;2368;9647;2611;10796
130426;201309;1945;8510;1866;8369;334;1468;1303;6121;1637;7589
130430;201309;3339;12288;3157;12007;387;1609;2308;8963;2695;10572
130440;201309;3630;13419;3339;13100;229;800;2933;11857;3162;12657
140002;201309;1254;4589;1212;4517;266;898;792;3192;1058;4090
140005;201309;2298;7472;2162;7317;137;439;1919;6598;2056;7037
140010;201309;42828;141742;39082;135418;9002;33221;22965;81188;31967;114409
140015;201309;2633;8991;2547;8874;229;582;2190;7949;2419;8531
140017;201309;2830;9248;2726;9116;213;681;2351;8021;2564;8702
140020;201309;4098;14056;3833;13691;560;1995;2810;10359;3370;12354
140023;201309;1846;6642;1722;6442;219;828;1304;5033;1523;5861
140028;201309;2055;5866;1989;5789;112;262;1797;5359;1909;5621
140030;201309;3442;11248;3303;11066;378;921;2784;9832;3162;10753
140040;201309;1458;7130;1402;6953;132;736;1037;5252;1169;5988
140045;201309;2301;8566;2196;8420;277;926;1720;7000;1997;7926
140047;201309;4979;14652;4672;14228;1276;3848;2552;8365;3828;12213
140050;201309;1447;4551;1362;4424;162;524;1071;3565;1233;4089
140060;201309;1311;4228;1208;4092;288;987;759;2669;1047;3656
140070;201309;1422;7027;1419;7021;58;235;1347;6742;1405;6977
150010;201309;31250;104449;30033;102811;2274;8145;25621;88870;27895;97015
150013;201309;1487;4810;1441;4756;137;463;1195;3982;1332;4445
150020;201309;10361;37255;10144;36919;1383;5006;7959;29623;9342;34629
150030;201309;5930;26417;5782;26158;607;2382;4801;22624;5408;25006
150034;201309;4337;11939;4124;11685;149;340;3914;11238;4063;11578
150040;201309;11707;41900;10343;40157;2163;7693;6973;29031;9136;36724
150050;201309;5817;22577;5689;22336;670;2856;4529;17921;5199;20777
150060;201309;13996;46646;13339;45675;3547;11921;7906;28348;11453;40269
150070;201309;5052;21910;4674;21443;579;2601;3748;17635;4327;20236
150080;201309;57792;160514;51647;152755;7033;19080;38747;118443;45780;137523
150085;201309;4700;17141;4534;16899;761;2426;3438;13572;4199;15998
150090;201309;9514;37774;9025;37091;1213;4770;7052;29852;8265;34622
150095;201309;4978;17569;4646;17051;554;2027;3661;13804;4215;15831
150100;201309;3328;12641;3144;12367;294;1372;2549;9938;2843;11310
150110;201309;3127;15088;3115;15058;161;673;2882;14125;3043;14798
150120;201309;5706;22957;5602;22743;872;3496;4306;17738;5178;21234
150125;201309;773;2453;712;2350;167;581;426;1401;593;1982
150130;201309;18544;61383;17864;60359;1838;6292;14527;49733;16365;56025
150140;201309;135004;415434;130708;410025;18933;59859;102380;325310;121313;385169
150145;201309;4643;15148;4316;14724;648;2267;3165;11028;3813;13295
150150;201309;8844;30017;8381;29258;1856;6786;5381;18988;7237;25774
150157;201309;2546;8625;2368;8371;364;1339;1816;6481;2180;7820
150160;201309;2645;9264;2551;9121;694;2390;1530;5748;2224;8138
150170;201309;21565;80922;20536;79616;3370;12818;15599;61546;18969;74364
150172;201309;2887;10213;2624;9830;291;1107;2162;8230;2453;9337
150175;201309;1961;6319;1895;6239;150;460;1659;5585;1809;6045
150178;201309;10473;33187;9127;31603;560;1680;8186;29041;8746;30721
150180;201309;17047;70115;16560;69443;1628;7098;13862;58930;15490;66028
150190;201309;6954;22661;6587;22144;437;1097;5754;20132;6191;21229
150195;201309;4213;15632;3964;15177;466;1777;3127;12177;3593;13954
150200;201309;4727;15841;4637;15729;115;358;4387;15015;4502;15373
150210;201309;21638;83622;21362;83221;2125;7870;18290;72466;20415;80336
150215;201309;5238;17460;4841;16857;1236;4428;2836;10072;4072;14500
150220;201309;12000;39945;11195;38623;2661;9377;6539;23159;9200;32536
150230;201309;10729;37759;9847;36519;829;3739;8245;30301;9074;34040
150240;201309;32099;100741;29636;96506;8732;29673;14452;48246;23184;77919
150250;201309;3609;14738;3506;14566;690;2683;2467;10823;3157;13506
150260;201309;1795;7693;1748;7595;312;1480;1156;5063;1468;6543
150270;201309;9193;28573;7246;26132;1644;6333;4514;16564;6158;22897
150275;201309;5485;20767;5235;20361;846;3354;3827;15185;4673;18539
150276;201309;2027;6147;1924;6020;276;902;1527;4791;1803;5693
150277;201309;4954;15658;4381;14983;514;1832;3511;12218;4025;14050
150280;201309;5703;25053;5584;24779;733;3167;4357;19814;5090;22981
150285;201309;2556;10357;2531;10304;247;1026;2158;8857;2405;9883
150290;201309;7910;26203;7766;26003;836;2689;6421;21997;7257;24686
150293;201309;8520;27627;7528;26083;2573;9158;3446;12539;6019;21697
150295;201309;5838;20400;5268;19637;1305;4952;3228;12426;4533;17378
150300;201309;1763;6238;1728;6188;120;426;1463;5375;1583;5801
150304;201309;3864;12544;3405;11926;504;1795;2559;9129;3063;10924
150307;201309;6398;22483;5989;21889;493;1752;4975;18722;5468;20474
150309;201309;6258;23007;5873;22461;1621;6158;3628;14486;5249;20644
150310;201309;4810;22748;4740;22624;539;2406;3909;19221;4448;21627
150320;201309;8048;23033;7813;22766;569;1596;6857;20301;7426;21897
150330;201309;12429;47043;11917;46199;1477;5747;9396;37257;10873;43004
150340;201309;2027;7193;1922;7036;458;1784;1182;4369;1640;6153
150345;201309;6277;22547;5901;22028;701;2647;4769;18184;5470;20831
150350;201309;6927;23735;6618;23269;986;3463;4900;17563;5886;21026
150360;201309;20103;65104;17784;62231;2612;9294;13281;47862;15893;57156
150370;201309;9572;37145;9260;36708;1145;4214;7554;30985;8699;35199
150375;201309;2671;11393;2617;11325;226;779;2252;10203;2478;10982
150380;201309;9120;29137;8287;27997;906;3316;6901;23310;7807;26626
150390;201309;7901;34433;7578;33755;1856;7795;4581;21667;6437;29462
150400;201309;5203;22090;5043;21734;646;2690;3753;16728;4399;19418
150405;201309;7958;25388;7272;24512;1514;4635;4932;17699;6446;22334
150410;201309;1610;6355;1580;6302;284;1165;1058;4343;1342;5508
150420;201309;30873;113835;28336;109704;7489;30320;15755;63229;23244;93549
150430;201309;6193;23741;6060;23485;826;3490;4635;18027;5461;21517
150440;201309;5130;18314;5039;18165;764;2706;3780;13925;4544;16631
150442;201309;20915;60780;19272;58702;3104;9618;13765;43065;16869;52683
150445;201309;5000;18033;4655;17541;694;2463;3591;13949;4285;16412
150450;201309;4072;19859;3949;19695;381;1869;3326;16942;3707;18811
150460;201309;6599;24805;5588;23729;447;1984;4865;21068;5312;23052
150470;201309;15873;50885;15443;50317;1475;4079;13240;44498;14715;48577
150480;201309;13704;47446;13207;46736;921;2984;11501;41604;12422;44588
150490;201309;6172;24292;6075;24163;376;1474;5479;22011;5855;23485
150495;201309;4389;16644;4309;16492;393;1564;3677;14154;4070;15718
150497;201309;3243;11456;2983;11024;844;3108;1712;6629;2556;9737
150500;201309;2824;8701;2716;8519;387;1249;2063;6490;2450;7739
150503;201309;3672;11782;3148;11105;1199;4422;1340;4935;2539;9357
150506;201309;11634;42786;11097;42033;2685;9002;7482;30372;10167;39374
150510;201309;9258;37466;8757;36582;1467;6183;6189;26866;7656;33049
150520;201309;5859;24688;5770;24552;501;1696;5067;22226;5568;23922
150530;201309;10803;40125;9934;38832;1425;5068;7386;30096;8811;35164
150540;201309;4440;14204;4094;13671;355;1248;3413;11389;3768;12637
150543;201309;4630;15201;4313;14750;1338;4590;2470;8707;3808;13297
150548;201309;7787;25277;7369;24736;691;2203;6265;21467;6956;23670
150549;201309;2138;6947;2044;6832;109;270;1854;6364;1963;6634
150550;201309;20346;66461;18482;63330;5502;19519;9166;32148;14668;51667
150553;201309;20498;77283;18733;72685;7747;31902;3550;13661;11297;45563
150555;201309;1609;5236;1428;4967;247;938;987;3454;1234;4392
150560;201309;1938;6394;1883;6263;229;841;1433;4728;1662;5569
150563;201309;2798;9506;2628;9186;621;2347;1579;5498;2200;7845
150565;201309;3249;11950;3077;11689;255;1091;2506;9633;2761;10724
150570;201309;4927;19504;4864;19395;407;1589;4114;16802;4521;18391
150580;201309;8994;37233;8856;37053;817;2968;7614;32999;8431;35967
150590;201309;5062;20986;4960;20862;162;747;4644;19634;4806;20381
150600;201309;7153;28833;7018;28603;634;2344;5987;25107;6621;27451
150610;201309;2412;8446;2252;8114;284;1162;1585;5641;1869;6803
150611;201309;2523;9682;2432;9463;313;1276;1808;7137;2121;8413
150613;201309;10829;34563;9645;32828;3343;11670;4550;16235;7893;27905
150616;201309;2918;8535;2377;7932;561;1818;1561;5410;2122;7228
150618;201309;7244;25897;6976;25406;2307;8762;3418;12705;5725;21467
150619;201309;5044;17835;4758;17410;755;2898;3375;12529;4130;15427
150620;201309;5902;21954;5417;21318;785;3125;4115;16778;4900;19903
150630;201309;5129;16642;4918;16362;436;1459;4142;13972;4578;15431
150635;201309;4309;14547;4067;14093;825;2942;2559;9174;3384;12116
150640;201309;1386;4570;1373;4549;36;102;1302;4362;1338;4464
150650;201309;11542;36900;10652;35280;2934;10132;5639;18954;8573;29086
150655;201309;5072;17507;4693;16955;770;2843;3434;12643;4204;15486
150658;201309;3871;13214;3714;12960;368;1527;2934;10124;3302;11651
150660;201309;5448;17786;5013;17225;1379;4673;2916;10446;4295;15119
150670;201309;5855;17772;5137;16899;1734;5773;2667;9378;4401;15151
150680;201309;47310;190864;45148;186810;16101;66118;20656;91721;36757;157839
150690;201309;1782;5999;1667;5783;278;988;1082;3860;1360;4848
150700;201309;5555;17976;5292;17620;1117;3726;3564;12138;4681;15864
150710;201309;3765;12489;3535;12158;375;1084;2977;10545;3352;11629
150715;201309;4783;16168;4398;15638;599;2151;3461;12558;4060;14709
150720;201309;6171;25904;5897;25411;914;3716;4340;19551;5254;23267
150730;201309;8700;30853;8236;30220;1166;4175;6589;24743;7755;28918
150740;201309;3475;11534;3273;11171;508;1820;2247;7820;2755;9640
150745;201309;5847;18677;5448;18137;932;3253;3962;13307;4894;16560
150746;201309;1345;4606;1288;4498;201;776;886;3141;1087;3917
150747;201309;4840;16323;4526;15910;447;1501;3660;13309;4107;14810
150750;201309;2525;9037;2469;8972;115;266;2314;8614;2429;8880
150760;201309;10870;36319;10465;35743;2613;8813;6511;23070;9124;31883
150770;201309;5454;20951;5299;20724;912;3309;3895;16215;4807;19524
150775;201309;1056;3495;970;3331;194;818;592;1946;786;2764
150780;201309;2940;10011;2919;9988;82;205;2768;9614;2850;9819
150790;201309;4775;15726;4502;15382;324;948;3886;13695;4210;14643
150795;201309;14082;45414;13000;43745;2125;6894;9418;32745;11543;39639
150796;201309;2677;8435;2602;8342;395;1171;2006;6707;2401;7878
150797;201309;3593;12375;3456;12158;185;684;3042;10816;3227;11500
150800;201309;13384;46107;12332;44790;2950;10179;8092;31000;11042;41179
150803;201309;6561;24299;6256;23848;899;3626;4620;18010;5519;21636
150805;201309;2640;9441;2468;9199;379;1342;1800;6937;2179;8279
150808;201309;5687;19830;4933;18402;2157;8469;1223;4780;3380;13249
150810;201309;18628;59914;15927;56630;2723;9320;11253;42142;13976;51462
150812;201309;4738;15346;4452;14998;467;1909;3436;11377;3903;13286
150815;201309;8350;27128;7550;26145;1186;3770;5781;20880;6967;24650
150820;201309;10035;30400;9202;29491;539;1160;8307;27470;8846;28630
150830;201309;12074;47600;11613;46780;902;3565;9507;39635;10409;43200
150835;201309;1912;7231;1788;6934;514;2097;846;3297;1360;5394
150840;201309;6679;20039;5463;18423;1378;5192;2950;9662;4328;14854
160005;201309;685;2666;648;2585;117;536;389;1537;506;2073
160010;201309;1513;5344;1502;5332;185;522;1254;4652;1439;5174
160015;201309;1493;5695;1461;5637;268;973;1042;4251;1310;5224
160020;201309;2250;7590;2100;7384;311;1144;1529;5497;1840;6641
160021;201309;794;3531;774;3495;143;691;530;2468;673;3159
160023;201309;926;3587;916;3571;100;352;775;3102;875;3454
160025;201309;1191;3435;1157;3399;22;77;1115;3272;1137;3349
160027;201309;7771;25538;7363;25048;1871;6416;4662;16413;6533;22829
160030;201309;36852;140711;35599;138057;8446;31998;23570;94382;32016;126380
160040;201309;3282;13828;3228;13737;209;963;2861;12237;3070;13200
160050;201309;3229;12348;2932;11887;1033;3871;1418;6478;2451;10349
160053;201309;2075;8780;2054;8745;579;2494;1246;5443;1825;7937
160055;201309;763;3016;747;2993;142;625;527;2124;669;2749
160060;201309;17260;58446;16281;57344;4694;15651;9924;37167;14618;52818
160070;201309;1913;8558;1898;8533;208;850;1629;7507;1837;8357
160080;201309;2533;9865;2515;9836;147;515;2317;9188;2464;9703
170025;201309;551;1920;507;1853;188;712;222;850;410;1562
170030;201309;1155;3869;1068;3713;303;1084;549;1930;852;3014
170035;201309;1515;4673;1250;4160;444;1598;396;1349;840;2947
170040;201309;1719;5871;1542;5598;330;1371;929;3377;1259;4748
170070;201309;2003;5586;1650;5133;429;1463;850;2696;1279;4159
170100;201309;2457;6876;2176;6381;303;1003;1662;4825;1965;5828
170105;201309;723;2413;616;2197;130;574;329;1125;459;1699
170110;201309;1183;3711;1045;3485;220;742;636;2136;856;2878
170130;201309;1342;4350;1203;4168;192;656;849;3058;1041;3714
170190;201309;1621;4768;1344;4372;612;2007;355;1301;967;3308
170200;201309;1444;4556;1142;4004;314;1227;367;1243;681;2470
170210;201309;26629;85594;23343;79649;9253;33950;6752;23695;16005;57645
170215;201309;1114;3664;1014;3500;141;505;753;2656;894;3161
170220;201309;6385;21505;5905;20757;868;3208;4166;15019;5034;18227
170230;201309;1398;4852;1250;4587;344;1421;591;2107;935;3528
170240;201309;2963;8457;2420;7776;338;1199;1670;5422;2008;6621
170255;201309;3550;11647;3044;10795;1101;3881;1235;4701;2336;8582
170270;201309;1039;2731;757;2344;181;596;429;1331;610;1927
170290;201309;2894;8916;2566;8513;216;646;2148;7408;2364;8054
170300;201309;2015;6488;1802;6145;307;1170;1217;4152;1524;5322
170305;201309;689;2229;581;2017;120;470;350;1188;470;1658
170307;201309;1045;3723;924;3512;290;1128;370;1574;660;2702
170310;201309;1616;4525;1301;4021;358;1163;576;1868;934;3031
170320;201309;934;2831;782;2567;194;652;416;1404;610;2056
170330;201309;813;2487;685;2329;131;451;451;1553;582;2004
170360;201309;453;1616;430;1576;95;374;222;807;317;1181
170370;201309;1371;4146;1161;3842;192;755;708;2327;900;3082
170380;201309;2076;6683;1724;6163;431;1740;911;3216;1342;4956
170382;201309;556;1886;495;1796;62;229;383;1395;445;1624
170384;201309;1497;6354;1424;6227;357;1597;889;4003;1246;5600
170386;201309;859;2623;723;2419;200;740;294;1006;494;1746
170388;201309;651;1981;568;1841;132;509;216;681;348;1190
170389;201309;915;3178;856;3086;100;442;645;2279;745;2721
170390;201309;1304;3991;1139;3781;187;644;830;2826;1017;3470
170410;201309;451;1513;431;1476;65;245;300;1027;365;1272
170460;201309;504;1430;390;1249;107;368;138;452;245;820
170510;201309;749;2576;644;2415;131;566;344;1281;475;1847
170550;201309;5323;17000;4484;15472;1828;6753;1226;4328;3054;11081
170555;201309;1326;3963;1108;3633;278;1013;612;2006;890;3019
170560;201309;1023;3516;869;3340;189;727;596;2385;785;3112
170600;201309;1296;3772;1160;3609;69;240;972;3078;1041;3318
170610;201309;1605;4923;1267;4376;210;809;731;2552;941;3361
170625;201309;394;1294;317;1126;88;326;86;304;174;630
170650;201309;1209;4021;1100;3808;276;1039;568;1976;844;3015
170700;201309;3852;13073;3263;12090;855;3491;1511;5808;2366;9299
170710;201309;1685;5092;1433;4714;186;719;1018;3357;1204;4076
170720;201309;1788;4802;1576;4474;307;885;1082;3124;1389;4009
170730;201309;1122;3247;924;2945;292;1047;413;1295;705;2342
170740;201309;2140;7855;1953;7548;312;1323;1356;5272;1668;6595
170755;201309;871;2803;740;2518;206;750;290;967;496;1717
170765;201309;1564;4281;1273;3812;338;1092;536;1663;874;2755
170770;201309;1802;6370;1688;6147;404;1525;975;3659;1379;5184
170820;201309;4116;13341;3719;12706;1075;3905;1616;5619;2691;9524
170825;201309;755;2308;577;1970;139;524;239;810;378;1334
170830;201309;1306;3922;1245;3827;48;107;1152;3587;1200;3694
170900;201309;2807;10083;2699;9875;357;1323;2013;7582;2370;8905
170930;201309;4153;12799;3419;11739;1385;5003;1130;3899;2515;8902
170950;201309;11459;35011;9159;31101;3915;14798;2102;6649;6017;21447
170980;201309;437;1433;385;1333;111;407;159;561;270;968
171050;201309;1244;4533;1185;4426;59;278;1052;3880;1111;4158
171070;201309;1654;5432;1532;5269;337;1224;944;3317;1281;4541
171090;201309;888;2688;779;2517;146;489;514;1681;660;2170
171110;201309;625;1863;516;1692;165;587;279;873;444;1460
171150;201309;853;2553;640;2149;128;464;363;1219;491;1683
171180;201309;599;1935;479;1679;125;479;200;722;325;1201
171190;201309;1835;6653;1577;6115;403;1647;743;3004;1146;4651
171195;201309;862;3164;790;3031;110;464;496;1979;606;2443
171200;201309;663;2200;556;2000;154;644;259;875;413;1519
171215;201309;450;1393;358;1229;66;253;166;589;232;842
171240;201309;864;2915;822;2844;70;170;683;2485;753;2655
171245;201309;657;2201;549;1936;122;480;249;865;371;1345
171250;201309;1147;3313;1031;3178;63;193;881;2761;944;2954
171270;201309;413;1719;384;1651;96;397;201;942;297;1339
171280;201309;891;2797;791;2619;192;627;396;1450;588;2077
171320;201309;3895;12220;3386;11474;1142;4043;1581;5374;2723;9417
171330;201309;2752;8506;2455;8055;640;2226;1345;4470;1985;6696
171360;201309;1482;4896;1269;4583;323;1244;686;2530;1009;3774
171370;201309;701;2001;627;1878;144;513;336;958;480;1471
171380;201309;1275;4449;1139;4175;331;1219;547;2077;878;3296
171395;201309;886;2843;755;2594;156;608;396;1353;552;1961
171420;201309;2278;6965;1845;6186;501;1803;776;2618;1277;4421
171430;201309;1025;3266;934;3133;217;739;560;1909;777;2648
171488;201309;2397;7488;2214;7215;577;1887;1192;4057;1769;5944
171500;201309;885;2729;779;2514;139;411;439;1470;578;1881
171510;201309;895;3275;817;3157;154;624;513;2073;667;2697
171515;201309;613;1808;488;1622;116;397;237;801;353;1198
171525;201309;585;2014;499;1852;104;422;266;982;370;1404
171550;201309;342;1160;292;1049;120;484;48;184;168;668
171570;201309;1103;3609;999;3449;206;710;633;2251;839;2961
171575;201309;1932;5621;1544;4911;429;1417;659;2175;1088;3592
171610;201309;6023;20933;5539;20004;1947;7409;1934;7035;3881;14444
171620;201309;2174;7079;2019;6838;196;729;1639;5592;1835;6321
171630;201309;890;3011;745;2752;183;758;317;1158;500;1916
171650;201309;2315;7410;1945;6764;529;1966;858;2954;1387;4920
171660;201309;2542;7221;2105;6445;491;1592;1093;3421;1584;5013
171665;201309;1384;4343;1217;4059;215;800;780;2642;995;3442
171670;201309;2276;6257;1891;5749;457;1502;1125;3368;1582;4870
171700;201309;1098;3733;1006;3580;157;630;651;2325;808;2955
171720;201309;665;2126;588;1977;172;641;282;943;454;1584
171750;201309;1197;4039;1079;3791;399;1469;377;1340;776;2809
171780;201309;1121;3302;832;2879;140;538;495;1694;635;2232
171790;201309;1723;5598;1414;5145;292;1086;845;3214;1137;4300
171800;201309;711;2327;657;2246;98;375;448;1536;546;1911
171820;201309;9281;29476;8606;28648;2163;7748;4942;16706;7105;24454
171830;201309;1619;5968;1483;5675;370;1502;693;2661;1063;4163
171840;201309;743;2265;672;2168;77;269;500;1619;577;1888
171845;201309;795;2176;623;1875;91;319;361;1058;452;1377
171850;201309;1015;3687;928;3498;108;482;603;2272;711;2754
171855;201309;1226;3985;1117;3802;119;500;840;2795;959;3295
171865;201309;475;1576;406;1475;102;422;198;702;300;1124
171870;201309;654;2145;551;1963;126;477;258;950;384;1427
171875;201309;1351;4378;1149;4067;179;706;823;2903;1002;3609
171880;201309;984;3531;956;3486;127;496;717;2671;844;3167
171884;201309;834;2487;651;2214;155;582;250;866;405;1448
171886;201309;1436;4982;1318;4730;448;1681;455;1678;903;3359
171888;201309;646;2024;562;1873;105;373;338;1166;443;1539
171889;201309;476;1615;455;1565;93;294;277;1004;370;1298
171890;201309;1099;3744;997;3591;146;643;674;2385;820;3028
171900;201309;428;1706;410;1666;100;414;230;948;330;1362
172000;201309;644;2095;553;1964;85;370;343;1179;428;1549
172010;201309;1157;3991;1096;3879;112;445;866;3086;978;3531
172015;201309;349;1325;305;1256;59;243;179;785;238;1028
172020;201309;2285;7653;2057;7313;305;1196;1473;5282;1778;6478
172025;201309;715;2149;596;1938;102;362;358;1171;460;1533
172030;201309;1071;3726;984;3565;175;723;630;2290;805;3013
172049;201309;1105;3201;1041;3113;139;418;778;2367;917;2785
172065;201309;1156;3542;980;3319;138;531;753;2535;891;3066
172080;201309;2633;8165;2257;7530;308;1201;1488;4869;1796;6070
172085;201309;501;1406;394;1208;95;318;119;364;214;682
172090;201309;3333;10191;2635;9293;560;2131;1585;5723;2145;7854
172093;201309;564;1880;451;1672;191;804;169;595;360;1399
172097;201309;666;2014;563;1837;164;580;197;628;361;1208
172100;201309;24563;86296;22202;81377;8014;31918;6368;23382;14382;55300
172110;201309;1675;6057;1560;5895;145;517;1249;4878;1394;5395
172120;201309;5457;16519;4585;15411;491;1734;3536;12137;4027;13871
172125;201309;316;978;257;888;59;224;125;451;184;675
172130;201309;503;1492;451;1416;78;262;295;962;373;1224
172208;201309;2132;6743;2016;6551;437;1522;1137;3763;1574;5285
172210;201309;2263;6900;2158;6769;164;556;1876;5880;2040;6436
210005;201309;20836;69556;18998;66586;6055;22494;9331;33055;15386;55549
210010;201309;1596;5679;1445;5487;171;617;1131;4448;1302;5065
210015;201309;3406;10638;3156;10284;227;473;2706;9306;2933;9779
210020;201309;6991;18065;6581;17570;439;1354;5442;14687;5881;16041
210030;201309;5805;19634;5537;19260;443;1834;4652;16100;5095;17934
210040;201309;1930;5660;1760;5454;183;580;1390;4364;1573;4944
210043;201309;5739;18017;5444;17563;409;1379;4605;15047;5014;16426
210047;201309;6642;26315;6239;25592;925;4124;4281;17692;5206;21816
210050;201309;2477;8655;2017;8063;301;1231;1430;5846;1731;7077
210055;201309;1616;5670;1535;5557;201;698;1195;4407;1396;5105
210060;201309;7831;29150;7107;28025;818;3579;5287;21261;6105;24840
210070;201309;6589;20718;6324;20371;302;1075;5711;18485;6013;19560
210080;201309;3625;12562;3556;12457;94;370;3322;11681;3416;12051
210083;201309;3457;12761;3397;12680;241;899;2991;11300;3232;12199
210087;201309;2427;7901;2324;7778;192;694;2012;6739;2204;7433
210090;201309;9384;31546;9109;31090;535;1988;7916;27126;8451;29114
210095;201309;6080;23853;5962;23640;675;2691;4866;19638;5541;22329
210100;201309;7467;22415;7113;22014;288;1087;6456;19963;6744;21050
210110;201309;3135;11003;3039;10865;200;763;2573;9370;2773;10133
210120;201309;24482;74109;21147;69936;2264;8056;16246;54576;18510;62632
210125;201309;3270;11076;3158;10946;217;704;2792;9855;3009;10559
210130;201309;3592;11179;3510;11077;300;913;2953;9446;3253;10359
210135;201309;1619;4854;1448;4598;118;380;1211;3916;1329;4296
210140;201309;16344;54113;14160;51251;3166;11771;8952;33557;12118;45328
210150;201309;4391;11719;4091;11353;163;458;3736;10384;3899;10842
210160;201309;17850;59668;16799;58111;2368;7921;12926;46030;15294;53951
210170;201309;13877;51611;13654;51290;1017;3502;11972;45841;12989;49343
210173;201309;1730;7546;1681;7441;165;751;1424;6368;1589;7119
210177;201309;2851;9623;2703;9432;361;1389;2081;7222;2442;8611
210180;201309;1429;4562;1363;4456;107;365;1141;3742;1248;4107
210190;201309;5030;16545;4761;16084;380;1701;3699;12209;4079;13910
210193;201309;1407;4552;1318;4406;95;374;1089;3672;1184;4046
210197;201309;1690;6254;1619;6174;108;479;1432;5441;1540;5920
210200;201309;9012;30900;8375;29959;1289;4358;6037;22600;7326;26958
210203;201309;6062;20899;5713;20446;482;1577;4893;17894;5375;19471
210207;201309;2934;10043;2784;9778;407;1397;2053;7395;2460;8792
210210;201309;8542;29551;8276;29126;327;1236;7273;26048;7600;27284
210215;201309;1735;6964;1694;6899;168;751;1401;5733;1569;6484
210220;201309;6096;23955;5912;23646;491;1972;4836;19841;5327;21813
210230;201309;5288;18293;4946;17729;490;1828;3957;14344;4447;16172
210232;201309;11083;41799;10571;41013;2291;8791;7237;29100;9528;37891
210235;201309;3372;10860;3086;10494;212;755;2665;9135;2877;9890
210237;201309;2520;9178;2492;9139;49;125;2403;8925;2452;9050
210240;201309;2879;9332;2775;9173;282;836;2229;7572;2511;8408
210250;201309;4642;15291;4485;15093;159;598;4142;14012;4301;14610
210255;201309;2578;8622;2369;8272;593;2249;1404;4930;1997;7179
210260;201309;5156;16758;4798;16229;647;2104;3688;12779;4335;14883
210270;201309;5214;15267;4714;14598;185;649;4205;13141;4390;13790
210275;201309;3279;8689;3070;8464;97;252;2911;8073;3008;8325
210280;201309;5861;17376;5152;16491;372;1282;4389;14203;4761;15485
210290;201309;5815;18693;5378;18142;524;1729;4411;15209;4935;16938
210300;201309;35146;110446;30326;104074;3258;11999;24132;84274;27390;96273
210310;201309;2784;8185;2663;7991;133;405;2337;7046;2470;7451
210312;201309;2001;6766;1975;6726;141;554;1717;5846;1858;6400
210315;201309;2243;8174;2157;8034;117;505;1877;7016;1994;7521
210317;201309;4283;12973;4181;12853;160;453;3927;12169;4087;12622
210320;201309;19126;61035;18010;59705;1217;3997;15766;53224;16983;57221
210325;201309;3523;11369;3192;10866;352;1322;2483;8490;2835;9812
210330;201309;30987;86272;26746;81587;3996;10935;19614;64468;23610;75403
210340;201309;11765;37342;10836;36192;1347;3930;8296;29444;9643;33374
210350;201309;10189;32961;9571;32094;828;2881;7858;26801;8686;29682
210355;201309;3920;14217;3613;13829;134;362;3343;13144;3477;13506
210360;201309;16384;51495;15487;50170;1430;4826;12451;41053;13881;45879
210370;201309;7663;22020;7025;21331;297;876;6403;19716;6700;20592
210375;201309;3194;9980;2813;9527;475;1746;2061;7066;2536;8812
210380;201309;6102;18282;5542;17420;583;1685;4485;14448;5068;16133
210390;201309;2661;9759;2504;9502;102;457;2268;8637;2370;9094
210400;201309;4791;15619;4620;15396;396;1205;3961;13494;4357;14699
210405;201309;8485;24132;7042;22158;2158;6898;3266;11140;5424;18038
210407;201309;2061;7298;1865;6996;205;717;1440;5651;1645;6368
210408;201309;2066;8486;1976;8378;79;322;1810;7856;1889;8178
210409;201309;3845;14003;3663;13714;303;1165;2937;11283;3240;12448
210410;201309;3500;11403;3298;11145;347;1136;2758;9476;3105;10612
210420;201309;4067;13813;3831;13393;369;1265;3093;11039;3462;12304
210430;201309;1955;6393;1913;6341;159;538;1632;5450;1791;5988
210440;201309;4143;13277;4052;13134;209;695;3620;11847;3829;12542
210450;201309;2813;9102;2592;8758;238;862;2101;7115;2339;7977
210455;201309;4058;12403;3483;11497;684;2275;2253;7691;2937;9966
210460;201309;4051;13177;3848;12917;207;780;3360;11388;3567;12168
210462;201309;1755;6413;1701;6314;184;707;1302;4942;1486;5649
210465;201309;2719;9067;2572;8873;376;1110;2014;7280;2390;8390
210467;201309;5986;20580;5610;20066;483;1614;4690;17305;5173;18919
210470;201309;1769;5309;1529;4952;103;405;1223;3961;1326;4366
210480;201309;13052;45589;11784;43848;3310;12394;6659;26185;9969;38579
210490;201309;3278;10274;3071;9960;367;1243;2388;7790;2755;9033
210500;201309;6723;26519;6455;26040;735;2893;5041;21052;5776;23945
210510;201309;6596;22533;6455;22370;226;617;5910;21104;6136;21721
210515;201309;3595;11685;3530;11595;268;811;3101;10372;3369;11183
210520;201309;2641;8556;2502;8364;234;810;2044;6949;2278;7759
210530;201309;38990;132778;34457;125572;11340;44154;17124;63603;28464;107757
210535;201309;3036;10994;2973;10877;146;577;2652;9770;2798;10347
210540;201309;11846;43097;10751;41271;2432;9244;6306;25850;8738;35094
210542;201309;6338;18756;5586;17926;324;972;4948;16235;5272;17207
210545;201309;2183;7526;2093;7378;92;413;1823;6424;1915;6837
210547;201309;3455;12783;3300;12545;209;880;2794;10743;3003;11623
210550;201309;6187;17901;5390;17008;281;750;4868;15718;5149;16468
210560;201309;3804;12649;3544;12241;259;1043;2968;10213;3227;11256
210565;201309;1528;5290;1349;5018;128;578;1009;3742;1137;4320
210570;201309;12399;36628;11356;35404;1014;2761;9553;30777;10567;33538
210580;201309;2787;9134;2489;8744;293;958;1993;7190;2286;8148
210590;201309;4398;13827;4176;13555;256;852;3687;12124;3943;12976
210592;201309;2388;7759;2338;7679;110;424;2085;6822;2195;7246
210594;201309;2665;7883;2279;7382;149;501;1968;6465;2117;6966
210596;201309;2808;10776;2685;10544;345;1371;2006;8016;2351;9387
210598;201309;1993;6184;1892;6069;112;473;1710;5399;1822;5872
210600;201309;3251;9743;3043;9450;336;1089;2400;7460;2736;8549
210610;201309;2577;8321;2321;8003;285;1017;1861;6463;2146;7480
210620;201309;1769;5570;1643;5401;53;146;1510;5023;1563;5169
210630;201309;3312;12496;2908;11678;542;2195;1730;7238;2272;9433
210632;201309;4752;16628;4390;16113;532;1938;3442;12870;3974;14808
210635;201309;1860;6854;1816;6787;75;249;1673;6361;1748;6610
210637;201309;2681;9294;2580;9150;138;516;2315;8290;2453;8806
210640;201309;4174;14111;4126;14049;27;82;4029;13794;4056;13876
210650;201309;6594;20484;6487;20343;227;691;6092;19243;6319;19934
210660;201309;7251;23262;6846;22616;307;887;6232;20747;6539;21634
210663;201309;2703;8199;2597;8068;98;350;2348;7339;2446;7689
210667;201309;1612;6090;1564;6020;103;446;1341;5212;1444;5658
210670;201309;4652;17807;4513;17556;437;1721;3609;14394;4046;16115
210675;201309;4756;13414;4532;13134;296;783;3950;11688;4246;12471
210680;201309;4302;12812;3907;12335;198;672;3452;10921;3650;11593
210690;201309;6637;23580;6390;23311;347;1233;5763;21294;6110;22527
210700;201309;2581;7392;2305;7070;199;388;1886;6309;2085;6697
210710;201309;4862;15987;4692;15719;184;603;4269;14415;4453;15018
210720;201309;2342;8949;2253;8826;153;647;1964;7720;2117;8367
210725;201309;1165;4368;1003;4072;133;598;635;2590;768;3188
210730;201309;1162;3755;1054;3635;96;302;893;3132;989;3434
210735;201309;3581;13633;3432;13357;651;2562;2386;9531;3037;12093
210740;201309;4807;13373;4503;13065;179;375;4186;12441;4365;12816
210745;201309;3511;11134;3380;10932;351;1013;2726;8985;3077;9998
210750;201309;19558;55818;18094;54111;2282;6902;14455;43813;16737;50715
210760;201309;5804;16110;5545;15827;84;252;5387;15397;5471;15649
210770;201309;6043;16850;5221;15914;299;947;4569;13985;4868;14932
210780;201309;8514;29465;8006;28528;1098;4222;5828;21028;6926;25250
210790;201309;4709;14319;4110;13650;312;820;3521;12215;3833;13035
210800;201309;4757;14278;4355;13842;198;735;3803;12402;4001;13137
210805;201309;3651;15736;3566;15566;197;880;3096;13791;3293;14671
210810;201309;5524;17343;5007;16748;500;1302;4249;14814;4749;16116
210820;201309;8838;25806;8375;25197;1407;4215;5983;18505;7390;22720
210825;201309;5459;18479;5322;18307;215;763;4837;16818;5052;17581
210830;201309;8102;26518;7824;26203;339;955;7264;24700;7603;25655
210840;201309;3703;10381;3412;9959;323;787;2699;8013;3022;8800
210845;201309;5442;17595;5243;17359;294;852;4628;15788;4922;16640
210850;201309;5800;22076;5482;21513;972;4241;3764;14814;4736;19055
210860;201309;16505;53356;15804;52358;1390;4990;13103;43541;14493;48531
210870;201309;6157;20565;5637;19866;776;2730;4143;14917;4919;17647
210880;201309;3895;12834;3834;12755;204;658;3481;11715;3685;12373
210890;201309;5289;16210;4965;15785;517;1736;4022;12803;4539;14539
210900;201309;4442;15023;4176;14553;1473;5239;1955;7092;3428;12331
210905;201309;1779;5655;1708;5563;113;301;1517;5072;1630;5373
210910;201309;10484;33526;9878;32576;1971;6988;6466;21458;8437;28446
210920;201309;3459;11595;3365;11470;141;404;3081;10711;3222;11115
210923;201309;1502;5671;1443;5570;204;829;1038;4152;1242;4981
210927;201309;4653;14933;4556;14834;38;102;4482;14649;4520;14751
210930;201309;2579;9515;2499;9397;199;907;2125;7950;2324;8857
210940;201309;2853;11408;2815;11336;314;1161;2281;9446;2595;10607
210945;201309;5788;17217;5601;17026;157;218;5388;16700;5545;16918
210950;201309;5453;17612;4855;16721;701;2463;3435;12173;4136;14636
210955;201309;1852;6329;1693;6054;284;1118;1159;4165;1443;5283
210960;201309;8970;30478;8694;30043;1973;6571;5886;21203;7859;27774
210970;201309;1348;5005;1211;4800;195;834;852;3437;1047;4271
210975;201309;1646;5959;1571;5809;162;642;1248;4649;1410;5291
210980;201309;8574;22399;8372;22160;412;988;7582;20314;7994;21302
210990;201309;14508;43003;12197;40375;1576;5435;9533;31784;11109;37219
211000;201309;15840;52530;14542;50844;1172;4263;12258;43523;13430;47786
211003;201309;5070;18031;4680;17427;715;2836;3266;12414;3981;15250
211010;201309;6534;22138;6380;21935;151;510;5975;20722;6126;21232
211020;201309;7266;22624;7198;22538;214;438;6878;21818;7092;22256
211023;201309;2339;8178;2256;8033;174;647;1894;6847;2068;7494
211027;201309;3023;11810;2889;11583;288;1078;2313;9627;2601;10705
211030;201309;4137;12954;3752;12507;832;2317;2684;9534;3516;11851
211040;201309;4006;15660;3916;15509;129;542;3534;14235;3663;14777
211050;201309;9718;27233;9590;27084;517;1363;8859;25205;9376;26568
211060;201309;5570;20983;5458;20758;596;2088;4474;17499;5070;19587
211065;201309;1665;5836;1533;5658;84;326;1388;5160;1472;5486
211070;201309;8483;29101;8096;28450;799;2911;6465;23067;7264;25978
211080;201309;1332;4252;1103;3936;90;444;907;3160;997;3604
211085;201309;1990;6807;1736;6473;314;1133;1280;4935;1594;6068
211090;201309;3447;11187;3273;10939;230;918;2759;9157;2989;10075
211100;201309;6509;17574;6375;17404;95;347;6042;16456;6137;16803
211102;201309;3078;11619;2983;11476;384;1415;2388;9444;2772;10859
211105;201309;2720;8784;2492;8487;173;650;2146;7322;2319;7972
211107;201309;4249;13522;4019;13224;157;501;3672;12231;3829;12732
211110;201309;6270;19379;5098;17819;865;2956;3460;12708;4325;15664
211120;201309;30680;87016;27256;82522;3672;10876;20200;63180;23872;74056
211125;201309;2081;6971;1941;6759;158;550;1612;5698;1770;6248
211130;201309;142065;429161;134393;419211;26674;82985;93716;299447;120390;382432
211140;201309;5628;18426;5380;18031;300;1109;4690;15733;4990;16842
211150;201309;9608;30616;9249;30156;746;2430;8010;26461;8756;28891
211153;201309;3188;9677;2920;9357;303;773;2415;8112;2718;8885
211157;201309;1217;4093;1045;3824;145;641;727;2719;872;3360
211160;201309;4105;14409;3610;13570;405;1762;2740;10319;3145;12081
211163;201309;1671;5596;1599;5501;65;240;1457;5046;1522;5286
211167;201309;1451;5036;1355;4878;58;245;1200;4322;1258;4567
211170;201309;6574;18058;6378;17818;153;543;5965;16576;6118;17119
211172;201309;2336;6979;2059;6544;191;712;1643;5130;1834;5842
211174;201309;2806;8494;2590;8216;133;541;2258;7102;2391;7643
211176;201309;5509;16295;4719;15369;548;1502;3757;12790;4305;14292
211178;201309;2934;9627;2871;9561;72;194;2737;9227;2809;9421
211180;201309;4191;15451;3955;15065;403;1704;3129;11977;3532;13681
211190;201309;2731;9429;2504;9098;148;649;2164;7887;2312;8536
211195;201309;1409;4572;1231;4351;114;418;998;3595;1112;4013
211200;201309;2090;7435;1893;7160;279;978;1373;5505;1652;6483
211210;201309;6709;22693;6543;22412;528;1845;5550;19228;6078;21073
211220;201309;34543;105196;30550;99854;7337;24793;18469;62159;25806;86952
211223;201309;5879;17093;5479;16434;712;2167;3827;12051;4539;14218
211227;201309;1510;5831;1467;5757;166;750;1145;4492;1311;5242
211230;201309;8805;30515;8215;29502;1388;5023;5689;20990;7077;26013
211240;201309;8337;28438;8134;28188;362;1311;7501;26134;7863;27445
211245;201309;4993;15707;4917;15609;221;629;4522;14568;4743;15197
211250;201309;11594;44403;11063;43778;1307;4290;9128;37789;10435;42079
211260;201309;7636;25511;7548;25368;365;1180;6927;23478;7292;24658
211270;201309;9831;35631;9391;35047;647;2706;7891;29791;8538;32497
211280;201309;11975;34825;11632;34421;1254;3002;9795;30153;11049;33155
211285;201309;1986;7111;1735;6645;414;1661;898;3627;1312;5288
211290;201309;7706;25438;7552;25258;566;1550;6628;22776;7194;24326
211300;201309;8355;26219;7556;25002;702;2421;6090;20314;6792;22735
211400;201309;12236;36885;11044;35519;2506;8011;6688;23509;9194;31520
220005;201309;1693;5056;1624;4949;54;260;1444;4270;1498;4530
220010;201309;1709;4582;1304;4078;143;539;1019;3121;1162;3660
220020;201309;3645;11388;3498;11129;614;2116;2373;7511;2987;9627
220025;201309;2113;5406;2004;5251;66;215;1793;4627;1859;4842
220027;201309;1373;3835;1281;3717;101;236;1094;3263;1195;3499
220030;201309;3272;10121;3209;10015;289;965;2687;8427;2976;9392
220040;201309;8238;25995;7883;25418;1495;5130;5037;16291;6532;21421
220045;201309;1432;4671;1306;4460;154;587;953;3229;1107;3816
220050;201309;4776;13837;4272;13140;348;1286;3497;10614;3845;11900
220060;201309;1995;5270;1903;5161;107;299;1703;4630;1810;4929
220070;201309;2558;7753;2290;7376;216;708;1837;6005;2053;6713
220080;201309;823;2587;777;2502;98;398;549;1694;647;2092
220090;201309;1716;4785;1546;4533;149;531;1211;3456;1360;3987
220095;201309;642;1879;622;1838;34;104;568;1668;602;1772
220100;201309;1399;4292;1223;4010;161;508;896;3023;1057;3531
220105;201309;2175;7304;2071;7109;225;815;1523;5252;1748;6067
220110;201309;3535;10397;3146;9842;302;1122;2540;7821;2842;8943
220115;201309;2174;8124;2095;7990;306;1223;1622;6244;1928;7467
220117;201309;1413;3810;1178;3467;95;318;936;2721;1031;3039
220120;201309;12255;36337;11495;35365;403;1535;10452;32138;10855;33673
220130;201309;775;2887;689;2772;66;187;590;2482;656;2669
220140;201309;1559;4255;1463;4138;275;627;1136;3378;1411;4005
220150;201309;7126;22902;6853;22511;475;1839;5819;19027;6294;20866
220155;201309;1033;3307;893;3044;83;358;627;2078;710;2436
220157;201309;1042;2772;961;2648;47;121;831;2311;878;2432
220160;201309;2827;8535;2553;8055;217;836;1938;6041;2155;6877
220170;201309;1248;4112;1182;3990;120;434;922;3143;1042;3577
220173;201309;2081;6382;1699;5632;83;385;1393;4526;1476;4911
220177;201309;1649;4985;1622;4941;86;277;1465;4472;1551;4749
220180;201309;1150;3189;1037;3012;78;274;796;2259;874;2533
220190;201309;4517;15040;3949;14304;479;1799;3041;11138;3520;12937
220191;201309;1409;4829;1354;4736;217;759;993;3492;1210;4251
220192;201309;1734;5153;1441;4658;180;554;1072;3539;1252;4093
220194;201309;1687;4965;1544;4707;201;682;1129;3349;1330;4031
220196;201309;1997;6061;1894;5889;223;808;1434;4405;1657;5213
220198;201309;1329;3672;1136;3414;43;143;1039;3143;1082;3286
220200;201309;4602;16033;4349;15629;759;2976;2975;10632;3734;13608
220202;201309;2008;6469;1843;6170;71;298;1627;5409;1698;5707
220205;201309;2828;7731;2525;7320;111;429;2206;6301;2317;6730
220207;201309;912;2824;794;2617;100;374;590;1929;690;2303
220208;201309;1612;5795;1525;5625;317;1324;965;3526;1282;4850
220209;201309;1548;4962;1429;4757;106;430;1101;3663;1207;4093
220210;201309;1849;4962;1624;4666;99;349;1286;3703;1385;4052
220211;201309;1631;4929;1549;4808;108;467;1275;3929;1383;4396
220213;201309;1777;5238;1663;5024;117;394;1311;3909;1428;4303
220217;201309;1777;5732;1728;5666;83;250;1556;5168;1639;5418
220220;201309;11447;33752;10672;32502;1445;4344;7600;23726;9045;28070
220225;201309;991;3095;951;3038;45;182;837;2644;882;2826
220230;201309;5979;16048;4976;14678;272;814;4345;12884;4617;13698
220240;201309;2660;8686;2562;8506;216;805;2032;6679;2248;7484
220245;201309;1413;3906;1333;3800;64;168;1191;3431;1255;3599
220250;201309;3347;9063;3047;8667;60;139;2863;8246;2923;8385
220253;201309;1820;5533;1593;5116;118;450;1177;3806;1295;4256
220255;201309;1727;5041;1539;4717;124;479;1231;3676;1355;4155
220260;201309;5206;16850;4758;16017;503;1941;3561;11942;4064;13883
220265;201309;1185;4397;1135;4312;102;478;845;3197;947;3675
220270;201309;6361;22073;6209;21796;434;1965;5253;18074;5687;20039
220271;201309;1429;4187;1380;4116;84;254;1197;3618;1281;3872
220272;201309;1758;5525;1643;5351;114;478;1300;4187;1414;4665
220273;201309;1272;3727;1127;3503;108;373;846;2607;954;2980
220275;201309;2046;5528;1764;5165;86;278;1529;4495;1615;4773
220277;201309;2523;7034;2167;6499;172;567;1663;5029;1835;5596
220280;201309;1772;4654;1552;4344;106;396;1252;3432;1358;3828
220285;201309;1662;4516;1494;4281;103;308;1234;3615;1337;3923
220290;201309;6553;21375;5563;20102;520;1944;4449;16341;4969;18285
220300;201309;1884;6207;1676;5929;96;433;1432;5062;1528;5495
220310;201309;2545;8323;2105;7795;109;351;1897;7204;2006;7555
220320;201309;3342;9980;2840;9141;421;1384;2041;6633;2462;8017
220323;201309;1397;5328;1290;5172;230;985;912;3676;1142;4661
220325;201309;1270;4002;1168;3809;166;583;769;2580;935;3163
220327;201309;1337;4325;1210;4098;84;393;982;3265;1066;3658
220330;201309;3590;10495;3442;10285;293;990;2881;8623;3174;9613
220335;201309;2051;5993;1834;5713;116;425;1588;4922;1704;5347
220340;201309;1768;5135;1585;4883;171;598;1220;3724;1391;4322
220342;201309;1212;3987;1150;3894;114;468;867;3010;981;3478
220345;201309;2835;7986;2418;7301;95;273;2082;6303;2177;6576
220350;201309;4443;12145;3921;11425;311;1002;3126;9097;3437;10099
220360;201309;1451;4026;1151;3554;123;414;834;2566;957;2980
220370;201309;9003;26336;8323;25462;465;1348;7497;23102;7962;24450
220375;201309;1527;4806;1429;4671;88;338;1264;4101;1352;4439
220380;201309;1325;3759;1147;3501;73;252;898;2741;971;2993
220385;201309;681;1904;616;1776;44;150;505;1397;549;1547
220390;201309;10262;32884;9454;31277;2232;7842;4944;16428;7176;24270
220400;201309;1433;3503;1307;3330;65;211;1133;2832;1198;3043
220410;201309;1381;4059;1189;3797;108;464;946;2927;1054;3391
220415;201309;870;2376;785;2254;90;249;586;1704;676;1953
220420;201309;2197;6506;2047;6223;146;442;1683;5130;1829;5572
220430;201309;2937;8742;2790;8547;417;1316;2056;6326;2473;7642
220435;201309;1596;4818;1515;4711;82;263;1303;4073;1385;4336
220440;201309;2796;8366;2313;7807;146;406;2054;7055;2200;7461
220450;201309;2714;8142;2367;7677;579;1952;1428;4687;2007;6639
220455;201309;1421;4392;1278;4189;59;199;1146;3793;1205;3992
220460;201309;1010;2850;958;2774;60;184;831;2395;891;2579
220465;201309;2412;8035;2259;7823;390;1446;1630;5696;2020;7142
220470;201309;3996;12266;3642;11630;255;955;2852;8967;3107;9922
220480;201309;2287;7064;2103;6779;161;552;1741;5619;1902;6171
220490;201309;2343;7043;2249;6918;133;497;1964;5995;2097;6492
220500;201309;3422;9365;2974;8638;211;803;2423;6839;2634;7642
220510;201309;2916;8239;2257;7288;103;460;1779;5715;1882;6175
220515;201309;1951;4939;1728;4654;83;239;1471;3960;1554;4199
220520;201309;4938;14199;4658;13798;247;693;4073;12202;4320;12895
220525;201309;1456;4163;1362;4032;108;396;1109;3208;1217;3604
220527;201309;1400;4530;1332;4381;138;440;1074;3584;1212;4024
220530;201309;1122;3339;1059;3243;117;442;857;2532;974;2974
220535;201309;849;2746;820;2701;72;305;659;2136;731;2441
220540;201309;3569;12097;3446;11887;288;1150;2805;9690;3093;10840
220545;201309;1409;4947;1352;4843;218;876;914;3238;1132;4114
220550;201309;9064;30160;8613;29329;1662;6029;5629;19199;7291;25228
220551;201309;1406;4904;1327;4762;136;579;1027;3632;1163;4211
220552;201309;1650;5188;1427;4821;137;628;1038;3364;1175;3992
220553;201309;1598;4836;1396;4537;78;285;1160;3751;1238;4036
220554;201309;926;2624;810;2463;124;385;569;1763;693;2148
220555;201309;2391;7171;2255;6981;100;347;1927;6057;2027;6404
220556;201309;1456;4696;1329;4450;105;440;1000;3302;1105;3742
220557;201309;1597;5339;1452;5059;185;768;1018;3495;1203;4263
220558;201309;1015;3198;957;3094;90;339;767;2468;857;2807
220559;201309;1539;4418;1427;4256;85;287;1225;3645;1310;3932
220560;201309;1752;4419;1471;4026;84;249;1249;3393;1333;3642
220570;201309;7305;23666;6920;23173;760;2211;5720;19789;6480;22000
220580;201309;6388;21345;6221;21139;439;1445;5494;18943;5933;20388
220585;201309;1873;7135;1819;7035;129;508;1546;6042;1675;6550
220590;201309;1402;4453;1270;4255;232;814;832;2834;1064;3648
220595;201309;2445;7209;2273;6974;88;301;2051;6308;2139;6609
220600;201309;1294;3304;1119;3092;195;456;759;2212;954;2668
220605;201309;2015;6090;1810;5770;121;412;1429;4566;1550;4978
220610;201309;2612;8611;2533;8491;188;745;2125;7084;2313;7829
220620;201309;7757;26732;7536;26390;417;1678;6582;23061;6999;24739
220630;201309;389;1199;336;1108;84;294;174;581;258;875
220635;201309;1843;6638;1714;6337;162;717;1139;4191;1301;4908
220640;201309;2763;8273;2664;8122;280;966;2067;6296;2347;7262
220650;201309;2455;6951;2214;6578;144;494;1818;5384;1962;5878
220660;201309;2465;8511;2039;7985;158;633;1815;7160;1973;7793
220665;201309;1213;4213;1163;4133;61;256;1012;3575;1073;3831
220667;201309;1751;5976;1662;5846;86;351;1432;5021;1518;5372
220669;201309;1861;6214;1738;5971;235;922;1238;4223;1473;5145
220670;201309;2107;6451;2000;6322;161;427;1732;5649;1893;6076
220672;201309;2171;6443;2123;6376;229;676;1778;5397;2007;6073
220675;201309;1336;3940;1250;3796;135;372;931;2882;1066;3254
220680;201309;2227;7411;2147;7295;155;542;1822;6253;1977;6795
220690;201309;1701;4948;1540;4680;127;481;1233;3686;1360;4167
220695;201309;863;2690;820;2617;69;228;635;2044;704;2272
220700;201309;8994;26651;8231;25510;792;2720;6439;19959;7231;22679
220710;201309;741;2258;650;2108;73;228;470;1543;543;1771
220720;201309;2113;5788;2003;5632;104;237;1780;5099;1884;5336
220730;201309;1346;3790;1199;3563;57;195;1013;2995;1070;3190
220735;201309;1023;2740;885;2516;87;272;658;1880;745;2152
220740;201309;1319;4429;1149;4195;134;448;915;3458;1049;3906
220750;201309;3922;11882;3741;11611;494;1431;2885;9255;3379;10686
220755;201309;1162;3520;1111;3439;67;201;970;3017;1037;3218
220760;201309;2619;9396;2444;9122;124;491;2136;8054;2260;8545
220770;201309;22945;80476;21693;78155;7555;28213;9402;34932;16957;63145
220775;201309;1148;2911;1136;2899;18;29;1111;2852;1129;2881
220777;201309;1679;4890;1598;4773;132;407;1308;3893;1440;4300
220779;201309;1132;3557;1107;3518;71;278;976;3077;1047;3355
220780;201309;6229;16496;5654;15737;493;1267;4662;13238;5155;14505
220785;201309;1278;3564;1235;3471;74;198;1105;3103;1179;3301
220790;201309;9135;30812;8916;30391;958;3590;7118;24212;8076;27802
220793;201309;893;2606;834;2506;70;236;678;2027;748;2263
220795;201309;1507;4315;1459;4242;118;354;1216;3571;1334;3925
220800;201309;16672;48602;15687;47090;1971;6903;11891;34924;13862;41827
220810;201309;3303;9822;2888;9068;254;989;2251;6951;2505;7940
220820;201309;5464;15897;5020;15309;349;1160;4263;13075;4612;14235
220830;201309;7668;22147;7358;21637;886;2580;5705;17077;6591;19657
220840;201309;14602;47790;13481;45527;3582;12369;6227;21783;9809;34152
220850;201309;2599;9748;2503;9596;350;1463;1897;7334;2247;8797
220855;201309;606;1974;563;1892;71;282;417;1383;488;1665
220860;201309;929;2650;871;2558;56;221;715;2051;771;2272
220865;201309;2647;7588;2238;6932;123;546;1827;5549;1950;6095
220870;201309;2390;7978;2099;7609;157;623;1792;6499;1949;7122
220880;201309;5333;14253;4907;13721;260;887;4304;12016;4564;12903
220885;201309;1328;4721;1180;4456;121;551;864;3266;985;3817
220887;201309;1264;3514;1129;3325;45;148;1004;2970;1049;3118
220890;201309;1599;5759;1444;5509;129;493;1185;4639;1314;5132
220900;201309;1837;5679;1662;5266;127;388;1342;4316;1469;4704
220910;201309;1727;5065;1545;4782;81;282;1342;4181;1423;4463
220915;201309;1030;3042;922;2862;53;232;735;2218;788;2450
220920;201309;1277;4859;1222;4779;123;560;946;3691;1069;4251
220930;201309;1465;4804;1298;4586;114;468;1045;3719;1159;4187
220935;201309;1020;3222;926;3012;69;304;694;2152;763;2456
220937;201309;1516;4312;1318;3957;85;310;1056;3109;1141;3419
220940;201309;1463;4557;1370;4353;107;399;1086;3445;1193;3844
220945;201309;474;1748;441;1647;59;253;307;1139;366;1392
220950;201309;1253;3238;922;2663;48;193;696;1945;744;2138
220955;201309;1592;4485;1359;4122;148;501;1045;3157;1193;3658
220960;201309;797;2304;719;2170;73;288;547;1592;620;1880
220965;201309;1653;5128;1565;5002;73;298;1350;4299;1423;4597
220970;201309;2081;5745;1586;4938;191;579;1113;3538;1304;4117
220975;201309;476;1934;473;1927;62;242;391;1614;453;1856
220980;201309;1484;4502;1318;4206;129;471;900;2946;1029;3417
220985;201309;1348;3941;1293;3863;113;389;1022;3045;1135;3434
220987;201309;1460;4905;1381;4759;126;516;1054;3569;1180;4085
220990;201309;1785;5371;1607;5066;103;438;1280;3979;1383;4417
220995;201309;1162;3622;965;3292;83;343;757;2583;840;2926
220997;201309;2080;6718;2002;6588;142;484;1774;5835;1916;6319
221000;201309;4261;13499;3963;12969;481;1697;2931;9578;3412;11275
221005;201309;1400;4523;1333;4405;385;1218;743;2551;1128;3769
221010;201309;1237;3431;1101;3256;65;206;944;2809;1009;3015
221020;201309;1895;5981;1798;5807;137;606;1379;4341;1516;4947
221030;201309;1819;5048;1593;4715;87;349;1303;3802;1390;4151
221035;201309;1531;4254;1392;4076;99;293;1203;3565;1302;3858
221037;201309;635;1983;574;1875;36;157;466;1459;502;1616
221038;201309;619;1831;518;1664;48;169;359;1166;407;1335
221039;201309;904;2727;864;2666;68;233;744;2278;812;2511
221040;201309;5081;15938;4837;15535;421;1484;3810;12369;4231;13853
221050;201309;3627;11423;3367;11042;225;918;2869;9302;3094;10220
221060;201309;9063;25038;7868;23464;864;2642;6232;18747;7096;21389
221062;201309;1272;4493;1218;4418;35;108;1143;4165;1178;4273
221063;201309;1104;3625;1049;3531;363;1177;556;1997;919;3174
221065;201309;2650;8043;2530;7842;270;890;1976;6111;2246;7001
221070;201309;4353;13616;3999;13080;293;1110;3209;10470;3502;11580
221080;201309;3347;9505;3051;9105;247;790;2476;7442;2723;8232
221090;201309;1319;3691;1192;3506;71;281;1003;2883;1074;3164
221093;201309;1780;5398;1705;5257;268;940;1136;3434;1404;4374
221095;201309;967;2665;844;2493;44;128;750;2238;794;2366
221097;201309;794;2336;713;2201;65;252;547;1669;612;1921
221100;201309;120616;376395;115350;367612;25502;89844;74395;231618;99897;321462
221110;201309;9450;33005;9284;32744;733;3021;7793;27329;8526;30350
221120;201309;4113;14128;3980;13879;1210;4102;2288;8375;3498;12477
221130;201309;4609;14018;4125;13028;1001;3305;2311;7239;3312;10544
221135;201309;1432;4644;1345;4507;189;725;969;3214;1158;3939
221140;201309;1385;3568;1284;3436;167;365;1001;2773;1168;3138
221150;201309;1218;3219;1038;2888;33;135;839;2317;872;2452
221160;201309;899;2467;855;2397;60;187;662;1863;722;2050
221170;201309;1094;3646;1055;3567;82;332;872;2910;954;3242
230010;201309;3268;9318;2829;8598;180;625;2264;6941;2444;7566
230015;201309;2910;10228;2712;9813;481;2015;1739;6201;2220;8216
230020;201309;13916;47538;13446;46603;1242;4692;10701;37282;11943;41974
230030;201309;12180;37204;11597;36228;1141;3903;9197;28743;10338;32646
230040;201309;4487;13067;3848;11933;372;1323;2967;9130;3339;10453
230050;201309;2531;8832;2200;7996;406;1658;1163;4226;1569;5884
230060;201309;1936;5989;1750;5619;191;720;1295;4119;1486;4839
230070;201309;4620;12927;4119;12218;398;1269;3139;9501;3537;10770
230075;201309;8592;32966;8210;32176;1078;4903;6031;23597;7109;28500
230080;201309;2322;6638;1995;6166;123;444;1642;5056;1765;5500
230090;201309;3284;10471;2991;9942;356;1385;2245;7338;2601;8723
230100;201309;16537;53254;15540;51425;4651;16213;7522;25256;12173;41469
230110;201309;13753;46603;12907;44771;2573;9693;7830;27143;10403;36836
230120;201309;7730;22029;6980;21013;829;2829;5197;15629;6026;18458
230125;201309;2819;8533;2377;7670;196;772;1788;5716;1984;6488
230130;201309;5771;19424;4867;17405;467;1989;3429;12130;3896;14119
230140;201309;3351;11321;2992;10670;500;1882;1929;7006;2429;8888
230150;201309;1731;5625;1528;5209;298;1184;956;3095;1254;4279
230160;201309;6178;19244;5490;18203;594;2185;4113;13678;4707;15863
230170;201309;6358;20954;5578;19513;550;2221;4034;13965;4584;16186
230180;201309;1901;5641;1704;5292;146;558;1212;3724;1358;4282
230185;201309;4088;14087;3814;13550;718;2597;2392;8762;3110;11359
230190;201309;12232;41247;11278;39317;2160;8559;6605;22824;8765;31383
230195;201309;4799;15416;4386;14758;393;1684;3368;10968;3761;12652
230200;201309;5625;16805;5056;15686;687;2244;3556;11038;4243;13282
230205;201309;4328;14161;3897;13422;423;1733;2811;9740;3234;11473
230210;201309;9005;26810;8112;25404;2023;6486;4513;14627;6536;21113
230220;201309;13417;41135;12523;39626;2099;7462;8438;26332;10537;33794
230230;201309;7211;24682;6529;23184;1160;4318;3948;14206;5108;18524
230240;201309;13148;39635;11987;37443;897;3435;9320;28673;10217;32108
230250;201309;10162;31698;9927;31334;574;2115;8441;26604;9015;28719
230260;201309;14614;51132;13638;49067;3261;12483;7116;26231;10377;38714
230270;201309;6921;21589;6219;20371;711;2611;4627;15213;5338;17824
230280;201309;19757;61761;18403;59462;2601;9053;13499;43684;16100;52737
230290;201309;5065;16034;4460;14809;634;2227;3019;10089;3653;12316
230300;201309;4593;14858;4425;14608;561;2093;3310;10907;3871;13000
230310;201309;4848;14862;4316;13972;412;1640;3273;10419;3685;12059
230320;201309;7234;24014;6829;23283;866;3314;4993;17077;5859;20391
230330;201309;4617;14226;4205;13404;454;1663;3037;9505;3491;11168
230340;201309;3335;11917;3163;11522;536;2205;1991;7097;2527;9302
230350;201309;17800;55955;16105;52949;3177;11242;9885;32820;13062;44062
230360;201309;2885;8913;2611;8426;296;1108;1990;6364;2286;7472
230365;201309;2871;8768;2547;8223;226;880;1901;6104;2127;6984
230370;201309;52744;180957;49400;175265;15103;56004;24616;90093;39719;146097
230380;201309;7011;20728;6068;19128;587;2177;4312;13565;4899;15742
230390;201309;3609;11715;3244;11108;454;1857;2198;7433;2652;9290
230393;201309;3312;11352;2887;10439;293;1442;2044;7141;2337;8583
230395;201309;4891;15984;4597;15400;652;2591;3141;10397;3793;12988
230400;201309;5011;16138;4453;15364;424;1858;3563;12040;3987;13898
230410;201309;15851;51100;14368;48337;2501;9114;8850;29815;11351;38929
230420;201309;23435;80476;22255;78066;5821;22313;11440;39838;17261;62151
230423;201309;4758;15946;4410;15312;535;2058;3099;10869;3634;12927
230425;201309;5279;18356;4958;17647;726;2827;3445;12227;4171;15054
230426;201309;2781;7975;2358;7211;155;640;1808;5401;1963;6041
230427;201309;1734;5400;1307;4411;141;536;853;2790;994;3326
230428;201309;8903;29972;8699;29614;1824;6995;5564;18633;7388;25628
230430;201309;4530;15033;4304;14575;433;1789;3169;10559;3602;12348
230435;201309;4789;16348;4357;15572;1124;4377;2149;7913;3273;12290
230440;201309;351378;1118342;333482;1085650;87960;309323;169436;551012;257396;860335
230445;201309;4654;13093;4067;12259;389;1163;3075;9505;3464;10668
230450;201309;3617;11936;3115;11012;491;1944;1979;7038;2470;8982
230460;201309;1887;6384;1752;6123;196;762;1289;4520;1485;5282
230465;201309;4067;12754;3384;11449;366;1564;2225;7356;2591;8920
230470;201309;11042;41321;10680;40615;1525;6222;7740;29929;9265;36151
230480;201309;1437;4758;1282;4458;238;871;827;2899;1065;3770
230490;201309;2948;8810;2613;8198;455;1612;1448;4543;1903;6155
230495;201309;5658;19407;5153;18561;980;4122;3064;11026;4044;15148
230500;201309;10648;36893;10181;36130;895;3328;8098;29364;8993;32692
230510;201309;1482;5458;1288;4969;364;1496;556;2225;920;3721
230520;201309;4960;15480;4354;14393;506;1939;3010;9917;3516;11856
230523;201309;12938;44649;12085;42718;3786;14807;3681;13151;7467;27958
230526;201309;4042;12995;3570;12129;470;1789;2458;8405;2928;10194
230530;201309;5072;17402;4716;16892;999;3601;3089;11283;4088;14884
230533;201309;3733;11314;3502;10861;301;1083;2726;8399;3027;9482
230535;201309;5323;16296;4721;15186;494;1720;3474;11311;3968;13031
230540;201309;18495;54711;16656;52004;1276;4670;13617;42191;14893;46861
230550;201309;19994;61859;18422;58856;4347;15116;10087;32090;14434;47206
230560;201309;6621;19607;6040;18512;353;1380;4809;14571;5162;15951
230565;201309;3434;10175;2952;9233;308;1134;2046;6326;2354;7460
230570;201309;3885;10882;3508;10396;248;922;2897;8472;3145;9394
230580;201309;10190;32170;9818;31653;590;2033;8565;27813;9155;29846
230590;201309;9438;30925;8790;29753;855;3582;6542;21692;7397;25274
230600;201309;3631;10492;2888;8977;310;1120;1918;5883;2228;7003
230610;201309;5974;20202;5600;19587;839;3218;3991;14062;4830;17280
230620;201309;1996;5843;1719;5282;181;646;1121;3358;1302;4004
230625;201309;7373;25147;6730;23654;1924;7380;2580;9033;4504;16413
230630;201309;10953;36899;10108;35158;2252;7794;5514;19978;7766;27772
230640;201309;25593;88687;24457;86891;4125;15491;17046;61286;21171;76777
230650;201309;4889;16075;4521;15354;431;1837;3454;11509;3885;13346
230655;201309;8379;32615;8118;32175;869;3470;6661;26849;7530;30319
230660;201309;6271;20172;5533;18806;599;2422;3971;13570;4570;15992
230670;201309;5897;16504;4865;14708;305;1116;3831;11346;4136;12462
230680;201309;2864;8684;2469;7952;423;1516;1484;4758;1907;6274
230690;201309;6522;21921;6320;21543;576;2465;4558;15188;5134;17653
230700;201309;9090;27087;8071;25200;955;3625;5467;16587;6422;20212
230710;201309;7449;24783;6716;23387;920;3266;4813;17130;5733;20396
230720;201309;1909;6123;1646;5612;246;925;1084;3712;1330;4637
230725;201309;3782;12845;3485;12180;625;2464;2211;7599;2836;10063
230730;201309;56140;175202;48262;162960;12789;47012;23942;82053;36731;129065
230740;201309;5118;16995;4974;16724;369;1569;4138;13747;4507;15316
230750;201309;8809;26309;7591;24271;773;2971;5661;17964;6434;20935
230760;201309;9806;31139;9542;30529;1421;5523;6817;20829;8238;26352
230763;201309;4162;13364;3945;12938;339;1536;3030;9542;3369;11078
230765;201309;43138;144861;40643;139719;13888;50687;14787;51793;28675;102480
230770;201309;22639;65403;21357;63445;1743;6361;16909;49547;18652;55908
230780;201309;5901;23944;5668;23388;1328;5585;3155;13689;4483;19274
230790;201309;2508;8766;2412;8604;295;1154;1884;6783;2179;7937
230800;201309;7728;28794;7179;27544;1751;7334;3527;13564;5278;20898
230810;201309;12278;41021;11794;40195;1458;5321;8967;30903;10425;36224
230820;201309;3360;11644;3006;10869;648;2605;1628;5921;2276;8526
230830;201309;7689;23884;7003;22662;748;2858;5083;16359;5831;19217
230835;201309;4093;11448;3539;10704;319;1054;2777;8417;3096;9471
230837;201309;3141;11005;2744;10189;397;1665;1808;6723;2205;8388
230840;201309;9211;31418;8460;30062;1490;5648;5414;19657;6904;25305
230850;201309;11041;34673;10511;33993;1361;4925;7881;25393;9242;30318
230860;201309;4998;15444;4595;14622;428;1632;3444;10806;3872;12438
230870;201309;18572;53139;16882;50232;1848;6279;12652;37348;14500;43627
230880;201309;1900;6735;1784;6499;267;1107;1174;4271;1441;5378
230890;201309;4079;15178;3810;14624;525;2402;2677;10127;3202;12529
230900;201309;2996;10266;2652;9530;474;1795;1565;5658;2039;7453
230910;201309;2964;9170;2445;8147;272;1079;1713;5605;1985;6684
230920;201309;4583;13842;4243;13409;348;1175;3462;11099;3810;12274
230930;201309;7644;24011;7017;22844;940;3299;4915;16097;5855;19396
230940;201309;7550;21744;6736;20554;359;1106;5767;17810;6126;18916
230945;201309;6137;18796;5340;17730;671;2367;3809;12871;4480;15238
230950;201309;6821;19241;5946;18069;399;1375;4668;14194;5067;15569
230960;201309;11848;39309;11039;37638;2669;10026;5355;18164;8024;28190
230970;201309;13062;43150;12032;41051;2661;10385;6293;20993;8954;31378
230980;201309;2761;9442;2575;9046;754;2713;1270;4614;2024;7327
230990;201309;1585;5071;1321;4522;173;726;858;2852;1031;3578
231000;201309;2851;7850;2308;6821;251;893;1562;4485;1813;5378
231010;201309;2899;8720;2578;8225;332;1300;1850;5768;2182;7068
231020;201309;7851;26630;7443;25792;1374;5062;4762;16780;6136;21842
231025;201309;7668;24826;6972;23638;958;3380;4886;16953;5844;20333
231030;201309;7827;26586;6711;24193;1336;5088;4008;14634;5344;19722
231040;201309;2946;10155;2697;9610;323;1381;1859;6516;2182;7897
231050;201309;11703;35288;10497;33063;1139;4025;7624;24056;8763;28081
231060;201309;2378;7726;2204;7415;211;966;1656;5401;1867;6367
231070;201309;9049;29427;8545;28480;1482;5341;5554;18643;7036;23984
231080;201309;4214;13558;3892;12948;306;1382;2877;9185;3183;10567
231085;201309;4588;15246;4443;14976;728;2685;3236;10944;3964;13629
231090;201309;4122;11849;3500;10596;236;886;2624;7822;2860;8708
231095;201309;2146;7284;1894;6786;228;889;1329;4801;1557;5690
231100;201309;3049;9659;2550;8640;247;971;1841;6186;2088;7157
231110;201309;3716;12712;3615;12525;418;1564;2645;9234;3063;10798
231120;201309;2425;8079;2258;7780;389;1424;1491;5161;1880;6585
231123;201309;2167;6190;1885;5730;143;468;1503;4583;1646;5051
231126;201309;6636;18849;5525;17301;482;1740;4321;13392;4803;15132
231130;201309;19813;63930;18262;61160;4791;16932;9546;33060;14337;49992
231135;201309;4554;13792;3896;12765;393;1507;2861;9270;3254;10777
231140;201309;15218;50907;14434;49371;1630;7373;10299;33937;11929;41310
231150;201309;5805;17427;4984;15812;1022;3614;2608;8070;3630;11684
231160;201309;5811;20265;5570;19804;1600;5926;3128;11140;4728;17066
231170;201309;4700;15371;4412;14814;531;2179;3061;10126;3592;12305
231180;201309;14380;45531;13367;43533;2737;9795;8126;26070;10863;35865
231190;201309;5000;14191;4194;13011;394;1402;3247;9934;3641;11336
231195;201309;4588;16057;4011;14926;415;1817;3015;11251;3430;13068
231200;201309;7474;26961;6837;25705;812;3655;4927;18390;5739;22045
231210;201309;4933;15804;4299;14872;344;1497;3283;11404;3627;12901
231220;201309;13921;40790;11893;37334;1341;4934;7745;24350;9086;29284
231230;201309;9529;34540;9003;33512;1285;5286;6377;23790;7662;29076
231240;201309;11514;37511;10543;35798;1455;5566;7121;24427;8576;29993
231250;201309;2080;6128;1445;4577;293;971;600;1801;893;2772
231260;201309;4037;11597;3678;11102;498;1597;2552;7863;3050;9460
231270;201309;7489;21981;6906;21075;750;2949;5027;14921;5777;17870
231280;201309;1706;5789;1615;5596;169;622;1198;4180;1367;4802
231290;201309;32430;118228;30029;112165;8113;33291;12719;46592;20832;79883
231300;201309;4473;13499;3750;11982;393;1542;2671;8223;3064;9765
231310;201309;7212;21680;6316;19843;1418;4686;3346;10454;4764;15140
231320;201309;6968;21984;6213;20535;467;1842;4738;15586;5205;17428
231325;201309;2537;7982;2296;7539;212;769;1726;5707;1938;6476
231330;201309;14002;44271;11892;40166;2048;7113;7380;25200;9428;32313
231335;201309;5009;14772;4463;13777;358;1416;3564;10753;3922;12169
231340;201309;17590;58780;16618;57360;1592;5294;13358;47391;14950;52685
231350;201309;12067;41918;11866;41598;1444;4898;9567;34295;11011;39193
231355;201309;4317;14164;4188;13957;230;754;3677;12435;3907;13189
231360;201309;6766;23169;6406;22606;1584;5481;3856;14196;5440;19677
231370;201309;2320;6860;1910;6259;146;576;1447;4668;1593;5244
231375;201309;4016;14112;3833;13751;439;1937;2933;10326;3372;12263
231380;201309;5255;17285;4942;16842;845;3091;3401;11806;4246;14897
231390;201309;3323;10782;3171;10575;255;1037;2583;8590;2838;9627
231395;201309;4170;13726;3759;13068;788;2876;2279;8120;3067;10996
231400;201309;10250;31395;9393;29851;1061;3953;6642;21079;7703;25032
231410;201309;14599;49158;13269;47285;1581;5655;9751;35937;11332;41592
240010;201309;2375;7593;2159;7103;580;2154;955;3016;1535;5170
240020;201309;11682;37360;10496;35084;2913;10518;4771;16231;7684;26749
240030;201309;2724;8211;2626;8057;294;1126;1984;5916;2278;7042
240040;201309;788;2404;678;2184;51;241;491;1494;542;1735
240050;201309;3483;9937;3146;9359;249;929;2388;6946;2637;7875
240060;201309;1419;4300;1352;4187;133;510;1022;3050;1155;3560
240070;201309;2759;8062;2641;7831;418;1331;1746;5103;2164;6434
240080;201309;3002;8225;2779;7891;271;756;2219;6400;2490;7156
240090;201309;2176;6142;1882;5562;80;330;1481;4280;1561;4610
240100;201309;10021;29721;9395;28461;1271;4622;5902;17717;7173;22339
240110;201309;5183;15979;4696;15133;963;3538;2796;8649;3759;12187
240120;201309;2954;9956;2868;9794;619;2273;1771;6180;2390;8453
240130;201309;2736;7708;2373;7133;217;801;1828;5404;2045;6205
240140;201309;2233;7093;2050;6763;477;1773;1069;3468;1546;5241
240145;201309;6133;19398;5562;18359;1582;5813;2831;9289;4413;15102
240150;201309;1012;3141;833;2781;129;533;488;1559;617;2092
240160;201309;1446;4817;1319;4594;161;637;911;3195;1072;3832
240165;201309;880;2919;799;2763;109;407;526;1844;635;2251
240170;201309;2543;7823;2311;7384;611;2092;1139;3695;1750;5787
240180;201309;2925;9384;2753;9095;698;2423;1493;5116;2191;7539
240185;201309;1486;5011;1439;4935;183;659;1062;3673;1245;4332
240190;201309;925;2859;882;2775;115;463;622;1899;737;2362
240200;201309;13705;36689;11719;34201;2361;7033;7323;22170;9684;29203
240210;201309;2689;7814;2500;7564;244;875;2050;6111;2294;6986
240220;201309;7356;23797;7112;23485;367;1512;6374;20891;6741;22403
240230;201309;5318;15589;4981;14977;482;1721;3835;11335;4317;13056
240240;201309;1764;5602;1364;4528;404;1463;315;947;719;2410
240250;201309;2829;8254;2669;8009;211;782;2138;6266;2349;7048
240260;201309;14613;50028;13964;48928;2434;9751;9208;32124;11642;41875
240270;201309;2331;7807;2222;7625;263;916;1642;5751;1905;6667
240280;201309;1608;4671;1442;4364;143;519;1034;3081;1177;3600
240290;201309;1419;4532;1215;4147;121;575;782;2539;903;3114
240300;201309;2024;5670;1675;5050;366;1220;837;2452;1203;3672
240310;201309;10184;29465;9349;28125;2328;7652;4845;14435;7173;22087
240320;201309;2036;6162;1684;5428;131;574;1177;3616;1308;4190
240325;201309;36003;102396;29027;90561;8956;30650;9839;30959;18795;61609
240330;201309;1524;4654;1294;4188;170;679;781;2410;951;3089
240340;201309;1576;4841;1423;4630;287;1014;900;2917;1187;3931
240350;201309;2043;6400;1953;6244;288;1102;1496;4645;1784;5747
240360;201309;7200;22226;6357;20933;1032;3673;4264;14398;5296;18071
240370;201309;1944;5450;1737;5122;136;488;1307;3841;1443;4329
240375;201309;879;2353;792;2233;147;481;458;1235;605;1716
240380;201309;2620;7945;2231;7123;351;1158;1328;4236;1679;5394
240390;201309;888;2601;744;2313;82;314;488;1499;570;1813
240400;201309;1430;3908;1256;3664;136;505;952;2700;1088;3205
240410;201309;531;1725;482;1616;69;279;319;1049;388;1328
240420;201309;4824;18525;4659;18150;1338;5281;2481;10192;3819;15473
240430;201309;3428;10061;3176;9613;380;1315;2265;6768;2645;8083
240440;201309;2626;7258;2468;6955;635;1800;1313;3752;1948;5552
240450;201309;3743;11492;3448;10941;554;2113;2111;6608;2665;8721
240460;201309;2777;9262;2709;9140;303;1216;2093;7004;2396;8220
240470;201309;3786;11610;3207;10449;568;2046;1801;5880;2369;7926
240480;201309;361;963;343;936;39;98;247;697;286;795
240485;201309;2110;6441;1872;5980;342;1215;1102;3510;1444;4725
240490;201309;1648;4291;1464;4037;87;333;1156;3073;1243;3406
240500;201309;2025;6285;1953;6166;183;659;1529;4821;1712;5480
240510;201309;1770;5503;1652;5278;256;884;1162;3722;1418;4606
240520;201309;1422;4221;1258;3983;233;840;836;2586;1069;3426
240530;201309;2157;7029;1958;6711;277;1039;1366;4668;1643;5707
240540;201309;1839;5644;1751;5495;178;633;1312;4062;1490;4695
240550;201309;745;2192;688;2094;50;200;539;1594;589;1794
240560;201309;3185;9458;3047;9244;282;957;2489;7516;2771;8473
240570;201309;3084;8922;2554;7741;595;2037;1126;3124;1721;5161
240580;201309;7988;25233;7583;24558;1347;4641;5405;17433;6752;22074
240590;201309;840;2419;752;2268;56;220;550;1621;606;1841
240600;201309;1467;4487;1216;3955;206;771;673;2077;879;2848
240610;201309;5002;14150;4437;13131;485;1626;3110;9054;3595;10680
240615;201309;1027;2997;879;2722;141;451;527;1637;668;2088
240620;201309;1571;5362;1488;5199;301;1136;1026;3598;1327;4734
240630;201309;2002;6291;1916;6143;171;532;1490;4944;1661;5476
240640;201309;871;2669;761;2493;91;407;509;1588;600;1995
240650;201309;3673;11536;3430;11204;320;1201;2765;8998;3085;10199
240660;201309;2484;8101;2387;7947;286;1018;1795;6060;2081;7078
240670;201309;2730;8270;2360;7515;371;1373;1378;4278;1749;5651
240680;201309;1475;4397;1197;3874;160;532;729;2389;889;2921
240690;201309;1077;3100;950;2889;107;383;681;2057;788;2440
240700;201309;2612;8007;2200;7202;153;682;1687;5353;1840;6035
240710;201309;18341;46622;16317;44104;3019;8307;10221;28465;13240;36772
240720;201309;5459;16162;5226;15796;1322;4407;3004;9024;4326;13431
240725;201309;1070;3235;834;2706;86;286;465;1479;551;1765
240730;201309;2255;7104;2041;6694;208;775;1423;4599;1631;5374
240740;201309;2252;6845;2029;6439;261;903;1351;4273;1612;5176
240750;201309;2188;8247;2023;7940;465;1942;1142;4565;1607;6507
240760;201309;1179;3656;1126;3576;110;313;904;2979;1014;3292
240770;201309;3480;10376;3212;9966;433;1504;2244;6952;2677;8456
240780;201309;5654;16632;4764;15151;937;3172;2635;8584;3572;11756
240790;201309;841;2688;710;2459;58;226;540;1872;598;2098
240800;201309;38793;115253;36090;110414;10583;34673;15627;48436;26210;83109
240810;201309;92517;283797;87540;274435;29273;95554;39324;125406;68597;220960
240820;201309;6751;20437;5892;19054;1034;3739;3389;11259;4423;14998
240830;201309;9219;28624;8767;27964;828;2778;7105;23042;7933;25820
240840;201309;1272;3618;1108;3333;106;391;715;2124;821;2515
240850;201309;1135;3550;891;3039;174;679;466;1501;640;2180
240860;201309;1282;3718;1109;3440;93;339;809;2472;902;2811
240870;201309;1116;3199;975;2926;127;489;661;1859;788;2348
240880;201309;1150;4000;1094;3919;150;671;774;2722;924;3393
240890;201309;5475;15539;4862;14502;807;2731;2831;8362;3638;11093
240895;201309;2758;9510;2533;9112;387;1488;1755;6395;2142;7883
240910;201309;2501;8279;2360;8010;268;1090;1764;5940;2032;7030
240920;201309;846;2778;783;2627;197;746;409;1336;606;2082
240930;201309;3548;9784;3246;9373;311;967;2566;7467;2877;8434
240933;201309;1382;4327;1266;4131;295;1058;671;2235;966;3293
240940;201309;6467;18624;5554;17052;1176;3815;2971;9123;4147;12938
240950;201309;1132;3619;1068;3511;102;430;783;2573;885;3003
240960;201309;767;2478;700;2340;83;332;512;1684;595;2016
240970;201309;2006;5773;1702;5229;162;603;1197;3627;1359;4230
240980;201309;3325;11064;3107;10644;736;2758;1819;6205;2555;8963
240990;201309;3036;9221;2859;8858;596;2085;1777;5355;2373;7440
241000;201309;1052;3029;930;2814;102;380;684;2022;786;2402
241010;201309;2939;9995;2669;9502;448;1828;1748;6100;2196;7928
241020;201309;2062;5944;1727;5301;183;673;1077;3155;1260;3828
241025;201309;1501;4708;1408;4543;137;574;987;3124;1124;3698
241030;201309;2523;8428;2334;8099;168;626;1889;6617;2057;7243
241040;201309;2104;7434;1932;7091;215;926;1443;5287;1658;6213
241050;201309;1275;3885;1166;3691;106;438;879;2683;985;3121
241060;201309;995;2895;912;2756;122;388;683;2075;805;2463
241070;201309;909;2681;785;2446;101;379;544;1639;645;2018
241080;201309;1163;3539;1041;3317;89;367;725;2233;814;2600
241090;201309;2124;6161;1863;5708;130;555;1515;4560;1645;5115
241100;201309;1174;3567;1063;3313;107;387;745;2271;852;2658
241105;201309;1117;3446;1056;3338;168;580;689;2230;857;2810
241110;201309;836;2723;714;2463;119;486;397;1334;516;1820
241120;201309;7997;24275;7311;23176;1478;4807;4836;15701;6314;20508
241140;201309;3264;9549;2958;8941;427;1405;1965;5855;2392;7260
241142;201309;692;2088;495;1649;151;580;134;402;285;982
241150;201309;5629;17331;5233;16656;887;2985;3504;11221;4391;14206
241160;201309;1102;3240;1039;3118;169;566;700;2091;869;2657
241170;201309;1338;3994;1222;3777;161;566;755;2414;916;2980
241180;201309;1015;2779;820;2435;108;368;485;1389;593;1757
241190;201309;1035;2907;943;2752;91;360;644;1760;735;2120
241200;201309;20059;61748;18717;59563;4994;17160;9727;31383;14721;48543
241210;201309;1456;4434;1258;4035;268;954;660;2098;928;3052
241220;201309;7918;27189;7578;26529;1827;6839;4208;15048;6035;21887
241230;201309;2960;9320;2719;8957;242;978;2169;7098;2411;8076
241240;201309;1137;3300;868;2731;87;278;525;1693;612;1971
241250;201309;5492;17780;4921;16654;380;1745;3979;13175;4359;14920
241255;201309;1870;7178;1782;6987;461;1882;875;3587;1336;5469
241260;201309;4736;13259;3894;11905;373;1376;2720;8178;3093;9554
241270;201309;2021;6189;1790;5735;271;1002;1081;3493;1352;4495
241280;201309;2129;6284;1982;5994;393;1233;1226;3776;1619;5009
241290;201309;3230;9089;2642;8158;492;1656;1558;4788;2050;6444
241300;201309;1365;4018;1250;3840;77;276;994;3061;1071;3337
241310;201309;1493;4869;1437;4774;213;707;1047;3577;1260;4284
241320;201309;864;2930;817;2834;164;628;456;1594;620;2222
241330;201309;1505;4844;1423;4731;159;623;1142;3758;1301;4381
241335;201309;2515;7973;2432;7821;216;676;2018;6548;2234;7224
241340;201309;1920;6062;1743;5688;468;1692;843;2676;1311;4368
241350;201309;1916;6189;1804;5962;178;746;1373;4414;1551;5160
241355;201309;1232;3491;1113;3277;79;262;941;2732;1020;2994
241360;201309;2079;5839;1875;5442;150;565;1368;3791;1518;4356
241370;201309;1324;4160;1086;3647;205;782;610;2016;815;2798
241380;201309;717;2104;625;1921;95;356;344;1033;439;1389
241390;201309;2837;9714;2694;9432;696;2500;1542;5580;2238;8080
241400;201309;3744;11325;3560;11056;494;1776;2614;8088;3108;9864
241410;201309;2603;7911;2414;7636;450;1570;1632;5107;2082;6677
241415;201309;1561;4952;1443;4715;151;580;1034;3337;1185;3917
241420;201309;2095;7431;1900;7135;588;2450;882;3328;1470;5778
241430;201309;424;1317;406;1267;55;194;276;820;331;1014
241440;201309;6556;23655;6189;23005;1139;4430;4256;16039;5395;20469
241445;201309;1006;3199;957;3128;166;476;706;2452;872;2928
241450;201309;3194;9189;2978;8872;489;1662;2106;6181;2595;7843
241460;201309;3485;10350;3106;9597;288;1102;2251;6816;2539;7918
241470;201309;1333;3850;1168;3645;136;550;874;2636;1010;3186
241475;201309;1225;3890;1065;3575;73;333;771;2504;844;2837
241480;201309;3204;10553;2941;10150;989;3545;1121;4211;2110;7756
241490;201309;623;1721;509;1543;57;236;348;991;405;1227
241500;201309;755;2407;739;2382;19;73;693;2231;712;2304
250010;201309;2631;8507;2349;8025;253;1073;1690;5627;1943;6700
250020;201309;1665;4884;1307;4215;121;517;909;2838;1030;3355
250030;201309;7651;22469;6937;21457;873;2854;5166;16312;6039;19166
250040;201309;4401;15141;4094;14551;780;2981;2622;9379;3402;12360
250050;201309;3534;11464;3274;11092;552;2077;2206;7511;2758;9588
250053;201309;1249;3887;1202;3823;180;636;834;2639;1014;3275
250057;201309;747;2575;727;2549;68;228;596;2165;664;2393
250060;201309;4737;15434;4582;15176;636;2457;3452;11184;4088;13641
250070;201309;4163;13109;3927;12687;456;1875;3030;9458;3486;11333
250073;201309;768;2355;698;2222;85;314;482;1532;567;1846
250077;201309;2215;6593;1856;5987;285;1005;1050;3417;1335;4422
250080;201309;4695;13872;4531;13632;604;1942;3324;9999;3928;11941
250090;201309;2581;7922;2509;7811;156;618;2113;6426;2269;7044
250100;201309;3901;13434;3739;13137;443;1755;2865;10040;3308;11795
250110;201309;5669;17616;5419;17253;876;3084;3963;12560;4839;15644
250115;201309;555;1849;486;1686;60;276;301;984;361;1260
250120;201309;2208;6598;1915;6042;195;732;1384;4306;1579;5038
250130;201309;5445;17112;5126;16643;342;1240;4241;13889;4583;15129
250135;201309;1066;3288;976;3129;126;427;676;2202;802;2629
250140;201309;2007;6667;1857;6474;248;867;1399;5007;1647;5874
250150;201309;5040;17221;4682;16570;534;2179;3498;12322;4032;14501
250153;201309;1574;4170;1418;3939;131;451;1116;3062;1247;3513
250157;201309;1593;5636;1457;5336;358;1320;802;3050;1160;4370
250160;201309;3269;10341;3133;10124;222;825;2684;8661;2906;9486
250170;201309;1588;4716;1495;4562;330;1068;919;2844;1249;3912
250180;201309;16142;51704;15705;50889;2837;10483;10514;33224;13351;43707
250190;201309;4284;12792;3997;12289;729;2438;2453;7484;3182;9922
250200;201309;2198;6137;1777;5593;139;518;1491;4648;1630;5166
250205;201309;1001;3362;874;3136;90;426;614;2176;704;2602
250210;201309;1619;5394;1498;5211;195;844;1062;3592;1257;4436
250215;201309;1398;4872;1356;4789;202;823;861;3031;1063;3854
250220;201309;813;2313;683;2156;47;167;586;1836;633;2003
250230;201309;1682;4352;1379;3852;192;612;1024;2772;1216;3384
250240;201309;2610;8544;2322;8101;254;938;1729;6119;1983;7057
250250;201309;4389;13669;4064;13210;458;1599;3181;10410;3639;12009
250260;201309;1891;5915;1680;5564;140;534;1279;4237;1419;4771
250270;201309;1240;4034;1154;3929;162;579;867;2974;1029;3553
250280;201309;3769;11421;3480;10956;759;2476;2140;6984;2899;9460
250290;201309;2136;5706;1769;5222;59;222;1553;4573;1612;4795
250300;201309;5414;16154;5120;15774;625;2504;4001;11839;4626;14343
250310;201309;1133;3720;1038;3564;166;673;742;2513;908;3186
250320;201309;7695;24635;7309;23778;1267;4658;4656;14732;5923;19390
250330;201309;2488;7953;2178;7511;261;1058;1644;5578;1905;6636
250340;201309;1130;3346;1091;3297;71;255;896;2726;967;2981
250350;201309;4523;12497;4146;12025;208;698;3591;10534;3799;11232
250355;201309;2115;6534;1929;6242;134;560;1530;4916;1664;5476
250360;201309;2020;6073;1878;5863;124;470;1460;4570;1584;5040
250370;201309;13592;38520;11934;36516;791;2473;10416;32169;11207;34642
250375;201309;1079;3450;1025;3359;69;289;854;2783;923;3072
250380;201309;1622;4663;1550;4574;105;370;1340;3927;1445;4297
250390;201309;1957;5323;1627;4762;215;693;1097;3208;1312;3901
250400;201309;63225;182284;58034;174790;14611;46410;32269;99354;46880;145764
250403;201309;1458;4956;1424;4908;161;644;1142;3897;1303;4541
250407;201309;1077;3244;958;3027;78;257;748;2345;826;2602
250410;201309;654;2145;573;1999;72;312;425;1460;497;1772
250415;201309;1815;5816;1672;5517;104;465;1273;4089;1377;4554
250420;201309;1294;4106;1206;3961;103;423;994;3187;1097;3610
250430;201309;6507;18431;6173;17944;500;1802;5078;14437;5578;16239
250435;201309;1609;4950;1448;4633;185;692;890;2911;1075;3603
250440;201309;4474;13614;4306;13376;282;1038;3676;11383;3958;12421
250450;201309;2059;5892;1845;5604;89;339;1643;4960;1732;5299
250460;201309;6059;18854;5674;18308;829;2864;4153;13550;4982;16414
250470;201309;1570;4382;1428;4178;140;496;1053;3025;1193;3521
250480;201309;3868;11786;3493;11229;171;696;3037;9684;3208;10380
250485;201309;605;1638;509;1465;29;116;402;1105;431;1221
250490;201309;4090;13460;3981;13288;650;2370;2859;9554;3509;11924
250500;201309;1901;5899;1760;5658;353;1185;1070;3493;1423;4678
250510;201309;4923;13927;4340;13112;329;1218;3559;10628;3888;11846
250520;201309;1844;5812;1749;5644;363;1384;1027;3209;1390;4593
250523;201309;1772;5718;1691;5610;218;782;1311;4399;1529;5181
250527;201309;1440;4448;1351;4323;65;292;1199;3775;1264;4067
250530;201309;671;2101;595;2001;54;213;483;1620;537;1833
250535;201309;1243;4076;1199;3988;99;407;960;3120;1059;3527
250540;201309;2455;7263;2300;7086;93;320;2102;6490;2195;6810
250550;201309;909;3052;840;2941;76;331;630;2159;706;2490
250560;201309;1716;5638;1678;5580;135;498;1424;4750;1559;5248
250570;201309;2510;8370;2290;7949;214;874;1727;5920;1941;6794
250580;201309;1103;3183;916;2863;136;541;605;1803;741;2344
250590;201309;1036;3211;933;3066;85;364;730;2343;815;2707
250600;201309;7657;22715;7277;22119;960;2969;5442;16818;6402;19787
250610;201309;3260;10074;3075;9790;403;1384;2242;7182;2645;8566
250620;201309;863;2548;796;2414;139;460;526;1584;665;2044
250625;201309;2050;6913;2014;6860;74;232;1856;6388;1930;6620
250630;201309;10138;33245;9643;32336;2284;8290;5335;17846;7619;26136
250640;201309;3866;11452;3614;11150;274;1075;3082;9348;3356;10423
250650;201309;889;2693;840;2597;167;618;441;1398;608;2016
250660;201309;2191;5284;1682;4668;26;71;1608;4472;1634;4543
250670;201309;2609;9082;2494;8860;293;1224;1787;6336;2080;7560
250680;201309;4883;14249;4620;13862;295;1081;3919;11678;4214;12759
250690;201309;6194;17193;6006;16930;616;2023;5022;13917;5638;15940
250700;201309;5276;16149;4973;15681;731;2592;3542;11007;4273;13599
250710;201309;4460;14564;4121;14122;621;2247;2936;10285;3557;12532
250720;201309;2596;8098;2476;7884;212;839;1960;6166;2172;7005
250730;201309;3544;11370;3397;11126;476;1768;2480;8079;2956;9847
250740;201309;2018;6116;1771;5667;251;895;1204;3805;1455;4700
250750;201309;100255;302387;95287;294567;19126;65290;61261;186730;80387;252020
250760;201309;2153;6645;2006;6396;258;1006;1395;4383;1653;5389
250770;201309;3737;13206;3550;12940;761;2902;2178;8069;2939;10971
250780;201309;1875;5749;1642;5312;179;723;1137;3595;1316;4318
250790;201309;2441;8072;2311;7878;621;2103;1416;4956;2037;7059
250800;201309;2668;7895;2367;7387;180;670;1774;5400;1954;6070
250810;201309;1337;4034;1170;3788;122;503;938;2961;1060;3464
250820;201309;1985;6253;1930;6163;114;436;1611;5192;1725;5628
250830;201309;5816;19515;5548;18989;741;3041;3780;12646;4521;15687
250840;201309;1035;3346;923;3109;122;468;587;1973;709;2441
250850;201309;2358;7005;2062;6514;240;934;1354;4407;1594;5341
250855;201309;1053;3152;997;3061;70;247;829;2511;899;2758
250860;201309;2870;9892;2661;9472;650;2540;1176;4191;1826;6731
250870;201309;1182;3442;1028;3191;81;313;743;2236;824;2549
250880;201309;1296;3935;1262;3884;123;410;1009;3087;1132;3497
250890;201309;9071;30066;8447;29182;1632;6510;5347;18261;6979;24771
250900;201309;3019;10220;2698;9602;325;1223;1901;6876;2226;8099
250905;201309;2100;6585;2008;6461;338;1150;1459;4708;1797;5858
250910;201309;5286;15702;4944;15169;556;1854;3701;11375;4257;13229
250915;201309;1722;5167;1584;4966;158;480;1297;4148;1455;4628
250920;201309;3556;10211;3355;9924;456;1353;2416;7361;2872;8714
250930;201309;1916;6334;1844;6210;372;1447;1224;4031;1596;5478
250933;201309;1149;3818;1110;3755;171;628;754;2579;925;3207
250937;201309;865;2705;776;2520;118;475;467;1495;585;1970
250939;201309;1706;5419;1551;5150;264;935;986;3301;1250;4236
250940;201309;3930;11698;3642;11242;287;1033;2845;8748;3132;9781
250950;201309;1323;4232;1233;4115;79;283;1021;3443;1100;3726
250960;201309;1347;4248;1196;4049;73;283;1016;3466;1089;3749
250970;201309;8632;24156;7863;23137;1207;3699;5554;16474;6761;20173
250980;201309;2654;8176;2450;7819;277;1125;1687;5174;1964;6299
250990;201309;2062;7326;1952;7103;301;1272;1317;4696;1618;5968
251000;201309;2549;7348;2103;6707;136;521;1688;5358;1824;5879
251010;201309;2818;8248;2570;7902;223;809;2031;6254;2254;7063
251020;201309;1649;5220;1536;5078;165;601;1248;4163;1413;4764
251030;201309;1311;3743;1194;3547;131;468;771;2279;902;2747
251040;201309;1941;6288;1752;5989;192;903;1249;4090;1441;4993
251050;201309;1124;3377;986;3123;164;563;544;1791;708;2354
251060;201309;1018;2575;838;2348;96;353;634;1683;730;2036
251065;201309;572;1738;503;1630;73;275;306;950;379;1225
251070;201309;589;1727;563;1686;51;213;442;1244;493;1457
251080;201309;21163;59560;19981;57636;5323;16355;11175;32598;16498;48953
251090;201309;3018;9656;2733;9134;327;1257;1942;6418;2269;7675
251100;201309;970;3238;859;3034;133;532;557;1915;690;2447
251110;201309;2095;6138;1901;5832;227;775;1327;4074;1554;4849
251120;201309;5866;20244;5707;19971;824;3413;4417;15118;5241;18531
251130;201309;3882;10203;3506;9775;82;279;3334;9254;3416;9533
251140;201309;4333;13591;4050;13138;276;1121;3162;10198;3438;11319
251150;201309;2818;9256;2604;8964;337;1351;1932;6699;2269;8050
251160;201309;1844;6172;1774;6079;103;412;1554;5329;1657;5741
251170;201309;1424;4474;1384;4427;127;484;1146;3610;1273;4094
251180;201309;2895;8785;2670;8499;640;2152;1571;5094;2211;7246
251190;201309;4224;12440;4105;12289;303;980;3584;10757;3887;11737
251200;201309;4181;12950;3984;12687;260;954;3434;10949;3694;11903
251203;201309;1316;4219;1196;3970;121;511;732;2499;853;3010
251207;201309;1225;3906;1059;3576;92;393;746;2468;838;2861
251210;201309;7913;23059;7032;21834;1110;3459;4972;15784;6082;19243
251220;201309;1278;3529;1150;3330;178;563;727;2158;905;2721
251230;201309;5137;15834;4538;15122;474;1775;3786;12545;4260;14320
251240;201309;3103;10359;3026;10231;325;1341;2375;7897;2700;9238
251250;201309;10187;31486;9572;30493;1703;5850;6546;20771;8249;26621
251260;201309;541;1694;487;1619;40;148;370;1237;410;1385
251270;201309;4110;12830;3882;12527;157;624;3537;11390;3694;12014
251272;201309;1367;4248;1278;4114;119;404;1011;3309;1130;3713
251274;201309;976;3148;925;3045;131;544;521;1753;652;2297
251275;201309;1356;3915;1281;3795;149;553;963;2764;1112;3317
251276;201309;1482;4478;1401;4323;234;777;835;2672;1069;3449
251278;201309;602;1956;533;1792;95;358;294;1034;389;1392
251280;201309;2272;7369;2198;7235;320;1178;1593;5244;1913;6422
251290;201309;5989;17459;5692;17076;877;3102;4075;11888;4952;14990
251300;201309;774;2674;720;2592;73;346;512;1786;585;2132
251310;201309;3151;9483;2899;9108;227;876;2339;7248;2566;8124
251315;201309;1627;5953;1588;5869;322;1272;974;3644;1296;4916
251320;201309;2110;6029;1762;5456;144;537;1284;4017;1428;4554
251330;201309;2037;5338;1696;4895;132;557;1399;3849;1531;4406
251335;201309;965;3386;935;3328;118;458;715;2536;833;2994
251340;201309;3889;10944;3322;10097;360;1388;2361;6987;2721;8375
251350;201309;1624;5076;1472;4853;261;960;955;3160;1216;4120
251360;201309;1814;6007;1750;5931;124;496;1480;5033;1604;5529
251365;201309;902;2681;728;2309;70;276;480;1483;550;1759
251370;201309;21401;74697;21041;74062;4387;16949;14151;49197;18538;66146
251380;201309;1339;4209;1189;3953;111;489;904;2906;1015;3395
251385;201309;861;2449;788;2323;81;303;537;1532;618;1835
251390;201309;5706;20583;5419;20137;1033;4168;3648;13487;4681;17655
251392;201309;1044;3120;971;2997;124;413;673;2103;797;2516
251394;201309;609;1909;514;1719;43;172;362;1202;405;1374
251396;201309;861;2506;800;2403;66;226;635;1878;701;2104
251398;201309;1125;3298;937;2944;93;359;633;1955;726;2314
251400;201309;1353;3966;1254;3835;169;655;881;2617;1050;3272
251410;201309;1603;4275;1456;4030;176;551;990;2786;1166;3337
251420;201309;2185;6371;1871;6012;190;729;1411;4471;1601;5200
251430;201309;1691;6150;1540;5907;122;544;1265;4861;1387;5405
251440;201309;1459;4511;1264;4144;174;658;893;2898;1067;3556
251445;201309;1530;4877;1459;4768;133;527;1201;3870;1334;4397
251450;201309;4775;15112;4291;14498;170;705;3768;12749;3938;13454
251455;201309;1208;3785;1045;3517;95;400;766;2537;861;2937
251460;201309;879;2797;851;2739;157;524;622;2027;779;2551
251465;201309;499;1602;456;1516;53;217;295;952;348;1169
251470;201309;1294;3765;1072;3356;145;558;627;1959;772;2517
251480;201309;1126;3114;1022;2940;64;244;821;2314;885;2558
251490;201309;2077;6218;1816;5862;318;1197;1161;3676;1479;4873
251500;201309;1713;5814;1665;5737;226;891;1238;4219;1464;5110
251510;201309;2516;8602;2365;8268;460;1765;1427;5020;1887;6785
251520;201309;1079;3020;985;2870;133;400;573;1687;706;2087
251530;201309;11609;34978;11162;34318;918;3550;9323;28140;10241;31690
251540;201309;2799;9400;2631;9030;311;1316;1891;6432;2202;7748
251550;201309;3941;9988;3352;9232;206;729;2770;7441;2976;8170
251560;201309;914;2761;833;2632;174;663;446;1304;620;1967
251570;201309;1029;3109;900;2856;114;433;553;1784;667;2217
251580;201309;2183;6076;2026;5863;295;815;1544;4556;1839;5371
251590;201309;1689;5637;1656;5599;110;392;1450;4959;1560;5351
251593;201309;996;3224;950;3146;140;535;628;2021;768;2556
251597;201309;1958;6122;1890;6014;219;808;1472;4617;1691;5425
251600;201309;7163;21655;6848;21139;1005;3181;4909;15560;5914;18741
251610;201309;3560;10900;3272;10512;382;1326;2451;7967;2833;9293
251615;201309;1206;3570;1061;3318;84;252;787;2594;871;2846
251620;201309;16986;49329;15174;46981;2446;8002;10682;33511;13128;41513
251630;201309;5337;13688;4693;12911;401;1192;3749;10395;4150;11587
251640;201309;2650;7843;2172;6977;279;1045;1464;4667;1743;5712
251650;201309;4349;12482;3924;11940;340;1186;3187;9806;3527;10992
251660;201309;3546;12024;3261;11579;276;1305;2632;9118;2908;10423
251670;201309;3916;11507;3522;10918;229;811;2931;9023;3160;9834
251675;201309;745;2558;713;2503;146;580;433;1494;579;2074
251680;201309;2858;8029;2333;7244;148;633;1899;5765;2047;6398
251690;201309;3355;10740;3130;10328;437;1589;2121;6974;2558;8563
251700;201309;2057;6938;1963;6808;241;932;1528;5267;1769;6199
251710;201309;931;2487;708;2089;98;370;382;1048;480;1418
251720;201309;1346;4240;1270;4123;120;474;987;3183;1107;3657
251740;201309;739;2084;601;1836;115;391;333;1027;448;1418
260005;201309;24411;61042;21889;57751;4653;12652;13773;36618;18426;49270
260010;201309;9455;26177;7740;24046;741;2546;6121;18991;6862;21537
260020;201309;5738;17273;5137;16340;670;2065;3698;12283;4368;14348
260030;201309;5344;16256;4971;15716;557;1938;3820;12025;4377;13963
260040;201309;10183;24650;8457;22688;625;1483;6982;19356;7607;20839
260050;201309;10672;35302;10056;34603;682;2549;8784;30490;9466;33039
260060;201309;4041;11404;3779;11009;319;987;3081;9095;3400;10082
260070;201309;9228;28562;8830;27986;2328;7922;5197;16550;7525;24472
260080;201309;5308;15682;4761;14862;593;2125;3336;10305;3929;12430
260090;201309;5160;14173;4907;13831;878;2273;3566;10467;4444;12740
260100;201309;3465;9368;3189;8996;250;925;2559;7221;2809;8146
260105;201309;4329;13345;4196;13101;828;2720;2745;8571;3573;11291
260110;201309;21153;64318;19755;62622;1642;5185;16724;53702;18366;58887
260120;201309;11303;35600;10976;35015;3195;10508;5557;18433;8752;28941
260130;201309;3079;8932;2933;8693;423;1245;2117;6407;2540;7652
260140;201309;12943;34419;11167;32209;1309;4272;8393;24443;9702;28715
260150;201309;2996;9059;2697;8605;276;982;2034;6595;2310;7577
260160;201309;5917;18079;5386;17445;493;1716;4409;14541;4902;16257
260170;201309;17223;48592;16575;47710;1460;3971;13722;40231;15182;44202
260180;201309;3383;10676;3108;10253;204;834;2600;8515;2804;9349
260190;201309;15668;38269;14939;37331;1108;3029;12701;31650;13809;34679
260200;201309;10950;32772;9734;30936;1314;4219;6994;22901;8308;27120
260210;201309;11251;35765;10464;34611;824;3075;8636;28881;9460;31956
260220;201309;8931;28746;8736;28456;778;3170;7391;23630;8169;26800
260230;201309;9605;28963;9249;28477;701;2286;7664;23971;8365;26257
260240;201309;2813;9155;2541;8742;388;1450;1747;6031;2135;7481
260250;201309;2750;7471;2535;7203;182;497;2145;6185;2327;6682
260260;201309;11251;33582;11064;33346;942;3153;9257;28443;10199;31596
260270;201309;3493;10808;3303;10524;413;1566;2566;8034;2979;9600
260280;201309;12319;42082;11412;40634;826;3362;9464;34000;10290;37362
260290;201309;33132;102136;32153;100559;5908;21102;22045;67362;27953;88464
260300;201309;8403;25943;7565;24744;770;2916;5827;19169;6597;22085
260310;201309;5078;15518;4772;15029;1479;4400;2403;8149;3882;12549
260320;201309;6624;22862;6213;22261;573;2209;4970;18024;5543;20233
260330;201309;3093;9755;2835;9309;289;1129;1907;6480;2196;7609
260340;201309;1838;5573;1761;5467;111;417;1543;4751;1654;5168
260345;201309;25456;85520;24554;83689;7729;28699;11312;37244;19041;65943
260350;201309;4328;12934;4149;12654;548;1873;2980;9074;3528;10947
260360;201309;2326;7460;2241;7319;594;2044;1193;4029;1787;6073
260370;201309;5986;18828;5536;18028;837;2799;3878;12932;4715;15731
260380;201309;4873;16319;4563;15919;437;1439;3750;13389;4187;14828
260390;201309;4724;15011;4128;14070;499;1956;2994;10034;3493;11990
260392;201309;3299;10801;3138;10576;193;763;2733;9191;2926;9954
260400;201309;13407;40494;12966;39777;2655;9073;8591;25862;11246;34935
260410;201309;61444;184407;58598;179635;19618;60703;27746;88149;47364;148852
260415;201309;4016;13324;3590;12532;588;2399;2227;7742;2815;10141
260420;201309;11556;27359;10611;26354;827;2351;8794;21769;9621;24120
260430;201309;2695;9143;2477;8792;262;1075;1879;6597;2141;7672
260440;201309;3392;10631;3175;10205;558;2020;1944;6161;2502;8181
260450;201309;4902;15505;4661;15088;485;1730;3577;11627;4062;13357
260460;201309;5890;18393;5614;17983;891;3257;3880;12236;4771;15493
260470;201309;4960;14770;4685;14385;489;1642;3662;11431;4151;13073
260480;201309;3806;11310;3469;10801;681;2286;2297;7107;2978;9393
260490;201309;6038;16040;5337;14938;738;2452;3532;9868;4270;12320
260500;201309;6654;18685;6221;18058;645;1985;4727;13977;5372;15962
260510;201309;10103;27555;9388;26559;922;2843;7233;21056;8155;23899
260515;201309;4733;15125;3912;13444;554;2114;2300;8056;2854;10170
260520;201309;15554;42730;15191;42253;3149;8238;10497;30319;13646;38557
260530;201309;10183;30583;9025;29041;527;1606;7853;25764;8380;27370
260540;201309;5710;15019;5456;14736;694;1624;4312;12042;5006;13666
260545;201309;42;162;28;115;4;19;6;23;10;42
260550;201309;2772;9522;2501;9013;694;2787;1173;4175;1867;6962
260560;201309;6690;17512;6074;16642;365;998;5306;14586;5671;15584
260570;201309;6179;21973;5814;21298;1075;4358;3911;14365;4986;18723
260580;201309;3891;10912;3714;10651;331;1081;3086;8705;3417;9786
260590;201309;6008;15937;5804;15686;386;1000;5089;14013;5475;15013
260600;201309;25119;80062;23929;77983;4963;17170;14715;48674;19678;65844
260610;201309;7039;21219;6729;20796;1322;4293;4661;14508;5983;18801
260620;201309;16972;53710;16400;52744;3127;11378;10883;34105;14010;45483
260630;201309;2265;6931;1981;6472;251;973;1444;4677;1695;5650
260640;201309;17141;47750;16369;46624;2230;6880;12176;34584;14406;41464
260650;201309;5519;17749;5288;17368;806;2655;3496;12227;4302;14882
260660;201309;8034;23405;7282;22402;716;2319;5834;18180;6550;20499
260670;201309;2384;6909;2033;6421;297;1068;1340;4248;1637;5316
260680;201309;22876;62951;21735;61094;4875;14674;12669;35255;17544;49929
260690;201309;3482;9827;3041;9117;241;885;2399;7110;2640;7995
260700;201309;5301;16121;5244;16061;101;233;5045;15647;5146;15880
260710;201309;1292;4047;1172;3868;150;591;867;2799;1017;3390
260720;201309;17266;57389;16433;55828;4701;16429;8694;30272;13395;46701
260730;201309;7322;24339;6606;23282;894;3280;4890;17497;5784;20777
260740;201309;1356;4173;1187;3862;179;635;724;2392;903;3027
260750;201309;6711;22160;6458;21790;575;1961;5373;18452;5948;20413
260760;201309;4638;13212;4362;12839;550;1726;3237;9589;3787;11315
260765;201309;7697;28395;7449;28008;1598;6611;4749;17975;6347;24586
260770;201309;4243;11187;3892;10714;247;895;3136;8438;3383;9333
260775;201309;5262;15563;5026;15186;608;2195;3662;10760;4270;12955
260780;201309;3941;13247;3805;13006;901;3345;2234;7667;3135;11012
260790;201309;117359;308235;113255;302293;26812;75362;68660;183510;95472;258872
260795;201309;3003;9855;2843;9607;485;1757;1904;6549;2389;8306
260800;201309;4639;12876;4334;12457;253;1022;3713;10373;3966;11395
260805;201309;4054;12101;3699;11541;596;1961;2491;7835;3087;9796
260810;201309;7388;21488;7186;21210;482;1724;6253;18276;6735;20000
260820;201309;4519;13468;4305;13165;1314;4085;2309;7189;3623;11274
260825;201309;3021;9876;2869;9651;295;1004;2334;7951;2629;8955
260830;201309;3598;11963;3374;11574;918;2997;1922;6963;2840;9960
260840;201309;4100;12289;3852;11917;246;939;3342;10273;3588;11212
260845;201309;4139;12535;3856;11968;672;2238;2607;8099;3279;10337
260850;201309;4812;17026;4438;16220;1177;4826;2165;7785;3342;12611
260860;201309;2946;9887;2757;9586;358;1270;2023;7165;2381;8435
260870;201309;4161;11741;3797;11277;594;1654;2719;8329;3313;9983
260875;201309;7281;19622;6677;18692;922;2608;4599;13299;5521;15907
260880;201309;8600;27905;8207;27326;1096;3668;6306;21344;7402;25012
260890;201309;14757;42733;14177;41860;1641;5552;10664;31417;12305;36969
260900;201309;6014;18921;5239;17613;1066;3734;3135;10770;4201;14504
260910;201309;2968;9362;2695;8957;302;1166;2089;6883;2391;8049
260915;201309;4459;15036;4348;14881;114;351;4053;14104;4167;14455
260920;201309;3318;10506;3169;10281;549;1935;2204;7282;2753;9217
260930;201309;4116;13358;3701;12753;551;1927;2646;9288;3197;11215
260940;201309;13583;39746;12533;37885;2531;9036;7017;20607;9548;29643
260950;201309;6203;20361;5975;19922;1043;4338;3866;12077;4909;16415
260960;201309;66687;189009;63335;183636;13900;42964;37230;108806;51130;151770
260970;201309;5274;17414;4935;16870;684;2737;3518;11900;4202;14637
260980;201309;3952;12744;3788;12523;267;1006;3164;10617;3431;11623
260990;201309;17152;55686;15867;53879;2333;7484;11472;41024;13805;48508
261000;201309;14721;43419;12447;39590;2867;9839;6746;21761;9613;31600
261010;201309;2779;7868;2606;7633;249;569;2168;6672;2417;7241
261020;201309;6246;18912;5763;18157;459;1802;4655;14277;5114;16079
261030;201309;3342;11252;3213;11034;346;1303;2551;8701;2897;10004
261040;201309;5269;17456;4593;16396;637;2584;3245;11539;3882;14123
261050;201309;8711;24848;8167;23998;1292;3969;5384;15757;6676;19726
261060;201309;11033;35095;10694;34545;2028;7183;7335;23374;9363;30557
261070;201309;47522;126497;43682;121160;10441;30483;24970;70082;35411;100565
261080;201309;5606;17498;5344;17065;448;1421;4435;14404;4883;15825
261090;201309;15910;45478;14986;44205;1634;5046;11933;35416;13567;40462
261100;201309;7253;23670;6812;22995;597;2431;5439;18259;6036;20690
261110;201309;65677;190658;60343;182929;14779;45766;34320;109780;49099;155546
261120;201309;3510;9723;3259;9397;159;473;2880;8394;3039;8867
261130;201309;6912;18148;6648;17856;284;789;6065;16287;6349;17076
261140;201309;3186;9178;2989;8868;657;2167;1811;5298;2468;7465
261150;201309;5382;16648;4892;15967;557;2103;3739;12243;4296;14346
261153;201309;1947;5665;1669;5280;115;436;1399;4446;1514;4882
261160;201309;222029;587423;213113;575437;43892;121176;135776;376216;179668;497392
261170;201309;5879;16818;5518;16279;824;2528;4133;12247;4957;14775
261180;201309;9135;26399;8947;26156;1075;3124;7127;21169;8202;24293
261190;201309;5290;17038;5057;16721;812;3555;3499;10890;4311;14445
261200;201309;3772;9782;3608;9564;543;1423;2637;7115;3180;8538
261210;201309;1896;5204;1819;5097;151;421;1553;4413;1704;4834
261220;201309;12267;41186;10945;38230;2226;8528;5988;20758;8214;29286
261230;201309;4320;13187;4025;12832;205;648;3574;11541;3779;12189
261240;201309;4810;14501;4572;14056;814;2469;3153;9878;3967;12347
261245;201309;3813;12300;3328;11485;300;1278;2434;8472;2734;9750
261247;201309;3471;11033;3062;10274;452;1607;2075;7035;2527;8642
261250;201309;18904;51569;18383;50839;2816;8037;14358;39802;17174;47839
261255;201309;4291;13501;3879;12827;391;1451;2957;9924;3348;11375
261260;201309;11944;35184;11049;34136;648;1857;9774;30698;10422;32555
261270;201309;3791;11039;3555;10665;512;1679;2490;7460;3002;9139
261280;201309;2709;8538;2466;8170;279;1072;1828;6017;2107;7089
261290;201309;2959;8585;2667;8207;251;878;2147;6669;2398;7547
261300;201309;10069;34934;9218;33393;1606;6436;6112;22189;7718;28625
261310;201309;8296;25687;7946;25080;1884;6280;4749;14989;6633;21269
261320;201309;5889;18654;5573;18056;725;2342;4081;13543;4806;15885
261330;201309;5472;16566;5339;16372;430;1462;4438;13623;4868;15085
261340;201309;4541;15050;4342;14733;712;2761;2882;9808;3594;12569
261350;201309;7837;27117;7455;26422;694;3010;5862;20535;6556;23545
261360;201309;9274;24507;8570;23548;1251;3620;5942;16644;7193;20264
261370;201309;20435;62235;19493;60847;3302;11017;13743;43109;17045;54126
261380;201309;4124;14443;3868;14020;641;2355;2648;9906;3289;12261
261390;201309;16788;52873;15460;50520;2818;10214;9589;31036;12407;41250
261400;201309;4807;17157;4419;16400;658;2740;3006;11234;3664;13974
261410;201309;7993;24435;7670;23923;1040;3339;5643;17981;6683;21320
261420;201309;7816;26679;7573;26311;1990;7576;4336;15278;6326;22854
261430;201309;3548;11161;3041;10485;427;1519;2195;7749;2622;9268
261440;201309;1643;5027;1538;4863;124;501;1246;3888;1370;4389
261450;201309;13973;41159;13595;40644;1110;3536;11803;35289;12913;38825
261460;201309;8409;24508;7881;23769;802;2317;5861;19025;6663;21342
261470;201309;3905;10662;3595;10286;253;826;3057;8713;3310;9539
261480;201309;3360;12556;3167;12208;389;1720;2392;9047;2781;10767
261485;201309;4840;15395;4578;14952;1089;3788;2579;8537;3668;12325
261500;201309;5830;16400;5238;15606;759;2093;3916;12196;4675;14289
261510;201309;2023;6760;1939;6632;130;387;1666;5843;1796;6230
261520;201309;2538;8422;2294;8039;232;947;1655;5781;1887;6728
261530;201309;12387;40749;11098;38243;2537;9712;5421;18603;7958;28315
261540;201309;7210;23346;7013;23014;1881;5880;4389;15062;6270;20942
261550;201309;3371;10508;3262;10338;492;1949;2448;7435;2940;9384
261560;201309;6653;22002;6179;21399;1308;4333;4249;15330;5557;19663
261570;201309;3588;11398;3303;10934;496;1702;2307;7779;2803;9481
261580;201309;5654;18608;5078;17656;455;1776;4043;14307;4498;16083
261590;201309;2805;8023;2480;7564;259;852;1822;5658;2081;6510
261600;201309;5000;14315;4308;13294;545;1771;3139;9820;3684;11591
261610;201309;2262;7011;2001;6646;187;757;1615;5242;1802;5999
261618;201309;2492;7305;2362;7126;289;936;1819;5458;2108;6394
261620;201309;4503;14066;4282;13715;487;1685;3120;10185;3607;11870
261630;201309;8076;24033;7216;22541;1461;5251;4069;12404;5530;17655
261640;201309;32533;85802;30404;83247;2099;6022;25810;71730;27909;77752
261650;201309;3698;12307;3552;12084;477;1820;2740;9320;3217;11140
270010;201309;4414;17128;4071;16406;526;2486;2860;11493;3386;13979
270020;201309;3859;12069;3634;11692;558;2085;2598;8207;3156;10292
270030;201309;44411;135200;42685;132589;11781;37480;24221;77209;36002;114689
270040;201309;10329;32178;9991;31803;1332;3716;8005;26403;9337;30119
270050;201309;3865;11498;3603;11129;425;1603;2707;8178;3132;9781
270060;201309;1540;5351;1485;5268;382;1491;864;3039;1246;4530
270070;201309;4049;12835;3824;12512;149;687;3390;10984;3539;11671
270080;201309;1267;4094;1153;3935;252;965;695;2350;947;3315
270090;201309;2034;6539;1986;6480;65;250;1862;6067;1927;6317
270100;201309;6347;20219;6099;19879;1279;4488;4108;13331;5387;17819
270110;201309;3396;9645;3136;9337;596;1863;1971;6270;2567;8133
270120;201309;3037;8969;2746;8573;165;616;2323;7276;2488;7892
270130;201309;4904;15540;4675;15271;719;2334;3503;11779;4222;14113
270135;201309;1690;4988;1614;4898;76;182;1473;4567;1549;4749
270140;201309;9141;24517;8246;23323;951;3782;6357;16874;7308;20656
270150;201309;2572;9071;2509;8982;250;1041;2090;7421;2340;8462
270160;201309;4750;16633;4411;16171;339;1177;3734;13930;4073;15107
270170;201309;3976;13393;3677;12933;834;3328;2078;7263;2912;10591
270180;201309;2134;7343;1922;7072;196;867;1485;5444;1681;6311
270190;201309;1867;6316;1784;6171;169;659;1384;4830;1553;5489
270200;201309;2703;9170;2556;8937;244;1105;2050;6987;2294;8092
270210;201309;4103;14214;4006;14076;489;1999;3231;11278;3720;13277
270220;201309;1686;5374;1585;5169;307;1177;868;2876;1175;4053
270230;201309;10924;36685;9757;34853;1502;6216;6807;24113;8309;30329
270235;201309;6382;21562;6095;21083;365;1653;5204;17884;5569;19537
270240;201309;9653;29406;8683;28099;1618;5524;5752;18742;7370;24266
270250;201309;3411;9022;3140;8723;157;447;2855;7944;3012;8391
270255;201309;5058;15764;4250;14352;450;1927;2985;9888;3435;11815
270260;201309;6198;20189;6034;19895;922;3572;4327;14245;5249;17817
270270;201309;1218;3594;1138;3468;196;658;786;2350;982;3008
270280;201309;3634;11096;3460;10841;558;2028;2483;7693;3041;9721
270290;201309;8300;29745;7949;29119;843;3441;6253;22939;7096;26380
270300;201309;3275;11356;3114;11163;195;873;2748;9814;2943;10687
270310;201309;7069;22518;6432;21421;460;2069;5148;16728;5608;18797
270320;201309;6180;20697;5974;20318;1713;6511;2884;9947;4597;16458
270330;201309;4763;16000;4526;15674;389;1443;3754;13127;4143;14570
270340;201309;1769;5594;1616;5404;223;790;1198;4084;1421;4874
270350;201309;2074;5911;1926;5716;362;1118;1201;3802;1563;4920
270360;201309;2057;6457;2019;6411;277;841;1602;5249;1879;6090
270370;201309;1692;5671;1559;5432;199;783;1071;3841;1270;4624
270375;201309;2886;9175;2759;8976;464;1861;1906;5922;2370;7783
270380;201309;6121;18684;5873;18351;610;2003;4587;14628;5197;16631
270390;201309;1439;4014;1311;3858;192;673;889;2513;1081;3186
270400;201309;6075;18917;5627;18256;584;2203;4142;13286;4726;15489
270410;201309;4773;15027;4579;14655;590;2064;3362;10740;3952;12804
270420;201309;5299;17689;5156;17478;306;1446;4407;14665;4713;16111
270430;201309;139674;410750;134651;403718;35524;109148;78266;240804;113790;349952
270440;201309;4897;15519;4641;15117;393;1467;3739;12237;4132;13704
270450;201309;6281;20188;6140;20006;675;2573;4861;15808;5536;18381
270460;201309;3475;9870;3159;9421;259;1033;2536;7329;2795;8362
270470;201309;10690;35057;10275;34311;1369;4394;7611;26404;8980;30798
270480;201309;3078;9959;2878;9604;374;1531;1948;6282;2322;7813
270490;201309;982;3165;927;3079;99;406;691;2239;790;2645
270500;201309;5380;18846;5206;18589;496;1796;4242;15546;4738;17342
270510;201309;5964;18850;5499;18199;974;4105;3910;12280;4884;16385
270520;201309;3609;12021;3415;11688;1013;3675;1706;5958;2719;9633
270530;201309;1533;4621;1359;4392;229;714;916;3097;1145;3811
270540;201309;1984;7068;1833;6830;187;909;1433;5221;1620;6130
270550;201309;6957;21620;6231;20623;1129;3905;4104;13985;5233;17890
270560;201309;2942;9560;2843;9427;604;2278;1866;6057;2470;8335
270570;201309;4241;13953;3910;13419;496;2058;2664;9069;3160;11127
270580;201309;1946;6663;1872;6530;334;1227;1307;4632;1641;5859
270590;201309;1303;4625;1227;4486;109;504;1006;3638;1115;4142
270600;201309;2816;9635;2581;9288;228;1135;2012;7023;2240;8158
270610;201309;3181;10223;2990;9937;357;1289;2309;7651;2666;8940
270620;201309;1442;4954;1308;4752;156;735;983;3470;1139;4205
270630;201309;17948;50767;17159;49627;2374;6846;13097;38448;15471;45294
270640;201309;5784;18156;5298;17571;450;1908;4351;14137;4801;16045
270642;201309;2459;8506;2312;8279;399;1615;1529;5479;1928;7094
270644;201309;2355;7237;2213;7077;364;1090;1691;5586;2055;6676
270650;201309;3865;12755;3737;12567;909;3556;2156;7115;3065;10671
270660;201309;2506;6642;2030;5904;179;646;1416;4028;1595;4674
270670;201309;14184;41082;12745;39234;1708;5819;9453;29392;11161;35211
270680;201309;4132;12838;4015;12699;255;745;3581;11468;3836;12213
270690;201309;8497;24643;7998;24014;2481;7246;4063;13199;6544;20445
270700;201309;795;2550;758;2492;134;550;473;1494;607;2044
270710;201309;5313;18481;5124;18228;551;1943;4177;15119;4728;17062
270720;201309;3278;11442;3056;11054;295;1364;2437;8661;2732;10025
270730;201309;6490;20611;6193;20219;1234;4252;4256;13971;5490;18223
270740;201309;2373;7173;2235;6950;378;1335;1468;4526;1846;5861
270750;201309;4641;15165;4363;14744;558;2035;3302;11181;3860;13216
270760;201309;3309;10349;3114;10058;430;1471;2288;7424;2718;8895
270770;201309;17310;47708;14980;44855;2844;9182;9663;29368;12507;38550
270780;201309;1910;6205;1780;5998;265;959;1247;4237;1512;5196
270790;201309;1618;5200;1483;4974;417;1514;684;2314;1101;3828
270800;201309;11019;33954;10445;33199;1005;3596;8472;26891;9477;30487
270810;201309;3303;10475;2780;9514;421;1663;1719;5886;2140;7549
270820;201309;1880;6503;1738;6252;266;1114;1200;4257;1466;5371
270830;201309;5034;16509;4674;16034;1370;5328;2580;8718;3950;14046
270840;201309;7260;25624;6713;24904;521;2471;5559;20399;6080;22870
270850;201309;7519;25134;7370;24950;1553;6468;5048;16185;6601;22653
270860;201309;11167;34694;10566;33830;1795;6767;7482;23344;9277;30111
270870;201309;2228;6574;1821;5735;272;937;1143;3606;1415;4543
270880;201309;7665;25271;7317;24755;520;2213;6177;20624;6697;22837
270890;201309;2580;8105;2414;7833;401;1564;1664;5242;2065;6806
270895;201309;3003;11239;2861;11046;281;1060;2370;9362;2651;10422
270900;201309;1910;5296;1586;4824;111;433;1220;3604;1331;4037
270910;201309;3241;11652;3197;11567;358;1607;2593;9141;2951;10748
270915;201309;9802;33973;9028;32564;2014;8212;4970;17818;6984;26030
270920;201309;6030;19760;5673;19227;376;1696;4837;16208;5213;17904
270930;201309;16709;46412;14038;43009;3071;10024;8009;25112;11080;35136
270940;201309;5706;19692;5540;19482;917;3424;4017;14247;4934;17671
280010;201309;709;2124;632;2004;70;280;410;1277;480;1557
280020;201309;4831;14957;4365;14111;912;3139;2681;8669;3593;11808
280030;201309;69902;190186;63462;180597;16051;48322;33856;97642;49907;145964
280040;201309;3123;10082;2850;9714;374;1293;2125;7482;2499;8775
280050;201309;4074;13295;3814;12912;1083;3695;2113;7473;3196;11168
280060;201309;4140;14259;4008;14032;977;3756;2345;8234;3322;11990
280067;201309;7444;21597;6380;20130;692;2431;4823;15192;5515;17623
280070;201309;1789;6397;1722;6297;349;1357;1112;4118;1461;5475
280100;201309;3967;12825;3617;12191;903;3142;1925;6659;2828;9801
280110;201309;1361;4257;1262;4096;107;440;1001;3199;1108;3639
280120;201309;7517;24561;7039;23770;1373;4446;4695;16682;6068;21128
280130;201309;7668;22645;7258;22042;1255;4395;4881;14537;6136;18932
280140;201309;5408;15362;4950;14762;546;1646;3930;11865;4476;13511
280150;201309;3245;10395;2995;9900;477;1925;1892;5967;2369;7892
280160;201309;1533;4442;1400;4226;177;612;1004;3022;1181;3634
280170;201309;4489;14022;4142;13590;543;1795;3142;10654;3685;12449
280190;201309;1079;3231;986;3079;119;469;684;2058;803;2527
280200;201309;1073;3417;1015;3324;161;670;724;2288;885;2958
280210;201309;11931;39408;11437;38640;2516;8969;7200;24835;9716;33804
280220;201309;1518;4756;1469;4691;98;386;1286;4086;1384;4472
280230;201309;3844;11410;3470;10791;737;2434;2028;6472;2765;8906
280240;201309;3366;10382;3128;10016;258;800;2507;8176;2765;8976
280250;201309;770;2105;691;1982;107;352;442;1195;549;1547
280260;201309;1963;5410;1805;5210;127;385;1537;4448;1664;4833
280270;201309;2164;6950;1900;6488;137;564;1502;5049;1639;5613
280280;201309;3991;13527;3754;13119;917;2876;2069;8059;2986;10935
280290;201309;16059;53374;14995;51516;2795;10372;10230;35390;13025;45762
280300;201309;9791;30355;9213;29698;834;2878;7760;25115;8594;27993
280310;201309;1415;4065;1260;3823;113;435;910;2675;1023;3110
280320;201309;7278;25380;6900;24683;1329;5367;4148;14825;5477;20192
280330;201309;4425;12992;4188;12689;549;1844;3215;9752;3764;11596
280340;201309;3649;11463;3537;11303;331;1094;2865;9414;3196;10508
280350;201309;20708;63412;19713;61840;3159;10257;13815;44289;16974;54546
280360;201309;5721;18529;5423;18066;1223;4599;3284;10794;4507;15393
280370;201309;1899;5540;1753;5296;214;769;1274;3739;1488;4508
280380;201309;908;2986;851;2898;123;496;634;2104;757;2600
280390;201309;3186;9658;2877;9105;746;2186;1692;5559;2438;7745
280400;201309;4358;12740;4006;12267;832;2454;2598;8318;3430;10772
280410;201309;2325;7805;2142;7490;365;1474;1311;4490;1676;5964
280420;201309;4023;11998;3781;11630;275;876;3243;10071;3518;10947
280430;201309;2024;5766;1927;5640;218;745;1500;4393;1718;5138
280440;201309;4991;15136;4693;14755;457;1563;3893;12293;4350;13856
280445;201309;2432;7134;2274;6861;125;492;1879;5566;2004;6058
280450;201309;8657;24233;8064;23542;782;1990;6751;20390;7533;22380
280460;201309;6643;18843;6015;17982;1222;3877;3949;11975;5171;15852
280470;201309;1750;5420;1612;5209;184;667;1220;3909;1404;4576
280480;201309;30058;93163;29099;91745;5108;18875;19712;60528;24820;79403
280490;201309;3661;11510;3431;11085;406;1504;2591;8349;2997;9853
280500;201309;871;2368;827;2314;34;112;730;2019;764;2131
280510;201309;2671;8020;2315;7522;304;1150;1717;5587;2021;6737
280520;201309;1687;4932;1564;4772;214;637;1169;3696;1383;4333
280530;201309;2005;6429;1905;6295;247;900;1466;4907;1713;5807
280540;201309;8633;24578;8206;23996;359;1271;7339;21336;7698;22607
280550;201309;6927;19362;6286;18323;552;1966;4783;13790;5335;15756
280560;201309;7730;23314;7339;22657;537;1872;6021;18530;6558;20402
280570;201309;6483;18622;6014;18012;933;3273;4166;12240;5099;15513
280580;201309;5608;17337;4907;16175;776;2683;3348;11237;4124;13920
280590;201309;2329;7218;2161;7019;292;1111;1604;5217;1896;6328
280600;201309;3972;12422;3735;11996;407;1615;2701;8474;3108;10089
280610;201309;2306;6842;2187;6657;365;1217;1395;4254;1760;5471
280620;201309;4669;15032;4373;14419;819;2917;2821;9326;3640;12243
280630;201309;3736;12637;3635;12486;370;1171;2946;10473;3316;11644
280640;201309;2165;6273;2021;6099;163;437;1746;5366;1909;5803
280650;201309;1073;3460;997;3317;194;700;618;2091;812;2791
280660;201309;2582;7685;2485;7521;280;948;2043;6107;2323;7055
280670;201309;15432;41674;14769;40849;1577;4661;11741;32534;13318;37195
280680;201309;2706;7374;2396;6977;185;596;2023;5879;2208;6475
280690;201309;944;2810;841;2650;124;461;562;1690;686;2151
280700;201309;1145;3428;1014;3235;91;303;758;2455;849;2758
280710;201309;9983;28683;9492;28078;582;1870;8205;24283;8787;26153
280720;201309;2461;6791;2213;6478;199;627;1746;5179;1945;5806
280730;201309;911;2799;883;2760;82;271;738;2332;820;2603
280740;201309;12332;34723;10921;32647;1701;5021;7617;23488;9318;28509
280750;201309;3499;11211;3273;10803;300;1260;2423;7878;2723;9138
280760;201309;5668;17709;5236;17139;719;2360;3894;13231;4613;15591
290010;201309;2961;6746;2174;5501;90;369;1726;4122;1816;4491
290020;201309;4871;15539;4438;15088;377;1182;3864;13393;4241;14575
290030;201309;3089;10253;3020;10121;465;1666;2221;7419;2686;9085
290035;201309;4421;12525;4018;11991;264;907;3430;10235;3694;11142
290040;201309;3639;10972;3431;10693;286;1114;2837;8689;3123;9803
290050;201309;2707;8964;2545;8713;262;1015;1966;6761;2228;7776
290060;201309;1254;3355;1064;3131;149;481;829;2411;978;2892
290070;201309;29906;80644;26267;76082;5753;17302;14624;44464;20377;61766
290080;201309;5780;18126;5187;17364;655;2286;3904;13379;4559;15665
290090;201309;2275;5112;1825;4633;249;650;1454;3733;1703;4383
290100;201309;10043;29456;8799;27321;1888;5911;4925;16000;6813;21911
290110;201309;5185;16078;5023;15797;909;3094;3403;10648;4312;13742
290115;201309;4763;14875;4263;14206;346;1232;3262;11115;3608;12347
290120;201309;6638;18693;6246;18217;435;1315;5415;15904;5850;17219
290130;201309;4509;11960;4001;11352;324;851;3395;9818;3719;10669
290135;201309;5000;13284;4385;12266;492;1633;2935;8124;3427;9757
290140;201309;3719;12481;3345;11998;394;1537;2661;9574;3055;11111
290150;201309;2084;6293;2019;6185;193;650;1698;5170;1891;5820
290160;201309;3423;9741;3348;9651;370;748;2856;8602;3226;9350
290170;201309;2790;9509;2579;9165;249;1032;2068;7348;2317;8380
290180;201309;2883;8474;2614;8100;306;1071;1905;5887;2211;6958
290190;201309;4125;13846;3987;13600;447;1610;3084;10624;3531;12234
290195;201309;2161;6144;1881;5727;150;514;1506;4608;1656;5122
290200;201309;3766;12421;3473;11891;442;1612;2551;8778;2993;10390
290205;201309;2758;9084;2598;8842;411;1673;1832;6081;2243;7754
290210;201309;15567;43522;14790;42616;2430;5681;10755;33840;13185;39521
290220;201309;2325;7270;2237;7134;326;1224;1596;4949;1922;6173
290225;201309;3003;8249;2837;8069;235;515;2456;7240;2691;7755
290230;201309;2342;7914;2302;7855;235;836;1907;6591;2142;7427
290240;201309;3834;10338;3476;9848;432;1361;2519;7067;2951;8428
290250;201309;3732;12150;3183;11264;308;1175;2408;8626;2716;9801
290260;201309;4567;14561;4328;14193;482;1692;3403;11169;3885;12861
290265;201309;3291;10928;3140;10659;326;1304;2395;8088;2721;9392
290270;201309;11746;44252;11123;43329;1467;6118;8458;33456;9925;39574
290280;201309;4944;16928;4731;16498;725;2663;3221;11508;3946;14171
290290;201309;9448;31073;8735;29906;1669;6031;5723;19935;7392;25966
290300;201309;4358;12587;3438;10983;326;1107;2474;8072;2800;9179
290310;201309;1502;4668;1430;4578;225;837;1034;3241;1259;4078
290320;201309;25138;80215;22934;77240;5071;18215;14025;47947;19096;66162
290323;201309;3971;10994;3292;10278;213;788;2816;8768;3029;9556
290327;201309;3916;12891;3671;12387;513;1838;2572;8704;3085;10542
290330;201309;1851;5077;1778;4995;285;893;1375;3803;1660;4696
290340;201309;5521;17731;5149;17205;1308;4472;2889;9971;4197;14443
290350;201309;4819;15030;3987;13885;528;1880;2873;10281;3401;12161
290360;201309;4077;13191;3732;12722;243;873;3255;11241;3498;12114
290370;201309;4500;13785;4177;13316;558;1813;3288;10618;3846;12431
290380;201309;5459;16306;4920;15584;380;1362;4093;12968;4473;14330
290390;201309;14699;49056;14114;48054;2979;9898;8970;32128;11949;42026
290395;201309;2745;9065;2496;8644;259;1105;1870;6462;2129;7567
290400;201309;3446;11252;3136;10806;472;1630;2275;8022;2747;9652
290405;201309;4287;14056;3771;13159;518;1897;2519;9036;3037;10933
290410;201309;5874;18099;5058;16901;571;2445;3750;12165;4321;14610
290420;201309;3211;9729;2700;8992;262;1056;2090;6886;2352;7942
290430;201309;3391;11058;3099;10636;702;2425;1900;6780;2602;9205
290440;201309;2885;7902;2436;7332;210;725;1985;6013;2195;6738
290450;201309;3475;10443;3167;9993;657;1991;2015;6637;2672;8628
290460;201309;12834;41068;12158;39897;3402;11883;6008;19581;9410;31464
290470;201309;4623;13508;3747;12373;876;3266;2033;6807;2909;10073
290475;201309;5051;18159;4610;17359;536;2156;3399;12984;3935;15140
290480;201309;2631;6925;2351;6557;351;1069;1638;4599;1989;5668
290485;201309;4436;15060;4170;14664;474;2131;3215;11181;3689;13312
290490;201309;7595;21438;7368;21119;927;2901;5836;16710;6763;19611
290500;201309;4545;14814;3958;13770;759;2852;2114;7370;2873;10222
290510;201309;3390;10113;2980;9514;258;977;2354;7523;2612;8500
290515;201309;2707;8768;2604;8575;164;531;2134;7199;2298;7730
290520;201309;11685;36978;9664;33189;1293;5201;6105;20868;7398;26069
290530;201309;5200;15339;4480;14286;380;1306;3636;11642;4016;12948
290540;201309;3919;11436;3750;11211;506;1467;2835;8715;3341;10182
290550;201309;4309;11571;3826;10976;213;621;3331;9603;3544;10224
290560;201309;5956;18058;5340;17177;1144;3867;3248;10597;4392;14464
290570;201309;39170;116818;36840;113233;5100;16780;27056;82849;32156;99629
290580;201309;7241;26126;6983;25730;1211;4470;5073;19233;6284;23703
290590;201309;7371;24180;6311;22451;480;2012;5088;18069;5568;20081
290600;201309;17828;56662;16917;55249;2518;8312;11831;39859;14349;48171
290610;201309;2307;8242;1967;7565;204;973;1453;5498;1657;6471
290620;201309;7228;21795;6524;20785;556;1926;5435;17334;5991;19260
290630;201309;8140;22676;7234;21713;859;2570;5777;17578;6636;20148
290640;201309;2689;8060;2258;7306;257;896;1601;5203;1858;6099
290650;201309;11484;34967;10815;33937;3323;10486;5682;18670;9005;29156
290660;201309;3651;10460;3052;9598;214;780;2440;7703;2654;8483
290670;201309;6319;20486;5839;19737;881;2819;4393;15488;5274;18307
290680;201309;10137;30505;9509;29755;562;1837;8255;26091;8817;27928
290682;201309;4173;12983;3826;12480;219;873;3186;10346;3405;11219
290685;201309;3158;8425;2447;7430;322;1088;1537;4750;1859;5838
290687;201309;8246;22517;6692;20682;1091;3678;4435;13908;5526;17586
290689;201309;3086;8936;2610;8168;278;934;1985;6248;2263;7182
290690;201309;5254;15871;4863;15329;637;2167;3709;11749;4346;13916
290700;201309;2216;7117;2129;6991;240;845;1632;5409;1872;6254
290710;201309;7556;25022;7082;24253;404;1384;6224;21533;6628;22917
290720;201309;17752;54065;16064;51948;2388;7231;12251;41029;14639;48260
290730;201309;7295;20674;6713;19934;1402;4029;4264;13163;5666;17192
290740;201309;984;3024;850;2798;164;538;493;1694;657;2232
290750;201309;9970;29405;8711;27164;1742;6348;4990;14853;6732;21201
290755;201309;2394;6956;2046;6370;134;530;1662;5112;1796;5642
290760;201309;4400;13311;3698;12332;404;1359;2775;9369;3179;10728
290770;201309;2520;8921;2366;8715;155;653;1990;7374;2145;8027
290780;201309;8464;23115;7626;21966;976;2598;5746;17061;6722;19659
290790;201309;4516;13994;4251;13625;522;1616;3255;10842;3777;12458
290800;201309;7142;16172;5534;14458;1143;2793;3843;10506;4986;13299
290810;201309;4772;15700;4249;14912;342;1295;3288;11724;3630;13019
290820;201309;5259;15665;4736;14909;605;2167;3409;10694;4014;12861
290830;201309;4227;12867;4080;12597;499;1951;2997;8978;3496;10929
290840;201309;17096;49466;15969;47927;2471;7136;11393;35667;13864;42803
290850;201309;6621;20318;6477;20103;1500;4635;4307;13773;5807;18408
290860;201309;4716;17293;4525;17031;751;2819;3257;12664;4008;15483
290870;201309;4715;14459;3980;13459;492;1973;2897;9689;3389;11662
290880;201309;1373;3913;1126;3520;123;393;749;2389;872;2782
290890;201309;6138;17666;5927;17389;640;1932;4794;14186;5434;16118
290900;201309;2393;7149;1840;6253;302;1167;974;3266;1276;4433
290910;201309;4677;13478;4080;12617;342;1155;3308;10254;3650;11409
290920;201309;4744;14342;4327;13775;357;1007;3533;11494;3890;12501
290930;201309;7205;23791;6690;22907;802;3092;4837;16378;5639;19470
290940;201309;3371;11144;3196;10912;289;1059;2685;9286;2974;10345
290950;201309;1581;4576;1487;4452;222;715;1072;3194;1294;3909
290960;201309;5748;17079;5279;16454;412;1325;4270;13526;4682;14851
290970;201309;3707;12286;3465;11866;523;1852;2294;8089;2817;9941
290980;201309;10588;32917;9573;30886;2865;9692;4015;12970;6880;22662
290990;201309;9066;27775;8317;26583;910;3087;6490;20823;7400;23910
291000;201309;2846;9188;2692;8977;448;1494;1967;6768;2415;8262
291005;201309;12630;37009;11604;35446;2213;7251;7560;23424;9773;30675
291010;201309;2929;10022;2516;9093;464;1817;1414;5120;1878;6937
291020;201309;1330;3705;1049;3189;132;498;610;1801;742;2299
291030;201309;2049;5979;1720;5272;191;652;1126;3413;1317;4065
291040;201309;5243;17263;4940;16798;716;2585;3590;12294;4306;14879
291050;201309;7847;26746;7261;25656;1895;7210;3879;13743;5774;20953
291060;201309;6108;23125;5859;22828;791;3497;4504;17512;5295;21009
291070;201309;15798;47791;14631;46091;1934;5721;10960;35765;12894;41486
291072;201309;19082;62030;16935;57751;6269;22716;5600;20131;11869;42847
291075;201309;5082;15255;4650;14659;330;1066;3617;11686;3947;12752
291077;201309;1499;4530;1291;4206;145;571;896;2862;1041;3433
291080;201309;79957;248929;73160;237455;19340;66093;34974;113352;54314;179445
291085;201309;5511;15303;4851;14408;615;1932;3715;11060;4330;12992
291090;201309;1256;3524;1119;3317;170;634;784;2227;954;2861
291100;201309;2654;7261;2242;6824;128;525;1928;5818;2056;6343
291110;201309;4918;18012;4473;17306;688;2940;3133;12078;3821;15018
291120;201309;7446;20353;7057;19803;1010;2981;5258;14805;6268;17786
291125;201309;1636;3739;1345;3431;134;326;1046;2788;1180;3114
291130;201309;2967;9224;2610;8628;264;1030;1870;6141;2134;7171
291140;201309;4017;12378;3785;11960;542;1812;2682;8529;3224;10341
291150;201309;1986;5291;1912;5202;181;528;1512;4084;1693;4612
291160;201309;5462;16982;4862;16101;1130;3900;2955;9819;4085;13719
291165;201309;2323;7173;1971;6504;165;702;1412;4553;1577;5255
291170;201309;20258;53300;17702;50183;1390;4721;14171;39889;15561;44610
291180;201309;6333;17169;5281;15742;605;2019;3988;11824;4593;13843
291185;201309;3702;10545;3545;10346;235;828;3051;8814;3286;9642
291190;201309;7409;21319;6725;20504;905;2677;5018;15927;5923;18604
291200;201309;3056;9450;2645;8755;350;1369;1853;6080;2203;7449
291210;201309;7565;18340;6713;17392;657;1806;5243;13696;5900;15502
291220;201309;4050;13253;3858;12923;606;2308;2720;8987;3326;11295
291230;201309;3755;10192;3366;9716;213;616;2926;8527;3139;9143
291240;201309;4702;13197;4020;11995;325;1023;3112;9212;3437;10235
291250;201309;3692;11333;2960;10119;316;1118;2124;7366;2440;8484
291260;201309;1159;3525;1104;3448;104;355;882;2757;986;3112
291270;201309;4375;15083;4195;14767;306;1198;3466;12264;3772;13462
291280;201309;2336;6030;1789;5400;516;1524;1037;3249;1553;4773
291290;201309;5873;17022;5386;16432;812;2491;3771;11837;4583;14328
291300;201309;4387;13389;3677;12187;492;1795;2486;8257;2978;10052
291310;201309;5253;15500;4670;14539;449;1499;3563;11104;4012;12603
291320;201309;5611;18956;5030;17820;1451;5603;2383;8331;3834;13934
291330;201309;1554;4923;1466;4763;221;841;926;2873;1147;3714
291340;201309;3760;11470;3055;10461;392;1570;2287;7718;2679;9288
291345;201309;3397;11459;3258;11308;258;902;2834;9992;3092;10894
291350;201309;6018;18247;5418;17327;682;2297;3632;11932;4314;14229
291360;201309;35754;105998;33602;102831;8052;24629;21367;67593;29419;92222
291370;201309;8947;27111;8601;26664;1215;3578;6434;20666;7649;24244
291380;201309;3762;11818;3357;11149;339;1160;2388;8180;2727;9340
291390;201309;10267;29322;9445;28362;1290;3865;7256;22090;8546;25955
291400;201309;16535;44435;13545;40403;2129;6604;8868;27378;10997;33982
291410;201309;3221;8510;2393;7291;205;839;1768;5205;1973;6044
291420;201309;2229;5953;2018;5700;95;231;1850;5300;1945;5531
291430;201309;3310;9973;2947;9493;265;1037;2296;7325;2561;8362
291440;201309;5822;18981;5000;17444;581;2165;3773;13343;4354;15508
291450;201309;7182;22930;6796;22257;446;1430;5593;18733;6039;20163
291460;201309;12368;39085;11190;37371;2558;8959;6781;22975;9339;31934
291465;201309;7749;23215;7121;22493;952;3299;5443;17235;6395;20534
291470;201309;15320;43734;13779;41831;1266;3928;10858;33907;12124;37835
291480;201309;34438;95544;30910;90567;5700;18532;19710;57277;25410;75809
291490;201309;4094;14318;4024;14215;564;1991;3159;11373;3723;13364
291500;201309;4105;12242;3617;11571;292;1010;2923;9403;3215;10413
291510;201309;3426;10863;3244;10605;158;564;2930;9637;3088;10201
291520;201309;4014;11360;3607;10805;649;1857;2388;7624;3037;9481
291530;201309;2062;6286;1777;5837;506;1771;881;2987;1387;4758
291535;201309;4276;12801;3882;12215;384;1280;2918;9525;3302;10805
291540;201309;2199;5526;1909;5223;157;398;1615;4529;1772;4927
291550;201309;5554;15636;5040;14911;1274;4011;2764;8284;4038;12295
291560;201309;16377;43950;13156;40246;1713;5388;9733;30523;11446;35911
291570;201309;2330;6445;2236;6327;152;399;1986;5694;2138;6093
291580;201309;5790;18169;5177;17196;839;3348;3343;10945;4182;14293
291590;201309;2001;6364;1790;6006;342;1272;1110;3824;1452;5096
291600;201309;5446;15499;4076;13572;1043;3795;1999;6588;3042;10383
291610;201309;5163;15070;5011;14849;486;1658;4085;11954;4571;13612
291620;201309;2995;7170;2509;6648;192;489;2002;5485;2194;5974
291630;201309;3184;8145;2839;7756;263;676;2411;6745;2674;7421
291640;201309;16907;47885;14404;44668;3942;13419;6434;20051;10376;33470
291650;201309;7928;24201;7366;23546;627;1623;6237;20723;6864;22346
291660;201309;2377;6463;2134;6136;268;918;1500;4205;1768;5123
291670;201309;2481;7114;2294;6804;374;1158;1304;4170;1678;5328
291680;201309;4961;14400;4494;13653;1169;4021;2094;6598;3263;10619
291685;201309;4219;11267;3778;10739;312;912;3054;8948;3366;9860
291690;201309;3945;11050;3276;9994;342;1083;2271;6989;2613;8072
291700;201309;9189;29698;8605;28716;1016;3543;6442;21873;7458;25416
291710;201309;5876;15901;5159;14942;1211;3807;2768;8304;3979;12111
291720;201309;3695;13295;3436;12760;397;1695;2556;9360;2953;11055
291730;201309;5710;18937;5365;18479;1343;4698;3283;11728;4626;16426
291733;201309;2484;7683;2192;7283;285;1020;1499;5035;1784;6055
291735;201309;2250;6718;1981;6314;128;494;1658;5233;1786;5727
291740;201309;3944;11672;3144;10434;327;1280;2229;7364;2556;8644
291750;201309;21731;58819;17641;52816;3992;12387;9747;29765;13739;42152
291760;201309;12012;39122;11245;37730;3877;14078;5091;17354;8968;31432
291770;201309;7926;23301;7316;22285;1201;3956;4920;14881;6121;18837
291780;201309;4217;13384;4059;13091;583;1825;3060;10029;3643;11854
291790;201309;2375;7771;2259;7611;183;727;1881;6307;2064;7034
291800;201309;30774;92209;28128;88389;6371;20865;16806;54232;23177;75097
291810;201309;10293;30790;9047;29342;699;2518;7338;24124;8037;26642
291820;201309;3535;10905;3263;10516;381;1245;2468;8064;2849;9309
291830;201309;4370;12039;4101;11637;591;1847;3050;8627;3641;10474
291835;201309;6038;19333;5098;17793;1113;4190;3213;11223;4326;15413
291840;201309;46415;132154;40503;125877;5087;15726;32040;101791;37127;117517
291845;201309;2988;8862;2706;8556;242;742;2347;7518;2589;8260
291850;201309;4815;13838;4118;12883;432;1314;3233;10419;3665;11733
291855;201309;1900;5146;1655;4837;301;1020;1122;3205;1423;4225
291860;201309;1914;5916;1717;5549;186;679;1153;3704;1339;4383
291870;201309;1321;3683;1062;3220;111;417;708;2107;819;2524
291875;201309;2756;9165;2524;8783;277;1128;1753;6017;2030;7145
291880;201309;4489;14514;4339;14285;320;1054;3727;12421;4047;13475
291890;201309;1408;3588;1203;3338;165;475;863;2421;1028;2896
291900;201309;1263;3735;1127;3537;118;434;855;2638;973;3072
291905;201309;2899;7867;2457;7162;238;802;1737;5122;1975;5924
291910;201309;2492;7036;2247;6715;181;678;1833;5358;2014;6036
291915;201309;6553;20881;5931;19634;541;1847;4880;16403;5421;18250
291920;201309;32343;95830;30051;92475;6070;19104;18789;59562;24859;78666
291930;201309;2513;7615;2294;7303;262;910;1747;5598;2009;6508
291940;201309;3546;10312;2709;8817;404;1519;1611;5056;2015;6575
291950;201309;9055;31395;8275;30110;2225;8247;4320;16187;6545;24434
291955;201309;7414;24813;7282;24621;1520;5235;4838;16687;6358;21922
291960;201309;3305;10100;2878;9523;366;1154;2039;7131;2405;8285
291970;201309;4397;13284;3935;12713;600;2001;2765;9133;3365;11134
291980;201309;11279;33233;8786;29652;1152;4079;6166;21273;7318;25352
291990;201309;2091;7014;1947;6796;211;764;1429;5137;1640;5901
291992;201309;2776;8700;2717;8577;503;1664;1937;6087;2440;7751
291995;201309;2071;6269;1884;6012;231;767;1426;4633;1657;5400
292000;201309;2288;6953;2083;6642;510;1802;1215;3797;1725;5599
292010;201309;6065;16153;4730;14122;466;1484;3634;10854;4100;12338
292020;201309;4428;15332;4085;14754;571;2237;2997;10970;3568;13207
292030;201309;2127;6880;1936;6601;255;957;1265;4354;1520;5311
292040;201309;4561;12975;4089;12469;361;1055;3417;10794;3778;11849
292045;201309;2402;8639;2372;8587;111;367;2194;8005;2305;8372
292050;201309;6101;19674;5532;18554;598;2467;3874;12799;4472;15266
292060;201309;10712;30771;10328;30247;990;3046;8541;25016;9531;28062
292070;201309;4282;13946;4183;13821;394;1178;3635;12235;4029;13413
292080;201309;3608;9775;3139;9143;297;890;2531;7451;2828;8341
292090;201309;4226;11587;3668;10948;350;1200;2965;8856;3315;10056
292100;201309;10733;30475;9383;28801;2486;8025;5443;17139;7929;25164
292105;201309;3132;9729;2742;9183;218;878;2189;7283;2407;8161
292110;201309;6998;18754;5412;16472;1209;3859;3113;9742;4322;13601
292120;201309;8272;24179;7351;22696;1522;4867;4312;13670;5834;18537
292130;201309;3216;8707;2929;8318;469;1143;2111;6297;2580;7440
292140;201309;5393;14402;4744;13551;537;1587;3425;10051;3962;11638
292145;201309;2658;8303;2442;7962;212;684;1841;6276;2053;6960
292150;201309;13331;41426;12457;40010;918;3438;9846;31825;10764;35263
292160;201309;2676;7851;2305;7338;192;585;1890;6185;2082;6770
292170;201309;8597;26368;7416;24299;1120;4084;4741;15704;5861;19788
292180;201309;3460;10408;2882;9518;350;1241;2038;6837;2388;8078
292190;201309;3146;9002;2783;8494;558;1867;1797;5486;2355;7353
292200;201309;5508;18849;5010;17749;1616;6155;1884;6650;3500;12805
292205;201309;3989;12557;3672;12131;282;1082;2942;9710;3224;10792
292210;201309;6454;19235;5714;18215;560;1890;4476;14624;5036;16514
292220;201309;1892;5499;1799;5364;423;1207;1079;3274;1502;4481
292225;201309;2865;9344;2656;9015;212;760;2143;7382;2355;8142
292230;201309;6190;18855;5920;18429;719;2655;4475;13621;5194;16276
292240;201309;4336;14041;4033;13351;658;2370;2453;8032;3111;10402
292250;201309;5141;16105;4863;15581;1043;3496;2657;8599;3700;12095
292260;201309;2955;9621;2815;9400;367;1290;2126;7117;2493;8407
292265;201309;3062;10225;2805;9749;246;1019;2079;7177;2325;8196
292270;201309;3800;10754;3107;9938;284;1099;2464;7895;2748;8994
292273;201309;2749;6800;2127;6006;310;859;1499;4420;1809;5279
292275;201309;1885;4992;1770;4829;225;703;1336;3612;1561;4315
292280;201309;2024;6224;1872;6061;186;509;1485;5112;1671;5621
292285;201309;2505;7250;2240;6870;288;980;1633;5103;1921;6083
292290;201309;7324;22558;6229;21136;359;1384;5145;17775;5504;19159
292300;201309;8246;25923;7311;24898;2394;8265;4021;14224;6415;22489
292303;201309;2754;8917;2580;8668;112;442;2244;7551;2356;7993
292305;201309;3126;8639;2967;8426;107;323;2678;7634;2785;7957
292310;201309;5811;18296;5356;17682;345;1206;4562;15198;4907;16404
292320;201309;5707;18066;5281;17332;598;2322;4008;13017;4606;15339
292330;201309;1945;5760;1840;5630;257;871;1378;4164;1635;5035
292335;201309;5227;13974;4785;13391;399;1152;4039;11363;4438;12515
292340;201309;6412;18995;5625;17780;543;1857;4203;13306;4746;15163
292350;201309;2027;6515;1912;6376;212;806;1518;5060;1730;5866
292360;201309;4811;14412;4650;13899;197;600;4066;12431;4263;13031
292370;201309;8254;26212;7545;25144;1060;3427;5294;18573;6354;22000
292380;201309;7234;21406;6848;20817;585;1655;5650;17428;6235;19083
292390;201309;3572;8301;3192;7890;108;209;2990;7476;3098;7685
292400;201309;21818;65509;20891;64018;3196;10407;14697;45943;17893;56350
292405;201309;4324;11909;3800;11274;271;821;3199;9611;3470;10432
292410;201309;1788;5038;1726;4969;146;450;1498;4296;1644;4746
292420;201309;3679;12022;3553;11879;180;512;3227;11024;3407;11536
292430;201309;5239;16947;4491;15970;313;1267;3589;12794;3902;14061
292440;201309;8472;28023;7973;27312;315;1228;7041;24418;7356;25646
292450;201309;4316;13094;3556;11873;344;1263;2562;8678;2906;9941
292460;201309;5551;16999;4960;15922;935;3107;3128;10164;4063;13271
292465;201309;2300;7195;2003;6714;250;971;1440;4846;1690;5817
292467;201309;2158;7144;2047;6949;440;1613;1290;4425;1730;6038
292470;201309;3158;8656;2660;7861;238;852;1994;5793;2232;6645
292480;201309;5757;16464;4994;15373;397;1393;4064;12555;4461;13948
292490;201309;2244;6553;1955;6115;217;819;1458;4486;1675;5305
292500;201309;6532;19985;5727;18597;600;2273;4196;13676;4796;15949
292510;201309;12960;38054;11600;36117;1183;4033;9047;28573;10230;32606
292520;201309;5604;17653;5251;17019;1585;5263;2582;8475;4167;13738
292525;201309;5443;14596;4801;13844;436;1366;3864;11247;4300;12613
292530;201309;24322;74477;22504;72348;4631;15385;14715;48749;19346;64134
292540;201309;2755;8404;2517;8047;509;1846;1650;5212;2159;7058
292550;201309;6128;20606;5588;19752;970;3615;3764;13584;4734;17199
292560;201309;4192;11742;3608;10981;315;1163;2934;8783;3249;9946
292570;201309;3939;11827;3822;11703;140;441;3339;10555;3479;10996
292575;201309;5896;20512;5741;20218;1190;4318;3832;13517;5022;17835
292580;201309;7034;21249;6587;20679;600;1946;5421;17201;6021;19147
292590;201309;7055;23038;6793;22589;1063;3508;4804;16297;5867;19805
292593;201309;3213;8634;2747;7948;259;777;2109;6095;2368;6872
292595;201309;5581;16432;5057;15724;482;1640;3879;12088;4361;13728
292600;201309;10474;30078;9933;29408;1334;3127;7962;24732;9296;27859
292610;201309;4301;12692;3608;11522;561;1888;2285;7433;2846;9321
292620;201309;5788;18342;5136;17573;362;1416;4537;15526;4899;16942
292630;201309;9816;25249;8631;23506;788;2278;6623;18269;7411;20547
292640;201309;8191;26895;7259;25656;662;2431;5675;20517;6337;22948
292650;201309;4621;13263;4475;13085;503;1126;3600;11241;4103;12367
292660;201309;10930;34072;10493;33418;1514;4884;7762;25301;9276;30185
292665;201309;2851;8612;2776;8497;100;283;2599;8021;2699;8304
292670;201309;3800;11040;3015;9723;371;1361;1979;6405;2350;7766
292680;201309;3529;10889;3372;10678;273;933;2831;8929;3104;9862
292690;201309;3331;9272;2460;7933;324;1172;1653;5414;1977;6586
292700;201309;8789;27744;7821;26383;1102;3557;5699;20101;6801;23658
292710;201309;1891;6322;1808;6199;105;402;1594;5474;1699;5876
292720;201309;9381;24724;8348;23546;782;2306;6923;19689;7705;21995
292730;201309;3297;10316;3201;10152;589;1803;2149;7074;2738;8877
292740;201309;344114;994344;328444;970946;80574;251999;195361;579322;275935;831321
292750;201309;5724;16185;5252;15565;413;1245;4276;12914;4689;14159
292760;201309;4189;13708;3873;13124;569;2120;2557;8760;3126;10880
292770;201309;5851;18467;5555;18000;1373;4493;3261;10984;4634;15477
292780;201309;1815;4681;1463;4259;217;754;1044;2989;1261;3743
292790;201309;3206;8921;3089;8792;275;658;2542;7610;2817;8268
292800;201309;9302;28666;8754;27773;964;3326;6759;21482;7723;24808
292805;201309;3051;9320;2830;8999;554;1932;1891;6081;2445;8013
292810;201309;9695;30325;8379;28574;1249;4391;6155;21558;7404;25949
292820;201309;7215;21266;5370;18658;450;1721;4348;15232;4798;16953
292830;201309;1827;5575;1674;5359;128;517;1356;4297;1484;4814
292840;201309;6839;23496;6379;22849;481;1851;5410;19510;5891;21361
292850;201309;3122;8481;2663;7792;371;1170;1854;5368;2225;6538
292860;201309;15002;41707;14485;41070;2020;5702;11234;32360;13254;38062
292870;201309;18302;52540;16494;49614;3403;11272;9527;28162;12930;39434
292880;201309;11518;35286;10496;33626;2003;6619;6562;21266;8565;27885
292890;201309;5324;18787;4845;17851;1032;3969;2743;10380;3775;14349
292895;201309;2678;7027;2268;6421;324;980;1688;4758;2012;5738
292900;201309;3014;9564;2846;9288;463;1789;1877;5894;2340;7683
292905;201309;3987;12224;3407;11466;345;1084;2786;9658;3131;10742
292910;201309;4984;15853;4647;15220;819;2879;2993;9757;3812;12636
292920;201309;8100;24314;7744;23773;790;2714;6168;18664;6958;21378
292925;201309;5012;16099;4495;15387;388;1449;3557;12227;3945;13676
292930;201309;6387;20979;6118;20467;888;3606;4351;14194;5239;17800
292935;201309;2081;5993;1776;5654;165;437;1442;4827;1607;5264
292937;201309;3274;8559;2809;7969;325;1052;2148;6010;2473;7062
292940;201309;3005;8528;2424;7726;303;969;1637;5451;1940;6420
292950;201309;8155;25177;7823;24626;1025;3849;5692;17415;6717;21264
292960;201309;4486;12978;4189;12517;510;1658;2941;8717;3451;10375
292970;201309;4179;13381;3872;12981;196;808;3300;11071;3496;11879
292975;201309;3226;9129;3124;8958;350;1038;2540;7318;2890;8356
292980;201309;3504;10144;2900;9416;412;1624;2007;6449;2419;8073
292990;201309;11944;34881;11054;33539;777;2504;9421;28642;10198;31146
293000;201309;2898;7866;2394;7206;137;480;2073;6223;2210;6703
293010;201309;17904;52419;16090;49507;3260;11079;9751;29874;13011;40953
293015;201309;7799;26083;6373;23954;1127;4557;4072;15283;5199;19840
293020;201309;9296;31292;8708;30430;644;2526;7183;25372;7827;27898
293030;201309;5466;16291;4480;14834;489;1785;3088;10522;3577;12307
293040;201309;3694;12001;3561;11852;262;945;3081;10267;3343;11212
293050;201309;18975;55511;17023;52922;2794;8869;11381;36498;14175;45367
293060;201309;4272;11072;3639;10066;426;1290;2500;6845;2926;8135
293070;201309;19293;60465;18158;58451;5158;17290;9482;31086;14640;48376
293075;201309;3502;11225;3201;10871;269;988;2708;9249;2977;10237
293076;201309;3665;10549;3444;10214;288;814;2887;8726;3175;9540
293077;201309;5127;16032;4478;15207;786;2860;2918;10008;3704;12868
293080;201309;4820;15274;4431;14615;337;1462;3495;11238;3832;12700
293090;201309;3538;11231;2932;10383;302;1099;2275;8185;2577;9284
293100;201309;5587;17563;4833;16236;485;1762;3665;12509;4150;14271
293105;201309;3799;12910;3377;12063;581;2135;2193;7993;2774;10128
293110;201309;1935;5911;1840;5748;112;427;1541;4790;1653;5217
293120;201309;3975;13590;3722;13231;353;1280;2975;10734;3328;12014
293130;201309;3939;11679;3235;10886;193;746;2837;9671;3030;10417
293135;201309;25988;71120;20969;64362;4139;15053;11133;33524;15272;48577
293140;201309;2059;6297;1998;6206;197;793;1555;4679;1752;5472
293150;201309;5793;19241;5268;18240;1105;3896;3119;11167;4224;15063
293160;201309;3499;9696;3341;9500;552;1220;2486;7548;3038;8768
293170;201309;3366;10505;3169;10201;467;1612;2305;7545;2772;9157
293180;201309;5313;15200;4494;13949;410;1515;3536;10812;3946;12327
293190;201309;13469;41742;12925;40880;647;2875;11158;34538;11805;37413
293200;201309;6137;18473;5536;17547;326;1195;4775;15049;5101;16244
293210;201309;4579;14288;4309;13832;572;1933;3044;9919;3616;11852
293220;201309;5059;15684;4643;15056;1221;4144;2429;8095;3650;12239
293230;201309;3908;12542;3636;12165;422;1625;2855;9496;3277;11121
293240;201309;4462;11809;3571;10591;193;580;2833;8418;3026;8998
293245;201309;4306;12842;3950;12245;518;1653;2785;8914;3303;10567
293250;201309;5890;17248;5482;16674;931;2965;3780;11601;4711;14566
293260;201309;4676;14300;3940;13235;371;1372;2950;10062;3321;11434
293270;201309;5735;16025;5464;15729;567;1549;4620;13543;5187;15092
293280;201309;5623;16205;4943;15316;436;1287;3860;12367;4296;13654
293290;201309;16215;55792;15484;54310;3405;12264;9212;33120;12617;45384
293300;201309;6128;16031;5347;15171;504;1405;4256;12260;4760;13665
293305;201309;4625;11964;4225;11436;394;1152;3352;9127;3746;10279
293310;201309;2663;7026;2213;6291;279;905;1510;4237;1789;5142
293315;201309;4815;12514;4344;11782;761;2034;2714;7752;3475;9786
293317;201309;2469;7553;2273;7192;325;1074;1484;4735;1809;5809
293320;201309;8061;26597;7861;26322;991;3614;6266;20903;7257;24517
293325;201309;1897;5629;1583;5135;301;1060;1000;3278;1301;4338
293330;201309;53344;172438;48322;163900;11142;41030;26752;91914;37894;132944
293340;201309;2681;7792;2164;6908;312;1139;1476;4617;1788;5756
293345;201309;3385;10467;2872;9718;362;1214;2012;7058;2374;8272
293350;201309;6573;18672;6329;18370;371;1032;5672;16714;6043;17746
293360;201309;13553;41753;12485;40334;765;2495;10639;35126;11404;37621
310010;201309;1223;3368;885;2819;248;944;393;1145;641;2089
310020;201309;3756;12139;3180;10815;1123;4127;613;1894;1736;6021
310030;201309;2375;8169;2161;7768;745;2786;904;3302;1649;6088
310040;201309;932;2685;798;2500;120;448;535;1631;655;2079
310050;201309;1889;6776;1668;6224;365;1583;798;2928;1163;4511
310060;201309;3050;10935;2939;10763;360;1363;2288;8532;2648;9895
310070;201309;318;961;239;808;37;159;105;319;142;478
310080;201309;747;2348;610;2077;175;689;195;611;370;1300
310090;201309;4542;14193;4031;13287;714;2631;2448;8073;3162;10704
310100;201309;3254;10372;2857;9765;399;1535;2027;6912;2426;8447
310110;201309;5806;16763;4924;15446;1128;4077;2663;8210;3791;12287
310120;201309;566;1895;540;1849;235;920;192;550;427;1470
310130;201309;452;1452;413;1391;112;429;197;624;309;1053
310140;201309;252;887;218;821;76;323;45;147;121;470
310150;201309;4597;14839;4218;14138;961;3693;2202;7309;3163;11002
310160;201309;6776;22464;5995;21079;1775;6962;2597;8929;4372;15891
310163;201309;677;2402;640;2331;166;705;272;957;438;1662
310170;201309;9552;28077;8837;26955;1875;6125;5246;16563;7121;22688
310180;201309;1799;5362;1459;4878;390;1494;696;2254;1086;3748
310190;201309;2493;8492;2269;8106;687;2743;315;1121;1002;3864
310200;201309;1833;6333;1555;5750;494;1973;505;1851;999;3824
310205;201309;934;3036;852;2855;182;639;500;1707;682;2346
310210;201309;2392;7814;2212;7527;405;1508;1489;5055;1894;6563
310220;201309;1246;3608;1008;3302;180;652;651;2121;831;2773
310230;201309;2828;9535;2477;8740;791;3228;891;2869;1682;6097
310240;201309;1010;3619;847;3276;149;651;446;1814;595;2465
310250;201309;954;3375;926;3330;191;793;572;1955;763;2748
310260;201309;3265;10863;2859;10024;916;3557;1056;3583;1972;7140
310270;201309;2271;7084;2089;6829;323;1201;1488;4887;1811;6088
310280;201309;2046;6167;1867;5872;681;2495;672;1933;1353;4428
310285;201309;2242;7958;2136;7808;276;954;1623;6149;1899;7103
310290;201309;1310;4218;1223;4083;400;1559;550;1623;950;3182
310300;201309;1834;6466;1743;6266;498;1984;951;3365;1449;5349
310310;201309;396;1127;291;908;58;198;149;460;207;658
310320;201309;349;1251;319;1175;87;353;145;532;232;885
310330;201309;479;1269;362;1058;43;156;211;567;254;723
310340;201309;8222;26742;7345;25284;1487;5387;4408;15662;5895;21049
310350;201309;13901;42251;11510;37784;4300;15305;2966;9796;7266;25101
310360;201309;421;1417;410;1397;106;419;245;790;351;1209
310370;201309;1390;5115;1335;5006;516;1983;528;2036;1044;4019
310375;201309;1266;3501;952;2956;149;562;524;1580;673;2142
310380;201309;393;1140;317;1027;143;518;116;336;259;854
310390;201309;475;1749;401;1575;122;526;65;230;187;756
310400;201309;9939;30488;7972;26893;2761;10251;2087;6887;4848;17138
310410;201309;1028;3363;681;2822;283;1268;126;501;409;1769
310420;201309;5543;16440;3221;10858;866;3286;494;1490;1360;4776
310430;201309;1576;5500;1336;4980;466;1849;348;1292;814;3141
310440;201309;621;1846;546;1729;159;578;203;597;362;1175
310445;201309;1157;4053;998;3775;149;634;645;2478;794;3112
310450;201309;4323;13176;3655;12152;855;2990;2096;7193;2951;10183
310460;201309;1499;4983;1319;4650;475;1814;307;1143;782;2957
310470;201309;3709;9860;3150;9166;326;1117;2490;7207;2816;8324
310480;201309;985;3214;892;3037;228;892;407;1308;635;2200
310490;201309;3226;11157;2811;10342;976;3875;987;3683;1963;7558
310500;201309;1437;5146;1337;4930;452;1818;491;1776;943;3594
310510;201309;2474;8309;2167;7601;852;3260;483;1595;1335;4855
310520;201309;1253;3665;1117;3436;94;316;741;2294;835;2610
310530;201309;825;2697;548;1979;129;519;92;318;221;837
310540;201309;3612;12158;3356;11773;1186;4413;1240;4422;2426;8835
310550;201309;1113;3522;952;3248;324;1271;323;1025;647;2296
310560;201309;15628;50238;13641;46305;4681;17630;4547;14671;9228;32301
310570;201309;1264;3998;1190;3894;177;677;868;2788;1045;3465
310590;201309;4063;12249;3262;10655;714;2694;1177;3623;1891;6317
310600;201309;1606;5512;1535;5345;537;2084;511;1662;1048;3746
310610;201309;548;1920;505;1823;163;698;174;557;337;1255
310620;201309;183163;595194;150927;527777;43344;168786;56823;189983;100167;358769
310630;201309;4050;13625;3849;13237;925;3638;2295;7594;3220;11232
310640;201309;1431;4508;1170;4040;387;1456;366;1198;753;2654
310650;201309;2772;9333;2331;8609;463;1882;1313;4952;1776;6834
310660;201309;1262;4055;1133;3869;205;813;799;2656;1004;3469
310665;201309;1145;3682;1064;3568;203;732;701;2387;904;3119
310670;201309;55090;177236;51167;168208;16150;56301;21749;70054;37899;126355
310680;201309;799;2451;735;2351;164;581;411;1281;575;1862
310690;201309;1184;4135;993;3709;294;1294;246;853;540;2147
310700;201309;512;1446;438;1334;114;401;220;630;334;1031
310710;201309;7281;24369;5985;22424;1394;5700;2896;11205;4290;16905
310720;201309;824;2613;754;2495;228;859;349;1069;577;1928
310730;201309;9221;30087;8590;29083;2014;7428;5121;17360;7135;24788
310740;201309;4914;17187;4269;15799;1677;6742;1024;3613;2701;10355
310750;201309;1557;4162;1303;3817;254;788;818;2393;1072;3181
310760;201309;607;1969;532;1837;138;512;231;788;369;1300
310770;201309;672;2578;665;2567;224;914;335;1301;559;2215
310780;201309;3544;10516;3252;10021;471;1414;2249;7069;2720;8483
310790;201309;1668;5568;1561;5399;493;1765;793;2818;1286;4583
310800;201309;3004;10016;2467;8907;1074;4208;383;1363;1457;5571
310810;201309;1505;4286;1400;4115;370;1218;678;1906;1048;3124
310820;201309;1449;4250;1091;3623;331;1193;352;1121;683;2314
310825;201309;2284;8137;1919;7500;176;899;1417;5484;1593;6383
310830;201309;1457;5074;1249;4637;483;1930;380;1363;863;3293
310840;201309;2179;7473;1995;7093;780;3047;556;1835;1336;4882
310850;201309;1472;4645;1277;4378;233;922;855;2873;1088;3795
310855;201309;3030;10164;2766;9733;765;2829;1460;5318;2225;8147
310860;201309;7597;24544;6854;23279;1240;4423;4013;14066;5253;18489
310870;201309;993;2962;864;2726;210;729;384;1193;594;1922
310880;201309;1233;3897;941;3342;202;812;445;1568;647;2380
310890;201309;2671;8734;2116;7638;663;2688;460;1552;1123;4240
310900;201309;4104;14223;3660;13283;1165;4666;1416;4944;2581;9610
310910;201309;1870;5647;1438;4846;431;1619;379;1244;810;2863
310920;201309;1824;5833;1503;5357;410;1664;718;2555;1128;4219
310925;201309;921;3135;833;2978;320;1259;246;869;566;2128
310930;201309;5066;15707;4304;14480;1007;3553;2381;8219;3388;11772
310940;201309;6131;18662;5355;17484;1068;3908;2985;9697;4053;13605
310945;201309;1250;3644;1013;3311;241;912;541;1687;782;2599
310950;201309;1813;6357;1534;5777;632;2612;415;1471;1047;4083
310960;201309;443;1544;393;1446;139;559;133;494;272;1053
310970;201309;1454;5209;1117;4262;444;1838;128;436;572;2274
310980;201309;448;1198;320;965;62;223;142;380;204;603
310990;201309;1122;3941;982;3662;224;953;357;1245;581;2198
311000;201309;4578;16258;4091;15213;1354;5592;1427;5074;2781;10666
311010;201309;943;3102;835;2902;270;1006;380;1282;650;2288
311020;201309;867;2788;748;2588;87;356;486;1657;573;2013
311030;201309;1690;5423;1426;4853;491;1856;508;1540;999;3396
311040;201309;479;1657;415;1480;131;484;108;371;239;855
311050;201309;2542;8320;2134;7479;713;2715;802;2810;1515;5525
311060;201309;2219;7184;1853;6378;556;2046;433;1450;989;3496
311070;201309;1702;6163;1501;5733;468;2011;462;1734;930;3745
311080;201309;1193;3272;1071;3086;170;552;703;2043;873;2595
311090;201309;1628;6354;1434;5945;525;2435;323;1293;848;3728
311100;201309;2261;8128;2046;7671;970;3775;489;1859;1459;5634
311110;201309;3665;9264;2813;8125;652;2145;1470;4098;2122;6243
311115;201309;1066;3371;925;3154;120;503;616;2121;736;2624
311120;201309;8263;25002;7016;22755;2472;8984;2045;6185;4517;15169
311130;201309;2375;7366;1934;6791;678;2713;777;2597;1455;5310
311140;201309;1219;3641;1056;3441;196;751;714;2270;910;3021
311150;201309;2402;8116;2222;7828;480;1684;1328;4880;1808;6564
311160;201309;4795;16447;4116;15319;1510;5998;1336;4921;2846;10919
311170;201309;745;2387;605;2114;68;273;381;1377;449;1650
311180;201309;1557;4426;1130;3571;358;1241;226;622;584;1863
311190;201309;1084;3341;920;2988;232;861;404;1250;636;2111
311200;201309;2498;7844;2182;7192;946;3407;512;1512;1458;4919
311205;201309;1173;3897;1049;3650;266;1054;399;1442;665;2496
311210;201309;897;2988;832;2884;159;545;580;2070;739;2615
311220;201309;895;2938;721;2541;190;702;245;857;435;1559
311230;201309;8738;27293;7561;25275;1683;6160;3928;13446;5611;19606
311240;201309;1326;4175;1117;3815;387;1479;320;1033;707;2512
311250;201309;1306;4428;1185;4216;365;1424;378;1201;743;2625
311260;201309;2901;8051;2192;6769;717;2426;647;1888;1364;4314
311265;201309;1294;3583;1033;3243;149;584;735;2285;884;2869
311270;201309;3308;11283;3000;10871;613;2582;1912;6815;2525;9397
311280;201309;1347;3845;1043;3309;288;1011;323;988;611;1999
311290;201309;2283;7626;2114;7261;404;1365;1228;4415;1632;5780
311300;201309;4952;16934;4550;16327;763;3118;2946;10618;3709;13736
311310;201309;486;1756;467;1722;128;562;174;580;302;1142
311320;201309;3966;13611;3468;12475;1018;4124;1129;3827;2147;7951
311330;201309;5385;16958;4691;15870;1740;6322;1694;5691;3434;12013
311340;201309;11823;39230;10923;37478;4096;15176;3124;10649;7220;25825
311350;201309;2226;6851;1936;6351;477;1846;878;2739;1355;4585
311360;201309;1306;3757;1044;3401;476;1628;287;961;763;2589
311370;201309;4371;13551;3958;12829;1055;4142;1694;5206;2749;9348
311380;201309;456;1562;390;1430;138;571;113;371;251;942
311390;201309;1910;7270;1834;7107;811;3467;548;2026;1359;5493
311400;201309;1674;5698;1551;5475;480;1922;656;2125;1136;4047
311410;201309;1983;7319;1864;7147;692;2837;843;3253;1535;6090
311420;201309;2198;7893;2003;7409;779;3054;428;1419;1207;4473
311430;201309;3737;12098;2912;10249;713;2768;563;1920;1276;4688
311440;201309;2147;7706;1826;7187;858;3727;438;1688;1296;5415
311450;201309;2361;8557;2105;7971;796;3237;615;2243;1411;5480
311455;201309;1523;4249;1349;3991;297;999;756;2177;1053;3176
311460;201309;598;2028;488;1785;129;583;123;429;252;1012
311470;201309;582;1896;475;1671;144;594;142;463;286;1057
311480;201309;776;2283;752;2241;237;754;355;1004;592;1758
311490;201309;309;1259;298;1217;108;458;100;412;208;870
311500;201309;496;1544;404;1359;168;617;126;411;294;1028
311510;201309;3037;9744;2557;8831;1000;3862;663;2142;1663;6004
311520;201309;683;2371;648;2298;258;985;246;848;504;1833
311530;201309;10243;28533;7319;23150;2235;8329;2047;6095;4282;14424
311535;201309;672;2130;507;1786;139;563;117;394;256;957
311540;201309;687;2539;656;2489;243;945;293;1116;536;2061
311545;201309;2010;6682;1950;6579;371;1387;1292;4345;1663;5732
311547;201309;1634;4676;1401;4309;155;520;953;2953;1108;3473
311550;201309;3217;10854;2878;10194;1018;4028;896;3088;1914;7116
311560;201309;252;698;233;674;63;206;132;361;195;567
311570;201309;1916;5026;1678;4765;133;399;1430;4095;1563;4494
311580;201309;2060;4926;1883;4721;601;1459;1069;2752;1670;4211
311590;201309;351;1182;312;1125;92;391;83;294;175;685
311600;201309;1307;4013;1138;3789;245;825;660;2325;905;3150
311610;201309;3520;12381;3269;11970;934;3398;1635;6453;2569;9851
311615;201309;2535;8683;2265;8227;294;1147;1609;5942;1903;7089
311620;201309;438;1448;394;1383;112;467;189;620;301;1087
311630;201309;1445;4380;1237;3982;316;1019;626;2051;942;3070
311640;201309;871;2740;743;2531;101;376;561;1907;662;2283
311650;201309;2406;7089;2023;6458;332;1212;1192;3853;1524;5065
311660;201309;2490;9027;2248;8441;698;2940;492;1607;1190;4547
311670;201309;1325;4285;1181;4016;471;1774;444;1440;915;3214
311680;201309;2225;7191;1900;6736;463;1762;1084;3926;1547;5688
311690;201309;502;1435;434;1362;85;298;275;849;360;1147
311700;201309;2113;6353;1907;6053;210;838;1448;4511;1658;5349
311710;201309;1604;5193;1305;4632;584;2262;353;1222;937;3484
311720;201309;399;1396;377;1357;80;288;244;873;324;1161
311730;201309;4650;13014;3142;10276;984;3543;1105;3377;2089;6920
311740;201309;1004;2932;878;2783;387;1221;375;1269;762;2490
311750;201309;3753;13048;3521;12726;623;2527;2345;8476;2968;11003
311760;201309;788;2781;734;2657;258;1078;239;735;497;1813
311770;201309;2574;8332;2147;7577;653;2573;704;2402;1357;4975
311780;201309;950;3675;821;3330;293;1323;112;436;405;1759
311783;201309;2031;6835;1823;6448;211;926;1202;4348;1413;5274
311787;201309;679;2379;513;1897;120;464;108;357;228;821
311790;201309;1197;4020;1006;3613;302;1167;220;765;522;1932
311800;201309;3838;13504;2712;9894;758;2973;246;725;1004;3698
311810;201309;1024;3504;993;3447;41;201;871;2974;912;3175
311820;201309;813;2734;699;2475;242;974;305;981;547;1955
311830;201309;10156;37328;9400;35383;3979;15743;2110;7865;6089;23608
311840;201309;3372;10281;2892;9541;1028;3693;1048;3378;2076;7071
311850;201309;308;957;267;891;71;257;124;410;195;667
311860;201309;54482;179311;48739;167941;15284;57249;19830;66542;35114;123791
311870;201309;2266;6996;1878;6250;507;1930;656;2064;1163;3994
311880;201309;6711;21234;6241;20623;937;3213;4470;15255;5407;18468
311890;201309;1568;5084;1337;4593;437;1654;524;1739;961;3393
311900;201309;783;2501;707;2389;159;549;426;1505;585;2054
311910;201309;4627;14032;3803;12857;1212;4461;1516;5180;2728;9641
311920;201309;2003;6755;1756;6399;218;919;1252;4513;1470;5432
311930;201309;4669;14481;4227;13743;1603;5656;1361;4410;2964;10066
311940;201309;13212;41887;11691;38733;4217;15271;3045;9741;7262;25012
311950;201309;2192;6759;1930;6430;151;515;1608;5416;1759;5931
311960;201309;366;1325;335;1258;125;502;112;405;237;907
311970;201309;453;1682;403;1578;148;628;64;235;212;863
311980;201309;740;2115;576;1870;137;472;267;899;404;1371
311990;201309;463;1487;432;1433;192;673;124;387;316;1060
311995;201309;997;3136;785;2673;234;886;220;646;454;1532
312000;201309;670;2163;643;2122;118;453;382;1254;500;1707
312010;201309;1021;3325;935;3166;204;753;427;1436;631;2189
312015;201309;1547;4906;1354;4573;207;847;830;2794;1037;3641
312020;201309;900;2995;809;2865;227;902;421;1454;648;2356
312030;201309;1734;5389;1570;5177;298;1121;1080;3487;1378;4608
312040;201309;696;2729;640;2576;256;1117;169;669;425;1786
312050;201309;1483;5200;1282;4749;408;1675;290;1027;698;2702
312060;201309;745;2335;674;2249;217;794;373;1204;590;1998
312070;201309;911;2908;620;2253;178;712;222;782;400;1494
312080;201309;2600;7445;2058;6572;515;1992;925;2669;1440;4661
312083;201309;888;2708;763;2528;96;380;487;1599;583;1979
312087;201309;2249;7071;2022;6766;411;1438;1320;4494;1731;5932
312090;201309;9609;31968;8880;30685;2787;10746;3694;12176;6481;22922
312100;201309;1342;4630;1205;4417;278;1147;650;2435;928;3582
312110;201309;1153;4222;1038;3974;393;1644;198;691;591;2335
312120;201309;879;3124;798;2940;267;1121;201;636;468;1757
312125;201309;1147;3804;1025;3519;276;1052;413;1395;689;2447
312130;201309;772;2429;638;2148;174;666;234;748;408;1414
312140;201309;1242;4006;1068;3586;266;957;413;1310;679;2267
312150;201309;589;1721;517;1584;76;282;322;947;398;1229
312160;201309;7790;27571;7212;26359;2417;9618;2613;9698;5030;19316
312170;201309;1002;3117;920;2953;158;547;571;1864;729;2411
312180;201309;1566;5012;1477;4871;469;1622;591;1950;1060;3572
312190;201309;624;2122;502;1883;210;880;97;332;307;1212
312200;201309;4487;14184;3970;13243;566;2018;2677;8977;3243;10995
312210;201309;1144;3240;929;2921;247;871;421;1271;668;2142
312220;201309;1835;6185;1670;5992;304;1114;1177;4421;1481;5535
312230;201309;17321;59481;14892;54379;7226;28017;2621;9828;9847;37845
312235;201309;1736;5079;1436;4594;206;793;947;3033;1153;3826
312240;201309;1096;3823;942;3495;296;1169;313;1161;609;2330
312245;201309;2352;7033;2067;6635;179;518;1688;5565;1867;6083
312247;201309;874;2678;692;2395;216;811;337;1200;553;2011
312250;201309;1115;3402;999;3200;217;783;507;1584;724;2367
312260;201309;885;3000;773;2852;114;524;543;1971;657;2495
312270;201309;775;2532;677;2334;185;771;221;638;406;1409
312280;201309;466;1626;424;1518;179;690;48;163;227;853
312290;201309;726;2590;680;2525;314;1292;133;495;447;1787
312300;201309;1063;3623;917;3289;309;1172;124;388;433;1560
312310;201309;921;3611;836;3391;277;1223;338;1332;615;2555
312320;201309;2390;6873;1983;6092;570;2017;582;1510;1152;3527
312330;201309;1097;3468;1004;3325;360;1346;418;1355;778;2701
312340;201309;307;829;287;799;54;200;198;505;252;705
312350;201309;368;984;349;958;51;165;275;719;326;884
312352;201309;1589;5412;1491;5271;508;1837;783;2838;1291;4675
312360;201309;3586;12442;3158;11529;1079;4234;740;2678;1819;6912
312370;201309;1620;5425;1504;5217;516;1992;559;1860;1075;3852
312380;201309;1925;5831;1797;5637;280;955;1211;3900;1491;4855
312385;201309;1174;3833;1117;3727;166;669;773;2486;939;3155
312390;201309;2007;6923;1773;6437;606;2374;392;1372;998;3746
312400;201309;3293;11230;3046;10759;1042;3789;1367;4990;2409;8779
312410;201309;10246;35327;9260;33271;2969;11588;3112;10888;6081;22476
312420;201309;3922;12993;3748;12788;702;2466;2592;9086;3294;11552
312430;201309;8323;25527;7387;24123;1450;4987;4643;15676;6093;20663
312440;201309;550;1881;490;1765;174;668;176;618;350;1286
312450;201309;1124;4278;1056;4126;505;1967;325;1302;830;3269
312460;201309;384;1211;344;1161;92;366;164;514;256;880
312470;201309;729;2136;505;1679;140;540;100;321;240;861
312480;201309;1259;4003;1098;3811;421;1527;447;1536;868;3063
312490;201309;2307;6157;1851;5560;300;1083;1101;3192;1401;4275
312500;201309;588;2123;556;2065;161;694;272;974;433;1668
312510;201309;1854;6668;1664;6218;507;2156;534;1788;1041;3944
312520;201309;374;1313;332;1221;120;470;110;409;230;879
312530;201309;556;1881;530;1824;111;456;285;923;396;1379
312540;201309;1450;4800;1217;4333;227;907;700;2447;927;3354
312550;201309;584;1982;541;1877;77;313;340;1140;417;1453
312560;201309;2066;5735;1846;5444;258;839;1345;4020;1603;4859
312570;201309;2619;8305;2328;7755;775;2789;698;2238;1473;5027
312580;201309;517;1781;422;1588;113;495;171;606;284;1101
312590;201309;1807;6313;1596;5838;556;2295;521;1725;1077;4020
312595;201309;1989;6920;1789;6430;424;1635;929;3293;1353;4928
312600;201309;757;2818;700;2687;226;972;254;909;480;1881
312610;201309;8361;26917;7237;24660;2755;10119;2050;6731;4805;16850
312620;201309;1970;5894;1539;5343;101;328;1287;4651;1388;4979
312630;201309;488;1678;457;1621;129;525;199;666;328;1191
312640;201309;558;1899;469;1704;118;497;190;639;308;1136
312650;201309;2301;7033;1665;5797;195;817;888;3047;1083;3864
312660;201309;1208;3484;1045;3266;209;781;637;1925;846;2706
312670;201309;5837;18759;5482;18192;1139;4427;3292;10681;4431;15108
312675;201309;1427;4656;1291;4382;271;1007;680;2331;951;3338
312680;201309;1689;5270;1508;4954;259;980;887;2947;1146;3927
312690;201309;2374;6686;1994;6154;420;1523;1089;3216;1509;4739
312695;201309;878;3204;826;3127;145;562;549;2135;694;2697
312700;201309;2138;6410;1646;5443;346;1318;826;2676;1172;3994
312705;201309;1363;4175;1212;3969;209;714;817;2695;1026;3409
312707;201309;1802;5664;1518;5181;320;1253;764;2589;1084;3842
312710;201309;7812;22808;5970;19518;2383;8661;1387;4193;3770;12854
312720;201309;753;2581;683;2446;204;811;268;898;472;1709
312730;201309;1838;4791;1435;4341;224;793;912;2763;1136;3556
312733;201309;1737;4806;1398;4182;131;487;981;2831;1112;3318
312735;201309;855;2657;759;2503;289;1000;317;1050;606;2050
312737;201309;986;2474;727;2122;174;532;384;1175;558;1707
312738;201309;498;1639;404;1461;146;622;148;474;294;1096
312740;201309;492;1430;337;1223;121;483;93;330;214;813
312750;201309;1272;4760;1220;4654;342;1449;565;2129;907;3578
312760;201309;2366;7872;1907;6979;642;2609;451;1662;1093;4271
312770;201309;43021;121845;33972;108128;10446;36129;11114;35338;21560;71467
312780;201309;2542;9419;2289;8975;510;2165;1296;5243;1806;7408
312790;201309;333;943;238;776;75;264;70;210;145;474
312800;201309;4978;17459;4434;16310;1499;5964;1380;5155;2879;11119
312810;201309;2138;6736;1656;5936;627;2456;383;1309;1010;3765
312820;201309;2032;6341;1931;6158;279;1065;1251;3843;1530;4908
312825;201309;1503;4196;1335;3985;144;469;1060;3153;1204;3622
312830;201309;2623;8616;1954;7265;641;2680;266;916;907;3596
312840;201309;1120;3834;949;3498;251;1063;345;1197;596;2260
312850;201309;679;2283;595;2107;193;779;187;639;380;1418
312860;201309;1311;3868;1021;3429;363;1423;352;1048;715;2471
312870;201309;5514;17780;4341;15558;1349;5473;1194;4050;2543;9523
312880;201309;1111;3450;941;3157;298;1141;377;1158;675;2299
312890;201309;1527;4827;1229;4279;458;1780;402;1331;860;3111
312900;201309;1321;4591;1289;4548;469;1681;614;2225;1083;3906
312910;201309;1452;3473;1177;3108;338;1068;530;1284;868;2352
312920;201309;961;3206;850;3034;305;1207;328;1128;633;2335
312930;201309;2139;6572;1931;6256;451;1575;1012;3337;1463;4912
312940;201309;907;3129;813;2943;246;1039;249;836;495;1875
312950;201309;3402;9851;2790;8935;993;3468;1120;3578;2113;7046
312960;201309;1865;5858;1680;5606;234;788;1243;4253;1477;5041
312965;201309;1705;5688;1498;5310;357;1367;807;2924;1164;4291
312970;201309;1110;3893;998;3741;444;1862;172;638;616;2500
312980;201309;20367;73147;19652;71404;7905;30634;7116;25147;15021;55781
312990;201309;385;1219;302;1067;118;469;87;293;205;762
313000;201309;503;1778;465;1706;156;676;135;428;291;1104
313005;201309;2527;8472;2259;8019;353;1440;1476;5211;1829;6651
313010;201309;3859;13301;3475;12622;1122;4471;1343;4593;2465;9064
313020;201309;1034;3582;947;3390;317;1294;324;1021;641;2315
313030;201309;1540;4466;1252;4060;345;1266;652;2009;997;3275
313040;201309;950;3406;808;2988;213;867;205;723;418;1590
313050;201309;1799;6068;1525;5622;516;2093;510;1800;1026;3893
313055;201309;1427;4956;1346;4835;142;512;1024;3802;1166;4314
313060;201309;916;3273;868;3172;419;1578;146;533;565;2111
313065;201309;1882;6456;1761;6275;265;1099;1288;4528;1553;5627
313070;201309;1148;3555;988;3256;264;1036;507;1559;771;2595
313080;201309;449;1464;374;1316;121;486;96;279;217;765
313090;201309;5056;15951;4827;15555;848;2970;3223;10517;4071;13487
313100;201309;1066;3522;999;3421;176;681;685;2297;861;2978
313110;201309;1649;5070;1321;4447;354;1417;512;1584;866;3001
313115;201309;2820;10178;2692;9908;929;3794;1145;3966;2074;7760
313120;201309;3735;11045;3214;10264;1179;3985;1313;4264;2492;8249
313130;201309;25370;83187;23156;78509;7204;27103;8390;26966;15594;54069
313140;201309;740;1964;547;1652;55;205;341;1007;396;1212
313150;201309;1629;5206;1481;4940;662;2279;408;1421;1070;3700
313160;201309;1159;3568;1047;3396;242;918;597;1844;839;2762
313170;201309;9584;35938;8904;34219;3653;14625;1909;7397;5562;22022
313180;201309;2641;7159;2061;6404;671;2347;689;2070;1360;4417
313190;201309;3383;12805;3253;12490;971;3938;1347;5186;2318;9124
313200;201309;1466;4721;1313;4476;209;871;826;2797;1035;3668
313210;201309;4513;14684;3888;13826;988;3967;2005;7036;2993;11003
313220;201309;1179;3717;970;3291;283;1099;238;709;521;1808
313230;201309;2485;8943;2340;8720;430;1695;1469;5676;1899;7371
313240;201309;7526;26850;6663;25135;2093;8563;2609;9841;4702;18404
313250;201309;7523;24419;6970;23596;1066;3597;4676;16451;5742;20048
313260;201309;586;1913;499;1732;152;601;137;447;289;1048
313270;201309;5334;16359;4892;15681;935;3157;3173;10330;4108;13487
313280;201309;510;1773;443;1614;114;483;162;566;276;1049
313290;201309;1027;3782;874;3451;284;1211;221;800;505;2011
313300;201309;1920;6731;1687;6146;560;2206;417;1425;977;3631
313310;201309;1035;3736;952;3553;289;1224;222;772;511;1996
313320;201309;2330;7325;2002;6742;471;1700;844;2848;1315;4548
313330;201309;3825;12928;3456;12220;774;3103;1665;5881;2439;8984
313340;201309;2151;5303;1691;4650;375;1117;955;2554;1330;3671
313350;201309;3286;10487;2575;8873;726;2706;497;1544;1223;4250
313360;201309;1180;3711;919;3195;325;1316;369;1139;694;2455
313370;201309;1424;5077;1351;4866;304;1266;583;1934;887;3200
313375;201309;1947;5351;1350;4498;323;1296;593;1956;916;3252
313380;201309;6556;22992;5728;21151;2362;9334;1456;5076;3818;14410
313390;201309;882;3318;847;3256;139;637;544;2046;683;2683
313400;201309;3671;11111;3397;10778;441;1501;2593;8324;3034;9825
313410;201309;1345;3952;1155;3689;253;898;692;2201;945;3099
313420;201309;18676;47596;12251;35941;3127;10445;3082;8655;6209;19100
313430;201309;1286;4301;1162;4080;384;1497;406;1374;790;2871
313440;201309;6381;15744;4912;14044;793;2466;3466;9949;4259;12415
313450;201309;693;2126;582;1905;161;655;203;581;364;1236
313460;201309;2636;9567;2385;9100;891;3675;717;2613;1608;6288
313470;201309;3378;9680;3231;9510;383;1037;2639;7980;3022;9017
313480;201309;1117;3405;863;2939;183;710;368;1205;551;1915
313490;201309;1339;4777;1086;4292;463;1807;222;915;685;2722
313500;201309;431;1411;410;1374;100;382;239;780;339;1162
313505;201309;8659;26183;8192;25605;551;1366;7226;23371;7777;24737
313507;201309;1275;3934;1153;3745;270;996;650;2128;920;3124
313510;201309;15605;47660;14138;45809;2557;8698;9758;32278;12315;40976
313520;201309;15703;48972;13634;45609;2055;8015;9046;30142;11101;38157
313530;201309;521;1863;461;1713;73;311;199;701;272;1012
313535;201309;2488;7638;2238;7224;396;1377;1401;4585;1797;5962
313540;201309;1143;3670;932;3155;288;1051;248;771;536;1822
313545;201309;1359;5095;1215;4839;237;1111;751;2901;988;4012
313550;201309;1906;6693;1839;6550;513;1996;970;3330;1483;5326
313560;201309;2264;5764;2017;5477;231;615;1580;4449;1811;5064
313570;201309;786;2981;700;2799;274;1200;257;987;531;2187
313580;201309;5999;17611;5355;16758;704;2348;4037;12765;4741;15113
313590;201309;1055;3247;870;3030;348;1225;447;1621;795;2846
313600;201309;3795;11845;3390;11181;662;2412;2024;6765;2686;9177
313610;201309;1144;3667;991;3354;282;1048;398;1323;680;2371
313620;201309;7381;25214;6967;24313;2452;9100;2316;7942;4768;17042
313630;201309;8263;26691;7309;25257;2394;9054;2519;9061;4913;18115
313640;201309;832;2716;736;2585;278;1048;280;976;558;2024
313650;201309;2272;7595;2027;7188;306;1131;1453;5275;1759;6406
313652;201309;1002;3678;924;3510;180;730;547;2095;727;2825
313655;201309;939;3231;799;2997;207;891;465;1689;672;2580
313657;201309;1091;3821;1039;3725;172;807;656;2118;828;2925
313660;201309;870;3120;806;3006;228;986;409;1449;637;2435
313665;201309;3506;11934;3288;11468;909;3587;1492;4970;2401;8557
313670;201309;51530;154252;37495;130343;12789;48459;11590;39268;24379;87727
313680;201309;1104;3358;980;3167;125;424;700;2289;825;2713
313690;201309;894;3284;832;3174;237;913;341;1361;578;2274
313695;201309;1466;4963;1272;4653;196;844;895;3243;1091;4087
313700;201309;3821;13068;3271;12312;499;1999;2327;8863;2826;10862
313710;201309;1374;3949;1173;3663;376;1304;562;1680;938;2984
313720;201309;5159;17762;4526;16389;1306;5285;1409;4612;2715;9897
313730;201309;1240;3545;1016;3257;145;506;686;2227;831;2733
313740;201309;2019;7492;1680;6574;625;2740;221;801;846;3541
313750;201309;2901;9116;2579;8491;856;3092;703;2121;1559;5213
313753;201309;1803;5607;1549;5162;488;1745;611;2061;1099;3806
313760;201309;4478;15256;3876;13968;1351;5414;1129;3849;2480;9263
313770;201309;3601;12404;3433;12008;1258;4672;1011;3547;2269;8219
313780;201309;3812;11236;3116;10177;904;3346;1309;4147;2213;7493
313790;201309;549;1952;532;1923;111;428;311;1137;422;1565
313800;201309;1241;3615;1114;3408;191;672;690;2096;881;2768
313810;201309;1455;4588;1399;4502;262;874;912;2996;1174;3870
313820;201309;12752;38532;10599;34591;3348;12092;3579;11655;6927;23747
313830;201309;476;1694;412;1552;150;637;122;438;272;1075
313835;201309;1057;3629;1018;3563;233;889;563;1972;796;2861
313840;201309;7239;22594;6261;20993;1976;7432;2126;6859;4102;14291
313850;201309;1240;3574;1134;3386;256;903;640;1802;896;2705
313860;201309;2558;8216;2238;7535;701;2618;529;1620;1230;4238
313862;201309;989;2830;719;2384;234;850;192;622;426;1472
313865;201309;2190;7142;2054;6905;321;1249;1439;4767;1760;6016
313867;201309;999;3559;862;3265;307;1215;291;1127;598;2342
313868;201309;1502;5496;1372;5217;187;822;902;3440;1089;4262
313870;201309;913;2895;809;2720;225;880;350;1095;575;1975
313880;201309;2259;7381;2063;7095;504;2056;1050;3327;1554;5383
313890;201309;1972;5537;1698;5191;308;965;1078;3351;1386;4316
313900;201309;4564;17121;4303;16557;1723;7282;1156;4408;2879;11690
313910;201309;757;2639;650;2403;295;1192;122;416;417;1608
313920;201309;3554;11802;3318;11375;536;1875;2155;7716;2691;9591
313925;201309;2106;5741;1598;4810;143;502;1078;3216;1221;3718
313930;201309;5189;17550;4423;16220;856;3464;2573;9624;3429;13088
313940;201309;7773;27684;6778;26054;2565;10591;2376;9409;4941;20000
313950;201309;4665;14082;3975;12929;1288;4721;1319;4086;2607;8807
313960;201309;5828;16450;4935;15180;1733;5972;1309;4027;3042;9999
313970;201309;1471;4439;1251;4190;273;990;775;2615;1048;3605
313980;201309;1184;4035;1026;3736;323;1319;284;990;607;2309
313990;201309;1997;7726;1803;7287;698;3048;501;1907;1199;4955
314000;201309;7834;27775;7288;26701;2193;8823;3702;13370;5895;22193
314010;201309;1049;3152;881;2942;178;707;456;1456;634;2163
314015;201309;1579;6027;1460;5750;557;2307;423;1679;980;3986
314020;201309;484;1606;416;1454;155;596;125;410;280;1006
314030;201309;838;2751;672;2366;156;637;220;708;376;1345
314040;201309;658;2009;586;1882;190;663;292;900;482;1563
314050;201309;1877;6274;1578;5640;506;2021;438;1424;944;3445
314053;201309;1383;4841;1328;4768;241;832;944;3504;1185;4336
314055;201309;2195;6741;1985;6444;218;712;1487;4953;1705;5665
314060;201309;1075;3548;940;3298;145;601;572;1975;717;2576
314070;201309;3628;11972;2981;10605;946;3721;798;2699;1744;6420
314080;201309;1831;5864;1356;4838;324;1296;330;1078;654;2374
314085;201309;1812;6545;1588;6227;547;2397;586;2294;1133;4691
314090;201309;3448;12090;3156;11518;1070;4219;1171;4363;2241;8582
314100;201309;3447;9551;3039;8961;397;1193;2279;6853;2676;8046
314110;201309;4373;14814;3865;13719;1063;4318;1439;4721;2502;9039
314120;201309;996;2461;561;1781;204;746;142;417;346;1163
314130;201309;665;1986;415;1413;110;423;77;231;187;654
314140;201309;4960;15981;4526;15162;1129;4064;2248;7592;3377;11656
314150;201309;1678;4631;1351;4135;234;804;807;2445;1041;3249
314160;201309;2276;6414;1945;5992;180;616;1587;4922;1767;5538
314170;201309;1039;3346;900;3048;179;715;473;1514;652;2229
314180;201309;6360;21062;5825;20253;1682;6405;2640;9312;4322;15717
314190;201309;804;2611;715;2462;232;914;270;884;502;1798
314200;201309;3012;10050;2757;9587;459;1825;1830;6274;2289;8099
314210;201309;1923;6256;1736;5890;465;1700;825;2720;1290;4420
314220;201309;1689;5679;1455;5183;517;2043;365;1124;882;3167
314225;201309;1160;3641;1049;3483;66;178;943;3198;1009;3376
314230;201309;694;2472;645;2372;210;833;224;793;434;1626
314240;201309;1115;3625;1007;3450;259;872;598;2125;857;2997
314250;201309;502;1596;428;1451;157;594;140;424;297;1018
314260;201309;1293;4763;1240;4649;429;1707;512;1947;941;3654
314270;201309;2682;9536;2532;9262;357;1449;1677;6179;2034;7628
314280;201309;3179;9372;2356;7803;763;2914;652;1904;1415;4818
314290;201309;5276;15289;4563;14150;672;2251;3157;9841;3829;12092
314300;201309;1927;6662;1807;6380;641;2425;680;2335;1321;4760
314310;201309;6373;21002;5637;19428;2370;8707;1252;4164;3622;12871
314315;201309;964;3734;896;3599;164;741;520;2119;684;2860
314320;201309;3275;10301;2736;9536;1026;3911;928;3156;1954;7067
314330;201309;51929;173230;49366;168551;16136;59893;21868;73720;38004;133613
314340;201309;2277;6546;1344;4571;366;1420;177;410;543;1830
314345;201309;1276;4478;1142;4262;376;1457;544;2123;920;3580
314350;201309;1299;4105;1115;3791;482;1781;285;950;767;2731
314360;201309;694;2271;537;1963;170;720;127;430;297;1150
314370;201309;550;1997;518;1956;169;695;258;962;427;1657
314380;201309;1012;3237;813;2900;348;1297;224;806;572;2103
314390;201309;15010;46826;12626;42183;4275;15496;3699;12079;7974;27575
314400;201309;5283;15348;4371;14070;1255;3998;2556;8595;3811;12593
314410;201309;2477;8337;2214;7783;735;2898;834;2753;1569;5651
314420;201309;764;2291;631;2104;99;405;465;1524;564;1929
314430;201309;8066;24673;7262;23182;2556;8892;2250;7310;4806;16202
314435;201309;1154;3976;1050;3760;214;953;586;1986;800;2939
314437;201309;1155;3053;1036;2884;101;292;809;2260;910;2552
314440;201309;741;2075;520;1783;204;779;113;362;317;1141
314450;201309;1708;5199;1479;4872;479;1845;678;2078;1157;3923
314460;201309;4570;16264;4100;15209;1483;5991;781;2909;2264;8900
314465;201309;2355;7732;2167;7382;237;976;1630;5455;1867;6431
314467;201309;1077;3224;964;3040;419;1374;364;1175;783;2549
314470;201309;2353;7921;1850;6687;571;2372;407;1229;978;3601
314480;201309;7161;25324;5423;20520;1418;5777;554;1909;1972;7686
314490;201309;925;2936;804;2695;249;966;330;1033;579;1999
314500;201309;2760;8036;2247;7036;712;2481;760;2351;1472;4832
314505;201309;1752;5615;1660;5445;413;1491;922;3010;1335;4501
314510;201309;1542;4901;1290;4465;533;1960;352;1217;885;3177
314520;201309;3675;14538;3116;12968;1187;5366;576;2199;1763;7565
314530;201309;7157;26005;6591;25074;1266;5038;3963;15599;5229;20637
314535;201309;2660;7953;2400;7609;370;1340;1615;5137;1985;6477
314537;201309;1424;4438;1207;4050;274;1045;590;2037;864;3082
314540;201309;463;1459;404;1325;130;487;127;392;257;879
314545;201309;1338;4401;1213;4206;278;1056;629;2174;907;3230
314550;201309;507;1640;431;1528;153;628;111;369;264;997
314560;201309;5206;18981;4538;17192;1345;5562;1003;3733;2348;9295
314570;201309;373;1193;335;1114;100;360;159;505;259;865
314580;201309;453;1595;393;1476;154;647;101;361;255;1008
314585;201309;650;2363;546;2147;177;755;142;544;319;1299
314587;201309;1699;5632;1559;5356;275;1016;888;3054;1163;4070
314590;201309;4145;14711;3095;11779;808;3289;399;1372;1207;4661
314600;201309;2051;7243;1727;6659;680;2922;306;1086;986;4008
314610;201309;8098;29804;7621;28643;2650;10754;2356;8603;5006;19357
314620;201309;1629;5135;1528;5008;229;738;1137;3837;1366;4575
314625;201309;1496;4952;1459;4903;237;896;977;3306;1214;4202
314630;201309;5031;15350;4412;14320;659;2386;2986;9853;3645;12239
314640;201309;820;2416;707;2210;257;877;200;581;457;1458
314650;201309;1236;3903;1017;3463;282;1125;428;1310;710;2435
314655;201309;1682;5103;1316;4410;268;959;669;2238;937;3197
314660;201309;169;491;148;447;27;97;90;264;117;361
314670;201309;1418;4081;1181;3669;234;809;645;1975;879;2784
314675;201309;1898;5913;1695;5556;241;898;1097;3641;1338;4539
314690;201309;2717;8853;2321;8129;744;2962;693;2252;1437;5214
314700;201309;9757;38002;8874;36138;4247;18050;1973;8405;6220;26455
314710;201309;8042;26726;5785;21520;1537;6416;736;2529;2273;8945
314720;201309;2629;9016;2220;8198;736;3008;895;3239;1631;6247
314730;201309;2398;7752;2085;7293;752;2960;680;2236;1432;5196
314740;201309;2940;10226;2731;9820;926;3607;1000;3466;1926;7073
314750;201309;316;1076;294;1024;66;284;150;491;216;775
314760;201309;1835;6695;1420;5562;357;1605;261;852;618;2457
314770;201309;1188;3866;784;2760;118;486;107;303;225;789
314780;201309;297;852;227;761;88;325;84;275;172;600
314790;201309;13269;41804;10253;36275;4241;16953;2351;7735;6592;24688
314795;201309;1526;4741;1363;4478;153;668;1030;3237;1183;3905
314800;201309;16939;53040;14240;47623;5977;20994;2868;9806;8845;30800
314810;201309;12708;39385;10036;34405;3334;12866;2450;8281;5784;21147
314820;201309;1094;3143;777;2675;305;1156;232;729;537;1885
314830;201309;1656;5804;1452;5392;564;2287;495;1829;1059;4116
314840;201309;1134;4051;911;3711;184;875;540;2197;724;3072
314850;201309;2205;6579;1900;6094;407;1508;1040;3280;1447;4788
314860;201309;3248;11483;3012;11089;619;2545;1826;6714;2445;9259
314870;201309;5609;18725;5066;17967;874;3495;3391;12216;4265;15711
314875;201309;1656;5817;1622;5764;274;918;1250;4568;1524;5486
314880;201309;778;2397;711;2265;83;293;492;1562;575;1855
314890;201309;587;1869;433;1544;138;547;103;308;241;855
314900;201309;392;1262;320;1137;99;378;152;526;251;904
314910;201309;1658;5928;1471;5586;559;2330;315;1119;874;3449
314915;201309;2447;7870;2187;7505;230;939;1758;6005;1988;6944
314920;201309;651;1938;492;1699;103;406;224;726;327;1132
314930;201309;5058;17679;4450;16313;1565;6266;963;3482;2528;9748
314940;201309;409;1243;386;1201;86;272;211;652;297;924
314950;201309;362;1314;321;1223;102;447;62;204;164;651
314960;201309;780;2629;659;2374;214;840;169;576;383;1416
314970;201309;844;3076;757;2881;312;1296;192;690;504;1986
314980;201309;2213;6922;2017;6594;861;3006;294;917;1155;3923
314990;201309;3072;10160;2512;8866;981;3778;423;1329;1404;5107
314995;201309;1515;4940;1397;4772;292;1190;866;2828;1158;4018
315000;201309;974;3041;848;2870;168;672;533;1757;701;2429
315010;201309;475;1585;403;1426;134;554;143;447;277;1001
315015;201309;1800;5730;1687;5593;346;1209;1153;3943;1499;5152
315020;201309;730;2473;664;2347;199;802;259;819;458;1621
315030;201309;1005;3151;872;2903;353;1286;174;562;527;1848
315040;201309;920;2907;852;2797;114;418;607;1977;721;2395
315050;201309;1549;4802;1322;4400;489;1799;391;1244;880;3043
315053;201309;1114;3366;961;3118;274;1082;347;1027;621;2109
315057;201309;1884;6600;1553;6103;240;972;1000;4085;1240;5057
315060;201309;939;3252;785;2844;248;977;196;737;444;1714
315070;201309;645;1996;599;1925;147;518;353;1101;500;1619
315080;201309;3413;12074;3130;11486;895;3564;1419;5192;2314;8756
315090;201309;745;2745;668;2590;190;811;220;877;410;1688
315100;201309;1164;4110;946;3616;283;1200;250;914;533;2114
315110;201309;1618;5023;1427;4706;433;1530;577;1881;1010;3411
315120;201309;13611;33606;9922;28839;1966;6250;5239;16085;7205;22335
315130;201309;1779;6029;1609;5684;598;2350;441;1518;1039;3868
315140;201309;2339;8070;1951;7184;583;2497;542;1723;1125;4220
315150;201309;4558;13006;3542;11162;928;3360;1347;4063;2275;7423
315160;201309;1357;3914;1231;3742;257;877;714;2130;971;3007
315170;201309;1334;4104;1161;3864;288;1065;644;2189;932;3254
315180;201309;13065;42056;10443;36376;3210;12690;2588;8603;5798;21293
315190;201309;2344;6450;1916;5818;601;1974;855;2596;1456;4570
315200;201309;4405;15159;3691;13577;1200;4849;1016;3595;2216;8444
315210;201309;8286;26465;7285;24622;2857;10382;2172;7138;5029;17520
315213;201309;1102;3660;1068;3606;100;310;896;3118;996;3428
315217;201309;2654;9279;2278;8611;388;1641;1341;5107;1729;6748
315220;201309;9934;30133;8905;28756;1737;5802;5712;18838;7449;24640
315230;201309;2359;6558;2203;6372;143;399;1908;5604;2051;6003
315240;201309;3062;10483;2915;10231;634;2434;1713;6008;2347;8442
315250;201309;8577;28644;6735;25227;2409;10075;2098;7779;4507;17854
315260;201309;1050;3588;910;3267;372;1452;147;484;519;1936
315270;201309;865;3155;753;2908;260;1074;163;593;423;1667
315280;201309;3855;12185;3164;10587;1155;4097;792;2489;1947;6586
315290;201309;1316;3858;1040;3421;413;1508;180;582;593;2090
315300;201309;484;1451;395;1337;208;750;105;325;313;1075
315310;201309;1182;4072;1090;3922;153;623;733;2616;886;3239
315320;201309;798;2798;697;2653;248;998;290;1147;538;2145
315330;201309;833;3069;686;2746;296;1341;114;429;410;1770
315340;201309;4136;12264;3587;11418;710;2431;2080;6735;2790;9166
315350;201309;1810;5316;1538;4947;176;529;1203;4027;1379;4556
315360;201309;1655;5733;1365;4932;351;1349;443;1518;794;2867
315370;201309;617;1891;542;1777;132;491;295;942;427;1433
315380;201309;271;992;254;942;96;373;49;177;145;550
315390;201309;1932;6984;1672;6346;617;2511;356;1328;973;3839
315400;201309;4343;14068;4014;13422;1180;4224;1917;6527;3097;10751
315410;201309;1669;4795;1420;4376;314;1172;769;2254;1083;3426
315415;201309;1059;3674;989;3553;434;1595;387;1435;821;3030
315420;201309;1505;4823;1146;4154;355;1417;243;839;598;2256
315430;201309;3952;11100;3093;9669;811;2872;1155;3538;1966;6410
315440;201309;952;2993;875;2882;161;618;532;1761;693;2379
315445;201309;2103;6272;1806;5868;288;1062;1251;4094;1539;5156
315450;201309;2465;8082;2348;7911;456;1575;1585;5480;2041;7055
315460;201309;37920;130082;33982;121530;11678;45199;9232;31932;20910;77131
315470;201309;488;1580;456;1526;93;334;274;899;367;1233
315480;201309;1253;4161;938;3439;218;892;230;782;448;1674
315490;201309;3231;9416;2830;8868;558;2099;1660;5011;2218;7110
315500;201309;451;1489;306;1114;72;315;126;394;198;709
315510;201309;1456;4336;1263;4007;194;715;775;2417;969;3132
315520;201309;1133;3681;968;3459;189;763;605;2097;794;2860
315530;201309;490;1764;464;1721;228;889;137;486;365;1375
315540;201309;1278;3937;1012;3479;221;939;368;1224;589;2163
315550;201309;1618;4912;1420;4650;480;1728;619;2004;1099;3732
315560;201309;6952;23680;6444;22989;971;3890;4425;15775;5396;19665
315570;201309;2367;7614;2215;7377;434;1610;1385;4607;1819;6217
315580;201309;2661;8438;2181;7513;648;2634;787;2515;1435;5149
315590;201309;863;2591;807;2503;122;455;581;1772;703;2227
315600;201309;2533;9378;2151;8772;350;1569;1371;5789;1721;7358
315610;201309;965;2976;843;2709;227;864;293;790;520;1654
315620;201309;336;1209;329;1193;106;399;150;555;256;954
315630;201309;987;3227;850;2991;243;905;228;783;471;1688
315640;201309;731;2377;641;2186;240;943;187;573;427;1516
315645;201309;809;2703;718;2466;294;1105;151;484;445;1589
315650;201309;1796;5572;1689;5427;166;687;1298;4063;1464;4750
315660;201309;2616;7318;2395;7007;413;1332;1531;4446;1944;5778
315670;201309;11362;41528;10482;39736;4045;16510;3213;11901;7258;28411
315680;201309;2830;10157;2349;9211;922;3776;582;2404;1504;6180
315690;201309;3025;10073;2586;9265;969;3816;693;2455;1662;6271
315700;201309;7001;23249;6241;21671;1482;5854;3025;10067;4507;15921
315710;201309;1795;5481;1478;4973;241;966;840;2778;1081;3744
315720;201309;2894;9913;2661;9423;859;3450;955;3124;1814;6574
315725;201309;1613;5087;1309;4694;328;1170;811;2979;1139;4149
315727;201309;645;2108;582;1976;141;510;296;1003;437;1513
315730;201309;971;3105;879;2916;229;804;441;1499;670;2303
315733;201309;1125;3703;1036;3506;459;1634;323;1074;782;2708
315737;201309;1344;4247;1150;3915;153;580;715;2464;868;3044
315740;201309;1014;3357;884;3101;267;1078;360;1163;627;2241
315750;201309;1106;3454;996;3304;114;474;720;2315;834;2789
315760;201309;917;2724;897;2695;33;92;836;2535;869;2627
315765;201309;1430;4635;1339;4479;188;665;991;3361;1179;4026
315770;201309;1647;5396;1509;5095;474;1735;541;1764;1015;3499
315780;201309;26749;90261;25136;86807;9210;33565;8220;29062;17430;62627
315790;201309;3106;10985;2865;10464;343;1208;1910;7254;2253;8462
315800;201309;1524;6076;1281;5342;426;1940;222;889;648;2829
315810;201309;1453;4298;1260;3978;278;933;727;2238;1005;3171
315820;201309;3031;10247;2618;9635;671;2623;1406;5266;2077;7889
315830;201309;1475;5069;1348;4781;348;1413;424;1427;772;2840
315840;201309;668;1915;533;1633;108;365;152;441;260;806
315850;201309;1335;4843;1290;4740;400;1535;504;1822;904;3357
315860;201309;410;1553;351;1420;118;541;76;307;194;848
315870;201309;463;1427;398;1323;111;414;155;480;266;894
315880;201309;1068;2984;901;2777;273;961;406;1217;679;2178
315890;201309;1613;5682;1472;5462;424;1611;779;3045;1203;4656
315895;201309;4946;15929;4623;15298;1487;5409;1962;6314;3449;11723
315900;201309;753;2501;695;2395;212;856;334;1044;546;1900
315910;201309;598;2193;552;2097;236;925;204;763;440;1688
315920;201309;1241;3919;1015;3438;328;1223;366;1161;694;2384
315930;201309;1082;3130;918;2832;298;997;290;868;588;1865
315935;201309;1133;3919;1060;3757;359;1401;333;1133;692;2534
315940;201309;621;2066;577;1988;167;635;294;986;461;1621
315950;201309;1198;3819;1121;3668;334;1126;615;2051;949;3177
315960;201309;2846;10087;2349;9029;1121;4899;233;800;1354;5699
315970;201309;804;2327;656;2108;82;263;485;1611;567;1874
315980;201309;3942;10292;2868;8428;817;2770;913;2352;1730;5122
315990;201309;4271;13139;3776;12339;902;3446;2028;6466;2930;9912
316000;201309;562;1904;496;1779;239;926;125;424;364;1350
316010;201309;441;1647;395;1537;117;527;84;267;201;794
316020;201309;1165;3863;937;3470;180;739;536;2029;716;2768
316030;201309;3604;10487;2649;8929;416;1554;1426;4923;1842;6477
316040;201309;3376;10717;2438;8534;456;1799;345;954;801;2753
316045;201309;2054;6852;1921;6648;293;922;1365;5034;1658;5956
316050;201309;352;1185;318;1132;64;256;185;650;249;906
316060;201309;770;2393;639;2210;128;548;374;1225;502;1773
316070;201309;5924;20284;5519;19448;1861;7209;2333;7867;4194;15076
316080;201309;719;2733;649;2538;174;759;152;594;326;1353
316090;201309;596;1806;456;1517;124;482;122;363;246;845
316095;201309;1205;4141;1125;3976;262;950;707;2564;969;3514
316100;201309;2829;9871;2344;8621;760;3083;465;1618;1225;4701
316105;201309;878;2562;684;2263;175;632;309;1038;484;1670
316110;201309;12167;44189;11075;42111;1529;6596;7854;30312;9383;36908
316120;201309;1258;4502;1211;4401;409;1520;509;1893;918;3413
316130;201309;992;2578;786;2267;212;717;357;997;569;1714
316140;201309;1049;3212;827;2842;158;595;475;1660;633;2255
316150;201309;1260;4042;1201;3946;324;1240;618;1950;942;3190
316160;201309;1211;3769;1010;3358;142;524;602;2027;744;2551
316165;201309;881;2583;774;2406;165;587;424;1283;589;1870
316170;201309;1334;4099;1052;3542;246;962;426;1307;672;2269
316180;201309;1199;3955;1012;3602;306;1272;334;1096;640;2368
316190;201309;2598;8061;1492;5273;356;1358;284;854;640;2212
316200;201309;4120;13644;3303;12038;977;4139;933;3211;1910;7350
316210;201309;4915;16356;4586;15661;2160;7887;943;3202;3103;11089
316220;201309;636;2034;479;1750;151;618;77;301;228;919
316225;201309;1050;3193;943;3038;155;578;619;1949;774;2527
316230;201309;441;1367;366;1230;68;252;204;692;272;944
316240;201309;6075;20088;5359;19206;680;2370;4158;15257;4838;17627
316245;201309;2907;10678;2769;10467;273;1230;2179;8232;2452;9462
316250;201309;8770;28438;7796;26398;3369;12237;2043;6561;5412;18798
316255;201309;2304;7536;2062;7247;332;1120;1483;5361;1815;6481
316257;201309;1283;3776;1029;3318;301;1105;376;1112;677;2217
316260;201309;1771;5212;1381;4659;393;1467;739;2493;1132;3960
316265;201309;1163;3463;1036;3205;94;344;747;2271;841;2615
316270;201309;5132;16933;4808;16272;1505;5550;1985;6770;3490;12320
316280;201309;3227;11065;2917;10442;660;2638;1475;5275;2135;7913
316290;201309;3067;10394;2880;10036;799;3151;1270;4171;2069;7322
316292;201309;3690;12581;3406;12011;1039;4124;1414;4684;2453;8808
316294;201309;816;2746;527;2018;138;627;72;266;210;893
316295;201309;1899;6893;1776;6627;477;2049;859;2996;1336;5045
316300;201309;911;3029;821;2858;94;343;555;1999;649;2342
316310;201309;687;2235;531;1902;133;533;183;649;316;1182
316320;201309;550;1885;487;1791;136;554;126;442;262;996
316330;201309;942;2939;819;2714;165;551;470;1615;635;2166
316340;201309;1127;3757;1011;3527;367;1448;270;842;637;2290
316350;201309;1467;4924;1334;4693;285;1034;736;2750;1021;3784
316360;201309;757;2040;610;1845;80;246;459;1411;539;1657
316370;201309;4981;16830;4473;15775;1553;5868;1042;3752;2595;9620
316380;201309;1406;4064;1153;3677;147;520;776;2491;923;3011
316390;201309;883;2761;754;2534;277;1012;292;988;569;2000
316400;201309;1453;4957;1290;4654;367;1412;510;1896;877;3308
316410;201309;1190;4125;1119;4012;221;878;698;2502;919;3380
316420;201309;1973;6866;1837;6678;307;1234;1197;4433;1504;5667
316430;201309;901;2837;776;2622;255;944;277;900;532;1844
316440;201309;593;2044;532;1962;225;958;198;665;423;1623
316443;201309;683;2143;583;1937;152;562;205;651;357;1213
316447;201309;1304;4484;1247;4378;189;741;958;3333;1147;4074
316450;201309;2178;7827;1949;7357;500;1911;1064;4166;1564;6077
316460;201309;832;2688;783;2611;217;832;434;1363;651;2195
316470;201309;7446;25632;6111;22498;2205;9194;1752;6005;3957;15199
316480;201309;251;892;224;835;69;272;69;248;138;520
316490;201309;360;1187;342;1144;123;440;139;455;262;895
316500;201309;1059;3935;750;2981;211;902;56;205;267;1107
316510;201309;937;3452;852;3285;368;1474;265;1020;633;2494
316520;201309;1144;3688;971;3427;291;1204;355;1144;646;2348
316530;201309;1183;3943;1003;3548;288;1220;401;1231;689;2451
316540;201309;1008;3372;905;3187;274;1142;310;981;584;2123
316550;201309;1255;4381;1158;4224;255;1030;726;2648;981;3678
316553;201309;2199;8237;1867;7385;682;2897;388;1482;1070;4379
316555;201309;2595;9609;2374;9343;227;894;1893;7644;2120;8538
316556;201309;583;1709;485;1517;57;222;318;943;375;1165
316557;201309;871;3230;844;3182;339;1329;353;1317;692;2646
316560;201309;370;1270;307;1121;77;339;83;266;160;605
316570;201309;1375;4495;1262;4247;252;936;662;2205;914;3141
316580;201309;244;788;220;737;74;266;74;224;148;490
316590;201309;1334;4089;1127;3705;219;858;622;1974;841;2832
316600;201309;1157;3889;1048;3658;220;834;585;1987;805;2821
316610;201309;595;2266;556;2193;145;662;313;1206;458;1868
316620;201309;2097;7003;1921;6626;533;2009;876;3007;1409;5016
316630;201309;1459;5069;1318;4751;568;2155;381;1374;949;3529
316640;201309;254;856;228;804;69;286;88;279;157;565
316650;201309;923;3694;826;3519;202;869;451;2029;653;2898
316660;201309;136;420;118;389;32;133;45;125;77;258
316670;201309;1718;5308;1426;4708;540;2036;335;966;875;3002
316680;201309;1909;5886;1694;5548;234;797;1290;4284;1524;5081
316690;201309;1108;3852;1008;3678;395;1613;320;1112;715;2725
316695;201309;1255;3950;1119;3710;124;403;776;2687;900;3090
316700;201309;349;1200;324;1136;84;341;152;500;236;841
316710;201309;3383;13252;2981;12326;1058;4504;918;4013;1976;8517
316720;201309;19959;68969;17250;62805;6416;24640;4449;16087;10865;40727
316730;201309;428;1395;375;1280;99;379;187;590;286;969
316740;201309;739;2620;673;2494;280;1130;176;617;456;1747
316750;201309;414;1491;385;1422;122;520;136;458;258;978
316760;201309;3552;12286;3054;11726;1806;6970;856;3518;2662;10488
316770;201309;1462;4482;1303;4261;230;837;853;2852;1083;3689
316780;201309;686;2420;645;2338;277;1068;162;569;439;1637
316790;201309;828;2480;625;2127;181;718;226;732;407;1450
316800;201309;5961;20254;5455;19284;1216;5016;2870;9713;4086;14729
316805;201309;890;2416;846;2360;145;390;624;1798;769;2188
316810;201309;522;1662;492;1609;148;534;228;732;376;1266
316820;201309;366;1099;267;928;113;426;46;148;159;574
316830;201309;579;2154;558;2107;217;874;201;736;418;1610
316840;201309;3335;10020;2833;9150;856;3154;1144;3489;2000;6643
316850;201309;2065;6750;1921;6491;476;1794;1020;3393;1496;5187
316860;201309;23262;74653;21522;71387;6281;23130;9622;31722;15903;54852
316870;201309;6901;23744;6165;21937;2418;9249;1364;4717;3782;13966
316880;201309;879;3043;852;3001;369;1416;241;803;610;2219
316890;201309;1403;3741;1126;3363;503;1653;371;1056;874;2709
316900;201309;2595;8462;2345;7958;772;2927;743;2275;1515;5202
316905;201309;418;1504;387;1435;169;655;113;409;282;1064
316910;201309;684;2415;574;2186;159;644;247;959;406;1603
316920;201309;1490;4678;1206;4198;197;757;604;2088;801;2845
316930;201309;9433;33280;8333;30959;2669;11269;2236;7862;4905;19131
316935;201309;4739;14507;3547;12388;1280;4972;882;2904;2162;7876
316940;201309;6635;23268;5799;21455;1625;6717;1677;5930;3302;12647
316950;201309;1475;4501;1311;4280;224;855;848;2728;1072;3583
316960;201309;5191;13988;4462;13053;1015;3231;2619;7638;3634;10869
316970;201309;3463;11725;3282;11391;1386;5385;838;2680;2224;8065
316980;201309;914;2969;753;2702;368;1398;199;722;567;2120
316990;201309;9655;33155;8872;31378;3781;14454;1386;4706;5167;19160
317000;201309;2489;9349;2421;9260;286;877;2020;8088;2306;8965
317005;201309;2342;7874;2259;7760;433;1540;1590;5526;2023;7066
317010;201309;28214;80310;19520;64878;5917;21864;4910;16855;10827;38719
317020;201309;43243;133755;30944;107220;8773;33524;7112;23061;15885;56585
317030;201309;868;2525;732;2319;132;510;416;1303;548;1813
317040;201309;12533;39391;11315;37135;4336;14922;4079;13624;8415;28546
317043;201309;801;2301;676;2130;203;695;330;1020;533;1715
317047;201309;1142;3150;906;2757;170;591;436;1311;606;1902
317050;201309;1793;6585;1579;6080;494;2099;510;1873;1004;3972
317052;201309;2326;7805;2080;7432;344;1317;1445;5239;1789;6556
317057;201309;1739;5207;1380;4580;251;992;688;2260;939;3252
317060;201309;384;1166;291;956;84;317;109;331;193;648
317065;201309;1209;4142;1094;3944;159;640;786;2827;945;3467
317070;201309;9186;31280;7389;27252;2421;9866;1704;6328;4125;16194
317075;201309;1216;3945;1099;3733;423;1563;378;1206;801;2769
317080;201309;6779;20243;6291;19451;2104;7052;2440;7594;4544;14646
317090;201309;4718;16634;4435;16096;759;2887;2950;10903;3709;13790
317100;201309;3189;9656;2793;8990;956;3434;1153;3511;2109;6945
317103;201309;1964;7064;1674;6433;391;1814;742;2794;1133;4608
317107;201309;1268;4127;1127;3839;289;1140;543;1754;832;2894
317110;201309;718;2008;516;1633;147;564;191;534;338;1098
317115;201309;1040;3427;933;3194;139;500;614;2117;753;2617
317120;201309;12907;44839;11288;41034;4017;15522;4013;14384;8030;29906
317130;201309;8796;28882;8035;27480;2325;8946;3457;11448;5782;20394
317140;201309;639;2288;598;2196;83;342;381;1391;464;1733
317150;201309;1025;2868;874;2689;120;438;621;1882;741;2320
317160;201309;3766;10414;2903;9299;442;1669;1914;6039;2356;7708
317170;201309;1901;5862;1801;5666;272;999;1071;3228;1343;4227
317180;201309;1803;6337;1466;5544;438;1788;439;1638;877;3426
317190;201309;1254;3896;1163;3772;101;371;973;3141;1074;3512
317200;201309;4248;14746;4012;14220;1499;5770;1004;3412;2503;9182
317210;201309;1060;3424;912;3184;284;1107;393;1357;677;2464
317220;201309;346;1278;340;1269;129;484;166;643;295;1127
320010;201309;5861;18817;5238;17358;924;3350;2818;9320;3742;12670
320013;201309;1859;5681;1448;4999;216;811;864;3034;1080;3845
320016;201309;3421;9729;2959;9072;531;1652;1991;6211;2522;7863
320020;201309;4161;13799;3845;13107;1365;4951;1411;4823;2776;9774
320030;201309;1721;5760;1563;5394;465;1746;666;2218;1131;3964
320035;201309;1624;5306;1484;5039;541;1982;474;1590;1015;3572
320040;201309;3040;10532;2582;9432;730;2888;797;2856;1527;5744
320050;201309;1876;5380;1601;4823;342;1151;825;2420;1167;3571
320060;201309;10502;33987;8465;29267;2297;8787;2987;9780;5284;18567
320070;201309;1784;6143;1590;5672;542;2085;410;1355;952;3440
320080;201309;5368;16398;4442;14504;1404;4954;1498;4804;2902;9758
320090;201309;8358;24565;7029;22122;2066;7019;3221;9835;5287;16854
320100;201309;3232;9894;2676;8776;662;2352;1236;3963;1898;6315
320110;201309;1541;4770;1410;4509;396;1375;466;1458;862;2833
320115;201309;1899;7101;1843;6967;662;2556;929;3590;1591;6146
320120;201309;16678;58321;15015;54979;5744;22357;4211;15493;9955;37850
320130;201309;38733;132730;36515;127931;11561;43737;16301;55855;27862;99592
320140;201309;4014;13385;2901;10527;765;3053;340;1166;1105;4219
320150;201309;17688;51571;13303;43028;4516;15663;2174;6910;6690;22573
320160;201309;5293;16593;4658;15545;1264;4726;2119;6713;3383;11439
320170;201309;1959;6574;1802;6222;689;2465;553;1955;1242;4420
320180;201309;908;3031;819;2890;293;1095;329;1153;622;2248
320190;201309;4229;15654;3915;14808;1502;5906;1122;4230;2624;10136
320200;201309;1103;3697;996;3476;314;1183;419;1476;733;2659
320210;201309;6268;17515;5468;16161;1405;4683;2748;7888;4153;12571
320220;201309;2725;8566;2146;7505;673;2574;746;2617;1419;5191
320225;201309;1415;5112;1248;4646;460;1835;252;947;712;2782
320230;201309;4207;14396;3943;13890;1340;5097;1441;5198;2781;10295
320240;201309;9517;30345;7731;26782;2622;9714;1899;6754;4521;16468
320245;201309;4146;14407;3907;13837;1263;4678;1635;5788;2898;10466
320250;201309;1711;5441;1307;4481;359;1375;290;902;649;2277
320255;201309;1990;6760;1727;6304;717;2790;604;2267;1321;5057
320260;201309;1335;4337;1114;3750;316;1179;409;1231;725;2410
320265;201309;2449;7641;2082;7191;282;1009;1531;5441;1813;6450
320270;201309;2207;7448;2028;7011;536;1965;962;3303;1498;5268
320280;201309;7112;21899;6609;21109;1300;4452;4067;13181;5367;17633
320290;201309;1504;5262;1376;4896;542;2001;354;1190;896;3191
320300;201309;4435;15331;4150;14740;1221;4614;1905;6799;3126;11413
320305;201309;4556;15428;4186;14537;1160;4441;1876;6347;3036;10788
320310;201309;1944;6038;1784;5788;412;1451;997;3165;1409;4616
320313;201309;2239;7010;1675;5667;487;1902;285;856;772;2758
320316;201309;2209;7095;2098;6828;591;2030;960;3110;1551;5140
320320;201309;18088;60373;16033;56285;5016;19648;6570;22377;11586;42025
320330;201309;2804;8937;2506;8382;596;2005;1373;4757;1969;6762
320332;201309;4776;16668;4400;15975;1455;5522;1894;7086;3349;12608
320334;201309;1536;5498;1278;4845;460;1942;236;803;696;2745
320335;201309;2047;6341;1613;5404;585;2170;307;957;892;3127
320340;201309;5540;16238;4531;14471;1169;4172;2053;6476;3222;10648
320350;201309;5404;14188;4083;12009;871;2928;1921;5481;2792;8409
320360;201309;1697;4701;1339;4041;288;991;652;1856;940;2847
320370;201309;3429;11639;2998;10757;932;3499;1202;4333;2134;7832
320380;201309;2672;8530;2396;7960;629;2215;1149;3746;1778;5961
320390;201309;8088;25196;6888;22785;2017;7428;2665;8543;4682;15971
320400;201309;4129;12068;3533;11224;716;2532;2152;6706;2868;9238
320405;201309;4121;12478;3808;12055;1173;4135;2050;6314;3223;10449
320410;201309;6034;15469;4550;13760;726;2245;3179;9769;3905;12014
320420;201309;2260;7220;1784;6469;785;3061;293;1015;1078;4076
320425;201309;2450;6391;2029;5798;324;1121;1269;3588;1593;4709
320430;201309;2218;6775;2038;6441;377;1344;1131;3508;1508;4852
320435;201309;2126;7628;1955;7220;767;2913;782;2979;1549;5892
320440;201309;1489;5114;1344;4682;440;1651;407;1337;847;2988
320450;201309;2413;8022;2134;7426;642;2452;908;3059;1550;5511
320455;201309;4552;16571;3717;14434;1221;4913;741;2852;1962;7765
320460;201309;2882;9761;2411;8718;815;3176;720;2481;1535;5657
320465;201309;1495;4964;1262;4365;290;1050;503;1699;793;2749
320470;201309;4118;13209;3129;10981;1074;4094;490;1632;1564;5726
320480;201309;1943;5986;1637;5393;419;1604;703;2170;1122;3774
320490;201309;17423;56634;14790;51284;5180;19203;4998;17864;10178;37067
320495;201309;1275;4271;1140;3956;500;1871;322;1088;822;2959
320500;201309;41717;135852;37644;128058;13223;48556;15801;52424;29024;100980
320501;201309;3650;12311;3407;11872;1188;4617;1464;4944;2652;9561
320503;201309;2219;8300;1961;7567;701;2857;491;1752;1192;4609
320506;201309;3139;10125;2223;7720;673;2505;328;1091;1001;3596
320510;201309;8040;26351;7295;24841;2669;9678;2606;8760;5275;18438
320515;201309;2076;6021;1857;5598;521;1677;731;2206;1252;3883
320517;201309;2079;7192;1823;6575;670;2612;410;1404;1080;4016
320520;201309;31023;103210;27203;95636;9306;35940;11399;39722;20705;75662
320530;201309;26849;86386;23320;79095;6774;25931;9865;31899;16639;57830
330010;201309;14933;48793;14028;46865;3397;12869;7858;25093;11255;37962
330015;201309;1945;5565;1710;5107;539;1800;567;1611;1106;3411
330020;201309;15949;49273;14721;47254;3841;13242;7916;25245;11757;38487
330022;201309;1574;5152;1428;4869;343;1352;760;2475;1103;3827
330023;201309;3273;10854;3100;10491;898;3346;1260;4119;2158;7465
330025;201309;3217;10146;2998;9810;742;2618;1839;5984;2581;8602
330030;201309;7345;25858;6779;24650;2161;8594;2790;9674;4951;18268
330040;201309;14107;41032;12076;37819;3303;11180;6223;19144;9526;30324
330045;201309;61684;182259;57303;175658;9330;30718;39323;120469;48653;151187
330050;201309;2915;9453;2590;8787;988;3769;690;2147;1678;5916
330060;201309;5351;16973;4879;16285;1138;4267;2953;9891;4091;14158
330070;201309;24834;78807;22850;75172;6799;24070;9935;32627;16734;56697
330080;201309;8701;26084;8363;25616;2135;6582;5099;16103;7234;22685
330090;201309;3068;8899;2914;8611;935;2961;1319;3832;2254;6793
330093;201309;1921;5700;1714;5362;425;1450;784;2425;1209;3875
330095;201309;1179;4165;1095;3952;431;1726;192;603;623;2329
330100;201309;52972;182060;50101;176869;12813;50005;25323;89618;38136;139623
330110;201309;2623;8477;2401;8048;850;3073;729;2412;1579;5485
330115;201309;2417;7524;2258;7232;787;2751;898;2783;1685;5534
330120;201309;2445;7315;2249;7033;685;2282;1013;3124;1698;5406
330130;201309;3871;13010;3540;12339;1223;4612;1302;4499;2525;9111
330140;201309;3372;10415;3078;10006;809;2921;1470;4758;2279;7679
330150;201309;2902;8933;2319;7674;813;2901;520;1659;1333;4560
330160;201309;1361;4832;1281;4650;489;1941;399;1380;888;3321
330170;201309;99148;307804;93427;298826;14026;48418;67326;215389;81352;263807
330180;201309;1632;5105;1496;4843;273;1128;954;2849;1227;3977
330185;201309;7697;24822;7240;24067;1938;6796;3988;13580;5926;20376
330187;201309;4177;12018;3776;11359;833;2890;2201;6475;3034;9365
330190;201309;27368;84561;26229;82627;6961;23364;15149;46923;22110;70287
330200;201309;12882;41764;11947;39857;2801;9644;6585;22364;9386;32008
330205;201309;2517;7001;2300;6642;519;1733;1183;3273;1702;5006
330210;201309;4634;12369;3481;10220;1066;3454;884;2559;1950;6013
330220;201309;10953;35455;10341;34253;3697;13241;3452;10970;7149;24211
330225;201309;3945;12712;3731;12373;642;2485;2571;8477;3213;10962
330227;201309;17381;49874;15845;47763;3676;11912;9521;28072;13197;39984
330230;201309;1497;4501;1382;4308;442;1551;524;1505;966;3056
330240;201309;19903;62619;17803;58920;7040;25394;3290;10597;10330;35991
330245;201309;1187;3870;992;3463;316;1204;222;783;538;1987
330250;201309;36636;108587;34731;105544;9747;30025;19220;59638;28967;89663
330260;201309;3440;11108;3243;10699;881;3190;1461;4639;2342;7829
330270;201309;13629;41330;11838;38373;3642;12560;4721;15454;8363;28014
330280;201309;1922;6278;1673;5758;417;1652;784;2511;1201;4163
330285;201309;17198;52633;15915;50819;3700;12538;9777;31310;13477;43848
330290;201309;3444;9812;3099;9361;648;2251;1800;5159;2448;7410
330300;201309;4105;13660;3929;13361;1000;3635;2049;7092;3049;10727
330310;201309;2710;8118;2491;7740;640;2117;1222;3736;1862;5853
330320;201309;15429;46298;14679;45128;3679;11549;8838;27775;12517;39324
330330;201309;30897;89846;28772;86521;7512;24378;16773;49700;24285;74078
330340;201309;13862;44026;11608;39372;3723;13743;3568;11884;7291;25627
330350;201309;90619;296911;88420;293794;16868;56231;62575;212035;79443;268266
330360;201309;5341;17121;5221;16927;832;2975;3776;12117;4608;15092
330370;201309;3709;14070;3524;13587;1425;5703;1208;4692;2633;10395
330380;201309;4063;13625;3631;12865;1141;4310;1635;5852;2776;10162
330385;201309;3953;13916;3652;13282;1239;4794;1296;4708;2535;9502
330390;201309;23009;78944;21276;75439;5331;21124;11070;38425;16401;59549
330395;201309;3243;9967;3042;9620;536;1839;1911;6086;2447;7925
330400;201309;2530;8627;2313;8201;571;2311;1126;3674;1697;5985
330410;201309;3043;9804;2632;8950;650;2309;1261;4306;1911;6615
330411;201309;2483;7979;2247;7501;508;1962;1162;3631;1670;5593
330412;201309;1364;4784;1105;4277;255;1140;449;1665;704;2805
330414;201309;25331;72731;21754;67860;4580;15277;13274;41476;17854;56753
330415;201309;3653;11670;3243;10911;847;3185;1433;4793;2280;7978
330420;201309;7161;23847;5839;21048;1895;7494;1055;3818;2950;11312
330430;201309;8101;24389;7303;22946;1839;6448;3541;10783;5380;17231
330440;201309;2094;7138;1758;6419;604;2460;412;1407;1016;3867
330450;201309;1591;5612;1500;5413;485;1973;564;1959;1049;3932
330452;201309;10564;33042;8812;29492;2547;9439;3547;11329;6094;20768
330455;201309;452769;1359821;392931;1260076;109477;375576;197404;630677;306881;1006253
330460;201309;1383;4742;1301;4581;383;1526;615;2111;998;3637
330470;201309;4246;14247;4013;13771;1504;5545;1179;3940;2683;9485
330475;201309;8035;26336;7386;25286;1934;7265;3930;13468;5864;20733
330480;201309;6456;19808;6056;19063;1795;6100;2462;7667;4257;13767
330490;201309;96887;276487;90967;267814;13422;41693;68169;201256;81591;242949
330500;201309;6713;20766;6304;19944;1478;5021;3238;10540;4716;15561
330510;201309;40390;134042;38350;130538;13885;47993;17729;62130;31614;110123
330513;201309;1574;4784;1454;4544;568;1882;500;1544;1068;3426
330515;201309;3022;9567;2793;9176;979;3441;999;3237;1978;6678
330520;201309;13071;39648;12177;38233;3024;9958;7000;22183;10024;32141
330530;201309;1539;4658;1425;4459;398;1387;725;2176;1123;3563
330540;201309;3238;10050;2829;9406;912;3267;1084;3498;1996;6765
330550;201309;8848;29730;7906;27993;3280;12319;2019;7235;5299;19554
330555;201309;10196;31668;9232;30154;1865;6352;5854;19397;7719;25749
330560;201309;4121;12863;3867;12433;836;3132;2216;6933;3052;10065
330570;201309;3613;10608;3193;9930;832;2708;1717;5447;2549;8155
330575;201309;5305;16525;4940;15852;1157;4004;2983;9302;4140;13306
330580;201309;16308;53754;14497;50109;5146;18687;5025;17777;10171;36464
330590;201309;1926;5967;1821;5788;564;1881;876;2790;1440;4671
330600;201309;9273;28445;8040;26490;1257;5188;5178;16190;6435;21378
330610;201309;8721;28677;8038;27378;2279;8619;3753;12561;6032;21180
330615;201309;1679;6012;1549;5654;651;2485;546;2046;1197;4531
330620;201309;3892;13866;3591;13260;1305;5041;1109;4326;2414;9367
330630;201309;20200;68247;18452;64459;5431;21083;8502;28368;13933;49451
350010;201309;2862;9262;2322;8018;751;2793;439;1440;1190;4233
350020;201309;566;1684;461;1465;124;453;166;479;290;932
350030;201309;4439;14564;3917;13449;1426;5343;1275;4357;2701;9700
350040;201309;577;2145;512;1999;179;764;101;354;280;1118
350050;201309;1384;4595;1154;4160;319;1308;376;1227;695;2535
350055;201309;593;2039;570;1998;177;674;267;918;444;1592
350060;201309;85;292;79;282;26;114;26;77;52;191
350070;201309;2705;9153;2261;8130;602;2415;511;1649;1113;4064
350075;201309;488;1805;441;1691;159;647;121;428;280;1075
350080;201309;585;1763;477;1546;134;505;172;540;306;1045
350090;201309;589;1718;450;1477;126;442;128;384;254;826
350100;201309;1807;6434;1646;6078;620;2462;514;1842;1134;4304
350110;201309;445;1377;354;1168;110;407;110;319;220;726
350115;201309;1293;4327;1150;3956;283;1100;489;1534;772;2634
350120;201309;674;1909;461;1488;142;496;109;346;251;842
350130;201309;3648;11392;3323;10755;893;3224;1388;4161;2281;7385
350140;201309;682;2160;618;2028;150;574;251;770;401;1344
350150;201309;399;1382;367;1308;149;560;93;324;242;884
350160;201309;6127;19797;4780;16802;1552;6017;1631;5262;3183;11279
350170;201309;2207;7960;1988;7403;767;2957;469;1662;1236;4619
350180;201309;1440;3818;1197;3397;301;898;523;1465;824;2363
350190;201309;3060;10769;2632;9882;938;3915;958;3265;1896;7180
350200;201309;406;1425;369;1368;140;585;127;447;267;1032
350210;201309;7281;21097;5974;18775;2420;8160;1912;5716;4332;13876
350220;201309;3105;10179;2810;9627;1043;3978;791;2446;1834;6424
350230;201309;740;2568;682;2470;241;945;222;804;463;1749
350240;201309;591;1833;513;1711;122;474;277;884;399;1358
350250;201309;2724;10229;2611;9993;1139;4625;821;3099;1960;7724
350260;201309;1029;2800;881;2551;215;634;387;1171;602;1805
350270;201309;5162;16405;4683;15424;1191;4250;2163;7108;3354;11358
350275;201309;1986;6649;1778;6336;553;2165;700;2341;1253;4506
350280;201309;21928;59645;14358;45126;3891;13093;3017;9547;6908;22640
350290;201309;1596;5662;1457;5344;490;1884;448;1692;938;3576
350300;201309;480;1555;445;1475;158;567;134;447;292;1014
350310;201309;998;3389;938;3261;240;986;406;1332;646;2318
350315;201309;555;1792;454;1577;77;343;155;498;232;841
350320;201309;11845;39611;10838;37224;3585;13157;1936;6449;5521;19606
350330;201309;9431;28471;8402;26289;1965;6866;4579;13409;6544;20275
350335;201309;542;1604;500;1518;133;428;191;631;324;1059
350340;201309;1024;3326;809;2906;236;934;212;752;448;1686
350350;201309;760;2495;670;2352;187;769;247;851;434;1620
350360;201309;785;2808;686;2578;218;863;246;929;464;1792
350370;201309;689;2164;519;1753;110;415;121;361;231;776
350380;201309;3659;12012;3093;11120;1366;5275;644;2192;2010;7467
350390;201309;8520;28174;7674;26602;1942;7352;3948;13202;5890;20554
350395;201309;297;980;241;855;75;280;47;161;122;441
350400;201309;8006;24143;6692;21735;2081;7405;2359;7308;4440;14713
350410;201309;7271;27453;6544;25738;2443;10318;1689;6464;4132;16782
350420;201309;1015;3270;824;2887;398;1479;75;260;473;1739
350430;201309;880;2806;770;2614;219;882;376;1205;595;2087
350440;201309;1355;4437;1283;4306;472;1682;582;1902;1054;3584
350450;201309;8041;25081;6868;22777;2367;8461;1912;6121;4279;14582
350460;201309;1470;4427;1090;3604;339;1239;310;895;649;2134
350470;201309;208;649;188;620;58;214;76;231;134;445
350480;201309;764;2399;507;1751;96;371;85;253;181;624
350490;201309;2086;6163;1797;5768;507;1894;915;2763;1422;4657
350500;201309;609;1839;529;1716;139;510;233;705;372;1215
350510;201309;1098;3585;959;3287;315;1218;340;1037;655;2255
350520;201309;1264;4963;1156;4726;455;1948;288;1140;743;3088
350530;201309;2489;7630;2061;6673;827;2888;502;1461;1329;4349
350535;201309;1466;4378;1429;4327;80;271;1262;3836;1342;4107
350540;201309;2036;5989;1753;5500;505;1746;699;2184;1204;3930
350550;201309;10688;32125;8665;28547;2617;9676;3220;9901;5837;19577
350560;201309;3405;11592;3106;11001;640;2430;1663;6049;2303;8479
350570;201309;20324;71740;18664;67816;6239;24232;6709;23347;12948;47579
350580;201309;1951;6542;1681;5965;526;2066;263;795;789;2861
350590;201309;3957;13331;3217;11648;1060;4254;1113;3645;2173;7899
350600;201309;36279;95102;25814;78536;5806;19369;12391;36672;18197;56041
350610;201309;8995;26845;7336;24113;2066;7630;3391;10686;5457;18316
350620;201309;431;1421;384;1329;93;365;161;531;254;896
350630;201309;1617;5180;1284;4506;420;1667;131;409;551;2076
350635;201309;4691;15629;3874;14009;1231;4661;1481;5467;2712;10128
350640;201309;669;2145;592;1943;195;702;222;688;417;1390
350650;201309;3865;13101;2996;10987;1226;4893;291;1020;1517;5913
350660;201309;3715;12165;3295;11404;961;3533;1504;5183;2465;8716
350670;201309;1845;5857;1735;5663;359;1343;1094;3413;1453;4756
350680;201309;1185;3756;962;3297;300;1219;372;1200;672;2419
350690;201309;1049;3612;898;3272;286;1153;222;744;508;1897
350700;201309;2828;9984;2510;9249;978;3975;909;2951;1887;6926
350710;201309;2106;6786;1924;6498;368;1414;1220;4049;1588;5463
350715;201309;1117;3453;987;3196;262;942;379;1162;641;2104
350720;201309;124;404;119;389;50;177;43;123;93;300
350730;201309;408;1605;392;1556;125;540;108;397;233;937
350740;201309;2349;7247;2114;6711;594;2053;870;2757;1464;4810
350745;201309;348;1120;289;979;70;279;126;371;196;650
350750;201309;9528;30078;7400;25700;2214;8437;1851;6014;4065;14451
350760;201309;11620;38057;10635;36289;3683;13960;4433;14273;8116;28233
350770;201309;885;2681;644;2193;152;593;232;765;384;1358
350775;201309;627;1884;569;1772;141;504;247;759;388;1263
350780;201309;2049;6369;1554;5299;379;1427;292;974;671;2401
350790;201309;2075;6910;1712;6133;585;2213;364;1175;949;3388
350800;201309;2983;10299;2851;10067;697;2795;1630;5585;2327;8380
350810;201309;2583;7670;2267;7087;771;2611;766;2462;1537;5073
350820;201309;521;1477;399;1220;88;319;153;409;241;728
350830;201309;868;2806;629;2188;131;502;124;364;255;866
350840;201309;2417;8864;2024;7804;704;2992;390;1304;1094;4296
350850;201309;6825;23465;5669;20610;1903;7351;1412;4855;3315;12206
350860;201309;3335;11075;3206;10878;543;2069;2336;7899;2879;9968
350870;201309;2370;8333;2149;7986;774;3051;1031;3841;1805;6892
350880;201309;1652;5707;1411;5147;453;1759;267;982;720;2741
350890;201309;625;1911;503;1645;101;357;163;455;264;812
350900;201309;4570;15556;3860;13993;1112;4397;1225;4158;2337;8555
350910;201309;867;2760;828;2674;382;1285;264;840;646;2125
350920;201309;9369;28966;8768;27962;1663;5952;5607;17231;7270;23183
350925;201309;5261;16718;4769;15745;1468;5332;2057;6566;3525;11898
350930;201309;1520;4329;1283;3926;169;631;888;2610;1057;3241
350940;201309;2295;7760;2104;7440;442;1837;1299;4382;1741;6219
350945;201309;932;3155;827;2931;242;945;322;1092;564;2037
350950;201309;69709;228380;59858;207961;18348;69471;23953;80723;42301;150194
350960;201309;4456;16026;3981;14958;843;3623;2113;7589;2956;11212
350970;201309;4119;15377;3788;14539;1545;6367;1138;4237;2683;10604
350980;201309;667;2185;618;2104;279;1030;124;424;403;1454
350990;201309;1750;6268;1568;5915;562;2312;546;2022;1108;4334
350995;201309;797;2947;755;2863;228;981;346;1238;574;2219
351000;201309;3509;10964;3067;10105;558;2170;1764;5529;2322;7699
351010;201309;419;1303;312;1074;126;472;61;215;187;687
351015;201309;939;3185;821;2956;322;1318;224;720;546;2038
351020;201309;7605;25488;6789;24193;1917;7361;3552;12827;5469;20188
351030;201309;1325;5056;1230;4830;395;1729;419;1594;814;3323
351040;201309;3600;11804;3338;11348;839;3344;1937;6154;2776;9498
351050;201309;8254;27971;7113;25664;2686;10444;2390;8542;5076;18986
351060;201309;31928;102496;27106;93453;9496;34577;8993;31319;18489;65896
351070;201309;1796;5226;1303;4324;481;1745;244;718;725;2463
351080;201309;2739;8372;2162;7661;691;2650;873;3020;1564;5670
351090;201309;381;1349;304;1182;111;489;46;162;157;651
351100;201309;1830;6035;1707;5804;638;2217;665;2329;1303;4546
351110;201309;7322;22285;5716;19210;2041;7527;1704;5394;3745;12921
351120;201309;590;1860;500;1648;81;327;247;725;328;1052
351130;201309;849;2369;440;1509;94;369;108;322;202;691
351140;201309;1980;7016;1816;6663;702;2821;565;2002;1267;4823
351150;201309;2153;7595;1768;6559;518;2114;425;1423;943;3537
351160;201309;1497;5365;1357;5029;473;1956;452;1606;925;3562
351170;201309;1455;5012;1265;4548;385;1498;486;1611;871;3109
351190;201309;872;2902;765;2616;199;728;177;549;376;1277
351200;201309;2202;6710;1900;6135;367;1411;927;2700;1294;4111
351210;201309;1044;3354;904;3075;302;1118;279;887;581;2005
351220;201309;3477;11940;3048;11007;914;3618;1197;4214;2111;7832
351230;201309;1862;6382;1685;6022;568;2235;753;2629;1321;4864
351240;201309;1010;3358;745;2702;222;919;195;622;417;1541
351250;201309;849;2487;642;2051;148;518;289;880;437;1398
351260;201309;1195;3631;1061;3345;298;1027;402;1212;700;2239
351270;201309;381;1393;345;1316;122;527;109;373;231;900
351280;201309;4275;13837;3675;12344;1138;4089;1095;3322;2233;7411
351290;201309;982;3081;864;2835;288;974;245;762;533;1736
351300;201309;9842;37014;8680;34224;2608;11138;3256;12729;5864;23867
351310;201309;3343;10661;2820;9679;753;2975;1319;4183;2072;7158
351320;201309;984;3578;880;3319;333;1358;191;639;524;1997
351330;201309;287;852;258;795;103;320;73;220;176;540
351340;201309;6497;23108;5926;21945;1748;6875;2975;11022;4723;17897
351350;201309;9014;30676;8195;28868;2700;9929;3011;10356;5711;20285
351360;201309;4844;15069;4571;14605;1279;4565;2219;6967;3498;11532
351370;201309;1905;6357;1554;5586;550;2195;359;1145;909;3340
351380;201309;36628;117762;34299;112935;9566;34422;16090;50708;25656;85130
351385;201309;250;799;244;789;96;322;87;278;183;600
351390;201309;1210;4185;1085;3920;435;1675;338;1166;773;2841
351400;201309;1217;3988;1142;3825;396;1404;424;1458;820;2862
351410;201309;2893;9037;2579;8469;643;2260;1258;4080;1901;6340
351420;201309;453;1347;314;1031;73;258;51;152;124;410
351430;201309;854;2775;773;2623;195;729;444;1467;639;2196
351440;201309;4646;14497;4078;13291;1627;5554;1057;3252;2684;8806
351450;201309;1795;5226;1581;4945;489;1567;831;2687;1320;4254
351460;201309;822;2645;688;2376;335;1246;195;619;530;1865
351470;201309;1068;3373;956;3160;404;1459;277;893;681;2352
351480;201309;2923;9811;2679;9394;706;2942;1271;4314;1977;7256
351490;201309;1972;6814;1775;6392;388;1648;965;3308;1353;4956
351492;201309;290;1006;213;792;51;223;57;169;108;392
351495;201309;147;528;128;473;41;160;47;170;88;330
351500;201309;19732;65091;17776;61263;5659;21032;7307;24712;12966;45744
351510;201309;7311;24283;6375;22684;1630;6317;3350;11829;4980;18146
351512;201309;372;1146;340;1082;88;299;137;424;225;723
351515;201309;1841;6427;1615;5893;561;2196;431;1504;992;3700
351518;201309;1630;5787;1246;5091;401;1775;241;935;642;2710
351519;201309;762;2553;661;2319;202;808;253;834;455;1642
351520;201309;802;2297;388;1407;68;286;48;158;116;444
351530;201309;464;1484;410;1350;89;316;125;354;214;670
351535;201309;2567;6830;2107;6151;258;870;1443;4134;1701;5004
351540;201309;2088;6813;1887;6445;978;3514;357;1215;1335;4729
351550;201309;5676;17772;4502;15289;1681;5988;1172;3911;2853;9899
351560;201309;425;1438;369;1296;144;545;59;199;203;744
351565;201309;235;811;218;765;67;281;83;256;150;537
351570;201309;12836;43249;11367;40139;3817;13913;4749;16857;8566;30770
351580;201309;399;1150;299;922;48;158;114;324;162;482
351590;201309;449;1269;387;1124;141;445;85;232;226;677
351600;201309;1852;5534;1699;5246;433;1563;812;2270;1245;3833
351610;201309;651;1833;555;1663;130;447;272;764;402;1211
351620;201309;21505;73322;17798;64944;5885;23355;4478;15120;10363;38475
351630;201309;14515;50032;13381;48132;3801;14127;7271;26614;11072;40741
351640;201309;7975;27055;6905;25093;1879;7423;3522;12672;5401;20095
351650;201309;345;1056;234;779;63;233;42;131;105;364
351660;201309;885;2854;700;2418;170;655;194;602;364;1257
351670;201309;4178;13495;3586;12251;835;3240;1728;5581;2563;8821
351680;201309;711;2260;535;1823;153;556;104;322;257;878
351685;201309;442;1361;351;1198;105;374;121;425;226;799
351690;201309;1317;3962;1042;3344;467;1511;258;777;725;2288
351700;201309;1433;4425;1308;4187;444;1496;435;1354;879;2850
351710;201309;785;2503;659;2217;166;566;194;615;360;1181
351720;201309;1610;5250;1246;4268;282;1085;428;1400;710;2485
351730;201309;1088;3364;950;3155;378;1398;314;997;692;2395
351740;201309;4512;13229;3910;11947;1110;3634;1306;3729;2416;7363
351750;201309;1502;5045;1306;4617;408;1569;343;1130;751;2699
351760;201309;3757;12393;3348;11470;871;3270;1532;5044;2403;8314
351770;201309;2259;7493;1957;6929;754;2756;815;2896;1569;5652
351780;201309;1601;4651;1108;3601;322;1158;248;762;570;1920
351790;201309;1121;3437;963;3216;292;1055;474;1552;766;2607
351800;201309;334;826;290;740;41;139;172;383;213;522
351810;201309;1189;3706;1126;3628;294;1107;689;2093;983;3200
351820;201309;2488;7513;1777;6157;695;2574;205;677;900;3251
351830;201309;3992;13380;3629;12553;968;3716;1638;5448;2606;9164
351840;201309;8821;31090;7935;29185;2770;10780;2603;9454;5373;20234
351850;201309;1204;4247;1052;3900;317;1319;214;698;531;2017
351860;201309;3539;11537;3301;11079;768;2947;1902;6070;2670;9017
351870;201309;34822;110497;32205;105922;7468;26673;19470;63567;26938;90240
351880;201309;114267;380803;101224;353866;33881;124706;31742;110498;65623;235204
351885;201309;620;2330;578;2229;167;690;253;937;420;1627
351890;201309;807;2448;636;2061;214;735;145;444;359;1179
351900;201309;1457;4585;1291;4310;474;1680;485;1632;959;3312
351905;201309;343;1280;297;1190;112;498;88;320;200;818
351907;201309;14351;46756;12585;43199;3099;11950;5966;19501;9065;31451
351910;201309;1137;3741;1045;3562;265;1018;329;1044;594;2062
351920;201309;1188;3507;1126;3415;275;959;673;1963;948;2922
351925;201309;970;2850;915;2753;121;468;668;1901;789;2369
351930;201309;3102;10894;2861;10363;883;3599;1176;3874;2059;7473
351940;201309;1004;3091;944;2975;285;993;550;1654;835;2647
351950;201309;1046;3269;926;3024;233;829;402;1232;635;2061
351960;201309;3791;12366;3280;11347;1250;4601;1203;4043;2453;8644
351970;201309;6853;26526;6329;25383;2437;10322;2042;8113;4479;18435
351980;201309;926;2924;787;2656;186;730;324;999;510;1729
351990;201309;1570;4632;1287;4058;377;1390;379;1036;756;2426
352000;201309;2459;8012;2248;7572;561;2041;1014;3273;1575;5314
352010;201309;2266;7857;2078;7383;776;2893;480;1727;1256;4620
352020;201309;1481;4873;1345;4596;439;1576;439;1537;878;3113
352030;201309;4345;13968;3987;13505;946;3460;2295;7903;3241;11363
352040;201309;1741;6228;1503;5608;456;1827;354;1223;810;3050
352042;201309;2165;6337;1696;5365;440;1561;854;2626;1294;4187
352044;201309;1337;4625;1088;3964;285;1121;256;842;541;1963
352050;201309;7417;25689;5488;21129;1733;7376;1027;3447;2760;10823
352060;201309;790;2407;706;2278;215;804;278;811;493;1615
352070;201309;724;2000;666;1904;294;912;192;573;486;1485
352080;201309;532;1673;454;1533;123;474;157;473;280;947
352090;201309;1672;5543;1391;4954;358;1438;479;1558;837;2996
352100;201309;1772;6186;1584;5801;547;2237;570;1843;1117;4080
352110;201309;412;1583;370;1476;114;507;106;399;220;906
352115;201309;358;1196;304;1078;96;378;132;437;228;815
352120;201309;988;2951;864;2777;188;634;514;1698;702;2332
352130;201309;1733;4934;1329;4253;353;1245;562;1651;915;2896
352140;201309;1240;4169;1047;3734;344;1296;411;1457;755;2753
352150;201309;603;1830;497;1639;180;646;182;577;362;1223
352160;201309;1226;3550;1125;3401;274;898;622;1883;896;2781
352170;201309;3109;9757;2853;9317;825;2891;1321;4146;2146;7037
352180;201309;3495;10237;3079;9471;882;2967;1374;4021;2256;6988
352190;201309;1041;3298;952;3131;231;931;455;1342;686;2273
352200;201309;406;1417;341;1283;76;320;152;577;228;897
352210;201309;15775;43811;12734;39280;2635;8692;7654;24100;10289;32792
352215;201309;559;1825;501;1735;84;328;287;1022;371;1350
352220;201309;14830;50508;13841;48436;4739;17568;5440;18997;10179;36565
352230;201309;13547;47419;12039;44554;3891;15700;4611;16700;8502;32400
352240;201309;12572;40603;11675;38987;4077;15161;4560;14554;8637;29715
352250;201309;25869;85230;23037;79715;6442;24204;9912;34147;16354;58351
352260;201309;5010;15928;3747;13377;1074;4267;1133;3683;2207;7950
352265;201309;927;3045;814;2868;142;569;513;1771;655;2340
352270;201309;2564;8834;2216;8013;893;3422;503;1717;1396;5139
352280;201309;2420;7713;2085;7137;606;2287;701;2337;1307;4624
352290;201309;1289;4262;1106;3841;289;1128;327;1010;616;2138
352300;201309;914;2779;776;2536;251;880;325;1047;576;1927
352310;201309;30645;106568;28006;101937;7934;31090;15840;56502;23774;87592
352320;201309;6607;21183;5858;19785;2082;7646;1868;5780;3950;13426
352330;201309;2175;7316;1915;7005;733;2884;677;2467;1410;5351
352340;201309;5699;19871;4723;17446;1686;6692;925;3153;2611;9845
352350;201309;1704;6424;1541;6023;447;1902;502;1890;949;3792
352360;201309;1169;3967;1041;3697;304;1275;538;1754;842;3029
352370;201309;890;3056;816;2889;194;780;386;1336;580;2116
352380;201309;1012;3295;887;3072;361;1398;249;820;610;2218
352390;201309;12135;37823;9735;33280;2499;9836;4328;13660;6827;23496
352400;201309;3032;9285;2077;7383;633;2481;839;2836;1472;5317
352410;201309;3939;11876;3072;10378;1104;4023;945;3055;2049;7078
352420;201309;1280;3749;1187;3600;474;1596;411;1211;885;2807
352430;201309;6199;19910;5476;18652;2192;8111;1714;5630;3906;13741
352440;201309;15228;49202;12739;44238;3523;13276;5114;17181;8637;30457
352450;201309;611;1885;425;1523;116;442;89;298;205;740
352460;201309;2637;9068;2400;8642;906;3634;870;2903;1776;6537
352470;201309;4883;13985;3040;10129;642;2329;1342;4360;1984;6689
352480;201309;5398;15609;4468;13866;1268;4518;1839;5265;3107;9783
352490;201309;721;2639;609;2359;156;674;119;450;275;1124
352500;201309;9889;33248;9376;32332;4289;15737;2869;9317;7158;25054
352510;201309;3331;11811;2755;10540;1020;4191;667;2473;1687;6664
352520;201309;2427;8746;2225;8302;572;2314;1316;4822;1888;7136
352530;201309;7191;24061;5582;20449;1745;6917;1083;3720;2828;10637
352540;201309;484;1625;396;1428;105;419;131;458;236;877
352550;201309;1057;3624;869;3214;328;1309;211;752;539;2061
352560;201309;552;1722;467;1541;93;373;220;649;313;1022
352570;201309;1600;5139;1143;4056;266;1057;312;969;578;2026
352580;201309;921;2819;802;2609;290;1064;331;997;621;2061
352585;201309;201;665;159;584;38;158;50;167;88;325
352590;201309;13462;44538;12094;41881;2909;11282;6541;21982;9450;33264
352600;201309;1847;6087;1711;5787;624;2193;571;1879;1195;4072
352610;201309;3559;11690;3186;11058;1274;4802;1019;3457;2293;8259
352620;201309;5439;17690;5157;17294;1258;4480;3258;10939;4516;15419
352630;201309;827;2810;781;2699;239;914;352;1180;591;2094
352640;201309;3003;9831;2432;8500;578;2233;956;3243;1534;5476
352650;201309;830;2512;621;2085;158;573;180;561;338;1134
352660;201309;1081;3824;887;3359;289;1172;276;1032;565;2204
352670;201309;7706;26643;6781;24839;2631;10056;1923;7113;4554;17169
352680;201309;3053;11311;2602;10056;713;3038;791;2713;1504;5751
352690;201309;23445;71853;19212;63894;5385;19676;8114;26186;13499;45862
352700;201309;765;2329;612;2092;183;709;268;879;451;1588
352710;201309;5041;15301;3731;12606;1039;3900;1364;4335;2403;8235
352720;201309;8644;29670;8138;28612;2738;10211;3228;11297;5966;21508
352725;201309;410;1252;277;937;57;229;65;205;122;434
352730;201309;2550;8987;2215;8059;636;2519;660;2152;1296;4671
352740;201309;2204;6718;1915;6177;530;2032;851;2459;1381;4491
352750;201309;367;1178;313;1088;116;434;63;186;179;620
352760;201309;917;3260;855;3143;289;1157;439;1567;728;2724
352770;201309;907;2851;855;2751;238;838;316;1019;554;1857
352780;201309;598;2084;523;1904;163;662;162;520;325;1182
352790;201309;642;1895;518;1688;162;583;97;308;259;891
352800;201309;1090;4212;902;3662;299;1248;154;567;453;1815
352810;201309;1011;2757;768;2303;154;536;299;861;453;1397
352820;201309;531;1659;452;1507;205;733;81;268;286;1001
352830;201309;405;1214;313;1009;88;292;50;154;138;446
352840;201309;3417;12141;3025;11264;958;3793;1070;3994;2028;7787
352850;201309;9600;31921;8469;29861;2570;9643;3155;11269;5725;20912
352860;201309;1024;3442;939;3246;398;1461;237;737;635;2198
352870;201309;1045;2759;841;2362;145;524;457;1143;602;1667
352880;201309;2215;6814;1784;5839;445;1597;444;1292;889;2889
352885;201309;303;1053;287;1015;93;356;106;352;199;708
352890;201309;705;2070;620;1896;148;513;209;577;357;1090
352900;201309;18581;57833;14440;49190;4072;15088;5687;18636;9759;33724
352910;201309;284;937;249;857;79;286;35;99;114;385
352920;201309;3377;10551;2894;9580;984;3601;972;2970;1956;6571
352930;201309;6979;22711;5532;19424;1725;6486;1054;3541;2779;10027
352940;201309;27622;95654;24167;87260;8895;33716;4940;17386;13835;51102
352950;201309;317;1019;230;829;68;294;62;200;130;494
352960;201309;493;1637;376;1332;76;291;70;233;146;524
352965;201309;360;1020;292;893;75;244;47;137;122;381
352970;201309;3336;8907;2963;8415;372;1132;2168;6274;2540;7406
352980;201309;1472;4417;1269;4090;424;1425;512;1698;936;3123
352990;201309;3637;12365;3383;11885;1204;4614;1107;3721;2311;8335
353000;201309;520;1482;395;1220;92;323;110;296;202;619
353010;201309;2942;8600;2298;7285;727;2562;794;2319;1521;4881
353020;201309;4352;12373;3188;9863;572;2003;1330;3746;1902;5749
353030;201309;4953;15205;4325;13900;1621;5649;993;2970;2614;8619
353040;201309;687;1992;589;1834;200;685;213;638;413;1323
353050;201309;5409;19271;4701;17766;1873;7589;1418;5099;3291;12688
353060;201309;32770;108752;30614;105230;5743;23217;20192;66473;25935;89690
353070;201309;8548;29877;6796;25722;2457;9781;1594;6091;4051;15872
353080;201309;4571;16125;3870;14449;1358;5460;1065;3739;2423;9199
353090;201309;584;1996;521;1870;96;415;249;811;345;1226
353100;201309;266;814;221;710;100;322;40;122;140;444
353110;201309;7813;24880;7008;23369;1581;5635;3931;13272;5512;18907
353120;201309;470;1636;405;1481;152;625;95;314;247;939
353130;201309;2972;9396;2629;8785;997;3639;954;2985;1951;6624
353140;201309;2476;7148;1996;6154;674;2259;576;1583;1250;3842
353150;201309;1898;6096;1587;5485;625;2275;364;1283;989;3558
353160;201309;575;1816;489;1618;152;523;99;303;251;826
353170;201309;514;1872;469;1788;196;829;160;580;356;1409
353180;201309;5029;16418;4444;15298;795;3219;2669;8787;3464;12006
353190;201309;3560;11649;3100;10560;813;3072;1386;4338;2199;7410
353200;201309;850;3039;766;2855;249;1043;288;1011;537;2054
353205;201309;538;1749;435;1508;112;387;144;512;256;899
353210;201309;1009;2779;834;2467;133;476;497;1417;630;1893
353215;201309;558;1800;481;1633;104;401;165;563;269;964
353220;201309;896;2806;811;2628;226;816;300;930;526;1746
353230;201309;1170;3727;1090;3582;323;1173;364;1126;687;2299
353240;201309;2130;7304;1938;6903;653;2590;774;2538;1427;5128
353250;201309;1194;3456;1005;3104;292;976;346;997;638;1973
353260;201309;1146;3437;1014;3214;339;1133;376;1151;715;2284
353270;201309;633;1956;542;1777;179;642;150;447;329;1089
353280;201309;547;1833;477;1710;168;633;129;461;297;1094
353282;201309;1751;5891;1696;5799;310;1186;1127;3767;1437;4953
353284;201309;323;941;253;816;77;261;78;246;155;507
353286;201309;145;439;94;316;26;85;16;57;42;142
353290;201309;428;1560;390;1479;170;679;136;499;306;1178
353300;201309;1880;6089;1690;5663;604;2186;561;1712;1165;3898
353310;201309;344;1098;323;1043;140;476;86;258;226;734
353320;201309;483;1386;423;1283;108;395;197;544;305;939
353325;201309;478;1715;403;1563;126;528;49;195;175;723
353330;201309;493;1536;411;1357;98;370;172;514;270;884
353340;201309;3107;10238;2673;9329;941;3545;892;2996;1833;6541
353350;201309;3348;10365;2974;9676;1014;3561;1357;4267;2371;7828
353360;201309;415;1480;365;1361;101;437;185;633;286;1070
353370;201309;698;2305;628;2135;185;663;288;973;473;1636
353380;201309;407;1370;368;1300;115;450;156;536;271;986
353390;201309;4911;13758;3762;11583;954;3255;1435;3999;2389;7254
353400;201309;605;1906;507;1697;118;441;172;508;290;949
353410;201309;680;2126;581;1969;188;703;287;942;475;1645
353420;201309;683;2033;519;1621;165;555;160;459;325;1014
353430;201309;2468;8664;1831;6782;536;2056;122;368;658;2424
353440;201309;59180;197222;53711;184039;17317;62594;17649;58832;34966;121426
353450;201309;456;1425;408;1338;113;439;146;448;259;887
353460;201309;3943;11424;3429;10493;937;3117;1611;4857;2548;7974
353470;201309;11115;35882;8737;30777;2807;10808;2013;6856;4820;17664
353475;201309;1653;4923;1237;3990;340;1202;328;952;668;2154
353480;201309;1531;4669;1377;4386;328;1210;739;2221;1067;3431
353490;201309;1628;4736;1352;4171;375;1292;375;1035;750;2327
353500;201309;1176;3491;1092;3338;483;1566;365;1057;848;2623
353510;201309;1344;4444;1160;3947;335;1251;359;1075;694;2326
353520;201309;1127;3543;958;3219;382;1368;248;835;630;2203
353530;201309;2715;8340;2429;7803;676;2442;1053;3212;1729;5654
353540;201309;1904;5976;1750;5701;683;2315;618;2061;1301;4376
353550;201309;6636;19575;5936;18410;1235;4527;3280;9443;4515;13970
353560;201309;2206;7385;1848;6698;443;1864;736;2529;1179;4393
353570;201309;476;1555;398;1388;102;407;196;612;298;1019
353580;201309;2342;7849;2212;7609;803;3092;1115;3609;1918;6701
353590;201309;787;2315;674;2115;263;897;172;559;435;1456
353600;201309;1847;5450;1690;5175;402;1358;850;2612;1252;3970
353610;201309;584;2108;516;1967;155;680;166;593;321;1273
353620;201309;2348;8315;2145;7944;738;2981;743;2585;1481;5566
353625;201309;353;996;258;828;103;373;69;198;172;571
353630;201309;1716;5948;1379;5140;359;1485;289;982;648;2467
353640;201309;1533;4492;1413;4256;400;1285;660;2034;1060;3319
353650;201309;6152;19082;4502;15285;1072;3926;1760;5637;2832;9563
353657;201309;300;1029;274;968;68;277;98;337;166;614
353660;201309;1335;3465;1009;3006;465;1511;148;299;613;1810
353670;201309;4770;16013;4177;14697;1331;5062;1392;4674;2723;9736
353680;201309;637;2335;604;2270;329;1275;151;572;480;1847
353690;201309;502;1421;349;1153;110;416;121;362;231;778
353700;201309;2271;7521;2008;6908;512;2020;639;2012;1151;4032
353710;201309;1899;6833;1640;6225;622;2597;528;1943;1150;4540
353715;201309;474;1431;415;1332;72;267;214;682;286;949
353720;201309;2066;6613;1819;6223;386;1330;1062;3792;1448;5122
353730;201309;4400;14079;3573;12121;947;3460;949;3019;1896;6479
353740;201309;2301;7120;1846;6154;652;2285;499;1601;1151;3886
353750;201309;616;2238;536;2061;186;770;137;531;323;1301
353760;201309;6767;22478;5670;20313;1823;6880;2193;7933;4016;14813
353770;201309;834;2633;541;1872;136;503;72;195;208;698
353780;201309;5719;20833;5198;19760;2539;9875;1227;4930;3766;14805
353790;201309;3089;11249;2777;10589;1030;4310;517;2005;1547;6315
353800;201309;14041;46144;11400;40855;3227;12720;4740;16476;7967;29196
353810;201309;1178;3967;1048;3676;335;1244;411;1435;746;2679
353820;201309;1202;4356;1153;4260;425;1765;437;1500;862;3265
353830;201309;782;2200;611;1866;134;446;257;775;391;1221
353850;201309;1809;6063;1691;5846;464;1741;799;2656;1263;4397
353860;201309;2400;8350;2056;7555;734;2921;695;2503;1429;5424
353870;201309;22864;73240;17522;62007;4217;16783;6190;19937;10407;36720
353880;201309;2496;8459;2292;8142;518;2119;1307;4508;1825;6627
353890;201309;2347;6275;1758;5305;537;1809;746;2112;1283;3921
353900;201309;1145;3660;856;2986;228;872;188;576;416;1448
353910;201309;2087;7487;1985;7206;660;2556;831;3043;1491;5599
353920;201309;2567;7818;1994;6605;509;1753;391;1208;900;2961
353930;201309;3689;13439;3248;12483;1244;5085;750;2781;1994;7866
353940;201309;1505;4889;1327;4524;344;1365;523;1617;867;2982
353950;201309;3620;12101;3340;11579;604;2418;2124;7158;2728;9576
353960;201309;579;1902;479;1664;124;483;130;380;254;863
353970;201309;521;1552;456;1464;53;207;337;1059;390;1266
353980;201309;14034;42251;11901;38803;3014;10610;6225;20047;9239;30657
353990;201309;505;1615;460;1500;149;540;163;470;312;1010
354000;201309;1879;5700;1295;4504;313;1209;128;386;441;1595
354010;201309;378;1216;339;1147;164;575;92;313;256;888
354020;201309;4589;14358;4184;13500;1484;5163;1603;4839;3087;10002
354025;201309;1048;3087;831;2672;232;823;199;617;431;1440
354030;201309;604;1634;433;1382;155;549;132;388;287;937
354040;201309;777;2165;623;1886;97;366;371;1039;468;1405
354050;201309;914;3147;836;2967;338;1284;217;758;555;2042
354060;201309;4312;14468;3605;12961;1028;4010;1480;5112;2508;9122
354070;201309;3556;11977;3105;10957;1185;4497;742;2562;1927;7059
354075;201309;2250;8626;2151;8445;772;3281;913;3510;1685;6791
354080;201309;1879;5846;1514;4954;419;1440;490;1505;909;2945
354085;201309;299;856;267;797;35;139;181;490;216;629
354090;201309;1098;3376;1046;3296;154;548;776;2391;930;2939
354100;201309;16594;57883;14417;53827;3908;15591;6744;25134;10652;40725
354105;201309;841;2724;698;2436;195;817;241;724;436;1541
354110;201309;808;2405;667;2179;184;671;216;659;400;1330
354120;201309;2186;6355;1893;5838;581;1999;655;1869;1236;3868
354130;201309;6209;19469;5546;18125;2055;7134;1760;5543;3815;12677
354140;201309;19152;51886;12737;39210;2624;9226;5360;15294;7984;24520
354150;201309;4382;12653;3586;11251;1116;3869;1413;4270;2529;8139
354160;201309;3936;13277;3503;12353;1050;3979;1431;4868;2481;8847
354165;201309;395;1491;361;1403;130;537;82;329;212;866
354170;201309;1596;5310;1308;4598;297;1184;462;1449;759;2633
354180;201309;506;1567;483;1519;51;187;346;1039;397;1226
354190;201309;1621;5539;1403;5020;491;1852;420;1442;911;3294
354200;201309;1142;3390;946;3024;229;871;361;1005;590;1876
354210;201309;850;3033;763;2827;199;874;297;1000;496;1874
354220;201309;3061;9867;2782;9326;1000;3545;1056;3444;2056;6989
354230;201309;785;2640;745;2572;244;898;339;1163;583;2061
354240;201309;1271;4419;1055;3944;326;1342;264;938;590;2280
354250;201309;528;1738;441;1588;193;778;120;403;313;1181
354260;201309;9388;28912;8528;27511;2722;9665;3454;11015;6176;20680
354270;201309;1120;4046;1045;3875;335;1386;412;1512;747;2898
354280;201309;890;2675;833;2577;177;623;445;1374;622;1997
354290;201309;1306;4708;1199;4471;398;1588;306;1115;704;2703
354300;201309;3870;13635;3777;13448;1063;4017;1984;7004;3047;11021
354310;201309;789;2678;625;2262;185;718;139;510;324;1228
354320;201309;823;2526;711;2296;216;787;237;705;453;1492
354323;201309;329;994;270;896;100;361;92;272;192;633
354325;201309;1291;4495;1182;4248;347;1422;420;1375;767;2797
354330;201309;7892;25160;7197;23763;2026;7202;3716;11972;5742;19174
354340;201309;29485;98096;25359;90377;9843;37678;8790;30326;18633;68004
354350;201309;1150;3527;1077;3391;314;1044;556;1688;870;2732
354360;201309;441;1441;362;1297;93;360;38;125;131;485
354370;201309;1151;3916;1027;3648;174;747;702;2420;876;3167
354380;201309;1304;3988;1092;3604;416;1526;188;537;604;2063
354390;201309;11221;37176;8569;31073;2300;9183;2601;8984;4901;18167
354400;201309;2096;7547;1835;6896;489;2007;570;2029;1059;4036
354410;201309;6285;19676;5315;18140;1300;4859;2842;9650;4142;14509
354420;201309;1645;4931;1394;4389;459;1555;445;1334;904;2889
354425;201309;3512;10342;3076;9547;1088;3596;950;3011;2038;6607
354430;201309;1324;4419;1220;4258;329;1292;577;1926;906;3218
354440;201309;503;1572;419;1407;110;407;152;487;262;894
354450;201309;457;1346;329;1059;60;252;100;275;160;527
354460;201309;746;2333;686;2224;263;893;333;1079;596;1972
354470;201309;451;1372;379;1227;74;298;167;490;241;788
354480;201309;731;2269;654;2132;154;594;293;829;447;1423
354490;201309;734;2538;568;2104;146;584;185;599;331;1183
354500;201309;2538;8718;2332;8335;879;3451;713;2563;1592;6014
354510;201309;672;2309;601;2148;197;759;227;799;424;1558
354515;201309;342;1210;284;1076;76;326;89;309;165;635
354520;201309;5110;18593;4401;16916;1487;6314;1494;5487;2981;11801
354530;201309;2689;9919;2518;9573;737;3001;1340;5077;2077;8078
354540;201309;1352;4289;1187;3996;401;1424;430;1496;831;2920
354550;201309;516;1791;456;1628;105;393;160;543;265;936
354560;201309;1385;4256;1094;3597;334;1129;328;1044;662;2173
354570;201309;601;1916;500;1668;185;668;115;362;300;1030
354580;201309;8826;26459;7435;23753;1664;6052;3649;11013;5313;17065
354600;201309;1702;5981;1517;5614;509;2161;603;2078;1112;4239
354610;201309;468;1328;330;1049;69;231;98;274;167;505
354620;201309;416;1473;342;1335;105;482;110;391;215;873
354625;201309;275;929;234;841;58;237;57;196;115;433
354630;201309;1859;6625;1680;6182;704;2614;530;1858;1234;4472
354640;201309;4101;14034;3536;12785;1096;4440;824;2748;1920;7188
354650;201309;982;3057;891;2861;194;722;481;1478;675;2200
354660;201309;1938;5961;1521;5143;504;1902;534;1714;1038;3616
354670;201309;1656;5507;1317;4611;404;1541;333;996;737;2537
354680;201309;5215;17947;4800;17031;1422;5381;1838;6343;3260;11724
354690;201309;767;2692;560;2151;126;523;184;646;310;1169
354700;201309;1143;3271;788;2503;138;508;327;890;465;1398
354710;201309;618;1881;531;1708;149;566;179;520;328;1086
354720;201309;189;557;152;479;57;177;41;138;98;315
354730;201309;7235;26308;6513;24783;2119;8585;2555;9433;4674;18018
354740;201309;227;764;193;688;47;173;45;162;92;335
354750;201309;2278;7454;1948;6992;690;2676;702;2470;1392;5146
354760;201309;2176;7393;1869;6684;646;2443;465;1598;1111;4041
354765;201309;255;712;186;591;38;146;39;104;77;250
354770;201309;2774;8316;2232;7407;1014;3622;387;1200;1401;4822
354780;201309;32758;108565;30757;103821;8248;30665;15200;48825;23448;79490
354790;201309;875;2876;794;2760;224;875;425;1388;649;2263
354800;201309;2138;6716;1977;6489;600;2138;1115;3638;1715;5776
354805;201309;866;2730;667;2288;120;475;126;390;246;865
354810;201309;660;2240;521;1947;195;790;85;308;280;1098
354820;201309;1033;3791;937;3579;315;1359;229;796;544;2155
354830;201309;427;1352;377;1253;112;433;136;414;248;847
354840;201309;788;2416;728;2297;239;811;243;740;482;1551
354850;201309;14634;48643;11403;41652;3322;13448;3943;13415;7265;26863
354860;201309;1253;4179;1139;3973;327;1357;505;1641;832;2998
354870;201309;42328;139273;39889;134160;12424;44784;19306;63174;31730;107958
354880;201309;4018;12968;2978;10579;932;3628;726;2304;1658;5932
354890;201309;14702;46305;12754;42319;3748;13735;4525;14278;8273;28013
354900;201309;602;1719;488;1557;170;603;177;552;347;1155
354910;201309;5854;18683;3751;13719;985;3954;503;1747;1488;5701
354920;201309;501;1503;385;1281;117;415;94;297;211;712
354925;201309;362;1066;212;746;42;162;35;111;77;273
354930;201309;249;768;229;719;75;272;60;176;135;448
354940;201309;2416;8640;1902;7236;811;3250;337;1237;1148;4487
354950;201309;1448;4937;1330;4767;254;1068;815;2840;1069;3908
354960;201309;785;2519;686;2351;213;813;272;893;485;1706
354970;201309;3980;13676;3525;12713;871;3552;1738;5975;2609;9527
354980;201309;32298;81201;17943;55946;4083;14182;6076;17536;10159;31718
354990;201309;34593;119576;32351;114802;7829;30846;17150;58950;24979;89796
354995;201309;1935;6208;1827;6046;485;1704;924;3082;1409;4786
355000;201309;1617;5578;1432;5251;554;2169;389;1392;943;3561
355010;201309;3634;11707;3100;10531;808;3056;1440;4771;2248;7827
355020;201309;3160;11644;2760;10842;1406;5831;706;2795;2112;8626
355030;201309;799719;2423955;738189;2302516;215118;726164;303481;923021;518599;1649185
355040;201309;2841;9581;2536;8986;925;3612;1133;3812;2058;7424
355050;201309;1232;4000;1019;3549;304;1155;275;938;579;2093
355060;201309;4784;16846;3868;14670;1156;4850;815;2793;1971;7643
355070;201309;6217;20207;5588;19124;1369;5405;2960;9549;4329;14954
355080;201309;1273;4795;1088;4285;397;1746;158;521;555;2267
355090;201309;1056;3885;897;3485;213;914;383;1423;596;2337
355100;201309;29173;96802;26248;91531;9650;35248;8818;31619;18468;66867
355110;201309;1296;4587;1185;4345;425;1681;382;1359;807;3040
355120;201309;651;2136;569;1967;185;694;222;731;407;1425
355130;201309;520;1442;350;1092;101;346;106;270;207;616
355140;201309;1005;3707;963;3607;299;1238;426;1541;725;2779
355150;201309;3368;11628;2968;10840;1011;3865;1109;3900;2120;7765
355160;201309;1469;5220;1291;4915;558;2364;350;1174;908;3538
355170;201309;8671;26478;6652;22658;2381;8768;1883;6221;4264;14989
355180;201309;2813;8968;2468;8324;731;2829;928;2963;1659;5792
355190;201309;1266;4527;1167;4306;506;1921;332;1187;838;3108
355200;201309;895;3415;858;3335;440;1789;196;740;636;2529
355210;201309;2703;9546;2458;9008;779;3213;956;3226;1735;6439
355220;201309;28646;100204;26506;95913;11952;44821;7268;27041;19220;71862
355230;201309;1037;3187;688;2382;131;536;163;483;294;1019
355240;201309;21359;67433;16618;56616;4138;15824;6659;20908;10797;36732
355250;201309;24039;83017;21916;78905;6644;25596;10217;36289;16861;61885
355255;201309;869;2477;637;1972;120;424;194;559;314;983
355260;201309;1575;4692;1414;4392;404;1405;538;1543;942;2948
355270;201309;1648;5161;1563;5024;240;976;1103;3346;1343;4322
355280;201309;22148;68936;19858;64510;5300;19335;9029;28100;14329;47435
355290;201309;859;2816;793;2694;167;634;390;1258;557;1892
355300;201309;840;2793;651;2372;163;658;156;508;319;1166
355310;201309;1028;3244;926;3052;254;875;411;1398;665;2273
355320;201309;732;2394;646;2192;193;727;219;633;412;1360
355330;201309;1518;5657;1307;5228;509;2250;329;1210;838;3460
355340;201309;3015;8384;2837;8079;778;2491;1521;4090;2299;6581
355350;201309;1347;4899;1210;4583;438;1792;303;1164;741;2956
355360;201309;1156;4134;1089;4002;282;1166;683;2459;965;3625
355365;201309;312;1004;262;899;76;289;67;224;143;513
355370;201309;6888;18398;5161;16387;1997;6952;1891;5971;3888;12923
355380;201309;3665;11398;2854;9485;844;3022;606;1771;1450;4793
355385;201309;979;3267;928;3170;386;1459;223;703;609;2162
355390;201309;1406;4008;1212;3612;334;1071;422;1227;756;2298
355395;201309;1570;5018;1297;4344;230;895;586;1800;816;2695
355400;201309;8610;30458;7924;29001;2687;10815;3293;11590;5980;22405
355410;201309;12454;46883;11754;45391;4855;19854;3330;12973;8185;32827
355420;201309;810;3011;774;2928;331;1317;247;949;578;2266
355430;201309;3577;10890;3132;10077;878;3119;1354;4199;2232;7318
355440;201309;879;2989;721;2574;222;825;188;607;410;1432
355450;201309;2508;8521;2116;7693;674;2688;643;2191;1317;4879
355460;201309;562;1637;436;1396;126;478;126;340;252;818
355465;201309;430;1319;364;1185;111;386;99;313;210;699
355470;201309;925;2948;757;2651;286;1108;236;775;522;1883
355475;201309;140;542;120;477;31;129;37;161;68;290
355480;201309;3184;11837;2997;11407;993;4085;1270;4674;2263;8759
355490;201309;802;2417;645;2098;194;700;140;451;334;1151
355495;201309;707;2401;669;2334;200;775;281;932;481;1707
355500;201309;8193;25390;5777;19921;1475;5642;1183;3725;2658;9367
355510;201309;1731;5275;1442;4635;340;1248;395;1192;735;2440
355520;201309;365;998;262;792;65;232;74;190;139;422
355530;201309;179;487;112;363;28;103;22;67;50;170
355535;201309;739;2304;610;2049;173;685;194;554;367;1239
355540;201309;10129;33479;9616;32589;2830;10324;4789;15923;7619;26247
355550;201309;705;2274;660;2182;199;727;304;973;503;1700
355560;201309;1429;4302;1102;3662;273;1024;249;704;522;1728
355570;201309;184;636;161;578;43;165;36;115;79;280
355580;201309;1217;3765;1064;3445;417;1503;349;1063;766;2566
355590;201309;246;700;218;644;50;181;106;301;156;482
355600;201309;1027;3427;875;3071;379;1404;204;682;583;2086
355610;201309;1403;4185;1200;3863;375;1324;485;1499;860;2823
355620;201309;3811;12589;3116;10992;793;3210;1296;4130;2089;7340
355630;201309;3190;9474;2038;6996;437;1703;699;2196;1136;3899
355635;201309;970;3311;858;3105;204;814;476;1680;680;2494
355640;201309;3786;12862;3189;11423;1184;4440;596;2108;1780;6548
355645;201309;3374;12390;3212;12070;700;2915;1944;7205;2644;10120
355650;201309;6377;20702;5601;19152;1351;5508;3104;9803;4455;15311
355660;201309;1270;4213;1062;3794;366;1466;349;1155;715;2621
355670;201309;2079;6896;1463;5397;403;1690;472;1524;875;3214
355680;201309;1716;6073;1446;5392;573;2246;289;1021;862;3267
355690;201309;326;1146;296;1091;195;749;23;59;218;808
355695;201309;328;1010;243;804;37;128;23;59;60;187
355700;201309;6281;22962;5821;21793;1836;7453;2493;8934;4329;16387
355710;201309;11988;31959;7922;24395;2772;9120;1950;5804;4722;14924
355715;201309;189;609;148;530;45;170;29;102;74;272
355720;201309;1549;5274;1321;4792;485;1939;380;1238;865;3177
355730;201309;769;2730;700;2589;284;1115;164;619;448;1734
410010;201309;1606;5250;1462;4921;413;1510;472;1580;885;3090
410020;201309;1216;4258;1146;4121;383;1433;405;1442;788;2875
410030;201309;1096;3905;956;3562;329;1310;192;739;521;2049
410040;201309;12575;42986;11606;41005;4221;16004;3300;11483;7521;27487
410045;201309;1066;3144;811;2671;262;928;269;839;531;1767
410050;201309;2961;8828;2133;7239;738;2745;629;2068;1367;4813
410060;201309;1896;6206;1726;5848;555;2113;601;1942;1156;4055
410070;201309;2148;6250;1752;5420;680;2297;342;940;1022;3237
410080;201309;1425;4379;1220;4010;298;1052;648;2059;946;3111
410090;201309;1117;3640;1016;3419;376;1364;308;985;684;2349
410100;201309;2871;8845;2318;7698;719;2734;496;1542;1215;4276
410105;201309;488;1618;399;1393;106;425;75;230;181;655
410110;201309;2531;8003;2246;7395;580;2185;805;2562;1385;4747
410115;201309;541;1544;466;1385;116;415;152;393;268;808
410120;201309;2831;9958;2691;9739;1102;4253;1030;3789;2132;8042
410130;201309;1358;4672;1246;4403;371;1287;608;2184;979;3471
410140;201309;14348;41435;10498;34101;3370;12177;3626;11602;6996;23779
410150;201309;16792;43924;8518;26431;1866;6595;1722;4762;3588;11357
410160;201309;3289;10763;2998;10261;1019;3846;1079;3707;2098;7553
410165;201309;765;2375;644;2104;136;486;310;980;446;1466
410170;201309;1680;5301;1451;4809;576;2072;414;1326;990;3398
410180;201309;8346;27452;7281;25067;1946;7622;3335;10649;5281;18271
410185;201309;665;1870;609;1776;159;491;358;1053;517;1544
410190;201309;2186;6716;1964;6228;649;2238;551;1645;1200;3883
410200;201309;4956;14622;4145;13025;1475;5087;724;2190;2199;7277
410210;201309;2548;7923;2038;6814;526;1992;413;1191;939;3183
410220;201309;607;1814;493;1577;103;367;185;568;288;935
410230;201309;1823;6008;1670;5729;662;2479;567;1877;1229;4356
410240;201309;5052;16166;4681;15388;1577;5600;1699;5511;3276;11111
410250;201309;2443;7106;1817;5832;614;2205;369;1048;983;3253
410260;201309;1645;5213;1464;4885;459;1636;523;1712;982;3348
410270;201309;534;1613;470;1496;148;511;194;622;342;1133
410275;201309;907;2755;660;2239;120;456;358;1211;478;1667
410280;201309;2741;8395;1954;6639;486;1868;324;1054;810;2922
410290;201309;3135;10096;2824;9489;842;3055;1110;3740;1952;6795
410300;201309;604;1774;548;1658;89;336;313;871;402;1207
410302;201309;546;1651;478;1546;56;183;317;1048;373;1231
410304;201309;1428;4800;1310;4560;399;1438;568;2052;967;3490
410305;201309;2152;5873;1848;5430;546;1695;994;2980;1540;4675
410310;201309;2270;7806;2090;7448;694;2687;717;2624;1411;5311
410315;201309;608;1950;505;1746;142;544;208;680;350;1224
410320;201309;1191;3592;835;2861;207;821;79;218;286;1039
410322;201309;550;1684;420;1384;117;411;124;395;241;806
410330;201309;1438;4166;1231;3757;369;1243;371;1070;740;2313
410335;201309;1041;3145;889;2859;255;934;315;941;570;1875
410337;201309;773;2133;675;1962;138;477;292;792;430;1269
410340;201309;565;1744;435;1407;89;326;110;298;199;624
410345;201309;1758;5411;1483;4854;517;1859;336;1005;853;2864
410347;201309;821;2375;604;1961;189;684;140;411;329;1095
410350;201309;987;3196;759;2729;227;907;127;438;354;1345
410360;201309;3293;10420;3006;9929;1018;3638;901;3006;1919;6644
410370;201309;12486;37604;9618;31503;2691;10020;2799;8471;5490;18491
410380;201309;1327;4287;1236;4105;312;1120;656;2155;968;3275
410390;201309;2775;8334;2275;7434;842;2942;633;1926;1475;4868
410395;201309;868;3037;796;2880;209;851;398;1428;607;2279
410400;201309;5011;16623;4450;15490;1464;5688;1300;4365;2764;10053
410405;201309;939;2846;776;2514;208;797;323;963;531;1760
410410;201309;1340;4659;1274;4536;491;1917;309;1062;800;2979
410420;201309;9527;31741;8516;29459;2997;11303;2327;7543;5324;18846
410425;201309;3156;10400;2320;8444;560;2290;377;1322;937;3612
410430;201309;14889;42583;11483;36217;3510;12128;3366;10500;6876;22628
410440;201309;3489;11345;3238;10894;861;3088;1611;5453;2472;8541
410442;201309;2892;10287;2660;9724;956;3693;859;3151;1815;6844
410445;201309;2330;8074;2038;7528;663;2637;785;3018;1448;5655
410450;201309;2579;7545;2103;6599;688;2322;433;1220;1121;3542
410460;201309;2334;7201;1969;6424;531;1885;758;2377;1289;4262
410465;201309;1701;6551;1560;6194;597;2457;470;1762;1067;4219
410470;201309;1884;6113;1671;5623;499;1777;633;2122;1132;3899
410480;201309;28687;86472;23920;77202;9349;32893;6375;19727;15724;52620
410490;201309;11079;37151;9391;33399;3134;12089;3093;10904;6227;22993
410500;201309;1435;4714;1238;4286;478;1796;315;1107;793;2903
410510;201309;2310;6358;1768;5297;504;1657;726;2020;1230;3677
410520;201309;3169;11337;3029;11052;1192;4580;1034;3787;2226;8367
410530;201309;1621;4774;1381;4300;375;1358;533;1529;908;2887
410540;201309;3770;11173;2767;9273;739;2665;1016;3392;1755;6057
410550;201309;6280;20020;5020;17136;1681;6334;743;2294;2424;8628
410560;201309;1233;4084;979;3415;244;901;246;738;490;1639
410570;201309;2740;9220;2512;8829;778;2843;1069;3973;1847;6816
410580;201309;24530;79991;21916;74556;7680;28581;6550;21255;14230;49836
410590;201309;1188;3893;822;2844;157;614;207;632;364;1246
410600;201309;1842;5703;1602;5230;478;1639;708;2340;1186;3979
410610;201309;816;2597;723;2419;208;757;311;992;519;1749
410620;201309;1689;6229;1535;5823;519;2076;395;1465;914;3541
410630;201309;2499;7562;2163;6926;610;2178;850;2636;1460;4814
410640;201309;4797;14533;3934;12903;1349;4994;946;2950;2295;7944
410645;201309;1260;4581;1210;4478;511;2026;371;1397;882;3423
410650;201309;2400;7564;2029;6828;737;2616;552;1787;1289;4403
410655;201309;870;2770;758;2537;246;883;208;687;454;1570
410657;201309;580;1841;519;1711;164;637;200;592;364;1229
410660;201309;3749;11138;2974;9439;1106;3749;616;1821;1722;5570
410670;201309;986;2908;766;2459;205;732;206;623;411;1355
410680;201309;2294;8297;1959;7391;557;2139;703;2790;1260;4929
410685;201309;652;2024;613;1957;122;393;397;1278;519;1671
410690;201309;104094;309115;73945;246201;19221;71175;18930;57114;38151;128289
410700;201309;2222;7428;2104;7193;717;2676;839;2728;1556;5404
410710;201309;1054;3391;880;2970;228;866;253;803;481;1669
410712;201309;743;2362;662;2191;307;1110;162;553;469;1663
410715;201309;1062;3403;937;3134;268;968;320;1044;588;2012
410720;201309;3899;12582;3318;11292;1016;3682;935;3025;1951;6707
410725;201309;1093;3183;817;2637;218;767;253;724;471;1491
410730;201309;691;2147;633;2020;281;955;168;516;449;1471
410740;201309;908;2799;663;2285;163;643;278;935;441;1578
410750;201309;1773;5518;1583;5059;542;1933;448;1300;990;3233
410752;201309;245;765;222;725;54;208;105;317;159;525
410753;201309;507;1589;416;1398;107;418;154;469;261;887
410754;201309;971;3087;861;2895;124;460;579;2023;703;2483
410755;201309;700;1988;559;1753;119;441;272;787;391;1228
410760;201309;2412;8053;2306;7846;925;3326;791;2653;1716;5979
410765;201309;15181;46696;11748;39648;3040;11422;2296;7625;5336;19047
410770;201309;844;2473;718;2235;264;903;208;596;472;1499
410773;201309;1234;3964;1115;3734;314;1170;487;1510;801;2680
410775;201309;1792;5402;1739;5315;489;1427;1082;3472;1571;4899
410780;201309;607;1868;507;1685;156;548;149;536;305;1084
410785;201309;909;3020;740;2519;265;930;270;931;535;1861
410790;201309;735;2324;632;2084;227;839;136;393;363;1232
410800;201309;2318;6701;1969;6090;814;2755;597;1758;1411;4513
410810;201309;307;962;250;826;34;131;106;343;140;474
410820;201309;1042;3240;920;2960;280;990;261;821;541;1811
410830;201309;29938;93342;25421;85014;8065;29370;8659;28726;16724;58096
410832;201309;1149;3534;1058;3359;247;925;523;1538;770;2463
410840;201309;7203;23440;6244;21285;2195;8148;1391;4322;3586;12470
410845;201309;1555;4800;1376;4429;276;975;773;2498;1049;3473
410850;201309;2686;8106;2439;7763;555;2068;1310;4128;1865;6196
410855;201309;704;2060;606;1862;173;583;205;621;378;1204
410860;201309;3511;10462;3022;9571;787;2620;1396;4574;2183;7194
410865;201309;1637;5780;1477;5461;381;1518;724;2727;1105;4245
410870;201309;1370;4363;1295;4240;627;2235;353;1094;980;3329
410880;201309;5010;15003;4133;13373;1284;4669;1115;3280;2399;7949
410890;201309;1087;3459;842;2979;285;1105;112;330;397;1435
410895;201309;1111;3982;1013;3752;368;1443;316;1125;684;2568
410900;201309;852;2480;673;2190;142;525;205;634;347;1159
410910;201309;308;984;273;920;61;219;126;407;187;626
410920;201309;810;2545;664;2270;208;764;181;568;389;1332
410930;201309;2017;6505;1796;6136;562;2214;668;2192;1230;4406
410940;201309;20199;70333;18361;66867;6199;24509;7697;28103;13896;52612
410950;201309;1869;6334;1707;6023;370;1363;1011;3635;1381;4998
410960;201309;6098;17913;4463;14939;1586;5693;1395;4786;2981;10479
410965;201309;1055;3492;957;3285;250;935;471;1644;721;2579
410970;201309;5003;15667;4218;14054;1476;5506;960;3228;2436;8734
410975;201309;1393;4177;1183;3802;223;843;606;1939;829;2782
410980;201309;5055;15442;3518;12087;985;3770;862;2810;1847;6580
410990;201309;1039;3256;797;2716;252;964;208;629;460;1593
411000;201309;446;1394;329;1131;78;306;54;158;132;464
411005;201309;474;1440;369;1174;98;309;66;186;164;495
411007;201309;2117;7011;1999;6786;617;2215;971;3420;1588;5635
411010;201309;3795;13244;3534;12646;1400;5477;863;2877;2263;8354
411020;201309;2561;8435;2345;8051;804;3071;861;2963;1665;6034
411030;201309;803;2282;706;2108;232;770;199;538;431;1308
411040;201309;369;1205;305;1050;106;390;62;204;168;594
411050;201309;2127;7834;1907;7306;767;3142;398;1501;1165;4643
411060;201309;2044;6630;1793;6103;597;2278;331;1025;928;3303
411065;201309;388;1197;311;1038;56;202;111;337;167;539
411070;201309;4080;13703;3148;11555;1045;4228;376;1221;1421;5449
411080;201309;1990;6413;1843;6103;491;1818;802;2631;1293;4449
411090;201309;1044;2928;899;2722;256;895;250;697;506;1592
411095;201309;1555;4597;1243;3993;328;1172;315;968;643;2140
411100;201309;1494;4391;1135;3681;270;982;276;870;546;1852
411110;201309;908;2778;706;2342;213;760;120;330;333;1090
411120;201309;1662;5369;1472;4966;490;1784;465;1536;955;3320
411125;201309;4625;15307;4500;15058;1610;5666;2143;7100;3753;12766
411130;201309;757;2370;637;2117;204;711;223;751;427;1462
411140;201309;2225;8121;1957;7406;723;2885;390;1565;1113;4450
411150;201309;5672;16598;4974;15271;1556;5213;1400;3941;2956;9154
411155;201309;1141;3498;1032;3250;368;1275;330;944;698;2219
411160;201309;303;922;275;869;113;369;83;253;196;622
411170;201309;779;2707;714;2548;213;813;233;818;446;1631
411180;201309;6026;18961;5327;17639;1696;6132;1631;5347;3327;11479
411190;201309;1771;5354;1494;4831;455;1640;444;1353;899;2993
411200;201309;3824;12411;3379;11668;1260;4720;1221;4137;2481;8857
411210;201309;2759;8124;2271;7239;889;3081;326;979;1215;4060
411220;201309;1178;3483;956;3064;249;915;399;1163;648;2078
411230;201309;1017;3197;820;2765;275;1020;220;682;495;1702
411240;201309;1375;3441;812;2535;261;908;191;510;452;1418
411250;201309;3080;8782;2553;7795;793;2514;810;2484;1603;4998
411260;201309;259;755;207;666;64;240;89;260;153;500
411270;201309;2000;6502;1853;6246;616;2313;784;2550;1400;4863
411275;201309;1510;4635;1329;4226;398;1304;366;1123;764;2427
411280;201309;1714;5384;1368;4633;411;1586;219;668;630;2254
411290;201309;1017;2935;851;2609;227;754;299;954;526;1708
411295;201309;1096;3375;1020;3248;222;792;457;1415;679;2207
411300;201309;1289;3408;902;2649;88;298;384;1046;472;1344
411310;201309;825;2459;666;2186;160;621;298;936;458;1557
411320;201309;5628;17779;4687;15860;1348;4777;1285;4221;2633;8998
411325;201309;1517;5023;1373;4736;190;761;910;3146;1100;3907
411330;201309;3435;11539;3156;11062;1255;4748;959;3327;2214;8075
411340;201309;966;2893;650;2138;125;456;267;890;392;1346
411342;201309;893;2606;730;2242;210;712;201;544;411;1256
411345;201309;1024;3392;959;3270;279;1034;486;1664;765;2698
411350;201309;2509;8090;1989;7036;670;2554;281;901;951;3455
411360;201309;505;1287;324;946;34;141;156;388;190;529
411370;201309;41703;124383;31884;105358;7575;29457;10906;32823;18481;62280
411373;201309;1374;4507;1181;4084;346;1378;273;884;619;2262
411375;201309;1314;3711;1060;3211;301;965;304;871;605;1836
411380;201309;1255;3406;794;2448;153;539;238;702;391;1241
411390;201309;1737;5493;1598;5298;263;1013;1151;3706;1414;4719
411400;201309;1623;5028;1358;4441;340;1254;471;1497;811;2751
411410;201309;2380;7605;2116;7010;720;2733;582;1638;1302;4371
411420;201309;4369;12933;3491;11071;1045;3698;790;2257;1835;5955
411430;201309;2754;9151;2390;8477;710;2720;1058;3634;1768;6354
411435;201309;549;1829;472;1626;132;495;155;514;287;1009
411440;201309;2528;8489;2327;8109;866;3259;695;2452;1561;5711
411450;201309;1933;6065;1780;5810;454;1571;932;3083;1386;4654
411460;201309;4164;13631;3366;11746;1356;5001;614;2026;1970;7027
411470;201309;908;2842;677;2258;186;666;130;400;316;1066
411480;201309;4479;14154;3694;12648;1698;6265;778;2540;2476;8805
411490;201309;1601;5195;1441;4901;638;2429;326;997;964;3426
411500;201309;1427;4396;1108;3698;368;1351;260;817;628;2168
411510;201309;2408;7237;1944;6339;643;2329;397;1133;1040;3462
411520;201309;27092;79285;18793;61801;6383;23181;3915;12134;10298;35315
411530;201309;886;2613;619;2098;262;1000;116;331;378;1331
411535;201309;493;1530;272;992;54;215;27;76;81;291
411540;201309;2908;8092;2336;7035;480;1559;1223;3761;1703;5320
411545;201309;987;3614;946;3523;220;901;606;2241;826;3142
411550;201309;683;1978;563;1778;256;873;112;333;368;1206
411560;201309;2528;7827;2140;6912;624;2208;497;1496;1121;3704
411570;201309;5325;15424;4230;13576;1347;4788;1087;3667;2434;8455
411573;201309;969;3089;927;3021;240;841;484;1607;724;2448
411575;201309;1388;4585;1230;4220;342;1252;484;1644;826;2896
411580;201309;3369;10414;2642;8950;646;2543;481;1422;1127;3965
411585;201309;442;1560;355;1307;94;366;50;170;144;536
411590;201309;553;1696;500;1585;145;530;131;387;276;917
411600;201309;355;1097;299;985;70;281;72;238;142;519
411605;201309;2245;6475;1705;5429;469;1654;644;1961;1113;3615
411610;201309;2156;6507;2056;6335;507;1670;1316;4014;1823;5684
411620;201309;2654;8981;2511;8736;873;3286;997;3524;1870;6810
411630;201309;680;1878;426;1464;138;544;84;251;222;795
411640;201309;568;1782;476;1586;142;519;170;531;312;1050
411650;201309;268;884;224;782;66;264;72;222;138;486
411660;201309;758;2291;666;2117;183;609;276;897;459;1506
411670;201309;1665;4985;1487;4647;511;1812;501;1438;1012;3250
411680;201309;1645;5230;1459;4909;394;1315;785;2827;1179;4142
411690;201309;3481;10729;2992;9819;1089;3846;810;2674;1899;6520
411695;201309;804;2633;688;2399;141;502;355;1253;496;1755
411700;201309;1802;5426;1385;4629;396;1487;389;1230;785;2717
411705;201309;2220;7750;1963;7269;487;1847;1143;4335;1630;6182
411710;201309;2142;6726;1705;5699;522;1916;359;1042;881;2958
411720;201309;830;2570;665;2174;161;583;166;508;327;1091
411721;201309;707;2171;600;1940;183;655;158;454;341;1109
411722;201309;659;2055;545;1827;147;572;166;507;313;1079
411725;201309;1261;4197;916;3358;247;1007;257;950;504;1957
411727;201309;2310;6758;1905;5916;508;1745;808;2400;1316;4145
411729;201309;509;1450;410;1281;78;272;158;454;236;726
411730;201309;5407;16466;4637;14975;1421;4962;1730;5579;3151;10541
411740;201309;520;1569;422;1360;131;494;161;467;292;961
411745;201309;839;2714;701;2385;208;785;172;532;380;1317
411750;201309;3889;12458;3203;10820;1029;3837;552;1669;1581;5506
411760;201309;8450;26085;7728;24868;2965;10095;2444;8260;5409;18355
411770;201309;3677;13468;3384;12745;1384;5438;766;2925;2150;8363
411780;201309;2908;9994;2831;9890;436;1460;2041;7516;2477;8976
411790;201309;2566;8009;2144;7192;735;2787;604;1927;1339;4714
411800;201309;1190;3682;780;2648;150;571;117;296;267;867
411810;201309;1458;4672;1265;4223;361;1376;311;858;672;2234
411820;201309;15940;51153;13461;46575;4797;17110;4257;15580;9054;32690
411830;201309;437;1229;362;1127;117;368;140;468;257;836
411840;201309;8278;25593;6893;22848;2188;7980;2067;6648;4255;14628
411845;201309;485;1606;391;1400;114;445;84;282;198;727
411850;201309;5884;18712;5090;17120;1485;5457;1566;5201;3051;10658
411860;201309;834;2767;723;2516;222;830;193;630;415;1460
411870;201309;970;3530;799;3057;143;581;198;711;341;1292
411880;201309;2449;7163;2088;6570;496;1754;1066;3361;1562;5115
411885;201309;1396;3941;1157;3578;370;1281;340;942;710;2223
411890;201309;1249;3951;929;3203;276;1064;210;640;486;1704
411900;201309;870;2851;692;2406;223;805;118;398;341;1203
411910;201309;1167;4131;1056;3855;321;1284;357;1243;678;2527
411915;201309;11324;33869;8005;26628;2126;7894;1929;5757;4055;13651
411920;201309;961;3531;878;3311;295;1208;188;674;483;1882
411925;201309;576;1704;468;1509;150;514;166;532;316;1046
411930;201309;5988;20357;5329;18997;1820;6916;1958;7120;3778;14036
411940;201309;3523;12136;3194;11416;1084;4071;886;3177;1970;7248
411950;201309;10172;33767;8959;31565;2859;10964;3919;13605;6778;24569
411960;201309;5534;17331;5203;16719;1497;5378;2361;7356;3858;12734
411965;201309;420;1472;372;1361;111;444;104;379;215;823
411970;201309;715;2162;584;1940;199;697;172;559;371;1256
411980;201309;2061;5787;1477;4852;189;689;834;2735;1023;3424
411990;201309;27205;96478;24075;89724;9327;37018;6355;24063;15682;61081
411995;201309;2945;9571;2729;9143;1137;4089;727;2425;1864;6514
412000;201309;1963;5631;1606;4999;363;1310;669;1829;1032;3139
412010;201309;711;2460;631;2273;201;762;205;716;406;1478
412015;201309;600;1957;515;1772;99;386;279;932;378;1318
412020;201309;413;1262;329;1092;119;432;126;396;245;828
412030;201309;571;1825;398;1406;87;366;120;392;207;758
412033;201309;687;2189;536;1826;140;529;96;299;236;828
412035;201309;923;2761;771;2478;201;742;319;951;520;1693
412040;201309;715;2413;652;2253;258;945;201;681;459;1626
412050;201309;1582;4856;1264;4159;324;1193;291;910;615;2103
412060;201309;7162;25705;6615;24415;2182;8551;2547;9388;4729;17939
412065;201309;932;2957;832;2745;261;979;234;708;495;1687
412070;201309;1073;3120;961;2885;211;688;391;1159;602;1847
412080;201309;1908;6187;1419;5080;434;1731;164;506;598;2237
412085;201309;268;754;162;555;48;181;41;134;89;315
412090;201309;4753;16095;4561;15738;1019;3814;2885;10050;3904;13864
412100;201309;2166;7048;1926;6619;656;2391;665;2265;1321;4656
412110;201309;870;2782;757;2541;278;976;257;839;535;1815
412120;201309;2327;8086;2143;7658;553;2166;1064;3670;1617;5836
412125;201309;951;3010;854;2853;263;957;332;1116;595;2073
412130;201309;751;2191;554;1809;131;484;151;483;282;967
412135;201309;547;1600;413;1311;86;307;188;541;274;848
412140;201309;1769;5525;1510;5007;456;1610;439;1459;895;3069
412150;201309;2708;8343;2410;7745;426;1516;1375;4309;1801;5825
412160;201309;1140;3657;910;3104;274;1056;326;1063;600;2119
412170;201309;4180;14535;3697;13557;1412;5493;1238;4480;2650;9973
412175;201309;1445;5193;1321;4902;388;1570;527;1974;915;3544
412180;201309;1681;5503;1327;4847;533;2133;343;1184;876;3317
412190;201309;2857;9002;2460;8348;974;3494;697;2487;1671;5981
412200;201309;2120;7439;1618;5968;403;1592;500;1784;903;3376
412210;201309;653;1981;467;1560;146;555;90;271;236;826
412215;201309;3073;10429;2813;9927;514;1880;1791;6516;2305;8396
412217;201309;1149;3498;1100;3411;241;876;671;1935;912;2811
412220;201309;5567;18931;5350;18503;1927;7031;2638;9063;4565;16094
412230;201309;2806;9961;2521;9323;868;3504;686;2437;1554;5941
412240;201309;7961;22780;4810;16035;1103;4089;679;2020;1782;6109
412250;201309;2122;6654;1935;6272;760;2661;479;1435;1239;4096
412260;201309;1253;3836;858;2954;211;831;242;725;453;1556
412265;201309;1125;3685;1054;3557;289;1166;488;1578;777;2744
412270;201309;730;2517;582;2127;147;616;101;334;248;950
412280;201309;883;2803;750;2544;203;735;332;1103;535;1838
412290;201309;1192;3437;1016;3104;218;755;418;1228;636;1983
412300;201309;1721;5232;1434;4652;445;1661;431;1293;876;2954
412310;201309;1188;3457;1043;3263;222;601;672;2340;894;2941
412320;201309;713;2004;527;1680;117;438;226;708;343;1146
412330;201309;1949;5478;1507;4716;394;1337;675;2083;1069;3420
412340;201309;850;2792;637;2250;142;561;118;386;260;947
412350;201309;2375;7811;2024;6992;649;2423;388;1222;1037;3645
412360;201309;334;1106;298;1006;71;257;77;220;148;477
412370;201309;1107;3505;875;3047;318;1163;248;853;566;2016
412380;201309;1954;6053;1730;5586;403;1349;766;2596;1169;3945
412382;201309;713;2064;533;1676;145;529;158;442;303;971
412385;201309;2431;7971;2263;7618;678;2389;858;2998;1536;5387
412390;201309;2376;7280;2200;6985;823;2851;776;2422;1599;5273
412395;201309;957;2723;782;2443;111;355;514;1649;625;2004
412400;201309;1181;3717;1059;3488;338;1200;435;1460;773;2660
412402;201309;1994;6354;1700;5718;546;1961;425;1305;971;3266
412405;201309;3926;11710;2571;8670;666;2574;260;763;926;3337
412410;201309;6082;20397;5581;19366;2496;9440;1074;3647;3570;13087
412420;201309;518;1579;433;1432;143;527;126;369;269;896
412430;201309;452;1387;380;1231;122;441;150;437;272;878
412440;201309;3963;12085;3519;11314;692;2468;1555;5237;2247;7705
412450;201309;410;1316;345;1155;87;324;79;214;166;538
412460;201309;972;2776;671;2204;163;631;172;525;335;1156
412470;201309;2015;7021;1846;6613;605;2329;706;2492;1311;4821
412480;201309;1316;3951;965;3177;229;829;194;535;423;1364
412490;201309;1269;3823;1137;3519;317;1033;327;1003;644;2036
412500;201309;1971;6025;1674;5432;529;1883;406;1197;935;3080
412510;201309;2675;9312;2392;8552;833;3201;763;2632;1596;5833
412520;201309;1801;5158;1404;4497;397;1365;509;1613;906;2978
412530;201309;782;2366;665;2115;221;762;172;518;393;1280
412535;201309;391;1198;275;902;77;274;98;277;175;551
412540;201309;1197;3626;950;3077;191;722;378;1196;569;1918
412545;201309;895;2611;751;2306;144;498;277;757;421;1255
412550;201309;23238;72217;16548;57004;4889;18193;3291;10523;8180;28716
412555;201309;309;982;228;772;58;208;42;114;100;322
412560;201309;4433;15444;3904;14309;1304;5178;885;3009;2189;8187
412570;201309;4071;12797;3248;10942;1055;3846;759;2501;1814;6347
412575;201309;1029;3315;861;2913;223;858;272;844;495;1702
412580;201309;1454;4062;1077;3407;268;914;360;1081;628;1995
412590;201309;478;1499;392;1343;159;579;93;314;252;893
412600;201309;1444;4725;1274;4379;448;1704;390;1269;838;2973
412610;201309;745;2444;611;2111;208;794;152;454;360;1248
412620;201309;1330;4468;1184;4155;452;1705;285;970;737;2675
412625;201309;13449;38875;11345;34933;4284;14244;2508;7632;6792;21876
412627;201309;936;2961;677;2393;226;857;83;279;309;1136
412630;201309;3444;11262;3065;10416;868;3178;933;3067;1801;6245
412635;201309;501;1579;386;1319;98;338;54;169;152;507
412640;201309;882;2761;682;2324;195;756;166;515;361;1271
412650;201309;2249;6510;1828;5742;504;1721;690;1971;1194;3692
412660;201309;2977;9172;2486;8123;662;2471;630;1924;1292;4395
412665;201309;711;1945;458;1503;140;508;131;404;271;912
412667;201309;1557;4836;1270;4245;342;1346;395;1185;737;2531
412670;201309;636;2036;430;1526;101;403;63;188;164;591
412680;201309;1372;4651;1189;4198;350;1316;336;1078;686;2394
412690;201309;629;2035;503;1746;186;704;70;230;256;934
412700;201309;1815;6115;1600;5730;616;2438;550;1911;1166;4349
412710;201309;8732;27917;7279;24867;2154;8011;1836;6061;3990;14072
412720;201309;1569;5026;1129;3923;289;1081;118;321;407;1402
412730;201309;2761;8517;1960;6787;627;2334;252;783;879;3117
412740;201309;2080;6958;1874;6474;772;2848;250;893;1022;3741
412750;201309;3291;11458;3139;11169;655;2625;2091;7237;2746;9862
412760;201309;2196;7519;2102;7351;684;2659;822;2715;1506;5374
412770;201309;11287;33986;7748;26133;1889;7126;1622;4958;3511;12084
412780;201309;1458;4919;1304;4548;405;1496;399;1322;804;2818
412785;201309;2357;7075;1811;5954;583;2068;717;2309;1300;4377
412788;201309;1329;4528;1253;4382;337;1388;540;1745;877;3133
412790;201309;1102;3568;933;3186;213;816;303;930;516;1746
412795;201309;1007;3061;871;2804;308;1076;278;851;586;1927
412796;201309;3115;9844;2922;9474;833;2970;1337;4222;2170;7192
412800;201309;3421;10487;2776;9231;803;2934;814;2530;1617;5464
412810;201309;8921;25954;6131;19902;1852;6595;1443;4260;3295;10855
412820;201309;6026;18968;4593;16080;1420;5369;1018;3614;2438;8983
412830;201309;399;1306;343;1193;103;418;84;243;187;661
412840;201309;2265;6655;1890;5922;577;2010;484;1496;1061;3506
412850;201309;2777;8621;2468;8178;533;2039;1246;4017;1779;6056
412853;201309;1620;4994;1448;4687;295;1185;789;2335;1084;3520
412855;201309;1640;4866;1342;4285;470;1714;355;982;825;2696
412860;201309;1231;3855;1092;3608;297;1101;495;1568;792;2669
412862;201309;772;2203;653;1982;191;639;226;649;417;1288
412863;201309;1204;4228;1161;4147;180;694;806;2861;986;3555
412865;201309;631;2036;474;1638;109;408;174;606;283;1014
412870;201309;1015;3014;874;2792;329;1146;277;879;606;2025
412880;201309;1565;4338;1323;3953;387;1282;365;1040;752;2322
420005;201309;484;1563;370;1310;86;333;160;537;246;870
420010;201309;3176;10211;2741;9455;439;1633;1901;6619;2340;8252
420020;201309;733;2535;492;1851;95;402;73;236;168;638
420030;201309;478;1440;291;1052;85;352;56;179;141;531
420040;201309;985;3115;681;2525;232;941;169;564;401;1505
420050;201309;758;2486;639;2211;203;729;236;801;439;1530
420055;201309;288;981;218;800;58;223;46;154;104;377
420060;201309;378;1349;288;1114;69;292;44;157;113;449
420070;201309;1960;6405;1714;5799;309;1163;783;2758;1092;3921
420075;201309;168;530;112;382;30;118;31;87;61;205
420080;201309;548;1917;495;1793;188;742;99;350;287;1092
420090;201309;675;2438;518;2038;142;578;99;396;241;974
420100;201309;1459;4891;1360;4753;350;1234;849;3040;1199;4274
420110;201309;423;1484;387;1399;128;464;155;577;283;1041
420120;201309;309;1097;258;982;112;460;38;125;150;585
420125;201309;352;1482;338;1448;132;603;94;371;226;974
420127;201309;559;1770;274;1035;92;375;31;116;123;491
420130;201309;2668;9335;2394;8774;763;3159;889;2958;1652;6117
420140;201309;4876;14862;3644;12540;1144;4395;927;3034;2071;7429
420150;201309;694;2192;516;1752;179;654;133;401;312;1055
420160;201309;285;878;192;654;49;201;40;105;89;306
420165;201309;196;655;142;512;25;97;35;131;60;228
420170;201309;230;776;166;639;66;294;17;46;83;340
420180;201309;417;1418;277;1030;83;316;67;238;150;554
420190;201309;517;1709;363;1389;137;579;62;222;199;801
420195;201309;1380;4028;1102;3641;294;1083;526;1758;820;2841
420200;201309;2812;9381;1853;7134;640;2759;316;1061;956;3820
420205;201309;1016;3480;919;3290;307;1194;391;1412;698;2606
420207;201309;1203;3685;919;3100;292;1108;248;772;540;1880
420208;201309;529;1699;414;1451;170;629;120;419;290;1048
420209;201309;341;1157;218;818;46;183;51;197;97;380
420210;201309;1712;5736;1155;4514;329;1473;164;565;493;2038
420213;201309;848;3222;810;3137;168;679;527;2051;695;2730
420215;201309;474;1644;367;1315;112;429;66;223;178;652
420220;201309;417;1663;391;1598;167;730;78;273;245;1003
420230;201309;4379;13953;3496;12301;898;3535;1782;6146;2680;9681
420240;201309;12134;38358;8442;30562;2011;8603;3286;10649;5297;19252
420243;201309;525;1745;446;1558;135;543;137;462;272;1005
420245;201309;1046;3405;783;2858;214;909;173;545;387;1454
420250;201309;840;2753;791;2673;303;1109;319;1096;622;2205
420253;201309;649;1733;541;1585;121;374;260;838;381;1212
420257;201309;413;1331;341;1193;100;348;155;548;255;896
420260;201309;1304;4532;1200;4326;381;1498;553;1983;934;3481
420270;201309;454;1522;248;923;34;131;27;88;61;219
420280;201309;2585;7803;1854;6472;586;2311;566;1754;1152;4065
420285;201309;143;431;57;211;11;47;2;5;13;52
420287;201309;640;1996;550;1820;146;521;216;706;362;1227
420290;201309;5914;17974;3948;13458;1039;3906;1337;4281;2376;8187
420300;201309;5615;18316;3912;14538;1172;4935;764;2802;1936;7737
420310;201309;812;2521;777;2458;185;631;462;1407;647;2038
420315;201309;914;3176;746;2806;198;857;321;1194;519;2051
420320;201309;4698;15549;4047;14348;1287;5134;1574;5330;2861;10464
420325;201309;473;1564;454;1513;159;593;140;449;299;1042
420330;201309;1254;4479;1016;3824;368;1515;180;554;548;2069
420340;201309;1473;4681;1210;4064;290;1058;419;1343;709;2401
420350;201309;1556;5175;1381;4813;405;1500;600;2096;1005;3596
420360;201309;3520;11652;2810;10066;1083;4236;493;1642;1576;5878
420370;201309;1925;5560;1749;5344;233;735;1404;4256;1637;4991
420380;201309;5294;18373;4528;16518;1498;5959;1180;4229;2678;10188
420390;201309;2012;6166;1254;4505;430;1689;275;876;705;2565
420395;201309;2175;6900;1697;5801;499;1928;376;1160;875;3088
420400;201309;1454;4475;1130;3841;348;1374;368;1172;716;2546
420410;201309;768;2214;577;1897;145;535;276;897;421;1432
420415;201309;484;1585;403;1374;118;431;144;488;262;919
420417;201309;800;2666;695;2428;157;563;337;1182;494;1745
420419;201309;404;1346;316;1192;158;635;79;300;237;935
420420;201309;14488;46004;11461;39434;3930;14611;3503;11909;7433;26520
420425;201309;1233;3563;804;2604;113;458;328;964;441;1422
420430;201309;4045;12987;2784;9943;861;3350;750;2610;1611;5960
420435;201309;194;681;147;552;70;296;23;77;93;373
420440;201309;1469;4401;908;3206;333;1267;154;492;487;1759
420445;201309;432;1286;333;1108;96;338;141;470;237;808
420450;201309;1256;3786;738;2674;181;747;146;423;327;1170
420455;201309;2233;7103;2004;6690;621;2359;838;2709;1459;5068
420460;201309;9389;30577;7853;27592;2378;9469;2972;9880;5350;19349
420470;201309;1119;3223;802;2640;245;884;238;760;483;1644
420475;201309;174;575;114;420;42;160;25;97;67;257
420480;201309;5950;18210;4947;16481;2094;7724;820;2649;2914;10373
420490;201309;687;2443;582;2191;179;707;145;518;324;1225
420500;201309;2083;6590;1771;6040;526;1912;925;3197;1451;5109
420510;201309;180;786;176;767;75;333;35;138;110;471
420515;201309;156;580;128;505;41;172;21;80;62;252
420517;201309;935;2945;855;2770;119;399;587;1937;706;2336
420519;201309;407;1180;302;955;62;198;119;391;181;589
420520;201309;695;2160;588;1977;168;615;233;758;401;1373
420530;201309;1345;4788;1118;4182;384;1577;262;860;646;2437
420535;201309;262;827;201;685;66;249;43;127;109;376
420540;201309;18798;59199;14715;50399;5298;19937;4350;14225;9648;34162
420543;201309;438;1301;323;1092;57;205;199;662;256;867
420545;201309;1491;4884;1240;4326;373;1463;369;1207;742;2670
420550;201309;4667;15829;4001;14240;1281;5129;1259;4372;2540;9501
420555;201309;453;1508;385;1348;152;569;110;381;262;950
420560;201309;567;1735;484;1569;80;285;252;834;332;1119
420570;201309;1897;6410;1555;5567;485;1938;465;1541;950;3479
420580;201309;984;3463;848;3204;262;1104;377;1428;639;2532
420590;201309;3164;10297;2351;8372;592;2308;498;1668;1090;3976
420600;201309;804;2894;729;2710;221;891;292;1085;513;1976
420610;201309;593;1987;435;1615;147;606;72;237;219;843
420620;201309;1184;3833;1058;3593;414;1524;238;785;652;2309
420630;201309;1037;3452;829;2918;268;1041;236;698;504;1739
420640;201309;621;2151;352;1410;88;400;40;165;128;565
420650;201309;2221;7171;1340;4959;314;1298;252;782;566;2080
420660;201309;667;2035;551;1814;110;405;297;960;407;1365
420665;201309;762;2278;495;1689;93;365;177;533;270;898
420670;201309;1682;5553;1296;4650;362;1451;210;688;572;2139
420675;201309;227;745;166;595;41;166;77;251;118;417
420680;201309;545;1475;380;1208;95;348;120;354;215;702
420690;201309;868;3121;671;2558;189;810;201;708;390;1518
420700;201309;6052;18897;5054;16794;1786;6605;1286;4033;3072;10638
420710;201309;729;2716;630;2495;243;1036;154;579;397;1615
420720;201309;1963;6176;1700;5812;484;1723;952;3262;1436;4985
420730;201309;4548;14514;4004;13537;1540;5525;1389;4635;2929;10160
420740;201309;675;2410;657;2379;182;689;399;1444;581;2133
420750;201309;2405;8037;1754;6401;426;1790;547;1754;973;3544
420757;201309;113;406;98;378;26;111;26;94;52;205
420760;201309;427;1414;313;1088;73;282;98;335;171;617
420765;201309;532;1928;403;1550;129;531;88;330;217;861
420768;201309;1222;4510;1084;4179;363;1453;397;1605;760;3058
420770;201309;848;2763;582;2125;187;746;160;551;347;1297
420775;201309;618;2045;515;1791;141;495;208;732;349;1227
420780;201309;1681;5273;1211;4124;365;1342;360;1153;725;2495
420785;201309;313;991;226;764;36;142;85;258;121;400
420790;201309;1334;4965;1116;4335;332;1371;433;1640;765;3011
420800;201309;883;2678;558;1930;155;587;128;406;283;993
420810;201309;2487;8931;2045;7853;728;3114;535;1974;1263;5088
420820;201309;7461;26706;6440;24788;2341;10044;2321;8791;4662;18835
420830;201309;2647;9112;2292;8418;902;3583;758;2676;1660;6259
420840;201309;787;2564;541;2037;168;714;161;554;329;1268
420845;201309;1087;3837;919;3490;328;1372;153;537;481;1909
420850;201309;1819;6199;1317;5140;459;1942;276;1088;735;3030
420860;201309;662;1985;452;1580;190;743;151;508;341;1251
420870;201309;1359;4094;1104;3726;438;1613;332;1104;770;2717
420880;201309;1446;4973;1204;4317;347;1291;249;863;596;2154
420890;201309;12383;29929;5873;18701;1219;4590;2298;6621;3517;11211
420895;201309;218;613;106;357;30;105;37;124;67;229
420900;201309;2255;6721;1533;5285;460;1739;379;1236;839;2975
420910;201309;22179;70372;15114;54793;4148;17095;3825;12971;7973;30066
420915;201309;656;2598;606;2464;170;700;274;1180;444;1880
420917;201309;401;1256;234;770;51;200;76;199;127;399
420920;201309;181;536;104;365;40;152;17;58;57;210
420930;201309;19572;61852;17123;57254;5851;21310;5786;19264;11637;40574
420940;201309;4460;14239;3922;13012;1251;4607;1252;3858;2503;8465
420945;201309;235;745;156;547;42;165;41;139;83;304
420950;201309;544;1683;301;1146;81;340;58;217;139;557
420960;201309;1413;4564;1212;4182;431;1637;368;1160;799;2797
420970;201309;2639;8619;2356;8163;678;2503;1205;4282;1883;6785
420980;201309;383;1384;352;1308;109;402;184;722;293;1124
420985;201309;480;1553;344;1252;110;433;85;294;195;727
420990;201309;874;2660;598;2156;153;608;178;579;331;1187
421000;201309;670;2433;484;1934;154;674;56;174;210;848
421003;201309;614;1836;270;971;63;252;41;131;104;383
421005;201309;233;799;216;766;67;263;102;358;169;621
421010;201309;6630;21284;5291;18474;1834;6885;1582;5269;3416;12154
421020;201309;506;1727;411;1527;83;303;225;901;308;1204
421030;201309;1045;3881;954;3636;346;1393;297;1145;643;2538
421040;201309;847;2716;755;2555;260;969;269;844;529;1813
421050;201309;1865;5218;1183;4054;314;1228;432;1379;746;2607
421055;201309;266;909;193;711;44;181;53;173;97;354
421060;201309;529;2012;439;1745;136;581;91;329;227;910
421070;201309;777;2522;544;1965;148;600;169;628;317;1228
421080;201309;653;2166;609;2072;207;757;249;819;456;1576
421085;201309;516;1465;296;1057;79;311;64;239;143;550
421090;201309;415;1256;318;1034;84;285;140;460;224;745
421100;201309;966;3128;739;2605;214;786;182;579;396;1365
421105;201309;1375;4638;1235;4372;335;1262;533;1966;868;3228
421110;201309;1625;5433;1412;5071;529;2078;448;1536;977;3614
421120;201309;1554;5296;1222;4449;314;1336;384;1280;698;2616
421125;201309;369;1245;329;1148;125;468;112;361;237;829
421130;201309;4530;15410;3891;14220;1591;6260;1166;4354;2757;10614
421140;201309;433;1411;350;1219;111;420;119;399;230;819
421145;201309;485;1650;416;1470;72;287;191;646;263;933
421150;201309;500;1730;390;1508;110;456;154;596;264;1052
421160;201309;818;2582;567;2046;136;548;176;590;312;1138
421165;201309;317;1174;260;980;63;251;103;405;166;656
421170;201309;1830;6068;1567;5351;493;1788;728;2424;1221;4212
421175;201309;1316;4083;1059;3650;363;1418;328;1044;691;2462
421180;201309;497;1518;322;1128;107;433;123;383;230;816
421185;201309;428;1306;352;1151;68;214;182;626;250;840
421187;201309;318;1021;263;912;76;279;97;316;173;595
421189;201309;527;1647;469;1528;136;476;171;546;307;1022
421190;201309;9547;31760;7539;27426;2487;9640;2255;8163;4742;17803
421200;201309;1046;3593;917;3291;284;1118;312;1060;596;2178
421205;201309;196;658;152;554;32;135;37;113;69;248
421210;201309;2009;6420;1775;5813;607;2110;572;1882;1179;3992
421220;201309;2453;8592;2204;8088;745;2934;716;2661;1461;5595
421223;201309;808;2411;552;1961;173;653;261;925;434;1578
421225;201309;1157;3668;987;3318;302;1103;376;1242;678;2345
421227;201309;934;3269;877;3176;262;944;504;1901;766;2845
421230;201309;746;2577;677;2399;197;759;243;811;440;1570
421240;201309;529;1823;368;1352;93;364;50;159;143;523
421250;201309;1846;5881;1342;4959;491;1976;366;1307;857;3283
421260;201309;244;792;159;618;40;158;33;123;73;281
421270;201309;629;1828;402;1426;144;550;86;319;230;869
421280;201309;1575;5094;1302;4664;471;1965;336;1169;807;3134
421290;201309;1925;5632;1309;4421;446;1605;287;879;733;2484
421300;201309;304;1009;271;940;117;448;96;307;213;755
421310;201309;512;1793;441;1595;152;555;110;394;262;949
421315;201309;358;1117;234;847;50;187;59;197;109;384
421320;201309;533;1862;359;1352;70;297;62;181;132;478
421330;201309;617;2218;540;2058;232;995;65;234;297;1229
421335;201309;562;1889;449;1658;129;523;93;336;222;859
421340;201309;1635;5595;1503;5347;532;2045;579;2029;1111;4074
421350;201309;1047;3635;868;3250;313;1300;235;825;548;2125
421360;201309;3188;9883;2172;7800;516;2134;727;2487;1243;4621
421370;201309;1087;3939;937;3589;331;1389;253;950;584;2339
421380;201309;1009;3029;845;2705;176;608;409;1309;585;1917
421390;201309;186;622;147;525;23;87;42;156;65;243
421400;201309;376;1488;311;1322;135;589;76;304;211;893
421410;201309;366;1176;295;1027;74;265;135;491;209;756
421415;201309;319;1058;206;812;69;281;58;216;127;497
421420;201309;1414;4544;1090;3713;269;984;242;761;511;1745
421430;201309;271;928;215;813;80;346;42;150;122;496
421440;201309;798;2501;572;2064;182;703;224;791;406;1494
421450;201309;617;2206;516;1956;219;884;124;469;343;1353
421460;201309;637;2152;466;1771;131;554;103;356;234;910
421470;201309;479;1899;445;1805;140;598;180;712;320;1310
421480;201309;2674;8822;1934;7202;617;2581;558;1882;1175;4463
421490;201309;263;959;195;785;95;400;38;152;133;552
421500;201309;2624;9609;2349;9030;1024;4292;531;1971;1555;6263
421505;201309;399;1400;363;1302;135;489;122;445;257;934
421507;201309;592;2091;501;1855;124;467;199;738;323;1205
421510;201309;289;1118;264;1061;85;389;106;375;191;764
421520;201309;769;2135;520;1621;63;241;271;762;334;1003
421530;201309;447;1536;318;1252;97;433;109;405;206;838
421535;201309;665;2137;437;1628;99;396;211;779;310;1175
421540;201309;373;1199;329;1109;80;304;120;387;200;691
421545;201309;1199;4252;998;3828;332;1407;206;739;538;2146
421550;201309;2115;7473;1945;7121;765;3041;593;2082;1358;5123
421555;201309;226;755;131;481;33;136;34;113;67;249
421560;201309;168;546;87;338;25;104;11;44;36;148
421565;201309;1070;3453;978;3289;449;1618;295;948;744;2566
421567;201309;942;3618;818;3276;406;1667;154;619;560;2286
421568;201309;454;1580;388;1430;121;455;122;462;243;917
421569;201309;186;632;123;448;21;89;35;111;56;200
421570;201309;947;3300;752;2849;274;1135;192;688;466;1823
421575;201309;602;2079;539;1945;116;437;281;1032;397;1469
421580;201309;4210;14327;3416;12542;1367;5559;757;2509;2124;8068
421590;201309;261;838;211;730;47;170;94;309;141;479
421600;201309;755;2434;612;2131;202;754;167;559;369;1313
421605;201309;664;2142;469;1730;140;580;108;383;248;963
421610;201309;1835;4854;1443;4281;215;693;918;2728;1133;3421
421620;201309;4735;15020;3510;12414;1269;4824;1146;4077;2415;8901
421625;201309;356;1220;239;893;74;307;80;276;154;583
421630;201309;2511;7884;1673;5914;476;1841;415;1416;891;3257
421635;201309;281;1006;241;937;69;289;92;327;161;616
421640;201309;1092;3614;977;3416;222;787;591;2115;813;2902
421650;201309;2398;8324;2123;7691;867;3414;347;1209;1214;4623
421660;201309;8983;31196;7399;27968;2613;10846;2185;7796;4798;18642
421670;201309;1096;3792;877;3240;259;1047;254;928;513;1975
421680;201309;1419;4811;1287;4476;530;1983;226;707;756;2690
421690;201309;2028;6930;1595;5842;491;1935;295;1049;786;2984
421700;201309;720;2345;495;1863;174;714;118;377;292;1091
421710;201309;331;1207;279;1066;112;440;69;252;181;692
421715;201309;243;778;183;634;50;178;55;191;105;369
421720;201309;1554;5162;1303;4687;543;2149;382;1277;925;3426
421725;201309;124;456;119;442;38;149;51;184;89;333
421730;201309;574;1875;325;1244;91;391;78;242;169;633
421740;201309;684;2222;532;1861;159;643;129;363;288;1006
421750;201309;1329;4250;1101;3748;348;1284;360;1119;708;2403
421755;201309;426;1445;337;1194;101;383;97;317;198;700
421760;201309;354;1228;281;1068;86;369;128;452;214;821
421770;201309;3622;11336;3013;10133;1341;4708;744;2575;2085;7283
421775;201309;548;1724;394;1415;94;336;123;445;217;781
421780;201309;1717;6114;1400;5387;590;2448;369;1332;959;3780
421790;201309;943;2804;622;2234;204;838;146;470;350;1308
421795;201309;379;1196;281;932;49;171;83;276;132;447
421800;201309;2388;8160;1929;7206;572;2397;620;2089;1192;4486
421810;201309;703;2412;594;2129;188;727;128;428;316;1155
421820;201309;1051;3500;888;3148;217;908;313;1010;530;1918
421825;201309;1300;4559;1211;4328;218;879;664;2308;882;3187
421830;201309;3030;10742;2860;10405;703;2625;1571;6028;2274;8653
421835;201309;178;580;141;518;55;228;53;172;108;400
421840;201309;514;1859;462;1726;193;793;154;530;347;1323
421850;201309;568;1681;432;1447;146;509;131;463;277;972
421860;201309;438;1498;335;1269;73;305;94;341;167;646
421870;201309;5117;15569;3719;12618;1216;4435;685;2254;1901;6689
421875;201309;301;965;192;709;48;200;48;152;96;352
421880;201309;1020;3507;826;3018;267;1110;196;631;463;1741
421885;201309;355;1278;320;1175;88;337;134;485;222;822
421890;201309;1060;3743;917;3430;323;1296;284;1035;607;2331
421895;201309;418;1460;405;1437;119;436;214;776;333;1212
421900;201309;869;2886;722;2521;201;749;260;824;461;1573
421910;201309;512;1736;388;1433;114;485;101;313;215;798
421915;201309;608;1920;507;1704;115;437;220;704;335;1141
421917;201309;540;1768;437;1567;145;611;127;405;272;1016
421920;201309;755;2423;623;2228;299;1164;175;563;474;1727
421930;201309;3732;11253;2736;9289;859;3224;453;1501;1312;4725
421935;201309;862;3167;714;2791;208;885;250;954;458;1839
421940;201309;290;1163;245;1013;91;405;56;204;147;609
421950;201309;4258;12390;2535;8841;815;3023;514;1816;1329;4839
421960;201309;247;819;205;718;56;211;59;197;115;408
421970;201309;1974;6295;1564;5347;545;2029;357;1109;902;3138
421985;201309;410;1210;263;898;46;187;91;317;137;504
430003;201309;919;2731;734;2406;213;782;262;848;475;1630
430005;201309;280;970;245;893;59;239;128;435;187;674
430010;201309;1987;6112;1581;5243;532;1813;569;1935;1101;3748
430020;201309;1086;3009;956;2814;238;792;516;1436;754;2228
430030;201309;1467;4246;1319;3933;406;1270;501;1427;907;2697
430040;201309;12799;33383;11321;31353;3509;10043;5489;15668;8998;25711
430045;201309;715;2016;583;1770;109;373;345;1009;454;1382
430047;201309;204;593;168;523;43;141;85;265;128;406
430050;201309;987;2884;677;2252;141;551;303;935;444;1486
430055;201309;253;756;195;624;47;166;101;313;148;479
430057;201309;69;182;29;97;7;30;11;24;18;54
430060;201309;13867;47100;12729;45107;4372;16053;5850;21195;10222;37248
430063;201309;1041;3207;885;2843;262;884;387;1279;649;2163
430064;201309;1643;5017;1409;4606;365;1204;755;2578;1120;3782
430066;201309;156;415;120;360;35;117;57;163;92;280
430070;201309;498;1687;403;1445;113;435;122;411;235;846
430080;201309;584;1966;475;1709;123;499;131;433;254;932
430085;201309;576;1795;474;1601;147;548;210;674;357;1222
430087;201309;949;2912;924;2864;98;328;749;2306;847;2634
430090;201309;732;1991;271;906;40;146;84;287;124;433
430100;201309;981;3226;815;2894;312;1213;202;615;514;1828
430105;201309;653;2228;561;2047;221;850;134;476;355;1326
430107;201309;256;865;208;720;40;147;94;312;134;459
430110;201309;2144;6518;2010;6307;667;2269;948;2942;1615;5211
430120;201309;1703;5375;1417;4770;290;1039;850;2835;1140;3874
430130;201309;4475;11648;4152;11242;735;2122;2768;7621;3503;9743
430140;201309;1174;3882;922;3259;310;1098;312;1120;622;2218
430150;201309;879;2443;629;1964;159;530;204;623;363;1153
430155;201309;496;1598;377;1323;103;352;151;538;254;890
430160;201309;18184;54595;17044;52742;3875;13242;9613;30244;13488;43486
430163;201309;1828;5666;1589;5211;382;1412;739;2443;1121;3855
430165;201309;277;992;239;919;108;425;42;160;150;585
430170;201309;751;2249;395;1400;103;413;90;280;193;693
430175;201309;946;3101;784;2743;186;597;417;1566;603;2163
430180;201309;1136;3193;1000;2990;211;676;559;1704;770;2380
430185;201309;744;1882;412;1243;68;246;141;363;209;609
430187;201309;753;2362;687;2261;183;721;307;964;490;1685
430190;201309;2239;6802;1984;6350;521;1908;947;3039;1468;4947
430192;201309;185;585;102;332;18;63;35;108;53;171
430195;201309;202;637;84;318;15;61;13;41;28;102
430200;201309;1766;5880;1525;5397;564;2110;281;997;845;3107
430205;201309;486;1496;401;1343;52;220;271;883;323;1103
430210;201309;5919;17584;3573;12387;1020;3761;675;2165;1695;5926
430215;201309;323;983;259;861;70;253;121;383;191;636
430220;201309;625;1673;313;1070;70;274;52;164;122;438
430222;201309;310;983;244;840;71;278;100;317;171;595
430223;201309;303;966;282;929;62;207;184;615;246;822
430225;201309;39;131;34;114;4;9;7;20;11;29
430230;201309;2158;6895;2036;6765;356;1110;1541;5298;1897;6408
430235;201309;237;814;200;726;69;278;45;133;114;411
430237;201309;387;1115;334;1020;48;182;229;666;277;848
430240;201309;999;3148;834;2801;312;1186;242;705;554;1891
430245;201309;815;2863;714;2614;203;765;307;1149;510;1914
430250;201309;1595;4531;1459;4279;523;1635;580;1742;1103;3377
430258;201309;176;551;139;467;24;84;68;217;92;301
430260;201309;811;2359;552;1808;78;296;316;1026;394;1322
430265;201309;321;1047;265;900;102;367;35;91;137;458
430270;201309;3406;9967;3115;9482;879;3041;1524;4552;2403;7593
430280;201309;5105;15091;4565;14078;1450;4792;1974;5980;3424;10772
430290;201309;2387;6810;2273;6686;322;975;1832;5469;2154;6444
430300;201309;9534;30110;8345;27854;3474;12144;3028;10454;6502;22598
430310;201309;8233;26692;7519;25307;2615;9490;3063;10059;5678;19549
430320;201309;796;2502;596;2084;96;328;305;1113;401;1441
430330;201309;968;2718;844;2483;230;735;361;985;591;1720
430340;201309;693;1883;456;1550;115;446;215;718;330;1164
430350;201309;6110;19918;5308;18117;2027;7322;1829;6114;3856;13436
430355;201309;222;620;142;469;27;112;34;99;61;211
430360;201309;1103;2957;978;2741;164;507;595;1652;759;2159
430367;201309;332;940;235;756;40;143;83;243;123;386
430370;201309;581;1757;489;1566;169;588;135;391;304;979
430380;201309;854;2247;469;1537;138;473;165;561;303;1034
430390;201309;4024;12420;3206;10607;829;3030;1047;3251;1876;6281
430400;201309;1262;3081;904;2570;200;680;491;1301;691;1981
430410;201309;678;1907;545;1686;105;370;283;861;388;1231
430420;201309;4399;13157;3699;11571;1167;3754;1481;4645;2648;8399
430430;201309;683;2012;511;1682;170;603;132;400;302;1003
430435;201309;1883;5287;1664;4888;374;1117;997;2974;1371;4091
430440;201309;4309;13684;3723;12731;869;3299;1665;5836;2534;9135
430450;201309;9028;26784;7599;23757;2731;8955;2650;8259;5381;17214
430460;201309;24110;75696;20309;68800;7120;25859;7250;24620;14370;50479
430461;201309;474;1345;160;523;36;123;37;125;73;248
430462;201309;332;1007;283;924;115;393;91;299;206;692
430463;201309;3771;12706;3374;11872;926;3561;1611;5657;2537;9218
430465;201309;608;1742;510;1563;129;437;304;925;433;1362
430466;201309;4180;12717;3968;12333;1287;4335;1809;5605;3096;9940
430467;201309;562;1775;497;1655;137;504;230;749;367;1253
430468;201309;1392;4220;1251;3987;547;1904;245;745;792;2649
430469;201309;126;343;41;158;11;44;12;49;23;93
430470;201309;6905;19020;5427;16627;1927;6402;1855;5670;3782;12072
430471;201309;923;3169;830;2959;311;1164;186;663;497;1827
430480;201309;793;2284;460;1521;81;307;91;253;172;560
430485;201309;220;696;130;481;24;85;52;209;76;294
430490;201309;528;1587;371;1280;111;402;124;434;235;836
430495;201309;399;1239;290;1001;76;295;78;255;154;550
430500;201309;1621;4669;1419;4317;406;1368;683;2032;1089;3400
430510;201309;25989;83222;20443;69240;7249;26806;5697;18391;12946;45197
430511;201309;470;1466;294;1014;79;264;60;205;139;469
430512;201309;1290;3472;1156;3250;343;993;483;1414;826;2407
430513;201309;639;1871;468;1516;88;291;218;704;306;995
430515;201309;594;1816;493;1592;101;347;215;707;316;1054
430517;201309;1329;4544;1243;4352;246;928;771;2658;1017;3586
430520;201309;1717;5211;1431;4598;469;1621;586;1837;1055;3458
430530;201309;957;2770;593;1927;147;552;174;499;321;1051
430535;201309;2304;7703;2008;6987;570;2177;670;2304;1240;4481
430537;201309;598;1745;430;1473;58;195;331;1165;389;1360
430540;201309;723;1822;567;1605;126;402;330;893;456;1295
430543;201309;582;1574;529;1520;134;410;330;963;464;1373
430544;201309;681;2387;603;2161;153;574;292;1020;445;1594
430545;201309;1326;4381;1185;4206;417;1348;621;2502;1038;3850
430550;201309;595;1918;478;1645;127;487;196;656;323;1143
430558;201309;117;350;88;291;32;115;13;33;45;148
430560;201309;331;920;255;771;52;202;115;327;167;529
430570;201309;1124;3071;859;2604;216;727;436;1245;652;1972
430580;201309;1016;3003;726;2406;258;887;212;725;470;1612
430583;201309;116;330;56;186;6;24;13;43;19;67
430585;201309;326;940;248;764;84;300;109;306;193;606
430587;201309;302;974;266;895;121;426;80;262;201;688
430590;201309;1541;4426;1463;4299;314;1056;872;2477;1186;3533
430593;201309;37;144;35;137;14;60;10;35;24;95
430595;201309;164;513;105;385;38;146;16;48;54;194
430597;201309;367;1184;314;1063;55;204;141;457;196;661
430600;201309;1847;5425;1366;4323;332;1115;502;1553;834;2668
430605;201309;1290;4199;1079;3742;272;1031;441;1575;713;2606
430607;201309;665;1869;587;1725;139;469;337;932;476;1401
430610;201309;7997;22486;6587;20203;1547;5272;3269;9964;4816;15236
430613;201309;213;566;142;429;40;132;58;158;98;290
430620;201309;938;2982;800;2667;251;937;301;919;552;1856
430630;201309;443;1375;279;952;81;280;57;177;138;457
430632;201309;711;2036;482;1555;81;307;273;835;354;1142
430635;201309;646;1866;490;1563;111;366;247;788;358;1154
430637;201309;511;1476;476;1415;87;305;316;888;403;1193
430640;201309;1779;5242;1048;3518;251;890;209;595;460;1485
430642;201309;461;1276;346;1093;73;255;184;588;257;843
430645;201309;171;530;108;379;27;103;26;84;53;187
430650;201309;2015;6891;1779;6331;412;1526;974;3564;1386;5090
430655;201309;299;931;268;855;64;229;98;264;162;493
430660;201309;5758;17788;4740;15838;1585;5792;1831;6045;3416;11837
430670;201309;503;1487;456;1396;46;133;347;1101;393;1234
430673;201309;708;1810;456;1411;129;413;209;654;338;1067
430675;201309;183;549;132;438;24;93;62;200;86;293
430676;201309;4436;13848;4137;13358;1275;4443;1947;6450;3222;10893
430680;201309;1214;3671;928;3030;222;838;371;1105;593;1943
430690;201309;4314;12892;3698;11719;1198;3922;1537;5056;2735;8978
430692;201309;283;981;217;833;35;143;139;534;174;677
430693;201309;1751;5090;1393;4276;317;1049;462;1382;779;2431
430695;201309;507;1485;417;1301;96;341;194;561;290;902
430697;201309;425;1247;333;1087;115;379;133;465;248;844
430700;201309;10418;28355;5742;18883;1269;4684;881;2652;2150;7336
430705;201309;409;1297;381;1247;133;474;153;496;286;970
430710;201309;1802;4844;1480;4322;311;976;828;2536;1139;3512
430720;201309;833;2189;562;1792;168;568;229;760;397;1328
430730;201309;1701;4894;1482;4556;356;1089;838;2700;1194;3789
430740;201309;578;1743;395;1337;128;456;56;164;184;620
430745;201309;532;1554;396;1269;67;223;208;650;275;873
430750;201309;1726;5125;1536;4766;436;1510;775;2281;1211;3791
430755;201309;643;1870;475;1492;118;425;202;568;320;993
430760;201309;3499;9220;2828;8411;621;2009;1608;4885;2229;6894
430770;201309;6598;20399;5565;18539;1441;5263;2569;8409;4010;13672
430780;201309;2016;6076;1635;5355;525;1856;623;1902;1148;3758
430781;201309;629;1981;480;1673;149;547;167;571;316;1118
430783;201309;563;1519;447;1317;91;300;206;555;297;855
430786;201309;116;409;103;370;40;157;13;44;53;201
430790;201309;3287;9439;2346;7553;536;1996;1040;3172;1576;5168
430800;201309;723;2334;625;2096;171;619;229;751;400;1370
430805;201309;442;1330;352;1158;29;110;242;807;271;917
430807;201309;280;895;246;821;63;262;90;252;153;514
430810;201309;514;1572;311;1101;62;260;59;186;121;446
430820;201309;1180;4027;996;3561;334;1278;308;1046;642;2324
430825;201309;445;1296;253;824;48;160;75;231;123;391
430830;201309;2717;8128;2518;7789;407;1304;1624;5302;2031;6606
430840;201309;940;3005;879;2865;241;764;395;1356;636;2120
430843;201309;98;326;77;255;15;48;31;99;46;147
430845;201309;456;1383;384;1246;134;459;79;247;213;706
430850;201309;3240;10213;2944;9648;927;3208;1169;3831;2096;7039
430860;201309;621;2141;538;1937;186;778;126;402;312;1180
430865;201309;710;2007;661;1915;206;609;330;971;536;1580
430870;201309;491;1487;366;1251;137;477;115;378;252;855
430880;201309;1349;4046;1127;3599;471;1607;283;932;754;2539
430885;201309;177;583;151;533;53;204;42;142;95;346
430890;201309;1844;5171;1583;4728;194;664;1033;3081;1227;3745
430900;201309;3201;8882;3042;8673;578;1711;2058;6004;2636;7715
430905;201309;1032;3176;766;2581;277;986;194;638;471;1624
430910;201309;1718;5687;1513;5306;607;2302;538;1826;1145;4128
430912;201309;568;1679;455;1484;83;320;238;745;321;1065
430915;201309;400;1456;312;1239;89;394;88;337;177;731
430920;201309;16591;54487;15778;53126;5727;19923;8397;28329;14124;48252
430925;201309;92;266;74;230;22;77;37;111;59;188
430930;201309;8815;28662;7588;26120;2313;8434;3106;11005;5419;19439
430940;201309;1099;3514;904;3124;219;862;304;1007;523;1869
430950;201309;1592;4616;1231;3812;375;1228;396;1199;771;2427
430955;201309;91;304;73;256;28;110;17;50;45;160
430957;201309;317;1100;264;977;77;300;111;409;188;709
430960;201309;1678;5005;1436;4577;575;1899;474;1530;1049;3429
430965;201309;1242;3995;1084;3668;228;903;670;2184;898;3087
430970;201309;507;1503;343;1146;94;347;95;306;189;653
430975;201309;620;2068;511;1814;103;381;307;1091;410;1472
430980;201309;554;1396;350;1097;100;357;125;344;225;701
430990;201309;632;2107;487;1719;167;614;104;366;271;980
430995;201309;693;2129;645;2041;215;690;284;926;499;1616
431000;201309;1594;4480;1011;3266;265;978;152;426;417;1404
431010;201309;2670;8185;1921;6608;569;2177;608;1950;1177;4127
431020;201309;13955;35802;9959;28514;2957;8875;3191;9424;6148;18299
431030;201309;407;1268;262;911;53;186;70;261;123;447
431033;201309;2838;8422;2617;8099;614;1963;1535;5013;2149;6976
431036;201309;183;546;95;324;24;89;25;70;49;159
431040;201309;993;2994;857;2752;245;867;429;1349;674;2216
431041;201309;579;1624;521;1539;200;628;172;528;372;1156
431043;201309;374;1284;308;1125;139;554;110;362;249;916
431046;201309;112;350;86;291;23;82;33;109;56;191
431050;201309;1789;4583;1571;4309;311;852;1052;2989;1363;3841
431053;201309;596;2021;519;1853;168;662;190;658;358;1320
431055;201309;638;1880;604;1814;81;248;439;1340;520;1588
431057;201309;323;953;196;693;58;222;79;274;137;496
431060;201309;6182;18469;5893;18125;1198;3326;4165;13511;5363;16837
431065;201309;431;1350;413;1316;50;171;285;907;335;1078
431070;201309;752;2257;515;1709;130;434;155;482;285;916
431075;201309;269;823;180;618;35;135;59;202;94;337
431080;201309;657;2181;553;1956;162;611;101;338;263;949
431085;201309;900;2477;738;2204;146;462;406;1213;552;1675
431087;201309;602;1780;558;1701;44;120;442;1372;486;1492
431090;201309;478;1299;296;946;94;322;78;232;172;554
431100;201309;4635;13173;3987;12040;1161;3745;1711;5269;2872;9014
431110;201309;1509;4301;1294;3877;349;1117;689;2006;1038;3123
431112;201309;668;2164;638;2112;224;740;306;1052;530;1792
431113;201309;631;1953;477;1587;165;542;129;448;294;990
431115;201309;1460;4491;1342;4278;319;1089;783;2460;1102;3549
431120;201309;2635;8717;2392;8230;751;2883;1016;3349;1767;6232
431123;201309;511;1665;441;1523;126;445;210;751;336;1196
431125;201309;1323;4267;1101;3794;339;1202;470;1714;809;2916
431127;201309;115;330;69;218;13;44;15;45;28;89
431130;201309;3846;11349;3279;10394;994;3459;1429;4572;2423;8031
431140;201309;3582;9831;2245;7442;483;1875;741;2210;1224;4085
431142;201309;550;1681;509;1615;63;217;350;1129;413;1346
431150;201309;1293;4011;1071;3589;311;1056;374;1301;685;2357
431160;201309;896;2769;762;2475;159;525;425;1422;584;1947
431162;201309;447;1281;268;912;52;200;59;185;111;385
431164;201309;95;258;34;126;12;41;1;4;13;45
431170;201309;896;2745;747;2437;240;831;226;730;466;1561
431171;201309;858;2677;780;2520;257;891;192;574;449;1465
431173;201309;469;1458;443;1409;100;331;273;871;373;1202
431175;201309;1305;3712;1145;3465;383;1221;489;1478;872;2699
431177;201309;966;3279;883;3103;290;1089;392;1392;682;2481
431179;201309;115;319;86;263;19;65;33;86;52;151
431180;201309;2711;8373;2205;7170;603;2178;660;1991;1263;4169
431190;201309;757;2140;494;1631;143;526;181;585;324;1111
431198;201309;350;1175;313;1097;144;568;57;179;201;747
431200;201309;244;737;119;403;25;93;18;57;43;150
431205;201309;294;988;233;813;64;231;79;262;143;493
431210;201309;746;2203;650;2000;168;538;340;1032;508;1570
431213;201309;313;990;263;897;78;295;102;331;180;626
431215;201309;328;988;168;581;40;147;27;82;67;229
431217;201309;236;749;189;637;65;238;50;171;115;409
431220;201309;1203;3141;919;2625;129;425;521;1427;650;1852
431225;201309;1324;4080;1183;3836;283;979;665;2182;948;3161
431230;201309;936;2876;752;2488;125;464;422;1394;547;1858
431235;201309;63;164;38;118;13;45;12;35;25;80
431237;201309;405;1393;365;1328;152;630;127;429;279;1059
431238;201309;51;170;43;153;10;41;15;49;25;90
431240;201309;2790;9038;2450;8390;908;3306;771;2630;1679;5936
431242;201309;423;1402;402;1361;170;646;27;79;197;725
431244;201309;432;1097;339;954;73;249;157;406;230;655
431245;201309;961;2756;826;2527;169;537;518;1608;687;2145
431247;201309;199;639;170;583;62;227;64;211;126;438
431250;201309;1895;6138;1704;5850;579;2146;686;2424;1265;4570
431260;201309;317;1000;271;907;67;256;62;192;129;448
431261;201309;229;826;198;753;51;224;62;226;113;450
431262;201309;343;999;164;586;26;123;66;227;92;350
431265;201309;1206;3405;818;2539;214;755;263;695;477;1450
431267;201309;191;599;160;542;46;167;67;208;113;375
431270;201309;2301;6739;2066;6386;699;2302;985;3061;1684;5363
431275;201309;213;708;154;547;52;176;35;114;87;290
431280;201309;146;468;102;359;28;112;26;73;54;185
431290;201309;319;1056;251;879;74;288;53;175;127;463
431295;201309;205;674;124;425;25;100;26;72;51;172
431300;201309;128;474;99;383;37;146;8;34;45;180
431301;201309;233;818;182;669;55;207;35;118;90;325
431303;201309;665;1850;549;1657;149;517;234;682;383;1199
431306;201309;2078;5927;1603;5040;347;1306;591;1650;938;2956
431308;201309;54;190;52;185;38;136;11;38;49;174
431310;201309;739;2456;571;2047;105;406;236;863;341;1269
431320;201309;820;2452;534;1869;169;663;121;376;290;1039
431330;201309;1907;5103;1055;3457;314;1133;237;766;551;1899
431333;201309;310;875;228;711;66;216;68;197;134;413
431335;201309;100;304;86;275;19;59;30;92;49;151
431337;201309;2512;7942;2132;7112;658;2322;644;2150;1302;4472
431339;201309;607;1816;480;1519;113;371;232;749;345;1120
431340;201309;26792;73873;20393;62920;5316;18248;8471;25521;13787;43769
431342;201309;580;1611;534;1526;118;354;339;952;457;1306
431344;201309;366;1060;289;922;25;84;174;561;199;645
431346;201309;281;787;181;548;56;175;49;144;105;319
431349;201309;531;1604;444;1404;91;284;214;685;305;969
431350;201309;3736;11529;3435;11025;551;2022;2288;7154;2839;9176
431360;201309;711;2059;586;1845;185;618;215;663;400;1281
431365;201309;1282;4101;1130;3837;447;1667;411;1365;858;3032
431370;201309;5445;16238;4727;15055;1269;4301;2301;7533;3570;11834
431380;201309;1124;3438;1068;3305;159;542;772;2359;931;2901
431390;201309;3350;10113;2543;8485;864;3144;727;2304;1591;5448
431395;201309;1585;4864;1430;4611;374;1290;613;2024;987;3314
431400;201309;165;584;117;455;37;159;12;34;49;193
431402;201309;1173;3044;786;2339;150;500;388;1107;538;1607
431403;201309;316;954;241;815;84;310;50;165;134;475
431405;201309;4467;12971;3607;11654;858;3239;1749;5433;2607;8672
431406;201309;776;2534;606;2094;215;774;219;746;434;1520
431407;201309;639;2023;492;1664;163;561;125;407;288;968
431410;201309;16346;52129;13599;46682;5618;20541;3316;11896;8934;32437
431413;201309;193;504;101;329;11;42;46;148;57;190
431415;201309;863;2561;766;2376;196;662;395;1196;591;1858
431417;201309;661;1755;533;1551;96;304;293;882;389;1186
431420;201309;1586;4489;1426;4227;356;1131;781;2352;1137;3483
431430;201309;575;1619;449;1419;123;435;180;535;303;970
431440;201309;31690;95608;29077;91189;9885;32401;13166;42793;23051;75194
431442;201309;202;667;157;547;51;200;20;51;71;251
431445;201309;491;1387;361;1098;68;228;164;484;232;712
431446;201309;489;1463;372;1224;98;323;163;536;261;859
431447;201309;835;2451;630;1985;119;398;299;958;418;1356
431449;201309;862;2547;739;2336;128;443;401;1288;529;1731
431450;201309;2197;5966;2044;5732;541;1565;1224;3439;1765;5004
431455;201309;613;1634;435;1276;119;384;169;463;288;847
431460;201309;3651;10566;3219;9732;914;2907;1353;4169;2267;7076
431470;201309;2183;6501;1866;5792;556;1701;808;2662;1364;4363
431475;201309;102;337;60;241;15;61;5;22;20;83
431477;201309;592;1753;488;1535;129;428;229;699;358;1127
431478;201309;188;496;98;296;25;81;38;112;63;193
431480;201309;2487;7603;2001;6645;683;2442;507;1652;1190;4094
431490;201309;103971;304570;92704;287678;18017;63656;59709;181671;77726;245327
431500;201309;1188;3149;957;2720;294;855;329;929;623;1784
431505;201309;353;1039;339;1021;36;105;274;834;310;939
431507;201309;453;1133;369;977;85;222;220;592;305;814
431510;201309;2195;6176;1894;5680;341;1126;1144;3354;1485;4480
431513;201309;214;667;183;594;46;159;75;249;121;408
431514;201309;109;276;59;184;13;48;24;73;37;121
431515;201309;747;2320;599;1967;142;515;299;916;441;1431
431517;201309;86;290;81;278;34;119;19;54;53;173
431520;201309;462;1453;327;1113;91;323;77;269;168;592
431530;201309;4454;11312;3665;10435;907;2554;2226;6816;3133;9370
431531;201309;267;783;197;641;48;169;78;269;126;438
431532;201309;512;1529;485;1473;98;325;283;848;381;1173
431535;201309;377;1124;260;817;60;219;68;190;128;409
431540;201309;2154;7158;1965;6894;239;771;1405;5260;1644;6031
431545;201309;133;406;57;215;5;21;12;48;17;69
431550;201309;2425;7507;2275;7217;561;2013;1101;3437;1662;5450
431555;201309;764;2083;677;1948;147;421;360;1038;507;1459
431560;201309;23259;74653;20873;69853;9013;30754;6548;23060;15561;53814
431570;201309;5490;16180;5163;15678;1172;3542;3393;10506;4565;14048
431575;201309;371;1094;317;1009;54;197;179;544;233;741
431580;201309;694;2262;601;2049;159;609;229;725;388;1334
431590;201309;909;2732;716;2297;83;288;391;1260;474;1548
431595;201309;608;1796;537;1636;135;437;203;636;338;1073
431600;201309;2192;6794;1742;5791;489;1840;378;1065;867;2905
431610;201309;1600;4666;1230;3982;316;1103;606;1951;922;3054
431620;201309;314;1008;240;780;89;305;92;281;181;586
431630;201309;1356;3822;1099;3260;266;825;578;1717;844;2542
431640;201309;5801;17986;5360;17242;1597;5633;2730;8586;4327;14219
431642;201309;496;1539;450;1430;69;262;253;773;322;1035
431643;201309;186;549;169;517;46;158;90;248;136;406
431645;201309;1784;5568;1651;5338;408;1346;960;3199;1368;4545
431647;201309;171;489;138;420;47;145;36;92;83;237
431650;201309;209;682;151;556;41;171;33;106;74;277
431660;201309;1444;4446;1158;3833;408;1408;414;1312;822;2720
431670;201309;1352;3886;1126;3482;338;1180;457;1337;795;2517
431673;201309;205;648;150;518;41;151;37;129;78;280
431675;201309;293;986;225;772;55;197;61;180;116;377
431680;201309;9692;28631;7829;25254;2564;8866;2828;9211;5392;18077
431690;201309;25002;73913;20900;67563;6848;23683;8263;27063;15111;50746
431695;201309;141;505;116;426;27;103;28;75;55;178
431697;201309;511;1478;469;1399;136;423;208;632;344;1055
431700;201309;1635;4712;1432;4323;304;1001;758;2223;1062;3224
431710;201309;12810;38560;10901;35217;3209;10916;4846;16269;8055;27185
431720;201309;6965;20328;5961;18488;1432;5026;3156;9551;4588;14577
431725;201309;40;148;39;145;21;80;6;22;27;102
431730;201309;3674;11687;3086;10560;929;3528;1186;4068;2115;7596
431740;201309;5973;18034;5381;16864;1864;6309;1841;5620;3705;11929
431750;201309;10309;30155;8921;27840;1847;6238;4853;15401;6700;21639
431755;201309;253;669;81;281;22;87;17;51;39;138
431760;201309;3866;12126;3273;10939;980;3552;940;3058;1920;6610
431770;201309;2299;6506;2001;6015;526;1719;1041;3061;1567;4780
431775;201309;245;717;196;619;78;261;57;163;135;424
431780;201309;2510;7000;2044;6111;613;1991;587;1670;1200;3661
431790;201309;1136;3698;1036;3518;286;1052;535;1798;821;2850
431795;201309;468;1440;384;1228;72;242;199;632;271;874
431800;201309;9412;28631;8115;26242;2717;9599;2758;8735;5475;18334
431805;201309;271;670;75;269;19;73;18;67;37;140
431810;201309;3727;10738;3222;9666;835;2716;1537;4558;2372;7274
431820;201309;2706;8764;2455;8263;769;2818;878;2860;1647;5678
431830;201309;10386;28697;8989;26423;3348;10691;3198;9390;6546;20081
431840;201309;3537;10886;3122;10047;1009;3348;1324;4358;2333;7706
431842;201309;717;1919;434;1353;99;333;145;439;244;772
431843;201309;324;995;298;948;76;262;160;495;236;757
431844;201309;170;515;131;438;38;145;40;130;78;275
431845;201309;537;1691;508;1634;51;167;371;1220;422;1387
431846;201309;503;1578;451;1468;82;305;262;849;344;1154
431848;201309;193;527;95;326;19;79;22;67;41;146
431849;201309;312;813;129;405;25;88;35;96;60;184
431850;201309;4956;14777;4440;13793;1098;3787;2272;6864;3370;10651
431860;201309;978;2844;827;2597;220;765;397;1186;617;1951
431861;201309;83;269;57;195;14;52;10;30;24;82
431862;201309;486;1698;422;1557;161;656;114;387;275;1043
431870;201309;26300;75714;22293;68483;6354;21444;9632;28803;15986;50247
431880;201309;4657;15182;3963;13530;1251;4683;1546;5105;2797;9788
431890;201309;5773;17153;5173;16010;2067;6732;1582;5006;3649;11738
431900;201309;936;3039;805;2787;250;971;314;982;564;1953
431910;201309;875;2170;469;1387;111;371;185;499;296;870
431912;201309;597;1768;478;1517;147;464;170;555;317;1019
431915;201309;1329;3772;1039;3224;309;993;352;1107;661;2100
431920;201309;1498;4399;1416;4283;198;577;1099;3400;1297;3977
431930;201309;1261;3613;1020;3206;148;451;616;2057;764;2508
431935;201309;96;377;90;360;43;179;17;54;60;233
431936;201309;488;1414;445;1336;72;211;293;954;365;1165
431937;201309;309;875;200;640;51;176;58;174;109;350
431940;201309;2683;7630;1934;6197;566;1926;543;1717;1109;3643
431950;201309;1884;6155;1684;5763;511;1910;645;2104;1156;4014
431960;201309;3706;11285;3411;10693;1099;3660;1206;3817;2305;7477
431970;201309;507;1422;288;957;52;190;85;261;137;451
431971;201309;131;405;114;380;18;65;63;203;81;268
431973;201309;478;1721;423;1604;72;280;241;989;313;1269
431975;201309;13;56;10;48;2;12;3;13;5;25
431980;201309;1525;4520;1407;4288;373;1327;632;1813;1005;3140
431990;201309;8737;25081;7323;22888;1497;5365;3614;11032;5111;16397
432000;201309;10691;32255;8911;29053;2998;10108;3773;12473;6771;22581
432010;201309;2482;7552;2186;6974;529;1944;1048;3188;1577;5132
432020;201309;2045;5708;1833;5411;350;1099;1135;3339;1485;4438
432023;201309;521;1545;410;1292;110;394;161;473;271;867
432026;201309;1213;3844;1067;3526;253;846;566;1919;819;2765
432030;201309;412;1270;351;1134;97;342;145;441;242;783
432032;201309;470;1289;351;1088;65;216;212;650;277;866
432035;201309;831;2755;766;2612;208;773;428;1420;636;2193
432040;201309;693;2130;516;1728;120;439;130;345;250;784
432045;201309;191;655;168;605;49;187;70;250;119;437
432050;201309;771;2287;693;2138;143;468;398;1253;541;1721
432055;201309;757;2448;689;2304;155;573;424;1393;579;1966
432057;201309;488;1322;405;1164;52;174;248;665;300;839
432060;201309;437;1277;202;725;63;243;50;167;113;410
432065;201309;215;666;183;602;47;176;80;230;127;406
432067;201309;962;3210;719;2626;222;838;290;1030;512;1868
432070;201309;2378;6784;1971;5974;655;2199;710;2131;1365;4330
432080;201309;4129;12360;3738;11672;1191;3943;1609;4975;2800;8918
432085;201309;254;845;223;787;78;316;64;209;142;525
432090;201309;1671;5347;1451;4851;586;2116;402;1149;988;3265
432100;201309;1120;3435;681;2391;191;696;131;405;322;1101
432110;201309;3070;9394;2506;8260;895;3217;500;1593;1395;4810
432120;201309;5176;16163;4475;14786;1588;5674;1332;4325;2920;9999
432130;201309;2043;6467;1916;6245;545;1922;1087;3558;1632;5480
432132;201309;408;1286;265;934;42;150;101;326;143;476
432135;201309;785;2394;745;2323;145;476;480;1501;625;1977
432140;201309;2895;8701;2403;7788;708;2371;921;3332;1629;5703
432143;201309;1345;4231;1185;3975;275;950;742;2563;1017;3513
432145;201309;943;3079;674;2439;241;945;132;428;373;1373
432146;201309;259;843;201;691;69;249;54;182;123;431
432147;201309;832;2669;678;2326;199;709;275;965;474;1674
432149;201309;390;1207;284;937;84;293;96;309;180;602
432150;201309;3173;9775;2635;8890;1029;3689;796;2755;1825;6444
432160;201309;4448;14889;4030;14160;1486;5504;1526;5646;3012;11150
432162;201309;321;810;97;325;24;90;24;67;48;157
432163;201309;329;854;100;314;20;63;20;63;40;126
432166;201309;793;2421;653;2125;146;542;304;910;450;1452
432170;201309;781;2661;577;2188;144;611;124;417;268;1028
432180;201309;2763;7493;2042;6314;632;2158;611;1803;1243;3961
432183;201309;395;1343;370;1290;154;554;102;362;256;916
432185;201309;823;2441;562;1864;131;480;209;672;340;1152
432190;201309;3478;9904;2648;8051;729;2382;823;2335;1552;4717
432195;201309;1269;3682;1152;3506;198;646;744;2260;942;2906
432200;201309;3096;9866;2565;8929;855;3160;1031;3698;1886;6858
432210;201309;426;1295;382;1236;109;413;183;548;292;961
432215;201309;872;2793;797;2675;157;503;503;1777;660;2280
432218;201309;310;886;238;738;48;158;102;296;150;454
432220;201309;3766;10454;3216;9549;548;1891;1980;5718;2528;7609
432225;201309;60;207;53;197;31;118;7;29;38;147
432230;201309;1040;2978;886;2707;285;982;406;1134;691;2116
432232;201309;566;1696;450;1472;104;380;240;778;344;1158
432234;201309;549;1554;417;1218;107;327;168;460;275;787
432235;201309;73;235;43;163;20;86;10;38;30;124
432237;201309;502;1422;459;1351;37;140;383;1108;420;1248
432240;201309;15098;51923;13416;49652;3404;13622;7935;29931;11339;43553
432250;201309;5460;19618;5185;19039;2444;9619;1275;4763;3719;14382
432252;201309;429;1333;393;1261;130;438;185;603;315;1041
432253;201309;1240;4271;1011;3657;339;1266;332;1212;671;2478
432254;201309;452;1201;187;617;50;174;26;83;76;257
432255;201309;187;484;107;359;30;109;37;131;67;240
432260;201309;6534;17683;5048;15248;1223;3945;2481;7524;3704;11469
432270;201309;2609;8402;2361;7967;689;2398;1216;4192;1905;6590
432280;201309;1065;3230;746;2548;192;751;205;583;397;1334
432285;201309;104;334;68;234;22;82;14;41;36;123
432290;201309;599;1857;425;1445;97;365;165;535;262;900
432300;201309;22627;71274;21025;68512;5930;20539;10929;35579;16859;56118
432310;201309;984;3165;865;2933;207;779;444;1440;651;2219
432320;201309;261;766;193;628;58;189;68;230;126;419
432330;201309;205;639;101;365;21;81;8;26;29;107
432335;201309;209;616;99;346;26;96;10;31;36;127
432340;201309;286;765;158;489;47;151;43;123;90;274
432345;201309;733;2152;685;2085;178;651;370;1043;548;1694
432350;201309;432;1276;322;1064;84;300;87;271;171;571
432360;201309;44;141;35;122;15;54;11;35;26;89
432370;201309;461;1335;402;1232;37;109;273;849;310;958
432375;201309;832;2196;700;1979;126;364;431;1244;557;1608
432377;201309;74;265;36;130;8;32;8;20;16;52
432380;201309;839;3038;769;2870;350;1440;242;831;592;2271
500020;201309;1911;6464;1573;5735;520;2084;422;1432;942;3516
500025;201309;913;2436;618;1899;124;411;256;752;380;1163
500060;201309;5797;17257;4964;16152;520;1681;3935;13207;4455;14888
500070;201309;3648;11405;3188;10635;803;3039;1506;4868;2309;7907
500080;201309;1711;5268;1338;4596;465;1728;398;1419;863;3147
500085;201309;2117;5784;1608;4965;231;778;966;2887;1197;3665
500090;201309;2219;6771;1791;5986;415;1441;927;3177;1342;4618
500100;201309;2362;7345;2227;7145;786;2865;948;2864;1734;5729
500110;201309;7815;23378;6516;21405;1083;4001;3878;13191;4961;17192
500124;201309;1706;5818;1511;5483;298;1068;852;3360;1150;4428
500150;201309;1265;3529;1070;3243;306;1018;510;1499;816;2517
500190;201309;4642;12777;3700;11601;850;2875;2071;6689;2921;9564
500200;201309;2511;6641;1861;5698;408;1432;1002;2965;1410;4397
500210;201309;4715;14691;4156;13849;1019;3661;2107;7243;3126;10904
500215;201309;1721;5493;1455;4947;362;1407;619;1982;981;3389
500220;201309;2632;8554;2159;7621;553;2124;840;3006;1393;5130
500230;201309;1890;5622;1613;5230;715;2522;541;1735;1256;4257
500240;201309;4402;14292;3417;12250;774;3090;1472;5448;2246;8538
500260;201309;2427;6858;2053;6276;472;1601;996;2854;1468;4455
500270;201309;99100;268500;69730;217778;22013;74834;18067;56936;40080;131770
500280;201309;1272;3835;1119;3618;227;777;668;2221;895;2998
500290;201309;3529;9607;2517;7806;744;2684;876;2498;1620;5182
500295;201309;2228;7192;1734;5973;450;1762;478;1450;928;3212
500310;201309;784;2144;711;2045;174;549;396;1087;570;1636
500315;201309;2797;9010;2447;8530;563;1907;1425;5325;1988;7232
500320;201309;12691;43989;11380;41617;4047;15547;4129;16105;8176;31652
500325;201309;3905;10803;3060;9433;933;3198;1245;3639;2178;6837
500330;201309;5136;14838;4425;13599;1443;4834;1897;5699;3340;10533
500345;201309;2342;7319;2062;6783;534;1943;1021;3267;1555;5210
500348;201309;2333;7154;2193;6922;285;992;1639;5177;1924;6169
500350;201309;1212;3779;771;2746;140;518;230;858;370;1376
500370;201309;21958;70910;18012;63140;4821;18774;7129;24918;11950;43692
500375;201309;2530;7238;1976;6227;468;1564;961;3131;1429;4695
500380;201309;2879;8616;2484;7796;751;2528;884;2752;1635;5280
500390;201309;529;1193;360;947;55;185;248;597;303;782
500400;201309;1212;4012;1051;3623;349;1328;301;949;650;2277
500410;201309;2089;5973;1743;5475;468;1599;780;2471;1248;4070
500430;201309;2405;7627;2052;7076;584;2115;933;3334;1517;5449
500440;201309;1302;3896;1116;3593;308;1126;586;1807;894;2933
500450;201309;2112;6715;1675;5780;455;1766;346;1076;801;2842
500460;201309;3564;11087;2923;10086;780;2950;1257;4325;2037;7275
500470;201309;3105;9825;2521;8448;836;3035;510;1560;1346;4595
500480;201309;1975;6476;1837;6258;200;713;1438;5000;1638;5713
500490;201309;1026;3051;879;2808;294;1047;297;952;591;1999
500500;201309;3101;9935;2606;9259;1023;4085;884;3057;1907;7142
500510;201309;804;2248;584;1888;148;572;242;700;390;1272
500515;201309;1710;4900;1422;4488;273;835;906;3036;1179;3871
500520;201309;2672;9654;2395;9268;611;2487;1406;5674;2017;8161
500525;201309;1087;3700;965;3467;238;918;486;1835;724;2753
500540;201309;4582;14020;3214;11295;1005;3969;809;2726;1814;6695
500560;201309;4270;15097;3922;14594;907;3558;2453;9286;3360;12844
500568;201309;3631;9930;2804;8716;667;2213;1291;4093;1958;6306
500570;201309;7293;20683;5395;17366;1643;5688;2097;6765;3740;12453
500580;201309;3233;9865;2608;8701;547;1944;1456;4877;2003;6821
500600;201309;2729;7948;2153;7020;675;2398;791;2558;1466;4956
500620;201309;7600;21874;5697;18772;1460;5446;2749;8897;4209;14343
500625;201309;860;2621;598;2072;165;618;194;630;359;1248
500630;201309;6002;17270;4888;15660;1773;6302;1387;4405;3160;10707
500635;201309;2255;9102;2015;8745;328;1345;1298;6134;1626;7479
500640;201309;1296;3474;1063;3132;178;587;665;1903;843;2490
500660;201309;14287;45001;12216;41378;2804;10457;6307;21365;9111;31822
500690;201309;2917;8705;2447;8119;650;2236;1338;4682;1988;6918
500710;201309;3249;10550;3065;10259;876;3095;1570;5291;2446;8386
500720;201309;4327;13340;3437;11537;1131;4163;1106;3667;2237;7830
500730;201309;926;2736;751;2391;185;660;310;955;495;1615
500740;201309;3516;10113;2653;8603;632;2362;1181;3618;1813;5980
500750;201309;793;2475;737;2393;191;668;410;1348;601;2016
500755;201309;1225;3735;964;3240;239;864;382;1243;621;2107
500769;201309;4414;12215;3096;9628;736;2573;1029;2926;1765;5499
500770;201309;1570;4870;1307;4357;383;1375;448;1510;831;2885
500780;201309;1017;3324;926;3133;306;1118;402;1313;708;2431
500790;201309;8278;24281;7005;22017;1493;5501;3739;11191;5232;16692
500793;201309;2378;7050;1916;6263;364;1348;847;2594;1211;3942
500795;201309;2216;6758;2000;6440;254;705;1487;5100;1741;5805
500797;201309;897;2543;708;2233;158;558;329;1045;487;1603
500800;201309;2194;6739;1886;6298;616;2293;832;2763;1448;5056
500830;201309;14578;44895;11185;37617;3491;12732;3114;10212;6605;22944
500840;201309;1235;3822;1018;3390;203;748;509;1675;712;2423
510010;201309;1242;4015;1163;3881;394;1393;509;1739;903;3132
510020;201309;2623;7803;1945;6577;575;2066;511;1670;1086;3736
510025;201309;8781;27293;7813;25669;2522;9164;3149;10076;5671;19240
510030;201309;2047;5659;1751;5228;541;1687;846;2567;1387;4254
510035;201309;898;2739;772;2549;178;598;425;1475;603;2073
510040;201309;1596;4520;1276;4044;293;1062;648;2008;941;3070
510050;201309;1660;5071;1304;4433;374;1410;509;1736;883;3146
510060;201309;1174;3577;937;3131;290;1085;296;942;586;2027
510080;201309;1284;4071;1078;3715;326;1313;380;1181;706;2494
510100;201309;592;1609;403;1241;102;351;150;442;252;793
510120;201309;282;596;199;504;14;24;174;453;188;477
510125;201309;2870;7809;2368;6995;484;1755;1154;3219;1638;4974
510130;201309;1988;5697;1746;5336;549;1766;733;2252;1282;4018
510140;201309;2924;9846;2464;9118;909;3506;922;3507;1831;7013
510160;201309;1264;4346;1211;4285;91;362;1063;3760;1154;4122
510170;201309;5652;18042;4907;16659;1304;4951;2221;7305;3525;12256
510180;201309;10078;28686;7737;24764;2517;8582;2780;9613;5297;18195
510185;201309;1121;3622;1053;3527;253;819;657;2340;910;3159
510190;201309;1534;5346;1286;4931;334;1439;569;2251;903;3690
510250;201309;13164;43070;11560;40877;3664;13716;5640;20385;9304;34101
510260;201309;2525;9562;2345;9198;733;3036;1087;4417;1820;7453
510263;201309;4047;11500;3153;10012;934;3233;1085;3351;2019;6584
510267;201309;4457;13612;3660;11930;921;3343;1494;4639;2415;7982
510268;201309;847;2522;734;2362;216;761;366;1174;582;1935
510269;201309;806;2689;727;2556;231;849;302;1098;533;1947
510270;201309;2475;7893;2222;7508;475;1632;1249;4469;1724;6101
510279;201309;2035;6713;1875;6442;715;2725;618;1946;1333;4671
510285;201309;1422;4540;1230;4170;372;1364;431;1398;803;2762
510300;201309;2975;9490;2724;9141;405;1518;2004;6686;2409;8204
510305;201309;1604;5236;1331;4707;390;1527;437;1567;827;3094
510310;201309;1082;3180;862;2826;313;1147;262;832;575;1979
510320;201309;3865;11801;3132;10295;977;3721;609;1712;1586;5433
510325;201309;5359;17533;4729;16609;629;2177;3591;13069;4220;15246
510330;201309;2604;8804;2289;8229;635;2538;904;3299;1539;5837
510335;201309;4322;14151;3895;13575;692;2402;2776;10055;3468;12457
510336;201309;489;1581;443;1492;101;364;225;758;326;1122
510337;201309;2206;7585;1993;7186;816;2997;721;2810;1537;5807
510340;201309;57726;176362;47387;160614;19306;71177;10992;39325;30298;110502
510343;201309;1074;3328;1006;3243;127;392;798;2649;925;3041
510345;201309;1609;4810;1404;4467;395;1351;563;1795;958;3146
510350;201309;3126;9532;2683;8940;799;2852;1339;4537;2138;7389
510360;201309;1712;4794;1349;4337;286;985;871;2777;1157;3762
510370;201309;823;3002;734;2851;229;938;335;1333;564;2271
510380;201309;472;1566;384;1381;139;557;71;236;210;793
510385;201309;868;3325;750;3020;129;562;363;1554;492;2116
510390;201309;1065;3419;975;3310;258;855;544;1987;802;2842
510395;201309;819;2213;644;1988;126;412;391;1264;517;1676
510410;201309;3758;12627;3575;12322;1101;4105;1807;6172;2908;10277
510420;201309;2215;5969;1713;5131;308;1080;906;2693;1214;3773
510450;201309;572;1631;444;1449;145;535;141;450;286;985
510452;201309;591;1897;442;1552;112;440;159;517;271;957
510454;201309;701;2303;624;2188;166;605;339;1237;505;1842
510455;201309;948;3003;760;2673;188;774;316;1080;504;1854
510460;201309;1715;5291;1601;5140;369;1362;1013;3126;1382;4488
510480;201309;3906;10983;3077;9408;789;2625;1093;3243;1882;5868
510490;201309;1437;4868;1307;4676;386;1465;720;2562;1106;4027
510500;201309;1220;3941;1010;3587;301;1214;482;1637;783;2851
510510;201309;2914;10443;2612;9928;1020;4076;1012;3859;2032;7935
510515;201309;5325;16761;4439;14954;1249;4728;1327;4180;2576;8908
510517;201309;1660;5197;1492;4947;456;1462;876;3056;1332;4518
510520;201309;2110;5637;1682;5020;143;500;1281;3795;1424;4295
510523;201309;1009;3137;857;2880;287;1027;369;1209;656;2236
510525;201309;7626;19612;4877;15224;1251;4255;1750;5362;3001;9617
510530;201309;555;1622;487;1524;91;333;285;891;376;1224
510550;201309;2572;8740;2278;8234;654;2439;1070;4026;1724;6465
510558;201309;2009;5972;1594;5352;513;1887;578;1923;1091;3810
510560;201309;1468;5034;1155;4466;433;1743;267;1091;700;2834
510562;201309;4910;15274;4387;14241;1574;5594;1441;4724;3015;10318
510590;201309;2675;7856;2150;7184;628;2312;939;3173;1567;5485
510600;201309;1401;3676;1007;3079;181;613;537;1576;718;2189
510610;201309;2499;7833;2366;7681;284;1063;1929;6199;2213;7262
510615;201309;2081;6989;1862;6602;631;2414;796;2783;1427;5197
510617;201309;486;1601;451;1550;82;312;331;1132;413;1444
510618;201309;1268;3835;955;3215;249;949;416;1378;665;2327
510619;201309;759;2166;504;1691;109;402;155;527;264;929
510620;201309;1161;3215;810;2706;293;1098;172;535;465;1633
510621;201309;1080;3836;942;3512;300;1213;318;1140;618;2353
510622;201309;3379;10679;2332;8222;599;2356;409;1250;1008;3606
510623;201309;3432;10173;3024;9556;1130;3767;1059;3340;2189;7107
510624;201309;1014;3413;897;3167;216;843;403;1342;619;2185
510625;201309;2272;6802;1835;5985;551;2025;517;1598;1068;3623
510626;201309;1178;3883;993;3577;332;1300;460;1661;792;2961
510627;201309;633;2064;530;1860;207;788;169;586;376;1374
510628;201309;1409;3862;1180;3578;171;608;832;2474;1003;3082
510629;201309;1734;5872;1522;5417;586;2267;337;1145;923;3412
510630;201309;2587;8769;2193;8077;744;3050;626;2352;1370;5402
510631;201309;399;1194;363;1132;80;254;235;731;315;985
510637;201309;2483;7784;2272;7391;725;2601;1052;3319;1777;5920
510642;201309;4525;15173;3915;14356;1410;5350;1744;6721;3154;12071
510645;201309;668;1716;546;1563;211;636;162;517;373;1153
510650;201309;5654;19836;5344;19439;1345;5196;3239;12151;4584;17347
510665;201309;1194;3211;868;2741;204;733;448;1419;652;2152
510670;201309;344;862;206;658;53;197;84;242;137;439
510675;201309;5951;20145;5216;18742;1870;7367;1525;5346;3395;12713
510677;201309;2465;6416;1864;5645;280;882;1317;4101;1597;4983
510680;201309;763;2447;663;2296;168;647;280;890;448;1537
510682;201309;2276;7402;1911;6741;526;1967;861;3185;1387;5152
510685;201309;758;2367;721;2312;121;409;505;1649;626;2058
510700;201309;3119;9299;2568;8506;569;2096;1549;5089;2118;7185
510704;201309;7611;22421;6476;20394;1831;6489;3048;9255;4879;15744
510706;201309;1542;4955;1289;4536;407;1512;598;2069;1005;3581
510710;201309;3503;10216;2851;8914;845;3010;993;2793;1838;5803
510715;201309;680;1816;464;1459;122;426;167;480;289;906
510718;201309;1655;5106;1484;4868;348;1214;923;3053;1271;4267
510719;201309;435;1017;265;786;36;147;124;334;160;481
510720;201309;1232;2981;921;2613;89;282;707;2025;796;2307
510724;201309;804;2534;691;2319;151;553;418;1378;569;1931
510726;201309;650;1800;565;1659;166;512;222;622;388;1134
510729;201309;614;1764;516;1606;156;521;214;667;370;1188
510730;201309;2111;6832;1947;6530;467;1813;1105;3520;1572;5333
510735;201309;1060;3754;904;3496;345;1413;352;1362;697;2775
510740;201309;962;2544;801;2321;181;521;476;1418;657;1939
510757;201309;647;2324;602;2220;170;663;297;1078;467;1741
510760;201309;25504;75525;21204;67989;7909;27083;7026;22501;14935;49584
510770;201309;3862;11407;3650;11144;626;1911;2438;8000;3064;9911
510774;201309;370;1076;308;981;65;232;165;514;230;746
510775;201309;847;2420;687;2181;268;947;264;853;532;1800
510776;201309;354;1113;308;1030;80;297;147;462;227;759
510777;201309;1367;4386;1113;4068;242;1045;688;2454;930;3499
510779;201309;607;1835;467;1577;88;320;183;637;271;957
510780;201309;3624;11116;3247;10580;758;2627;1908;6342;2666;8969
510785;201309;1792;5435;1495;4941;503;1753;559;1888;1062;3641
510787;201309;1909;6194;1716;5838;525;1957;650;2142;1175;4099
510788;201309;345;1103;318;1066;136;433;107;390;243;823
510790;201309;14063;42537;9952;34583;3025;12045;1510;5032;4535;17077
510792;201309;5405;18311;4148;15562;1178;5062;776;2700;1954;7762
510794;201309;1329;4216;1059;3783;514;1927;208;679;722;2606
510795;201309;7971;27347;6689;24636;2366;9308;1817;6814;4183;16122
510800;201309;1689;5036;1468;4736;420;1508;714;2210;1134;3718
510805;201309;1720;4993;1424;4558;303;1128;890;2774;1193;3902
510810;201309;642;1623;522;1458;161;490;261;710;422;1200
510820;201309;817;2087;635;1813;163;544;247;641;410;1185
510830;201309;540;1914;490;1833;173;698;217;855;390;1553
510835;201309;661;2136;537;1905;200;784;210;686;410;1470
510840;201309;46804;121941;38589;111729;10133;30999;20456;61175;30589;92174
510850;201309;1641;4923;1341;4455;595;2217;208;549;803;2766
510860;201309;2399;8190;2008;7342;736;2890;379;1362;1115;4252
510880;201309;793;2731;707;2568;263;1001;249;900;512;1901
510885;201309;522;1535;399;1344;90;333;179;603;269;936
510890;201309;890;3076;772;2843;265;1095;202;675;467;1770
510895;201309;1085;3568;985;3390;309;1189;402;1302;711;2491
520005;201309;1169;3890;1092;3764;370;1336;460;1603;830;2939
520010;201309;1780;6340;1585;5891;719;2969;231;718;950;3687
520013;201309;3933;11176;3063;9647;782;2633;1436;4566;2218;7199
520015;201309;578;1597;461;1424;132;415;183;588;315;1003
520017;201309;1156;3738;1017;3499;296;1114;427;1440;723;2554
520020;201309;393;1073;305;930;87;277;154;488;241;765
520025;201309;20373;68600;19919;68026;3392;12263;15133;51756;18525;64019
520030;201309;4370;14613;3924;13863;1392;5286;1396;5079;2788;10365
520050;201309;330;1005;311;965;62;220;208;621;270;841
520055;201309;658;1982;564;1824;145;465;290;978;435;1443
520060;201309;1606;5142;1423;4789;347;1297;574;1973;921;3270
520080;201309;1473;5037;1374;4824;355;1299;712;2540;1067;3839
520082;201309;594;2090;567;2031;159;569;334;1237;493;1806
520085;201309;992;3186;869;2889;213;785;354;1177;567;1962
520090;201309;768;2124;706;2021;123;330;459;1359;582;1689
520110;201309;36972;114771;29484;103336;12121;46355;7665;27223;19786;73578
520120;201309;262;688;153;495;37;141;40;135;77;276
520130;201309;3588;10847;3353;10481;768;2592;1978;6192;2746;8784
520140;201309;41927;143677;38202;136117;14233;54603;11624;41282;25857;95885
520145;201309;534;1403;396;1212;95;316;167;491;262;807
520150;201309;669;1782;553;1640;164;535;260;755;424;1290
520160;201309;795;2446;716;2332;256;881;283;947;539;1828
520170;201309;3683;9354;3005;8625;622;1899;2014;5917;2636;7816
520180;201309;1509;4961;1382;4735;437;1620;592;1997;1029;3617
520215;201309;1509;4114;1321;3838;297;969;771;2239;1068;3208
520235;201309;775;2191;630;1972;198;695;269;811;467;1506
520250;201309;1095;3732;1020;3600;358;1338;483;1745;841;3083
520260;201309;721;1958;561;1670;103;349;285;819;388;1168
520280;201309;546;1642;497;1564;240;789;132;457;372;1246
520310;201309;926;2453;760;2254;208;628;448;1392;656;2020
520320;201309;1413;4677;1221;4309;285;1053;620;2245;905;3298
520330;201309;2689;8621;2134;7630;696;2699;527;1803;1223;4502
520340;201309;1857;4825;1510;4417;231;655;1147;3457;1378;4112
520350;201309;2803;8823;2481;8169;939;3316;1013;3250;1952;6566
520355;201309;1096;3881;1067;3809;427;1592;443;1573;870;3165
520357;201309;881;2460;764;2294;77;266;531;1573;608;1839
520360;201309;568;1580;503;1473;141;417;233;686;374;1103
520380;201309;1035;2892;810;2531;162;562;459;1447;621;2009
520390;201309;1166;3164;818;2687;276;1031;303;917;579;1948
520393;201309;562;1515;512;1432;96;282;342;960;438;1242
520396;201309;685;2254;647;2189;90;351;455;1540;545;1891
520400;201309;1713;4992;1460;4640;285;973;923;2961;1208;3934
520410;201309;1395;3946;1148;3578;357;1229;512;1551;869;2780
520420;201309;326;923;255;795;53;196;117;339;170;535
520425;201309;1405;3977;1328;3832;445;1382;633;1788;1078;3170
520430;201309;1853;5064;1427;4363;329;1161;655;1930;984;3091
520440;201309;2785;7971;2239;7092;855;2974;621;1922;1476;4896
520450;201309;9062;26986;7282;23674;2239;8109;1749;5327;3988;13436
520455;201309;661;2015;551;1837;228;815;150;504;378;1319
520460;201309;790;2363;656;2132;192;690;245;782;437;1472
520465;201309;801;2222;703;2090;175;632;315;857;490;1489
520470;201309;1654;5494;1516;5287;386;1359;913;3329;1299;4688
520480;201309;945;2838;829;2648;192;635;492;1598;684;2233
520485;201309;1112;3832;1040;3706;412;1560;450;1593;862;3153
520490;201309;4273;13484;3475;12235;1499;5693;1091;3831;2590;9524
520495;201309;1381;3800;1162;3539;55;136;1062;3318;1117;3454
520500;201309;2017;5445;1808;5155;624;1901;724;2235;1348;4136
520505;201309;889;2575;769;2390;128;383;528;1704;656;2087
520510;201309;10643;30740;7217;24780;2303;8673;1832;6242;4135;14915
520520;201309;1007;2979;866;2784;343;1181;326;1063;669;2244
520530;201309;2344;7373;2037;6869;484;1668;998;3725;1482;5393
520540;201309;2829;8952;2524;8404;853;2985;1032;3420;1885;6405
520545;201309;1286;4056;1111;3691;346;1250;335;1046;681;2296
520547;201309;807;2578;649;2288;227;892;188;613;415;1505
520549;201309;7991;25214;7064;24066;1832;6762;4108;13910;5940;20672
520551;201309;3604;11196;3465;11017;1059;3514;1913;6333;2972;9847
520552;201309;674;2304;660;2284;129;498;440;1506;569;2004
520570;201309;563;1691;424;1458;182;665;83;291;265;956
520580;201309;1886;5645;1554;5131;482;1789;474;1483;956;3272
520590;201309;1432;4191;1262;3920;360;1197;518;1504;878;2701
520620;201309;6772;22507;6223;21646;1472;5493;3634;12808;5106;18301
520630;201309;611;1718;528;1618;161;481;301;955;462;1436
520640;201309;2435;7433;2218;7104;808;2678;943;3177;1751;5855
520650;201309;782;2326;680;2134;292;964;244;759;536;1723
520660;201309;357;1157;315;1067;108;401;94;315;202;716
520670;201309;766;2312;748;2286;77;191;640;2012;717;2203
520680;201309;551;1728;491;1642;185;675;181;592;366;1267
520690;201309;305;807;214;681;31;107;122;398;153;505
520710;201309;327;887;285;816;10;32;204;569;214;601
520725;201309;1706;4636;1358;4130;337;1152;698;2086;1035;3238
520735;201309;587;1853;506;1709;190;676;157;513;347;1189
520740;201309;1632;4906;1392;4553;395;1368;659;2151;1054;3519
520750;201309;676;1846;515;1630;144;512;293;921;437;1433
520753;201309;1118;3368;1095;3334;180;501;833;2634;1013;3135
520760;201309;1121;3197;997;3039;331;1093;535;1603;866;2696
520780;201309;1824;4816;1617;4544;188;528;1280;3659;1468;4187
520790;201309;2391;7143;2170;6825;333;1154;1539;4889;1872;6043
520800;201309;16628;50666;14915;48597;3511;11349;8927;31229;12438;42578
520810;201309;802;2447;786;2416;120;390;604;1884;724;2274
520815;201309;393;1386;312;1223;170;738;38;140;208;878
520830;201309;1660;4361;1304;3989;60;161;1182;3701;1242;3862
520840;201309;1618;5552;1464;5244;506;1920;532;1958;1038;3878
520850;201309;774;2292;616;2072;192;690;280;924;472;1614
520860;201309;6899;20353;5333;18278;1589;5892;2546;8872;4135;14764
520870;201309;117790;337795;84838;277244;28131;99775;25333;82232;53464;182007
520880;201309;6278;18628;4656;15931;1452;5554;656;2016;2108;7570
520890;201309;3412;10542;3118;10081;781;2693;1670;5386;2451;8079
520910;201309;3596;11818;3162;10893;1136;4248;880;2882;2016;7130
520915;201309;879;2533;652;2086;164;555;243;739;407;1294
520920;201309;2842;8101;2161;6969;601;2076;698;2309;1299;4385
520929;201309;438;1309;399;1263;118;388;202;637;320;1025
520940;201309;918;2858;850;2752;122;450;625;1988;747;2438
520945;201309;616;1586;548;1478;209;572;194;497;403;1069
520960;201309;860;2567;722;2364;123;421;455;1503;578;1924
520970;201309;3300;9745;2680;8612;611;2224;1099;3439;1710;5663
520980;201309;1002;2773;938;2686;187;590;678;1919;865;2509
520990;201309;3621;11483;3222;10787;706;2556;1718;6238;2424;8794
520993;201309;1041;2966;853;2599;149;503;488;1448;637;1951
520995;201309;2493;6951;2255;6629;371;1141;1623;4793;1994;5934
521000;201309;7407;22779;6438;21205;1574;5645;3496;11587;5070;17232
521010;201309;3469;11303;3086;10524;863;3170;1318;4519;2181;7689
521015;201309;688;2006;593;1854;156;509;298;942;454;1451
521020;201309;4208;12761;3437;11138;1295;4546;741;2156;2036;6702
521030;201309;786;2150;703;2035;144;437;477;1400;621;1837
521040;201309;5162;15503;4728;14806;1809;5746;2228;7258;4037;13004
521056;201309;972;3033;830;2800;282;1000;356;1229;638;2229
521060;201309;1110;3188;962;2933;241;785;393;1164;634;1949
521080;201309;1112;2871;749;2254;176;630;266;681;442;1311
521090;201309;3037;9213;2625;8626;946;3304;1001;3314;1947;6618
521100;201309;1365;3641;1270;3535;242;676;896;2550;1138;3226
521120;201309;4623;13663;4246;13016;1016;3040;2419;7723;3435;10763
521130;201309;1040;3053;894;2806;197;694;464;1481;661;2175
521140;201309;873;2978;789;2780;302;1132;168;562;470;1694
521150;201309;11169;30948;8531;26020;2684;8933;3808;11490;6492;20423
521160;201309;711;1860;501;1430;90;288;295;803;385;1091
521170;201309;1303;3208;1133;3001;326;845;653;1742;979;2587
521180;201309;6161;21440;5656;20380;2156;8267;1586;5708;3742;13975
521190;201309;8215;25240;6340;21944;2299;8364;1998;6993;4297;15357
521200;201309;784;2160;742;2107;115;335;536;1537;651;1872
521205;201309;479;1581;440;1501;73;262;264;922;337;1184
521210;201309;815;2469;600;2027;229;880;212;620;441;1500
521220;201309;3637;10664;3135;9955;1126;3853;1182;3688;2308;7541
521225;201309;374;989;302;893;48;159;199;599;247;758
521230;201309;1272;4108;1207;3956;468;1630;515;1617;983;3247
521250;201309;24923;85500;23927;83809;9905;36939;9303;32966;19208;69905
521260;201309;780;1975;624;1689;112;393;347;869;459;1262
521270;201309;1679;5544;1579;5373;147;439;1266;4488;1413;4927
521280;201309;1661;5341;1453;4979;480;1758;588;2010;1068;3768
521290;201309;500;1501;381;1295;102;417;157;512;259;929
521295;201309;1070;3069;1001;2973;182;593;716;2110;898;2703
521300;201309;1743;5208;1599;4966;560;1808;664;2145;1224;3953
521305;201309;823;2207;697;2035;172;506;410;1237;582;1743
521308;201309;4737;14507;3918;13176;766;2895;2381;7858;3147;10753
521310;201309;6710;21174;5726;19441;2260;8165;1589;5311;3849;13476
521340;201309;239;787;219;750;75;283;84;272;159;555
521350;201309;2082;5567;1726;5097;246;822;1126;3471;1372;4293
521370;201309;980;3196;904;3043;327;1180;322;1050;649;2230
521375;201309;1294;3781;1125;3506;288;980;578;1764;866;2744
521377;201309;926;2884;902;2850;90;272;765;2462;855;2734
521380;201309;3514;10627;2903;9644;690;2552;1238;3997;1928;6549
521385;201309;571;1664;516;1587;158;509;255;787;413;1296
521390;201309;1101;2946;828;2563;296;1033;250;763;546;1796
521400;201309;2330;6383;2015;6027;284;909;1570;4675;1854;5584
521405;201309;1047;3253;998;3177;193;628;647;2117;840;2745
521410;201309;731;2394;674;2299;339;1136;211;774;550;1910
521440;201309;1426;4023;1401;3997;150;382;1198;3500;1348;3882
521450;201309;4844;14903;4075;13454;1337;4752;1003;3126;2340;7878
521460;201309;6670;21482;6157;20666;1997;7188;2878;9696;4875;16884
521470;201309;697;1997;523;1666;122;444;113;362;235;806
521480;201309;510;1505;383;1286;131;452;96;327;227;779
521483;201309;2967;8061;2540;7349;679;2074;1175;3359;1854;5433
521486;201309;1526;4417;1388;4146;373;1252;825;2343;1198;3595
521487;201309;546;1529;418;1337;99;322;215;701;314;1023
521490;201309;797;2369;659;2187;129;469;413;1391;542;1860
521500;201309;1139;3864;1068;3731;170;661;723;2444;893;3105
521520;201309;869;2092;776;1988;194;410;436;1271;630;1681
521523;201309;10999;41573;10307;40341;3719;15897;3865;14869;7584;30766
521525;201309;1065;2784;955;2635;133;416;644;1725;777;2141
521530;201309;1932;5815;1365;4692;547;1988;230;752;777;2740
521540;201309;872;2591;650;2131;208;789;163;467;371;1256
521550;201309;900;2312;814;2188;242;712;436;1122;678;1834
521560;201309;4868;15099;3899;13794;1670;6435;1009;3413;2679;9848
521565;201309;599;1725;546;1653;91;298;388;1178;479;1476
521570;201309;4198;11936;3243;10157;1160;3922;1070;3381;2230;7303
521580;201309;604;1576;465;1373;174;547;157;463;331;1010
521590;201309;713;2075;618;1915;239;799;123;405;362;1204
521600;201309;616;1653;445;1349;116;391;156;424;272;815
521630;201309;1736;4830;1471;4407;600;2075;269;654;869;2729
521640;201309;1727;5081;1521;4759;524;1893;414;1329;938;3222
521645;201309;624;1995;551;1833;156;575;223;686;379;1261
521680;201309;1322;4430;1224;4197;712;2554;203;651;915;3205
521690;201309;560;1696;505;1592;121;457;246;708;367;1165
521710;201309;2107;6733;1893;6323;405;1441;1137;3780;1542;5221
521720;201309;1986;6046;1830;5831;450;1469;1110;3624;1560;5093
521730;201309;3636;12471;3454;12111;1552;5943;1004;3257;2556;9200
521740;201309;3239;9175;2641;8399;1277;4170;888;2941;2165;7111
521760;201309;11797;41302;11228;40425;2084;8325;7617;27539;9701;35864
521770;201309;2697;8321;2309;7544;1032;3612;501;1519;1533;5131
521800;201309;8300;25344;7283;23855;2749;9443;3306;11170;6055;20613
521805;201309;912;2153;772;1911;254;559;381;1098;635;1657
521810;201309;818;2436;715;2256;181;623;363;1128;544;1751
521830;201309;5377;18465;5103;18027;1092;4158;3388;11960;4480;16118
521839;201309;644;2018;550;1809;156;544;224;706;380;1250
521850;201309;6230;18129;5678;17309;1366;4155;3352;10447;4718;14602
521860;201309;1695;5254;1477;4798;427;1527;534;1642;961;3169
521870;201309;544;1917;504;1808;158;617;142;466;300;1083
521878;201309;434;1459;400;1399;142;555;136;455;278;1010
521880;201309;23308;63603;16271;51868;5993;20501;4678;15037;10671;35538
521890;201309;3530;11224;3025;10202;1196;4322;714;2386;1910;6708
521900;201309;1639;4394;1342;3970;361;1188;532;1453;893;2641
521910;201309;1167;3381;1027;3216;262;908;592;1875;854;2783
521920;201309;404;1302;395;1283;167;570;172;554;339;1124
521925;201309;601;1885;540;1747;123;441;264;808;387;1249
521930;201309;3769;12451;3440;11792;1343;4890;1097;3732;2440;8622
521935;201309;669;2031;635;1962;195;639;333;1000;528;1639
521940;201309;1147;3127;950;2806;359;1128;327;972;686;2100
521945;201309;663;2323;615;2265;132;439;437;1712;569;2151
521950;201309;484;1602;426;1492;157;590;158;552;315;1142
521960;201309;920;2714;787;2474;206;694;372;1153;578;1847
521970;201309;2409;7010;2227;6769;374;1171;1572;4922;1946;6093
521971;201309;902;2555;743;2290;193;664;314;913;507;1577
521973;201309;816;2803;749;2671;231;866;241;853;472;1719
521975;201309;12703;37722;12004;36806;2430;8145;7784;23892;10214;32037
521980;201309;1677;5498;1641;5454;291;935;1269;4352;1560;5287
521990;201309;1001;3225;944;3119;189;685;580;1879;769;2564
522000;201309;2062;6214;1836;5923;400;1353;1110;3751;1510;5104
522005;201309;303;881;244;784;63;219;126;390;189;609
522010;201309;2737;8442;2419;7919;911;3264;720;2265;1631;5529
522015;201309;967;2920;817;2687;247;901;390;1275;637;2176
522020;201309;4201;12177;3726;11567;1011;3357;2086;6426;3097;9783
522026;201309;612;1780;439;1601;209;807;130;480;339;1287
522028;201309;519;1571;471;1491;123;427;274;843;397;1270
522040;201309;2924;7567;2133;6538;787;2613;820;2496;1607;5109
522045;201309;12155;41099;10652;37831;3674;14175;2319;8054;5993;22229
522050;201309;982;2929;816;2650;277;998;327;1007;604;2005
522060;201309;2753;9025;2485;8621;782;2904;1342;4652;2124;7556
522068;201309;1396;4746;1313;4653;120;371;1116;4097;1236;4468
522070;201309;824;2539;753;2422;127;486;476;1510;603;1996
522100;201309;796;2222;705;2081;264;889;320;873;584;1762
522108;201309;910;2696;806;2544;89;295;598;1929;687;2224
522119;201309;1241;3872;1057;3636;140;457;809;2884;949;3341
522130;201309;503;1471;435;1395;133;472;221;711;354;1183
522140;201309;16385;47527;14565;45005;4417;14706;7257;22335;11674;37041
522145;201309;904;2641;855;2557;453;1426;214;629;667;2055
522150;201309;1262;3332;1032;3024;367;1148;377;1136;744;2284
522155;201309;705;2142;647;2058;154;511;386;1269;540;1780
522157;201309;662;1997;608;1910;72;252;465;1466;537;1718
522160;201309;5828;17114;4452;14806;1951;7142;815;2553;2766;9695
522170;201309;3175;8879;2709;8235;755;2329;1249;4014;2004;6343
522180;201309;428;1277;334;1141;158;596;112;366;270;962
522185;201309;13706;44514;12949;43460;2922;10634;7904;26674;10826;37308
522190;201309;729;2122;651;1956;127;405;383;1151;510;1556
522200;201309;1541;5245;1429;4999;516;1947;430;1447;946;3394
522205;201309;1286;3766;1086;3433;328;1076;485;1547;813;2623
522220;201309;1036;3293;947;3171;233;837;518;1838;751;2675
522230;201309;963;3156;909;3063;202;744;552;1894;754;2638
530010;201309;246751;816537;222287;765970;70098;266281;72860;249976;142958;516257
110001;201308;4258;14208;3700;13311;1080;4026;2015;7348;3095;11374
110002;201308;12346;40755;11079;38491;3761;13974;4818;16840;8579;30814
110003;201308;981;3210;917;3108;280;1003;380;1262;660;2265
110004;201308;9178;30843;8078;28526;2667;10262;2892;10189;5559;20451
110005;201308;2297;7896;2197;7704;832;2982;946;3364;1778;6346
110006;201308;3409;9207;2156;7456;722;2645;632;2074;1354;4719
110007;201308;1405;4669;1298;4508;341;1219;779;2759;1120;3978
110008;201308;2450;8662;2303;8448;572;2005;1526;5868;2098;7873
110009;201308;5138;15177;4130;13717;919;3182;2440;8189;3359;11371
110010;201308;8283;24040;7365;22908;1392;3885;4978;16773;6370;20658
110011;201308;10679;33502;8902;30437;3479;12583;3099;10612;6578;23195
110012;201308;15645;49801;13958;46578;5099;18040;5263;17485;10362;35525
110013;201308;5122;16538;4313;15386;1323;4922;2097;7660;3420;12582
110014;201308;4128;12461;3522;11606;846;2902;2085;6968;2931;9870
110015;201308;4906;16257;4121;14879;1626;6247;1443;5228;3069;11475
110018;201308;5020;15075;4134;13927;1336;4982;1845;5980;3181;10962
110020;201308;52233;158873;45550;150445;10639;36254;27393;93211;38032;129465
110025;201308;4203;12738;3592;11607;607;2143;2565;8235;3172;10378
110026;201308;800;2402;677;2256;154;507;447;1540;601;2047
110028;201308;7285;21905;5575;19131;1758;6563;1755;5970;3513;12533
110029;201308;1648;4923;1329;4376;454;1554;562;1883;1016;3437
110030;201308;11096;32480;9168;30022;2643;9278;4700;15916;7343;25194
110032;201308;3985;13288;3625;12494;1037;3725;1656;5753;2693;9478
110033;201308;5278;17094;4930;16555;1593;5395;2421;8652;4014;14047
110034;201308;3714;9790;3159;9143;477;1318;2464;7274;2941;8592
110037;201308;2019;6975;1797;6562;517;1887;972;3630;1489;5517
110040;201308;3436;11566;3255;11221;1102;4054;1514;5208;2616;9262
110045;201308;5016;17951;4732;17595;1324;5170;2865;10718;4189;15888
110050;201308;1766;5800;1491;5448;553;2039;758;2850;1311;4889
110060;201308;968;3435;866;3242;259;1009;454;1704;713;2713
110070;201308;1884;6566;1844;6470;320;1169;1332;4694;1652;5863
110080;201308;3257;10699;3166;10581;557;1748;2447;8419;3004;10167
110090;201308;924;2820;752;2547;229;867;322;1023;551;1890
110092;201308;1669;5499;1527;5306;375;1320;874;3178;1249;4498
110094;201308;2794;9458;2602;9178;702;2632;1556;5521;2258;8153
110100;201308;2623;8572;2292;8019;690;2501;1215;4298;1905;6799
110110;201308;1724;5777;1622;5656;697;2461;732;2663;1429;5124
110120;201308;1653;5640;1438;5122;414;1547;558;1979;972;3526
110130;201308;2733;8005;2116;7117;566;2023;1048;3548;1614;5571
110140;201308;2386;8410;2298;8277;552;2027;1457;5330;2009;7357
110143;201308;1499;5083;1236;4629;304;1195;722;2688;1026;3883
110145;201308;954;2994;855;2830;170;602;542;1799;712;2401
110146;201308;447;1463;404;1394;111;399;217;757;328;1156
110147;201308;898;2734;711;2423;202;740;259;816;461;1556
110148;201308;1317;4008;1084;3545;359;1290;373;1160;732;2450
110149;201308;3413;10451;2860;9681;692;2443;1849;6369;2541;8812
110150;201308;2772;8393;2295;7669;419;1537;1485;4939;1904;6476
110155;201308;868;2984;840;2921;304;1112;383;1302;687;2414
110160;201308;2075;6757;1768;6265;571;2078;878;3153;1449;5231
110170;201308;3125;9219;2490;8156;556;1931;1546;5110;2102;7041
110175;201308;1576;5210;1245;4799;115;481;943;3654;1058;4135
110180;201308;1683;5356;1456;4972;341;1206;879;3030;1220;4236
120001;201308;2763;10150;2689;10003;724;2842;1519;5786;2243;8628
120005;201308;1475;6169;1433;6087;183;726;1093;4852;1276;5578
120010;201308;4235;15357;4070;15059;958;3375;2570;10005;3528;13380
120013;201308;1780;6963;1748;6909;330;1272;1217;5018;1547;6290
120017;201308;2022;7361;1933;7203;547;2111;956;3854;1503;5965
120020;201308;13804;61099;13610;60633;2613;10931;9749;45523;12362;56454
120025;201308;2533;9044;2463;8934;659;2483;1445;5367;2104;7850
120030;201308;5413;22764;5369;22681;634;2495;4389;19065;5023;21560
120032;201308;1333;6379;1289;6268;181;1008;955;4682;1136;5690
120033;201308;3525;13596;3498;13546;199;831;3133;12222;3332;13053
120034;201308;1795;7285;1794;7284;64;260;1693;6915;1757;7175
120035;201308;2461;12048;2441;11994;267;1264;1964;10027;2231;11291
120038;201308;3123;11528;3019;11310;860;3297;1630;6305;2490;9602
120039;201308;1336;7662;1314;7607;182;1096;1027;6057;1209;7153
120040;201308;42571;157951;39890;152073;12429;49418;19421;76170;31850;125588
120042;201308;2638;11704;2550;11485;362;1718;1872;8605;2234;10323
120043;201308;783;3775;772;3747;72;353;650;3212;722;3565
120045;201308;4335;15415;4297;15351;1021;3606;2991;10985;4012;14591
120050;201308;7943;33303;7738;32852;1720;7053;4912;22245;6632;29298
120060;201308;5500;27104;5437;26983;820;3967;4176;21499;4996;25466
120070;201308;2672;10332;2631;10234;598;2203;1659;6848;2257;9051
120080;201308;3569;13669;3437;13460;613;2438;2454;9893;3067;12331
130002;201308;2761;11742;2609;11475;306;1408;2028;9044;2334;10452
130006;201308;1682;7320;1525;6998;192;980;1110;5126;1302;6106
130008;201308;1874;7896;1814;7777;196;907;1414;6198;1610;7105
130010;201308;2723;9243;2368;8824;255;865;1946;7479;2201;8344
130014;201308;3298;10924;2871;10287;450;1776;1939;6985;2389;8761
130020;201308;2345;8409;2331;8393;62;238;2244;8081;2306;8319
130030;201308;6469;26109;6283;25858;565;1946;5394;22934;5959;24880
130040;201308;3536;11281;3360;11018;197;685;2965;9765;3162;10450
130050;201308;5654;23186;5049;22177;799;3400;3508;16404;4307;19804
130060;201308;5757;24573;5445;24139;593;2512;4484;20389;5077;22901
130063;201308;2968;13243;2949;13202;420;1784;2387;10972;2807;12756
130068;201308;2913;12449;2732;12078;367;1761;1982;8851;2349;10612
130070;201308;6239;21577;5843;21024;623;2187;4703;17342;5326;19529
130080;201308;4818;21675;4697;21492;806;3837;3385;15887;4191;19724
130083;201308;1668;7082;1608;6981;295;1342;1142;4989;1437;6331
130090;201308;2284;8508;2183;8364;188;834;1857;7091;2045;7925
130100;201308;5184;20389;4992;20117;477;2057;4125;16837;4602;18894
130110;201308;6361;20712;5973;20234;967;3178;4507;15827;5474;19005
130115;201308;3449;13270;3289;13049;210;663;2978;12044;3188;12707
130120;201308;12593;49419;12341;49066;1168;4246;10505;43010;11673;47256
130130;201308;3318;14556;3215;14362;485;2119;2463;11302;2948;13421
130140;201308;5689;23075;5647;23020;145;435;5453;22482;5598;22917
130150;201308;3255;12366;3189;12279;269;1307;2695;10294;2964;11601
130160;201308;3818;15757;3759;15668;222;786;3448;14580;3670;15366
130165;201308;2702;11149;2663;11084;514;2154;2019;8514;2533;10668
130170;201308;7961;30625;7086;29481;1353;5643;4864;21156;6217;26799
130180;201308;3295;10517;3226;10420;124;378;2989;9717;3113;10095
130185;201308;8171;30392;7928;30053;1632;5970;5585;22083;7217;28053
130190;201308;16156;57807;14451;55591;3160;11716;9228;37790;12388;49506
130195;201308;1735;7146;1676;7054;97;437;1482;6290;1579;6727
130200;201308;1941;7118;1811;6898;333;1324;1215;4694;1548;6018
130210;201308;1116;4357;1061;4257;179;691;787;3280;966;3971
130220;201308;2001;8232;1838;7935;355;1717;1132;4909;1487;6626
130230;201308;3272;14907;3111;14610;392;2045;2298;10999;2690;13044
130240;201308;7951;31403;7395;30569;549;2534;6230;26155;6779;28689
130250;201308;16780;62882;16398;62296;2752;9948;12256;48511;15008;58459
130255;201308;3818;14228;3627;13894;250;851;3141;12385;3391;13236
130260;201308;234090;769038;214425;738567;60678;212026;115365;413406;176043;625432
130270;201308;7220;30428;6544;29358;1105;4818;4639;21861;5744;26679
130280;201308;2962;11618;2897;11521;159;533;2606;10630;2765;11163
130290;201308;10320;37844;10093;37483;232;724;9479;35719;9711;36443
130300;201308;4215;16714;3994;16394;357;1529;3278;13694;3635;15223
130310;201308;4413;17822;4091;17399;683;2773;2973;13207;3656;15980
130320;201308;2662;9301;2438;8984;366;1417;1734;6532;2100;7949
130330;201308;3318;12322;2972;11837;253;1057;2471;10006;2724;11063
130340;201308;16610;65796;16217;65164;2827;10715;11536;49005;14363;59720
130350;201308;3190;12901;3055;12737;227;725;2711;11661;2938;12386
130353;201308;4928;16606;4471;15971;1244;4410;2522;9548;3766;13958
130356;201308;3916;14473;3768;14241;565;2044;2853;11286;3418;13330
130360;201308;2671;8093;2409;7785;71;199;2224;7355;2295;7554
130370;201308;4684;18520;4005;17615;292;1584;3298;14533;3590;16117
130380;201308;6624;28052;6391;27662;490;2306;5405;23607;5895;25913
130390;201308;4388;19540;4136;19112;479;2157;3308;15748;3787;17905
130395;201308;1917;7398;1780;7137;311;1388;1129;4512;1440;5900
130400;201308;2121;7634;2053;7531;100;392;1845;6840;1945;7232
130406;201308;8777;34264;7911;32795;2013;8167;4519;19980;6532;28147
130410;201308;4063;15621;3766;15063;920;3809;2109;8772;3029;12581
130420;201308;9366;40658;9090;40039;2726;11738;5015;23412;7741;35150
130423;201308;2935;11619;2799;11439;243;1163;2339;9576;2582;10739
130426;201308;1929;8465;1854;8331;319;1413;1308;6154;1627;7567
130430;201308;3304;12200;3128;11939;382;1590;2302;8972;2684;10562
130440;201308;3611;13377;3322;13060;243;839;2904;11785;3147;12624
140002;201308;1249;4602;1211;4534;273;928;796;3211;1069;4139
140005;201308;2272;7419;2140;7272;137;440;1900;6564;2037;7004
140010;201308;42351;140477;38709;134332;8838;32657;22948;81240;31786;113897
140015;201308;2547;8814;2467;8710;207;562;2136;7814;2343;8376
140017;201308;2815;9277;2716;9150;209;668;2354;8087;2563;8755
140020;201308;4056;13970;3799;13612;562;2015;2782;10279;3344;12294
140023;201308;1839;6662;1723;6473;221;835;1323;5125;1544;5960
140028;201308;2031;5830;1965;5753;113;271;1768;5307;1881;5578
140030;201308;3412;11211;3280;11037;369;902;2766;9811;3135;10713
140040;201308;1451;7099;1396;6927;132;736;1030;5222;1162;5958
140045;201308;2261;8513;2170;8384;264;893;1721;7027;1985;7920
140047;201308;4933;14779;4707;14467;1113;3279;2934;9619;4047;12898
140050;201308;1437;4521;1355;4400;160;508;1072;3574;1232;4082
140060;201308;1263;4125;1168;4000;261;888;769;2736;1030;3624
140070;201308;1426;7040;1423;7034;58;235;1351;6755;1409;6990
150010;201308;30910;104251;29748;102676;2274;8180;25389;88864;27663;97044
150013;201308;1459;4733;1414;4681;132;449;1180;3940;1312;4389
150020;201308;10220;36948;10018;36630;1354;4920;7880;29461;9234;34381
150030;201308;5855;26115;5709;25858;617;2412;4718;22291;5335;24703
150034;201308;4338;11941;4124;11686;146;338;3917;11241;4063;11579
150040;201308;11645;41835;10298;40114;2141;7631;6948;29022;9089;36653
150050;201308;5828;22626;5700;22385;680;2893;4534;17946;5214;20839
150060;201308;13779;46184;13173;45289;3529;11845;7779;28086;11308;39931
150070;201308;4995;21762;4620;21303;581;2586;3696;17526;4277;20112
150080;201308;57351;159520;51241;151803;6816;18485;38642;118278;45458;136763
150085;201308;4663;16981;4498;16739;785;2491;3373;13335;4158;15826
150090;201308;9458;37613;8980;36949;1213;4778;7029;29752;8242;34530
150095;201308;4964;17542;4638;17035;550;2019;3662;13803;4212;15822
150100;201308;3319;12614;3136;12341;302;1398;2548;9942;2850;11340
150110;201308;3131;15115;3119;15085;160;668;2887;14157;3047;14825
150120;201308;5668;22903;5571;22704;835;3357;4321;17861;5156;21218
150125;201308;769;2448;709;2349;162;566;423;1395;585;1961
150130;201308;17914;60101;17326;59207;1850;6386;14078;48753;15928;55139
150140;201308;133037;411148;128897;405929;19119;60662;100496;320522;119615;381184
150145;201308;4630;15118;4302;14686;643;2254;3161;11029;3804;13283
150150;201308;8779;29899;8328;29158;1835;6707;5381;19074;7216;25781
150157;201308;2460;8446;2308;8229;353;1338;1775;6356;2128;7694
150160;201308;2589;9130;2499;8995;675;2332;1512;5710;2187;8042
150170;201308;21506;80725;20493;79448;3264;12441;15723;61993;18987;74434
150172;201308;2837;10091;2578;9713;287;1104;2130;8148;2417;9252
150175;201308;1941;6290;1880;6215;150;466;1644;5555;1794;6021
150178;201308;10414;33108;9094;31555;562;1684;8155;29008;8717;30692
150180;201308;16430;68603;16006;68014;1552;6977;13457;57811;15009;64788
150190;201308;6874;22485;6510;21969;427;1084;5695;19983;6122;21067
150195;201308;4091;15403;3851;14959;453;1749;3028;11967;3481;13716
150200;201308;4545;15564;4489;15492;104;345;4271;14833;4375;15178
150210;201308;21571;83302;21314;82931;2090;7760;18326;72448;20416;80208
150215;201308;5101;17132;4730;16572;1245;4459;2762;9896;4007;14355
150220;201308;11892;39831;11156;38605;2645;9327;6565;23313;9210;32640
150230;201308;10546;37485;9718;36316;808;3677;8157;30219;8965;33896
150240;201308;31537;99673;29268;95760;8502;28990;14647;49033;23149;78023
150250;201308;3548;14510;3451;14351;664;2546;2448;10774;3112;13320
150260;201308;1784;7683;1748;7597;298;1414;1175;5140;1473;6554
150270;201308;9141;28544;7233;26154;1649;6366;4521;16610;6170;22976
150275;201308;5418;20622;5182;20233;856;3386;3767;15031;4623;18417
150276;201308;2012;6125;1914;6005;277;904;1519;4780;1796;5684
150277;201308;4909;15536;4343;14869;504;1789;3497;12189;4001;13978
150280;201308;5667;24963;5558;24713;677;2941;4414;20057;5091;22998
150285;201308;2552;10349;2529;10302;238;979;2171;8922;2409;9901
150290;201308;7784;25976;7642;25777;831;2702;6303;21746;7134;24448
150293;201308;8438;27506;7496;26059;2543;9065;3488;12738;6031;21803
150295;201308;5760;20312;5230;19593;1317;4971;3192;12375;4509;17346
150300;201308;1713;6166;1679;6117;119;418;1452;5345;1571;5763
150304;201308;3844;12500;3390;11892;520;1849;2535;9054;3055;10903
150307;201308;6371;22431;5966;21841;492;1754;4955;18668;5447;20422
150309;201308;6152;22847;5805;22339;1622;6178;3585;14411;5207;20589
150310;201308;4800;22705;4730;22581;536;2398;3901;19178;4437;21576
150320;201308;7642;22640;7493;22461;498;1538;6692;20141;7190;21679
150330;201308;12393;46998;11891;46172;1479;5758;9376;37239;10855;42997
150340;201308;2027;7205;1921;7045;474;1837;1168;4333;1642;6170
150345;201308;6254;22551;5888;22043;697;2645;4769;18214;5466;20859
150350;201308;6872;23610;6577;23166;951;3368;4897;17562;5848;20930
150360;201308;20002;64872;17697;62030;2566;9130;13329;48104;15895;57234
150370;201308;9491;36985;9197;36571;1132;4188;7508;30866;8640;35054
150375;201308;2666;11334;2611;11265;235;802;2239;10127;2474;10929
150380;201308;9095;29065;8277;27945;911;3339;6895;23263;7806;26602
150390;201308;7812;34133;7500;33472;1833;7716;4555;21571;6388;29287
150400;201308;5154;21968;5001;21618;640;2653;3722;16655;4362;19308
150405;201308;7937;25352;7256;24483;1503;4603;4935;17719;6438;22322
150410;201308;1604;6344;1574;6291;271;1120;1071;4398;1342;5518
150420;201308;30331;112311;27897;108364;7387;29963;15627;62952;23014;92915
150430;201308;6088;23511;5975;23298;825;3549;4576;17856;5401;21405
150440;201308;5130;18318;5039;18169;767;2705;3779;13926;4546;16631
150442;201308;20814;60476;19189;58428;3092;9585;13744;42976;16836;52561
150445;201308;4871;17668;4530;17183;658;2382;3518;13725;4176;16107
150450;201308;4068;19817;3944;19649;383;1879;3322;16897;3705;18776
150460;201308;6364;24512;5486;23580;397;1831;4895;21208;5292;23039
150470;201308;15547;50464;15133;49915;1509;4211;12911;43972;14420;48183
150480;201308;13645;47332;13176;46668;903;2933;11524;41690;12427;44623
150490;201308;6146;24170;6050;24044;373;1453;5457;21911;5830;23364
150495;201308;4388;16631;4308;16479;403;1605;3661;14079;4064;15684
150497;201308;3236;11446;2981;11028;829;3058;1735;6722;2564;9780
150500;201308;2811;8718;2706;8539;385;1276;2058;6483;2443;7759
150503;201308;3629;11700;3121;11040;1196;4416;1340;4950;2536;9366
150506;201308;11444;42270;10953;41594;2635;8836;7458;30305;10093;39141
150510;201308;9195;37291;8708;36432;1456;6164;6164;26777;7620;32941
150520;201308;5768;24470;5682;24338;455;1582;5028;22125;5483;23707
150530;201308;10712;39822;9858;38559;1404;4988;7366;30009;8770;34997
150540;201308;4426;14222;4091;13708;354;1248;3415;11436;3769;12684
150543;201308;4572;15048;4265;14613;1331;4577;2440;8612;3771;13189
150548;201308;7730;25127;7315;24591;705;2237;6191;21268;6896;23505
150549;201308;2132;6949;2041;6839;105;266;1858;6386;1963;6652
150550;201308;20190;66097;18407;63139;5416;19241;9330;32768;14746;52009
150553;201308;20349;76800;18622;72278;7744;31876;3599;13876;11343;45752
150555;201308;1596;5212;1417;4946;247;940;973;3424;1220;4364
150560;201308;1936;6383;1883;6256;229;835;1438;4738;1667;5573
150563;201308;2787;9505;2619;9191;617;2341;1586;5537;2203;7878
150565;201308;3200;11892;3044;11651;250;1079;2506;9640;2756;10719
150570;201308;4879;19393;4819;19289;409;1606;4077;16715;4486;18321
150580;201308;8959;37179;8836;37015;802;2910;7627;33064;8429;35974
150590;201308;4997;20788;4895;20664;167;770;4572;19400;4739;20170
150600;201308;7083;28659;6964;28448;645;2385;5932;24950;6577;27335
150610;201308;2406;8429;2252;8110;284;1160;1585;5640;1869;6800
150611;201308;2512;9680;2426;9474;308;1278;1818;7184;2126;8462
150613;201308;10770;34513;9631;32831;3348;11717;4544;16242;7892;27959
150616;201308;2915;8523;2381;7937;569;1847;1571;5440;2140;7287
150618;201308;7227;25852;6965;25373;2308;8748;3410;12701;5718;21449
150619;201308;5008;17725;4727;17305;754;2890;3354;12450;4108;15340
150620;201308;5888;21933;5417;21312;782;3112;4128;16819;4910;19931
150630;201308;5069;16536;4859;16256;442;1488;4082;13842;4524;15330
150635;201308;4236;14393;4014;13975;827;2949;2543;9148;3370;12097
150640;201308;1389;4582;1376;4561;36;102;1305;4374;1341;4476
150650;201308;11487;36774;10613;35185;2908;10055;5657;19025;8565;29080
150655;201308;5040;17517;4682;16999;774;2855;3424;12692;4198;15547
150658;201308;3846;13134;3693;12893;354;1481;2935;10134;3289;11615
150660;201308;5461;17824;5025;17262;1399;4735;2916;10439;4315;15174
150670;201308;5766;17663;5064;16806;1705;5723;2683;9463;4388;15186
150680;201308;46804;189802;44775;185968;15990;65798;20679;92165;36669;157963
150690;201308;1783;6002;1668;5786;278;988;1083;3863;1361;4851
150700;201308;5496;17870;5257;17541;1112;3708;3533;12072;4645;15780
150710;201308;3740;12400;3520;12085;378;1076;2971;10520;3349;11596
150715;201308;4705;16058;4350;15580;573;2047;3468;12693;4041;14740
150720;201308;6098;25730;5835;25260;888;3625;4327;19538;5215;23163
150730;201308;8627;30691;8169;30067;1171;4188;6518;24573;7689;28761
150740;201308;3417;11462;3232;11119;496;1805;2246;7856;2742;9661
150745;201308;5840;18697;5455;18179;917;3196;3991;13440;4908;16636
150746;201308;1306;4595;1252;4491;190;780;887;3202;1077;3982
150747;201308;4825;16292;4521;15889;447;1512;3661;13298;4108;14810
150750;201308;2530;9070;2474;9005;119;279;2316;8636;2435;8915
150760;201308;10802;36096;10422;35549;2570;8647;6572;23194;9142;31841
150770;201308;5162;20585;5020;20369;902;3317;3752;15960;4654;19277
150775;201308;1043;3464;961;3308;196;823;581;1914;777;2737
150780;201308;2947;10047;2926;10024;86;219;2771;9636;2857;9855
150790;201308;4722;15613;4461;15276;327;957;3858;13622;4185;14579
150795;201308;13925;45118;12895;43518;2084;6771;9403;32766;11487;39537
150796;201308;2659;8425;2597;8347;397;1176;2008;6723;2405;7899
150797;201308;3595;12378;3459;12161;184;686;3049;10830;3233;11516
150800;201308;13220;45818;12222;44562;2884;9984;8080;30999;10964;40983
150803;201308;6354;24031;6163;23745;877;3587;4621;18110;5498;21697
150805;201308;2634;9423;2464;9183;382;1351;1790;6902;2172;8253
150808;201308;5667;19789;4923;18382;2164;8493;1238;4867;3402;13360
150810;201308;18461;59487;15809;56263;2681;9206;11237;42075;13918;51281
150812;201308;4698;15300;4421;14968;465;1897;3419;11392;3884;13289
150815;201308;8328;27113;7532;26135;1138;3620;5830;21066;6968;24686
150820;201308;9977;30251;9145;29343;524;1133;8274;27368;8798;28501
150830;201308;11970;47300;11514;46488;922;3615;9401;39351;10323;42966
150835;201308;1907;7203;1782;6903;507;2063;853;3322;1360;5385
150840;201308;6358;19268;5254;17860;1353;5110;2923;9623;4276;14733
160005;201308;681;2655;646;2579;114;528;391;1546;505;2074
160010;201308;1474;5324;1463;5312;193;544;1204;4599;1397;5143
160015;201308;1497;5713;1465;5655;268;973;1045;4266;1313;5239
160020;201308;2243;7556;2095;7353;296;1082;1554;5576;1850;6658
160021;201308;787;3529;767;3493;148;730;518;2427;666;3157
160023;201308;912;3534;902;3518;106;379;757;3028;863;3407
160025;201308;1185;3349;1151;3313;23;80;1106;3176;1129;3256
160027;201308;7736;25612;7336;25133;1746;6085;4788;16887;6534;22972
160030;201308;36347;139479;35454;137620;8397;31730;23772;95276;32169;127006
160040;201308;3195;13626;3142;13536;214;988;2771;12004;2985;12992
160050;201308;3115;12036;2828;11577;1008;3787;1359;6297;2367;10084
160053;201308;2032;8628;2011;8593;575;2467;1207;5315;1782;7782
160055;201308;764;3026;748;3003;143;627;528;2133;671;2760
160060;201308;17223;58165;16247;57068;4518;15079;10109;37619;14627;52698
160070;201308;1914;8567;1899;8542;205;838;1633;7528;1838;8366
160080;201308;2457;9821;2438;9790;152;549;2234;9105;2386;9654
170025;201308;554;1940;511;1874;184;707;233;884;417;1591
170030;201308;1141;3857;1057;3708;301;1083;560;1983;861;3066
170035;201308;1513;4678;1249;4167;445;1600;395;1349;840;2949
170040;201308;1708;5873;1544;5621;341;1416;922;3356;1263;4772
170070;201308;2002;5590;1649;5134;419;1432;877;2778;1296;4210
170100;201308;2457;6848;2188;6375;284;929;1703;4919;1987;5848
170105;201308;727;2434;621;2220;131;581;332;1141;463;1722
170110;201308;1180;3704;1044;3481;212;714;645;2171;857;2885
170130;201308;1340;4343;1203;4163;193;662;851;3059;1044;3721
170190;201308;1609;4762;1346;4384;613;2012;360;1326;973;3338
170200;201308;1443;4564;1143;4016;308;1210;371;1261;679;2471
170210;201308;26147;84584;23064;79033;9306;34327;6603;23263;15909;57590
170215;201308;1111;3675;1013;3514;147;523;745;2647;892;3170
170220;201308;6379;21514;5902;20773;858;3175;4180;15092;5038;18267
170230;201308;1401;4877;1256;4621;352;1458;589;2105;941;3563
170240;201308;2976;8454;2439;7800;333;1183;1696;5483;2029;6666
170255;201308;3508;11576;3011;10727;1099;3880;1215;4653;2314;8533
170270;201308;1034;2730;757;2353;204;660;428;1357;632;2017
170290;201308;2878;8897;2555;8502;218;656;2135;7385;2353;8041
170300;201308;2005;6471;1793;6130;307;1165;1212;4149;1519;5314
170305;201308;686;2229;578;2016;118;463;346;1182;464;1645
170307;201308;1044;3721;920;3502;292;1128;365;1559;657;2687
170310;201308;1605;4497;1304;4020;349;1141;598;1929;947;3070
170320;201308;930;2815;777;2548;191;642;416;1398;607;2040
170330;201308;810;2491;686;2347;126;428;466;1629;592;2057
170360;201308;453;1611;430;1571;97;380;217;791;314;1171
170370;201308;1369;4139;1163;3844;195;764;712;2336;907;3100
170380;201308;2053;6663;1720;6169;431;1743;910;3224;1341;4967
170382;201308;558;1902;503;1826;53;187;409;1505;462;1692
170384;201308;1482;6339;1414;6216;345;1547;902;4082;1247;5629
170386;201308;835;2569;702;2367;205;759;269;937;474;1696
170388;201308;647;1966;567;1834;134;512;220;692;354;1204
170389;201308;918;3189;861;3099;102;450;649;2289;751;2739
170390;201308;1291;3971;1131;3766;192;652;819;2803;1011;3455
170410;201308;456;1530;437;1497;65;247;304;1040;369;1287
170460;201308;500;1419;388;1239;105;359;139;456;244;815
170510;201308;752;2591;647;2430;131;566;347;1296;478;1862
170550;201308;5303;16949;4474;15440;1824;6744;1238;4370;3062;11114
170555;201308;1313;3940;1096;3612;280;1025;606;1994;886;3019
170560;201308;1023;3514;871;3342;189;727;603;2404;792;3131
170600;201308;1293;3758;1161;3601;72;244;973;3074;1045;3318
170610;201308;1599;4911;1270;4388;205;795;746;2607;951;3402
170625;201308;389;1282;313;1116;87;323;86;306;173;629
170650;201308;1196;4004;1098;3816;261;976;593;2079;854;3055
170700;201308;3831;13045;3253;12079;884;3609;1487;5726;2371;9335
170710;201308;1671;5085;1425;4718;183;710;1017;3386;1200;4096
170720;201308;1779;4774;1569;4449;313;897;1074;3098;1387;3995
170730;201308;1129;3272;932;2972;295;1056;414;1301;709;2357
170740;201308;2120;7842;1955;7576;301;1284;1382;5395;1683;6679
170755;201308;869;2793;738;2508;204;738;291;971;495;1709
170765;201308;1558;4267;1267;3800;335;1080;532;1656;867;2736
170770;201308;1802;6394;1690;6177;400;1516;980;3701;1380;5217
170820;201308;4100;13296;3708;12665;1066;3877;1634;5676;2700;9553
170825;201308;751;2302;575;1968;139;525;236;798;375;1323
170830;201308;1282;3873;1228;3792;50;117;1134;3544;1184;3661
170900;201308;2786;10054;2679;9850;344;1269;2026;7667;2370;8936
170930;201308;4158;12807;3424;11754;1392;5032;1141;3934;2533;8966
170950;201308;11011;34045;8912;30503;3951;14982;2020;6444;5971;21426
170980;201308;423;1401;372;1306;107;393;153;548;260;941
171050;201308;1229;4505;1171;4399;60;282;1047;3883;1107;4165
171070;201308;1651;5427;1531;5266;340;1238;942;3304;1282;4542
171090;201308;866;2656;769;2502;149;500;505;1665;654;2165
171110;201308;627;1887;519;1717;166;602;283;891;449;1493
171150;201308;855;2551;641;2143;132;478;360;1202;492;1680
171180;201308;590;1906;475;1658;124;479;203;725;327;1204
171190;201308;1831;6645;1573;6107;400;1635;742;3009;1142;4644
171195;201308;854;3131;782;2999;111;466;496;1973;607;2439
171200;201308;657;2176;554;1983;155;647;261;878;416;1525
171215;201308;435;1358;355;1223;64;240;170;599;234;839
171240;201308;867;2930;826;2861;70;175;688;2501;758;2676
171245;201308;661;2224;552;1957;120;475;266;931;386;1406
171250;201308;1134;3283;1024;3155;67;205;866;2711;933;2916
171270;201308;411;1711;382;1643;96;398;203;949;299;1347
171280;201308;870;2762;780;2603;190;624;394;1448;584;2072
171320;201308;3829;12085;3347;11390;1142;4072;1570;5359;2712;9431
171330;201308;2726;8486;2444;8056;638;2222;1354;4534;1992;6756
171360;201308;1483;4913;1270;4600;323;1247;688;2545;1011;3792
171370;201308;696;1992;623;1871;143;516;336;952;479;1468
171380;201308;1272;4460;1148;4221;323;1194;577;2208;900;3402
171395;201308;886;2852;755;2602;156;602;396;1368;552;1970
171420;201308;2262;6938;1839;6179;491;1784;785;2643;1276;4427
171430;201308;1023;3267;933;3135;217;736;556;1902;773;2638
171488;201308;2392;7489;2209;7216;580;1899;1186;4046;1766;5945
171500;201308;885;2739;781;2528;136;402;444;1490;580;1892
171510;201308;882;3244;804;3123;152;609;508;2076;660;2685
171515;201308;611;1811;492;1639;115;400;236;799;351;1199
171525;201308;589;2028;503;1866;106;428;270;1001;376;1429
171550;201308;342;1160;291;1047;118;475;52;200;170;675
171570;201308;1076;3583;975;3433;184;643;645;2340;829;2983
171575;201308;1908;5587;1540;4924;453;1511;637;2114;1090;3625
171610;201308;5960;20778;5502;19897;1960;7460;1913;6949;3873;14409
171620;201308;2143;7032;2008;6822;196;741;1631;5565;1827;6306
171630;201308;890;3010;745;2750;178;738;326;1193;504;1931
171650;201308;2276;7327;1923;6716;539;2009;863;2960;1402;4969
171660;201308;2535;7203;2103;6443;502;1633;1089;3412;1591;5045
171665;201308;1370;4315;1211;4044;221;821;772;2626;993;3447
171670;201308;2240;6178;1880;5719;455;1513;1139;3402;1594;4915
171700;201308;1095;3732;1002;3578;159;643;648;2319;807;2962
171720;201308;665;2125;589;1976;166;600;295;996;461;1596
171750;201308;1192;4023;1074;3778;402;1480;377;1340;779;2820
171780;201308;1113;3291;830;2876;139;532;500;1726;639;2258
171790;201308;1718;5606;1409;5153;292;1086;841;3216;1133;4302
171800;201308;708;2311;654;2230;98;372;447;1529;545;1901
171820;201308;9212;29375;8555;28568;2127;7612;4961;16832;7088;24444
171830;201308;1609;5945;1476;5657;368;1503;688;2640;1056;4143
171840;201308;739;2257;669;2161;77;273;500;1616;577;1889
171845;201308;786;2145;614;1848;89;316;356;1040;445;1356
171850;201308;1021;3697;934;3508;106;475;611;2295;717;2770
171855;201308;1215;3973;1108;3794;124;512;826;2776;950;3288
171865;201308;474;1579;407;1480;103;426;199;708;302;1134
171870;201308;650;2133;551;1961;124;466;265;978;389;1444
171875;201308;1347;4364;1150;4063;177;692;826;2909;1003;3601
171880;201308;981;3535;955;3493;127;491;718;2692;845;3183
171884;201308;833;2487;649;2209;160;598;245;848;405;1446
171886;201308;1438;4999;1323;4751;455;1710;450;1659;905;3369
171888;201308;641;2006;557;1852;110;384;338;1163;448;1547
171889;201308;464;1584;449;1544;86;268;281;1024;367;1292
171890;201308;1086;3717;988;3570;141;634;676;2386;817;3020
171900;201308;424;1688;405;1646;96;399;231;949;327;1348
172000;201308;642;2088;551;1957;89;386;339;1166;428;1552
172010;201308;1154;3992;1093;3880;114;456;859;3063;973;3519
172015;201308;350;1322;307;1257;62;248;180;788;242;1036
172020;201308;2279;7639;2053;7303;303;1187;1469;5277;1772;6464
172025;201308;709;2151;601;1956;103;375;356;1162;459;1537
172030;201308;1062;3706;977;3547;174;718;626;2284;800;3002
172049;201308;1090;3174;1026;3084;141;427;771;2344;912;2771
172065;201308;1145;3508;971;3287;140;545;742;2489;882;3034
172080;201308;2631;8200;2261;7576;314;1217;1515;4992;1829;6209
172085;201308;493;1390;392;1215;106;379;118;356;224;735
172090;201308;3325;10191;2634;9308;551;2108;1595;5762;2146;7870
172093;201308;565;1883;452;1675;187;786;171;611;358;1397
172097;201308;666;2017;565;1843;165;585;196;631;361;1216
172100;201308;24217;85379;21987;80782;7939;31670;6435;23713;14374;55383
172110;201308;1637;5979;1531;5827;149;544;1224;4807;1373;5351
172120;201308;5423;16487;4574;15404;480;1693;3554;12210;4034;13903
172125;201308;317;980;258;890;59;224;124;447;183;671
172130;201308;488;1462;437;1387;78;261;282;938;360;1199
172208;201308;2123;6720;2009;6529;442;1527;1129;3747;1571;5274
172210;201308;2246;6818;2144;6693;148;500;1891;5898;2039;6398
210005;201308;20522;68999;18816;66215;5902;21986;9430;33511;15332;55497
210010;201308;1595;5661;1444;5469;177;637;1129;4432;1306;5069
210015;201308;3392;10586;3147;10240;221;465;2707;9272;2928;9737
210020;201308;6961;18027;6558;17538;437;1354;5441;14709;5878;16063
210030;201308;5803;19656;5543;19293;449;1879;4656;16107;5105;17986
210040;201308;1914;5653;1750;5458;178;566;1389;4386;1567;4952
210043;201308;5677;17913;5429;17526;390;1338;4622;15066;5012;16404
210047;201308;6627;26281;6240;25588;945;4191;4257;17603;5202;21794
210050;201308;2475;8625;2016;8040;267;1096;1492;6061;1759;7157
210055;201308;1614;5677;1532;5563;199;689;1199;4434;1398;5123
210060;201308;7820;29102;7109;28012;831;3619;5299;21304;6130;24923
210070;201308;6524;20740;6278;20428;293;1054;5701;18634;5994;19688
210080;201308;3609;12482;3541;12378;97;388;3304;11585;3401;11973
210083;201308;3424;12664;3368;12590;251;923;2953;11188;3204;12111
210087;201308;2350;7787;2263;7677;194;702;1958;6646;2152;7348
210090;201308;9319;31343;9053;30899;537;1974;7886;27046;8423;29020
210095;201308;6066;23887;5952;23686;678;2730;4858;19655;5536;22385
210100;201308;7461;22397;7111;22003;280;1062;6475;20023;6755;21085
210110;201308;3124;10994;3029;10857;204;783;2560;9342;2764;10125
210120;201308;22774;72358;20216;68973;2200;7938;15479;53847;17679;61785
210125;201308;3246;11024;3139;10899;227;736;2759;9764;2986;10500
210130;201308;3487;10950;3408;10851;281;886;2887;9277;3168;10163
210135;201308;1607;4838;1443;4595;117;370;1212;3928;1329;4298
210140;201308;16209;53878;14074;51094;3140;11708;8945;33594;12085;45302
210150;201308;4350;11779;4085;11463;169;468;3732;10502;3901;10970
210160;201308;17758;59509;16719;57973;2327;7796;12914;46078;15241;53874
210170;201308;13711;51371;13501;51066;1027;3549;11822;45603;12849;49152
210173;201308;1729;7557;1683;7457;167;765;1424;6373;1591;7138
210177;201308;2832;9689;2687;9498;377;1464;2048;7206;2425;8670
210180;201308;1419;4532;1355;4429;115;391;1123;3685;1238;4076
210190;201308;5028;16589;4769;16145;384;1722;3727;12335;4111;14057
210193;201308;1406;4563;1319;4421;98;387;1089;3679;1187;4066
210197;201308;1671;6215;1601;6136;112;492;1412;5395;1524;5887
210200;201308;8868;30570;8259;29680;1297;4372;5923;22323;7220;26695
210203;201308;6030;20871;5682;20419;480;1584;4870;17881;5350;19465
210207;201308;2933;10035;2788;9782;398;1363;2075;7457;2473;8820
210210;201308;8492;29462;8232;29047;336;1277;7225;25924;7561;27201
210215;201308;1740;6982;1702;6924;165;730;1417;5801;1582;6531
210220;201308;6080;23924;5897;23619;490;1981;4835;19851;5325;21832
210230;201308;5276;18273;4938;17714;500;1847;3931;14284;4431;16131
210232;201308;10949;41605;10491;40885;2309;8891;7189;28938;9498;37829
210235;201308;3306;10717;3045;10374;219;778;2626;9020;2845;9798
210237;201308;2510;9128;2483;9090;46;110;2399;8895;2445;9005
210240;201308;2850;9278;2749;9122;273;821;2218;7551;2491;8372
210250;201308;4508;15231;4362;15053;160;608;4030;13998;4190;14606
210255;201308;2555;8578;2355;8241;604;2283;1378;4868;1982;7151
210260;201308;5115;16663;4766;16143;653;2110;3664;12731;4317;14841
210270;201308;5192;15220;4700;14564;184;639;4199;13134;4383;13773
210275;201308;3248;8675;3044;8455;99;258;2885;8062;2984;8320
210280;201308;5838;17345;5137;16469;376;1290;4377;14190;4753;15480
210290;201308;5804;18694;5376;18154;530;1752;4407;15209;4937;16961
210300;201308;34884;110197;30251;104074;3253;11957;24185;84665;27438;96622
210310;201308;2747;8161;2636;7979;137;428;2311;7025;2448;7453
210312;201308;1922;6616;1897;6577;143;566;1642;5694;1785;6260
210315;201308;2225;8140;2146;8015;102;452;1888;7062;1990;7514
210317;201308;4290;12998;4189;12879;160;454;3935;12192;4095;12646
210320;201308;18917;60642;17819;59335;1206;3982;15596;52904;16802;56886
210325;201308;3504;11343;3184;10856;357;1334;2478;8494;2835;9828
210330;201308;30621;86133;26451;81526;3940;10977;19470;64467;23410;75444
210340;201308;11692;37242;10786;36123;1330;3911;8293;29439;9623;33350
210350;201308;9814;32396;9320;31699;837;2930;7649;26486;8486;29416
210355;201308;3906;14190;3604;13814;134;358;3338;13134;3472;13492
210360;201308;16350;51493;15468;50188;1425;4844;12465;41145;13890;45989
210370;201308;7596;21925;6969;21248;289;867;6369;19673;6658;20540
210375;201308;3171;9928;2798;9484;481;1756;2055;7058;2536;8814
210380;201308;6049;18216;5506;17370;563;1641;4477;14443;5040;16084
210390;201308;2648;9797;2508;9567;101;454;2284;8740;2385;9194
210400;201308;4771;15629;4602;15410;411;1245;3927;13462;4338;14707
210405;201308;8434;24000;7012;22058;2126;6764;3296;11257;5422;18021
210407;201308;2061;7297;1864;6992;201;694;1441;5655;1642;6349
210408;201308;2050;8456;1963;8352;79;321;1799;7833;1878;8154
210409;201308;3830;13950;3656;13674;310;1181;2928;11245;3238;12426
210410;201308;3478;11357;3275;11094;360;1177;2729;9379;3089;10556
210420;201308;4040;13765;3815;13366;373;1273;3074;11002;3447;12275
210430;201308;1898;6243;1861;6196;150;515;1607;5401;1757;5916
210440;201308;4105;13238;4012;13092;211;716;3575;11771;3786;12487
210450;201308;2773;9036;2570;8722;230;858;2095;7108;2325;7966
210455;201308;4020;12310;3449;11405;656;2206;2266;7729;2922;9935
210460;201308;4056;13213;3856;12958;205;765;3379;11467;3584;12232
210462;201308;1748;6399;1698;6307;185;709;1303;4953;1488;5662
210465;201308;2714;9058;2570;8869;351;1031;2042;7369;2393;8400
210467;201308;5907;20458;5538;19948;482;1643;4624;17150;5106;18793
210470;201308;1749;5289;1528;4956;101;401;1224;3967;1325;4368
210480;201308;12961;45521;11732;43845;3209;12098;6801;26708;10010;38806
210490;201308;3242;10216;3035;9904;369;1260;2349;7719;2718;8979
210500;201308;6678;26403;6410;25922;741;2936;4999;20920;5740;23856
210510;201308;6519;22408;6396;22263;200;602;5905;21056;6105;21658
210515;201308;3557;11596;3500;11513;279;841;3056;10249;3335;11090
210520;201308;2621;8521;2486;8334;237;821;2032;6929;2269;7750
210530;201308;38863;132667;34437;125652;11324;44062;17138;63775;28462;107837
210535;201308;2986;10934;2929;10825;146;585;2603;9688;2749;10273
210540;201308;11712;42881;10696;41182;2424;9246;6327;25943;8751;35189
210542;201308;6298;18716;5561;17900;328;993;4924;16192;5252;17185
210545;201308;2154;7471;2068;7331;93;409;1799;6392;1892;6801
210547;201308;3384;12653;3233;12420;206;886;2733;10618;2939;11504
210550;201308;6159;18023;5366;17134;282;780;4844;15817;5126;16597
210560;201308;3756;12594;3522;12227;269;1070;2949;10208;3218;11278
210565;201308;1533;5294;1355;5024;125;559;1017;3760;1142;4319
210570;201308;12322;36698;11300;35499;1019;2855;9507;30803;10526;33658
210580;201308;2754;9072;2469;8695;287;959;1977;7130;2264;8089
210590;201308;4350;13786;4148;13539;256;869;3665;12111;3921;12980
210592;201308;2391;7773;2341;7693;110;424;2088;6836;2198;7260
210594;201308;2653;7885;2279;7409;148;512;1970;6478;2118;6990
210596;201308;2806;10772;2682;10540;350;1397;2000;7988;2350;9385
210598;201308;1994;6181;1897;6070;110;467;1720;5415;1830;5882
210600;201308;3246;9733;3039;9442;335;1087;2402;7470;2737;8557
210610;201308;2568;8301;2319;7997;279;996;1867;6482;2146;7478
210620;201308;1763;5560;1638;5393;53;147;1506;5016;1559;5163
210630;201308;3307;12477;2904;11660;547;2212;1723;7205;2270;9417
210632;201308;4727;16575;4374;16072;533;1964;3427;12800;3960;14764
210635;201308;1868;6918;1825;6853;70;225;1688;6453;1758;6678
210637;201308;2664;9238;2566;9097;141;525;2297;8222;2438;8747
210640;201308;4147;14014;4097;13947;30;95;3993;13665;4023;13760
210650;201308;6487;20307;6396;20183;247;754;5974;18992;6221;19746
210660;201308;7175;23190;6775;22550;293;882;6173;20679;6466;21561
210663;201308;2705;8218;2619;8121;56;158;2487;7822;2543;7980
210667;201308;1593;6087;1545;6018;107;471;1321;5194;1428;5665
210670;201308;4625;17757;4493;17516;432;1714;3604;14400;4036;16114
210675;201308;4671;13280;4466;13023;292;784;3896;11591;4188;12375
210680;201308;4290;12829;3899;12356;196;668;3451;10956;3647;11624
210690;201308;6606;23607;6366;23350;362;1315;5745;21280;6107;22595
210700;201308;2572;7379;2298;7058;193;383;1890;6310;2083;6693
210710;201308;4829;15875;4673;15632;178;560;4281;14454;4459;15014
210720;201308;2335;8938;2248;8816;153;642;1962;7721;2115;8363
210725;201308;1163;4357;1006;4071;135;599;635;2589;770;3188
210730;201308;1157;3741;1050;3623;97;305;889;3119;986;3424
210735;201308;3585;13650;3438;13376;648;2561;2392;9548;3040;12109
210740;201308;4757;13284;4465;12988;179;379;4146;12350;4325;12729
210745;201308;3445;11031;3323;10841;329;997;2690;8899;3019;9896
210750;201308;19473;55628;18009;53919;2229;6771;14433;43763;16662;50534
210760;201308;5764;15989;5516;15719;84;254;5360;15295;5444;15549
210770;201308;6032;16868;5218;15941;375;1183;4484;13774;4859;14957
210780;201308;8491;29458;7997;28548;1094;4210;5848;21126;6942;25336
210790;201308;4688;14263;4103;13614;314;811;3526;12228;3840;13039
210800;201308;4722;14316;4333;13897;198;743;3790;12475;3988;13218
210805;201308;3638;15771;3565;15628;199;890;3108;13898;3307;14788
210810;201308;5467;17254;4955;16666;525;1393;4171;14634;4696;16027
210820;201308;8805;25752;8356;25166;1396;4190;6005;18591;7401;22781
210825;201308;5384;18300;5270;18162;209;738;4806;16733;5015;17471
210830;201308;8034;26479;7761;26169;350;984;7215;24672;7565;25656
210840;201308;3689;10343;3401;9922;328;798;2689;7980;3017;8778
210845;201308;5380;17548;5200;17331;275;816;4622;15811;4897;16627
210850;201308;5737;21964;5436;21429;978;4294;3726;14709;4704;19003
210860;201308;16203;53022;15672;52245;1401;5019;13049;43610;14450;48629
210870;201308;6100;20513;5596;19833;764;2719;4120;14894;4884;17613
210880;201308;3785;12565;3731;12493;204;637;3385;11503;3589;12140
210890;201308;5248;16175;4934;15761;518;1754;4001;12783;4519;14537
210900;201308;4432;14987;4172;14530;1455;5164;1970;7153;3425;12317
210905;201308;1766;5646;1702;5561;109;286;1525;5103;1634;5389
210910;201308;10414;33420;9828;32502;1985;7037;6426;21405;8411;28442
210920;201308;3464;11617;3372;11494;139;398;3089;10736;3228;11134
210923;201308;1496;5669;1437;5569;200;824;1039;4165;1239;4989
210927;201308;4648;14947;4560;14859;40;107;4484;14669;4524;14776
210930;201308;2540;9413;2465;9303;200;906;2093;7865;2293;8771
210940;201308;2848;11399;2810;11327;317;1174;2273;9426;2590;10600
210945;201308;5759;17140;5573;16950;151;215;5364;16622;5515;16837
210950;201308;5405;17520;4818;16651;699;2464;3406;12119;4105;14583
210955;201308;1806;6248;1661;5989;280;1118;1139;4109;1419;5227
210960;201308;8928;30414;8660;29987;1928;6422;5911;21322;7839;27744
210970;201308;1343;5017;1207;4813;200;852;844;3438;1044;4290
210975;201308;1622;5955;1554;5820;154;658;1252;4683;1406;5341
210980;201308;8390;22188;8208;21972;352;887;7533;20305;7885;21192
210990;201308;14394;42676;12175;40179;1471;5003;9667;32164;11138;37167
211000;201308;15731;52399;14466;50747;1204;4426;12159;43265;13363;47691
211003;201308;5054;17996;4670;17401;740;2928;3246;12334;3986;15262
211010;201308;6528;22072;6374;21868;152;512;5967;20649;6119;21161
211020;201308;7249;22568;7183;22485;215;434;6867;21793;7082;22227
211023;201308;2341;8190;2258;8045;177;660;1895;6850;2072;7510
211027;201308;3026;11817;2892;11590;287;1076;2315;9629;2602;10705
211030;201308;4102;12919;3733;12488;823;2305;2682;9537;3505;11842
211040;201308;3997;15648;3908;15498;127;534;3532;14247;3659;14781
211050;201308;9689;27163;9561;27014;523;1372;8825;25126;9348;26498
211060;201308;5557;20989;5448;20765;574;1994;4494;17613;5068;19607
211065;201308;1651;5814;1518;5636;83;325;1375;5136;1458;5461
211070;201308;8452;29030;8085;28418;805;2925;6470;23099;7275;26024
211080;201308;1326;4239;1100;3927;91;445;904;3155;995;3600
211085;201308;1984;6794;1730;6463;313;1125;1286;4981;1599;6106
211090;201308;3430;11174;3261;10934;234;929;2743;9139;2977;10068
211100;201308;6416;17468;6284;17301;97;353;5949;16347;6046;16700
211102;201308;3068;11599;2975;11460;391;1444;2369;9386;2760;10830
211105;201308;2677;8722;2479;8467;167;621;2152;7359;2319;7980
211107;201308;4232;13497;4018;13223;149;478;3682;12257;3831;12735
211110;201308;6248;19400;5123;17951;869;2982;3503;12890;4372;15872
211120;201308;30295;86297;27024;81952;3583;10588;20177;63144;23760;73732
211125;201308;2062;6961;1929;6757;157;549;1599;5687;1756;6236
211130;201308;141124;427538;133732;418073;26249;81793;94137;301201;120386;382994
211140;201308;5609;18419;5382;18061;301;1115;4690;15754;4991;16869
211150;201308;9549;30626;9209;30190;741;2439;8001;26547;8742;28986
211153;201308;3180;9672;2914;9354;298;756;2413;8125;2711;8881
211157;201308;1208;4075;1040;3811;147;646;724;2712;871;3358
211160;201308;4081;14388;3603;13584;408;1786;2745;10365;3153;12151
211163;201308;1655;5550;1584;5456;65;247;1452;5014;1517;5261
211167;201308;1446;5023;1350;4864;59;252;1194;4301;1253;4553
211170;201308;6575;18084;6384;17851;156;551;5975;16624;6131;17175
211172;201308;2322;6962;2050;6536;185;699;1636;5125;1821;5824
211174;201308;2803;8488;2590;8214;134;549;2260;7102;2394;7651
211176;201308;5454;16256;4683;15355;519;1433;3781;12922;4300;14355
211178;201308;2887;9512;2823;9445;69;194;2691;9107;2760;9301
211180;201308;4177;15416;3943;15033;408;1720;3114;11929;3522;13649
211190;201308;2721;9429;2499;9109;144;624;2168;7942;2312;8566
211195;201308;1396;4552;1221;4340;123;442;985;3576;1108;4018
211200;201308;2074;7401;1880;7129;280;972;1362;5491;1642;6463
211210;201308;6713;22735;6548;22456;527;1863;5558;19257;6085;21120
211220;201308;34296;104696;30387;99496;7291;24629;18407;62149;25698;86778
211223;201308;5880;17098;5483;16443;711;2168;3833;12060;4544;14228
211227;201308;1488;5788;1455;5731;168;766;1133;4459;1301;5225
211230;201308;8705;30361;8146;29394;1405;5116;5626;20834;7031;25950
211240;201308;8338;28444;8136;28195;362;1322;7503;26128;7865;27450
211245;201308;4959;15706;4883;15608;221;626;4488;14568;4709;15194
211250;201308;11472;44274;10961;43667;1280;4246;9074;37743;10354;41989
211260;201308;7327;25249;7250;25120;366;1204;6642;23237;7008;24441
211270;201308;9785;35561;9365;35008;642;2707;7885;29787;8527;32494
211280;201308;11896;34572;11581;34203;1303;3131;9702;29834;11005;32965
211285;201308;1978;7097;1732;6640;420;1679;894;3617;1314;5296
211290;201308;7693;25460;7548;25291;548;1467;6669;22952;7217;24419
211300;201308;8279;26144;7495;24946;715;2504;6009;20147;6724;22651
211400;201308;12118;36663;10999;35382;2462;7873;6747;23650;9209;31523
220005;201308;1691;5054;1626;4954;61;283;1447;4279;1508;4562
220010;201308;1711;4592;1305;4087;143;541;1019;3126;1162;3667
220020;201308;3638;11389;3499;11141;631;2151;2369;7531;3000;9682
220025;201308;2108;5408;2010;5276;68;221;1814;4691;1882;4912
220027;201308;1361;3829;1276;3719;98;235;1095;3275;1193;3510
220030;201308;3256;10129;3196;10028;274;933;2696;8487;2970;9420
220040;201308;8233;26014;7891;25459;1484;5108;5062;16374;6546;21482
220045;201308;1425;4647;1302;4448;159;606;954;3228;1113;3834
220050;201308;4760;13819;4273;13155;356;1302;3504;10651;3860;11953
220060;201308;1973;5212;1882;5104;114;319;1675;4554;1789;4873
220070;201308;2545;7727;2281;7357;216;696;1831;6009;2047;6705
220080;201308;819;2590;773;2505;98;393;543;1688;641;2081
220090;201308;1705;4781;1538;4532;150;534;1203;3453;1353;3987
220095;201308;634;1877;617;1839;38;113;558;1655;596;1768
220100;201308;1396;4293;1222;4017;163;512;894;3026;1057;3538
220105;201308;2165;7291;2062;7097;223;804;1522;5268;1745;6072
220110;201308;3521;10374;3134;9821;302;1119;2532;7812;2834;8931
220115;201308;2169;8118;2090;7984;302;1202;1621;6259;1923;7461
220117;201308;1399;3795;1170;3460;93;313;927;2707;1020;3020
220120;201308;12159;36163;11420;35217;412;1553;10375;32006;10787;33559
220130;201308;774;2889;689;2776;67;194;588;2475;655;2669
220140;201308;1545;4230;1461;4129;271;621;1141;3384;1412;4005
220150;201308;7019;22785;6759;22410;468;1841;5757;18996;6225;20837
220155;201308;1035;3311;896;3048;87;373;630;2081;717;2454
220157;201308;1034;2774;958;2664;47;122;832;2336;879;2458
220160;201308;2806;8499;2536;8026;227;862;1921;6014;2148;6876
220170;201308;1237;4103;1180;3995;122;440;917;3136;1039;3576
220173;201308;2070;6357;1714;5670;86;396;1401;4556;1487;4952
220177;201308;1623;4945;1600;4909;87;276;1442;4439;1529;4715
220180;201308;1148;3183;1036;3008;80;280;794;2250;874;2530
220190;201308;4498;14993;3932;14262;485;1834;3016;11052;3501;12886
220191;201308;1406;4823;1353;4734;219;765;998;3517;1217;4282
220192;201308;1726;5141;1443;4670;181;561;1082;3571;1263;4132
220194;201308;1663;4902;1524;4646;199;677;1119;3320;1318;3997
220196;201308;1980;6041;1880;5875;222;808;1427;4406;1649;5214
220198;201308;1329;3669;1137;3412;42;134;1042;3152;1084;3286
220200;201308;4592;16023;4347;15628;763;2988;2968;10620;3731;13608
220202;201308;1991;6452;1830;6159;72;302;1615;5402;1687;5704
220205;201308;2790;7704;2494;7299;113;442;2179;6283;2292;6725
220207;201308;909;2824;799;2634;100;371;601;1972;701;2343
220208;201308;1594;5798;1514;5635;316;1315;960;3562;1276;4877
220209;201308;1541;4959;1424;4755;103;416;1100;3675;1203;4091
220210;201308;1846;4978;1623;4684;100;354;1289;3729;1389;4083
220211;201308;1625;4923;1545;4811;109;472;1269;3923;1378;4395
220213;201308;1775;5246;1668;5050;120;402;1321;3953;1441;4355
220217;201308;1776;5710;1727;5644;83;251;1554;5142;1637;5393
220220;201308;11355;33660;10635;32497;1443;4368;7633;23888;9076;28256
220225;201308;984;3083;950;3033;43;181;839;2642;882;2823
220230;201308;5916;15970;4915;14602;272;820;4294;12825;4566;13645
220240;201308;2640;8640;2546;8469;218;808;2019;6657;2237;7465
220245;201308;1400;3901;1327;3804;67;169;1188;3451;1255;3620
220250;201308;3335;9041;3042;8659;63;143;2859;8245;2922;8388
220253;201308;1822;5553;1597;5140;117;457;1187;3840;1304;4297
220255;201308;1722;5058;1538;4747;130;499;1227;3694;1357;4193
220260;201308;5175;16800;4750;16007;505;1956;3572;11978;4077;13934
220265;201308;1183;4399;1133;4314;100;473;851;3222;951;3695
220270;201308;6256;21960;6115;21701;432;1958;5179;18042;5611;20000
220271;201308;1392;4133;1351;4074;87;269;1168;3567;1255;3836
220272;201308;1756;5510;1642;5339;113;471;1303;4186;1416;4657
220273;201308;1261;3703;1121;3486;104;360;850;2616;954;2976
220275;201308;2041;5540;1761;5178;88;286;1525;4503;1613;4789
220277;201308;2509;7015;2160;6495;177;590;1651;5001;1828;5591
220280;201308;1756;4638;1542;4336;99;373;1254;3460;1353;3833
220285;201308;1649;4491;1493;4275;105;312;1232;3608;1337;3920
220290;201308;6533;21317;5553;20056;516;1928;4462;16374;4978;18302
220300;201308;1875;6186;1671;5913;96;433;1434;5067;1530;5500
220310;201308;2516;8247;2076;7720;112;356;1875;7144;1987;7500
220320;201308;3344;9983;2847;9158;412;1352;2063;6701;2475;8053
220323;201308;1399;5335;1293;5180;231;985;913;3680;1144;4665
220325;201308;1269;3987;1169;3800;166;583;772;2578;938;3161
220327;201308;1309;4285;1191;4075;91;418;964;3257;1055;3675
220330;201308;3578;10497;3429;10286;297;996;2869;8630;3166;9626
220335;201308;2026;5949;1820;5683;118;431;1573;4889;1691;5320
220340;201308;1750;5099;1574;4859;177;619;1211;3705;1388;4324
220342;201308;1208;3974;1145;3880;111;452;865;3007;976;3459
220345;201308;2835;8020;2427;7347;95;273;2097;6363;2192;6636
220350;201308;4428;12134;3914;11426;314;1017;3122;9096;3436;10113
220360;201308;1447;4033;1150;3562;125;422;831;2567;956;2989
220370;201308;8971;26295;8312;25451;451;1297;7517;23197;7968;24494
220375;201308;1513;4767;1416;4634;89;335;1250;4065;1339;4400
220380;201308;1302;3727;1136;3483;74;257;887;2725;961;2982
220385;201308;682;1909;617;1781;44;150;506;1402;550;1552
220390;201308;10235;32862;9456;31323;2232;7865;4992;16611;7224;24476
220400;201308;1433;3508;1307;3336;64;211;1135;2841;1199;3052
220410;201308;1379;4060;1187;3798;107;463;945;2925;1052;3388
220415;201308;858;2361;776;2244;92;255;576;1693;668;1948
220420;201308;2183;6490;2054;6254;153;480;1701;5192;1854;5672
220430;201308;2923;8732;2777;8537;434;1378;2022;6238;2456;7616
220435;201308;1582;4796;1504;4693;81;254;1293;4064;1374;4318
220440;201308;2786;8323;2305;7768;146;402;2046;7020;2192;7422
220450;201308;2702;8108;2358;7649;580;1939;1428;4700;2008;6639
220455;201308;1411;4385;1268;4181;57;193;1138;3788;1195;3981
220460;201308;1003;2843;952;2768;57;175;829;2402;886;2577
220465;201308;2413;8045;2264;7839;385;1432;1648;5766;2033;7198
220470;201308;3986;12250;3637;11620;255;951;2849;8974;3104;9925
220480;201308;2245;7001;2079;6744;163;552;1721;5592;1884;6144
220490;201308;2314;7041;2227;6923;132;493;1946;6010;2078;6503
220500;201308;3391;9326;2958;8621;215;819;2409;6827;2624;7646
220510;201308;2905;8204;2259;7274;104;462;1786;5724;1890;6186
220515;201308;1939;4926;1717;4643;84;243;1462;3956;1546;4199
220520;201308;4880;14116;4622;13744;255;732;4034;12124;4289;12856
220525;201308;1427;4150;1338;4024;103;372;1099;3253;1202;3625
220527;201308;1386;4500;1325;4367;132;416;1084;3622;1216;4038
220530;201308;1077;3265;1032;3193;134;495;821;2453;955;2948
220535;201308;853;2754;826;2712;73;309;664;2147;737;2456
220540;201308;3558;12051;3439;11849;290;1157;2798;9650;3088;10807
220545;201308;1394;4930;1342;4834;221;895;909;3236;1130;4131
220550;201308;8934;29937;8496;29119;1711;6179;5482;18884;7193;25063
220551;201308;1387;4883;1319;4758;135;573;1021;3633;1156;4206
220552;201308;1628;5140;1417;4794;139;637;1026;3325;1165;3962
220553;201308;1579;4813;1391;4530;73;275;1165;3767;1238;4042
220554;201308;924;2621;809;2461;124;388;568;1758;692;2146
220555;201308;2376;7163;2247;6980;103;361;1916;6045;2019;6406
220556;201308;1447;4670;1321;4428;102;428;992;3277;1094;3705
220557;201308;1579;5318;1448;5062;183;772;1018;3504;1201;4276
220558;201308;1013;3198;956;3097;89;338;770;2479;859;2817
220559;201308;1528;4402;1419;4243;85;291;1217;3626;1302;3917
220560;201308;1747;4412;1468;4021;86;253;1245;3385;1331;3638
220570;201308;7238;23511;6864;23042;722;2077;5734;19887;6456;21964
220580;201308;6387;21377;6219;21169;436;1457;5493;18954;5929;20411
220585;201308;1843;7099;1797;7011;129;515;1530;6031;1659;6546
220590;201308;1395;4442;1264;4245;227;801;832;2837;1059;3638
220595;201308;2434;7187;2267;6958;90;309;2044;6287;2134;6596
220600;201308;1284;3324;1116;3119;188;461;773;2260;961;2721
220605;201308;1989;6056;1805;5767;124;422;1424;4567;1548;4989
220610;201308;2605;8622;2530;8508;192;757;2127;7114;2319;7871
220620;201308;7727;26625;7515;26295;412;1646;6579;23042;6991;24688
220630;201308;382;1184;330;1094;83;292;169;569;252;861
220635;201308;1836;6641;1709;6344;166;736;1140;4219;1306;4955
220640;201308;2757;8276;2664;8134;279;961;2066;6308;2345;7269
220650;201308;2451;6944;2213;6574;139;478;1828;5411;1967;5889
220660;201308;2471;8548;2045;8022;158;633;1823;7203;1981;7836
220665;201308;1201;4194;1151;4114;60;250;998;3550;1058;3800
220667;201308;1754;5993;1666;5865;86;353;1437;5044;1523;5397
220669;201308;1863;6223;1740;5980;235;922;1240;4232;1475;5154
220670;201308;2098;6460;1996;6338;159;424;1739;5702;1898;6126
220672;201308;2158;6421;2110;6352;225;668;1767;5374;1992;6042
220675;201308;1324;3921;1243;3784;132;361;926;2878;1058;3239
220680;201308;2223;7432;2147;7325;135;495;1853;6366;1988;6861
220690;201308;1700;4973;1550;4720;132;498;1256;3768;1388;4266
220695;201308;855;2675;815;2607;66;220;634;2043;700;2263
220700;201308;8967;26632;8222;25520;795;2718;6451;20061;7246;22779
220710;201308;739;2257;650;2112;77;238;473;1563;550;1801
220720;201308;2099;5774;1993;5622;104;237;1771;5090;1875;5327
220730;201308;1331;3773;1208;3584;60;199;1020;3016;1080;3215
220735;201308;1018;2736;880;2512;90;280;649;1866;739;2146
220740;201308;1317;4444;1149;4216;128;431;926;3511;1054;3942
220750;201308;3904;11850;3724;11579;492;1430;2869;9216;3361;10646
220755;201308;1149;3505;1102;3431;68;206;962;3010;1030;3216
220760;201308;2579;9325;2408;9056;117;483;2105;7989;2222;8472
220770;201308;22863;80244;21629;77963;7503;28035;9438;35054;16941;63089
220775;201308;1139;2891;1128;2880;18;29;1104;2836;1122;2865
220777;201308;1664;4869;1592;4763;134;420;1302;3872;1436;4292
220779;201308;1121;3551;1099;3515;70;277;970;3077;1040;3354
220780;201308;6223;16497;5657;15751;509;1303;4671;13282;5180;14585
220785;201308;1276;3570;1233;3477;71;196;1103;3100;1174;3296
220790;201308;9053;30714;8839;30300;956;3620;7034;24066;7990;27686
220793;201308;877;2580;820;2482;70;242;666;1998;736;2240
220795;201308;1491;4311;1443;4237;114;347;1205;3574;1319;3921
220800;201308;16598;48490;15640;47018;1981;6950;11856;34877;13837;41827
220810;201308;3269;9755;2859;9009;254;996;2223;6883;2477;7879
220820;201308;5437;15916;5003;15342;351;1155;4247;13128;4598;14283
220830;201308;7652;22180;7352;21694;908;2650;5699;17122;6607;19772
220840;201308;14490;47526;13405;45357;3572;12353;6221;21820;9793;34173
220850;201308;2570;9666;2475;9517;351;1478;1868;7227;2219;8705
220855;201308;604;1968;561;1886;71;282;415;1377;486;1659
220860;201308;925;2658;867;2566;56;223;712;2059;768;2282
220865;201308;2637;7588;2237;6946;126;560;1826;5558;1952;6118
220870;201308;2370;7906;2085;7545;156;623;1772;6409;1928;7032
220880;201308;5295;14189;4874;13663;266;907;4263;11930;4529;12837
220885;201308;1326;4726;1179;4465;119;548;866;3278;985;3826
220887;201308;1242;3477;1112;3294;47;151;987;2939;1034;3090
220890;201308;1593;5765;1441;5518;118;434;1198;4723;1316;5157
220900;201308;1825;5659;1650;5246;128;394;1331;4292;1459;4686
220910;201308;1727;5071;1549;4794;81;280;1346;4195;1427;4475
220915;201308;1035;3054;929;2878;55;241;746;2246;801;2487
220920;201308;1275;4860;1220;4780;122;557;943;3688;1065;4245
220930;201308;1459;4799;1292;4581;118;486;1038;3702;1156;4188
220935;201308;1019;3225;926;3017;70;308;692;2151;762;2459
220937;201308;1505;4306;1317;3969;86;305;1051;3119;1137;3424
220940;201308;1459;4551;1367;4350;103;377;1095;3488;1198;3865
220945;201308;473;1746;441;1645;59;254;310;1149;369;1403
220950;201308;1243;3219;915;2648;47;191;690;1928;737;2119
220955;201308;1570;4453;1341;4096;152;515;1026;3123;1178;3638
220960;201308;791;2300;714;2167;74;292;542;1589;616;1881
220965;201308;1629;5103;1546;4984;76;309;1330;4274;1406;4583
220970;201308;2085;5763;1599;4981;196;604;1124;3573;1320;4177
220975;201308;473;1926;469;1917;61;235;385;1600;446;1835
220980;201308;1482;4505;1317;4210;130;480;899;2945;1029;3425
220985;201308;1350;3944;1295;3866;115;393;1025;3054;1140;3447
220987;201308;1463;4931;1385;4789;131;539;1053;3580;1184;4119
220990;201308;1788;5388;1610;5083;104;443;1289;4015;1393;4458
220995;201308;1143;3603;965;3296;82;339;758;2590;840;2929
220997;201308;2080;6702;2006;6584;146;496;1774;5819;1920;6315
221000;201308;4157;13294;3869;12784;469;1683;2862;9432;3331;11115
221005;201308;1389;4490;1322;4372;373;1176;751;2590;1124;3766
221010;201308;1239;3441;1103;3267;65;206;952;2839;1017;3045
221020;201308;1897;5990;1800;5816;137;608;1385;4359;1522;4967
221030;201308;1813;5044;1591;4721;87;349;1300;3802;1387;4151
221035;201308;1516;4227;1378;4051;99;293;1188;3536;1287;3829
221037;201308;636;1989;575;1881;36;159;467;1463;503;1622
221038;201308;614;1813;513;1646;46;158;357;1163;403;1321
221039;201308;898;2729;860;2672;65;225;746;2298;811;2523
221040;201308;5074;15947;4840;15560;423;1496;3815;12387;4238;13883
221050;201308;3605;11393;3347;11014;228;933;2853;9282;3081;10215
221060;201308;9025;24963;7846;23415;872;2681;6213;18696;7085;21377
221062;201308;1260;4466;1208;4394;35;106;1132;4140;1167;4246
221063;201308;1088;3609;1043;3531;357;1161;559;2016;916;3177
221065;201308;2630;8034;2516;7841;265;878;1972;6122;2237;7000
221070;201308;4362;13669;4013;13139;293;1107;3235;10578;3528;11685
221080;201308;3315;9515;3033;9138;256;826;2471;7502;2727;8328
221090;201308;1319;3703;1192;3518;72;285;1004;2900;1076;3185
221093;201308;1776;5405;1704;5271;250;901;1165;3522;1415;4423
221095;201308;959;2663;836;2489;43;118;743;2243;786;2361
221097;201308;787;2327;708;2196;65;250;545;1670;610;1920
221100;201308;120158;375476;114974;366808;25461;89918;74327;231596;99788;321514
221110;201308;9383;32940;9225;32687;729;2993;7756;27355;8485;30348
221120;201308;4076;14055;3949;13820;1225;4156;2250;8278;3475;12434
221130;201308;4590;13970;4117;13010;999;3296;2318;7264;3317;10560
221135;201308;1432;4641;1348;4509;189;715;967;3211;1156;3926
221140;201308;1381;3564;1280;3431;169;368;995;2765;1164;3133
221150;201308;1217;3223;1045;2910;33;135;843;2332;876;2467
221160;201308;901;2480;859;2414;61;190;668;1887;729;2077
221170;201308;1088;3634;1051;3559;84;334;868;2910;952;3244
230010;201308;3266;9309;2826;8588;180;624;2267;6949;2447;7573
230015;201308;2920;10285;2718;9853;491;2056;1728;6165;2219;8221
230020;201308;13816;47397;13349;46464;1298;4886;10531;36878;11829;41764
230030;201308;12087;37131;11537;36209;1173;4008;9133;28699;10306;32707
230040;201308;4478;13073;3842;11943;378;1340;2965;9157;3343;10497
230050;201308;2535;8838;2211;8026;419;1702;1184;4309;1603;6011
230060;201308;1933;6000;1749;5633;190;719;1296;4134;1486;4853
230070;201308;4599;12887;4111;12202;397;1264;3136;9503;3533;10767
230075;201308;8542;33003;8181;32257;1098;4948;6009;23725;7107;28673
230080;201308;2309;6614;1987;6148;123;452;1636;5040;1759;5492
230090;201308;3226;10376;2959;9879;347;1352;2228;7315;2575;8667
230100;201308;16474;53172;15520;51436;4677;16345;7530;25300;12207;41645
230110;201308;13753;46727;12917;44915;2576;9757;7877;27352;10453;37109
230120;201308;7618;21870;6937;20954;822;2804;5191;15659;6013;18463
230125;201308;2818;8543;2376;7679;200;770;1795;5768;1995;6538
230130;201308;5741;19378;4846;17369;477;2035;3411;12090;3888;14125
230140;201308;3291;11227;2960;10636;500;1880;1933;7095;2433;8975
230150;201308;1719;5605;1522;5203;296;1183;957;3113;1253;4296
230160;201308;6141;19203;5474;18202;594;2182;4113;13721;4707;15903
230170;201308;6354;20931;5589;19520;559;2240;4048;14010;4607;16250
230180;201308;1892;5629;1699;5286;147;564;1211;3725;1358;4289
230185;201308;4061;14038;3798;13515;721;2627;2380;8723;3101;11350
230190;201308;12192;41170;11247;39255;2125;8443;6657;23012;8782;31455
230195;201308;4763;15352;4356;14706;404;1737;3357;10964;3761;12701
230200;201308;5551;16680;5023;15648;707;2316;3523;10974;4230;13290
230205;201308;4307;14170;3880;13437;424;1737;2807;9788;3231;11525
230210;201308;8958;26747;8097;25411;1980;6373;4605;14941;6585;21314
230220;201308;13341;41071;12471;39607;2108;7521;8402;26315;10510;33836
230230;201308;7159;24614;6488;23138;1140;4273;3944;14246;5084;18519
230240;201308;12974;39299;11870;37219;878;3393;9281;28607;10159;32000
230250;201308;10163;31735;9931;31376;576;2104;8465;26716;9041;28820
230260;201308;14605;51136;13636;49082;3288;12585;7095;26173;10383;38758
230270;201308;6862;21504;6192;20354;708;2596;4614;15248;5322;17844
230280;201308;19737;61769;18425;59571;2525;8880;13693;44268;16218;53148
230290;201308;5055;16023;4462;14833;620;2189;3040;10169;3660;12358
230300;201308;4591;14888;4424;14641;561;2107;3324;10980;3885;13087
230310;201308;4841;14869;4319;14004;413;1651;3281;10458;3694;12109
230320;201308;7192;24003;6804;23307;874;3351;4978;17109;5852;20460
230330;201308;4596;14193;4210;13431;442;1629;3076;9646;3518;11275
230340;201308;3317;11904;3156;11538;531;2204;2003;7162;2534;9366
230350;201308;17743;55834;16059;52854;3216;11361;9804;32608;13020;43969
230360;201308;2865;8875;2603;8410;292;1096;1997;6384;2289;7480
230365;201308;2855;8748;2535;8205;229;892;1886;6073;2115;6965
230370;201308;52356;180070;49103;174551;15100;56024;24494;89856;39594;145880
230380;201308;6991;20694;6058;19109;597;2205;4306;13555;4903;15760
230390;201308;3602;11720;3240;11117;456;1857;2196;7457;2652;9314
230393;201308;3303;11348;2909;10511;306;1484;2049;7165;2355;8649
230395;201308;4855;15876;4565;15304;654;2605;3130;10363;3784;12968
230400;201308;5001;16147;4449;15386;434;1895;3560;12073;3994;13968
230410;201308;15872;51259;14393;48533;2468;9038;9018;30472;11486;39510
230420;201308;23379;80369;22223;78016;5809;22287;11451;39924;17260;62211
230423;201308;4741;15941;4397;15318;538;2066;3093;10901;3631;12967
230425;201308;5256;18327;4949;17656;745;2905;3435;12224;4180;15129
230426;201308;2770;7962;2377;7261;158;656;1819;5421;1977;6077
230427;201308;1732;5395;1309;4414;144;551;855;2790;999;3341
230428;201308;8837;29850;8636;29493;1812;6951;5539;18637;7351;25588
230430;201308;4517;15009;4295;14559;432;1789;3161;10541;3593;12330
230435;201308;4723;16218;4311;15483;1127;4402;2110;7822;3237;12224
230440;201308;350027;1116457;332647;1084699;87948;309872;169719;553029;257667;862901
230445;201308;4637;13086;4063;12276;406;1218;3054;9459;3460;10677
230450;201308;3597;11857;3100;10944;496;1954;1967;6980;2463;8934
230460;201308;1868;6354;1739;6102;198;762;1279;4511;1477;5273
230465;201308;4032;12747;3364;11472;360;1502;2230;7483;2590;8985
230470;201308;10853;40966;10526;40322;1512;6204;7611;29687;9123;35891
230480;201308;1436;4760;1289;4475;232;852;840;2935;1072;3787
230490;201308;2937;8800;2609;8205;454;1612;1447;4552;1901;6164
230495;201308;5648;19375;5146;18537;988;4161;3068;11038;4056;15199
230500;201308;10625;36834;10169;36092;886;3275;8114;29452;9000;32727
230510;201308;1464;5432;1281;4966;364;1505;566;2269;930;3774
230520;201308;4958;15514;4355;14432;510;1951;3023;9984;3533;11935
230523;201308;12920;44585;12076;42676;3796;14853;3658;13073;7454;27926
230526;201308;4010;12970;3544;12116;471;1790;2422;8351;2893;10141
230530;201308;5038;17316;4692;16817;987;3548;3092;11307;4079;14855
230533;201308;3711;11292;3496;10872;305;1100;2721;8408;3026;9508
230535;201308;5297;16260;4703;15167;503;1769;3461;11280;3964;13049
230540;201308;18371;54547;16653;52040;1272;4671;13677;42411;14949;47082
230550;201308;19988;61956;18436;58996;4404;15291;10116;32283;14520;47574
230560;201308;6597;19614;6051;18585;358;1403;4824;14658;5182;16061
230565;201308;3415;10162;2960;9286;306;1135;2066;6410;2372;7545
230570;201308;3873;10872;3500;10395;250;931;2887;8462;3137;9393
230580;201308;10105;32035;9753;31545;582;2017;8520;27759;9102;29776
230590;201308;9397;30925;8779;29815;844;3535;6577;21900;7421;25435
230600;201308;3600;10451;2880;8979;328;1175;1902;5868;2230;7043
230610;201308;5942;20167;5581;19573;855;3297;3966;13992;4821;17289
230620;201308;1987;5825;1714;5275;187;678;1115;3337;1302;4015
230625;201308;7315;25006;6712;23616;1889;7264;2630;9219;4519;16483
230630;201308;10856;36741;10049;35058;2119;7375;5660;20494;7779;27869
230640;201308;25398;88503;24335;86808;4116;15499;16947;61195;21063;76694
230650;201308;4855;16033;4495;15329;434;1853;3430;11478;3864;13331
230655;201308;8319;32518;8063;32087;887;3531;6592;26724;7479;30255
230660;201308;6258;20176;5534;18844;606;2453;3961;13560;4567;16013
230670;201308;5854;16439;4842;14683;301;1110;3818;11358;4119;12468
230680;201308;2866;8711;2485;8022;448;1610;1495;4808;1943;6418
230690;201308;6588;22145;6335;21672;596;2551;4548;15212;5144;17763
230700;201308;9040;27061;8039;25200;962;3670;5423;16528;6385;20198
230710;201308;7262;24593;6691;23448;905;3252;4799;17165;5704;20417
230720;201308;1904;6129;1640;5615;237;877;1095;3783;1332;4660
230725;201308;3800;12879;3528;12284;614;2433;2300;7880;2914;10313
230730;201308;55993;175030;48237;163050;12541;46139;24696;84814;37237;130953
230740;201308;5028;16861;4927;16661;360;1562;4114;13724;4474;15286
230750;201308;8776;26268;7576;24259;789;3028;5646;17938;6435;20966
230760;201308;9702;30921;9457;30365;1404;5502;6788;20797;8192;26299
230763;201308;4146;13333;3931;12913;344;1567;3018;9505;3362;11072
230765;201308;43048;144856;40617;139836;13905;50779;14946;52442;28851;103221
230770;201308;22292;65000;21231;63357;1717;6397;16898;49657;18615;56054
230780;201308;5895;23954;5666;23413;1315;5536;3195;13869;4510;19405
230790;201308;2491;8735;2402;8588;300;1166;1884;6798;2184;7964
230800;201308;7707;28790;7173;27580;1764;7448;3550;13664;5314;21112
230810;201308;12236;40963;11776;40173;1457;5322;8956;30901;10413;36223
230820;201308;3334;11603;2985;10840;653;2629;1618;5919;2271;8548
230830;201308;7645;23822;6992;22664;740;2856;5096;16416;5836;19272
230835;201308;4073;11431;3524;10703;327;1086;2759;8393;3086;9479
230837;201308;3131;10988;2733;10170;402;1690;1793;6693;2195;8383
230840;201308;9160;31351;8416;30005;1556;5872;5290;19326;6846;25198
230850;201308;11052;34713;10522;34032;1367;4964;7909;25506;9276;30470
230860;201308;5002;15463;4600;14638;434;1649;3444;10798;3878;12447
230870;201308;18521;53156;16852;50276;1910;6486;12573;37207;14483;43693
230880;201308;1904;6754;1787;6517;278;1145;1176;4289;1454;5434
230890;201308;4084;15206;3823;14669;523;2392;2705;10217;3228;12609
230900;201308;2996;10268;2657;9548;462;1766;1589;5724;2051;7490
230910;201308;2944;9131;2438;8134;279;1114;1706;5578;1985;6692
230920;201308;4575;13844;4238;13415;350;1182;3456;11103;3806;12285
230930;201308;7606;23947;7001;22820;941;3308;4900;16068;5841;19376
230940;201308;7530;21678;6726;20510;344;1040;5781;17859;6125;18899
230945;201308;6090;18754;5315;17728;662;2342;3822;12969;4484;15311
230950;201308;6784;19215;5939;18092;397;1390;4678;14226;5075;15616
230960;201308;11791;39207;11012;37600;2690;10106;5352;18183;8042;28289
230970;201308;12971;43002;12006;41060;2667;10432;6307;21102;8974;31534
230980;201308;2755;9437;2574;9050;750;2713;1281;4652;2031;7365
230990;201308;1565;5085;1325;4572;179;746;852;2844;1031;3590
231000;201308;2807;7814;2301;6859;262;939;1554;4501;1816;5440
231010;201308;2883;8696;2573;8219;336;1317;1841;5752;2177;7069
231020;201308;7833;26624;7431;25796;1395;5145;4757;16798;6152;21943
231025;201308;7618;24783;6940;23633;908;3215;4974;17304;5882;20519
231030;201308;7819;26607;6711;24232;1314;5014;4048;14806;5362;19820
231040;201308;2929;10153;2687;9622;325;1392;1851;6518;2176;7910
231050;201308;11668;35284;10504;33140;1140;4046;7650;24163;8790;28209
231060;201308;2363;7688;2196;7397;211;963;1653;5392;1864;6355
231070;201308;8975;29358;8499;28463;1480;5362;5564;18757;7044;24119
231080;201308;4166;13531;3859;12946;315;1444;2854;9185;3169;10629
231085;201308;4583;15235;4440;14968;726;2683;3235;10937;3961;13620
231090;201308;4114;11839;3502;10607;241;902;2637;7865;2878;8767
231095;201308;2145;7289;1895;6797;227;885;1335;4831;1562;5716
231100;201308;3033;9595;2551;8626;243;958;1856;6234;2099;7192
231110;201308;3707;12704;3607;12520;421;1577;2642;9230;3063;10807
231120;201308;2416;8079;2254;7790;391;1431;1492;5183;1883;6614
231123;201308;2169;6211;1894;5773;149;487;1508;4614;1657;5101
231126;201308;6613;18820;5521;17303;488;1758;4322;13408;4810;15166
231130;201308;19752;63934;18248;61246;4820;17073;9550;33101;14370;50174
231135;201308;4546;13803;3899;12793;393;1508;2861;9288;3254;10796
231140;201308;15177;50873;14406;49367;1659;7504;10288;33989;11947;41493
231150;201308;5797;17438;4979;15831;1048;3702;2583;8030;3631;11732
231160;201308;5789;20230;5559;19781;1613;5981;3110;11077;4723;17058
231170;201308;4667;15291;4390;14757;540;2226;3066;10142;3606;12368
231180;201308;14168;45191;13249;43361;2704;9836;8071;25960;10775;35796
231190;201308;4986;14176;4195;13019;396;1405;3250;9965;3646;11370
231195;201308;4594;16122;4017;14990;429;1888;3015;11286;3444;13174
231200;201308;7449;26931;6841;25745;827;3727;4972;18585;5799;22312
231210;201308;4900;15779;4277;14858;346;1498;3258;11378;3604;12876
231220;201308;13890;40765;11888;37359;1359;5003;7727;24322;9086;29325
231230;201308;9448;34470;8943;33470;1273;5257;6344;23817;7617;29074
231240;201308;11453;37362;10497;35678;1456;5573;7102;24382;8558;29955
231250;201308;2058;6101;1427;4542;282;945;608;1829;890;2774
231260;201308;4030;11589;3676;11100;503;1615;2550;7851;3053;9466
231270;201308;7459;21960;6883;21070;766;2997;5008;14936;5774;17933
231280;201308;1702;5773;1613;5583;170;626;1201;4193;1371;4819
231290;201308;32295;118044;29936;112075;8168;33524;12700;46620;20868;80144
231300;201308;4441;13426;3732;11943;395;1549;2667;8226;3062;9775
231310;201308;7151;21613;6319;19918;1424;4718;3385;10639;4809;15357
231320;201308;6954;21962;6218;20550;472;1861;4754;15642;5226;17503
231325;201308;2532;7988;2292;7546;213;780;1718;5688;1931;6468
231330;201308;13934;44082;11840;40016;2070;7179;7328;25045;9398;32224
231335;201308;4951;14690;4449;13765;356;1407;3554;10753;3910;12160
231340;201308;17496;58598;16564;57233;1593;5329;13313;47268;14906;52597
231350;201308;12013;41845;11820;41538;1438;4889;9545;34288;10983;39177
231355;201308;4319;14161;4190;13954;235;764;3671;12410;3906;13174
231360;201308;6750;23126;6404;22593;1563;5413;3882;14295;5445;19708
231370;201308;2317;6873;1909;6277;147;582;1447;4681;1594;5263
231375;201308;3985;14108;3795;13737;452;1985;2875;10240;3327;12225
231380;201308;5231;17236;4927;16810;865;3168;3375;11727;4240;14895
231390;201308;3328;10812;3177;10609;244;995;2617;8717;2861;9712
231395;201308;4163;13719;3754;13067;810;2967;2278;8105;3088;11072
231400;201308;10209;31333;9395;29884;1082;4024;6660;21176;7742;25200
231410;201308;14546;49081;13237;47251;1534;5519;9798;36174;11332;41693
240010;201308;2360;7569;2153;7096;585;2165;951;3023;1536;5188
240020;201308;11645;37276;10482;35059;2927;10551;4774;16303;7701;26854
240030;201308;2720;8213;2625;8062;292;1113;1984;5932;2276;7045
240040;201308;786;2391;679;2176;51;243;493;1489;544;1732
240050;201308;3465;9938;3145;9388;255;950;2390;6976;2645;7926
240060;201308;1417;4310;1356;4206;138;532;1025;3060;1163;3592
240070;201308;2743;8036;2625;7807;404;1314;1742;5092;2146;6406
240080;201308;2989;8210;2775;7888;262;739;2227;6418;2489;7157
240090;201308;2172;6133;1886;5567;85;350;1479;4268;1564;4618
240100;201308;9958;29735;9340;28486;1273;4659;5880;17804;7153;22463
240110;201308;5078;15712;4647;14985;965;3519;2830;8812;3795;12331
240120;201308;2935;9905;2856;9758;627;2308;1758;6125;2385;8433
240130;201308;2674;7608;2327;7061;212;781;1792;5360;2004;6141
240140;201308;2211;7041;2035;6722;476;1769;1070;3485;1546;5254
240145;201308;6129;19389;5572;18384;1555;5716;2875;9449;4430;15165
240150;201308;1004;3126;829;2768;127;527;486;1552;613;2079
240160;201308;1442;4821;1319;4605;164;654;913;3199;1077;3853
240165;201308;868;2885;792;2742;103;391;529;1849;632;2240
240170;201308;2537;7822;2309;7395;603;2056;1165;3798;1768;5854
240180;201308;2908;9360;2747;9096;690;2396;1507;5167;2197;7563
240185;201308;1484;5004;1436;4925;191;683;1054;3647;1245;4330
240190;201308;905;2821;871;2760;122;496;608;1865;730;2361
240200;201308;13626;36559;11671;34110;2353;7019;7332;22230;9685;29249
240210;201308;2683;7805;2497;7560;245;878;2042;6089;2287;6967
240220;201308;7331;23698;7107;23418;337;1364;6413;21015;6750;22379
240230;201308;5287;15585;4970;15011;495;1769;3821;11357;4316;13126
240240;201308;1718;5509;1336;4470;411;1489;309;935;720;2424
240250;201308;2813;8223;2663;7989;212;794;2131;6243;2343;7037
240260;201308;14566;49980;13928;48903;2452;9860;9177;32072;11629;41932
240270;201308;2314;7812;2206;7631;265;931;1644;5798;1909;6729
240280;201308;1606;4676;1439;4364;144;523;1032;3084;1176;3607
240290;201308;1416;4522;1215;4143;117;562;792;2575;909;3137
240300;201308;2010;5638;1677;5054;355;1179;857;2520;1212;3699
240310;201308;10102;29184;9307;27932;2305;7591;4892;14531;7197;22122
240320;201308;2016;6141;1718;5526;135;601;1190;3657;1325;4258
240325;201308;35675;101789;28901;90290;8817;30287;10035;31612;18852;61899
240330;201308;1522;4663;1293;4200;169;678;773;2395;942;3073
240340;201308;1574;4837;1422;4627;291;1031;896;2903;1187;3934
240350;201308;2034;6394;1943;6235;300;1132;1469;4589;1769;5721
240360;201308;7127;22116;6319;20875;1041;3719;4249;14373;5290;18092
240370;201308;1933;5435;1729;5114;136;489;1313;3873;1449;4362
240375;201308;869;2335;781;2212;145;479;452;1222;597;1701
240380;201308;2589;7853;2230;7110;359;1181;1348;4297;1707;5478
240390;201308;885;2595;742;2308;82;315;486;1494;568;1809
240400;201308;1431;3920;1257;3676;137;509;955;2718;1092;3227
240410;201308;528;1718;478;1608;73;292;311;1030;384;1322
240420;201308;4821;18498;4658;18129;1347;5312;2471;10143;3818;15455
240430;201308;3422;10052;3175;9617;385;1332;2256;6740;2641;8072
240440;201308;2626;7294;2468;6998;640;1818;1305;3768;1945;5586
240450;201308;3682;11347;3405;10837;557;2105;2093;6606;2650;8711
240460;201308;2771;9293;2704;9172;306;1228;2080;7001;2386;8229
240470;201308;3759;11567;3190;10430;569;2067;1793;5884;2362;7951
240480;201308;350;935;334;913;40;106;250;702;290;808
240485;201308;2106;6424;1873;5971;338;1197;1122;3576;1460;4773
240490;201308;1644;4293;1463;4043;89;344;1162;3095;1251;3439
240500;201308;1996;6251;1937;6152;184;664;1522;4836;1706;5500
240510;201308;1769;5496;1651;5271;258;878;1160;3724;1418;4602
240520;201308;1427;4256;1263;4019;231;839;849;2646;1080;3485
240530;201308;2143;7031;1954;6721;282;1060;1353;4641;1635;5701
240540;201308;1836;5643;1749;5496;171;612;1320;4096;1491;4708
240550;201308;728;2167;680;2084;51;205;535;1596;586;1801
240560;201308;3165;9426;3031;9217;284;961;2472;7490;2756;8451
240570;201308;3076;8920;2552;7751;586;2018;1132;3150;1718;5168
240580;201308;7942;25110;7557;24485;1362;4635;5364;17389;6726;22024
240590;201308;829;2393;749;2258;56;220;546;1605;602;1825
240600;201308;1457;4460;1209;3931;211;787;667;2059;878;2846
240610;201308;5013;14182;4455;13176;486;1628;3129;9105;3615;10733
240615;201308;1008;2953;880;2717;146;458;524;1632;670;2090
240620;201308;1568;5371;1487;5212;307;1156;1022;3598;1329;4754
240630;201308;1992;6278;1908;6135;167;527;1488;4943;1655;5470
240640;201308;852;2644;748;2479;94;421;497;1569;591;1990
240650;201308;3650;11497;3415;11179;320;1208;2751;8966;3071;10174
240660;201308;2445;8044;2351;7894;287;1057;1769;5999;2056;7056
240670;201308;2719;8266;2359;7531;375;1396;1382;4301;1757;5697
240680;201308;1475;4401;1199;3882;159;539;736;2403;895;2942
240690;201308;1071;3096;950;2898;108;389;682;2065;790;2454
240700;201308;2598;7966;2190;7168;152;675;1676;5316;1828;5991
240710;201308;18249;46354;16260;43909;2990;8185;10273;28617;13263;36802
240720;201308;5452;16154;5217;15781;1331;4433;2983;8979;4314;13412
240725;201308;1066;3226;834;2708;94;310;459;1468;553;1778
240730;201308;2248;7102;2035;6692;207;777;1421;4609;1628;5386
240740;201308;2245;6838;2025;6439;257;904;1357;4288;1614;5192
240750;201308;2166;8175;2007;7877;455;1914;1148;4579;1603;6493
240760;201308;1165;3636;1112;3556;108;306;896;2976;1004;3282
240770;201308;3469;10364;3204;9957;436;1512;2234;6941;2670;8453
240780;201308;5584;16526;4717;15083;956;3224;2597;8531;3553;11755
240790;201308;837;2687;709;2460;59;230;536;1859;595;2089
240800;201308;38548;114758;35911;110051;10543;34634;15711;48762;26254;83396
240810;201308;92247;283369;87439;274364;29334;95740;39327;125648;68661;221388
240820;201308;6704;20350;5875;19013;1008;3651;3421;11346;4429;14997
240830;201308;9179;28579;8744;27946;835;2809;7083;23006;7918;25815
240840;201308;1262;3607;1104;3328;106;391;710;2112;816;2503
240850;201308;1130;3539;888;3033;171;671;467;1501;638;2172
240860;201308;1278;3708;1106;3432;96;354;805;2454;901;2808
240870;201308;1101;3170;969;2916;127;492;658;1850;785;2342
240880;201308;1136;3962;1084;3885;153;671;762;2684;915;3355
240890;201308;5426;15444;4856;14491;800;2735;2872;8463;3672;11198
240895;201308;2745;9495;2523;9100;387;1497;1755;6403;2142;7900
240910;201308;2488;8260;2354;8004;270;1098;1771;5981;2041;7079
240920;201308;840;2768;783;2629;198;751;410;1340;608;2091
240930;201308;3529;9764;3231;9356;312;971;2548;7441;2860;8412
240933;201308;1348;4275;1240;4092;308;1094;630;2156;938;3250
240940;201308;6465;18690;5556;17122;1185;3863;2988;9204;4173;13067
240950;201308;1120;3607;1059;3502;100;420;776;2569;876;2989
240960;201308;764;2475;699;2342;104;394;491;1637;595;2031
240970;201308;1988;5770;1705;5256;162;613;1192;3634;1354;4247
240980;201308;3318;11042;3105;10632;748;2787;1809;6176;2557;8963
240990;201308;3031;9223;2860;8869;610;2122;1775;5365;2385;7487
241000;201308;1046;3017;929;2811;99;379;684;2014;783;2393
241010;201308;2907;9941;2639;9450;444;1820;1725;6062;2169;7882
241020;201308;2054;5934;1719;5289;182;673;1071;3144;1253;3817
241025;201308;1500;4704;1409;4541;145;602;985;3115;1130;3717
241030;201308;2509;8386;2323;8059;170;643;1890;6595;2060;7238
241040;201308;2084;7387;1922;7064;213;917;1438;5279;1651;6196
241050;201308;1272;3883;1163;3689;109;448;875;2676;984;3124
241060;201308;991;2889;907;2746;120;382;682;2079;802;2461
241070;201308;908;2681;784;2446;100;375;544;1642;644;2017
241080;201308;1163;3551;1047;3343;89;369;744;2309;833;2678
241090;201308;2087;6080;1837;5649;130;555;1504;4530;1634;5085
241100;201308;1162;3547;1060;3313;106;393;743;2272;849;2665
241105;201308;1113;3435;1053;3328;161;557;698;2257;859;2814
241110;201308;839;2732;718;2473;121;488;393;1324;514;1812
241120;201308;8000;24259;7324;23186;1440;4662;4912;15930;6352;20592
241140;201308;3223;9499;2937;8924;415;1383;1970;5884;2385;7267
241142;201308;696;2110;515;1719;157;606;135;405;292;1011
241150;201308;5582;17252;5212;16630;873;2961;3505;11241;4378;14202
241160;201308;1103;3250;1042;3130;172;574;703;2100;875;2674
241170;201308;1330;3970;1215;3756;160;565;766;2451;926;3016
241180;201308;1016;2783;823;2449;104;356;493;1414;597;1770
241190;201308;1029;2898;943;2756;88;347;651;1787;739;2134
241200;201308;19905;61534;18620;59431;4997;17233;9689;31355;14686;48588
241210;201308;1447;4420;1258;4045;261;928;677;2167;938;3095
241220;201308;7919;27219;7584;26567;1816;6808;4237;15163;6053;21971
241230;201308;2959;9336;2719;8974;249;999;2163;7097;2412;8096
241240;201308;1125;3273;867;2733;88;281;528;1700;616;1981
241250;201308;5474;17835;4927;16755;397;1793;4004;13353;4401;15146
241255;201308;1864;7194;1784;7018;456;1875;890;3646;1346;5521
241260;201308;4582;12994;3815;11729;390;1424;2649;8022;3039;9446
241270;201308;2003;6158;1791;5746;278;1019;1084;3521;1362;4540
241280;201308;2120;6257;1975;5970;389;1224;1224;3762;1613;4986
241290;201308;3218;9081;2640;8169;493;1662;1559;4798;2052;6460
241300;201308;1333;3959;1237;3813;81;292;984;3033;1065;3325
241310;201308;1476;4847;1429;4765;209;699;1045;3580;1254;4279
241320;201308;850;2883;811;2802;166;634;455;1585;621;2219
241330;201308;1494;4819;1415;4710;158;632;1138;3741;1296;4373
241335;201308;2486;7915;2409;7775;207;649;2019;6574;2226;7223
241340;201308;1910;6038;1743;5691;469;1683;851;2714;1320;4397
241350;201308;1905;6171;1795;5945;180;753;1365;4400;1545;5153
241355;201308;1224;3471;1109;3261;76;248;939;2725;1015;2973
241360;201308;2070;5841;1877;5465;156;582;1375;3825;1531;4407
241370;201308;1321;4166;1092;3682;203;802;629;2059;832;2861
241380;201308;702;2085;613;1904;91;349;337;1018;428;1367
241390;201308;2819;9678;2683;9409;712;2549;1527;5547;2239;8096
241400;201308;3709;11286;3532;11027;488;1737;2595;8100;3083;9837
241410;201308;2602;7903;2414;7629;450;1574;1635;5107;2085;6681
241415;201308;1559;4954;1442;4718;152;582;1032;3338;1184;3920
241420;201308;2063;7377;1873;7086;575;2422;886;3360;1461;5782
241430;201308;422;1307;403;1255;50;170;279;837;329;1007
241440;201308;6518;23564;6157;22922;1138;4419;4222;15944;5360;20363
241445;201308;1006;3208;957;3137;173;485;700;2452;873;2937
241450;201308;3185;9185;2979;8879;488;1663;2107;6184;2595;7847
241460;201308;3460;10290;3086;9549;297;1128;2227;6760;2524;7888
241470;201308;1334;3860;1171;3657;135;550;880;2652;1015;3202
241475;201308;1217;3890;1065;3595;76;338;774;2542;850;2880
241480;201308;3181;10496;2925;10103;970;3467;1140;4290;2110;7757
241490;201308;622;1719;510;1543;57;236;349;991;406;1227
241500;201308;749;2398;735;2377;19;72;689;2226;708;2298
250010;201308;2615;8492;2345;8042;256;1088;1679;5615;1935;6703
250020;201308;1663;4888;1307;4222;126;530;913;2868;1039;3398
250030;201308;7601;22402;6887;21389;872;2886;5118;16220;5990;19106
250040;201308;4388;15134;4085;14551;781;2988;2621;9398;3402;12386
250050;201308;3532;11492;3274;11124;561;2112;2198;7508;2759;9620
250053;201308;1247;3890;1201;3829;181;644;834;2645;1015;3289
250057;201308;759;2563;738;2535;72;246;600;2123;672;2369
250060;201308;4673;15356;4539;15132;634;2461;3428;11184;4062;13645
250070;201308;4162;13097;3929;12681;466;1911;3031;9449;3497;11360
250073;201308;767;2353;701;2231;82;305;490;1559;572;1864
250077;201308;2209;6575;1848;5967;289;1015;1048;3410;1337;4425
250080;201308;4671;13825;4509;13586;610;1974;3301;9927;3911;11901
250090;201308;2573;7902;2502;7793;151;603;2117;6437;2268;7040
250100;201308;3896;13433;3736;13142;448;1781;2866;10042;3314;11823
250110;201308;5642;17576;5396;17219;886;3116;3938;12518;4824;15634
250115;201308;553;1845;484;1681;59;270;301;984;360;1254
250120;201308;2190;6562;1902;6014;201;754;1363;4248;1564;5002
250130;201308;5433;17140;5122;16682;357;1293;4252;13964;4609;15257
250135;201308;1062;3288;973;3129;123;425;682;2230;805;2655
250140;201308;1990;6646;1842;6455;246;858;1390;5008;1636;5866
250150;201308;5025;17199;4674;16566;539;2177;3499;12368;4038;14545
250153;201308;1572;4174;1418;3946;130;445;1121;3087;1251;3532
250157;201308;1590;5636;1454;5336;359;1328;798;3039;1157;4367
250160;201308;3255;10349;3124;10144;225;847;2672;8649;2897;9496
250170;201308;1587;4708;1495;4555;327;1059;928;2862;1255;3921
250180;201308;16032;51376;15628;50606;2892;10653;10403;32853;13295;43506
250190;201308;4271;12755;3989;12264;728;2432;2451;7484;3179;9916
250200;201308;2189;6118;1776;5592;137;511;1500;4675;1637;5186
250205;201308;1001;3361;876;3137;92;435;614;2170;706;2605
250210;201308;1619;5395;1498;5212;200;867;1063;3593;1263;4460
250215;201308;1396;4867;1354;4784;207;838;859;3028;1066;3866
250220;201308;815;2324;688;2172;49;170;594;1866;643;2036
250230;201308;1684;4363;1383;3867;200;641;1025;2779;1225;3420
250240;201308;2589;8533;2311;8120;256;962;1731;6166;1987;7128
250250;201308;4346;13599;4028;13147;475;1657;3129;10298;3604;11955
250260;201308;1892;5920;1681;5569;137;525;1281;4245;1418;4770
250270;201308;1230;4016;1151;3917;162;582;867;2966;1029;3548
250280;201308;3747;11395;3473;10956;758;2489;2137;6984;2895;9473
250290;201308;2129;5688;1766;5209;59;222;1549;4558;1608;4780
250300;201308;5393;16094;5100;15715;632;2528;3975;11761;4607;14289
250310;201308;1133;3720;1039;3565;163;661;747;2532;910;3193
250320;201308;7578;24408;7211;23589;1301;4783;4561;14507;5862;19290
250330;201308;2475;7932;2169;7493;265;1076;1644;5589;1909;6665
250340;201308;1129;3349;1090;3300;71;255;895;2729;966;2984
250350;201308;4527;12524;4155;12057;211;710;3597;10549;3808;11259
250355;201308;2117;6543;1932;6255;134;560;1533;4929;1667;5489
250360;201308;2015;6059;1876;5853;126;473;1460;4569;1586;5042
250370;201308;13546;38478;11931;36518;797;2489;10400;32139;11197;34628
250375;201308;1077;3450;1027;3365;71;299;853;2778;924;3077
250380;201308;1619;4655;1547;4566;108;385;1335;3908;1443;4293
250390;201308;1957;5319;1627;4758;216;699;1097;3202;1313;3901
250400;201308;62268;180506;57490;173666;14890;47087;31762;98418;46652;145505
250403;201308;1432;4918;1400;4872;166;670;1118;3844;1284;4514
250407;201308;1062;3210;954;3017;85;271;739;2326;824;2597
250410;201308;653;2141;574;2000;72;312;426;1461;498;1773
250415;201308;1798;5797;1665;5518;103;446;1275;4134;1378;4580
250420;201308;1298;4129;1212;3986;102;416;1004;3231;1106;3647
250430;201308;6498;18418;6166;17935;500;1798;5080;14463;5580;16261
250435;201308;1606;4953;1445;4636;186;694;886;2911;1072;3605
250440;201308;4426;13542;4270;13314;287;1055;3636;11311;3923;12366
250450;201308;2050;5879;1840;5599;89;336;1642;4967;1731;5303
250460;201308;5986;18689;5613;18161;856;2975;4069;13307;4925;16282
250470;201308;1572;4383;1430;4179;142;504;1055;3024;1197;3528
250480;201308;3839;11719;3468;11167;175;714;3007;9599;3182;10313
250485;201308;599;1629;503;1456;27;113;397;1097;424;1210
250490;201308;4072;13482;3967;13312;625;2306;2895;9708;3520;12014
250500;201308;1899;5883;1762;5653;358;1206;1066;3462;1424;4668
250510;201308;4920;13966;4341;13159;337;1249;3555;10656;3892;11905
250520;201308;1838;5807;1745;5642;361;1384;1039;3254;1400;4638
250523;201308;1767;5713;1686;5605;214;773;1310;4406;1524;5179
250527;201308;1432;4446;1342;4318;66;298;1191;3769;1257;4067
250530;201308;671;2099;596;2001;54;213;483;1617;537;1830
250535;201308;1240;4084;1199;4001;98;401;961;3143;1059;3544
250540;201308;2445;7250;2290;7073;97;340;2090;6462;2187;6802
250550;201308;906;3053;837;2942;76;331;627;2159;703;2490
250560;201308;1714;5644;1676;5586;140;516;1416;4736;1556;5252
250570;201308;2505;8364;2285;7945;213;870;1725;5920;1938;6790
250580;201308;1095;3167;913;2857;140;551;598;1786;738;2337
250590;201308;1034;3211;931;3066;82;354;731;2353;813;2707
250600;201308;7549;22863;7164;22253;1096;3455;5161;16383;6257;19838
250610;201308;3244;10080;3065;9806;412;1416;2234;7197;2646;8613
250620;201308;861;2547;794;2413;137;455;528;1593;665;2048
250625;201308;2033;6896;1997;6843;77;244;1836;6358;1913;6602
250630;201308;10076;33162;9596;32279;2285;8327;5334;17886;7619;26213
250640;201308;3862;11439;3612;11139;263;1028;3108;9438;3371;10466
250650;201308;889;2693;840;2597;167;615;440;1401;607;2016
250660;201308;2189;5273;1681;4658;26;71;1607;4462;1633;4533
250670;201308;2595;9074;2482;8855;291;1228;1786;6363;2077;7591
250680;201308;4866;14244;4605;13859;302;1105;3895;11645;4197;12750
250690;201308;6136;17175;5950;16915;635;2090;4940;13812;5575;15902
250700;201308;5259;16154;4968;15700;705;2513;3578;11153;4283;13666
250710;201308;4458;14578;4125;14145;625;2265;2936;10285;3561;12550
250720;201308;2590;8123;2475;7919;213;847;1955;6180;2168;7027
250730;201308;3532;11353;3386;11112;482;1802;2484;8090;2966;9892
250740;201308;2017;6129;1777;5691;259;928;1205;3807;1464;4735
250750;201308;99743;301817;94930;294276;19232;65692;61119;187000;80351;252692
250760;201308;2131;6619;1989;6377;266;1026;1378;4362;1644;5388
250770;201308;3737;13209;3553;12947;747;2860;2219;8207;2966;11067
250780;201308;1878;5755;1651;5326;178;719;1149;3614;1327;4333
250790;201308;2436;8070;2309;7881;619;2114;1419;4954;2038;7068
250800;201308;2655;7886;2356;7379;179;671;1763;5388;1942;6059
250810;201308;1333;4024;1168;3780;120;500;940;2962;1060;3462
250820;201308;1958;6222;1905;6138;110;414;1595;5201;1705;5615
250830;201308;5794;19497;5533;18987;750;3071;3761;12630;4511;15701
250840;201308;1036;3354;931;3134;125;477;589;1978;714;2455
250850;201308;2345;6986;2054;6500;238;934;1345;4386;1583;5320
250855;201308;1040;3115;984;3024;68;246;822;2487;890;2733
250860;201308;2858;9879;2667;9502;662;2587;1170;4191;1832;6778
250870;201308;1177;3438;1029;3195;85;332;746;2245;831;2577
250880;201308;1284;3916;1255;3873;122;410;1011;3098;1133;3508
250890;201308;9045;30099;8437;29247;1654;6605;5343;18308;6997;24913
250900;201308;3007;10215;2692;9608;325;1229;1900;6893;2225;8122
250905;201308;2098;6574;2007;6451;329;1123;1467;4734;1796;5857
250910;201308;5275;15683;4934;15155;579;1923;3673;11309;4252;13232
250915;201308;1713;5149;1576;4950;142;436;1309;4187;1451;4623
250920;201308;3514;10164;3321;9889;443;1345;2417;7388;2860;8733
250930;201308;1903;6310;1832;6187;375;1464;1215;4015;1590;5479
250933;201308;1136;3830;1098;3768;182;666;734;2563;916;3229
250937;201308;861;2708;775;2529;122;488;462;1489;584;1977
250939;201308;1697;5414;1546;5157;265;950;1003;3358;1268;4308
250940;201308;3908;11680;3626;11231;300;1078;2832;8741;3132;9819
250950;201308;1319;4225;1232;4115;81;283;1021;3457;1102;3740
250960;201308;1346;4263;1196;4065;76;296;1019;3490;1095;3786
250970;201308;8585;24149;7852;23196;1136;3466;5679;16973;6815;20439
250980;201308;2655;8200;2453;7846;280;1139;1687;5187;1967;6326
250990;201308;2048;7338;1938;7117;305;1289;1318;4764;1623;6053
251000;201308;2538;7336;2094;6698;137;533;1682;5352;1819;5885
251010;201308;2800;8239;2559;7900;231;829;2013;6227;2244;7056
251020;201308;1652;5239;1540;5102;170;624;1252;4176;1422;4800
251030;201308;1297;3719;1181;3524;134;478;761;2265;895;2743
251040;201308;1940;6287;1753;5990;190;897;1251;4090;1441;4987
251050;201308;1122;3378;985;3126;165;569;543;1793;708;2362
251060;201308;1005;2566;833;2353;98;361;629;1690;727;2051
251065;201308;573;1742;504;1634;74;278;307;953;381;1231
251070;201308;586;1722;560;1681;50;208;439;1243;489;1451
251080;201308;21121;59473;19971;57603;5351;16427;11180;32590;16531;49017
251090;201308;3013;9653;2730;9135;325;1248;1944;6435;2269;7683
251100;201308;966;3233;856;3030;131;531;555;1908;686;2439
251110;201308;2080;6121;1899;5841;223;769;1336;4103;1559;4872
251120;201308;5865;20204;5709;19935;818;3382;4431;15139;5249;18521
251130;201308;3868;10187;3500;9767;66;243;3351;9292;3417;9535
251140;201308;4327;13575;4046;13126;281;1143;3156;10177;3437;11320
251150;201308;2820;9258;2606;8966;329;1325;1952;6767;2281;8092
251160;201308;1844;6166;1775;6074;106;425;1551;5307;1657;5732
251170;201308;1421;4474;1383;4430;124;471;1152;3635;1276;4106
251180;201308;2882;8765;2659;8482;646;2176;1556;5059;2202;7235
251190;201308;4198;12391;4078;12239;300;974;3559;10715;3859;11689
251200;201308;4206;12959;4008;12695;261;948;3458;10966;3719;11914
251203;201308;1307;4208;1186;3955;123;512;722;2491;845;3003
251207;201308;1224;3915;1061;3589;94;401;747;2475;841;2876
251210;201308;7820;22939;7016;21835;1108;3465;4973;15820;6081;19285
251220;201308;1276;3527;1150;3332;178;564;727;2158;905;2722
251230;201308;5114;15829;4524;15126;473;1781;3773;12546;4246;14327
251240;201308;3093;10333;3017;10206;328;1360;2367;7865;2695;9225
251250;201308;10112;31353;9520;30396;1716;5924;6507;20687;8223;26611
251260;201308;535;1674;485;1607;39;146;369;1227;408;1373
251270;201308;4088;12816;3863;12518;166;665;3518;11367;3684;12032
251272;201308;1360;4236;1272;4105;118;410;1007;3297;1125;3707
251274;201308;971;3144;922;3044;132;551;517;1746;649;2297
251275;201308;1355;3919;1281;3800;151;561;956;2749;1107;3310
251276;201308;1477;4476;1398;4324;236;789;827;2655;1063;3444
251278;201308;579;1896;510;1732;91;350;277;986;368;1336
251280;201308;2265;7346;2191;7212;318;1170;1586;5223;1904;6393
251290;201308;5944;17390;5652;17011;861;3083;4061;11857;4922;14940
251300;201308;777;2685;723;2603;73;347;516;1799;589;2146
251310;201308;3146;9472;2893;9091;240;903;2326;7224;2566;8127
251315;201308;1615;5932;1577;5846;321;1279;976;3648;1297;4927
251320;201308;2105;6028;1768;5482;146;550;1292;4036;1438;4586
251330;201308;2028;5323;1691;4885;139;585;1389;3817;1528;4402
251335;201308;964;3382;934;3324;117;462;720;2546;837;3008
251340;201308;3880;10916;3313;10070;361;1392;2353;6963;2714;8355
251350;201308;1615;5056;1465;4837;266;970;945;3139;1211;4109
251360;201308;1809;6007;1750;5932;124;495;1485;5050;1609;5545
251365;201308;902;2681;728;2309;70;283;481;1479;551;1762
251370;201308;21179;74277;20841;73671;4403;17038;13985;48852;18388;65890
251380;201308;1321;4172;1181;3932;114;503;891;2868;1005;3371
251385;201308;859;2448;786;2321;84;308;533;1524;617;1832
251390;201308;5685;20535;5407;20111;1044;4219;3639;13456;4683;17675
251392;201308;1029;3101;958;2980;125;420;660;2085;785;2505
251394;201308;611;1910;516;1720;44;175;367;1214;411;1389
251396;201308;867;2528;807;2426;68;233;638;1890;706;2123
251398;201308;1118;3288;931;2935;96;373;629;1950;725;2323
251400;201308;1346;3954;1249;3826;174;673;875;2604;1049;3277
251410;201308;1577;4235;1444;4016;182;573;969;2750;1151;3323
251420;201308;2184;6384;1876;6031;192;734;1406;4462;1598;5196
251430;201308;1685;6134;1537;5897;125;552;1259;4836;1384;5388
251440;201308;1452;4512;1263;4157;176;667;893;2910;1069;3577
251445;201308;1519;4866;1449;4759;135;537;1187;3845;1322;4382
251450;201308;4762;15105;4283;14496;168;693;3766;12774;3934;13467
251455;201308;1208;3791;1045;3523;97;412;765;2536;862;2948
251460;201308;874;2781;851;2733;158;521;623;2030;781;2551
251465;201308;502;1604;459;1518;54;218;298;956;352;1174
251470;201308;1292;3753;1073;3351;153;581;630;1959;783;2540
251480;201308;1121;3104;1019;2935;65;249;817;2305;882;2554
251490;201308;2072;6216;1814;5866;337;1258;1146;3635;1483;4893
251500;201308;1675;5768;1629;5695;225;899;1211;4191;1436;5090
251510;201308;2471;8494;2331;8192;476;1833;1388;4923;1864;6756
251520;201308;1076;3022;988;2883;135;405;603;1793;738;2198
251530;201308;11525;34907;11087;34258;963;3704;9189;27873;10152;31577
251540;201308;2791;9397;2629;9043;313;1330;1897;6457;2210;7787
251550;201308;3949;10096;3370;9356;211;747;2795;7595;3006;8342
251560;201308;913;2754;832;2625;174;663;445;1298;619;1961
251570;201308;1029;3119;915;2911;119;448;576;1871;695;2319
251580;201308;2182;6072;2030;5867;254;717;1595;4673;1849;5390
251590;201308;1681;5630;1650;5594;111;403;1448;4957;1559;5360
251593;201308;992;3224;946;3146;145;550;625;2027;770;2577
251597;201308;1959;6122;1894;6023;233;872;1474;4608;1707;5480
251600;201308;7111;21610;6803;21107;1026;3257;4849;15477;5875;18734
251610;201308;3552;10881;3264;10496;384;1332;2443;7948;2827;9280
251615;201308;1202;3562;1059;3312;86;255;787;2592;873;2847
251620;201308;16876;49218;15142;46942;2474;8130;10655;33441;13129;41571
251630;201308;5326;13699;4683;12921;397;1195;3751;10416;4148;11611
251640;201308;2652;7846;2174;6980;282;1052;1465;4666;1747;5718
251650;201308;4339;12462;3915;11923;340;1185;3181;9793;3521;10978
251660;201308;3529;11999;3251;11562;278;1315;2623;9106;2901;10421
251670;201308;3879;11425;3482;10831;247;872;2867;8854;3114;9726
251675;201308;740;2548;710;2495;137;559;456;1559;593;2118
251680;201308;2836;7987;2318;7211;144;610;1889;5756;2033;6366
251690;201308;3322;10691;3106;10299;456;1649;2094;6943;2550;8592
251700;201308;2056;6954;1964;6824;241;927;1528;5282;1769;6209
251710;201308;923;2469;705;2080;99;372;384;1049;483;1421
251720;201308;1342;4227;1265;4111;122;481;980;3164;1102;3645
251740;201308;734;2080;597;1830;116;389;329;1024;445;1413
260005;201308;24303;60832;21820;57598;4591;12494;13828;36800;18419;49294
260010;201308;9404;26099;7730;24021;737;2549;6127;18996;6864;21545
260020;201308;5697;17251;5108;16339;684;2102;3679;12320;4363;14422
260030;201308;5325;16242;4957;15722;550;1917;3824;12084;4374;14001
260040;201308;9904;24308;8419;22619;606;1453;7038;19475;7644;20928
260050;201308;10631;35207;10025;34515;685;2540;8752;30403;9437;32943
260060;201308;4036;11397;3778;11007;324;1005;3079;9090;3403;10095
260070;201308;9156;28433;8780;27892;2328;7945;5161;16469;7489;24414
260080;201308;5255;15612;4715;14798;582;2121;3309;10267;3891;12388
260090;201308;5156;14131;4903;13788;845;2178;3628;10617;4473;12795
260100;201308;3460;9371;3186;9004;257;949;2547;7202;2804;8151
260105;201308;4259;13215;4135;12990;811;2698;2732;8559;3543;11257
260110;201308;21033;64225;19665;62570;1634;5162;16666;53730;18300;58892
260120;201308;11266;35567;10947;34993;3205;10539;5546;18453;8751;28992
260130;201308;3075;8927;2934;8692;408;1187;2132;6462;2540;7649
260140;201308;12589;34076;11034;32129;1315;4321;8312;24401;9627;28722
260150;201308;2940;9012;2657;8576;274;985;2007;6577;2281;7562
260160;201308;5896;18014;5381;17408;499;1731;4418;14561;4917;16292
260170;201308;17088;48409;16448;47542;1448;3971;13632;40103;15080;44074
260180;201308;3355;10673;3099;10273;209;858;2591;8521;2800;9379
260190;201308;15594;38205;14884;37290;1126;3086;12641;31585;13767;34671
260200;201308;10784;32670;9591;30863;1288;4249;6865;22743;8153;26992
260210;201308;11245;35732;10461;34582;834;3100;8625;28836;9459;31936
260220;201308;8914;28728;8724;28444;777;3168;7388;23646;8165;26814
260230;201308;9563;28876;9213;28400;702;2288;7645;23916;8347;26204
260240;201308;2793;9113;2527;8707;384;1437;1731;5990;2115;7427
260250;201308;2738;7458;2523;7189;183;511;2134;6162;2317;6673
260260;201308;11272;33670;11085;33434;942;3152;9280;28534;10222;31686
260270;201308;3479;10853;3294;10579;407;1567;2562;8078;2969;9645
260280;201308;12255;42028;11372;40617;847;3427;9393;33869;10240;37296
260290;201308;33059;102036;32100;100506;5910;21118;22038;67437;27948;88555
260300;201308;8374;25913;7554;24750;769;2888;5830;19240;6599;22128
260310;201308;5073;15554;4772;15079;1476;4417;2411;8186;3887;12603
260320;201308;6574;22809;6165;22207;580;2258;4917;17921;5497;20179
260330;201308;3083;9757;2826;9312;292;1131;1898;6484;2190;7615
260340;201308;1841;5584;1765;5481;113;426;1548;4764;1661;5190
260345;201308;25329;85329;24456;83575;7729;28713;11337;37513;19066;66226
260350;201308;4270;12851;4096;12583;580;1982;2881;8846;3461;10828
260360;201308;2292;7411;2222;7292;589;2039;1199;4073;1788;6112
260370;201308;5979;18832;5539;18046;840;2809;3883;12960;4723;15769
260380;201308;4843;16307;4542;15920;430;1408;3751;13458;4181;14866
260390;201308;4716;15046;4126;14118;508;1993;2992;10082;3500;12075
260392;201308;3200;10666;3046;10450;195;767;2637;9053;2832;9820
260400;201308;13346;40402;12913;39700;2638;9020;8613;25990;11251;35010
260410;201308;61121;183701;58370;179109;19298;59656;28057;89320;47355;148976
260415;201308;4000;13322;3583;12556;585;2384;2242;7835;2827;10219
260420;201308;11414;27184;10476;26184;855;2446;8627;21491;9482;23937
260430;201308;2696;9149;2482;8805;264;1082;1887;6617;2151;7699
260440;201308;3388;10625;3177;10214;558;2026;1947;6175;2505;8201
260450;201308;4841;15429;4606;15018;508;1818;3508;11494;4016;13312
260460;201308;5853;18314;5586;17920;881;3234;3886;12258;4767;15492
260470;201308;4946;14746;4668;14354;475;1592;3657;11449;4132;13041
260480;201308;3763;11209;3446;10738;687;2325;2288;7070;2975;9395
260490;201308;6032;16041;5334;14944;750;2478;3519;9859;4269;12337
260500;201308;6636;18614;6210;18007;635;1956;4758;14078;5393;16034
260510;201308;10002;27495;9288;26498;952;2952;7099;20872;8051;23824
260515;201308;4728;15126;3915;13459;571;2152;2299;8072;2870;10224
260520;201308;15331;42375;14991;41922;2767;7353;10803;31114;13570;38467
260530;201308;10163;30523;9022;29008;532;1603;7855;25756;8387;27359
260540;201308;5675;14954;5428;14677;687;1611;4291;11993;4978;13604
260545;201308;40;156;28;115;4;19;6;23;10;42
260550;201308;2749;9459;2488;8981;705;2827;1175;4198;1880;7025
260560;201308;6669;17487;6063;16633;364;995;5302;14599;5666;15594
260570;201308;6120;21924;5772;21279;1074;4368;3889;14384;4963;18752
260580;201308;3891;10911;3714;10650;333;1083;3084;8702;3417;9785
260590;201308;5992;15911;5791;15663;427;1101;5022;13853;5449;14954
260600;201308;24803;79484;23657;77481;5087;17552;14339;47827;19426;65379
260610;201308;7029;21196;6724;20782;1333;4312;4660;14525;5993;18837
260620;201308;16871;53619;16319;52692;3099;11336;10900;34304;13999;45640
260630;201308;2262;6942;1979;6492;250;989;1446;4691;1696;5680
260640;201308;17054;47595;16314;46523;2191;6744;12224;34823;14415;41567
260650;201308;5612;17980;5389;17612;832;2727;3523;12328;4355;15055
260660;201308;7970;23337;7230;22345;736;2369;5769;18088;6505;20457
260670;201308;2379;6918;2036;6445;307;1082;1345;4307;1652;5389
260680;201308;22843;62777;21729;60981;4866;14637;12781;35524;17647;50161
260690;201308;3464;9796;3029;9096;248;908;2381;7069;2629;7977
260700;201308;5236;16031;5181;15973;102;238;4981;15551;5083;15789
260710;201308;1294;4065;1174;3886;152;602;866;2802;1018;3404
260720;201308;17238;57321;16412;55770;4703;16427;8717;30373;13420;46800
260730;201308;7307;24392;6599;23354;907;3349;4885;17537;5792;20886
260740;201308;1355;4167;1189;3863;185;658;722;2382;907;3040
260750;201308;6662;22142;6444;21816;577;1955;5367;18497;5944;20452
260760;201308;4591;13127;4320;12760;550;1732;3197;9513;3747;11245
260765;201308;7655;28422;7421;28053;1624;6713;4700;17931;6324;24644
260770;201308;4230;11176;3883;10708;249;908;3125;8415;3374;9323
260775;201308;5264;15569;5034;15204;595;2150;3713;10928;4308;13078
260780;201308;3921;13215;3788;12981;884;3280;2244;7703;3128;10983
260790;201308;116815;307237;112808;301457;26859;75601;68493;183333;95352;258934
260795;201308;2984;9840;2831;9605;478;1723;1910;6617;2388;8340
260800;201308;4598;12815;4306;12414;254;1012;3683;10334;3937;11346
260805;201308;4033;12075;3693;11539;596;1951;2493;7862;3089;9813
260810;201308;7362;21505;7167;21233;481;1733;6243;18302;6724;20035
260820;201308;4513;13530;4306;13234;1280;3988;2352;7379;3632;11367
260825;201308;3013;9870;2865;9649;293;996;2335;7966;2628;8962
260830;201308;3591;11967;3371;11584;916;3006;1925;6981;2841;9987
260840;201308;4093;12273;3849;11912;239;912;3350;10304;3589;11216
260845;201308;4125;12507;3844;11942;678;2246;2590;8070;3268;10316
260850;201308;4805;17053;4434;16253;1179;4828;2162;7826;3341;12654
260860;201308;2935;9893;2746;9592;358;1267;2013;7176;2371;8443
260870;201308;4156;11727;3792;11262;597;1668;2716;8313;3313;9981
260875;201308;7274;19624;6686;18721;907;2567;4626;13373;5533;15940
260880;201308;8468;27636;8092;27072;1108;3715;6182;21039;7290;24754
260890;201308;14706;42643;14132;41783;1645;5573;10632;31368;12277;36941
260900;201308;5996;18897;5236;17629;1077;3765;3129;10784;4206;14549
260910;201308;2945;9316;2680;8929;302;1170;2078;6863;2380;8033
260915;201308;4435;14984;4331;14839;112;338;4036;14069;4148;14407
260920;201308;3275;10440;3134;10228;555;1967;2153;7165;2708;9132
260930;201308;4097;13321;3693;12735;553;1947;2642;9259;3195;11206
260940;201308;13518;39808;12492;37986;2543;9150;6966;20569;9509;29719
260950;201308;6171;20323;5951;19902;1043;4350;3890;12207;4933;16557
260960;201308;66434;188507;63154;183310;13812;42747;37346;109266;51158;152013
260970;201308;5270;17426;4933;16884;677;2729;3534;11959;4211;14688
260980;201308;3938;12713;3781;12499;270;1017;3156;10591;3426;11608
260990;201308;16859;55219;15597;53446;2255;7347;11307;40788;13562;48135
261000;201308;14510;43147;12393;39568;2886;9962;6755;21853;9641;31815
261010;201308;2774;7855;2601;7620;253;582;2153;6637;2406;7219
261020;201308;6125;18737;5697;18080;440;1801;4639;14306;5079;16107
261030;201308;3331;11238;3211;11033;344;1296;2557;8732;2901;10028
261040;201308;5228;17388;4560;16337;646;2625;3210;11458;3856;14083
261050;201308;8702;24804;8168;23966;1281;3926;5417;15826;6698;19752
261060;201308;10946;34956;10621;34430;2132;7509;7168;22962;9300;30471
261070;201308;47194;125910;43415;120670;10456;30592;24769;69710;35225;100302
261080;201308;5581;17474;5321;17047;457;1439;4411;14392;4868;15831
261090;201308;15836;45356;14933;44123;1582;4895;11998;35692;13580;40587
261100;201308;7226;23637;6798;22983;577;2353;5502;18507;6079;20860
261110;201308;65208;189592;60095;182274;14632;45276;34500;110419;49132;155695
261120;201308;3467;9651;3238;9353;162;487;2856;8331;3018;8818
261130;201308;6878;18098;6616;17809;288;801;6034;16237;6322;17038
261140;201308;3181;9171;2988;8869;652;2142;1819;5343;2471;7485
261150;201308;5369;16677;4885;16008;535;2037;3762;12350;4297;14387
261153;201308;1949;5676;1676;5301;114;433;1413;4492;1527;4925
261160;201308;221719;587223;213026;575604;43430;119833;136819;379537;180249;499370
261170;201308;5858;16776;5507;16252;803;2479;4158;12309;4961;14788
261180;201308;9054;26316;8886;26095;1116;3257;7044;21037;8160;24294
261190;201308;5262;17010;5045;16710;810;3578;3513;10926;4323;14504
261200;201308;3769;9886;3616;9687;500;1317;2722;7438;3222;8755
261210;201308;1872;5179;1798;5076;150;413;1529;4385;1679;4798
261220;201308;12211;41064;10927;38199;2242;8564;5975;20752;8217;29316
261230;201308;4306;13140;4014;12794;203;642;3572;11534;3775;12176
261240;201308;4794;14469;4556;14024;817;2467;3142;9871;3959;12338
261245;201308;3789;12320;3313;11523;305;1296;2430;8545;2735;9841
261247;201308;3458;11028;3061;10290;470;1656;2061;7022;2531;8678
261250;201308;18790;51351;18299;50664;2691;7735;14454;40045;17145;47780
261255;201308;4240;13457;3835;12794;390;1465;2903;9838;3293;11303
261260;201308;11803;35066;10955;34069;636;1848;9711;30666;10347;32514
261270;201308;3781;11014;3550;10646;507;1652;2491;7467;2998;9119
261280;201308;2699;8537;2456;8169;277;1073;1824;6024;2101;7097
261290;201308;2894;8503;2609;8132;240;858;2105;6627;2345;7485
261300;201308;10028;34902;9205;33415;1588;6343;6157;22445;7745;28788
261310;201308;8280;25656;7936;25056;1872;6263;4768;15040;6640;21303
261320;201308;5846;18540;5542;17965;740;2377;4039;13424;4779;15801
261330;201308;5480;16582;5354;16403;426;1436;4480;13764;4906;15200
261340;201308;4522;15014;4324;14700;723;2806;2853;9722;3576;12528
261350;201308;7800;27064;7428;26396;699;3024;5829;20488;6528;23512
261360;201308;9270;24491;8570;23538;1275;3709;5914;16534;7189;20243
261370;201308;20315;62014;19392;60666;3150;10634;13903;43640;17053;54274
261380;201308;4113;14424;3860;14007;645;2363;2643;9909;3288;12272
261390;201308;16727;52781;15434;50499;2823;10221;9584;31092;12407;41313
261400;201308;4799;17125;4415;16378;661;2746;2998;11205;3659;13951
261410;201308;7949;24513;7652;24043;945;3053;5795;18586;6740;21639
261420;201308;7741;26493;7500;26129;1989;7588;4284;15149;6273;22737
261430;201308;3534;11128;3026;10451;426;1525;2188;7728;2614;9253
261440;201308;1632;5013;1530;4854;125;505;1238;3877;1363;4382
261450;201308;13914;41145;13537;40632;1125;3586;11720;35191;12845;38777
261460;201308;8378;24424;7857;23695;816;2370;5824;18902;6640;21272
261470;201308;3897;10636;3587;10260;252;824;3050;8686;3302;9510
261480;201308;3319;12490;3140;12166;381;1707;2403;9129;2784;10836
261485;201308;4808;15349;4568;14935;1076;3765;2597;8581;3673;12346
261500;201308;5750;16296;5219;15582;773;2130;3900;12182;4673;14312
261510;201308;2025;6815;1948;6706;121;345;1691;5975;1812;6320
261520;201308;2526;8405;2293;8048;223;906;1670;5856;1893;6762
261530;201308;12362;40742;11090;38268;2554;9758;5442;18734;7996;28492
261540;201308;7166;23212;6976;22892;1916;5971;4349;14947;6265;20918
261550;201308;3336;10477;3229;10307;503;2021;2409;7338;2912;9359
261560;201308;6551;21762;6106;21198;1308;4306;4204;15243;5512;19549
261570;201308;3552;11362;3284;10928;484;1673;2316;7847;2800;9520
261580;201308;5654;18654;5090;17715;458;1789;4057;14371;4515;16160
261590;201308;2780;7958;2461;7509;260;854;1806;5607;2066;6461
261600;201308;4977;14305;4295;13297;547;1778;3121;9799;3668;11577
261610;201308;2227;6952;1983;6607;188;759;1604;5221;1792;5980
261618;201308;2470;7272;2348;7102;294;958;1804;5420;2098;6378
261620;201308;4487;14038;4272;13702;489;1692;3111;10166;3600;11858
261630;201308;8044;23991;7211;22553;1478;5312;4081;12465;5559;17777
261640;201308;32469;85733;30393;83268;2023;5770;25971;72269;27994;78039
261650;201308;3681;12316;3548;12114;467;1801;2760;9424;3227;11225
270010;201308;4415;17139;4073;16420;529;2497;2865;11521;3394;14018
270020;201308;3834;12031;3613;11661;552;2080;2592;8199;3144;10279
270030;201308;44281;134902;42616;132400;11807;37553;24239;77306;36046;114859
270040;201308;10321;32164;9998;31810;1281;3558;8096;26665;9377;30223
270050;201308;3849;11484;3591;11118;417;1576;2705;8193;3122;9769
270060;201308;1512;5296;1456;5212;379;1491;848;3019;1227;4510
270070;201308;4040;12808;3818;12488;147;672;3389;10988;3536;11660
270080;201308;1259;4085;1147;3931;257;989;684;2325;941;3314
270090;201308;2028;6535;1982;6478;65;250;1859;6067;1924;6317
270100;201308;6315;20202;6070;19867;1257;4450;4132;13446;5389;17896
270110;201308;3381;9642;3130;9343;607;1888;1958;6260;2565;8148
270120;201308;3036;8977;2745;8581;168;627;2318;7267;2486;7894
270130;201308;4912;15545;4686;15280;711;2297;3519;11812;4230;14109
270135;201308;1682;4972;1605;4881;74;180;1468;4554;1542;4734
270140;201308;9051;24446;8195;23309;980;3929;6312;16830;7292;20759
270150;201308;2558;9055;2495;8966;260;1087;2064;7350;2324;8437
270160;201308;4708;16606;4389;16169;332;1150;3748;14032;4080;15182
270170;201308;3970;13362;3671;12903;814;3269;2095;7302;2909;10571
270180;201308;2116;7344;1907;7077;199;874;1472;5455;1671;6329
270190;201308;1862;6328;1779;6183;171;662;1376;4837;1547;5499
270200;201308;2702;9163;2557;8935;245;1108;2060;7016;2305;8124
270210;201308;4098;14189;4002;14052;487;1998;3228;11252;3715;13250
270220;201308;1680;5364;1585;5169;304;1169;874;2898;1178;4067
270230;201308;10914;36708;9763;34925;1503;6199;6857;24356;8360;30555
270235;201308;6373;21534;6090;21062;362;1641;5215;17917;5577;19558
270240;201308;9628;29367;8679;28080;1621;5530;5737;18679;7358;24209
270250;201308;3370;8996;3128;8729;158;463;2845;7938;3003;8401
270255;201308;5043;15767;4239;14371;452;1942;2988;9950;3440;11892
270260;201308;6157;20102;5996;19814;932;3601;4275;14118;5207;17719
270270;201308;1221;3614;1147;3498;199;666;817;2461;1016;3127
270280;201308;3638;11133;3468;10885;561;2044;2491;7736;3052;9780
270290;201308;8287;29793;7948;29193;799;3264;6350;23386;7149;26650
270300;201308;3261;11298;3104;11110;195;874;2742;9776;2937;10650
270310;201308;7022;22443;6393;21359;461;2074;5114;16669;5575;18743
270320;201308;6182;20703;5979;20329;1717;6505;2869;9909;4586;16414
270330;201308;4726;15946;4495;15628;394;1471;3729;13082;4123;14553
270340;201308;1755;5581;1614;5408;224;784;1200;4107;1424;4891
270350;201308;2077;5934;1933;5743;364;1132;1204;3810;1568;4942
270360;201308;2048;6446;2012;6404;252;779;1622;5311;1874;6090
270370;201308;1697;5683;1564;5444;202;800;1074;3838;1276;4638
270375;201308;2885;9195;2758;8993;492;1965;1876;5836;2368;7801
270380;201308;6111;18645;5868;18319;617;2007;4573;14580;5190;16587
270390;201308;1419;3992;1304;3852;195;697;886;2500;1081;3197
270400;201308;6057;18895;5616;18241;577;2200;4169;13380;4746;15580
270410;201308;4781;15080;4593;14719;601;2133;3406;10884;4007;13017
270420;201308;5266;17636;5127;17432;311;1469;4396;14670;4707;16139
270430;201308;139267;409859;134368;403019;35387;108690;78510;241608;113897;350298
270440;201308;4882;15500;4629;15101;397;1492;3736;12230;4133;13722
270450;201308;6266;20199;6131;20023;691;2629;4855;15823;5546;18452
270460;201308;3444;9811;3131;9364;258;1030;2514;7285;2772;8315
270470;201308;10660;35007;10252;34273;1359;4333;7672;26675;9031;31008
270480;201308;3073;9949;2883;9623;371;1520;1967;6356;2338;7876
270490;201308;978;3163;925;3083;100;408;686;2234;786;2642
270500;201308;5391;18928;5219;18676;490;1769;4272;15698;4762;17467
270510;201308;5933;18812;5476;18171;985;4168;3887;12225;4872;16393
270520;201308;3595;12039;3408;11718;997;3635;1746;6113;2743;9748
270530;201308;1534;4625;1360;4396;230;723;915;3090;1145;3813
270540;201308;1972;7044;1825;6811;187;912;1427;5205;1614;6117
270550;201308;6943;21650;6222;20661;1136;3950;4080;13951;5216;17901
270560;201308;2907;9519;2819;9401;585;2226;1873;6109;2458;8335
270570;201308;4227;13928;3906;13409;497;2066;2660;9050;3157;11116
270580;201308;1946;6688;1877;6565;349;1281;1312;4651;1661;5932
270590;201308;1292;4603;1217;4465;111;519;991;3591;1102;4110
270600;201308;2808;9602;2576;9258;229;1134;2007;7000;2236;8134
270610;201308;3167;10211;2984;9930;358;1289;2304;7648;2662;8937
270620;201308;1438;4951;1303;4748;158;741;980;3473;1138;4214
270630;201308;17897;50714;17132;49616;2350;6723;13173;38779;15523;45502
270640;201308;5777;18149;5308;17600;451;1913;4365;14188;4816;16101
270642;201308;2458;8507;2313;8283;403;1627;1528;5477;1931;7104
270644;201308;2311;7122;2178;6974;371;1119;1655;5468;2026;6587
270650;201308;3834;12702;3716;12529;927;3634;2135;7075;3062;10709
270660;201308;2501;6638;2031;5909;189;674;1413;4017;1602;4691
270670;201308;13955;40840;12621;39109;1692;5849;9390;29285;11082;35134
270680;201308;4107;12778;3995;12645;255;747;3561;11416;3816;12163
270690;201308;8453;24583;8008;24041;2482;7194;4224;13722;6706;20916
270700;201308;792;2545;755;2485;136;555;471;1493;607;2048
270710;201308;5309;18474;5122;18225;539;1915;4206;15209;4745;17124
270720;201308;3264;11390;3050;11019;296;1360;2429;8633;2725;9993
270730;201308;6457;20574;6158;20178;1252;4350;4191;13786;5443;18136
270740;201308;2374;7172;2236;6949;378;1333;1476;4545;1854;5878
270750;201308;4623;15125;4350;14713;541;1994;3302;11179;3843;13173
270760;201308;3281;10279;3094;10009;426;1476;2279;7389;2705;8865
270770;201308;17226;47492;14933;44695;2848;9189;9680;29394;12528;38583
270780;201308;1907;6164;1777;5955;250;897;1275;4315;1525;5212
270790;201308;1604;5166;1473;4948;415;1514;687;2322;1102;3836
270800;201308;10950;33839;10387;33094;1004;3602;8419;26786;9423;30388
270810;201308;3291;10448;2774;9490;422;1665;1713;5867;2135;7532
270820;201308;1879;6512;1740;6266;265;1116;1211;4305;1476;5421
270830;201308;4999;16502;4647;16036;1444;5642;2479;8420;3923;14062
270840;201308;7217;25563;6676;24852;520;2456;5526;20364;6046;22820
270850;201308;7472;25071;7327;24891;1564;6479;5014;16178;6578;22657
270860;201308;11088;34563;10495;33702;1811;6807;7391;23149;9202;29956
270870;201308;2212;6523;1818;5722;270;933;1141;3600;1411;4533
270880;201308;7912;25977;7555;25450;597;2484;6316;21022;6913;23506
270890;201308;2568;8078;2406;7812;404;1561;1653;5223;2057;6784
270895;201308;2988;11222;2849;11038;281;1061;2368;9380;2649;10441
270900;201308;1898;5293;1579;4830;115;447;1213;3607;1328;4054
270910;201308;3217;11566;3176;11487;358;1589;2602;9178;2960;10767
270915;201308;9757;33891;8998;32516;2037;8281;4918;17715;6955;25996
270920;201308;5957;19725;5607;19202;403;1800;4748;16086;5151;17886
270930;201308;16675;46384;14019;42995;3067;10020;8009;25140;11076;35160
270940;201308;5683;19653;5525;19459;922;3442;4004;14229;4926;17671
280010;201308;709;2119;632;1999;69;277;411;1275;480;1552
280020;201308;4775;14898;4343;14119;893;3108;2687;8729;3580;11837
280030;201308;69282;188943;62993;179613;15937;48072;33724;97529;49661;145601
280040;201308;3113;10068;2844;9707;373;1297;2123;7476;2496;8773
280050;201308;4062;13271;3808;12899;1087;3708;2130;7544;3217;11252
280060;201308;4127;14226;3998;14006;977;3767;2343;8223;3320;11990
280067;201308;7403;21528;6344;20068;686;2419;4817;15210;5503;17629
280070;201308;1794;6415;1727;6315;350;1360;1117;4134;1467;5494
280100;201308;3946;12785;3603;12162;902;3130;1928;6679;2830;9809
280110;201308;1343;4233;1245;4071;113;471;980;3149;1093;3620
280120;201308;7474;24538;7012;23786;1424;4628;4641;16631;6065;21259
280130;201308;7655;22612;7258;22041;1250;4376;4900;14595;6150;18971
280140;201308;5378;15347;4928;14760;497;1493;3991;12114;4488;13607
280150;201308;3238;10385;2992;9899;486;1971;1877;5904;2363;7875
280160;201308;1531;4439;1399;4225;181;616;1004;3030;1185;3646
280170;201308;4451;13986;4110;13560;557;1871;3098;10558;3655;12429
280190;201308;1079;3233;985;3079;119;465;686;2069;805;2534
280200;201308;1049;3364;996;3284;165;696;709;2241;874;2937
280210;201308;11709;39047;11269;38345;2484;8959;7121;24637;9605;33596
280220;201308;1504;4713;1456;4650;95;370;1279;4054;1374;4424
280230;201308;3820;11348;3456;10746;733;2418;2024;6457;2757;8875
280240;201308;3359;10386;3126;10027;254;802;2511;8193;2765;8995
280250;201308;755;2070;693;1978;99;321;460;1245;559;1566
280260;201308;1916;5369;1762;5173;128;392;1500;4409;1628;4801
280270;201308;2153;6911;1894;6457;139;566;1495;5016;1634;5582
280280;201308;3958;13462;3726;13053;893;2815;2098;8147;2991;10962
280290;201308;15845;52991;14860;51261;2760;10293;10237;35474;12997;45767
280300;201308;9685;30161;9129;29528;804;2816;7733;25068;8537;27884
280310;201308;1409;4054;1256;3814;113;435;909;2677;1022;3112
280320;201308;7221;25328;6872;24673;1305;5319;4193;15013;5498;20332
280330;201308;4400;12971;4168;12673;553;1858;3193;9728;3746;11586
280340;201308;3627;11439;3514;11275;324;1093;2853;9397;3177;10490
280350;201308;20574;63249;19627;61751;3193;10400;13715;44109;16908;54509
280360;201308;5717;18521;5420;18059;1222;4595;3284;10799;4506;15394
280370;201308;1888;5532;1752;5307;218;781;1271;3740;1489;4521
280380;201308;888;2952;834;2868;132;533;613;2043;745;2576
280390;201308;3166;9629;2869;9096;734;2170;1716;5629;2450;7799
280400;201308;4332;12698;3991;12242;824;2432;2601;8346;3425;10778
280410;201308;2291;7729;2122;7441;367;1476;1296;4454;1663;5930
280420;201308;3927;11864;3697;11518;276;916;3162;9931;3438;10847
280430;201308;2006;5753;1910;5628;231;795;1466;4315;1697;5110
280440;201308;4940;15076;4663;14718;444;1540;3901;12323;4345;13863
280445;201308;2422;7094;2267;6825;129;506;1880;5555;2009;6061
280450;201308;8574;24197;8001;23535;785;2031;6709;20377;7494;22408
280460;201308;6608;18801;5991;17961;1271;4029;3889;11834;5160;15863
280470;201308;1732;5395;1597;5188;181;660;1209;3893;1390;4553
280480;201308;29875;92847;28948;91491;5018;18623;19747;60765;24765;79388
280490;201308;3647;11468;3423;11054;402;1500;2600;8362;3002;9862
280500;201308;864;2359;821;2306;33;114;722;2003;755;2117
280510;201308;2655;7996;2301;7505;306;1160;1703;5569;2009;6729
280520;201308;1671;4916;1548;4755;206;628;1149;3652;1355;4280
280530;201308;1985;6395;1887;6264;240;889;1462;4904;1702;5793
280540;201308;8598;24563;8183;23994;367;1306;7322;21345;7689;22651
280550;201308;6864;19348;6253;18360;536;1918;4795;13953;5331;15871
280560;201308;7684;23251;7305;22616;540;1873;5988;18497;6528;20370
280570;201308;6468;18643;6010;18050;937;3294;4178;12316;5115;15610
280580;201308;5586;17277;4890;16130;761;2641;3370;11303;4131;13944
280590;201308;2323;7196;2157;7001;276;1063;1617;5254;1893;6317
280600;201308;3962;12406;3726;11981;412;1638;2687;8438;3099;10076
280610;201308;2287;6837;2181;6676;372;1239;1382;4256;1754;5495
280620;201308;4645;14982;4356;14381;848;3005;2781;9217;3629;12222
280630;201308;3724;12613;3625;12466;369;1172;2933;10442;3302;11614
280640;201308;2124;6221;1985;6052;184;520;1687;5231;1871;5751
280650;201308;1070;3458;995;3317;199;713;612;2083;811;2796
280660;201308;2546;7633;2450;7470;264;910;2024;6087;2288;6997
280670;201308;15297;41358;14654;40564;1517;4490;11737;32550;13254;37040
280680;201308;2689;7338;2386;6955;185;593;2014;5861;2199;6454
280690;201308;936;2800;834;2641;124;461;553;1670;677;2131
280700;201308;1150;3438;1019;3245;93;309;761;2461;854;2770
280710;201308;9871;28474;9408;27902;585;1901;8128;24104;8713;26005
280720;201308;2446;6751;2199;6441;198;623;1745;5164;1943;5787
280730;201308;902;2778;875;2740;89;300;719;2276;808;2576
280740;201308;12281;34651;10917;32650;1710;5031;7633;23552;9343;28583
280750;201308;3476;11203;3258;10803;299;1256;2424;7910;2723;9166
280760;201308;5622;17593;5199;17037;719;2370;3863;13133;4582;15503
290010;201308;2955;6740;2176;5507;94;382;1729;4128;1823;4510
290020;201308;4834;15459;4404;15011;375;1191;3833;13310;4208;14501
290030;201308;3067;10231;3001;10102;423;1519;2249;7561;2672;9080
290035;201308;4405;12519;4010;11994;257;901;3436;10268;3693;11169
290040;201308;3627;10963;3428;10695;287;1128;2842;8694;3129;9822
290050;201308;2697;8951;2539;8707;263;1021;1962;6764;2225;7785
290060;201308;1232;3302;1046;3084;99;291;882;2611;981;2902
290070;201308;29635;80281;26116;75872;5668;17158;14718;44819;20386;61977
290080;201308;5747;18068;5169;17324;656;2311;3899;13343;4555;15654
290090;201308;2276;5124;1827;4647;247;656;1458;3741;1705;4397
290100;201308;9995;29341;8761;27222;1911;5967;4861;15824;6772;21791
290110;201308;5157;16036;5001;15764;900;3063;3412;10696;4312;13759
290115;201308;4763;14885;4267;14221;346;1235;3275;11144;3621;12379
290120;201308;6585;18606;6207;18149;429;1296;5395;15900;5824;17196
290130;201308;4513;11984;4013;11387;324;842;3414;9879;3738;10721
290135;201308;4962;13269;4367;12286;482;1607;2948;8238;3430;9845
290140;201308;3686;12428;3326;11960;407;1580;2632;9514;3039;11094
290150;201308;2078;6305;2018;6202;199;678;1692;5163;1891;5841
290160;201308;3422;9743;3348;9655;374;752;2852;8602;3226;9354
290170;201308;2757;9432;2555;9097;251;1041;2045;7283;2296;8324
290180;201308;2867;8446;2613;8098;307;1077;1903;5881;2210;6958
290190;201308;4124;13836;3986;13592;451;1609;3100;10691;3551;12300
290195;201308;2138;6120;1873;5725;139;471;1512;4658;1651;5129
290200;201308;3747;12436;3467;11927;441;1636;2546;8796;2987;10432
290205;201308;2721;9033;2570;8807;416;1710;1808;6044;2224;7754
290210;201308;15496;43440;14758;42580;2471;5802;10691;33709;13162;39511
290220;201308;2303;7255;2220;7126;333;1245;1582;4955;1915;6200
290225;201308;2995;8232;2830;8053;241;525;2440;7205;2681;7730
290230;201308;2330;7884;2293;7830;243;857;1895;6555;2138;7412
290240;201308;3839;10342;3489;9867;432;1352;2532;7096;2964;8448
290250;201308;3725;12158;3179;11276;312;1189;2405;8634;2717;9823
290260;201308;4556;14559;4324;14197;491;1730;3405;11186;3896;12916
290265;201308;3275;10906;3131;10648;328;1316;2384;8068;2712;9384
290270;201308;11653;44043;11047;43153;1424;6023;8451;33452;9875;39475
290280;201308;4882;16797;4675;16381;717;2648;3179;11421;3896;14069
290290;201308;9427;31089;8726;29942;1654;5996;5758;20088;7412;26084
290300;201308;4344;12570;3446;11016;329;1118;2500;8161;2829;9279
290310;201308;1502;4691;1431;4604;221;825;1048;3307;1269;4132
290320;201308;24807;79609;22729;76798;5039;18111;13988;48071;19027;66182
290323;201308;3947;10975;3272;10264;212;784;2799;8767;3011;9551
290327;201308;3895;12864;3658;12372;511;1842;2568;8709;3079;10551
290330;201308;1830;5024;1761;4946;287;898;1360;3754;1647;4652
290340;201308;5503;17732;5146;17222;1302;4462;2895;10007;4197;14469
290350;201308;4828;15066;3996;13920;527;1878;2883;10318;3410;12196
290360;201308;4055;13130;3723;12685;236;838;3259;11252;3495;12090
290370;201308;4501;13819;4182;13356;559;1818;3292;10655;3851;12473
290380;201308;5428;16306;4901;15611;387;1393;4097;13053;4484;14446
290390;201308;14650;49086;14080;48114;2973;9899;8993;32333;11966;42232
290395;201308;2737;9065;2494;8662;257;1101;1870;6479;2127;7580
290400;201308;3429;11298;3127;10865;465;1617;2283;8135;2748;9752
290405;201308;4243;13978;3744;13119;521;1900;2511;9053;3032;10953
290410;201308;5852;18084;5046;16901;570;2452;3756;12206;4326;14658
290420;201308;3181;9708;2683;8986;270;1083;2064;6842;2334;7925
290430;201308;3347;10948;3070;10554;693;2403;1892;6756;2585;9159
290440;201308;2841;7871;2409;7323;215;738;1977;6044;2192;6782
290450;201308;3459;10412;3154;9969;669;2020;1994;6594;2663;8614
290460;201308;12769;40982;12114;39866;3275;11497;6150;20102;9425;31599
290470;201308;4603;13494;3743;12403;875;3286;2042;6842;2917;10128
290475;201308;5054;18209;4618;17415;549;2197;3395;12996;3944;15193
290480;201308;2618;6931;2347;6573;367;1131;1622;4569;1989;5700
290485;201308;4412;15010;4156;14635;480;2154;3193;11129;3673;13283
290490;201308;7508;21360;7299;21064;939;2952;5762;16610;6701;19562
290500;201308;4537;14822;3960;13806;752;2831;2167;7586;2919;10417
290510;201308;3391;10139;2986;9547;258;989;2365;7552;2623;8541
290515;201308;2677;8721;2587;8547;162;522;2123;7195;2285;7717
290520;201308;11606;36888;9639;33198;1314;5292;6117;20954;7431;26246
290530;201308;5174;15304;4465;14273;378;1308;3617;11597;3995;12905
290540;201308;3918;11422;3748;11196;508;1477;2831;8689;3339;10166
290550;201308;4278;11508;3800;10914;229;665;3280;9467;3509;10132
290560;201308;5939;18058;5333;17192;1144;3889;3270;10683;4414;14572
290570;201308;38676;116023;36379;112475;5039;16748;26767;82460;31806;99208
290580;201308;7239;26145;6983;25751;1209;4483;5078;19243;6287;23726
290590;201308;7321;24093;6292;22437;471;1996;5105;18159;5576;20155
290600;201308;17781;56691;16883;55302;2517;8321;11823;39961;14340;48282
290610;201308;2291;8197;1961;7540;208;988;1453;5491;1661;6479
290620;201308;7195;21714;6502;20724;547;1902;5429;17322;5976;19224
290630;201308;8058;22541;7179;21604;838;2512;5757;17568;6595;20080
290640;201308;2682;8032;2256;7283;257;889;1597;5181;1854;6070
290650;201308;11493;35017;10824;33987;3343;10557;5668;18636;9011;29193
290660;201308;3634;10454;3046;9604;214;783;2429;7688;2643;8471
290670;201308;6290;20422;5813;19675;868;2758;4395;15531;5263;18289
290680;201308;10052;30375;9448;29655;554;1795;8226;26103;8780;27898
290682;201308;4158;12989;3821;12504;222;888;3186;10391;3408;11279
290685;201308;3145;8416;2446;7438;318;1072;1543;4776;1861;5848
290687;201308;8242;22608;6708;20796;1049;3558;4519;14231;5568;17789
290689;201308;3086;8918;2614;8154;275;920;1989;6244;2264;7164
290690;201308;5203;15777;4818;15243;628;2169;3673;11655;4301;13824
290700;201308;2211;7109;2124;6983;238;843;1634;5424;1872;6267
290710;201308;7521;24930;7061;24197;410;1413;6217;21527;6627;22940
290720;201308;17517;53546;15862;51470;2400;7261;12046;40547;14446;47808
290730;201308;7279;20661;6710;19938;1402;4013;4272;13231;5674;17244
290740;201308;984;3023;854;2803;168;546;495;1700;663;2246
290750;201308;9919;29416;8689;27228;1752;6409;5039;15103;6791;21512
290755;201308;2379;6951;2041;6383;133;531;1668;5156;1801;5687
290760;201308;4399;13326;3699;12350;393;1333;2808;9485;3201;10818
290770;201308;2516;8899;2363;8694;158;648;1992;7380;2150;8028
290780;201308;8463;23153;7641;22032;1009;2670;5726;17060;6735;19730
290790;201308;4463;13917;4214;13584;528;1641;3224;10814;3752;12455
290800;201308;7086;16165;5516;14497;1163;2847;3793;10453;4956;13300
290810;201308;4763;15705;4250;14933;348;1330;3299;11772;3647;13102
290820;201308;5242;15651;4723;14897;618;2195;3381;10633;3999;12828
290830;201308;4189;12829;4047;12567;500;1954;2961;8935;3461;10889
290840;201308;17012;49298;15921;47808;2414;6963;11473;35899;13887;42862
290850;201308;6602;20294;6459;20079;1549;4798;4229;13544;5778;18342
290860;201308;4674;17228;4493;16980;759;2855;3236;12631;3995;15486
290870;201308;4693;14498;3969;13520;490;1977;2907;9809;3397;11786
290880;201308;1368;3903;1124;3516;121;394;748;2385;869;2779
290890;201308;6108;17626;5902;17355;625;1922;4795;14181;5420;16103
290900;201308;2377;7118;1828;6230;302;1191;974;3268;1276;4459
290910;201308;4657;13480;4066;12630;350;1187;3289;10239;3639;11426
290920;201308;4654;14166;4243;13607;349;997;3464;11342;3813;12339
290930;201308;7180;23755;6688;22920;789;3070;4877;16503;5666;19573
290940;201308;3350;11099;3177;10874;289;1065;2661;9228;2950;10293
290950;201308;1580;4592;1493;4478;227;729;1085;3237;1312;3966
290960;201308;5702;17013;5242;16398;416;1343;4228;13454;4644;14797
290970;201308;3699;12279;3467;11876;523;1856;2302;8121;2825;9977
290980;201308;10441;32643;9487;30737;2819;9617;4065;13147;6884;22764
290990;201308;9033;27740;8320;26599;910;3089;6513;20913;7423;24002
291000;201308;2827;9212;2693;9032;463;1534;1962;6810;2425;8344
291005;201308;12297;36411;11331;34948;2197;7250;7358;23015;9555;30265
291010;201308;2906;10027;2502;9113;483;1900;1391;5081;1874;6981
291020;201308;1329;3703;1048;3185;132;498;610;1801;742;2299
291030;201308;2032;5943;1725;5299;189;643;1142;3472;1331;4115
291040;201308;5228;17244;4934;16789;721;2618;3589;12288;4310;14906
291050;201308;7841;26773;7264;25698;1900;7218;3892;13828;5792;21046
291060;201308;6094;23129;5851;22838;792;3513;4519;17591;5311;21104
291070;201308;15639;47489;14507;45830;1979;5850;10817;35434;12796;41284
291072;201308;18820;61413;16769;57340;6296;22899;5536;19983;11832;42882
291075;201308;5058;15198;4632;14606;331;1064;3600;11634;3931;12698
291077;201308;1492;4520;1286;4199;147;582;890;2848;1037;3430
291080;201308;79840;248448;73242;237516;19023;65059;36150;117043;55173;182102
291085;201308;5479;15263;4832;14386;621;1956;3687;11008;4308;12964
291090;201308;1236;3485;1098;3277;164;654;760;2136;924;2790
291100;201308;2646;7273;2239;6841;129;524;1930;5850;2059;6374
291110;201308;4878;17959;4442;17265;672;2899;3126;12108;3798;15007
291120;201308;7407;20285;7025;19740;1010;2987;5236;14763;6246;17750
291125;201308;1637;3752;1348;3446;134;326;1050;2806;1184;3132
291130;201308;2963;9211;2606;8614;264;1016;1868;6147;2132;7163
291140;201308;4000;12358;3777;11960;541;1826;2689;8543;3230;10369
291150;201308;1970;5278;1900;5193;185;543;1503;4070;1688;4613
291160;201308;5445;16938;4848;16063;1133;3928;2947;9791;4080;13719
291165;201308;2300;7160;1964;6522;170;725;1410;4570;1580;5295
291170;201308;20235;53250;17713;50195;1404;4754;14242;40088;15646;44842
291180;201308;6299;17160;5280;15771;605;2038;4007;11878;4612;13916
291185;201308;3630;10446;3480;10255;226;809;3001;8745;3227;9554
291190;201308;7360;21282;6701;20504;902;2652;5015;16001;5917;18653
291200;201308;3046;9449;2658;8804;356;1389;1874;6143;2230;7532
291210;201308;7523;18283;6687;17357;680;1869;5190;13566;5870;15435
291220;201308;4016;13173;3827;12845;610;2320;2691;8917;3301;11237
291230;201308;3725;10133;3343;9667;214;633;2896;8446;3110;9079
291240;201308;4662;13117;4001;11955;331;1039;3091;9169;3422;10208
291250;201308;3677;11295;2956;10108;325;1145;2113;7341;2438;8486
291260;201308;1154;3514;1099;3441;105;364;880;2752;985;3116
291270;201308;4319;14937;4161;14668;276;1083;3531;12483;3807;13566
291280;201308;2326;6003;1783;5388;522;1536;1032;3243;1554;4779
291290;201308;5832;17011;5366;16447;753;2289;3881;12248;4634;14537
291300;201308;4384;13400;3680;12211;489;1780;2503;8331;2992;10111
291310;201308;5201;15422;4643;14514;448;1518;3559;11122;4007;12640
291320;201308;5570;18891;5010;17789;1433;5510;2396;8434;3829;13944
291330;201308;1557;4931;1469;4771;221;841;929;2881;1150;3722
291340;201308;3733;11448;3041;10457;399;1593;2276;7725;2675;9318
291345;201308;3379;11444;3242;11295;254;899;2818;9971;3072;10870
291350;201308;6012;18247;5413;17329;684;2293;3639;11973;4323;14266
291360;201308;35681;105983;33569;102877;8015;24571;21406;67784;29421;92355
291370;201308;8912;27135;8572;26696;1270;3717;6359;20603;7629;24320
291380;201308;3739;11783;3353;11147;336;1153;2389;8186;2725;9339
291390;201308;10197;29291;9381;28338;1277;3860;7224;22127;8501;25987
291400;201308;16395;44240;13459;40292;2095;6514;8847;27453;10942;33967
291410;201308;3211;8487;2388;7277;205;840;1768;5197;1973;6037
291420;201308;2210;5907;2004;5659;97;236;1835;5256;1932;5492
291430;201308;3291;9948;2932;9473;272;1070;2285;7313;2557;8383
291440;201308;5779;18908;4968;17386;588;2207;3737;13247;4325;15454
291450;201308;7121;22840;6763;22218;477;1530;5527;18575;6004;20105
291460;201308;12268;38908;11098;37198;2614;9149;6668;22720;9282;31869
291465;201308;7623;23026;7037;22368;967;3364;5374;17133;6341;20497
291470;201308;15260;43750;13757;41894;1216;3753;10926;34269;12142;38022
291480;201308;34156;95069;30681;90162;5782;18716;19482;56897;25264;75613
291490;201308;4051;14254;3986;14153;558;2001;3139;11317;3697;13318
291500;201308;4097;12241;3617;11576;292;1008;2923;9409;3215;10417
291510;201308;3394;10825;3218;10574;162;586;2899;9581;3061;10167
291520;201308;3968;11317;3587;10796;640;1823;2379;7661;3019;9484
291530;201308;2044;6276;1772;5851;507;1790;878;2989;1385;4779
291535;201308;4257;12786;3871;12211;392;1307;2903;9517;3295;10824
291540;201308;2190;5517;1903;5217;156;396;1611;4525;1767;4921
291550;201308;5535;15683;5037;14979;1253;4012;2810;8434;4063;12446
291560;201308;16242;43847;13101;40231;1758;5557;9620;30299;11378;35856
291570;201308;2318;6432;2234;6326;147;383;2000;5728;2147;6111
291580;201308;5774;18158;5167;17190;858;3438;3288;10766;4146;14204
291590;201308;1995;6355;1787;6002;347;1298;1096;3775;1443;5073
291600;201308;5408;15446;4050;13539;1036;3753;2008;6673;3044;10426
291610;201308;5126;14973;4974;14750;489;1677;4040;11802;4529;13479
291620;201308;2979;7143;2509;6635;208;539;1990;5433;2198;5972
291630;201308;3177;8141;2836;7755;263;677;2411;6747;2674;7424
291640;201308;16724;47633;14303;44531;3938;13456;6491;20317;10429;33773
291650;201308;7896;24120;7343;23475;635;1630;6209;20659;6844;22289
291660;201308;2370;6452;2129;6129;267;908;1519;4277;1786;5185
291670;201308;2483;7129;2296;6819;374;1161;1305;4178;1679;5339
291680;201308;4940;14407;4491;13694;1169;4021;2109;6686;3278;10707
291685;201308;4195;11241;3765;10727;288;836;3088;9066;3376;9902
291690;201308;3933;11038;3267;9983;337;1068;2264;6976;2601;8044
291700;201308;9147;29747;8585;28808;1002;3526;6473;22098;7475;25624
291710;201308;5815;15823;5114;14883;1255;3983;2655;7990;3910;11973
291720;201308;3648;13187;3421;12704;405;1718;2544;9327;2949;11045
291730;201308;5679;18907;5342;18458;1365;4786;3234;11604;4599;16390
291733;201308;2471;7695;2186;7305;283;1020;1498;5064;1781;6084
291735;201308;2195;6618;1945;6242;122;470;1643;5213;1765;5683
291740;201308;3941;11662;3144;10435;328;1285;2233;7369;2561;8654
291750;201308;21469;58461;17532;52702;3971;12342;9751;29922;13722;42264
291760;201308;11949;38986;11216;37661;3864;14005;5126;17529;8990;31534
291770;201308;7883;23244;7307;22291;1161;3838;4978;15076;6139;18914
291780;201308;4210;13379;4060;13107;595;1867;3058;10028;3653;11895
291790;201308;2361;7766;2247;7608;194;751;1853;6270;2047;7021
291800;201308;30419;91794;27935;88225;6449;21160;16756;54403;23205;75563
291810;201308;10253;30797;9026;29372;708;2546;7322;24166;8030;26712
291820;201308;3513;10868;3252;10497;382;1257;2458;8039;2840;9296
291830;201308;4358;12044;4098;11654;607;1890;3037;8615;3644;10505
291835;201308;6010;19257;5093;17765;1077;4060;3270;11405;4347;15465
291840;201308;46129;131625;40277;125413;5030;15649;31976;101711;37006;117360
291845;201308;2978;8846;2697;8540;233;710;2351;7541;2584;8251
291850;201308;4814;13843;4122;12898;435;1329;3243;10457;3678;11786
291855;201308;1872;5100;1645;4817;295;1008;1127;3223;1422;4231
291860;201308;1871;5810;1711;5528;191;699;1155;3711;1346;4410
291870;201308;1318;3677;1061;3220;109;411;709;2109;818;2520
291875;201308;2754;9207;2537;8851;279;1135;1815;6253;2094;7388
291880;201308;4464;14473;4320;14250;303;1003;3738;12482;4041;13485
291890;201308;1410;3620;1206;3371;169;493;869;2451;1038;2944
291900;201308;1251;3725;1122;3534;116;427;851;2636;967;3063
291905;201308;2873;7822;2438;7130;244;826;1716;5082;1960;5908
291910;201308;2470;7007;2238;6701;187;702;1822;5331;2009;6033
291915;201308;6523;20827;5916;19599;532;1837;4876;16388;5408;18225
291920;201308;32216;95464;29968;92190;6003;18806;18906;59957;24909;78763
291930;201308;2488;7575;2277;7276;260;876;1749;5663;2009;6539
291940;201308;3537;10302;2719;8857;417;1571;1638;5165;2055;6736
291950;201308;8997;31338;8239;30099;2218;8279;4331;16261;6549;24540
291955;201308;7313;24590;7195;24425;1473;5102;4825;16710;6298;21812
291960;201308;3298;10091;2876;9521;365;1153;2041;7144;2406;8297
291970;201308;4384;13279;3926;12722;625;2066;2750;9139;3375;11205
291980;201308;11231;33189;8781;29683;1126;3983;6195;21421;7321;25404
291990;201308;2079;7007;1940;6797;211;767;1420;5124;1631;5891
291992;201308;2769;8692;2713;8574;507;1668;1925;6070;2432;7738
291995;201308;2066;6267;1886;6025;230;764;1441;4689;1671;5453
292000;201308;2275;6937;2076;6635;526;1854;1198;3753;1724;5607
292010;201308;6029;16105;4709;14098;452;1455;3628;10863;4080;12318
292020;201308;4421;15371;4081;14798;574;2248;2990;11005;3564;13253
292030;201308;2123;6905;1937;6634;255;951;1292;4481;1547;5432
292040;201308;4527;12932;4069;12440;354;1046;3414;10793;3768;11839
292045;201308;2336;8559;2307;8508;123;413;2114;7871;2237;8284
292050;201308;6034;19573;5516;18554;613;2524;3882;12860;4495;15384
292060;201308;10689;30728;10319;30232;980;2992;8560;25085;9540;28077
292070;201308;4264;13934;4167;13811;391;1163;3625;12240;4016;13403
292080;201308;3591;9783;3134;9162;299;892;2528;7479;2827;8371
292090;201308;4207;11553;3653;10918;357;1231;2944;8798;3301;10029
292100;201308;10369;30003;9210;28564;2416;7858;5517;17450;7933;25308
292105;201308;3129;9721;2740;9176;220;885;2188;7278;2408;8163
292110;201308;6962;18684;5388;16440;1195;3818;3114;9773;4309;13591
292120;201308;8251;24212;7361;22789;1530;4937;4336;13762;5866;18699
292130;201308;3202;8686;2935;8334;421;999;2200;6558;2621;7557
292140;201308;5339;14344;4725;13530;526;1574;3423;10058;3949;11632
292145;201308;2637;8285;2425;7951;213;692;1836;6284;2049;6976
292150;201308;13299;41356;12442;39971;917;3448;9832;31781;10749;35229
292160;201308;2659;7820;2294;7315;196;607;1878;6150;2074;6757
292170;201308;8564;26370;7411;24362;1110;4046;4778;15905;5888;19951
292180;201308;3448;10460;2885;9598;338;1203;2070;7006;2408;8209
292190;201308;3127;8957;2768;8456;563;1887;1786;5449;2349;7336
292200;201308;5436;18709;4958;17654;1618;6183;1867;6616;3485;12799
292205;201308;3985;12561;3681;12155;289;1104;2938;9690;3227;10794
292210;201308;6417;19204;5686;18199;574;1921;4434;14582;5008;16503
292220;201308;1891;5497;1797;5361;427;1223;1076;3262;1503;4485
292225;201308;2849;9329;2640;9002;216;775;2122;7351;2338;8126
292230;201308;6174;18809;5908;18391;728;2677;4468;13605;5196;16282
292240;201308;4259;13920;3982;13285;650;2329;2433;8066;3083;10395
292250;201308;5109;16026;4836;15511;1013;3390;2692;8728;3705;12118
292260;201308;2931;9638;2805;9439;335;1210;2150;7230;2485;8440
292265;201308;3061;10328;2809;9867;253;1036;2109;7381;2362;8417
292270;201308;3765;10715;3084;9915;291;1125;2447;7877;2738;9002
292273;201308;2740;6787;2122;5997;315;878;1489;4392;1804;5270
292275;201308;1882;4993;1768;4831;226;704;1333;3613;1559;4317
292280;201308;2015;6223;1873;6072;191;525;1482;5110;1673;5635
292285;201308;2490;7235;2232;6864;297;1009;1609;5049;1906;6058
292290;201308;7337;22626;6261;21245;307;1181;5286;18300;5593;19481
292300;201308;8174;25782;7259;24789;2372;8206;4020;14265;6392;22471
292303;201308;2727;8900;2562;8659;105;423;2237;7570;2342;7993
292305;201308;3112;8624;2954;8412;108;327;2662;7610;2770;7937
292310;201308;5811;18404;5361;17797;367;1278;4560;15290;4927;16568
292320;201308;5631;17956;5236;17268;593;2323;3979;12976;4572;15299
292330;201308;1905;5700;1800;5570;272;937;1326;4046;1598;4983
292335;201308;5178;13942;4762;13387;401;1161;4015;11350;4416;12511
292340;201308;6392;18972;5611;17766;537;1836;4197;13313;4734;15149
292350;201308;2026;6531;1914;6396;211;806;1521;5074;1732;5880
292360;201308;4784;14447;4631;13943;200;612;4043;12465;4243;13077
292370;201308;8190;26211;7502;25176;1010;3280;5320;18807;6330;22087
292380;201308;7212;21350;6833;20780;574;1626;5663;17461;6237;19087
292390;201308;3496;8187;3119;7779;110;220;2915;7352;3025;7572
292400;201308;21756;65358;20852;63913;3178;10356;14729;46058;17907;56414
292405;201308;4315;11911;3801;11287;274;837;3201;9629;3475;10466
292410;201308;1691;4969;1645;4916;132;461;1437;4246;1569;4707
292420;201308;3627;11956;3507;11819;183;518;3177;10957;3360;11475
292430;201308;5182;16877;4454;15923;322;1293;3552;12763;3874;14056
292440;201308;8469;28038;7989;27362;301;1177;7112;24653;7413;25830
292450;201308;4300;13078;3544;11864;348;1284;2548;8645;2896;9929
292460;201308;5557;17025;4975;15964;931;3102;3145;10210;4076;13312
292465;201308;2279;7173;1987;6698;251;979;1432;4847;1683;5826
292467;201308;2156;7137;2046;6945;440;1622;1289;4413;1729;6035
292470;201308;3143;8633;2651;7848;236;851;1998;5813;2234;6664
292480;201308;5689;16384;4938;15300;399;1421;4007;12451;4406;13872
292490;201308;2216;6513;1934;6091;223;842;1437;4466;1660;5308
292500;201308;6493;19938;5700;18571;592;2257;4195;13716;4787;15973
292510;201308;12892;38004;11574;36125;1176;4041;9038;28584;10214;32625
292520;201308;5512;17420;5163;16792;1560;5187;2534;8368;4094;13555
292525;201308;5420;14575;4784;13832;452;1409;3826;11177;4278;12586
292530;201308;24191;74206;22407;72136;4497;14929;14981;49681;19478;64610
292540;201308;2733;8398;2503;8051;534;1908;1605;5145;2139;7053
292550;201308;6052;20472;5527;19632;984;3671;3682;13363;4666;17034
292560;201308;4184;11744;3606;10989;314;1156;2930;8792;3244;9948
292570;201308;3887;11754;3799;11662;142;446;3315;10513;3457;10959
292575;201308;5848;20419;5703;20136;1224;4433;3754;13294;4978;17727
292580;201308;6981;21208;6545;20652;592;1920;5393;17207;5985;19127
292590;201308;7013;22987;6763;22551;1099;3594;4739;16163;5838;19757
292593;201308;3195;8625;2735;7945;257;780;2104;6102;2361;6882
292595;201308;5537;16444;5034;15767;478;1643;3885;12178;4363;13821
292600;201308;10311;29785;9822;29186;1397;3268;7815;24426;9212;27694
292610;201308;4290;12671;3607;11518;572;1930;2267;7372;2839;9302
292620;201308;5781;18316;5144;17568;382;1497;4536;15482;4918;16979
292630;201308;9787;25196;8620;23486;776;2249;6638;18312;7414;20561
292640;201308;8180;26886;7259;25666;660;2403;5692;20618;6352;23021
292650;201308;4609;13236;4465;13064;502;1131;3594;11221;4096;12352
292660;201308;10895;34038;10477;33404;1551;4959;7700;25193;9251;30152
292665;201308;2840;8604;2770;8496;101;285;2593;8020;2694;8305
292670;201308;3789;11018;3014;9715;370;1359;1985;6424;2355;7783
292680;201308;3497;10857;3355;10665;260;910;2839;8965;3099;9875
292690;201308;3320;9268;2460;7946;324;1170;1664;5455;1988;6625
292700;201308;8744;27688;7801;26369;1067;3456;5752;20290;6819;23746
292710;201308;1884;6314;1809;6202;110;423;1589;5450;1699;5873
292720;201308;9353;24733;8333;23566;793;2342;6895;19669;7688;22011
292730;201308;3277;10268;3184;10116;604;1841;2123;7009;2727;8850
292740;201308;342905;993711;327597;970829;80322;251644;195426;581344;275748;832988
292750;201308;5688;16132;5230;15529;414;1223;4255;12913;4669;14136
292760;201308;4175;13684;3864;13116;566;2117;2564;8802;3130;10919
292770;201308;5831;18425;5539;17967;1388;4559;3236;10912;4624;15471
292780;201308;1801;4671;1459;4262;216;758;1040;2980;1256;3738
292790;201308;3131;8857;3026;8740;271;662;2492;7571;2763;8233
292800;201308;9246;28568;8715;27706;957;3304;6732;21447;7689;24751
292805;201308;3032;9298;2820;8987;553;1925;1891;6105;2444;8030
292810;201308;9632;30312;8358;28620;1253;4436;6152;21603;7405;26039
292820;201308;7190;21225;5366;18659;454;1745;4348;15230;4802;16975
292830;201308;1823;5571;1671;5357;131;526;1352;4292;1483;4818
292840;201308;6584;23104;6127;22461;508;1946;5127;19010;5635;20956
292850;201308;3105;8457;2653;7777;376;1183;1841;5345;2217;6528
292860;201308;14912;41586;14421;40984;2028;5723;11203;32386;13231;38109
292870;201308;18100;52153;16347;49308;3356;11186;9510;28187;12866;39373
292880;201308;11470;35261;10467;33624;2031;6723;6530;21260;8561;27983
292890;201308;5306;18783;4840;17875;1044;4033;2734;10377;3778;14410
292895;201308;2669;7025;2268;6432;323;978;1691;4770;2014;5748
292900;201308;3015;9588;2847;9309;463;1788;1876;5902;2339;7690
292905;201308;3961;12188;3380;11429;356;1125;2746;9568;3102;10693
292910;201308;4939;15779;4623;15191;828;2928;2995;9774;3823;12702
292920;201308;7904;23836;7568;23329;759;2622;6069;18485;6828;21107
292925;201308;4997;16104;4482;15399;381;1426;3566;12316;3947;13742
292930;201308;6353;20899;6091;20399;889;3616;4335;14162;5224;17778
292935;201308;2070;5968;1773;5637;175;464;1424;4767;1599;5231
292937;201308;3267;8576;2807;7993;337;1082;2132;5995;2469;7077
292940;201308;3002;8556;2424;7758;296;958;1644;5487;1940;6445
292950;201308;8094;25094;7768;24554;1046;3935;5624;17266;6670;21201
292960;201308;4449;12967;4185;12554;503;1643;2962;8819;3465;10462
292970;201308;4152;13342;3861;12961;203;840;3279;11014;3482;11854
292975;201308;3197;9098;3100;8936;358;1078;2503;7242;2861;8320
292980;201308;3505;10153;2904;9434;413;1615;2015;6481;2428;8096
292990;201308;11809;34655;10995;33441;788;2524;9374;28607;10162;31131
293000;201308;2884;7848;2392;7212;137;480;2071;6224;2208;6704
293010;201308;17437;51830;15864;49238;3277;11153;9683;29840;12960;40993
293015;201308;7753;26042;6347;23957;1129;4581;4069;15341;5198;19922
293020;201308;9271;31224;8692;30376;649;2558;7172;25335;7821;27893
293030;201308;5446;16286;4476;14857;495;1778;3092;10591;3587;12369
293040;201308;3637;11879;3507;11733;252;914;3040;10188;3292;11102
293050;201308;18784;55175;16877;52635;2745;8742;11377;36542;14122;45284
293060;201308;4257;11048;3641;10068;430;1317;2511;6865;2941;8182
293070;201308;19085;59990;17994;58066;5078;17054;9500;31213;14578;48267
293075;201308;3511;11240;3210;10888;261;956;2734;9329;2995;10285
293076;201308;3647;10530;3430;10198;292;827;2876;8713;3168;9540
293077;201308;5131;16051;4486;15237;763;2787;2993;10227;3756;13014
293080;201308;4767;15215;4392;14576;352;1520;3451;11178;3803;12698
293090;201308;3531;11215;2929;10375;301;1103;2283;8209;2584;9312
293100;201308;5563;17524;4817;16208;488;1773;3650;12483;4138;14256
293105;201308;3773;12876;3361;12056;548;2063;2227;8110;2775;10173
293110;201308;1935;5912;1840;5749;111;418;1550;4823;1661;5241
293120;201308;3948;13551;3699;13199;357;1306;2953;10690;3310;11996
293130;201308;3907;11624;3208;10836;197;765;2806;9602;3003;10367
293135;201308;25450;70501;20787;64244;4118;15108;11134;33688;15252;48796
293140;201308;2040;6272;1984;6186;199;808;1546;4663;1745;5471
293150;201308;5797;19239;5279;18248;1093;3851;3145;11244;4238;15095
293160;201308;3338;9518;3183;9324;495;1165;2412;7458;2907;8623
293170;201308;3355;10499;3166;10206;474;1644;2299;7529;2773;9173
293180;201308;5308;15186;4498;13959;410;1518;3538;10819;3948;12337
293190;201308;13371;41585;12858;40766;647;2844;11110;34504;11757;37348
293200;201308;6050;18346;5463;17424;327;1214;4711;14928;5038;16142
293210;201308;4565;14279;4306;13843;579;1949;3044;9955;3623;11904
293220;201308;5008;15588;4625;15017;1193;4052;2477;8263;3670;12315
293230;201308;3906;12533;3636;12163;414;1607;2868;9530;3282;11137
293240;201308;4439;11773;3558;10582;193;584;2827;8425;3020;9009
293245;201308;4290;12845;3942;12263;516;1662;2786;8940;3302;10602
293250;201308;5863;17220;5476;16678;945;2993;3762;11594;4707;14587
293260;201308;4647;14269;3918;13219;366;1365;2946;10097;3312;11462
293270;201308;5716;16003;5449;15710;563;1546;4602;13501;5165;15047
293280;201308;5592;16206;4941;15351;434;1287;3877;12460;4311;13747
293290;201308;16078;55561;15431;54231;3358;12079;9311;33556;12669;45635
293300;201308;6093;15981;5319;15129;515;1428;4220;12207;4735;13635
293305;201308;4595;11936;4222;11439;414;1215;3335;9096;3749;10311
293310;201308;2652;7024;2210;6305;297;957;1489;4191;1786;5148
293315;201308;4766;12433;4307;11718;763;2042;2672;7678;3435;9720
293317;201308;2451;7533;2261;7179;329;1093;1474;4718;1803;5811
293320;201308;8035;26545;7837;26272;998;3640;6231;20815;7229;24455
293325;201308;1890;5623;1578;5131;302;1060;1000;3294;1302;4354
293330;201308;52921;171634;48052;163384;11092;40936;26753;92147;37845;133083
293340;201308;2669;7782;2158;6906;308;1119;1478;4646;1786;5765
293345;201308;3359;10420;2848;9674;363;1218;1987;7008;2350;8226
293350;201308;6562;18672;6323;18374;365;1014;5679;16752;6044;17766
293360;201308;13518;41716;12469;40322;778;2547;10621;35088;11399;37635
310010;201308;1222;3372;884;2822;247;941;392;1147;639;2088
310020;201308;3731;12098;3177;10827;1144;4212;616;1905;1760;6117
310030;201308;2370;8158;2156;7757;746;2803;898;3288;1644;6091
310040;201308;932;2687;797;2501;120;449;534;1631;654;2080
310050;201308;1885;6792;1665;6244;365;1592;795;2939;1160;4531
310060;201308;3031;10897;2927;10736;355;1356;2292;8551;2647;9907
310070;201308;310;945;234;798;39;166;100;309;139;475
310080;201308;740;2331;605;2064;175;691;193;606;368;1297
310090;201308;4465;14060;3982;13217;702;2597;2451;8148;3153;10745
310100;201308;3225;10320;2835;9730;413;1583;2002;6859;2415;8442
310110;201308;5785;16749;4915;15452;1148;4151;2651;8195;3799;12346
310120;201308;563;1899;538;1855;238;939;191;555;429;1494
310130;201308;454;1481;415;1420;118;459;205;668;323;1127
310140;201308;251;888;217;822;77;326;44;150;121;476
310150;201308;4565;14791;4187;14091;960;3698;2194;7323;3154;11021
310160;201308;6707;22303;5962;21009;1750;6890;2665;9211;4415;16101
310163;201308;675;2395;638;2320;166;702;291;1026;457;1728
310170;201308;9511;28008;8805;26895;1886;6189;5197;16411;7083;22600
310180;201308;1785;5341;1451;4871;392;1507;701;2280;1093;3787
310190;201308;2478;8449;2262;8079;691;2754;303;1077;994;3831
310200;201308;1822;6309;1549;5734;503;2019;509;1864;1012;3883
310205;201308;932;3037;852;2857;185;650;500;1706;685;2356
310210;201308;2366;7780;2195;7504;411;1528;1472;5031;1883;6559
310220;201308;1243;3603;1006;3302;180;644;651;2134;831;2778
310230;201308;2809;9501;2468;8738;805;3292;874;2811;1679;6103
310240;201308;996;3595;838;3269;145;624;455;1873;600;2497
310250;201308;952;3377;924;3332;191;797;571;1955;762;2752
310260;201308;3242;10832;2856;10038;939;3643;1051;3583;1990;7226
310270;201308;2252;7041;2069;6783;326;1204;1460;4817;1786;6021
310280;201308;2043;6165;1864;5870;687;2510;662;1912;1349;4422
310285;201308;2238;7965;2135;7821;277;948;1629;6192;1906;7140
310290;201308;1306;4217;1218;4081;401;1576;548;1621;949;3197
310300;201308;1827;6449;1737;6251;493;1953;955;3395;1448;5348
310310;201308;388;1104;288;894;57;195;148;453;205;648
310320;201308;349;1251;319;1175;87;353;145;532;232;885
310330;201308;475;1263;362;1059;48;172;209;564;257;736
310340;201308;8195;26715;7331;25286;1471;5345;4438;15791;5909;21136
310350;201308;13750;41977;11451;37690;4294;15307;2971;9840;7265;25147
310360;201308;421;1422;410;1402;106;419;245;795;351;1214
310370;201308;1376;5109;1326;5009;520;2009;511;1984;1031;3993
310375;201308;1260;3494;955;2970;149;566;533;1611;682;2177
310380;201308;392;1142;317;1030;143;519;116;338;259;857
310390;201308;473;1739;399;1565;124;533;67;237;191;770
310400;201308;9837;30289;7942;26821;2766;10282;2077;6857;4843;17139
310410;201308;1026;3350;678;2810;282;1265;125;500;407;1765
310420;201308;5508;16337;3200;10795;866;3294;494;1494;1360;4788
310430;201308;1558;5448;1324;4940;474;1888;348;1297;822;3185
310440;201308;620;1848;543;1727;160;582;203;601;363;1183
310445;201308;1158;4072;1000;3796;156;662;638;2464;794;3126
310450;201308;4300;13168;3641;12155;842;2979;2109;7237;2951;10216
310460;201308;1473;4931;1303;4613;474;1818;307;1149;781;2967
310470;201308;3709;9889;3151;9198;327;1126;2490;7225;2817;8351
310480;201308;980;3192;887;3015;228;890;405;1298;633;2188
310490;201308;3220;11132;2809;10323;978;3857;985;3699;1963;7556
310500;201308;1429;5130;1335;4938;459;1851;492;1784;951;3635
310510;201308;2467;8291;2163;7594;860;3298;488;1609;1348;4907
310520;201308;1247;3660;1117;3441;95;318;738;2285;833;2603
310530;201308;817;2684;548;1986;128;523;96;334;224;857
310540;201308;3596;12122;3346;11748;1192;4429;1237;4414;2429;8843
310550;201308;1100;3498;942;3227;320;1262;316;1002;636;2264
310560;201308;15442;49830;13562;46141;4708;17743;4553;14738;9261;32481
310570;201308;1262;3995;1188;3891;177;677;868;2789;1045;3466
310590;201308;3978;12054;3217;10541;716;2704;1149;3548;1865;6252
310600;201308;1605;5511;1535;5342;538;2084;511;1668;1049;3752
310610;201308;543;1907;500;1810;169;720;164;527;333;1247
310620;201308;182271;593407;150280;526597;43346;169127;56821;190633;100167;359760
310630;201308;4011;13560;3819;13184;941;3698;2259;7514;3200;11212
310640;201308;1427;4509;1170;4047;386;1454;373;1226;759;2680
310650;201308;2730;9307;2313;8634;469;1919;1334;5108;1803;7027
310660;201308;1267;4076;1138;3890;206;815;805;2681;1011;3496
310665;201308;1121;3636;1046;3535;207;742;686;2355;893;3097
310670;201308;54554;176116;50950;167853;16186;56587;22285;71880;38471;128467
310680;201308;799;2454;735;2354;164;581;411;1281;575;1862
310690;201308;1173;4102;990;3695;288;1263;250;868;538;2131
310700;201308;512;1455;438;1343;113;399;221;641;334;1040
310710;201308;7197;24269;6005;22509;1389;5658;3065;11904;4454;17562
310720;201308;819;2600;752;2489;223;840;359;1102;582;1942
310730;201308;9211;30084;8588;29095;1996;7352;5149;17482;7145;24834
310740;201308;4885;17111;4253;15748;1683;6766;1025;3618;2708;10384
310750;201308;1542;4137;1292;3796;261;815;801;2347;1062;3162
310760;201308;607;1970;531;1836;138;510;229;781;367;1291
310770;201308;673;2589;666;2578;222;902;344;1345;566;2247
310780;201308;3534;10515;3247;10031;463;1384;2271;7161;2734;8545
310790;201308;1651;5534;1553;5380;490;1753;797;2842;1287;4595
310800;201308;3002;10028;2474;8944;1074;4218;387;1387;1461;5605
310810;201308;1505;4285;1402;4120;367;1212;689;1939;1056;3151
310820;201308;1439;4241;1089;3635;332;1206;353;1124;685;2330
310825;201308;2253;8065;1910;7464;177;897;1412;5470;1589;6367
310830;201308;1460;5093;1248;4649;481;1930;384;1391;865;3321
310840;201308;2167;7444;1986;7068;766;2992;569;1892;1335;4884
310850;201308;1429;4585;1255;4348;238;943;828;2822;1066;3765
310855;201308;3017;10158;2769;9751;778;2877;1449;5284;2227;8161
310860;201308;7566;24481;6838;23244;1221;4396;4033;14114;5254;18510
310870;201308;982;2946;859;2717;211;730;384;1204;595;1934
310880;201308;1226;3886;939;3342;205;832;447;1575;652;2407
310890;201308;2651;8679;2108;7614;661;2678;453;1542;1114;4220
310900;201308;4061;14146;3632;13230;1166;4674;1399;4918;2565;9592
310910;201308;1806;5532;1429;4849;434;1633;383;1264;817;2897
310920;201308;1785;5790;1490;5347;412;1682;715;2550;1127;4232
310925;201308;912;3109;826;2954;321;1260;238;844;559;2104
310930;201308;4750;15218;4158;14243;1013;3617;2321;8120;3334;11737
310940;201308;6102;18599;5342;17437;1061;3881;3007;9752;4068;13633
310945;201308;1250;3655;1013;3322;238;907;540;1690;778;2597
310950;201308;1806;6371;1534;5803;636;2620;415;1504;1051;4124
310960;201308;444;1550;394;1452;142;573;129;478;271;1051
310970;201308;1454;5202;1119;4263;450;1855;137;476;587;2331
310980;201308;444;1192;319;963;62;223;141;378;203;601
310990;201308;1119;3939;981;3666;227;971;362;1261;589;2232
311000;201308;4557;16239;4080;15214;1341;5540;1452;5209;2793;10749
311010;201308;935;3086;829;2887;266;990;377;1277;643;2267
311020;201308;864;2784;746;2585;91;372;495;1687;586;2059
311030;201308;1672;5381;1422;4840;490;1855;515;1567;1005;3422
311040;201308;477;1654;413;1480;127;471;110;383;237;854
311050;201308;2493;8243;2102;7422;704;2717;787;2765;1491;5482
311060;201308;2201;7150;1847;6370;558;2054;432;1448;990;3502
311070;201308;1699;6159;1496;5721;465;1993;466;1760;931;3753
311080;201308;1192;3266;1073;3086;171;557;707;2053;878;2610
311090;201308;1622;6342;1427;5931;524;2431;329;1325;853;3756
311100;201308;2242;8085;2037;7660;964;3759;503;1925;1467;5684
311110;201308;3663;9259;2813;8125;649;2140;1478;4116;2127;6256
311115;201308;1068;3382;931;3170;116;487;631;2172;747;2659
311120;201308;8234;24989;7021;22788;2481;9036;2068;6268;4549;15304
311130;201308;2366;7350;1932;6790;687;2745;775;2594;1462;5339
311140;201308;1215;3625;1052;3425;196;754;710;2251;906;3005
311150;201308;2393;8081;2213;7793;483;1695;1318;4844;1801;6539
311160;201308;4790;16451;4113;15330;1521;6055;1331;4901;2852;10956
311170;201308;733;2359;601;2102;76;301;370;1343;446;1644
311180;201308;1552;4419;1126;3565;358;1243;223;616;581;1859
311190;201308;1083;3356;926;3027;234;872;418;1308;652;2180
311200;201308;2482;7817;2187;7216;964;3468;512;1517;1476;4985
311205;201308;1171;3902;1047;3656;266;1058;392;1433;658;2491
311210;201308;894;2973;829;2869;150;515;588;2093;738;2608
311220;201308;886;2917;716;2530;186;685;250;878;436;1563
311230;201308;8699;27226;7546;25252;1672;6135;3964;13562;5636;19697
311240;201308;1326;4184;1122;3833;392;1501;322;1039;714;2540
311250;201308;1304;4428;1182;4212;371;1440;375;1205;746;2645
311260;201308;2903;8055;2194;6777;713;2418;657;1916;1370;4334
311265;201308;1290;3582;1033;3247;152;595;738;2296;890;2891
311270;201308;3280;11266;2989;10876;614;2588;1926;6914;2540;9502
311280;201308;1346;3837;1043;3306;290;1020;319;973;609;1993
311290;201308;2285;7640;2117;7277;405;1374;1231;4432;1636;5806
311300;201308;4921;16908;4528;16312;747;3066;2961;10704;3708;13770
311310;201308;485;1765;465;1730;108;484;200;688;308;1172
311320;201308;3947;13605;3454;12482;1019;4148;1109;3782;2128;7930
311330;201308;5349;16902;4685;15867;1735;6313;1737;5850;3472;12163
311340;201308;11687;38936;10845;37274;4111;15242;3123;10665;7234;25907
311350;201308;2175;6784;1913;6330;478;1848;869;2749;1347;4597
311360;201308;1301;3749;1040;3394;475;1627;291;976;766;2603
311370;201308;4372;13593;3969;12889;1064;4176;1702;5248;2766;9424
311380;201308;457;1565;391;1433;139;573;112;370;251;943
311390;201308;1907;7251;1831;7088;808;3445;547;2025;1355;5470
311400;201308;1673;5708;1552;5489;479;1915;661;2157;1140;4072
311410;201308;1974;7293;1855;7121;694;2853;834;3217;1528;6070
311420;201308;2183;7858;1997;7396;780;3066;430;1423;1210;4489
311430;201308;3688;12014;2897;10221;711;2761;561;1926;1272;4687
311440;201308;2121;7615;1815;7132;855;3720;436;1672;1291;5392
311450;201308;2345;8505;2095;7942;825;3360;631;2289;1456;5649
311455;201308;1504;4209;1338;3962;295;995;746;2149;1041;3144
311460;201308;595;2022;484;1774;126;573;124;434;250;1007
311470;201308;578;1881;473;1663;150;619;141;458;291;1077
311480;201308;776;2291;752;2249;243;771;349;998;592;1769
311490;201308;309;1260;299;1222;107;455;101;416;208;871
311500;201308;493;1540;402;1357;174;643;120;388;294;1031
311510;201308;3026;9749;2553;8851;990;3840;666;2161;1656;6001
311520;201308;677;2360;642;2287;261;997;245;849;506;1846
311530;201308;10158;28363;7275;23058;2241;8372;2034;6066;4275;14438
311535;201308;658;2107;500;1778;137;554;120;414;257;968
311540;201308;681;2533;651;2484;239;941;292;1124;531;2065
311545;201308;1982;6640;1924;6543;383;1431;1266;4299;1649;5730
311547;201308;1630;4671;1405;4316;159;530;960;2984;1119;3514
311550;201308;3206;10835;2875;10191;1019;4040;906;3130;1925;7170
311560;201308;254;702;235;678;65;212;132;359;197;571
311570;201308;1918;5034;1687;4783;134;407;1442;4117;1576;4524
311580;201308;2041;4901;1875;4708;579;1402;1084;2797;1663;4199
311590;201308;351;1174;311;1116;90;380;85;298;175;678
311600;201308;1301;4006;1131;3781;241;800;660;2352;901;3152
311610;201308;3584;12553;3326;12138;946;3436;1669;6575;2615;10011
311615;201308;2498;8634;2244;8205;290;1139;1612;5978;1902;7117
311620;201308;436;1446;392;1381;110;458;190;627;300;1085
311630;201308;1447;4387;1241;3991;295;953;649;2118;944;3071
311640;201308;864;2725;736;2514;101;378;554;1889;655;2267
311650;201308;2405;7080;2023;6450;333;1217;1193;3846;1526;5063
311660;201308;2477;9005;2241;8434;696;2939;507;1675;1203;4614
311670;201308;1308;4257;1172;4000;466;1760;442;1437;908;3197
311680;201308;2212;7163;1892;6722;437;1672;1108;4020;1545;5692
311690;201308;491;1416;426;1347;90;318;263;814;353;1132
311700;201308;2107;6369;1905;6076;217;865;1443;4511;1660;5376
311710;201308;1587;5150;1293;4600;574;2216;350;1233;924;3449
311720;201308;393;1379;373;1344;78;283;242;865;320;1148
311730;201308;4568;12854;3122;10223;965;3476;1104;3382;2069;6858
311740;201308;1000;2930;874;2781;383;1216;376;1274;759;2490
311750;201308;3743;13045;3516;12732;615;2491;2356;8539;2971;11030
311760;201308;788;2782;735;2659;263;1104;224;668;487;1772
311770;201308;2573;8332;2153;7597;651;2578;712;2426;1363;5004
311780;201308;941;3656;816;3322;293;1327;111;433;404;1760
311783;201308;2024;6823;1818;6440;212;933;1196;4331;1408;5264
311787;201308;678;2374;518;1912;118;459;113;375;231;834
311790;201308;1183;3981;997;3585;305;1177;213;740;518;1917
311800;201308;3825;13485;2783;10140;857;3336;307;927;1164;4263
311810;201308;1021;3497;992;3445;42;205;874;2989;916;3194
311820;201308;808;2716;695;2459;243;976;301;969;544;1945
311830;201308;10121;37254;9404;35415;4005;15857;2141;7976;6146;23833
311840;201308;3358;10266;2877;9523;1030;3725;1033;3339;2063;7064
311850;201308;305;950;264;884;72;262;122;401;194;663
311860;201308;54374;179521;48773;168434;15339;57622;19906;66930;35245;124552
311870;201308;2255;6975;1877;6253;516;1956;653;2067;1169;4023
311880;201308;6673;21212;6211;20615;927;3201;4473;15318;5400;18519
311890;201308;1562;5073;1336;4599;443;1681;523;1741;966;3422
311900;201308;781;2491;705;2379;160;555;423;1489;583;2044
311910;201308;4612;14029;3800;12867;1229;4536;1500;5122;2729;9658
311920;201308;1992;6743;1749;6394;228;962;1250;4518;1478;5480
311930;201308;4632;14391;4207;13694;1603;5672;1365;4416;2968;10088
311940;201308;13208;41926;11722;38863;4244;15362;3123;10044;7367;25406
311950;201308;2178;6750;1922;6421;154;530;1601;5398;1755;5928
311960;201308;363;1315;333;1251;122;492;117;423;239;915
311970;201308;454;1684;403;1579;153;653;67;244;220;897
311980;201308;736;2104;577;1871;136;469;268;897;404;1366
311990;201308;456;1469;426;1416;181;616;145;472;326;1088
311995;201308;997;3141;787;2683;238;913;226;670;464;1583
312000;201308;668;2163;641;2121;119;458;377;1241;496;1699
312010;201308;1012;3313;933;3163;203;753;428;1441;631;2194
312015;201308;1540;4900;1347;4567;210;852;822;2783;1032;3635
312020;201308;900;2998;810;2869;230;914;420;1447;650;2361
312030;201308;1717;5402;1558;5195;321;1198;1043;3414;1364;4612
312040;201308;686;2699;635;2558;249;1090;174;687;423;1777
312050;201308;1472;5192;1283;4785;465;1921;329;1173;794;3094
312060;201308;746;2336;676;2252;218;799;377;1212;595;2011
312070;201308;909;2912;619;2258;183;735;218;773;401;1508
312080;201308;2581;7422;2049;6558;530;2059;921;2660;1451;4719
312083;201308;885;2708;760;2527;96;382;484;1590;580;1972
312087;201308;2231;7089;2010;6795;407;1455;1335;4580;1742;6035
312090;201308;9564;31879;8854;30627;2778;10725;3712;12256;6490;22981
312100;201308;1336;4624;1200;4414;278;1146;651;2446;929;3592
312110;201308;1148;4221;1039;3988;399;1670;199;702;598;2372
312120;201308;879;3135;799;2953;266;1119;201;642;467;1761
312125;201308;1139;3792;1017;3508;273;1042;410;1387;683;2429
312130;201308;750;2377;624;2115;176;675;227;732;403;1407
312140;201308;1348;4338;1159;3889;298;1066;425;1349;723;2415
312150;201308;573;1682;510;1569;89;323;309;910;398;1233
312160;201308;7743;27522;7186;26350;2396;9523;2662;9954;5058;19477
312170;201308;1005;3126;927;2972;161;561;575;1874;736;2435
312180;201308;1549;4977;1465;4846;478;1662;586;1946;1064;3608
312190;201308;618;2107;500;1875;212;888;98;334;310;1222
312200;201308;4457;14145;3944;13211;580;2082;2625;8837;3205;10919
312210;201308;1122;3196;920;2911;251;899;432;1302;683;2201
312220;201308;1821;6172;1659;5982;302;1107;1172;4427;1474;5534
312230;201308;17167;59154;14835;54257;7231;28050;2647;9978;9878;38028
312235;201308;1731;5070;1434;4592;210;807;949;3047;1159;3854
312240;201308;1091;3816;940;3494;295;1171;312;1159;607;2330
312245;201308;2336;7003;2054;6611;177;515;1684;5570;1861;6085
312247;201308;871;2677;699;2419;221;819;339;1216;560;2035
312250;201308;1106;3390;1003;3216;212;768;520;1631;732;2399
312260;201308;883;2999;771;2851;116;530;540;1966;656;2496
312270;201308;775;2538;677;2340;188;785;220;634;408;1419
312280;201308;465;1626;424;1520;179;691;45;156;224;847
312290;201308;707;2524;662;2462;308;1270;130;483;438;1753
312300;201308;1056;3606;914;3278;312;1186;127;397;439;1583
312310;201308;914;3601;830;3381;280;1235;334;1330;614;2565
312320;201308;2386;6861;1987;6099;576;2034;596;1548;1172;3582
312330;201308;1092;3465;1002;3325;364;1364;412;1336;776;2700
312340;201308;305;824;285;794;54;200;197;502;251;702
312350;201308;363;968;344;942;52;169;271;705;323;874
312352;201308;1577;5387;1484;5250;506;1831;777;2820;1283;4651
312360;201308;3569;12406;3148;11506;1078;4222;730;2655;1808;6877
312370;201308;1614;5426;1500;5221;522;2021;550;1841;1072;3862
312380;201308;1907;5803;1792;5628;280;954;1210;3900;1490;4854
312385;201308;1166;3810;1111;3709;160;653;776;2501;936;3154
312390;201308;1983;6886;1761;6429;614;2420;404;1426;1018;3846
312400;201308;3275;11224;3051;10804;1046;3814;1385;5056;2431;8870
312410;201308;10154;35139;9202;33152;3015;11783;3064;10776;6079;22559
312420;201308;3897;12941;3724;12738;699;2469;2584;9078;3283;11547
312430;201308;8272;25470;7346;24077;1492;5125;4561;15486;6053;20611
312440;201308;545;1866;483;1745;175;677;171;600;346;1277
312450;201308;1119;4276;1056;4130;505;1975;331;1324;836;3299
312460;201308;383;1205;343;1155;90;357;163;509;253;866
312470;201308;724;2130;503;1676;145;559;97;310;242;869
312480;201308;1251;4008;1094;3820;422;1546;448;1547;870;3093
312490;201308;2302;6153;1848;5559;296;1063;1113;3242;1409;4305
312500;201308;584;2117;552;2059;159;683;270;979;429;1662
312510;201308;1835;6611;1644;6155;505;2144;516;1734;1021;3878
312520;201308;359;1289;329;1222;120;472;109;412;229;884
312530;201308;552;1891;527;1835;113;462;282;933;395;1395
312540;201308;1445;4792;1217;4331;234;934;701;2453;935;3387
312550;201308;582;1983;537;1872;76;306;342;1158;418;1464
312560;201308;2054;5715;1842;5439;267;857;1335;4006;1602;4863
312570;201308;2606;8304;2324;7771;785;2844;689;2219;1474;5063
312580;201308;515;1774;422;1581;112;488;170;602;282;1090
312590;201308;1793;6292;1590;5841;565;2325;529;1784;1094;4109
312595;201308;1981;6924;1791;6460;398;1538;962;3428;1360;4966
312600;201308;745;2800;696;2684;227;975;252;908;479;1883
312610;201308;8315;26812;7211;24600;2756;10125;2037;6716;4793;16841
312620;201308;1940;5856;1528;5334;110;362;1267;4611;1377;4973
312630;201308;486;1671;457;1619;129;528;199;661;328;1189
312640;201308;556;1880;469;1691;115;482;191;632;306;1114
312650;201308;2301;7036;1669;5813;194;813;885;3041;1079;3854
312660;201308;1201;3477;1041;3262;210;787;627;1899;837;2686
312670;201308;5832;18775;5491;18228;1098;4277;3372;10955;4470;15232
312675;201308;1425;4660;1291;4390;283;1047;685;2360;968;3407
312680;201308;1685;5270;1508;4960;263;994;888;2951;1151;3945
312690;201308;2363;6662;1984;6133;425;1554;1085;3195;1510;4749
312695;201308;868;3184;818;3109;141;562;548;2131;689;2693
312700;201308;2114;6358;1629;5405;348;1329;815;2647;1163;3976
312705;201308;1357;4162;1209;3961;214;723;810;2682;1024;3405
312707;201308;1790;5659;1514;5183;328;1275;751;2573;1079;3848
312710;201308;7785;22784;5959;19518;2385;8681;1395;4231;3780;12912
312720;201308;732;2525;666;2402;202;808;264;897;466;1705
312730;201308;1829;4788;1434;4348;226;807;908;2756;1134;3563
312733;201308;1729;4799;1405;4208;128;478;986;2856;1114;3334
312735;201308;841;2647;749;2496;272;968;322;1057;594;2025
312737;201308;981;2463;725;2115;171;520;391;1198;562;1718
312738;201308;496;1646;405;1471;146;627;147;471;293;1098
312740;201308;492;1435;339;1230;124;496;95;339;219;835
312750;201308;1271;4768;1219;4662;339;1444;570;2154;909;3598
312760;201308;2315;7806;1906;7019;655;2672;456;1694;1111;4366
312770;201308;42651;121067;33743;107645;10449;36231;11064;35300;21513;71531
312780;201308;2470;9255;2232;8849;498;2153;1287;5258;1785;7411
312790;201308;318;917;243;796;81;284;67;208;148;492
312800;201308;4919;17372;4400;16267;1501;5975;1377;5172;2878;11147
312810;201308;2134;6735;1662;5959;654;2553;404;1384;1058;3937
312820;201308;2033;6342;1939;6177;282;1070;1252;3845;1534;4915
312825;201308;1493;4180;1330;3977;142;465;1057;3145;1199;3610
312830;201308;2601;8582;1945;7261;649;2726;259;899;908;3625
312840;201308;1106;3810;941;3483;254;1079;331;1154;585;2233
312850;201308;674;2280;598;2118;189;758;193;669;382;1427
312860;201308;1306;3846;1017;3413;366;1438;361;1061;727;2499
312870;201308;5494;17725;4339;15554;1364;5535;1192;4046;2556;9581
312880;201308;1104;3418;937;3130;302;1154;379;1151;681;2305
312890;201308;1511;4805;1221;4276;461;1799;391;1306;852;3105
312900;201308;1302;4547;1270;4504;474;1710;586;2134;1060;3844
312910;201308;1447;3465;1178;3107;333;1054;540;1306;873;2360
312920;201308;954;3185;844;3014;303;1194;327;1125;630;2319
312930;201308;2137;6570;1930;6256;454;1583;1009;3334;1463;4917
312940;201308;905;3135;811;2949;248;1053;246;830;494;1883
312950;201308;3390;9842;2784;8938;989;3459;1128;3624;2117;7083
312960;201308;1856;5848;1672;5599;228;780;1239;4250;1467;5030
312965;201308;1702;5694;1499;5324;356;1361;816;2969;1172;4330
312970;201308;1108;3888;996;3736;447;1872;168;629;615;2501
312980;201308;20249;72952;19575;71327;7917;30764;7164;25446;15081;56210
312990;201308;372;1186;296;1049;114;457;87;294;201;751
313000;201308;496;1760;458;1688;153;658;134;439;287;1097
313005;201308;2503;8426;2238;7980;348;1440;1491;5280;1839;6720
313010;201308;3827;13232;3453;12581;1128;4515;1362;4680;2490;9195
313020;201308;1018;3520;937;3352;314;1286;331;1043;645;2329
313030;201308;1540;4476;1259;4078;346;1270;657;2023;1003;3293
313040;201308;949;3401;807;2983;212;863;205;724;417;1587
313050;201308;1795;6056;1524;5615;518;2096;508;1793;1026;3889
313055;201308;1421;4946;1341;4826;144;517;1019;3791;1163;4308
313060;201308;909;3264;864;3165;425;1598;148;549;573;2147
313065;201308;1870;6432;1751;6253;261;1086;1283;4518;1544;5604
313070;201308;1142;3549;981;3252;263;1042;506;1563;769;2605
313080;201308;441;1455;369;1310;118;480;95;278;213;758
313090;201308;5033;15940;4810;15554;852;2990;3201;10491;4053;13481
313100;201308;1039;3452;977;3363;176;696;666;2233;842;2929
313110;201308;1636;5050;1314;4441;350;1415;519;1624;869;3039
313115;201308;2806;10163;2679;9896;929;3797;1145;3985;2074;7782
313120;201308;3736;11059;3216;10283;1187;4010;1306;4254;2493;8264
313130;201308;25345;83225;23154;78606;7190;27071;8421;27128;15611;54199
313140;201308;737;1962;544;1650;59;224;336;995;395;1219
313150;201308;1624;5197;1477;4932;667;2300;408;1413;1075;3713
313160;201308;1153;3548;1043;3380;247;936;592;1829;839;2765
313170;201308;9457;35609;8839;34042;3676;14752;1920;7458;5596;22210
313180;201308;2638;7149;2068;6416;679;2372;704;2125;1383;4497
313190;201308;3379;12798;3263;12526;974;3952;1381;5325;2355;9277
313200;201308;1457;4710;1306;4467;208;868;821;2790;1029;3658
313210;201308;4503;14683;3883;13835;983;3934;2020;7110;3003;11044
313220;201308;1156;3672;962;3277;281;1100;240;723;521;1823
313230;201308;2434;8867;2325;8694;429;1697;1459;5657;1888;7354
313240;201308;7477;26752;6625;25062;2091;8595;2580;9758;4671;18353
313250;201308;7506;24441;6982;23691;999;3354;4879;17236;5878;20590
313260;201308;567;1863;488;1704;152;606;137;456;289;1062
313270;201308;5297;16281;4857;15610;988;3358;3092;10084;4080;13442
313280;201308;510;1778;443;1619;113;479;164;577;277;1056
313290;201308;1027;3789;878;3470;292;1244;222;810;514;2054
313300;201308;1919;6726;1694;6169;564;2226;430;1471;994;3697
313310;201308;1036;3737;954;3555;290;1221;223;776;513;1997
313320;201308;2321;7314;1999;6741;472;1691;840;2852;1312;4543
313330;201308;3785;12960;3440;12296;769;3096;1700;6083;2469;9179
313340;201308;2139;5287;1680;4636;372;1107;948;2552;1320;3659
313350;201308;3275;10460;2576;8881;734;2740;498;1554;1232;4294
313360;201308;1163;3669;906;3158;324;1313;358;1108;682;2421
313370;201308;1417;5074;1352;4891;306;1272;592;1987;898;3259
313375;201308;1918;5294;1341;4479;312;1270;607;1995;919;3265
313380;201308;6509;22908;5712;21150;2381;9435;1451;5073;3832;14508
313390;201308;884;3324;848;3261;139;637;544;2047;683;2684
313400;201308;3643;11097;3374;10769;437;1494;2576;8317;3013;9811
313410;201308;1346;3965;1159;3711;256;913;700;2223;956;3136
313420;201308;18572;47487;12253;36000;3150;10541;3180;8932;6330;19473
313430;201308;1283;4307;1160;4087;382;1500;409;1391;791;2891
313440;201308;6332;15642;4886;13968;805;2506;3445;9881;4250;12387
313450;201308;685;2094;582;1898;166;667;200;569;366;1236
313460;201308;2635;9584;2388;9127;902;3728;724;2639;1626;6367
313470;201308;3370;9689;3227;9523;383;1039;2642;8006;3025;9045
313480;201308;1115;3410;863;2949;185;715;365;1207;550;1922
313490;201308;1288;4716;1081;4292;470;1840;216;894;686;2734
313500;201308;429;1409;408;1372;101;390;237;774;338;1164
313505;201308;8605;26053;8141;25478;555;1384;7165;23214;7720;24598
313507;201308;1283;3974;1163;3789;275;1016;662;2168;937;3184
313510;201308;15533;47536;14076;45698;2593;8825;9662;32003;12255;40828
313520;201308;15639;48849;13612;45589;2055;8041;9093;30296;11148;38337
313530;201308;520;1855;460;1705;72;308;203;711;275;1019
313535;201308;2453;7591;2215;7198;406;1418;1373;4528;1779;5946
313540;201308;1139;3661;936;3170;282;1025;256;807;538;1832
313545;201308;1360;5101;1216;4845;237;1111;751;2904;988;4015
313550;201308;1905;6701;1839;6559;516;2010;971;3337;1487;5347
313560;201308;2251;5742;2006;5459;223;592;1585;4465;1808;5057
313570;201308;774;2950;690;2772;272;1185;252;986;524;2171
313580;201308;5977;17591;5347;16758;691;2312;4043;12805;4734;15117
313590;201308;1054;3251;871;3036;347;1222;450;1632;797;2854
313600;201308;3803;11861;3403;11219;690;2548;2031;6745;2721;9293
313610;201308;1141;3666;989;3359;281;1045;402;1342;683;2387
313620;201308;7366;25192;6956;24306;2440;9092;2339;8027;4779;17119
313630;201308;8213;26626;7292;25247;2402;9092;2519;9079;4921;18171
313640;201308;832;2726;739;2601;278;1053;283;987;561;2040
313650;201308;2268;7592;2025;7189;303;1121;1457;5298;1760;6419
313652;201308;993;3646;917;3482;180;731;549;2094;729;2825
313655;201308;934;3230;799;3005;209;902;470;1711;679;2613
313657;201308;1077;3812;1030;3726;180;836;645;2113;825;2949
313660;201308;862;3097;800;2988;226;982;404;1432;630;2414
313665;201308;3552;12163;3340;11719;916;3642;1537;5160;2453;8802
313670;201308;51199;153596;37383;130180;12813;48594;11601;39423;24414;88017
313680;201308;1092;3328;968;3137;128;436;685;2244;813;2680
313690;201308;886;3263;832;3173;244;942;338;1354;582;2296
313695;201308;1463;4963;1272;4656;199;855;892;3232;1091;4087
313700;201308;3734;12976;3249;12286;490;1972;2321;8863;2811;10835
313710;201308;1370;3953;1174;3675;380;1324;568;1698;948;3022
313720;201308;5106;17692;4515;16377;1305;5299;1420;4655;2725;9954
313730;201308;1230;3534;1015;3259;147;517;683;2221;830;2738
313740;201308;2018;7505;1679;6588;641;2820;224;817;865;3637
313750;201308;2882;9086;2567;8480;858;3108;702;2137;1560;5245
313753;201308;1785;5570;1546;5149;500;1795;616;2069;1116;3864
313760;201308;4462;15242;3873;13981;1365;5474;1143;3899;2508;9373
313770;201308;3572;12328;3412;11956;1259;4670;1024;3597;2283;8267
313780;201308;3782;11220;3096;10179;918;3400;1282;4112;2200;7512
313790;201308;549;1959;532;1930;112;432;312;1145;424;1577
313800;201308;1240;3608;1114;3402;189;667;691;2095;880;2762
313810;201308;1417;4542;1369;4466;277;935;866;2889;1143;3824
313820;201308;12668;38333;10521;34401;3376;12212;3477;11357;6853;23569
313830;201308;471;1678;407;1536;149;633;119;432;268;1065
313835;201308;1060;3648;1021;3582;238;913;562;1968;800;2881
313840;201308;7146;22442;6222;20917;1971;7433;2133;6925;4104;14358
313850;201308;1233;3547;1131;3368;253;887;647;1824;900;2711
313860;201308;2547;8209;2242;7564;711;2658;545;1674;1256;4332
313862;201308;975;2824;713;2385;237;863;190;615;427;1478
313865;201308;2187;7136;2052;6902;321;1249;1441;4770;1762;6019
313867;201308;989;3526;854;3236;302;1198;287;1112;589;2310
313868;201308;1491;5477;1367;5214;195;840;887;3410;1082;4250
313870;201308;912;2889;808;2714;221;865;353;1104;574;1969
313880;201308;2247;7354;2059;7081;505;2061;1048;3318;1553;5379
313890;201308;1955;5534;1688;5199;300;933;1088;3429;1388;4362
313900;201308;4542;17073;4290;16531;1730;7324;1147;4393;2877;11717
313910;201308;752;2621;647;2392;290;1177;128;433;418;1610
313920;201308;3528;11746;3298;11332;531;1844;2161;7779;2692;9623
313925;201308;2099;5735;1593;4809;143;496;1073;3219;1216;3715
313930;201308;5153;17488;4421;16224;859;3485;2580;9651;3439;13136
313940;201308;7720;27595;6754;26011;2596;10722;2361;9362;4957;20084
313950;201308;4630;14004;3946;12865;1256;4610;1361;4258;2617;8868
313960;201308;5796;16388;4914;15133;1725;5959;1310;4031;3035;9990
313970;201308;1464;4436;1249;4192;273;994;777;2630;1050;3624
313980;201308;1178;4021;1020;3722;322;1315;279;977;601;2292
313990;201308;1995;7726;1805;7298;695;3035;512;1954;1207;4989
314000;201308;7743;27620;7213;26579;2196;8850;3638;13276;5834;22126
314010;201308;1039;3138;873;2930;176;693;454;1468;630;2161
314015;201308;1578;6023;1460;5747;561;2322;423;1683;984;4005
314020;201308;482;1604;414;1450;154;595;124;411;278;1006
314030;201308;825;2721;661;2338;162;671;209;667;371;1338
314040;201308;658;2014;585;1885;193;673;290;895;483;1568
314050;201308;1864;6245;1572;5633;503;2019;436;1424;939;3443
314053;201308;1381;4848;1324;4772;244;845;941;3505;1185;4350
314055;201308;2195;6735;1988;6445;224;734;1486;4946;1710;5680
314060;201308;1069;3522;935;3277;147;611;565;1944;712;2555
314070;201308;3601;11922;2986;10632;949;3748;819;2786;1768;6534
314080;201308;1803;5790;1348;4800;325;1299;338;1100;663;2399
314085;201308;1797;6516;1579;6211;554;2411;593;2353;1147;4764
314090;201308;3448;12093;3164;11540;1072;4211;1186;4422;2258;8633
314100;201308;3416;9510;3017;8933;401;1202;2255;6813;2656;8015
314110;201308;4355;14773;3850;13683;1056;4316;1443;4729;2499;9045
314120;201308;970;2404;554;1759;206;754;139;405;345;1159
314130;201308;666;1999;422;1440;118;457;82;244;200;701
314140;201308;4945;15968;4522;15182;1120;4052;2308;7816;3428;11868
314150;201308;1675;4627;1354;4143;234;801;821;2476;1055;3277
314160;201308;2250;6410;1936;6008;188;651;1571;4906;1759;5557
314170;201308;1033;3340;898;3048;183;729;475;1527;658;2256
314180;201308;6339;21089;5824;20309;1699;6471;2654;9402;4353;15873
314190;201308;803;2609;715;2462;231;909;269;881;500;1790
314200;201308;2997;10034;2748;9585;469;1864;1826;6286;2295;8150
314210;201308;1909;6241;1725;5884;465;1712;816;2710;1281;4422
314220;201308;1667;5629;1450;5167;519;2049;387;1209;906;3258
314225;201308;1158;3642;1049;3486;69;186;939;3189;1008;3375
314230;201308;698;2486;649;2386;210;833;228;807;438;1640
314240;201308;1105;3619;1005;3455;258;865;599;2136;857;3001
314250;201308;495;1591;425;1453;157;592;137;424;294;1016
314260;201308;1290;4762;1239;4657;431;1721;513;1955;944;3676
314270;201308;2676;9545;2529;9278;381;1533;1658;6135;2039;7668
314280;201308;3173;9366;2362;7821;761;2907;663;1940;1424;4847
314290;201308;5263;15316;4565;14206;649;2208;3200;9982;3849;12190
314300;201308;1905;6622;1797;6364;643;2436;689;2382;1332;4818
314310;201308;6312;20890;5614;19389;2385;8775;1243;4157;3628;12932
314315;201308;964;3733;897;3600;163;736;521;2124;684;2860
314320;201308;3248;10257;2722;9510;1025;3906;913;3110;1938;7016
314330;201308;51465;172304;49028;167831;16112;59853;21832;73867;37944;133720
314340;201308;2194;6336;1306;4473;356;1383;164;380;520;1763
314345;201308;1274;4482;1140;4266;381;1475;538;2113;919;3588
314350;201308;1270;4064;1103;3771;486;1795;276;923;762;2718
314360;201308;695;2273;536;1959;169;712;129;440;298;1152
314370;201308;544;1985;513;1945;171;708;255;950;426;1658
314380;201308;995;3204;808;2890;341;1270;224;809;565;2079
314390;201308;14916;46691;12594;42153;4273;15509;3707;12159;7980;27668
314400;201308;5269;15336;4363;14069;1209;3842;2615;8810;3824;12652
314410;201308;2461;8294;2210;7784;725;2859;848;2816;1573;5675
314420;201308;762;2292;630;2106;98;401;465;1528;563;1929
314430;201308;8072;24697;7269;23211;2562;8912;2258;7353;4820;16265
314435;201308;1127;3923;1024;3706;222;992;553;1891;775;2883
314437;201308;1143;3029;1034;2873;102;294;811;2261;913;2555
314440;201308;739;2077;520;1789;204;781;114;369;318;1150
314450;201308;1707;5214;1476;4879;480;1862;677;2085;1157;3947
314460;201308;4554;16225;4087;15184;1475;5965;792;2965;2267;8930
314465;201308;2348;7720;2160;7370;241;990;1621;5437;1862;6427
314467;201308;1068;3201;958;3021;424;1380;353;1145;777;2525
314470;201308;2340;7895;1843;6675;578;2398;400;1208;978;3606
314480;201308;7146;25328;5481;20751;1452;5948;573;1978;2025;7926
314490;201308;923;2936;803;2697;248;964;330;1036;578;2000
314500;201308;2751;8020;2240;7022;718;2506;754;2338;1472;4844
314505;201308;1730;5585;1644;5424;414;1506;910;2978;1324;4484
314510;201308;1473;4789;1262;4410;541;2006;342;1185;883;3191
314520;201308;3530;14170;3074;12843;1204;5452;580;2233;1784;7685
314530;201308;7133;25995;6576;25076;1267;5053;3956;15628;5223;20681
314535;201308;2648;7928;2388;7585;370;1347;1602;5100;1972;6447
314537;201308;1421;4441;1207;4063;274;1031;594;2074;868;3105
314540;201308;461;1450;403;1319;129;482;126;388;255;870
314545;201308;1307;4348;1202;4182;280;1075;631;2192;911;3267
314550;201308;506;1635;430;1523;153;629;112;371;265;1000
314560;201308;5188;18930;4531;17168;1363;5629;1000;3736;2363;9365
314570;201308;371;1191;335;1118;101;362;158;507;259;869
314580;201308;454;1608;394;1489;161;673;99;359;260;1032
314585;201308;648;2359;545;2145;178;762;138;527;316;1289
314587;201308;1696;5648;1562;5377;274;1026;901;3098;1175;4124
314590;201308;4135;14695;3093;11791;809;3301;395;1372;1204;4673
314600;201308;2036;7194;1716;6620;673;2903;301;1065;974;3968
314610;201308;8045;29674;7589;28575;2675;10864;2333;8546;5008;19410
314620;201308;1626;5128;1526;5003;232;741;1132;3829;1364;4570
314625;201308;1476;4906;1441;4858;232;876;961;3277;1193;4153
314630;201308;5003;15292;4393;14280;658;2387;2971;9825;3629;12212
314640;201308;812;2413;707;2222;261;897;208;610;469;1507
314650;201308;1237;3908;1017;3463;281;1125;431;1320;712;2445
314655;201308;1679;5127;1334;4479;263;950;691;2322;954;3272
314660;201308;166;483;148;445;26;91;91;268;117;359
314670;201308;1398;4060;1172;3662;236;816;636;1968;872;2784
314675;201308;1878;5890;1679;5539;240;889;1090;3649;1330;4538
314690;201308;2711;8843;2317;8126;733;2926;698;2267;1431;5193
314700;201308;9711;37961;8840;36122;4249;18114;1968;8446;6217;26560
314710;201308;7934;26466;5769;21468;1557;6494;748;2582;2305;9076
314720;201308;2610;8974;2211;8179;735;3009;888;3220;1623;6229
314730;201308;2392;7761;2080;7303;736;2892;676;2257;1412;5149
314740;201308;2931;10222;2724;9820;925;3607;1012;3536;1937;7143
314750;201308;317;1083;295;1031;66;284;154;509;220;793
314760;201308;1808;6623;1413;5543;356;1593;258;841;614;2434
314770;201308;1174;3840;787;2773;132;549;109;304;241;853
314780;201308;290;840;222;751;80;298;89;297;169;595
314790;201308;13228;41725;10233;36252;4208;16815;2377;7873;6585;24688
314795;201308;1512;4718;1355;4464;153;673;1022;3217;1175;3890
314800;201308;16862;52894;14240;47672;5996;21099;2896;9925;8892;31024
314810;201308;12637;39276;9999;34359;3340;12936;2453;8284;5793;21220
314820;201308;1083;3116;769;2664;308;1170;229;719;537;1889
314830;201308;1650;5795;1447;5384;567;2301;492;1820;1059;4121
314840;201308;1131;4041;908;3703;185;877;535;2185;720;3062
314850;201308;2181;6563;1899;6119;411;1526;1033;3288;1444;4814
314860;201308;3245;11525;3013;11142;610;2497;1852;6875;2462;9372
314870;201308;5593;18734;5056;17981;888;3539;3367;12184;4255;15723
314875;201308;1647;5809;1616;5764;276;922;1250;4583;1526;5505
314880;201308;772;2387;708;2258;91;315;481;1531;572;1846
314890;201308;586;1867;431;1541;139;551;100;301;239;852
314900;201308;386;1253;315;1129;96;370;149;522;245;892
314910;201308;1654;5943;1481;5647;664;2761;350;1251;1014;4012
314915;201308;2433;7835;2180;7480;226;921;1764;6027;1990;6948
314920;201308;650;1933;491;1694;102;400;226;733;328;1133
314930;201308;4986;17476;4394;16152;1563;6282;940;3414;2503;9696
314940;201308;409;1243;386;1201;87;273;209;648;296;921
314950;201308;362;1316;321;1223;101;445;60;195;161;640
314960;201308;772;2603;652;2349;213;837;170;570;383;1407
314970;201308;834;3061;747;2864;318;1329;198;727;516;2056
314980;201308;2210;6924;2017;6603;865;3030;297;929;1162;3959
314990;201308;3064;10147;2508;8859;988;3796;417;1324;1405;5120
314995;201308;1501;4922;1385;4754;296;1213;859;2812;1155;4025
315000;201308;965;3037;843;2872;170;682;526;1749;696;2431
315010;201308;470;1572;400;1418;137;569;141;438;278;1007
315015;201308;1786;5722;1679;5594;345;1209;1149;3951;1494;5160
315020;201308;729;2475;663;2349;201;819;258;812;459;1631
315030;201308;1002;3145;870;2901;354;1290;175;572;529;1862
315040;201308;917;2902;850;2793;107;393;609;1987;716;2380
315050;201308;1527;4763;1317;4392;488;1797;390;1248;878;3045
315053;201308;1107;3346;961;3112;275;1080;352;1048;627;2128
315057;201308;1873;6592;1544;6100;236;965;999;4096;1235;5061
315060;201308;939;3249;785;2841;248;977;197;738;445;1715
315070;201308;638;1977;592;1906;148;522;350;1098;498;1620
315080;201308;3377;12053;3113;11512;911;3624;1413;5222;2324;8846
315090;201308;744;2748;666;2587;191;816;218;874;409;1690
315100;201308;1158;4103;945;3621;284;1222;258;942;542;2164
315110;201308;1612;5017;1427;4713;430;1523;588;1927;1018;3450
315120;201308;13481;33345;9877;28736;1978;6255;5234;16132;7212;22387
315130;201308;1766;5992;1597;5651;610;2390;443;1529;1053;3919
315140;201308;2327;8043;1945;7174;581;2480;535;1710;1116;4190
315150;201308;4519;12935;3534;11149;934;3384;1347;4064;2281;7448
315160;201308;1357;3915;1232;3746;255;867;722;2152;977;3019
315170;201308;1316;4066;1154;3845;290;1073;646;2191;936;3264
315180;201308;12907;41708;10419;36346;3241;12853;2614;8682;5855;21535
315190;201308;2331;6427;1907;5808;609;2003;847;2580;1456;4583
315200;201308;4382;15110;3688;13571;1207;4862;1015;3595;2222;8457
315210;201308;8219;26341;7248;24575;2871;10440;2138;7084;5009;17524
315213;201308;1092;3652;1060;3601;98;307;892;3120;990;3427
315217;201308;2618;9218;2266;8587;391;1662;1334;5077;1725;6739
315220;201308;9870;30086;8863;28748;1563;5344;5910;19464;7473;24808
315230;201308;2343;6525;2187;6339;145;414;1888;5552;2033;5966
315240;201308;3042;10443;2898;10196;635;2443;1703;5971;2338;8414
315250;201308;8338;28142;6639;24985;2402;10080;2093;7783;4495;17863
315260;201308;1048;3588;909;3270;371;1447;147;490;518;1937
315270;201308;867;3156;756;2913;262;1086;164;590;426;1676
315280;201308;3825;12124;3164;10603;1169;4150;796;2518;1965;6668
315290;201308;1313;3843;1036;3404;409;1495;182;580;591;2075
315300;201308;480;1445;392;1332;205;737;106;334;311;1071
315310;201308;1178;4064;1088;3917;152;617;734;2619;886;3236
315320;201308;794;2799;693;2654;248;1000;286;1152;534;2152
315330;201308;833;3071;686;2750;298;1350;113;429;411;1779
315340;201308;4130;12261;3584;11418;712;2436;2085;6759;2797;9195
315350;201308;1805;5300;1538;4936;174;523;1209;4035;1383;4558
315360;201308;1657;5753;1385;5007;350;1343;461;1593;811;2936
315370;201308;614;1889;544;1785;134;498;295;940;429;1438
315380;201308;271;993;254;943;96;373;49;178;145;551
315390;201308;1923;6956;1665;6322;616;2503;349;1311;965;3814
315400;201308;4316;14041;4009;13438;1181;4225;1908;6537;3089;10762
315410;201308;1654;4762;1408;4349;305;1146;767;2245;1072;3391
315415;201308;1042;3652;976;3535;425;1575;386;1441;811;3016
315420;201308;1505;4821;1152;4179;365;1452;265;916;630;2368
315430;201308;3920;11045;3082;9655;814;2876;1161;3569;1975;6445
315440;201308;947;2979;874;2881;156;593;545;1812;701;2405
315445;201308;2060;6224;1789;5861;295;1084;1243;4099;1538;5183
315450;201308;2462;8095;2348;7929;459;1594;1587;5501;2046;7095
315460;201308;37661;129464;33828;121163;11637;45207;9517;32912;21154;78119
315470;201308;489;1588;457;1534;93;334;275;906;368;1240
315480;201308;1219;4085;926;3415;223;911;224;773;447;1684
315490;201308;3218;9370;2820;8827;552;2085;1672;5034;2224;7119
315500;201308;452;1496;308;1125;76;336;128;401;204;737
315510;201308;1450;4339;1257;4010;192;724;778;2438;970;3162
315520;201308;1130;3702;970;3492;193;789;635;2222;828;3011
315530;201308;487;1753;462;1711;228;890;135;475;363;1365
315540;201308;1269;3912;1006;3460;221;938;368;1219;589;2157
315550;201308;1613;4901;1417;4641;479;1726;618;2003;1097;3729
315560;201308;6891;23590;6393;22911;985;3946;4359;15634;5344;19580
315570;201308;2363;7609;2217;7386;426;1576;1421;4737;1847;6313
315580;201308;2633;8398;2163;7487;644;2626;780;2513;1424;5139
315590;201308;867;2606;812;2519;119;440;588;1800;707;2240
315600;201308;2526;9383;2155;8806;350;1572;1383;5856;1733;7428
315610;201308;958;2963;840;2707;232;879;287;780;519;1659
315620;201308;336;1212;330;1198;108;408;151;559;259;967
315630;201308;982;3216;847;2982;242;900;228;782;470;1682
315640;201308;729;2388;640;2198;242;952;189;594;431;1546
315645;201308;803;2687;713;2456;288;1084;151;487;439;1571
315650;201308;1792;5567;1688;5429;166;687;1299;4068;1465;4755
315660;201308;2594;7307;2383;7013;406;1326;1551;4522;1957;5848
315670;201308;11253;41222;10401;39497;4029;16455;3224;11943;7253;28398
315680;201308;2824;10156;2348;9223;919;3778;585;2418;1504;6196
315690;201308;2998;10019;2575;9238;975;3844;688;2439;1663;6283
315700;201308;6967;23191;6235;21668;1480;5853;3031;10092;4511;15945
315710;201308;1793;5507;1478;5004;245;987;841;2799;1086;3786
315720;201308;2867;9915;2652;9456;853;3422;942;3129;1795;6551
315725;201308;1576;5027;1303;4680;317;1127;838;3089;1155;4216
315727;201308;644;2109;583;1981;143;518;296;1004;439;1522
315730;201308;968;3112;876;2924;243;855;423;1451;666;2306
315733;201308;1119;3687;1032;3498;466;1667;320;1060;786;2727
315737;201308;1342;4248;1151;3924;158;598;718;2471;876;3069
315740;201308;1009;3349;881;3097;269;1085;356;1160;625;2245
315750;201308;1105;3434;995;3284;118;485;715;2284;833;2769
315760;201308;903;2696;886;2670;33;92;825;2510;858;2602
315765;201308;1423;4634;1335;4484;192;675;981;3355;1173;4030
315770;201308;1636;5364;1501;5070;472;1735;543;1771;1015;3506
315780;201308;26603;89968;25056;86686;9252;33806;8337;29514;17589;63320
315790;201308;3079;10921;2851;10434;343;1209;1911;7262;2254;8471
315800;201308;1517;6068;1278;5344;423;1933;223;896;646;2829
315810;201308;1449;4304;1258;3986;283;953;721;2231;1004;3184
315820;201308;3036;10271;2623;9659;673;2633;1413;5289;2086;7922
315830;201308;1474;5072;1353;4805;354;1450;445;1497;799;2947
315840;201308;668;1923;535;1643;108;364;153;450;261;814
315850;201308;1336;4850;1291;4747;402;1542;504;1825;906;3367
315860;201308;409;1545;350;1412;116;531;77;313;193;844
315870;201308;463;1428;400;1326;111;414;155;477;266;891
315880;201308;1065;2975;897;2765;278;976;399;1197;677;2173
315890;201308;1613;5690;1472;5470;424;1611;780;3054;1204;4665
315895;201308;4911;15812;4590;15184;1503;5453;1915;6177;3418;11630
315900;201308;750;2496;696;2401;222;888;326;1026;548;1914
315910;201308;598;2193;552;2097;237;930;204;763;441;1693
315920;201308;1202;3852;1016;3460;339;1272;376;1189;715;2461
315930;201308;1064;3101;912;2828;305;1022;291;883;596;1905
315935;201308;1127;3905;1054;3745;355;1380;328;1131;683;2511
315940;201308;610;2016;572;1954;160;607;306;1008;466;1615
315950;201308;1194;3815;1119;3666;332;1116;615;2060;947;3176
315960;201308;2795;9977;2330;8974;1100;4800;229;797;1329;5597
315970;201308;791;2313;656;2107;84;272;484;1604;568;1876
315980;201308;3926;10277;2864;8439;828;2808;911;2350;1739;5158
315990;201308;4263;13133;3776;12342;898;3428;2033;6498;2931;9926
316000;201308;561;1905;494;1778;241;932;122;420;363;1352
316010;201308;431;1619;386;1512;120;546;75;235;195;781
316020;201308;1165;3865;938;3476;180;739;536;2029;716;2768
316030;201308;3598;10474;2651;8937;429;1597;1419;4909;1848;6506
316040;201308;3324;10618;2449;8558;460;1827;364;997;824;2824
316045;201308;2038;6824;1909;6628;290;920;1362;5034;1652;5954
316050;201308;342;1162;310;1112;63;259;181;636;244;895
316060;201308;768;2405;645;2232;129;550;381;1255;510;1805
316070;201308;5915;20275;5518;19458;1859;7213;2356;7954;4215;15167
316080;201308;720;2740;651;2548;176;772;153;595;329;1367
316090;201308;592;1792;454;1508;123;472;120;356;243;828
316095;201308;1200;4131;1123;3969;246;905;723;2610;969;3515
316100;201308;2814;9832;2344;8625;766;3113;471;1647;1237;4760
316105;201308;871;2540;682;2250;171;620;310;1035;481;1655
316110;201308;12122;44152;11046;42100;1521;6559;7864;30437;9385;36996
316120;201308;1244;4479;1210;4415;416;1546;531;1985;947;3531
316130;201308;946;2477;751;2177;217;738;316;875;533;1613
316140;201308;1033;3188;820;2838;158;599;472;1660;630;2259
316150;201308;1253;4026;1195;3932;324;1235;616;1949;940;3184
316160;201308;1205;3760;1006;3357;141;522;606;2044;747;2566
316165;201308;885;2586;777;2406;166;590;423;1272;589;1862
316170;201308;1314;4049;1044;3520;249;966;420;1289;669;2255
316180;201308;1184;3921;1011;3610;308;1283;342;1130;650;2413
316190;201308;2579;8020;1588;5580;376;1448;323;992;699;2440
316200;201308;4099;13597;3300;12032;971;4130;951;3269;1922;7399
316210;201308;4904;16327;4581;15652;2170;7926;946;3214;3116;11140
316220;201308;634;2030;477;1746;151;618;76;299;227;917
316225;201308;1036;3185;935;3041;162;600;606;1935;768;2535
316230;201308;440;1363;365;1226;69;255;201;682;270;937
316240;201308;6041;20062;5330;19190;667;2333;4161;15347;4828;17680
316245;201308;2878;10613;2744;10413;268;1198;2176;8264;2444;9462
316250;201308;8657;28194;7739;26272;3411;12384;2036;6544;5447;18928
316255;201308;2290;7507;2054;7228;321;1072;1507;5453;1828;6525
316257;201308;1276;3760;1026;3309;306;1121;367;1088;673;2209
316260;201308;1782;5199;1389;4641;398;1485;746;2473;1144;3958
316265;201308;1152;3449;1038;3221;96;348;742;2270;838;2618
316270;201308;5135;16932;4816;16287;1507;5544;2011;6877;3518;12421
316280;201308;3224;11049;2915;10428;656;2619;1474;5274;2130;7893
316290;201308;3067;10405;2883;10051;800;3151;1272;4187;2072;7338
316292;201308;3681;12582;3401;12020;1031;4082;1419;4732;2450;8814
316294;201308;894;3048;593;2299;159;720;85;320;244;1040
316295;201308;1895;6897;1773;6634;487;2096;852;2974;1339;5070
316300;201308;906;3060;826;2909;99;359;561;2051;660;2410
316310;201308;685;2230;534;1910;134;538;187;664;321;1202
316320;201308;549;1888;488;1801;149;614;131;461;280;1075
316330;201308;931;2920;813;2701;163;546;469;1614;632;2160
316340;201308;1122;3759;1014;3546;381;1495;263;824;644;2319
316350;201308;1463;4919;1331;4690;284;1027;737;2763;1021;3790
316360;201308;750;2041;605;1846;77;242;460;1422;537;1664
316370;201308;4921;16701;4452;15711;1540;5820;1075;3864;2615;9684
316380;201308;1399;4050;1148;3666;153;547;766;2455;919;3002
316390;201308;871;2734;749;2524;278;1007;291;997;569;2004
316400;201308;1448;4952;1287;4653;367;1411;530;1984;897;3395
316410;201308;1186;4132;1114;4018;221;887;698;2513;919;3400
316420;201308;1967;6866;1841;6689;309;1241;1199;4437;1508;5678
316430;201308;885;2804;766;2602;246;910;281;926;527;1836
316440;201308;589;2030;529;1951;214;916;211;711;425;1627
316443;201308;664;2118;576;1930;151;561;204;657;355;1218
316447;201308;1300;4479;1244;4374;195;762;947;3300;1142;4062
316450;201308;2172;7841;1950;7389;510;1948;1049;4131;1559;6079
316460;201308;813;2633;766;2559;210;809;431;1355;641;2164
316470;201308;7299;25310;6102;22507;2228;9304;1765;6071;3993;15375
316480;201308;252;894;225;837;70;274;69;248;139;522
316490;201308;358;1176;341;1138;125;444;140;459;265;903
316500;201308;1051;3908;747;2972;209;893;61;224;270;1117
316510;201308;932;3452;848;3288;376;1525;261;1000;637;2525
316520;201308;1121;3640;951;3383;294;1218;352;1145;646;2363
316530;201308;1186;3951;1006;3556;289;1224;402;1232;691;2456
316540;201308;1001;3348;898;3163;279;1166;305;963;584;2129
316550;201308;1251;4373;1155;4217;253;1018;727;2658;980;3676
316553;201308;2186;8206;1856;7363;692;2940;392;1512;1084;4452
316555;201308;2555;9568;2369;9342;222;877;1905;7706;2127;8583
316556;201308;579;1702;482;1509;58;227;313;929;371;1156
316557;201308;869;3228;844;3181;329;1291;368;1372;697;2663
316560;201308;368;1264;306;1119;77;339;84;269;161;608
316570;201308;1353;4458;1248;4226;248;931;679;2281;927;3212
316580;201308;232;775;215;736;76;272;72;223;148;495
316590;201308;1323;4079;1121;3702;216;845;623;1996;839;2841
316600;201308;1150;3907;1044;3681;253;960;551;1889;804;2849
316610;201308;594;2263;556;2194;145;661;312;1199;457;1860
316620;201308;2069;6946;1904;6587;526;1977;867;2999;1393;4976
316630;201308;1455;5048;1314;4723;560;2131;386;1378;946;3509
316640;201308;251;854;227;806;69;286;88;288;157;574
316650;201308;916;3681;821;3510;201;868;445;2013;646;2881
316660;201308;134;419;116;388;31;128;43;127;74;255
316670;201308;1636;5100;1377;4573;531;2001;338;988;869;2989
316680;201308;1891;5835;1683;5512;233;796;1285;4258;1518;5054
316690;201308;1088;3800;1003;3668;395;1615;322;1122;717;2737
316695;201308;1245;3933;1113;3699;119;378;781;2721;900;3099
316700;201308;351;1210;327;1154;98;402;147;484;245;886
316710;201308;3367;13254;2970;12340;1056;4517;923;4042;1979;8559
316720;201308;19909;68899;17260;62900;6433;24703;4501;16325;10934;41028
316730;201308;425;1390;372;1275;97;373;186;589;283;962
316740;201308;732;2606;668;2482;280;1129;174;605;454;1734
316750;201308;413;1489;386;1428;123;521;138;465;261;986
316760;201308;3539;12255;3046;11703;1807;6948;873;3603;2680;10551
316770;201308;1455;4470;1296;4249;233;853;845;2831;1078;3684
316780;201308;682;2416;644;2338;282;1088;161;566;443;1654
316790;201308;827;2478;626;2128;187;745;232;755;419;1500
316800;201308;5948;20251;5451;19310;1213;5022;2887;9796;4100;14818
316805;201308;882;2393;838;2337;145;387;615;1777;760;2164
316810;201308;514;1647;483;1589;146;531;221;716;367;1247
316820;201308;356;1078;262;916;115;434;46;150;161;584
316830;201308;575;2157;554;2110;213;853;199;751;412;1604
316840;201308;3275;9921;2841;9201;869;3201;1157;3569;2026;6770
316850;201308;2052;6733;1912;6483;491;1864;993;3304;1484;5168
316860;201308;23080;74309;21473;71320;6284;23171;9631;31814;15915;54985
316870;201308;6875;23696;6170;21977;2437;9324;1376;4765;3813;14089
316880;201308;876;3038;849;2996;370;1422;240;800;610;2222
316890;201308;1402;3743;1125;3367;505;1661;371;1060;876;2721
316900;201308;2562;8408;2344;7957;772;2917;738;2269;1510;5186
316905;201308;412;1493;386;1433;157;617;118;425;275;1042
316910;201308;672;2378;569;2166;157;634;247;960;404;1594
316920;201308;1473;4656;1198;4185;193;750;599;2073;792;2823
316930;201308;9385;33144;8351;31005;2703;11414;2337;8235;5040;19649
316935;201308;4737;14516;3552;12410;1292;5006;884;2907;2176;7913
316940;201308;6575;23110;5765;21369;1614;6742;1715;6046;3329;12788
316950;201308;1457;4465;1297;4250;227;868;840;2707;1067;3575
316960;201308;5162;13932;4444;13024;1010;3233;2635;7699;3645;10932
316970;201308;3427;11668;3248;11338;1402;5465;824;2634;2226;8099
316980;201308;915;2975;758;2717;360;1372;217;784;577;2156
316990;201308;9593;33030;8853;31360;3781;14495;1425;4839;5206;19334
317000;201308;2467;9297;2400;9209;292;901;1997;8022;2289;8923
317005;201308;2313;7829;2235;7720;436;1562;1563;5460;1999;7022
317010;201308;27729;79473;19395;64654;5920;21908;4900;16884;10820;38792
317020;201308;41663;130050;30260;105358;8734;33490;6810;22244;15544;55734
317030;201308;860;2489;726;2285;137;535;406;1251;543;1786
317040;201308;12459;39205;11267;37007;4337;14886;4058;13615;8395;28501
317043;201308;791;2292;667;2122;211;730;314;979;525;1709
317047;201308;1141;3162;913;2786;177;624;434;1304;611;1928
317050;201308;1782;6560;1574;6069;494;2104;502;1837;996;3941
317052;201308;2303;7789;2067;7432;369;1412;1423;5207;1792;6619
317057;201308;1726;5189;1374;4579;248;985;690;2273;938;3258
317060;201308;383;1168;290;957;84;320;109;334;193;654
317065;201308;1207;4157;1101;3980;159;652;802;2889;961;3541
317070;201308;9074;31001;7330;27103;2424;9902;1717;6374;4141;16276
317075;201308;1208;3945;1104;3761;429;1590;384;1234;813;2824
317080;201308;6726;20182;6259;19419;2099;7063;2490;7763;4589;14826
317090;201308;4702;16626;4428;16104;756;2887;2950;10931;3706;13818
317100;201308;3169;9626;2786;8988;946;3405;1162;3558;2108;6963
317103;201308;1970;7080;1683;6448;384;1777;766;2877;1150;4654
317107;201308;1249;4113;1122;3856;291;1159;543;1764;834;2923
317110;201308;712;1983;513;1612;149;560;192;539;341;1099
317115;201308;1024;3387;922;3164;141;507;607;2099;748;2606
317120;201308;12825;44629;11264;40975;4040;15639;4035;14493;8075;30132
317130;201308;8772;28845;8019;27461;2312;8922;3477;11534;5789;20456
317140;201308;638;2287;596;2194;86;354;380;1387;466;1741
317150;201308;1021;2864;872;2688;120;442;620;1881;740;2323
317160;201308;3730;10394;2895;9315;450;1694;1916;6086;2366;7780
317170;201308;1899;5857;1799;5661;272;997;1070;3228;1342;4225
317180;201308;1792;6303;1459;5518;438;1794;431;1605;869;3399
317190;201308;1256;3912;1166;3790;104;391;976;3153;1080;3544
317200;201308;4234;14716;4003;14201;1505;5792;998;3402;2503;9194
317210;201308;1058;3420;909;3179;292;1140;390;1345;682;2485
317220;201308;345;1273;339;1264;130;490;164;632;294;1122
320010;201308;5843;18790;5235;17359;897;3254;2860;9471;3757;12725
320013;201308;1825;5619;1443;5007;216;813;875;3087;1091;3900
320016;201308;3413;9713;2954;9059;531;1658;1988;6202;2519;7860
320020;201308;4145;13782;3838;13116;1369;4980;1410;4827;2779;9807
320030;201308;1715;5751;1563;5407;457;1717;696;2334;1153;4051
320035;201308;1607;5258;1471;5002;534;1958;466;1571;1000;3529
320040;201308;2995;10410;2551;9349;726;2864;808;2917;1534;5781
320050;201308;1863;5407;1593;4857;347;1182;807;2407;1154;3589
320060;201308;10315;33604;8390;29067;2294;8783;2960;9722;5254;18505
320070;201308;1777;6140;1594;5695;550;2119;415;1369;965;3488
320080;201308;5259;16176;4426;14473;1414;4989;1519;4876;2933;9865
320090;201308;8291;24379;7009;22040;2067;7032;3254;9912;5321;16944
320100;201308;3223;9880;2672;8773;670;2407;1228;3922;1898;6329
320110;201308;1538;4774;1410;4517;396;1379;460;1446;856;2825
320115;201308;1894;7091;1839;6960;657;2536;932;3603;1589;6139
320120;201308;16589;58150;14964;54883;5731;22328;4239;15648;9970;37976
320130;201308;38306;131633;36168;127024;11548;43674;16195;55762;27743;99436
320140;201308;4012;13407;2936;10648;793;3148;356;1233;1149;4381
320150;201308;17572;51346;13266;42972;4551;15803;2157;6892;6708;22695
320160;201308;5285;16559;4668;15555;1270;4741;2153;6828;3423;11569
320170;201308;1962;6588;1808;6240;699;2501;553;1959;1252;4460
320180;201308;901;3029;819;2895;288;1077;340;1196;628;2273
320190;201308;4215;15602;3911;14798;1511;5943;1132;4268;2643;10211
320200;201308;1095;3679;993;3471;310;1166;418;1476;728;2642
320210;201308;6207;17395;5421;16073;1415;4703;2714;7859;4129;12562
320220;201308;2687;8505;2116;7449;662;2541;733;2617;1395;5158
320225;201308;1399;5058;1233;4592;458;1832;242;904;700;2736
320230;201308;4165;14275;3908;13791;1333;5060;1440;5210;2773;10270
320240;201308;11339;37113;9568;33588;3527;13082;2367;8637;5894;21719
320245;201308;4129;14363;3899;13808;1261;4664;1673;5917;2934;10581
320250;201308;1691;5387;1298;4448;359;1374;288;903;647;2277
320255;201308;1972;6718;1719;6283;714;2779;603;2269;1317;5048
320260;201308;1361;4441;1146;3876;328;1235;417;1258;745;2493
320265;201308;2422;7597;2064;7155;278;1004;1526;5429;1804;6433
320270;201308;2193;7419;2025;7006;543;1989;968;3334;1511;5323
320280;201308;7093;21861;6606;21117;1285;4392;4131;13425;5416;17817
320290;201308;1502;5265;1379;4912;537;1990;370;1245;907;3235
320300;201308;4431;15349;4152;14772;1213;4586;1964;7020;3177;11606
320305;201308;4522;15353;4160;14481;1166;4474;1866;6321;3032;10795
320310;201308;1934;6010;1780;5776;411;1456;1013;3216;1424;4672
320313;201308;2219;6971;1665;5639;485;1892;279;846;764;2738
320316;201308;2205;7100;2097;6841;591;2030;963;3127;1554;5157
320320;201308;17935;59958;15963;56065;4989;19567;6631;22592;11620;42159
320330;201308;2784;8920;2499;8385;606;2047;1357;4713;1963;6760
320332;201308;4767;16655;4394;15974;1459;5539;1897;7106;3356;12645
320334;201308;1526;5482;1277;4852;464;1967;227;773;691;2740
320335;201308;2027;6308;1608;5403;597;2214;307;966;904;3180
320340;201308;5479;16116;4503;14413;1143;4079;2072;6563;3215;10642
320350;201308;5372;14128;4074;11993;868;2917;1932;5508;2800;8425
320360;201308;1705;4727;1355;4096;298;1028;661;1890;959;2918
320370;201308;3418;11628;2989;10750;923;3451;1216;4419;2139;7870
320380;201308;2654;8494;2378;7919;653;2315;1099;3586;1752;5901
320390;201308;8052;25112;6876;22769;1978;7312;2750;8816;4728;16128
320400;201308;4119;12062;3529;11231;695;2465;2188;6839;2883;9304
320405;201308;4109;12478;3801;12061;1185;4181;2033;6290;3218;10471
320410;201308;5991;15408;4536;13734;715;2215;3180;9782;3895;11997
320420;201308;2255;7211;1785;6478;785;3060;303;1054;1088;4114
320425;201308;2450;6409;2036;5824;328;1131;1279;3625;1607;4756
320430;201308;2215;6778;2039;6452;360;1293;1165;3619;1525;4912
320435;201308;2105;7576;1945;7197;715;2692;828;3183;1543;5875
320440;201308;1484;5106;1348;4699;446;1675;409;1342;855;3017
320450;201308;2375;7971;2120;7427;638;2437;911;3105;1549;5542
320455;201308;4516;16430;3690;14315;1191;4775;746;2877;1937;7652
320460;201308;2846;9665;2388;8657;812;3179;709;2439;1521;5618
320465;201308;1480;4929;1258;4361;291;1055;501;1694;792;2749
320470;201308;4103;13191;3127;10988;1085;4136;486;1623;1571;5759
320480;201308;1980;6105;1665;5498;421;1624;728;2257;1149;3881
320490;201308;17343;56443;14781;51280;5177;19181;5081;18199;10258;37380
320495;201308;1275;4277;1147;3986;504;1889;329;1109;833;2998
320500;201308;41284;134742;37310;127146;13188;48468;15666;52115;28854;100583
320501;201308;3710;12495;3471;12055;1194;4626;1499;5077;2693;9703
320503;201308;2212;8273;1956;7547;695;2842;493;1754;1188;4596
320506;201308;3107;10052;2218;7724;657;2432;356;1217;1013;3649
320510;201308;7953;26132;7244;24714;2650;9638;2591;8730;5241;18368
320515;201308;2060;5977;1849;5569;514;1649;747;2260;1261;3909
320517;201308;2062;7160;1816;6574;665;2600;420;1462;1085;4062
320520;201308;30712;102516;26992;95158;9260;35775;11360;39743;20620;75518
320530;201308;26668;86011;23212;78876;6771;25989;9861;32006;16632;57995
330010;201308;14693;48169;13808;46276;3386;12856;7647;24482;11033;37338
330015;201308;1927;5520;1699;5077;535;1790;562;1588;1097;3378
330020;201308;15811;48873;14610;46913;3851;13290;7831;24963;11682;38253
330022;201308;1530;5019;1401;4776;329;1318;749;2428;1078;3746
330023;201308;3229;10730;3070;10401;898;3348;1272;4173;2170;7521
330025;201308;3181;10062;2968;9736;724;2576;1835;5982;2559;8558
330030;201308;7252;25610;6698;24437;2154;8615;2745;9542;4899;18157
330040;201308;14070;40950;12059;37778;3292;11165;6274;19302;9566;30467
330045;201308;60860;180360;56683;174127;9353;30770;38967;119856;48320;150626
330050;201308;2903;9414;2580;8755;985;3764;704;2197;1689;5961
330060;201308;5296;16858;4835;16183;1137;4285;2924;9809;4061;14094
330070;201308;24547;78137;22630;74639;6803;24151;9813;32315;16616;56466
330080;201308;8675;26057;8342;25594;2154;6640;5066;16046;7220;22686
330090;201308;3032;8843;2889;8575;947;3007;1314;3827;2261;6834
330093;201308;1904;5652;1701;5327;425;1451;788;2445;1213;3896
330095;201308;1178;4168;1095;3956;434;1735;194;610;628;2345
330100;201308;52152;180159;49477;175256;12715;49728;25155;89252;37870;138980
330110;201308;2605;8393;2386;7975;862;3103;718;2372;1580;5475
330115;201308;2414;7531;2258;7243;793;2774;897;2789;1690;5563
330120;201308;2378;7174;2204;6922;634;2129;1069;3311;1703;5440
330130;201308;3839;12911;3513;12257;1225;4613;1279;4424;2504;9037
330140;201308;3332;10306;3040;9897;790;2858;1460;4739;2250;7597
330150;201308;2893;8942;2331;7740;820;2939;526;1699;1346;4638
330160;201308;1350;4800;1274;4624;497;1969;389;1341;886;3310
330170;201308;98277;305681;92670;296942;13899;48107;66949;214604;80848;262711
330180;201308;1621;5072;1489;4817;274;1127;960;2869;1234;3996
330185;201308;7632;24664;7186;23932;1948;6844;3933;13421;5881;20265
330187;201308;4115;11886;3747;11291;826;2889;2179;6408;3005;9297
330190;201308;27202;84260;26118;82406;6978;23443;15041;46676;22019;70119
330200;201308;12769;41406;11854;39540;2775;9546;6558;22277;9333;31823
330205;201308;2523;7021;2305;6661;528;1766;1182;3275;1710;5041
330210;201308;4617;12370;3497;10293;1089;3544;922;2679;2011;6223
330220;201308;10862;35254;10289;34142;3722;13338;3465;11069;7187;24407
330225;201308;3914;12644;3702;12307;651;2525;2537;8381;3188;10906
330227;201308;17123;49211;15643;47200;3519;11448;9668;28553;13187;40001
330230;201308;1491;4482;1381;4299;443;1554;521;1492;964;3046
330240;201308;19884;62598;17797;58926;7033;25358;3314;10699;10347;36057
330245;201308;1184;3853;992;3455;317;1208;222;776;539;1984
330250;201308;36345;107942;34551;105106;9598;29606;19438;60368;29036;89974
330260;201308;3386;10956;3205;10577;884;3200;1457;4634;2341;7834
330270;201308;13556;41195;11825;38362;3658;12591;4802;15741;8460;28332
330280;201308;1906;6248;1664;5745;416;1656;798;2570;1214;4226
330285;201308;17179;52664;15910;50871;3690;12541;9827;31497;13517;44038
330290;201308;3428;9769;3088;9330;633;2198;1810;5187;2443;7385
330300;201308;4104;13706;3934;13422;1017;3716;2061;7164;3078;10880
330310;201308;2688;8088;2479;7726;644;2129;1216;3729;1860;5858
330320;201308;15328;46030;14587;44870;3722;11669;8719;27440;12441;39109
330330;201308;30548;89091;28553;85977;7516;24358;16649;49456;24165;73814
330340;201308;13809;43891;11589;39309;3724;13759;3581;11909;7305;25668
330350;201308;90206;296309;88065;293315;16836;56197;62400;212058;79236;268255
330360;201308;5272;16966;5155;16778;845;3031;3687;11883;4532;14914
330370;201308;3684;14004;3506;13531;1425;5712;1220;4729;2645;10441
330380;201308;4023;13506;3603;12781;1157;4360;1611;5798;2768;10158
330385;201308;3939;13914;3642;13284;1239;4819;1277;4647;2516;9466
330390;201308;22771;78340;21187;75195;5335;21135;11055;38419;16390;59554
330395;201308;3221;9938;3025;9603;530;1807;1904;6107;2434;7914
330400;201308;2501;8535;2286;8120;569;2306;1108;3621;1677;5927
330410;201308;3038;9806;2636;8975;645;2297;1266;4330;1911;6627
330411;201308;2474;7936;2243;7467;503;1935;1170;3654;1673;5589
330412;201308;1352;4769;1097;4265;254;1144;449;1665;703;2809
330414;201308;25231;72541;21682;67722;4548;15213;13279;41536;17827;56749
330415;201308;3633;11612;3227;10866;849;3190;1429;4791;2278;7981
330420;201308;6977;23405;5766;20869;1883;7458;1054;3865;2937;11323
330430;201308;8040;24268;7259;22860;1850;6504;3496;10647;5346;17151
330440;201308;2075;7098;1747;6410;616;2507;405;1406;1021;3913
330450;201308;1575;5577;1490;5392;489;1991;546;1900;1035;3891
330452;201308;10506;32895;8779;29404;2543;9437;3546;11326;6089;20763
330455;201308;448299;1349679;390004;1252874;108813;373843;196863;630454;305676;1004297
330460;201308;1377;4734;1297;4577;379;1519;616;2120;995;3639
330470;201308;4216;14203;4002;13756;1524;5643;1154;3843;2678;9486
330475;201308;7979;26226;7370;25258;1917;7186;3998;13753;5915;20939
330480;201308;6438;19767;6041;19028;1803;6131;2439;7593;4242;13724
330490;201308;96192;275002;90364;266490;13527;42086;67524;199733;81051;241819
330500;201308;6661;20653;6254;19834;1484;5070;3186;10387;4670;15457
330510;201308;39982;133067;38018;129705;13851;48022;17623;61872;31474;109894
330513;201308;1571;4776;1451;4536;563;1862;508;1571;1071;3433
330515;201308;2979;9477;2754;9090;957;3359;1009;3294;1966;6653
330520;201308;12807;39066;12023;37904;2852;9448;7245;23082;10097;32530
330530;201308;1539;4664;1425;4465;395;1370;741;2229;1136;3599
330540;201308;3211;10006;2808;9374;920;3293;1056;3437;1976;6730
330550;201308;8809;29620;7885;27923;3247;12156;2057;7396;5304;19552
330555;201308;10139;31491;9199;30020;1857;6334;5862;19391;7719;25725
330560;201308;4105;12824;3853;12392;827;3108;2226;6965;3053;10073
330570;201308;3587;10556;3180;9906;824;2691;1716;5446;2540;8137
330575;201308;5275;16473;4920;15813;1145;3970;2979;9309;4124;13279
330580;201308;16163;53416;14403;49900;5170;18841;4964;17583;10134;36424
330590;201308;1924;5966;1820;5788;552;1835;889;2844;1441;4679
330600;201308;9132;28077;7938;26203;1267;5248;5099;15949;6366;21197
330610;201308;8662;28567;7992;27294;2307;8731;3704;12430;6011;21161
330615;201308;1684;6035;1559;5694;637;2425;594;2237;1231;4662
330620;201308;3885;13863;3590;13275;1301;5027;1131;4429;2432;9456
330630;201308;20000;67809;18327;64155;5468;21295;8414;28115;13882;49410
350010;201308;2855;9244;2325;8023;757;2819;441;1444;1198;4263
350020;201308;561;1676;457;1457;123;449;164;479;287;928
350030;201308;4243;14067;3855;13314;1444;5411;1296;4505;2740;9916
350040;201308;572;2127;507;1984;181;774;103;362;284;1136
350050;201308;1376;4582;1147;4150;322;1317;369;1214;691;2531
350055;201308;592;2043;570;2005;179;682;266;921;445;1603
350060;201308;80;275;73;262;23;104;24;70;47;174
350070;201308;2691;9107;2259;8119;606;2423;517;1673;1123;4096
350075;201308;481;1789;436;1679;159;654;119;419;278;1073
350080;201308;586;1765;480;1552;131;492;187;587;318;1079
350090;201308;576;1708;457;1502;132;465;130;389;262;854
350100;201308;1782;6370;1637;6042;617;2455;528;1891;1145;4346
350110;201308;442;1372;351;1163;109;404;111;326;220;730
350115;201308;1283;4315;1144;3948;289;1126;483;1520;772;2646
350120;201308;729;2054;535;1691;161;561;117;371;278;932
350130;201308;3650;11401;3325;10763;898;3249;1387;4160;2285;7409
350140;201308;683;2165;619;2033;151;575;250;769;401;1344
350150;201308;398;1378;367;1306;150;562;89;310;239;872
350160;201308;6199;20186;4864;17221;1596;6230;1646;5343;3242;11573
350170;201308;2181;7899;1966;7354;760;2941;463;1643;1223;4584
350180;201308;1441;3826;1200;3408;302;903;524;1470;826;2373
350190;201308;2987;10523;2565;9654;917;3833;931;3194;1848;7027
350200;201308;404;1423;369;1369;143;593;133;468;276;1061
350210;201308;7283;21111;5979;18795;2424;8171;1911;5719;4335;13890
350220;201308;3096;10169;2804;9628;1046;3999;787;2442;1833;6441
350230;201308;728;2533;672;2440;242;951;213;778;455;1729
350240;201308;587;1824;509;1700;127;497;268;851;395;1348
350250;201308;2721;10227;2606;9987;1138;4620;823;3116;1961;7736
350260;201308;1021;2784;881;2560;216;643;395;1199;611;1842
350270;201308;5162;16441;4691;15480;1225;4387;2153;7088;3378;11475
350275;201308;1957;6561;1754;6263;544;2134;709;2382;1253;4516
350280;201308;21818;59483;14337;45129;3924;13238;2988;9468;6912;22706
350290;201308;1493;5311;1379;5042;488;1884;446;1665;934;3549
350300;201308;477;1548;441;1464;158;569;130;433;288;1002
350310;201308;997;3389;938;3264;245;1007;402;1313;647;2320
350315;201308;555;1795;454;1580;79;352;155;498;234;850
350320;201308;11792;39477;10800;37126;3583;13163;1939;6456;5522;19619
350330;201308;9385;28397;8393;26313;1924;6783;4649;13658;6573;20441
350335;201308;540;1597;498;1511;133;432;194;635;327;1067
350340;201308;1018;3317;810;2917;249;987;202;712;451;1699
350350;201308;752;2474;665;2337;192;783;240;829;432;1612
350360;201308;774;2766;676;2538;218;868;243;921;461;1789
350370;201308;687;2161;516;1745;110;417;121;361;231;778
350380;201308;3616;11884;3064;11027;1368;5275;633;2169;2001;7444
350390;201308;8428;27928;7602;26408;1918;7316;3978;13322;5896;20638
350395;201308;296;981;240;856;73;276;47;160;120;436
350400;201308;7941;24037;6667;21706;2113;7508;2355;7348;4468;14856
350410;201308;7188;27240;6487;25595;2446;10352;1696;6512;4142;16864
350420;201308;1007;3262;826;2899;401;1494;74;259;475;1753
350430;201308;879;2802;772;2615;222;893;376;1208;598;2101
350440;201308;1346;4424;1275;4296;465;1665;581;1906;1046;3571
350450;201308;8008;25035;6860;22782;2382;8515;1927;6204;4309;14719
350460;201308;1456;4390;1087;3590;347;1269;305;884;652;2153
350470;201308;206;642;186;613;55;206;77;232;132;438
350480;201308;764;2415;512;1780;97;382;89;261;186;643
350490;201308;2071;6117;1791;5740;497;1837;954;2892;1451;4729
350500;201308;604;1818;525;1697;144;527;231;689;375;1216
350510;201308;1095;3576;961;3293;313;1211;344;1048;657;2259
350520;201308;1252;4924;1149;4701;456;1955;286;1137;742;3092
350530;201308;2476;7607;2057;6669;822;2875;509;1493;1331;4368
350535;201308;1466;4371;1429;4320;80;268;1262;3833;1342;4101
350540;201308;2032;5992;1757;5522;516;1801;707;2202;1223;4003
350550;201308;10639;32012;8645;28501;2634;9750;3198;9826;5832;19576
350560;201308;3385;11514;3105;10978;633;2400;1705;6204;2338;8604
350570;201308;20146;71297;18547;67537;6250;24329;6669;23282;12919;47611
350580;201308;1939;6517;1676;5961;529;2068;264;806;793;2874
350590;201308;3936;13287;3206;11634;1056;4247;1117;3675;2173;7922
350600;201308;34908;92762;25229;77372;5736;19371;12129;36191;17865;55562
350610;201308;8968;26789;7339;24124;2060;7612;3434;10836;5494;18448
350620;201308;430;1416;385;1329;93;364;162;533;255;897
350630;201308;1612;5184;1285;4521;416;1669;132;412;548;2081
350635;201308;4621;15473;3833;13906;1226;4668;1471;5452;2697;10120
350640;201308;670;2156;594;1956;198;713;222;693;420;1406
350650;201308;3825;12993;2975;10944;1218;4855;290;1046;1508;5901
350660;201308;3684;12104;3272;11365;931;3464;1522;5240;2453;8704
350670;201308;1821;5804;1715;5617;356;1342;1079;3371;1435;4713
350680;201308;1174;3728;958;3289;299;1214;373;1208;672;2422
350690;201308;1043;3602;896;3272;286;1163;220;739;506;1902
350700;201308;2812;9930;2504;9216;973;3946;914;2963;1887;6909
350710;201308;2085;6737;1909;6462;369;1422;1209;4023;1578;5445
350715;201308;1110;3450;981;3194;252;911;383;1185;635;2096
350720;201308;123;403;118;388;51;181;41;118;92;299
350730;201308;406;1598;390;1549;126;547;107;395;233;942
350740;201308;2321;7166;2097;6648;596;2060;860;2722;1456;4782
350745;201308;348;1120;289;979;70;279;126;371;196;650
350750;201308;9442;29927;7348;25576;2223;8472;1810;5927;4033;14399
350760;201308;11547;37894;10582;36168;3695;14021;4406;14223;8101;28244
350770;201308;881;2684;645;2205;152;592;231;774;383;1366
350775;201308;628;1883;569;1768;143;506;247;760;390;1266
350780;201308;2018;6299;1548;5283;366;1375;317;1062;683;2437
350790;201308;2049;6833;1704;6119;596;2260;365;1178;961;3438
350800;201308;2953;10205;2823;9977;698;2803;1610;5525;2308;8328
350810;201308;2577;7650;2263;7069;776;2634;767;2452;1543;5086
350820;201308;511;1458;398;1231;90;330;153;414;243;744
350830;201308;869;2820;628;2192;132;506;126;376;258;882
350840;201308;2952;11164;2547;10060;969;4128;532;1905;1501;6033
350850;201308;6804;23409;5657;20575;1884;7288;1445;4983;3329;12271
350860;201308;3302;11002;3178;10812;553;2105;2298;7788;2851;9893
350870;201308;2345;8296;2132;7965;789;3119;1014;3803;1803;6922
350880;201308;1654;5716;1412;5154;453;1759;268;989;721;2748
350890;201308;625;1909;504;1648;102;363;162;449;264;812
350900;201308;4552;15516;3868;14033;1133;4480;1245;4231;2378;8711
350910;201308;863;2753;825;2669;377;1266;266;854;643;2120
350920;201308;9306;28808;8713;27817;1632;5855;5604;17244;7236;23099
350925;201308;5244;16694;4763;15756;1470;5354;2078;6643;3548;11997
350930;201308;1508;4310;1274;3913;173;646;877;2587;1050;3233
350940;201308;2290;7758;2100;7441;437;1829;1313;4441;1750;6270
350945;201308;930;3154;827;2936;246;965;320;1084;566;2049
350950;201308;69292;227162;59597;207186;18294;69283;23884;80591;42178;149874
350960;201308;4443;15990;3971;14936;848;3641;2097;7545;2945;11186
350970;201308;4103;15342;3784;14535;1546;6378;1152;4292;2698;10670
350980;201308;667;2188;618;2107;281;1035;122;422;403;1457
350990;201308;1734;6232;1558;5891;561;2307;551;2048;1112;4355
350995;201308;798;2953;756;2869;230;989;345;1236;575;2225
351000;201308;3488;10916;3059;10075;560;2179;1763;5522;2323;7701
351010;201308;416;1298;311;1072;127;475;60;213;187;688
351015;201308;935;3170;819;2947;319;1305;228;736;547;2041
351020;201308;7575;25395;6768;24117;1914;7354;3559;12832;5473;20186
351030;201308;1299;4991;1210;4789;400;1757;412;1583;812;3340
351040;201308;3574;11759;3321;11319;837;3354;1926;6133;2763;9487
351050;201308;8096;27616;7024;25454;2677;10459;2356;8441;5033;18900
351060;201308;31555;101492;26803;92610;9462;34529;8891;31077;18353;65606
351070;201308;1786;5210;1305;4336;490;1784;245;721;735;2505
351080;201308;2741;8379;2167;7673;697;2666;862;2993;1559;5659
351090;201308;380;1344;303;1177;111;492;43;148;154;640
351100;201308;1800;5962;1709;5813;653;2281;704;2458;1357;4739
351110;201308;7182;21997;5709;19184;2056;7568;1711;5437;3767;13005
351120;201308;578;1837;491;1631;79;322;243;721;322;1043
351130;201308;841;2342;442;1506;101;387;105;312;206;699
351140;201308;1967;6967;1809;6634;705;2835;566;2010;1271;4845
351150;201308;2128;7516;1760;6537;519;2122;425;1435;944;3557
351160;201308;1489;5348;1350;5014;469;1944;455;1622;924;3566
351170;201308;1446;4985;1258;4529;382;1492;491;1634;873;3126
351190;201308;1007;3338;894;3039;238;872;195;610;433;1482
351200;201308;2200;6705;1896;6127;366;1407;930;2714;1296;4121
351210;201308;1031;3348;902;3082;305;1130;282;908;587;2038
351220;201308;3465;11919;3036;10983;917;3644;1176;4144;2093;7788
351230;201308;1848;6338;1672;5981;573;2259;735;2566;1308;4825
351240;201308;1001;3336;743;2693;225;928;200;640;425;1568
351250;201308;848;2498;642;2063;149;523;289;889;438;1412
351260;201308;1189;3626;1055;3340;296;1028;404;1223;700;2251
351270;201308;377;1376;341;1299;123;529;110;378;233;907
351280;201308;4254;13788;3662;12324;1134;4075;1094;3331;2228;7406
351290;201308;973;3054;854;2800;295;1006;236;732;531;1738
351300;201308;9800;36953;8671;34257;2603;11136;3309;12969;5912;24105
351310;201308;3329;10652;2809;9674;764;3013;1311;4184;2075;7197
351320;201308;971;3564;879;3327;339;1386;189;632;528;2018
351330;201308;286;848;257;791;104;322;72;217;176;539
351340;201308;6423;22929;5857;21781;1724;6798;2978;11103;4702;17901
351350;201308;9001;30663;8189;28873;2696;9921;3021;10399;5717;20320
351360;201308;4836;15067;4572;14624;1284;4553;2257;7119;3541;11672
351370;201308;1903;6357;1553;5589;546;2187;362;1150;908;3337
351380;201308;36409;117288;34122;112545;9522;34342;16033;50626;25555;84968
351385;201308;248;797;242;787;95;319;86;279;181;598
351390;201308;1208;4181;1084;3917;435;1673;336;1158;771;2831
351400;201308;1210;3974;1136;3813;388;1379;426;1473;814;2852
351410;201308;2880;9022;2576;8476;645;2272;1254;4081;1899;6353
351420;201308;453;1347;314;1031;73;258;51;152;124;410
351430;201308;855;2777;774;2625;195;729;445;1469;640;2198
351440;201308;4635;14488;4081;13321;1632;5575;1075;3329;2707;8904
351450;201308;1794;5240;1581;4958;490;1569;830;2693;1320;4262
351460;201308;818;2640;686;2373;336;1250;194;619;530;1869
351470;201308;1070;3384;959;3172;402;1447;281;910;683;2357
351480;201308;2918;9782;2676;9369;709;2966;1282;4325;1991;7291
351490;201308;1956;6771;1763;6361;395;1688;954;3259;1349;4947
351492;201308;292;1012;215;798;53;233;57;165;110;398
351495;201308;146;524;128;473;42;162;47;170;89;332
351500;201308;19591;64747;17669;61000;5587;20771;7364;24984;12951;45755
351510;201308;7140;23852;6277;22411;1608;6267;3327;11767;4935;18034
351512;201308;352;1103;320;1037;91;310;121;376;212;686
351515;201308;1824;6380;1610;5880;555;2176;452;1591;1007;3767
351518;201308;1745;6254;1362;5564;453;1998;256;999;709;2997
351519;201308;751;2516;656;2292;197;788;258;853;455;1641
351520;201308;789;2262;385;1393;70;295;48;153;118;448
351530;201308;459;1483;410;1362;90;320;121;347;211;667
351535;201308;2558;6803;2110;6150;249;835;1474;4240;1723;5075
351540;201308;2075;6778;1883;6435;982;3526;361;1230;1343;4756
351550;201308;5651;17713;4488;15261;1713;6127;1145;3818;2858;9945
351560;201308;422;1426;370;1295;147;552;62;211;209;763
351565;201308;231;802;214;756;66;277;82;256;148;533
351570;201308;12758;43063;11310;39998;3821;13934;4708;16759;8529;30693
351580;201308;397;1147;301;931;48;157;115;329;163;486
351590;201308;449;1269;387;1124;140;440;88;243;228;683
351600;201308;1843;5511;1691;5223;437;1578;805;2247;1242;3825
351610;201308;646;1819;553;1655;126;433;276;776;402;1209
351620;201308;22822;78196;19144;69906;6614;26175;4820;16335;11434;42510
351630;201308;14435;49817;13309;47940;3705;13778;7358;26954;11063;40732
351640;201308;8206;27926;7118;25947;2005;7881;3595;13030;5600;20911
351650;201308;345;1056;236;787;64;237;46;144;110;381
351660;201308;940;3039;751;2595;185;712;199;619;384;1331
351670;201308;4109;13335;3561;12223;855;3338;1712;5547;2567;8885
351680;201308;706;2256;534;1826;155;562;106;333;261;895
351685;201308;440;1351;349;1188;105;374;122;427;227;801
351690;201308;1307;3921;1041;3330;472;1527;259;777;731;2304
351700;201308;1390;4335;1275;4117;441;1510;408;1272;849;2782
351710;201308;763;2451;647;2190;169;584;184;585;353;1169
351720;201308;1600;5223;1241;4251;281;1081;427;1396;708;2477
351730;201308;1078;3352;951;3164;369;1359;324;1040;693;2399
351740;201308;4490;13176;3907;11943;1109;3633;1323;3789;2432;7422
351750;201308;1492;5016;1300;4595;407;1559;339;1115;746;2674
351760;201308;3754;12400;3347;11480;870;3273;1547;5105;2417;8378
351770;201308;2245;7454;1947;6903;745;2732;822;2929;1567;5661
351780;201308;1599;4659;1124;3656;334;1201;248;767;582;1968
351790;201308;1119;3440;961;3219;293;1066;477;1565;770;2631
351800;201308;330;817;288;734;41;139;172;385;213;524
351810;201308;1187;3709;1124;3631;293;1104;690;2103;983;3207
351820;201308;2520;7551;1784;6165;701;2593;209;686;910;3279
351830;201308;3970;13342;3616;12537;973;3738;1619;5402;2592;9140
351840;201308;8787;31008;7911;29134;2754;10737;2630;9558;5384;20295
351850;201308;1192;4219;1051;3898;317;1315;216;709;533;2024
351860;201308;3527;11489;3294;11046;762;2927;1925;6140;2687;9067
351870;201308;34681;110211;32119;105761;7380;26403;19571;63988;26951;90391
351880;201308;113817;380202;101078;353844;33921;124980;31793;110864;65714;235844
351885;201308;615;2316;574;2219;169;693;251;943;420;1636
351890;201308;809;2458;638;2071;214;736;145;447;359;1183
351900;201308;1442;4538;1282;4275;473;1674;487;1640;960;3314
351905;201308;342;1277;296;1187;114;506;85;309;199;815
351907;201308;14186;46409;12462;42909;3115;12025;5846;19203;8961;31228
351910;201308;1132;3731;1040;3552;266;1026;323;1028;589;2054
351920;201308;1185;3503;1124;3412;272;940;674;1975;946;2915
351925;201308;974;2867;920;2771;122;474;671;1910;793;2384
351930;201308;3111;10932;2870;10401;892;3631;1171;3861;2063;7492
351940;201308;999;3084;941;2970;284;1000;555;1662;839;2662
351950;201308;1019;3220;910;3007;234;841;398;1245;632;2086
351960;201308;3722;12299;3241;11315;1262;4663;1164;3961;2426;8624
351970;201308;6858;26544;6339;25419;2445;10348;2052;8145;4497;18493
351980;201308;917;2914;782;2655;186;731;321;1008;507;1739
351990;201308;1562;4615;1281;4047;380;1396;380;1047;760;2443
352000;201308;2441;7973;2232;7539;555;2032;1012;3287;1567;5319
352010;201308;2271;7874;2084;7405;784;2925;487;1750;1271;4675
352020;201308;1472;4859;1344;4605;440;1585;436;1523;876;3108
352030;201308;4310;13876;3957;13423;911;3358;2328;8023;3239;11381
352040;201308;1713;6133;1476;5510;454;1820;345;1193;799;3013
352042;201308;2108;6183;1660;5268;431;1534;843;2600;1274;4134
352044;201308;1331;4597;1086;3946;285;1115;252;829;537;1944
352050;201308;7269;25238;5410;20878;1706;7306;1057;3560;2763;10866
352060;201308;788;2403;708;2280;215;807;281;813;496;1620
352070;201308;716;1994;661;1903;299;937;185;564;484;1501
352080;201308;529;1677;455;1543;127;489;159;488;286;977
352090;201308;1674;5551;1397;4974;369;1489;478;1549;847;3038
352100;201308;1747;6118;1564;5746;543;2224;565;1837;1108;4061
352110;201308;415;1575;375;1474;114;504;110;397;224;901
352115;201308;352;1183;298;1065;96;386;128;424;224;810
352120;201308;982;2940;856;2764;192;653;506;1676;698;2329
352130;201308;1723;4905;1331;4258;354;1259;572;1679;926;2938
352140;201308;1211;4096;1032;3692;341;1289;400;1420;741;2709
352150;201308;605;1833;499;1642;179;639;185;591;364;1230
352160;201308;1218;3541;1119;3394;279;932;613;1856;892;2788
352170;201308;3087;9699;2836;9274;830;2898;1311;4135;2141;7033
352180;201308;3464;10133;3055;9383;882;2973;1372;4010;2254;6983
352190;201308;1025;3255;936;3088;230;921;445;1315;675;2236
352200;201308;393;1374;335;1253;75;317;144;539;219;856
352210;201308;15646;43471;12625;38974;2642;8729;7547;23784;10189;32513
352215;201308;556;1816;499;1729;90;342;288;1025;378;1367
352220;201308;14791;50444;13841;48480;4772;17692;5579;19522;10351;37214
352230;201308;13478;47237;11998;44432;3911;15797;4596;16674;8507;32471
352240;201308;12612;40733;11717;39139;4061;15088;4669;14951;8730;30039
352250;201308;25840;85185;23074;79856;6431;24190;10086;34738;16517;58928
352260;201308;4903;15663;3725;13332;1084;4301;1121;3661;2205;7962
352265;201308;930;3056;818;2881;144;583;516;1783;660;2366
352270;201308;2550;8798;2209;7993;897;3423;505;1729;1402;5152
352280;201308;2412;7695;2087;7139;611;2302;707;2365;1318;4667
352290;201308;1280;4247;1104;3844;294;1157;322;991;616;2148
352300;201308;914;2779;779;2543;251;873;327;1052;578;1925
352310;201308;30337;106068;27815;101634;7919;31130;15728;56320;23647;87450
352320;201308;6601;21211;5860;19839;2081;7657;1880;5857;3961;13514
352330;201308;2158;7279;1901;6974;738;2913;682;2504;1420;5417
352340;201308;5672;19815;4721;17468;1689;6713;934;3197;2623;9910
352350;201308;1688;6372;1531;5994;446;1897;496;1876;942;3773
352360;201308;1165;3970;1038;3702;308;1291;529;1732;837;3023
352370;201308;891;3062;817;2896;196;790;387;1339;583;2129
352380;201308;1008;3294;884;3073;361;1392;246;820;607;2212
352390;201308;12054;37787;9746;33378;2528;9960;4310;13622;6838;23582
352400;201308;2964;9099;2057;7300;634;2476;842;2862;1476;5338
352410;201308;3938;11907;3076;10413;1136;4148;950;3093;2086;7241
352420;201308;1274;3756;1187;3624;475;1601;413;1236;888;2837
352430;201308;6169;19845;5459;18614;2194;8106;1714;5642;3908;13748
352440;201308;15182;49108;12709;44175;3506;13221;5119;17208;8625;30429
352450;201308;607;1871;424;1520;115;438;88;295;203;733
352460;201308;2623;9050;2392;8637;907;3652;893;2986;1800;6638
352470;201308;4868;13946;3031;10114;642;2330;1356;4419;1998;6749
352480;201308;5382;15586;4477;13888;1265;4509;1869;5343;3134;9852
352490;201308;723;2655;612;2377;158;684;119;452;277;1136
352500;201308;9831;33102;9328;32211;4220;15517;2958;9616;7178;25133
352510;201308;3309;11735;2738;10474;1013;4175;671;2476;1684;6651
352520;201308;2407;8685;2208;8246;566;2300;1312;4808;1878;7108
352530;201308;7214;24256;5640;20729;1767;7028;1134;3923;2901;10951
352540;201308;492;1668;409;1480;111;436;140;507;251;943
352550;201308;1041;3589;856;3187;323;1295;211;762;534;2057
352560;201308;550;1714;467;1543;92;369;221;649;313;1018
352570;201308;1623;5244;1161;4146;276;1104;316;991;592;2095
352580;201308;916;2815;798;2607;287;1055;328;995;615;2050
352585;201308;199;662;159;585;38;158;48;164;86;322
352590;201308;13439;44516;12100;41934;2915;11325;6578;22149;9493;33474
352600;201308;1839;6077;1706;5781;618;2187;567;1863;1185;4050
352610;201308;3548;11667;3176;11038;1271;4806;1030;3486;2301;8292
352620;201308;5405;17642;5128;17252;1252;4468;3240;10913;4492;15381
352630;201308;827;2819;783;2714;241;924;355;1196;596;2120
352640;201308;3001;9829;2433;8507;590;2296;943;3177;1533;5473
352650;201308;825;2493;616;2064;157;569;179;552;336;1121
352660;201308;1080;3825;891;3378;291;1176;277;1037;568;2213
352670;201308;7668;26537;6759;24780;2572;9799;2042;7601;4614;17400
352680;201308;3061;11364;2622;10145;726;3085;800;2766;1526;5851
352690;201308;23301;71561;19110;63701;5360;19656;8086;26154;13446;45810
352700;201308;764;2333;612;2097;182;703;269;890;451;1593
352710;201308;4982;15154;3699;12511;1036;3896;1344;4267;2380;8163
352720;201308;8585;29566;8097;28552;2734;10262;3214;11275;5948;21537
352725;201308;408;1248;277;941;56;227;65;210;121;437
352730;201308;2525;8918;2202;8020;633;2516;655;2126;1288;4642
352740;201308;2202;6724;1915;6184;539;2070;846;2438;1385;4508
352750;201308;358;1161;308;1076;116;435;59;178;175;613
352760;201308;905;3232;844;3116;286;1146;430;1541;716;2687
352770;201308;909;2858;858;2759;241;846;316;1019;557;1865
352780;201308;595;2083;523;1913;167;680;156;504;323;1184
352790;201308;637;1878;519;1686;163;589;104;328;267;917
352800;201308;1089;4209;902;3662;297;1237;157;584;454;1821
352810;201308;1009;2755;767;2306;152;526;307;896;459;1422
352820;201308;531;1657;452;1505;205;731;81;268;286;999
352830;201308;403;1217;313;1014;92;306;51;157;143;463
352840;201308;3388;12053;3002;11195;951;3803;1074;4001;2025;7804
352850;201308;9571;31859;8451;29829;2605;9765;3101;11114;5706;20879
352860;201308;1024;3447;938;3248;400;1475;235;731;635;2206
352870;201308;1018;2701;836;2366;146;530;450;1141;596;1671
352880;201308;2196;6772;1778;5829;447;1606;447;1302;894;2908
352885;201308;300;1045;284;1007;94;361;102;338;196;699
352890;201308;700;2058;614;1882;150;516;205;570;355;1086
352900;201308;18398;57457;14371;49041;4086;15148;5703;18743;9789;33891
352910;201308;284;938;249;858;80;290;34;96;114;386
352920;201308;3375;10563;2901;9610;986;3612;981;3009;1967;6621
352930;201308;6949;22656;5530;19443;1734;6530;1063;3571;2797;10101
352940;201308;27678;96091;24272;87824;8941;33971;5031;17815;13972;51786
352950;201308;317;1019;230;829;68;294;62;200;130;494
352960;201308;485;1612;376;1329;75;284;77;257;152;541
352965;201308;359;1021;292;897;75;244;46;136;121;380
352970;201308;3326;8893;2954;8403;375;1132;2162;6276;2537;7408
352980;201308;1465;4396;1261;4067;429;1450;503;1659;932;3109
352990;201308;3604;12279;3362;11821;1194;4550;1112;3759;2306;8309
353000;201308;520;1490;400;1239;92;323;112;301;204;624
353010;201308;2883;8483;2273;7239;739;2613;778;2275;1517;4888
353020;201308;4330;12345;3205;9906;586;2033;1333;3777;1919;5810
353030;201308;4942;15211;4344;13989;1619;5651;1050;3148;2669;8799
353040;201308;684;1991;587;1834;203;697;207;624;410;1321
353050;201308;5335;19135;4687;17756;1879;7608;1437;5184;3316;12792
353060;201308;32554;108355;30420;104878;5769;23335;19978;65958;25747;89293
353070;201308;8507;29778;6766;25655;2462;9829;1591;6092;4053;15921
353080;201308;4570;16122;3871;14456;1361;5460;1063;3745;2424;9205
353090;201308;583;2003;521;1880;101;439;245;804;346;1243
353100;201308;265;807;220;703;100;321;41;129;141;450
353110;201308;7772;24807;6972;23295;1548;5521;3943;13361;5491;18882
353120;201308;474;1654;409;1499;154;635;96;318;250;953
353130;201308;2967;9400;2629;8802;1003;3669;960;3008;1963;6677
353140;201308;2481;7180;2002;6188;680;2286;575;1585;1255;3871
353150;201308;1895;6097;1594;5509;634;2310;361;1269;995;3579
353160;201308;570;1800;485;1608;153;527;102;314;255;841
353170;201308;512;1868;467;1784;197;836;157;569;354;1405
353180;201308;4896;16059;4340;15001;805;3284;2583;8524;3388;11808
353190;201308;3537;11577;3089;10512;823;3105;1376;4292;2199;7397
353200;201308;840;3013;760;2837;246;1028;285;1002;531;2030
353205;201308;537;1749;433;1507;116;410;138;486;254;896
353210;201308;1005;2766;831;2455;134;484;492;1394;626;1878
353215;201308;557;1790;482;1627;106;410;170;583;276;993
353220;201308;892;2794;809;2622;226;816;301;934;527;1750
353230;201308;1172;3748;1098;3617;330;1210;374;1154;704;2364
353240;201308;2118;7291;1933;6903;662;2620;769;2542;1431;5162
353250;201308;1167;3390;999;3078;288;961;347;998;635;1959
353260;201308;1147;3446;1016;3225;341;1143;376;1152;717;2295
353270;201308;629;1948;540;1774;184;662;151;448;335;1110
353280;201308;544;1824;478;1709;172;650;125;441;297;1091
353282;201308;1726;5882;1678;5806;323;1249;1145;3881;1468;5130
353284;201308;325;948;256;824;78;268;80;248;158;516
353286;201308;141;429;93;313;24;78;15;52;39;130
353290;201308;427;1562;389;1481;169;678;136;502;305;1180
353300;201308;1865;6030;1683;5626;599;2159;563;1718;1162;3877
353310;201308;347;1107;327;1059;145;493;87;263;232;756
353320;201308;483;1384;423;1281;109;399;197;541;306;940
353325;201308;475;1705;401;1558;127;533;50;197;177;730
353330;201308;490;1526;410;1351;97;364;172;515;269;879
353340;201308;3104;10241;2671;9335;949;3582;887;2983;1836;6565
353350;201308;3321;10271;2949;9586;1004;3524;1352;4242;2356;7766
353360;201308;416;1483;366;1364;102;440;185;633;287;1073
353370;201308;699;2310;629;2140;185;663;289;978;474;1641
353380;201308;402;1357;363;1287;116;454;155;532;271;986
353390;201308;5079;14280;3969;12186;1064;3603;1515;4225;2579;7828
353400;201308;603;1895;506;1688;117;439;175;514;292;953
353410;201308;675;2116;576;1958;190;712;281;926;471;1638
353420;201308;649;1966;523;1644;165;553;164;475;329;1028
353430;201308;2458;8619;1858;6853;575;2166;129;379;704;2545
353440;201308;58868;196441;53618;183758;17306;62584;17719;59146;35025;121730
353450;201308;454;1423;408;1341;113;441;146;447;259;888
353460;201308;3929;11421;3426;10507;984;3271;1565;4740;2549;8011
353470;201308;11071;35756;8715;30703;2814;10836;2006;6844;4820;17680
353475;201308;1654;4930;1238;3994;343;1211;326;949;669;2160
353480;201308;1522;4650;1370;4370;322;1190;739;2223;1061;3413
353490;201308;1625;4739;1351;4180;378;1302;376;1047;754;2349
353500;201308;1178;3502;1094;3349;484;1570;365;1060;849;2630
353510;201308;1351;4478;1172;3997;339;1266;373;1131;712;2397
353520;201308;1126;3551;959;3231;387;1396;247;827;634;2223
353530;201308;2694;8301;2415;7778;687;2494;1038;3168;1725;5662
353540;201308;1900;5961;1747;5689;697;2360;608;2024;1305;4384
353550;201308;6607;19508;5913;18356;1243;4557;3254;9369;4497;13926
353560;201308;2193;7340;1847;6691;448;1895;751;2580;1199;4475
353570;201308;477;1552;399;1385;102;407;197;609;299;1016
353580;201308;2323;7808;2194;7568;799;3084;1105;3587;1904;6671
353590;201308;785;2302;671;2099;266;907;176;566;442;1473
353600;201308;1836;5445;1683;5177;404;1377;847;2616;1251;3993
353610;201308;578;2090;514;1960;163;714;173;624;336;1338
353620;201308;2329;8269;2138;7922;741;2995;758;2647;1499;5642
353625;201308;350;986;258;824;103;374;69;197;172;571
353630;201308;1760;6123;1442;5375;400;1657;317;1089;717;2746
353640;201308;1523;4461;1414;4249;410;1315;679;2094;1089;3409
353650;201308;5957;18576;4420;15038;1072;3937;1765;5667;2837;9604
353657;201308;292;1006;268;947;69;283;93;312;162;595
353660;201308;1337;3482;1014;3031;467;1519;149;306;616;1825
353670;201308;4756;15994;4176;14704;1327;5046;1402;4717;2729;9763
353680;201308;630;2315;598;2252;329;1278;145;551;474;1829
353690;201308;497;1414;345;1147;111;420;117;354;228;774
353700;201308;2267;7515;2010;6916;516;2042;639;2011;1155;4053
353710;201308;1880;6787;1629;6200;623;2608;523;1941;1146;4549
353715;201308;472;1424;414;1326;70;260;219;698;289;958
353720;201308;2057;6594;1812;6210;384;1318;1066;3816;1450;5134
353730;201308;4383;14033;3562;12096;954;3485;940;2993;1894;6478
353740;201308;2290;7101;1839;6144;655;2293;492;1580;1147;3873
353750;201308;617;2249;540;2079;189;787;138;539;327;1326
353760;201308;6692;22325;5605;20169;1818;6905;2132;7742;3950;14647
353770;201308;828;2617;552;1919;136;511;79;215;215;726
353780;201308;5710;20809;5191;19740;2558;9952;1218;4890;3776;14842
353790;201308;3088;11248;2777;10592;1036;4338;520;2019;1556;6357
353800;201308;13937;45891;11330;40675;3189;12612;4801;16740;7990;29352
353810;201308;1173;3963;1043;3672;332;1231;410;1446;742;2677
353820;201308;1198;4342;1148;4242;434;1794;427;1471;861;3265
353830;201308;781;2197;610;1863;130;435;265;796;395;1231
353850;201308;1796;6045;1679;5829;466;1750;785;2629;1251;4379
353860;201308;2371;8258;2038;7491;735;2924;699;2521;1434;5445
353870;201308;23175;74863;17991;63984;4426;17664;6328;20480;10754;38144
353880;201308;2508;8509;2305;8193;521;2129;1315;4536;1836;6665
353890;201308;2330;6253;1748;5289;537;1808;736;2092;1273;3900
353900;201308;1131;3617;850;2969;234;901;188;580;422;1481
353910;201308;2084;7496;1984;7217;663;2574;828;3035;1491;5609
353920;201308;2569;7818;1997;6613;509;1752;396;1217;905;2969
353930;201308;3649;13304;3224;12393;1241;5092;761;2797;2002;7889
353940;201308;1504;4892;1328;4535;348;1384;528;1641;876;3025
353950;201308;3609;12080;3329;11558;612;2453;2112;7121;2724;9574
353960;201308;572;1873;473;1638;122;474;134;393;256;867
353970;201308;520;1558;457;1474;54;211;339;1067;393;1278
353980;201308;13982;42110;11879;38755;3018;10647;6234;20074;9252;30721
353990;201308;507;1622;462;1507;149;540;165;476;314;1016
354000;201308;1870;5679;1288;4485;310;1205;129;387;439;1592
354010;201308;378;1215;340;1147;172;598;87;295;259;893
354020;201308;4584;14349;4178;13488;1453;5060;1639;4965;3092;10025
354025;201308;1043;3067;827;2657;228;808;202;624;430;1432
354030;201308;591;1601;436;1385;154;545;137;398;291;943
354040;201308;770;2138;619;1870;97;366;371;1036;468;1402
354050;201308;904;3125;831;2954;342;1294;222;779;564;2073
354060;201308;4238;14248;3547;12777;1015;3969;1453;5017;2468;8986
354070;201308;3533;11933;3094;10940;1186;4507;745;2577;1931;7084
354075;201308;2249;8643;2150;8462;768;3264;918;3541;1686;6805
354080;201308;1864;5810;1511;4949;419;1432;498;1535;917;2967
354085;201308;295;851;263;792;35;141;177;483;212;624
354090;201308;1091;3368;1041;3293;161;567;765;2368;926;2935
354100;201308;16528;57779;14380;53797;3873;15492;6804;25434;10677;40926
354105;201308;843;2734;699;2445;196;824;241;726;437;1550
354110;201308;777;2357;654;2158;180;660;206;635;386;1295
354120;201308;2172;6338;1889;5838;590;2034;650;1857;1240;3891
354130;201308;6180;19436;5533;18143;2025;7071;1808;5739;3833;12810
354140;201308;18732;50979;12570;38761;2623;9215;5305;15174;7928;24389
354150;201308;4376;12668;3592;11288;1121;3890;1412;4280;2533;8170
354160;201308;3883;13149;3470;12266;1052;4018;1411;4795;2463;8813
354165;201308;390;1468;356;1380;124;501;85;347;209;848
354170;201308;1586;5310;1305;4619;301;1208;459;1459;760;2667
354180;201308;507;1571;484;1523;50;186;348;1046;398;1232
354190;201308;1621;5544;1404;5027;490;1844;419;1443;909;3287
354200;201308;1143;3398;949;3038;234;894;365;1016;599;1910
354210;201308;848;3025;763;2823;198;867;299;1007;497;1874
354220;201308;3030;9803;2763;9285;1018;3632;1046;3416;2064;7048
354230;201308;784;2646;744;2578;241;885;342;1184;583;2069
354240;201308;1266;4409;1051;3936;327;1348;269;968;596;2316
354250;201308;523;1718;436;1568;191;764;115;392;306;1156
354260;201308;9367;28901;8513;27511;2725;9655;3472;11145;6197;20800
354270;201308;1119;4038;1044;3867;339;1397;411;1511;750;2908
354280;201308;879;2662;822;2564;178;624;434;1356;612;1980
354290;201308;1303;4724;1201;4498;404;1623;309;1128;713;2751
354300;201308;3861;13644;3771;13464;1045;3968;2007;7105;3052;11073
354310;201308;775;2639;619;2246;181;714;139;506;320;1220
354320;201308;819;2532;714;2319;220;808;239;713;459;1521
354323;201308;327;989;268;892;93;340;98;292;191;632
354325;201308;1282;4484;1173;4236;352;1448;419;1379;771;2827
354330;201308;7871;25119;7191;23752;2027;7196;3739;12076;5766;19272
354340;201308;29335;97793;25293;90260;9834;37690;8824;30506;18658;68196
354350;201308;1142;3511;1070;3378;313;1044;552;1682;865;2726
354360;201308;441;1459;366;1324;95;372;42;146;137;518
354370;201308;1149;3926;1027;3667;176;758;703;2425;879;3183
354380;201308;1299;3974;1087;3592;419;1546;190;545;609;2091
354390;201308;11136;36966;8540;31007;2318;9262;2628;9091;4946;18353
354400;201308;2085;7498;1832;6870;491;2019;578;2046;1069;4065
354410;201308;6230;19543;5283;18069;1293;4846;2862;9734;4155;14580
354420;201308;1641;4927;1407;4423;468;1581;452;1353;920;2934
354425;201308;3502;10316;3068;9533;1092;3611;953;3030;2045;6641
354430;201308;1304;4367;1206;4222;325;1267;573;1933;898;3200
354440;201308;504;1574;420;1409;110;407;153;489;263;896
354450;201308;451;1328;326;1045;57;236;98;270;155;506
354460;201308;720;2289;676;2208;266;899;334;1088;600;1987
354470;201308;446;1365;377;1223;74;302;165;484;239;786
354480;201308;728;2259;651;2122;153;592;290;819;443;1411
354490;201308;727;2509;563;2082;150;605;185;600;335;1205
354500;201308;2523;8703;2317;8318;875;3456;721;2595;1596;6051
354510;201308;662;2286;592;2126;196;759;216;766;412;1525
354515;201308;338;1200;283;1073;77;330;89;310;166;640
354520;201308;5087;18530;4390;16888;1489;6336;1493;5486;2982;11822
354530;201308;2665;9850;2498;9509;746;3027;1317;5010;2063;8037
354540;201308;1345;4283;1186;4001;410;1463;423;1476;833;2939
354550;201308;515;1790;456;1629;104;391;160;541;264;932
354560;201308;1359;4194;1091;3585;342;1147;321;1023;663;2170
354570;201308;595;1914;494;1664;188;686;115;366;303;1052
354580;201308;8695;26185;7373;23593;1655;6031;3650;11057;5305;17088
354600;201308;1688;5971;1506;5609;506;2151;606;2117;1112;4268
354610;201308;470;1334;335;1065;74;244;97;272;171;516
354620;201308;415;1473;342;1337;103;466;113;412;216;878
354625;201308;273;928;234;848;58;239;60;211;118;450
354630;201308;1847;6597;1670;6157;698;2601;525;1841;1223;4442
354640;201308;4088;13991;3533;12762;1104;4481;825;2751;1929;7232
354650;201308;982;3057;891;2861;193;719;482;1482;675;2201
354660;201308;1925;5930;1511;5115;513;1936;519;1667;1032;3603
354670;201308;1655;5491;1317;4602;402;1535;340;1022;742;2557
354680;201308;5160;17858;4780;17019;1428;5411;1827;6358;3255;11769
354690;201308;634;2402;525;2083;131;560;177;635;308;1195
354700;201308;1146;3308;804;2560;137;529;343;938;480;1467
354710;201308;616;1883;535;1725;151;573;179;519;330;1092
354720;201308;184;539;147;461;57;177;39;128;96;305
354730;201308;7186;26173;6470;24660;2127;8626;2517;9303;4644;17929
354740;201308;227;763;193;687;47;173;45;161;92;334
354750;201308;2280;7487;1950;7025;694;2698;701;2476;1395;5174
354760;201308;2166;7362;1862;6664;650;2463;472;1627;1122;4090
354765;201308;252;708;185;589;37;143;40;107;77;250
354770;201308;2767;8312;2228;7407;1017;3628;380;1184;1397;4812
354780;201308;32432;107802;30513;103252;8247;30718;15075;48572;23322;79290
354790;201308;874;2884;794;2771;231;900;417;1370;648;2270
354800;201308;2121;6698;1962;6472;601;2148;1102;3616;1703;5764
354805;201308;859;2734;670;2313;123;492;128;404;251;896
354810;201308;654;2222;521;1950;206;840;82;296;288;1136
354820;201308;1034;3790;939;3583;315;1356;231;806;546;2162
354830;201308;425;1344;376;1246;110;424;137;416;247;840
354840;201308;790;2425;731;2308;240;816;244;744;484;1560
354850;201308;14544;48467;11371;41617;3314;13446;3937;13442;7251;26888
354860;201308;1247;4168;1136;3970;333;1383;502;1636;835;3019
354870;201308;42138;138878;39766;133926;12279;44401;19537;63951;31816;108352
354880;201308;3977;12849;2969;10551;943;3666;728;2336;1671;6002
354890;201308;14605;46063;12676;42128;3725;13684;4539;14339;8264;28023
354900;201308;598;1708;485;1547;174;611;169;535;343;1146
354910;201308;5467;17746;3738;13699;1026;4126;518;1819;1544;5945
354920;201308;498;1491;386;1279;117;413;92;290;209;703
354925;201308;360;1064;212;746;42;162;35;111;77;273
354930;201308;249;770;229;721;75;273;60;177;135;450
354940;201308;2455;8776;1937;7366;832;3327;343;1256;1175;4583
354950;201308;1442;4918;1324;4748;256;1083;812;2822;1068;3905
354960;201308;781;2502;686;2345;205;781;302;986;507;1767
354970;201308;3959;13640;3505;12675;890;3636;1708;5888;2598;9524
354980;201308;32135;80837;17863;55727;4051;14077;6042;17467;10093;31544
354990;201308;34008;118095;31898;113626;7775;30767;17005;58691;24780;89458
354995;201308;1929;6196;1823;6038;489;1720;920;3068;1409;4788
355000;201308;1612;5566;1428;5239;558;2182;392;1418;950;3600
355010;201308;3590;11593;3087;10499;800;3033;1453;4816;2253;7849
355020;201308;3151;11644;2755;10850;1405;5843;719;2859;2124;8702
355030;201308;782285;2381942;723790;2266607;212911;721173;296488;906033;509399;1627206
355040;201308;2824;9547;2521;8958;937;3664;1110;3748;2047;7412
355050;201308;1227;4004;1016;3556;304;1157;276;951;580;2108
355060;201308;4756;16746;3849;14588;1161;4875;807;2759;1968;7634
355070;201308;6147;20052;5540;19013;1376;5433;2931;9505;4307;14938
355080;201308;1271;4807;1086;4295;406;1787;159;529;565;2316
355090;201308;1053;3883;897;3494;214;921;386;1435;600;2356
355100;201308;29152;96830;26253;91596;9645;35242;8833;31691;18478;66933
355110;201308;1290;4583;1181;4346;428;1698;384;1369;812;3067
355120;201308;645;2108;564;1941;185;692;219;720;404;1412
355130;201308;479;1357;346;1083;99;340;106;274;205;614
355140;201308;1002;3689;963;3594;302;1247;429;1543;731;2790
355150;201308;3296;11504;2929;10746;1006;3855;1093;3867;2099;7722
355160;201308;1461;5217;1285;4911;558;2365;351;1191;909;3556
355170;201308;8659;26459;6656;22665;2386;8782;1890;6239;4276;15021
355180;201308;2791;8943;2464;8338;741;2869;935;2998;1676;5867
355190;201308;1260;4511;1162;4293;495;1883;333;1192;828;3075
355200;201308;894;3403;856;3320;434;1756;201;765;635;2521
355210;201308;2679;9493;2437;8961;777;3213;935;3163;1712;6376
355220;201308;28371;99497;26309;95388;11972;44918;7316;27321;19288;72239
355230;201308;1023;3144;680;2355;133;540;162;479;295;1019
355240;201308;21163;66968;16503;56338;4125;15810;6605;20793;10730;36603
355250;201308;23817;82446;21767;78495;6583;25404;10263;36519;16846;61923
355255;201308;869;2473;639;1970;119;418;197;565;316;983
355260;201308;1579;4712;1417;4410;403;1402;539;1555;942;2957
355270;201308;1646;5156;1561;5019;244;993;1100;3335;1344;4328
355280;201308;21920;68410;19727;64204;5281;19330;9045;28247;14326;47577
355290;201308;857;2809;792;2689;168;638;388;1249;556;1887
355300;201308;844;2816;662;2412;169;680;159;525;328;1205
355310;201308;1017;3219;917;3032;257;885;399;1365;656;2250
355320;201308;724;2380;639;2180;196;742;213;623;409;1365
355330;201308;1463;5479;1265;5083;512;2272;311;1130;823;3402
355340;201308;2979;8302;2812;8020;768;2460;1519;4098;2287;6558
355350;201308;1337;4893;1204;4591;441;1813;297;1159;738;2972
355360;201308;1121;4046;1061;3925;279;1152;670;2426;949;3578
355365;201308;312;1007;263;904;79;308;68;225;147;533
355370;201308;6826;18309;5126;16332;2012;7021;1871;5922;3883;12943
355380;201308;3656;11374;2849;9475;852;3045;607;1790;1459;4835
355385;201308;976;3267;927;3177;391;1480;224;709;615;2189
355390;201308;1395;3999;1204;3607;335;1080;409;1203;744;2283
355395;201308;1542;4923;1279;4272;236;921;572;1741;808;2662
355400;201308;8577;30385;7914;28995;2598;10480;3553;12562;6151;23042
355410;201308;12330;46508;11664;45100;4853;19835;3355;13076;8208;32911
355420;201308;809;3012;777;2943;335;1324;248;962;583;2286
355430;201308;3557;10867;3122;10072;891;3163;1328;4142;2219;7305
355440;201308;873;2968;721;2568;223;833;196;626;419;1459
355450;201308;2484;8441;2103;7642;679;2700;636;2166;1315;4866
355460;201308;555;1625;431;1388;124;472;122;334;246;806
355465;201308;428;1317;362;1183;110;384;99;315;209;699
355470;201308;923;2941;755;2644;291;1129;229;742;520;1871
355475;201308;140;542;120;477;31;129;37;161;68;290
355480;201308;3171;11804;2986;11380;993;4101;1256;4623;2249;8724
355490;201308;782;2367;633;2064;191;683;137;444;328;1127
355495;201308;697;2378;667;2328;204;782;278;928;482;1710
355500;201308;8146;25310;5767;19923;1484;5669;1177;3724;2661;9393
355510;201308;1697;5231;1441;4630;343;1259;392;1189;735;2448
355520;201308;364;995;261;789;66;235;72;184;138;419
355530;201308;178;486;111;361;29;107;22;68;51;175
355535;201308;735;2290;609;2044;179;708;194;556;373;1264
355540;201308;10100;33442;9596;32577;2837;10368;4776;15917;7613;26285
355550;201308;704;2269;660;2179;198;726;303;965;501;1691
355560;201308;1428;4298;1106;3670;280;1056;254;719;534;1775
355570;201308;182;631;160;577;43;168;36;114;79;282
355580;201308;1206;3728;1057;3415;431;1542;334;1019;765;2561
355590;201308;245;699;219;647;50;181;108;307;158;488
355600;201308;1021;3417;872;3071;385;1432;207;688;592;2120
355610;201308;1404;4200;1201;3878;376;1330;488;1512;864;2842
355620;201308;3788;12536;3104;10973;792;3221;1294;4131;2086;7352
355630;201308;3195;9486;2047;7016;439;1707;720;2263;1159;3970
355635;201308;964;3297;854;3094;211;848;464;1636;675;2484
355640;201308;3754;12775;3183;11411;1190;4464;599;2127;1789;6591
355645;201308;3355;12350;3200;12042;703;2940;1934;7175;2637;10115
355650;201308;6335;20599;5578;19097;1371;5584;3095;9777;4466;15361
355660;201308;1264;4208;1056;3789;369;1493;340;1123;709;2616
355670;201308;2044;6804;1447;5342;400;1687;468;1511;868;3198
355680;201308;1707;6046;1443;5384;582;2281;281;997;863;3278
355690;201308;325;1143;296;1089;194;749;23;59;217;808
355695;201308;326;1000;241;794;39;135;25;66;64;201
355700;201308;6237;22833;5789;21708;1823;7424;2493;8946;4316;16370
355710;201308;11801;31584;7921;24446;2807;9231;1952;5857;4759;15088
355715;201308;186;606;147;529;45;170;29;102;74;272
355720;201308;1545;5262;1318;4782;483;1932;378;1231;861;3163
355730;201308;768;2729;699;2588;286;1124;163;622;449;1746
410010;201308;1595;5216;1459;4917;421;1533;507;1719;928;3252
410020;201308;1207;4227;1137;4095;378;1426;403;1426;781;2852
410030;201308;1121;4016;985;3683;347;1384;203;785;550;2169
410040;201308;12269;42224;11378;40424;4275;16310;3265;11428;7540;27738
410045;201308;1061;3139;808;2669;262;932;272;851;534;1783
410050;201308;2918;8745;2124;7226;735;2736;635;2095;1370;4831
410060;201308;1867;6130;1699;5777;539;2042;599;1951;1138;3993
410070;201308;2135;6219;1751;5415;675;2284;349;953;1024;3237
410080;201308;1413;4354;1218;4015;304;1079;659;2106;963;3185
410090;201308;1114;3641;1015;3429;376;1373;309;990;685;2363
410100;201308;2842;8785;2310;7684;729;2777;509;1597;1238;4374
410105;201308;487;1614;400;1398;109;438;76;234;185;672
410110;201308;2498;7936;2231;7367;576;2166;817;2616;1393;4782
410115;201308;536;1528;462;1372;118;421;149;382;267;803
410120;201308;2838;9989;2699;9771;1103;4257;1036;3810;2139;8067
410130;201308;1345;4642;1236;4384;359;1247;624;2252;983;3499
410140;201308;14175;41092;10432;33958;3407;12304;3620;11617;7027;23921
410150;201308;16699;43961;8563;26729;1889;6732;1733;4824;3622;11556
410160;201308;3262;10715;2984;10234;1019;3838;1082;3738;2101;7576
410165;201308;755;2360;646;2118;139;499;318;1012;457;1511
410170;201308;1648;5210;1429;4741;568;2050;409;1309;977;3359
410180;201308;8268;27265;7229;24958;1935;7621;3330;10667;5265;18288
410185;201308;655;1857;600;1764;150;463;360;1075;510;1538
410190;201308;2164;6669;1963;6233;646;2238;561;1690;1207;3928
410200;201308;4949;14619;4151;13048;1498;5182;727;2200;2225;7382
410210;201308;2536;7879;2032;6789;530;2013;423;1229;953;3242
410220;201308;603;1807;492;1579;105;374;183;567;288;941
410230;201308;1792;5936;1656;5696;663;2484;561;1865;1224;4349
410240;201308;5007;16067;4655;15342;1571;5577;1719;5618;3290;11195
410250;201308;2419;7047;1816;5828;622;2230;361;1022;983;3252
410260;201308;1627;5158;1452;4849;459;1647;507;1657;966;3304
410270;201308;529;1599;465;1482;152;523;187;602;339;1125
410275;201308;872;2662;659;2246;122;462;362;1232;484;1694
410280;201308;2730;8368;1947;6626;483;1861;320;1051;803;2912
410290;201308;3113;10043;2812;9456;848;3075;1105;3735;1953;6810
410300;201308;605;1778;552;1671;89;338;318;886;407;1224
410302;201308;534;1631;474;1542;58;188;314;1050;372;1238
410304;201308;1418;4768;1303;4538;397;1428;570;2063;967;3491
410305;201308;2146;5881;1844;5441;557;1732;977;2947;1534;4679
410310;201308;2253;7767;2079;7422;699;2708;711;2611;1410;5319
410315;201308;596;1937;509;1768;141;538;228;758;369;1296
410320;201308;1185;3563;844;2874;211;832;87;240;298;1072
410322;201308;544;1660;415;1364;119;418;119;380;238;798
410330;201308;1420;4137;1220;3740;374;1259;366;1070;740;2329
410335;201308;1041;3155;890;2870;256;937;315;952;571;1889
410337;201308;763;2114;671;1956;139;485;289;784;428;1269
410340;201308;563;1745;431;1401;89;327;104;284;193;611
410345;201308;1724;5333;1469;4817;517;1860;335;1005;852;2865
410347;201308;814;2358;601;1954;189;683;134;389;323;1072
410350;201308;959;3116;748;2691;235;933;122;407;357;1340
410360;201308;3279;10396;2997;9916;1027;3672;892;2991;1919;6663
410370;201308;12401;37425;9588;31469;2717;10101;2788;8497;5505;18598
410380;201308;1316;4265;1228;4091;315;1130;645;2131;960;3261
410390;201308;2766;8326;2273;7453;851;2986;639;1933;1490;4919
410395;201308;865;3044;797;2897;216;875;397;1437;613;2312
410400;201308;4989;16556;4440;15450;1464;5686;1296;4354;2760;10040
410405;201308;932;2834;768;2497;208;795;319;959;527;1754
410410;201308;1329;4648;1271;4541;492;1933;311;1072;803;3005
410420;201308;9491;31693;8506;29483;3015;11397;2371;7738;5386;19135
410425;201308;3132;10363;2318;8453;574;2358;388;1360;962;3718
410430;201308;14777;42385;11450;36174;3520;12203;3384;10582;6904;22785
410440;201308;3471;11347;3232;10925;854;3058;1625;5567;2479;8625
410442;201308;2890;10295;2667;9757;954;3694;874;3205;1828;6899
410445;201308;2312;8019;2027;7494;660;2627;792;3046;1452;5673
410450;201308;2523;7449;2104;6640;684;2337;504;1468;1188;3805
410460;201308;2322;7157;1962;6396;528;1873;756;2365;1284;4238
410465;201308;1683;6504;1549;6162;606;2495;458;1723;1064;4218
410470;201308;1869;6069;1679;5643;494;1753;641;2161;1135;3914
410480;201308;28245;85540;23725;76762;9323;32939;6395;19834;15718;52773
410490;201308;10926;36847;9340;33306;3156;12220;3096;10968;6252;23188
410500;201308;1424;4686;1238;4284;478;1790;322;1129;800;2919
410510;201308;2280;6286;1756;5263;505;1648;715;2000;1220;3648
410520;201308;3154;11287;3017;11008;1188;4563;1027;3771;2215;8334
410530;201308;1599;4726;1371;4271;377;1364;527;1519;904;2883
410540;201308;3754;11178;2779;9361;754;2739;1031;3468;1785;6207
410550;201308;6235;19919;4989;17073;1682;6347;735;2275;2417;8622
410560;201308;1208;4034;969;3394;247;918;240;715;487;1633
410570;201308;2713;9199;2497;8827;774;2837;1069;3994;1843;6831
410580;201308;24366;79641;21865;74524;7746;28875;6572;21392;14318;50267
410590;201308;1227;4004;861;2970;168;663;216;662;384;1325
410600;201308;1827;5671;1596;5217;478;1637;710;2357;1188;3994
410610;201308;814;2585;724;2413;216;784;310;986;526;1770
410620;201308;1671;6181;1523;5795;520;2094;398;1487;918;3581
410630;201308;2481;7521;2159;6914;619;2224;868;2696;1487;4920
410640;201308;4665;14241;3918;12876;1363;5053;957;2986;2320;8039
410645;201308;1261;4587;1213;4486;499;1986;386;1453;885;3439
410650;201308;2389;7541;2024;6819;739;2610;570;1860;1309;4470
410655;201308;862;2754;754;2529;248;888;204;673;452;1561
410657;201308;565;1808;519;1715;166;644;199;590;365;1234
410660;201308;3744;11133;2972;9444;1106;3755;619;1831;1725;5586
410670;201308;981;2900;765;2462;212;756;210;638;422;1394
410680;201308;2275;8196;1949;7312;563;2167;704;2781;1267;4948
410685;201308;647;2011;611;1948;122;395;396;1273;518;1668
410690;201308;103033;306039;73697;245198;19281;71494;19251;57894;38532;129388
410700;201308;2202;7389;2088;7162;740;2766;806;2628;1546;5394
410710;201308;1046;3383;875;2968;221;850;255;814;476;1664
410712;201308;740;2359;661;2192;310;1120;161;549;471;1669
410715;201308;1056;3384;931;3113;265;963;316;1021;581;1984
410720;201308;3870;12523;3307;11287;1018;3695;954;3113;1972;6808
410725;201308;1080;3152;810;2620;224;785;256;738;480;1523
410730;201308;688;2141;634;2025;284;967;168;515;452;1482
410740;201308;898;2782;657;2276;164;650;272;923;436;1573
410750;201308;1762;5496;1582;5062;547;1961;447;1298;994;3259
410752;201308;244;761;222;723;54;208;106;319;160;527
410753;201308;493;1552;412;1387;109;423;150;459;259;882
410754;201308;963;3067;858;2887;128;480;572;1996;700;2476
410755;201308;681;1958;550;1734;130;484;259;747;389;1231
410760;201308;2408;8053;2304;7848;928;3337;793;2666;1721;6003
410765;201308;14995;46193;11696;39444;3083;11567;2338;7766;5421;19333
410770;201308;837;2458;716;2232;264;910;213;612;477;1522
410773;201308;1209;3908;1096;3690;307;1154;480;1498;787;2652
410775;201308;1770;5387;1735;5334;480;1403;1102;3556;1582;4959
410780;201308;583;1846;508;1697;153;535;149;536;302;1071
410785;201308;894;2985;738;2516;263;929;272;930;535;1859
410790;201308;730;2321;632;2093;224;830;138;402;362;1232
410800;201308;2254;6558;1940;6041;828;2810;582;1731;1410;4541
410810;201308;308;961;249;822;34;134;104;333;138;467
410820;201308;1033;3219;915;2949;282;999;265;835;547;1834
410830;201308;29685;92867;25303;84805;8057;29376;8643;28760;16700;58136
410832;201308;1141;3514;1051;3342;245;920;520;1532;765;2452
410840;201308;7161;23417;6293;21475;2234;8332;1485;4652;3719;12984
410845;201308;1548;4788;1370;4419;281;997;766;2476;1047;3473
410850;201308;2659;8065;2428;7747;545;2038;1320;4160;1865;6198
410855;201308;703;2067;609;1877;175;589;206;628;381;1217
410860;201308;3389;10218;2960;9439;791;2656;1351;4465;2142;7121
410865;201308;1626;5754;1472;5443;370;1485;736;2756;1106;4241
410870;201308;1360;4337;1287;4216;615;2198;361;1111;976;3309
410880;201308;4999;14990;4129;13373;1303;4747;1143;3375;2446;8122
410890;201308;1081;3439;840;2968;291;1129;111;331;402;1460
410895;201308;1117;4010;1023;3789;375;1458;326;1169;701;2627
410900;201308;847;2464;670;2181;140;522;203;625;343;1147
410910;201308;307;982;272;917;63;227;124;400;187;627
410920;201308;800;2527;654;2252;203;748;176;557;379;1305
410930;201308;2008;6495;1789;6131;558;2198;669;2210;1227;4408
410940;201308;19983;69836;18248;66600;6118;24249;7790;28536;13908;52785
410950;201308;1871;6343;1715;6048;372;1363;1021;3678;1393;5041
410960;201308;5953;17480;4407;14764;1580;5664;1402;4812;2982;10476
410965;201308;1045;3487;956;3306;247;929;485;1712;732;2641
410970;201308;4965;15588;4213;14036;1487;5550;966;3242;2453;8792
410975;201308;1372;4150;1167;3780;216;827;605;1949;821;2776
410980;201308;5020;15353;3507;12059;999;3823;878;2848;1877;6671
410990;201308;1027;3230;792;2705;251;965;197;587;448;1552
411000;201308;439;1373;324;1114;77;300;52;155;129;455
411005;201308;456;1395;368;1179;100;318;67;191;167;509
411007;201308;2103;6986;1993;6785;616;2207;995;3519;1611;5726
411010;201308;3769;13160;3520;12594;1428;5582;894;3012;2322;8594
411020;201308;2535;8392;2325;8018;789;3029;868;3003;1657;6032
411030;201308;803;2291;706;2117;233;773;201;549;434;1322
411040;201308;351;1156;292;1014;104;382;61;200;165;582
411050;201308;2103;7807;1914;7356;764;3129;412;1571;1176;4700
411060;201308;2039;6622;1792;6102;602;2296;330;1020;932;3316
411065;201308;381;1179;308;1029;55;200;110;332;165;532
411070;201308;3974;13395;3091;11399;1038;4230;367;1208;1405;5438
411080;201308;1977;6373;1835;6076;491;1817;810;2649;1301;4466
411090;201308;1041;2930;901;2734;255;893;255;713;510;1606
411095;201308;1547;4598;1242;4014;337;1214;315;978;652;2192
411100;201308;1484;4360;1136;3678;279;1017;273;862;552;1879
411110;201308;901;2765;710;2357;217;776;125;346;342;1122
411120;201308;1632;5314;1462;4943;487;1770;470;1569;957;3339
411125;201308;4597;15235;4477;14995;1619;5712;2129;7066;3748;12778
411130;201308;750;2358;634;2111;202;705;225;764;427;1469
411140;201308;2210;8096;1959;7432;743;2958;389;1584;1132;4542
411150;201308;5640;16571;4992;15347;1561;5224;1460;4153;3021;9377
411155;201308;1133;3485;1025;3234;369;1274;323;930;692;2204
411160;201308;303;924;275;871;114;376;84;255;198;631
411170;201308;767;2669;703;2512;211;804;232;814;443;1618
411180;201308;5969;18841;5299;17592;1703;6172;1632;5372;3335;11544
411190;201308;1766;5352;1492;4834;464;1679;442;1350;906;3029
411200;201308;3802;12371;3368;11650;1279;4801;1195;4068;2474;8869
411210;201308;2745;8088;2266;7219;898;3123;321;956;1219;4079
411220;201308;1177;3490;956;3073;250;924;398;1162;648;2086
411230;201308;989;3137;817;2758;281;1048;223;692;504;1740
411240;201308;1082;3066;791;2540;296;1062;188;522;484;1584
411250;201308;3073;8772;2551;7793;789;2509;818;2505;1607;5014
411260;201308;259;755;207;666;64;236;89;266;153;502
411270;201308;1997;6492;1850;6236;622;2329;780;2540;1402;4869
411275;201308;1502;4622;1342;4270;405;1343;394;1218;799;2561
411280;201308;1707;5359;1369;4629;414;1599;214;654;628;2253
411290;201308;1015;2933;851;2610;227;755;299;955;526;1710
411295;201308;1094;3379;1018;3256;220;788;462;1437;682;2225
411300;201308;1272;3374;898;2639;87;297;383;1045;470;1342
411310;201308;823;2457;666;2189;162;628;302;954;464;1582
411320;201308;5591;17699;4662;15818;1341;4775;1303;4293;2644;9068
411325;201308;1494;4985;1358;4723;183;745;914;3190;1097;3935
411330;201308;3410;11510;3141;11052;1230;4684;981;3408;2211;8092
411340;201308;962;2884;653;2148;126;458;268;891;394;1349
411342;201308;893;2608;732;2246;212;721;199;535;411;1256
411345;201308;1013;3375;953;3261;280;1036;485;1662;765;2698
411350;201308;2481;8036;1975;7010;678;2588;282;917;960;3505
411360;201308;505;1287;326;954;33;135;163;412;196;547
411370;201308;41067;122824;31464;104283;7630;29794;10709;32314;18339;62108
411373;201308;1372;4501;1178;4075;350;1390;272;877;622;2267
411375;201308;1301;3694;1050;3194;300;966;302;876;602;1842
411380;201308;1241;3366;791;2432;152;527;238;708;390;1235
411390;201308;1743;5518;1605;5325;261;1004;1160;3742;1421;4746
411400;201308;1608;5000;1347;4423;342;1258;465;1489;807;2747
411410;201308;2366;7565;2115;7004;729;2769;589;1656;1318;4425
411420;201308;4360;12921;3526;11179;1079;3831;816;2337;1895;6168
411430;201308;2720;9059;2362;8398;704;2704;1056;3634;1760;6338
411435;201308;542;1809;468;1616;136;520;147;481;283;1001
411440;201308;2519;8464;2317;8084;870;3279;688;2425;1558;5704
411450;201308;1876;5955;1725;5701;446;1546;892;3014;1338;4560
411460;201308;4050;13360;3351;11692;1371;5075;621;2043;1992;7118
411470;201308;906;2837;689;2308;199;713;145;455;344;1168
411480;201308;4362;13956;3693;12642;1703;6278;779;2545;2482;8823
411490;201308;1596;5201;1438;4910;648;2472;317;971;965;3443
411500;201308;1394;4342;1093;3670;373;1380;256;809;629;2189
411510;201308;2399;7204;1944;6324;636;2298;403;1149;1039;3447
411520;201308;26900;78740;18725;61564;6376;23215;3945;12222;10321;35437
411530;201308;863;2530;607;2046;263;992;120;354;383;1346
411535;201308;483;1501;279;1006;61;240;27;79;88;319
411540;201308;2789;7880;2264;6917;477;1591;1166;3623;1643;5214
411545;201308;966;3562;933;3490;216;891;601;2233;817;3124
411550;201308;681;1972;561;1772;255;865;112;338;367;1203
411560;201308;2504;7769;2142;6929;628;2228;511;1539;1139;3767
411570;201308;5080;14890;4132;13320;1378;4867;1080;3690;2458;8557
411573;201308;960;3074;919;3007;238;834;483;1613;721;2447
411575;201308;1378;4565;1227;4220;343;1258;486;1659;829;2917
411580;201308;3318;10333;2641;8955;660;2600;492;1468;1152;4068
411585;201308;440;1559;354;1308;95;376;49;165;144;541
411590;201308;551;1699;499;1589;146;534;130;386;276;920
411600;201308;353;1089;297;977;71;284;69;225;140;509
411605;201308;2216;6432;1710;5466;472;1676;666;2043;1138;3719
411610;201308;2151;6502;2053;6334;510;1685;1315;4009;1825;5694
411620;201308;2637;8963;2502;8731;873;3316;994;3512;1867;6828
411630;201308;676;1872;424;1460;141;559;81;241;222;800
411640;201308;560;1756;471;1570;141;519;167;521;308;1040
411650;201308;264;869;219;764;66;264;71;219;137;483
411660;201308;745;2268;662;2112;182;606;272;889;454;1495
411670;201308;1633;4935;1474;4636;510;1818;500;1444;1010;3262
411680;201308;1643;5228;1458;4909;393;1315;784;2821;1177;4136
411690;201308;3417;10617;2990;9809;1093;3856;827;2734;1920;6590
411695;201308;798;2615;687;2393;142;510;358;1259;500;1769
411700;201308;1762;5369;1380;4640;411;1546;401;1288;812;2834
411705;201308;2216;7767;1965;7296;486;1842;1148;4368;1634;6210
411710;201308;2134;6722;1704;5709;531;1957;352;1026;883;2983
411720;201308;826;2554;661;2157;167;607;165;499;332;1106
411721;201308;687;2119;600;1949;177;636;193;583;370;1219
411722;201308;657;2039;543;1815;148;574;169;516;317;1090
411725;201308;1253;4176;914;3355;249;1018;273;1010;522;2028
411727;201308;2307;6749;1911;5936;502;1728;819;2435;1321;4163
411729;201308;508;1453;409;1283;80;281;158;455;238;736
411730;201308;5376;16439;4621;14967;1425;4997;1745;5644;3170;10641
411740;201308;515;1558;422;1362;128;485;165;480;293;965
411745;201308;832;2698;701;2389;213;800;175;547;388;1347
411750;201308;3720;11878;3158;10663;1032;3846;540;1639;1572;5485
411760;201308;8407;25966;7699;24775;2959;10075;2447;8264;5406;18339
411770;201308;3651;13410;3381;12758;1402;5532;767;2937;2169;8469
411780;201308;2905;9989;2829;9887;438;1468;2042;7517;2480;8985
411790;201308;2528;7925;2124;7157;742;2821;586;1895;1328;4716
411800;201308;1179;3665;774;2643;150;572;113;291;263;863
411810;201308;1448;4663;1258;4214;351;1349;310;862;661;2211
411820;201308;15842;50904;13399;46415;4816;17172;4269;15671;9085;32843
411830;201308;435;1229;361;1128;118;374;143;479;261;853
411840;201308;8198;25362;6854;22738;2198;8054;2066;6660;4264;14714
411845;201308;475;1582;383;1378;116;453;79;270;195;723
411850;201308;5822;18599;5079;17142;1509;5570;1642;5495;3151;11065
411860;201308;827;2748;717;2496;226;845;191;622;417;1467
411870;201308;956;3510;802;3083;145;599;200;719;345;1318
411880;201308;2444;7146;2085;6557;491;1735;1066;3365;1557;5100
411885;201308;1389;3935;1156;3583;375;1300;332;918;707;2218
411890;201308;1227;3895;924;3194;281;1085;209;635;490;1720
411900;201308;863;2843;698;2435;218;791;139;480;357;1271
411910;201308;1155;4102;1050;3836;318;1265;359;1257;677;2522
411915;201308;11193;33586;7961;26567;2144;8010;1928;5767;4072;13777
411920;201308;954;3510;876;3301;303;1246;193;700;496;1946
411925;201308;571;1702;469;1522;151;514;179;579;330;1093
411930;201308;5936;20283;5301;18954;1805;6896;1976;7192;3781;14088
411940;201308;3480;12054;3166;11369;1077;4062;909;3275;1986;7337
411950;201308;10217;33915;9006;31771;2915;11187;3949;13747;6864;24934
411960;201308;5524;17359;5212;16781;1522;5470;2371;7404;3893;12874
411965;201308;419;1470;371;1359;111;442;104;382;215;824
411970;201308;720;2178;589;1957;200;700;175;571;375;1271
411980;201308;2046;5745;1470;4826;188;689;839;2753;1027;3442
411990;201308;26735;95307;23739;88865;9282;37005;6304;24005;15586;61010
411995;201308;2923;9496;2714;9087;1144;4110;732;2441;1876;6551
412000;201308;1917;5560;1576;4947;360;1307;645;1784;1005;3091
412010;201308;709;2454;631;2273;206;782;204;714;410;1496
412015;201308;596;1944;514;1765;100;389;278;927;378;1316
412020;201308;407;1253;324;1084;120;437;123;389;243;826
412030;201308;550;1765;387;1376;82;352;119;394;201;746
412033;201308;681;2176;537;1830;147;559;94;289;241;848
412035;201308;916;2757;769;2481;200;747;321;964;521;1711
412040;201308;694;2354;637;2207;263;974;194;653;457;1627
412050;201308;1568;4811;1260;4144;326;1199;292;908;618;2107
412060;201308;7152;25771;6621;24517;2186;8593;2630;9784;4816;18377
412065;201308;926;2950;832;2751;263;985;231;702;494;1687
412070;201308;1053;3079;948;2856;205;668;395;1178;600;1846
412080;201308;1893;6147;1414;5060;434;1725;165;514;599;2239
412085;201308;266;749;161;551;48;178;40;132;88;310
412090;201308;4711;16002;4523;15654;1013;3783;2865;10024;3878;13807
412100;201308;2162;7043;1924;6616;659;2403;668;2279;1327;4682
412110;201308;796;2631;737;2507;278;981;259;853;537;1834
412120;201308;2321;8078;2142;7660;551;2155;1074;3711;1625;5866
412125;201308;952;3027;858;2877;268;976;335;1139;603;2115
412130;201308;748;2175;554;1806;131;488;158;504;289;992
412135;201308;533;1571;411;1310;81;294;193;560;274;854
412140;201308;1779;5557;1522;5047;466;1650;443;1468;909;3118
412150;201308;2680;8290;2396;7722;418;1496;1378;4331;1796;5827
412160;201308;1119;3612;911;3128;277;1068;328;1081;605;2149
412170;201308;4164;14504;3696;13562;1439;5600;1234;4462;2673;10062
412175;201308;1442;5192;1323;4913;384;1553;536;2010;920;3563
412180;201308;1666;5486;1318;4841;533;2135;337;1181;870;3316
412190;201308;2839;8963;2451;8325;975;3490;706;2534;1681;6024
412200;201308;2117;7442;1624;6005;410;1623;499;1782;909;3405
412210;201308;651;1973;467;1557;146;556;87;258;233;814
412215;201308;3039;10369;2788;9883;523;1921;1761;6433;2284;8354
412217;201308;1152;3518;1104;3433;243;886;673;1946;916;2832
412220;201308;6199;20753;5926;20222;2196;7848;2746;9407;4942;17255
412230;201308;2775;9878;2501;9263;879;3558;672;2386;1551;5944
412240;201308;7840;22490;4763;15930;1118;4161;673;2008;1791;6169
412250;201308;2092;6602;1914;6237;735;2587;507;1551;1242;4138
412260;201308;1242;3819;853;2946;213;836;237;719;450;1555
412265;201308;1103;3628;1034;3503;290;1168;479;1554;769;2722
412270;201308;731;2527;584;2136;147;618;101;338;248;956
412280;201308;873;2786;751;2550;198;715;341;1145;539;1860
412290;201308;1187;3431;1018;3112;218;758;426;1255;644;2013
412300;201308;1698;5180;1420;4617;442;1647;429;1295;871;2942
412310;201308;1190;3455;1046;3264;224;595;674;2350;898;2945
412320;201308;717;2019;531;1695;115;432;236;742;351;1174
412330;201308;1936;5448;1499;4698;396;1344;671;2075;1067;3419
412340;201308;845;2775;637;2255;144;568;118;386;262;954
412350;201308;2338;7706;1991;6895;648;2424;368;1159;1016;3583
412360;201308;332;1108;298;1013;76;275;76;221;152;496
412370;201308;1088;3463;868;3023;317;1157;248;857;565;2014
412380;201308;1930;6019;1728;5609;396;1337;791;2694;1187;4031
412382;201308;717;2078;541;1697;146;530;161;452;307;982
412385;201308;2418;7925;2256;7590;676;2374;868;3043;1544;5417
412390;201308;2358;7254;2185;6961;819;2847;778;2442;1597;5289
412395;201308;952;2706;779;2431;105;333;518;1660;623;1993
412400;201308;1182;3723;1061;3500;338;1202;440;1479;778;2681
412402;201308;1969;6309;1687;5703;548;1967;406;1268;954;3235
412405;201308;3889;11641;2550;8633;667;2582;262;781;929;3363
412410;201308;6047;20334;5552;19317;2500;9449;1065;3650;3565;13099
412420;201308;514;1572;434;1442;144;535;127;372;271;907
412430;201308;454;1396;382;1240;124;449;149;434;273;883
412440;201308;3951;12052;3513;11296;694;2475;1558;5244;2252;7719
412450;201308;406;1304;343;1144;89;330;81;220;170;550
412460;201308;968;2754;671;2198;159;616;180;550;339;1166
412470;201308;1992;6950;1835;6580;588;2275;728;2565;1316;4840
412480;201308;1301;3902;962;3171;231;835;191;527;422;1362
412490;201308;1265;3820;1135;3520;317;1034;327;1001;644;2035
412500;201308;1954;5983;1664;5410;534;1913;406;1201;940;3114
412510;201308;2661;9275;2383;8527;838;3230;751;2586;1589;5816
412520;201308;1785;5128;1396;4488;394;1353;517;1655;911;3008
412530;201308;779;2358;667;2122;223;769;178;544;401;1313
412535;201308;381;1177;278;916;76;271;101;290;177;561
412540;201308;1187;3617;960;3112;192;726;386;1227;578;1953
412545;201308;883;2595;747;2309;138;480;293;817;431;1297
412550;201308;23180;72235;16654;57445;4981;18556;3339;10698;8320;29254
412555;201308;309;986;228;776;59;212;41;114;100;326
412560;201308;4378;15346;3884;14285;1287;5138;899;3050;2186;8188
412570;201308;3996;12640;3202;10863;1085;3988;748;2515;1833;6503
412575;201308;1012;3283;856;2900;226;868;272;850;498;1718
412580;201308;1437;4037;1069;3400;269;919;356;1081;625;2000
412590;201308;461;1463;388;1329;161;586;86;291;247;877
412600;201308;1439;4706;1273;4372;446;1684;389;1276;835;2960
412610;201308;737;2427;609;2112;215;820;150;452;365;1272
412620;201308;1324;4459;1186;4170;467;1763;291;1000;758;2763
412625;201308;13376;38693;11310;34838;4306;14322;2526;7715;6832;22037
412627;201308;927;2947;678;2403;227;864;83;281;310;1145
412630;201308;3402;11174;3031;10340;870;3195;919;3039;1789;6234
412635;201308;491;1543;379;1292;98;334;55;170;153;504
412640;201308;885;2776;692;2354;202;779;171;532;373;1311
412650;201308;2249;6500;1835;5749;504;1717;708;2026;1212;3743
412660;201308;2956;9131;2477;8118;670;2513;629;1921;1299;4434
412665;201308;710;1944;458;1506;140;514;130;397;270;911
412667;201308;1551;4833;1270;4258;346;1355;395;1196;741;2551
412670;201308;619;1994;418;1496;102;413;59;180;161;593
412680;201308;1353;4601;1178;4164;351;1325;334;1066;685;2391
412690;201308;620;2014;497;1731;185;698;68;226;253;924
412700;201308;1800;6102;1591;5726;622;2481;547;1899;1169;4380
412710;201308;8705;27865;7258;24829;2156;8047;1842;6099;3998;14146
412720;201308;1552;4996;1133;3949;294;1099;120;332;414;1431
412730;201308;2747;8505;1963;6821;634;2366;250;778;884;3144
412740;201308;2070;6930;1875;6476;788;2899;242;868;1030;3767
412750;201308;3241;11391;3103;11138;652;2639;2087;7299;2739;9938
412760;201308;2179;7473;2090;7317;695;2696;803;2662;1498;5358
412770;201308;11125;33661;7702;26057;1915;7246;1588;4879;3503;12125
412780;201308;1454;4912;1300;4540;408;1508;400;1326;808;2834
412785;201308;2331;7036;1810;5983;585;2089;720;2332;1305;4421
412788;201308;1327;4534;1251;4387;339;1401;540;1753;879;3154
412790;201308;1086;3533;928;3176;217;826;306;950;523;1776
412795;201308;998;3041;868;2798;316;1112;278;847;594;1959
412796;201308;3107;9822;2927;9492;838;2991;1359;4313;2197;7304
412800;201308;3369;10352;2760;9191;820;3004;805;2511;1625;5515
412810;201308;8681;25292;6069;19674;1865;6622;1452;4318;3317;10940
412820;201308;5920;18685;4543;15917;1430;5410;1027;3658;2457;9068
412830;201308;384;1287;340;1194;105;427;81;240;186;667
412840;201308;2313;6808;1941;6086;602;2109;507;1557;1109;3666
412850;201308;2746;8542;2447;8118;516;1959;1276;4151;1792;6110
412853;201308;1653;5116;1483;4816;315;1259;798;2372;1113;3631
412855;201308;1642;4879;1346;4303;471;1722;365;1017;836;2739
412860;201308;1218;3819;1080;3575;296;1099;486;1541;782;2640
412862;201308;745;2128;634;1924;188;624;218;628;406;1252
412863;201308;1194;4217;1156;4145;180;689;803;2871;983;3560
412865;201308;627;2028;470;1627;109;410;171;594;280;1004
412870;201308;1014;3016;874;2799;330;1146;279;892;609;2038
412880;201308;1565;4332;1324;3949;394;1321;377;1073;771;2394
420005;201308;478;1545;366;1298;88;342;157;524;245;866
420010;201308;3152;10148;2722;9398;437;1634;1886;6567;2323;8201
420020;201308;731;2529;499;1868;101;429;75;244;176;673
420030;201308;447;1395;283;1042;82;344;56;181;138;525
420040;201308;975;3095;677;2525;239;971;166;557;405;1528
420050;201308;723;2406;631;2194;205;751;233;792;438;1543
420055;201308;275;954;213;787;57;222;45;150;102;372
420060;201308;377;1341;287;1106;72;304;43;152;115;456
420070;201308;1938;6359;1698;5760;291;1092;777;2751;1068;3843
420075;201308;163;520;114;392;31;121;34;103;65;224
420080;201308;549;1929;496;1805;191;759;99;351;290;1110
420090;201308;670;2425;515;2031;143;586;101;406;244;992
420100;201308;1456;4904;1362;4776;341;1206;860;3089;1201;4295
420110;201308;421;1477;385;1392;128;465;155;576;283;1041
420120;201308;304;1085;254;971;113;465;36;118;149;583
420125;201308;347;1472;333;1438;132;603;90;363;222;966
420127;201308;556;1765;279;1053;95;386;32;120;127;506
420130;201308;2661;9339;2398;8808;764;3166;892;2973;1656;6139
420140;201308;5767;17519;4360;14946;1463;5572;1077;3524;2540;9096
420150;201308;678;2177;515;1751;182;670;132;396;314;1066
420160;201308;277;859;188;642;54;227;45;113;99;340
420165;201308;188;635;137;498;26;100;32;122;58;222
420170;201308;228;767;164;630;64;284;18;50;82;334
420180;201308;407;1391;274;1018;81;310;68;239;149;549
420190;201308;507;1692;361;1390;137;580;62;224;199;804
420195;201308;1365;3972;1087;3585;290;1066;517;1725;807;2791
420200;201308;2785;9314;1849;7126;641;2761;316;1061;957;3822
420205;201308;1009;3473;912;3283;304;1189;389;1413;693;2602
420207;201308;1191;3632;907;3052;287;1087;245;754;532;1841
420208;201308;520;1686;410;1446;169;625;117;414;286;1039
420209;201308;331;1125;213;803;45;180;49;191;94;371
420210;201308;1699;5711;1145;4494;324;1458;161;557;485;2015
420213;201308;840;3217;803;3133;174;707;515;2023;689;2730
420215;201308;473;1644;366;1315;113;436;63;210;176;646
420220;201308;414;1662;391;1602;168;737;78;274;246;1011
420230;201308;4343;13862;3478;12247;890;3508;1787;6167;2677;9675
420240;201308;12049;38160;8391;30441;2016;8619;3256;10583;5272;19202
420243;201308;496;1694;434;1539;139;563;138;466;277;1029
420245;201308;1023;3331;775;2820;213;905;170;533;383;1438
420250;201308;841;2758;792;2678;303;1109;320;1101;623;2210
420253;201308;650;1735;542;1587;120;371;262;841;382;1212
420257;201308;411;1328;340;1192;100;352;155;549;255;901
420260;201308;1297;4536;1194;4332;384;1512;548;1989;932;3501
420270;201308;432;1477;251;942;34;131;26;89;60;220
420280;201308;2561;7738;1859;6483;587;2317;569;1752;1156;4069
420285;201308;143;437;59;221;11;48;2;5;13;53
420287;201308;636;1993;548;1820;147;528;214;701;361;1229
420290;201308;5758;17560;3920;13406;1040;3920;1357;4392;2397;8312
420300;201308;5566;18204;3884;14464;1176;4971;764;2790;1940;7761
420310;201308;790;2490;754;2425;185;645;441;1368;626;2013
420315;201308;900;3163;745;2815;202;874;320;1190;522;2064
420320;201308;4660;15478;4023;14303;1275;5131;1574;5338;2849;10469
420325;201308;473;1565;455;1516;159;593;140;449;299;1042
420330;201308;1237;4430;1015;3818;367;1517;181;555;548;2072
420340;201308;1459;4650;1218;4097;292;1085;446;1437;738;2522
420350;201308;1546;5160;1378;4812;398;1482;606;2117;1004;3599
420360;201308;3473;11552;2795;10040;1099;4306;494;1661;1593;5967
420370;201308;1917;5540;1746;5334;223;709;1412;4282;1635;4991
420380;201308;5256;18261;4506;16453;1513;6040;1173;4200;2686;10240
420390;201308;2012;6168;1254;4507;430;1689;275;878;705;2567
420395;201308;2175;6898;1708;5830;511;1974;390;1206;901;3180
420400;201308;1448;4468;1130;3846;352;1393;363;1150;715;2543
420410;201308;760;2216;575;1912;144;538;279;916;423;1454
420415;201308;480;1576;404;1377;116;420;148;504;264;924
420417;201308;789;2631;696;2428;157;559;344;1210;501;1769
420419;201308;398;1337;314;1186;157;632;81;307;238;939
420420;201308;14423;45895;11443;39413;3945;14700;3476;11800;7421;26500
420425;201308;1213;3518;792;2575;116;475;319;935;435;1410
420430;201308;4027;12949;2773;9926;866;3378;746;2604;1612;5982
420435;201308;191;674;144;545;70;296;21;73;91;369
420440;201308;1458;4378;905;3199;333;1268;155;495;488;1763
420445;201308;430;1285;334;1115;100;357;144;480;244;837
420450;201308;1240;3742;732;2668;179;747;144;418;323;1165
420455;201308;2223;7094;1997;6683;620;2366;841;2728;1461;5094
420460;201308;9422;30742;7914;27812;2397;9531;3029;10087;5426;19618
420470;201308;1102;3175;797;2626;247;881;238;775;485;1656
420475;201308;173;570;113;415;42;159;24;93;66;252
420480;201308;5938;18191;4953;16509;2101;7747;820;2662;2921;10409
420490;201308;683;2422;578;2170;180;710;143;508;323;1218
420500;201308;2068;6573;1777;6062;533;1935;933;3226;1466;5161
420510;201308;180;788;176;769;75;333;35;138;110;471
420515;201308;157;582;128;506;41;172;21;81;62;253
420517;201308;923;2940;845;2766;120;406;578;1927;698;2333
420519;201308;405;1173;303;958;63;200;121;398;184;598
420520;201308;682;2128;582;1953;167;605;231;754;398;1359
420530;201308;1348;4800;1122;4194;392;1611;264;872;656;2483
420535;201308;259;830;202;695;65;245;45;141;110;386
420540;201308;19112;60584;15035;51803;5450;20533;4529;15029;9979;35562
420543;201308;433;1286;319;1077;59;211;197;658;256;869
420545;201308;1459;4787;1217;4250;378;1490;366;1188;744;2678
420550;201308;4605;15679;3983;14196;1306;5232;1249;4343;2555;9575
420555;201308;443;1485;380;1339;152;577;108;374;260;951
420560;201308;565;1719;483;1557;74;264;255;837;329;1101
420570;201308;1865;6322;1537;5519;487;1949;453;1505;940;3454
420580;201308;948;3372;821;3127;251;1075;369;1406;620;2481
420590;201308;3120;10179;2341;8336;590;2293;506;1711;1096;4004
420600;201308;689;2546;643;2445;206;850;267;1004;473;1854
420610;201308;577;1945;433;1607;146;603;73;239;219;842
420620;201308;1182;3829;1059;3593;413;1521;240;786;653;2307
420630;201308;1024;3422;824;2900;266;1031;232;688;498;1719
420640;201308;605;2106;351;1398;90;404;41;166;131;570
420650;201308;2194;7148;1350;4993;324;1341;263;810;587;2151
420660;201308;670;2043;554;1822;110;406;299;966;409;1372
420665;201308;758;2279;502;1717;93;367;184;560;277;927
420670;201308;1669;5516;1290;4633;359;1442;215;705;574;2147
420675;201308;228;748;167;598;41;166;79;257;120;423
420680;201308;541;1469;381;1212;95;347;128;386;223;733
420690;201308;847;3066;658;2520;187;806;197;699;384;1505
420700;201308;6069;19020;5078;16933;1819;6735;1265;3981;3084;10716
420710;201308;724;2701;628;2486;242;1031;155;584;397;1615
420720;201308;1953;6162;1699;5810;483;1720;955;3275;1438;4995
420730;201308;4512;14426;3983;13480;1548;5568;1375;4596;2923;10164
420740;201308;663;2385;647;2357;180;686;392;1425;572;2111
420750;201308;2383;7957;1741;6352;430;1804;541;1725;971;3529
420757;201308;109;385;94;357;27;115;23;77;50;192
420760;201308;421;1409;327;1147;77;297;112;387;189;684
420765;201308;526;1910;399;1538;128;525;87;326;215;851
420768;201308;1226;4525;1090;4199;364;1452;403;1630;767;3082
420770;201308;842;2748;584;2130;187;746;167;572;354;1318
420775;201308;601;1993;516;1792;141;495;222;781;363;1276
420780;201308;1675;5258;1212;4123;367;1343;364;1165;731;2508
420785;201308;307;975;231;776;38;152;88;265;126;417
420790;201308;1327;4950;1117;4341;336;1393;432;1638;768;3031
420800;201308;876;2652;553;1910;153;579;128;409;281;988
420810;201308;2453;8869;2035;7834;730;3137;543;1997;1273;5134
420820;201308;7402;26537;6404;24667;2337;10032;2315;8791;4652;18823
420830;201308;2641;9098;2292;8414;909;3604;756;2664;1665;6268
420840;201308;751;2501;533;2022;173;744;163;563;336;1307
420845;201308;1080;3818;913;3471;335;1395;156;553;491;1948
420850;201308;1761;6048;1292;5056;457;1943;273;1080;730;3023
420860;201308;660;1988;452;1585;189;742;152;511;341;1253
420870;201308;1345;4076;1101;3723;437;1613;332;1104;769;2717
420880;201308;1445;4971;1215;4361;357;1331;260;911;617;2242
420890;201308;12328;29786;5874;18688;1226;4634;2307;6650;3533;11284
420895;201308;218;613;106;357;29;103;38;126;67;229
420900;201308;2245;6712;1535;5298;465;1752;384;1269;849;3021
420910;201308;21891;69709;15014;54536;4172;17199;3797;12933;7969;30132
420915;201308;658;2618;610;2489;169;698;279;1205;448;1903
420917;201308;401;1261;234;775;55;217;74;191;129;408
420920;201308;176;530;107;381;42;160;18;62;60;222
420930;201308;19465;61654;17065;57130;5853;21334;5775;19277;11628;40611
420940;201308;4434;14193;3918;13030;1242;4578;1277;3952;2519;8530
420945;201308;230;732;153;536;42;163;39;133;81;296
420950;201308;532;1664;299;1142;79;330;56;215;135;545
420960;201308;1412;4560;1211;4178;435;1652;367;1152;802;2804
420970;201308;2609;8562;2338;8135;674;2475;1204;4303;1878;6778
420980;201308;377;1362;346;1286;105;387;183;718;288;1105
420985;201308;479;1552;343;1250;111;439;84;290;195;729
420990;201308;858;2638;593;2156;151;594;176;577;327;1171
421000;201308;670;2444;487;1953;156;686;58;179;214;865
421003;201308;608;1823;271;981;64;256;42;137;106;393
421005;201308;234;809;217;776;67;263;105;372;172;635
421010;201308;6595;21261;5293;18515;1844;6889;1587;5352;3431;12241
421020;201308;505;1728;411;1528;84;306;224;899;308;1205
421030;201308;1044;3873;953;3628;346;1392;296;1142;642;2534
421040;201308;834;2698;753;2562;255;951;275;875;530;1826
421050;201308;1858;5242;1192;4112;316;1235;441;1427;757;2662
421055;201308;263;904;193;712;44;184;55;179;99;363
421060;201308;529;2019;439;1752;137;588;90;329;227;917
421070;201308;773;2523;547;1978;148;602;171;639;319;1241
421080;201308;641;2139;603;2055;207;752;247;822;454;1574
421085;201308;515;1464;294;1050;79;313;63;234;142;547
421090;201308;415;1256;318;1034;84;285;140;460;224;745
421100;201308;954;3094;740;2606;219;803;185;590;404;1393
421105;201308;1355;4573;1222;4324;330;1245;534;1967;864;3212
421110;201308;1618;5415;1409;5063;529;2075;447;1534;976;3609
421120;201308;1537;5221;1225;4435;314;1336;387;1277;701;2613
421125;201308;363;1236;323;1139;121;459;109;357;230;816
421130;201308;4526;15429;3896;14261;1595;6283;1175;4386;2770;10669
421140;201308;432;1411;348;1216;111;422;120;402;231;824
421145;201308;479;1639;412;1461;72;285;188;641;260;926
421150;201308;480;1685;383;1491;109;454;151;589;260;1043
421160;201308;814;2581;564;2047;136;551;174;590;310;1141
421165;201308;315;1164;258;970;63;253;104;405;167;658
421170;201308;1826;6062;1568;5355;500;1812;727;2412;1227;4224
421175;201308;1282;3999;1044;3609;362;1415;324;1037;686;2452
421180;201308;482;1473;316;1112;105;429;119;366;224;795
421185;201308;428;1304;353;1155;67;211;184;633;251;844
421187;201308;316;1022;261;910;77;283;95;313;172;596
421189;201308;525;1647;469;1533;139;489;170;547;309;1036
421190;201308;9372;31326;7512;27322;2509;9750;2299;8319;4808;18069
421200;201308;1048;3656;929;3381;296;1206;376;1312;672;2518
421205;201308;196;658;152;554;32;135;37;113;69;248
421210;201308;2001;6394;1776;5810;608;2116;575;1883;1183;3999
421220;201308;2436;8565;2194;8082;742;2925;723;2711;1465;5636
421223;201308;805;2409;551;1962;175;664;262;928;437;1592
421225;201308;1155;3665;988;3324;300;1092;380;1253;680;2345
421227;201308;933;3283;877;3191;257;932;507;1925;764;2857
421230;201308;748;2593;680;2417;198;759;250;843;448;1602
421240;201308;516;1787;371;1363;96;376;51;163;147;539
421250;201308;1841;5867;1335;4936;489;1968;371;1325;860;3293
421260;201308;233;772;158;617;39;156;34;127;73;283
421270;201308;622;1809;400;1416;144;544;85;317;229;861
421280;201308;1558;5051;1289;4626;472;1974;332;1152;804;3126
421290;201308;1918;5631;1306;4421;447;1615;289;892;736;2507
421300;201308;302;1008;270;942;118;455;93;297;211;752
421310;201308;513;1798;442;1600;153;558;111;398;264;956
421315;201308;356;1111;235;849;50;187;61;207;111;394
421320;201308;528;1833;361;1355;74;315;66;189;140;504
421330;201308;609;2209;541;2064;235;1010;67;243;302;1253
421335;201308;558;1895;449;1673;130;528;96;356;226;884
421340;201308;1623;5573;1499;5335;530;2027;576;2024;1106;4051
421350;201308;1028;3592;858;3224;320;1334;236;832;556;2166
421360;201308;3118;9746;2158;7772;520;2156;725;2485;1245;4641
421370;201308;1075;3916;937;3602;333;1405;253;951;586;2356
421380;201308;1007;3033;846;2717;180;622;413;1327;593;1949
421390;201308;186;621;149;529;23;87;43;157;66;244
421400;201308;373;1482;308;1315;134;587;77;308;211;895
421410;201308;365;1176;296;1031;73;262;136;496;209;758
421415;201308;319;1062;207;817;69;281;58;217;127;498
421420;201308;1389;4504;1100;3755;273;993;241;766;514;1759
421430;201308;268;919;214;808;79;341;41;148;120;489
421440;201308;789;2474;567;2050;187;718;218;776;405;1494
421450;201308;612;2198;513;1952;219;890;124;473;343;1363
421460;201308;620;2122;465;1779;131;557;101;353;232;910
421470;201308;475;1892;441;1798;142;606;180;713;322;1319
421480;201308;2559;8581;1878;7045;619;2612;557;1890;1176;4502
421490;201308;241;903;194;781;93;391;38;152;131;543
421500;201308;2621;9619;2354;9058;1024;4300;547;2042;1571;6342
421505;201308;397;1392;360;1292;133;485;122;442;255;927
421507;201308;587;2088;509;1889;125;473;202;749;327;1222
421510;201308;284;1104;261;1050;85;389;103;365;188;754
421520;201308;722;2059;527;1650;66;252;292;849;358;1101
421530;201308;449;1556;321;1273;98;437;111;422;209;859
421535;201308;652;2111;443;1652;100;400;212;786;312;1186
421540;201308;372;1199;328;1109;79;303;120;387;199;690
421545;201308;1184;4234;999;3846;333;1413;208;755;541;2168
421550;201308;2083;7390;1923;7053;757;3014;603;2145;1360;5159
421555;201308;226;758;131;484;33;136;34;116;67;252
421560;201308;177;603;102;406;28;115;14;57;42;172
421565;201308;1065;3436;972;3270;448;1615;292;940;740;2555
421567;201308;942;3620;818;3278;407;1670;154;619;561;2289
421568;201308;409;1494;372;1408;132;514;123;467;255;981
421569;201308;169;574;120;433;24;101;33;101;57;202
421570;201308;927;3282;748;2851;277;1156;193;692;470;1848
421575;201308;605;2091;542;1957;117;442;282;1034;399;1476
421580;201308;4172;14255;3398;12518;1381;5638;752;2516;2133;8154
421590;201308;260;835;211;728;47;170;94;309;141;479
421600;201308;751;2423;615;2137;202;744;169;569;371;1313
421605;201308;662;2134;468;1725;142;587;108;382;250;969
421610;201308;1811;4804;1425;4235;217;703;896;2667;1113;3370
421620;201308;4680;14862;3490;12349;1259;4782;1142;4071;2401;8853
421625;201308;350;1218;244;916;77;320;82;281;159;601
421630;201308;2412;7642;1650;5836;472;1820;411;1407;883;3227
421635;201308;280;1004;241;938;67;285;95;336;162;621
421640;201308;1093;3619;978;3421;222;789;592;2117;814;2906
421650;201308;2380;8294;2118;7698;879;3480;345;1201;1224;4681
421660;201308;8833;30842;7305;27738;2622;10922;2167;7827;4789;18749
421670;201308;1100;3824;886;3286;257;1045;266;974;523;2019
421680;201308;1403;4773;1275;4449;532;2000;227;706;759;2706
421690;201308;2011;6881;1596;5838;510;1998;301;1077;811;3075
421700;201308;729;2385;503;1904;177;721;123;403;300;1124
421710;201308;325;1191;278;1062;113;443;67;246;180;689
421715;201308;224;753;182;645;50;182;54;198;104;380
421720;201308;1512;5080;1300;4684;538;2127;386;1295;924;3422
421725;201308;124;456;119;442;37;145;51;184;88;329
421730;201308;550;1820;324;1241;94;404;81;254;175;658
421740;201308;675;2198;525;1842;158;646;128;359;286;1005
421750;201308;1321;4236;1102;3759;352;1295;355;1112;707;2407
421755;201308;418;1434;337;1200;99;377;98;326;197;703
421760;201308;349;1206;279;1059;87;374;125;438;212;812
421770;201308;3584;11275;3008;10146;1376;4835;737;2567;2113;7402
421775;201308;526;1692;393;1414;97;349;122;442;219;791
421780;201308;1712;6096;1395;5371;590;2447;365;1320;955;3767
421790;201308;937;2801;620;2237;205;845;146;469;351;1314
421795;201308;353;1138;283;940;50;177;87;285;137;462
421800;201308;2352;8081;1920;7180;573;2410;617;2074;1190;4484
421810;201308;696;2404;594;2137;198;769;122;410;320;1179
421820;201308;1033;3467;881;3133;214;900;313;1015;527;1915
421825;201308;1286;4499;1199;4280;213;862;658;2280;871;3142
421830;201308;3006;10685;2843;10363;701;2606;1565;6029;2266;8635
421835;201308;164;562;138;511;55;228;51;166;106;394
421840;201308;516;1863;464;1730;195;803;154;527;349;1330
421850;201308;564;1670;436;1456;146;505;136;482;282;987
421860;201308;435;1491;333;1261;75;314;95;347;170;661
421870;201308;5074;15469;3708;12587;1211;4427;686;2255;1897;6682
421875;201308;263;901;187;701;49;211;48;153;97;364
421880;201308;1002;3451;820;2997;265;1099;199;643;464;1742
421885;201308;356;1282;323;1185;91;346;144;522;235;868
421890;201308;1056;3728;914;3417;321;1287;285;1032;606;2319
421895;201308;418;1469;405;1446;118;434;215;787;333;1221
421900;201308;864;2874;716;2508;199;745;258;826;457;1571
421910;201308;499;1709;386;1433;113;487;99;308;212;795
421915;201308;603;1911;516;1731;110;413;242;783;352;1196
421917;201308;523;1741;435;1568;148;619;128;405;276;1024
421920;201308;730;2374;615;2207;301;1166;173;558;474;1724
421930;201308;3661;11149;2727;9288;860;3241;447;1489;1307;4730
421935;201308;856;3147;710;2775;208;881;254;971;462;1852
421940;201308;291;1170;249;1030;94;420;57;204;151;624
421950;201308;4208;12274;2542;8863;828;3082;523;1846;1351;4928
421960;201308;243;811;204;718;57;216;59;199;116;415
421970;201308;1940;6220;1559;5341;554;2053;356;1109;910;3162
421985;201308;406;1196;259;882;44;178;93;326;137;504
430003;201308;907;2698;730;2392;215;793;265;857;480;1650
430005;201308;278;964;243;887;59;239;127;430;186;669
430010;201308;1963;6066;1566;5216;516;1770;573;1953;1089;3723
430020;201308;1087;3016;958;2822;239;795;516;1438;755;2233
430030;201308;1466;4252;1316;3932;407;1276;501;1432;908;2708
430040;201308;12726;33232;11300;31303;3513;10024;5500;15737;9013;25761
430045;201308;703;1986;580;1767;105;362;349;1025;454;1387
430047;201308;196;582;167;524;42;138;86;273;128;411
430050;201308;945;2775;646;2166;124;497;296;926;420;1423
430055;201308;252;754;197;628;47;166;103;317;150;483
430057;201308;68;179;29;97;7;30;11;24;18;54
430060;201308;13707;46717;12618;44825;4380;16087;5766;20985;10146;37072
430063;201308;1031;3189;878;2830;262;888;382;1265;644;2153
430064;201308;1647;5036;1413;4625;364;1199;769;2631;1133;3830
430066;201308;149;403;120;360;35;117;57;163;92;280
430070;201308;493;1682;405;1460;113;436;125;424;238;860
430080;201308;573;1945;472;1702;126;518;126;414;252;932
430085;201308;554;1757;461;1576;147;558;204;658;351;1216
430087;201308;944;2907;923;2866;98;332;747;2298;845;2630
430090;201308;721;1973;272;916;42;154;89;306;131;460
430100;201308;945;3192;818;2907;313;1219;204;620;517;1839
430105;201308;645;2205;559;2036;219;842;132;469;351;1311
430107;201308;254;859;207;717;41;151;96;321;137;472
430110;201308;2136;6503;2004;6298;661;2251;955;2974;1616;5225
430120;201308;1674;5319;1415;4773;281;1002;866;2892;1147;3894
430130;201308;4451;11609;4136;11213;723;2080;2772;7654;3495;9734
430140;201308;1170;3870;922;3258;311;1102;315;1133;626;2235
430150;201308;847;2394;626;1968;161;538;203;624;364;1162
430155;201308;491;1581;373;1313;101;343;152;544;253;887
430160;201308;18094;54417;16978;52605;3884;13263;9555;30138;13439;43401
430163;201308;1807;5618;1571;5165;374;1387;731;2423;1105;3810
430165;201308;278;998;241;926;108;425;42;160;150;585
430170;201308;745;2240;402;1430;110;438;94;292;204;730
430175;201308;936;3086;778;2734;189;613;416;1567;605;2180
430180;201308;1135;3209;1005;3024;202;648;589;1819;791;2467
430185;201308;734;1858;406;1228;68;242;136;347;204;589
430187;201308;752;2369;686;2268;184;727;311;986;495;1713
430190;201308;2236;6801;1982;6350;524;1919;949;3053;1473;4972
430192;201308;184;585;103;338;20;70;35;108;55;178
430195;201308;195;630;84;325;15;60;12;39;27;99
430200;201308;1755;5863;1527;5416;564;2112;283;1016;847;3128
430205;201308;484;1500;401;1351;49;206;271;894;320;1100
430210;201308;5896;17555;3579;12415;1034;3805;677;2178;1711;5983
430215;201308;309;967;258;869;71;261;124;399;195;660
430220;201308;621;1664;314;1073;72;281;54;171;126;452
430222;201308;310;983;244;840;72;281;100;317;172;598
430223;201308;301;961;280;924;66;224;179;596;245;820
430225;201308;39;131;34;114;4;9;7;20;11;29
430230;201308;2161;6911;2038;6780;358;1113;1540;5307;1898;6420
430235;201308;231;801;197;720;69;279;43;129;112;408
430237;201308;381;1104;333;1019;45;178;235;680;280;858
430240;201308;995;3139;830;2795;313;1193;238;693;551;1886
430245;201308;805;2840;706;2597;199;751;300;1128;499;1879
430250;201308;1586;4515;1454;4272;502;1569;603;1823;1105;3392
430258;201308;177;555;140;471;26;90;67;215;93;305
430260;201308;807;2355;551;1813;78;303;314;1022;392;1325
430265;201308;320;1046;265;900;104;378;35;91;139;469
430270;201308;3391;9923;3103;9451;878;3042;1514;4514;2392;7556
430280;201308;5093;15088;4563;14094;1452;4820;1977;5990;3429;10810
430290;201308;2352;6751;2237;6626;328;996;1792;5396;2120;6392
430300;201308;9459;29991;8313;27822;3481;12203;3010;10427;6491;22630
430310;201308;8177;26563;7483;25230;2613;9490;3046;10036;5659;19526
430320;201308;783;2475;587;2067;95;325;300;1104;395;1429
430330;201308;948;2674;842;2472;225;722;365;991;590;1713
430340;201308;685;1877;455;1553;118;457;212;715;330;1172
430350;201308;6070;19880;5294;18137;2011;7306;1855;6228;3866;13534
430355;201308;224;638;144;487;29;123;34;106;63;229
430360;201308;1091;2935;973;2734;163;513;598;1663;761;2176
430367;201308;328;935;230;747;38;141;83;246;121;387
430370;201308;579;1751;489;1566;169;587;136;394;305;981
430380;201308;852;2242;470;1538;139;478;164;558;303;1036
430390;201308;3959;12276;3187;10569;829;3038;1039;3223;1868;6261
430400;201308;1245;3051;895;2552;195;668;492;1308;687;1976
430410;201308;675;1910;542;1689;111;385;284;883;395;1268
430420;201308;4384;13138;3689;11564;1162;3737;1481;4662;2643;8399
430430;201308;656;1961;505;1667;171;605;133;403;304;1008
430435;201308;1869;5264;1656;4874;355;1049;1022;3061;1377;4110
430440;201308;4257;13556;3678;12613;888;3386;1610;5643;2498;9029
430450;201308;8979;26707;7598;23774;2666;8712;2779;8686;5445;17398
430460;201308;23858;75013;20139;68305;7117;25867;7246;24696;14363;50563
430461;201308;471;1343;161;530;36;120;38;131;74;251
430462;201308;327;1002;281;923;114;396;91;296;205;692
430463;201308;3745;12641;3354;11820;924;3563;1606;5648;2530;9211
430465;201308;601;1731;504;1555;134;456;294;899;428;1355
430466;201308;4146;12677;3941;12308;1291;4348;1790;5585;3081;9933
430467;201308;555;1756;490;1636;138;505;224;740;362;1245
430468;201308;1392;4226;1251;3993;545;1897;244;747;789;2644
430469;201308;126;341;41;158;11;44;12;49;23;93
430470;201308;6822;18859;5401;16571;1916;6385;1890;5797;3806;12182
430471;201308;922;3165;830;2957;309;1158;187;663;496;1821
430480;201308;787;2277;470;1561;87;318;97;280;184;598
430485;201308;217;688;130;480;25;87;51;206;76;293
430490;201308;520;1572;369;1278;112;406;121;427;233;833
430495;201308;398;1239;288;994;75;288;78;259;153;547
430500;201308;1615;4664;1419;4322;407;1380;691;2056;1098;3436
430510;201308;25861;82925;20348;68998;7211;26705;5686;18401;12897;45106
430511;201308;464;1455;293;1016;83;279;58;199;141;478
430512;201308;1281;3454;1149;3235;338;976;484;1425;822;2401
430513;201308;633;1872;470;1528;87;289;217;703;304;992
430515;201308;589;1814;494;1601;100;348;217;714;317;1062
430517;201308;1293;4474;1228;4322;245;931;760;2631;1005;3562
430520;201308;1707;5202;1438;4633;479;1654;595;1883;1074;3537
430530;201308;935;2717;590;1936;149;550;176;520;325;1070
430535;201308;2272;7639;1993;6964;567;2177;676;2338;1243;4515
430537;201308;588;1726;426;1463;58;195;330;1163;388;1358
430540;201308;723;1826;570;1617;129;416;327;884;456;1300
430543;201308;580;1584;527;1530;133;408;329;974;462;1382
430544;201308;680;2387;601;2158;152;573;293;1025;445;1598
430545;201308;1314;4354;1175;4182;415;1340;624;2521;1039;3861
430550;201308;587;1907;474;1638;126;484;196;656;322;1140
430558;201308;117;350;88;291;32;115;13;33;45;148
430560;201308;331;920;255;771;52;202;114;323;166;525
430570;201308;1110;3049;853;2596;215;722;438;1260;653;1982
430580;201308;999;2961;724;2400;259;891;212;725;471;1616
430583;201308;116;330;56;186;6;24;13;43;19;67
430585;201308;327;947;251;775;83;298;114;319;197;617
430587;201308;301;970;266;895;121;426;80;262;201;688
430590;201308;1536;4407;1460;4284;318;1067;870;2463;1188;3530
430593;201308;38;149;36;142;15;64;10;35;25;99
430595;201308;161;504;104;381;38;146;16;50;54;196
430597;201308;362;1163;311;1046;55;204;144;465;199;669
430600;201308;1829;5384;1370;4332;334;1121;499;1541;833;2662
430605;201308;1285;4187;1078;3736;277;1052;443;1578;720;2630
430607;201308;666;1872;589;1729;137;457;343;954;480;1411
430610;201308;7934;22381;6561;20160;1524;5231;3293;10042;4817;15273
430613;201308;206;551;141;421;38;127;61;163;99;290
430620;201308;936;2984;800;2673;253;953;301;915;554;1868
430630;201308;432;1359;278;954;80;278;59;187;139;465
430632;201308;711;2034;484;1560;80;306;281;860;361;1166
430635;201308;632;1847;482;1552;104;349;254;819;358;1168
430637;201308;499;1446;463;1383;80;278;314;894;394;1172
430640;201308;1745;5187;1056;3552;255;912;216;613;471;1525
430642;201308;460;1276;348;1099;74;253;189;608;263;861
430645;201308;170;528;107;377;29;111;23;74;52;185
430650;201308;1997;6866;1764;6308;414;1535;961;3538;1375;5073
430655;201308;296;926;268;858;64;230;99;266;163;496
430660;201308;5720;17763;4725;15851;1610;5861;1824;6073;3434;11934
430670;201308;502;1489;455;1398;46;134;347;1103;393;1237
430673;201308;686;1773;453;1409;133;423;211;664;344;1087
430675;201308;180;546;133;440;23;89;64;206;87;295
430676;201308;4431;13855;4138;13381;1278;4455;1962;6508;3240;10963
430680;201308;1211;3658;928;3033;218;821;378;1131;596;1952
430690;201308;4302;12872;3695;11719;1214;3969;1551;5126;2765;9095
430692;201308;282;984;215;833;38;157;133;518;171;675
430693;201308;1743;5074;1393;4276;318;1055;465;1388;783;2443
430695;201308;510;1496;420;1312;96;341;196;569;292;910
430697;201308;411;1202;332;1075;116;380;134;460;250;840
430700;201308;10292;28123;5752;18942;1273;4705;901;2741;2174;7446
430705;201308;408;1295;380;1245;131;468;154;500;285;968
430710;201308;1801;4852;1484;4340;314;989;839;2571;1153;3560
430720;201308;773;2098;549;1763;164;552;238;789;402;1341
430730;201308;1692;4884;1480;4553;350;1071;843;2716;1193;3787
430740;201308;563;1709;396;1332;133;467;63;188;196;655
430745;201308;520;1527;401;1285;64;211;223;696;287;907
430750;201308;1720;5115;1533;4767;450;1564;767;2259;1217;3823
430755;201308;633;1847;470;1484;121;443;197;552;318;995
430760;201308;3418;9137;2818;8400;610;1986;1619;4927;2229;6913
430770;201308;6557;20320;5554;18519;1436;5241;2562;8404;3998;13645
430780;201308;1964;5940;1619;5297;526;1875;632;1915;1158;3790
430781;201308;623;1965;479;1668;150;552;167;568;317;1120
430783;201308;558;1509;448;1320;92;304;207;556;299;860
430786;201308;116;409;103;370;40;157;14;48;54;205
430790;201308;3217;9271;2306;7455;543;2029;1016;3113;1559;5142
430800;201308;716;2320;623;2094;175;631;234;772;409;1403
430805;201308;435;1316;351;1155;28;107;244;812;272;919
430807;201308;275;877;242;806;64;264;92;259;156;523
430810;201308;515;1576;312;1105;61;253;59;186;120;439
430820;201308;1160;3968;987;3524;327;1252;316;1088;643;2340
430825;201308;444;1303;254;834;50;174;76;233;126;407
430830;201308;2718;8147;2520;7809;410;1314;1621;5308;2031;6622
430840;201308;936;2978;875;2844;240;756;395;1359;635;2115
430843;201308;98;326;77;255;15;48;31;99;46;147
430845;201308;463;1399;392;1265;138;472;81;247;219;719
430850;201308;3217;10157;2926;9604;935;3243;1163;3824;2098;7067
430860;201308;618;2127;537;1930;187;783;129;407;316;1190
430865;201308;709;2008;661;1917;203;599;332;981;535;1580
430870;201308;480;1484;366;1264;134;467;119;400;253;867
430880;201308;1335;4019;1123;3587;470;1615;281;921;751;2536
430885;201308;174;575;148;525;51;190;41;142;92;332
430890;201308;1845;5183;1589;4751;196;669;1063;3201;1259;3870
430900;201308;3196;8879;3038;8673;585;1731;2061;6032;2646;7763
430905;201308;1021;3145;767;2577;272;976;202;654;474;1630
430910;201308;1705;5666;1504;5297;601;2296;534;1817;1135;4113
430912;201308;571;1692;459;1499;87;340;239;745;326;1085
430915;201308;398;1448;315;1254;90;395;91;353;181;748
430920;201308;16448;54102;15668;52809;5690;19828;8389;28307;14079;48135
430925;201308;93;270;75;234;22;77;38;115;60;192
430930;201308;8770;28572;7584;26128;2323;8492;3135;11102;5458;19594
430940;201308;1068;3428;891;3076;221;874;299;985;520;1859
430950;201308;1589;4605;1230;3808;376;1227;393;1193;769;2420
430955;201308;90;304;72;256;28;110;16;50;44;160
430957;201308;312;1095;266;991;68;260;131;489;199;749
430960;201308;1670;4986;1431;4563;568;1884;482;1555;1050;3439
430965;201308;1212;3946;1059;3621;228;911;640;2102;868;3013
430970;201308;502;1487;341;1138;94;345;96;311;190;656
430975;201308;609;2039;515;1820;102;376;320;1132;422;1508
430980;201308;549;1395;350;1102;98;353;127;350;225;703
430990;201308;632;2109;490;1728;168;618;106;374;274;992
430995;201308;691;2127;643;2037;213;684;284;928;497;1612
431000;201308;1584;4462;1016;3287;272;1003;152;429;424;1432
431010;201308;2634;8094;1910;6570;565;2159;606;1941;1171;4100
431020;201308;13884;35679;9924;28458;2966;8921;3155;9336;6121;18257
431030;201308;403;1260;262;914;54;190;69;258;123;448
431033;201308;2829;8400;2607;8075;620;1994;1517;4951;2137;6945
431036;201308;181;539;96;329;24;89;25;70;49;159
431040;201308;991;2992;858;2756;248;876;427;1342;675;2218
431041;201308;575;1619;517;1534;199;627;170;526;369;1153
431043;201308;371;1275;305;1116;137;547;107;353;244;900
431046;201308;111;347;85;288;23;82;34;113;57;195
431050;201308;1780;4564;1573;4309;303;823;1070;3047;1373;3870
431053;201308;595;2018;519;1855;169;669;192;666;361;1335
431055;201308;633;1880;601;1816;86;268;439;1347;525;1615
431057;201308;323;945;196;687;59;222;78;268;137;490
431060;201308;6146;18395;5866;18062;1149;3150;4204;13667;5353;16817
431065;201308;431;1351;413;1317;50;171;285;908;335;1079
431070;201308;739;2230;519;1718;126;415;175;551;301;966
431075;201308;266;817;180;619;35;135;58;201;93;336
431080;201308;650;2160;546;1936;161;609;99;329;260;938
431085;201308;896;2478;734;2204;147;468;400;1201;547;1669
431087;201308;599;1777;555;1697;36;92;459;1433;495;1525
431090;201308;478;1302;296;949;95;326;78;234;173;560
431100;201308;4625;13183;3986;12067;1139;3698;1761;5426;2900;9124
431110;201308;1504;4305;1298;3898;350;1113;704;2062;1054;3175
431112;201308;693;2215;661;2162;231;767;318;1070;549;1837
431113;201308;629;1951;475;1585;163;535;131;459;294;994
431115;201308;1454;4488;1346;4290;329;1118;778;2446;1107;3564
431120;201308;2610;8680;2385;8237;749;2882;1020;3379;1769;6261
431123;201308;509;1664;440;1523;123;439;212;757;335;1196
431125;201308;1309;4239;1101;3798;334;1179;477;1742;811;2921
431127;201308;113;327;68;215;13;43;14;42;27;85
431130;201308;3838;11329;3278;10387;990;3439;1445;4633;2435;8072
431140;201308;3463;9668;2233;7438;497;1922;746;2264;1243;4186
431142;201308;549;1678;508;1612;62;215;352;1136;414;1351
431150;201308;1296;4027;1076;3612;313;1075;390;1345;703;2420
431160;201308;876;2719;745;2426;156;515;421;1400;577;1915
431162;201308;447;1286;271;922;54;206;59;185;113;391
431164;201308;90;251;34;126;12;41;1;4;13;45
431170;201308;883;2715;747;2437;240;833;227;734;467;1567
431171;201308;852;2663;776;2509;257;899;194;582;451;1481
431173;201308;469;1461;443;1412;100;332;273;873;373;1205
431175;201308;1308;3730;1148;3483;386;1239;490;1483;876;2722
431177;201308;964;3273;880;3095;293;1097;392;1398;685;2495
431179;201308;115;319;87;264;19;65;34;87;53;152
431180;201308;2695;8341;2200;7161;602;2179;659;1984;1261;4163
431190;201308;757;2142;494;1633;143;526;181;587;324;1113
431198;201308;349;1170;313;1095;147;577;58;183;205;760
431200;201308;239;729;118;406;25;94;17;58;42;152
431205;201308;284;959;229;800;65;233;75;251;140;484
431210;201308;739;2188;648;1996;163;521;348;1060;511;1581
431213;201308;317;1006;267;913;79;301;105;341;184;642
431215;201308;324;977;171;588;45;165;29;88;74;253
431217;201308;216;703;189;639;68;249;48;166;116;415
431220;201308;1194;3130;924;2654;134;442;537;1494;671;1936
431225;201308;1318;4074;1182;3839;280;970;672;2221;952;3191
431230;201308;926;2867;747;2487;127;472;414;1381;541;1853
431235;201308;44;130;37;115;12;42;13;37;25;79
431237;201308;406;1396;366;1331;151;628;130;439;281;1067
431238;201308;51;171;43;154;10;41;15;50;25;91
431240;201308;2778;9026;2444;8390;900;3304;788;2691;1688;5995
431242;201308;424;1406;403;1365;172;652;28;82;200;734
431244;201308;431;1092;337;945;71;239;159;415;230;654
431245;201308;955;2745;822;2521;172;552;513;1595;685;2147
431247;201308;195;634;172;590;65;237;64;211;129;448
431250;201308;1885;6118;1695;5832;583;2151;678;2415;1261;4566
431260;201308;315;995;272;909;66;252;63;196;129;448
431261;201308;231;837;200;767;50;219;67;249;117;468
431262;201308;337;980;164;586;26;123;66;228;92;351
431265;201308;1197;3381;819;2543;218;769;270;710;488;1479
431267;201308;191;600;161;545;47;169;67;209;114;378
431270;201308;2273;6699;2057;6372;690;2283;979;3055;1669;5338
431275;201308;213;711;156;557;51;176;36;118;87;294
431280;201308;147;482;105;377;30;126;25;69;55;195
431290;201308;314;1037;246;860;70;274;56;187;126;461
431295;201308;204;672;124;425;25;100;26;72;51;172
431300;201308;128;473;99;382;37;146;9;37;46;183
431301;201308;231;815;181;667;57;212;33;113;90;325
431303;201308;630;1779;533;1618;148;513;232;674;380;1187
431306;201308;2065;5911;1593;5036;341;1283;585;1646;926;2929
431308;201308;54;191;52;186;39;141;10;34;49;175
431310;201308;738;2453;572;2053;106;413;238;870;344;1283
431320;201308;807;2424;526;1849;164;650;122;376;286;1026
431330;201308;1857;4993;1038;3414;304;1106;239;766;543;1872
431333;201308;306;872;226;711;65;212;69;205;134;417
431335;201308;101;307;87;278;19;59;31;95;50;154
431337;201308;2464;7863;2133;7147;673;2394;674;2251;1347;4645
431339;201308;618;1844;491;1547;116;381;239;765;355;1146
431340;201308;26604;73570;20338;62833;5287;18171;8532;25760;13819;43931
431342;201308;581;1617;535;1532;118;354;340;957;458;1311
431344;201308;366;1058;291;924;26;87;179;572;205;659
431346;201308;280;785;182;551;57;179;49;144;106;323
431349;201308;520;1587;437;1397;88;278;218;704;306;982
431350;201308;3692;11448;3405;10967;548;2021;2273;7131;2821;9152
431360;201308;709;2051;583;1834;186;619;210;648;396;1267
431365;201308;1269;4063;1118;3802;449;1671;402;1339;851;3010
431370;201308;5416;16252;4738;15152;1256;4290;2416;7935;3672;12225
431380;201308;1122;3431;1069;3304;166;568;769;2341;935;2909
431390;201308;3325;10062;2541;8474;865;3145;731;2322;1596;5467
431395;201308;1570;4845;1427;4618;366;1261;621;2067;987;3328
431400;201308;152;549;112;442;38;165;13;42;51;207
431402;201308;1157;3006;775;2312;148;493;382;1094;530;1587
431403;201308;315;945;241;810;84;314;49;153;133;467
431405;201308;4422;12897;3578;11603;859;3264;1730;5387;2589;8651
431406;201308;775;2538;604;2096;215;780;216;733;431;1513
431407;201308;636;2021;491;1666;164;568;129;422;293;990
431410;201308;16294;52066;13597;46711;5640;20633;3324;11941;8964;32574
431413;201308;189;496;100;325;11;42;46;148;57;190
431415;201308;857;2553;765;2381;197;663;398;1212;595;1875
431417;201308;661;1752;534;1549;98;307;292;877;390;1184
431420;201308;1582;4485;1425;4231;354;1123;784;2365;1138;3488
431430;201308;572;1616;448;1420;124;443;180;540;304;983
431440;201308;31607;95468;29040;91136;9870;32376;13193;42896;23063;75272
431442;201308;202;667;157;547;51;200;20;51;71;251
431445;201308;481;1366;366;1111;67;226;168;496;235;722
431446;201308;484;1450;370;1218;91;305;177;581;268;886
431447;201308;832;2453;629;1990;120;402;298;959;418;1361
431449;201308;855;2545;738;2342;130;448;403;1300;533;1748
431450;201308;2183;5945;2034;5722;543;1566;1210;3414;1753;4980
431455;201308;592;1585;444;1301;116;373;190;516;306;889
431460;201308;3647;10565;3223;9752;914;2901;1361;4199;2275;7100
431470;201308;2158;6461;1887;5855;560;1726;836;2742;1396;4468
431475;201308;91;312;58;233;13;53;4;18;17;71
431477;201308;593;1750;489;1535;132;431;235;720;367;1151
431478;201308;181;475;95;284;23;72;38;112;61;184
431480;201308;2479;7601;1995;6647;679;2431;508;1669;1187;4100
431490;201308;103094;302848;92080;286391;18041;63791;59234;180754;77275;244545
431500;201308;1189;3151;959;2725;293;854;334;947;627;1801
431505;201308;349;1035;336;1018;36;105;272;833;308;938
431507;201308;450;1126;373;985;87;232;222;592;309;824
431510;201308;2193;6175;1899;5698;332;1094;1171;3456;1503;4550
431513;201308;215;668;184;595;46;159;76;250;122;409
431514;201308;106;267;64;201;12;41;33;105;45;146
431515;201308;747;2320;599;1967;142;515;299;916;441;1431
431517;201308;86;293;82;282;35;123;18;49;53;172
431520;201308;459;1445;340;1151;101;351;82;286;183;637
431530;201308;4435;11298;3658;10434;886;2506;2252;6899;3138;9405
431531;201308;266;779;199;646;50;179;77;262;127;441
431532;201308;512;1529;485;1473;98;325;283;848;381;1173
431535;201308;377;1125;260;817;61;223;66;183;127;406
431540;201308;2111;7059;1929;6805;228;710;1396;5281;1624;5991
431545;201308;131;402;58;219;5;21;12;48;17;69
431550;201308;2417;7476;2269;7190;563;2017;1093;3411;1656;5428
431555;201308;766;2091;679;1956;147;421;361;1044;508;1465
431560;201308;23103;74288;20866;69818;9040;30762;6640;23460;15680;54222
431570;201308;5453;16154;5168;15698;1079;3250;3501;10845;4580;14095
431575;201308;362;1084;316;1012;53;192;180;556;233;748
431580;201308;693;2262;600;2049;161;619;225;710;386;1329
431590;201308;904;2728;718;2307;84;290;390;1260;474;1550
431595;201308;606;1790;539;1638;134;432;208;649;342;1081
431600;201308;2172;6756;1744;5808;491;1858;383;1077;874;2935
431610;201308;1577;4624;1223;3986;319;1129;609;1972;928;3101
431620;201308;296;947;238;772;88;297;92;285;180;582
431630;201308;1344;3796;1103;3269;263;812;581;1729;844;2541
431640;201308;5679;17842;5293;17182;1595;5678;2691;8543;4286;14221
431642;201308;494;1537;450;1432;66;248;259;795;325;1043
431643;201308;182;542;169;518;46;158;90;248;136;406
431645;201308;1784;5572;1651;5342;407;1345;960;3201;1367;4546
431647;201308;170;486;138;421;45;141;37;94;82;235
431650;201308;203;669;146;545;38;160;32;107;70;267
431660;201308;1443;4439;1164;3841;410;1421;423;1325;833;2746
431670;201308;1332;3828;1110;3432;333;1167;453;1322;786;2489
431673;201308;197;636;146;513;41;160;37;129;78;289
431675;201308;287;969;224;772;55;197;61;182;116;379
431680;201308;9673;28668;7832;25313;2569;8919;2855;9294;5424;18213
431690;201308;24819;73480;20787;67285;6831;23644;8275;27166;15106;50810
431695;201308;138;496;113;417;29;108;27;75;56;183
431697;201308;504;1461;466;1390;139;435;210;633;349;1068
431700;201308;1632;4708;1432;4326;303;1001;765;2242;1068;3243
431710;201308;12737;38375;10878;35126;3189;10814;4903;16474;8092;27288
431720;201308;6930;20280;5963;18533;1434;5068;3175;9602;4609;14670
431725;201308;40;148;39;145;21;80;6;22;27;102
431730;201308;3629;11574;3071;10504;917;3484;1209;4142;2126;7626
431740;201308;5970;18049;5389;16911;1860;6300;1884;5773;3744;12073
431750;201308;10238;30040;8870;27758;1827;6174;4848;15448;6675;21622
431755;201308;249;667;83;288;22;90;21;58;43;148
431760;201308;3830;12053;3252;10894;989;3576;939;3074;1928;6650
431770;201308;2282;6478;1994;6008;519;1699;1044;3078;1563;4777
431775;201308;243;712;194;614;76;256;57;163;133;419
431780;201308;2500;6967;2036;6082;623;2006;587;1677;1210;3683
431790;201308;1121;3658;1028;3492;288;1061;533;1789;821;2850
431795;201308;463;1432;380;1220;63;211;210;674;273;885
431800;201308;9368;28532;8093;26186;2705;9572;2752;8724;5457;18296
431805;201308;267;659;73;263;20;78;15;55;35;133
431810;201308;3720;10749;3234;9729;857;2785;1527;4545;2384;7330
431820;201308;2694;8751;2452;8268;767;2812;860;2821;1627;5633
431830;201308;10306;28584;8954;26380;3357;10735;3183;9380;6540;20115
431840;201308;3529;10890;3119;10059;1013;3367;1323;4358;2336;7725
431842;201308;717;1920;440;1369;97;323;154;467;251;790
431843;201308;322;993;298;951;76;265;160;495;236;760
431844;201308;170;516;131;439;38;145;40;131;78;276
431845;201308;536;1690;508;1635;51;168;371;1220;422;1388
431846;201308;500;1574;448;1464;82;305;259;845;341;1150
431848;201308;193;527;95;326;19;79;22;67;41;146
431849;201308;305;805;131;413;22;78;37;104;59;182
431850;201308;4938;14752;4436;13800;1111;3842;2277;6879;3388;10721
431860;201308;971;2830;826;2591;227;782;393;1176;620;1958
431861;201308;81;267;57;195;15;55;9;31;24;86
431862;201308;481;1699;421;1564;159;644;122;434;281;1078
431870;201308;26282;75670;22299;68501;6351;21443;9676;28957;16027;50400
431880;201308;4640;15167;3958;13542;1252;4719;1550;5130;2802;9849
431890;201308;5779;17193;5193;16081;2091;6811;1597;5055;3688;11866
431900;201308;930;3037;806;2799;253;987;316;995;569;1982
431910;201308;866;2159;468;1388;107;357;188;512;295;869
431912;201308;595;1760;478;1514;148;465;167;543;315;1008
431915;201308;1310;3719;1033;3199;311;998;351;1101;662;2099
431920;201308;1479;4379;1410;4280;199;580;1092;3396;1291;3976
431930;201308;1253;3594;1016;3192;145;444;618;2060;763;2504
431935;201308;96;377;90;360;43;179;17;54;60;233
431936;201308;487;1410;445;1334;74;215;292;950;366;1165
431937;201308;290;821;202;641;52;177;61;182;113;359
431940;201308;2676;7622;1944;6232;577;1965;546;1730;1123;3695
431950;201308;1877;6133;1681;5749;512;1910;644;2103;1156;4013
431960;201308;3707;11310;3416;10728;1101;3673;1228;3890;2329;7563
431970;201308;507;1428;288;964;52;190;88;275;140;465
431971;201308;130;404;114;380;18;65;63;203;81;268
431973;201308;469;1708;418;1600;69;270;239;993;308;1263
431975;201308;13;56;10;48;2;12;3;13;5;25
431980;201308;1526;4518;1406;4281;372;1322;642;1850;1014;3172
431990;201308;8700;25054;7346;22978;1499;5375;3704;11361;5203;16736
432000;201308;10494;31828;8847;28888;3008;10143;3732;12384;6740;22527
432010;201308;2478;7552;2187;6988;536;1970;1050;3207;1586;5177
432020;201308;2026;5698;1833;5436;352;1109;1135;3358;1487;4467
432023;201308;518;1539;407;1291;112;401;159;473;271;874
432026;201308;1210;3832;1073;3541;248;824;579;1966;827;2790
432030;201308;410;1266;351;1134;101;354;146;444;247;798
432032;201308;469;1287;352;1090;65;218;212;645;277;863
432035;201308;831;2760;766;2617;208;773;428;1423;636;2196
432040;201308;691;2127;515;1727;121;450;129;336;250;786
432045;201308;191;656;168;606;50;193;69;245;119;438
432050;201308;766;2274;689;2127;145;475;394;1241;539;1716
432055;201308;756;2454;690;2313;156;579;424;1394;580;1973
432057;201308;487;1327;408;1175;54;181;249;670;303;851
432060;201308;425;1249;201;725;67;257;49;166;116;423
432065;201308;209;649;177;586;46;175;77;222;123;397
432067;201308;960;3216;717;2631;222;841;290;1034;512;1875
432070;201308;2323;6705;1975;6011;671;2252;718;2164;1389;4416
432080;201308;4112;12319;3724;11636;1179;3896;1623;5039;2802;8935
432085;201308;251;835;220;777;78;316;65;213;143;529
432090;201308;1666;5355;1454;4881;587;2127;397;1140;984;3267
432100;201308;1103;3402;681;2403;199;730;129;397;328;1127
432110;201308;3062;9370;2509;8258;905;3238;509;1641;1414;4879
432120;201308;5090;15989;4409;14641;1535;5545;1323;4292;2858;9837
432130;201308;2019;6404;1895;6188;541;1923;1082;3536;1623;5459
432132;201308;406;1283;265;934;44;160;101;326;145;486
432135;201308;783;2391;743;2320;145;476;479;1500;624;1976
432140;201308;2897;8734;2420;7856;718;2417;942;3406;1660;5823
432143;201308;1341;4229;1184;3978;272;943;748;2585;1020;3528
432145;201308;929;3033;667;2417;237;932;129;422;366;1354
432146;201308;255;833;200;688;70;253;54;182;124;435
432147;201308;827;2660;675;2320;196;700;278;979;474;1679
432149;201308;387;1207;285;943;83;290;99;319;182;609
432150;201308;3128;9687;2614;8851;1034;3709;789;2749;1823;6458
432160;201308;4431;14873;4016;14150;1486;5532;1517;5611;3003;11143
432162;201308;321;810;97;325;24;90;24;67;48;157
432163;201308;324;850;107;342;22;71;22;69;44;140
432166;201308;784;2396;648;2115;146;541;297;895;443;1436
432170;201308;773;2633;570;2163;140;594;125;419;265;1013
432180;201308;2738;7432;2037;6302;639;2196;629;1854;1268;4050
432183;201308;395;1346;370;1293;156;561;101;361;257;922
432185;201308;815;2421;558;1855;132;483;205;660;337;1143
432190;201308;3434;9797;2635;8024;731;2389;823;2357;1554;4746
432195;201308;1264;3666;1147;3490;198;646;738;2241;936;2887
432200;201308;3076;9833;2550;8904;865;3199;1017;3663;1882;6862
432210;201308;426;1296;382;1237;109;413;184;552;293;965
432215;201308;872;2793;797;2675;160;512;503;1776;663;2288
432218;201308;307;883;238;740;48;158;102;298;150;456
432220;201308;3744;10415;3196;9514;549;1898;1956;5667;2505;7565
432225;201308;60;214;53;204;32;125;6;29;38;154
432230;201308;1012;2944;880;2724;290;999;401;1154;691;2153
432232;201308;555;1673;446;1461;103;378;239;775;342;1153
432234;201308;554;1569;422;1231;109;333;170;464;279;797
432235;201308;68;226;43;163;20;86;10;38;30;124
432237;201308;500;1419;460;1356;37;140;384;1113;421;1253
432240;201308;15009;51769;13348;49521;3420;13682;7863;29763;11283;43445
432250;201308;5414;19528;5153;18978;2461;9705;1242;4665;3703;14370
432252;201308;425;1327;389;1253;128;432;186;610;314;1042
432253;201308;1234;4256;1014;3668;340;1269;333;1207;673;2476
432254;201308;429;1147;180;601;49;171;22;74;71;245
432255;201308;174;456;102;344;26;98;40;138;66;236
432260;201308;6406;17488;5019;15208;1212;3914;2486;7564;3698;11478
432270;201308;2580;8381;2350;7969;677;2360;1233;4277;1910;6637
432280;201308;1050;3199;741;2538;194;760;204;583;398;1343
432285;201308;106;340;70;240;23;87;15;42;38;129
432290;201308;596;1847;424;1443;96;364;165;536;261;900
432300;201308;22471;70874;20923;68220;5923;20497;10882;35491;16805;55988
432310;201308;984;3171;866;2941;209;785;441;1433;650;2218
432320;201308;260;762;192;624;57;186;68;229;125;415
432330;201308;203;631;108;388;25;99;10;32;35;131
432335;201308;209;613;101;350;27;99;12;36;39;135
432340;201308;284;756;158;486;47;151;43;119;90;270
432345;201308;726;2139;679;2073;176;645;369;1043;545;1688
432350;201308;428;1270;321;1067;84;300;87;272;171;572
432360;201308;45;150;37;132;16;58;11;35;27;93
432370;201308;459;1333;401;1231;37;109;272;848;309;957
432375;201308;813;2167;702;1984;127;369;432;1246;559;1615
432377;201308;73;260;35;125;6;24;8;20;14;44
432380;201308;837;3030;766;2860;347;1426;244;842;591;2268
500020;201308;1878;6366;1550;5655;529;2116;401;1359;930;3475
500025;201308;887;2384;609;1883;130;428;255;752;385;1180
500060;201308;5702;17050;4915;16039;485;1562;3968;13363;4453;14925
500070;201308;3541;11156;3103;10428;804;3059;1459;4743;2263;7802
500080;201308;1646;5109;1319;4535;457;1707;392;1391;849;3098
500085;201308;2109;5795;1614;4996;231;785;972;2917;1203;3702
500090;201308;2189;6747;1790;6010;418;1461;925;3184;1343;4645
500100;201308;2335;7280;2199;7077;788;2869;925;2812;1713;5681
500110;201308;7693;23124;6448;21236;1083;4007;3842;13096;4925;17103
500124;201308;1654;5674;1472;5361;297;1054;837;3322;1134;4376
500150;201308;1259;3512;1067;3233;307;1016;507;1493;814;2509
500190;201308;4600;12682;3675;11535;854;2902;2060;6648;2914;9550
500200;201308;2481;6610;1854;5716;430;1501;979;2927;1409;4428
500210;201308;4701;14686;4153;13866;1025;3693;2115;7283;3140;10976
500215;201308;1701;5446;1446;4921;366;1423;614;1970;980;3393
500220;201308;2587;8449;2139;7573;548;2107;833;2998;1381;5105
500230;201308;1816;5474;1562;5112;710;2519;516;1667;1226;4186
500240;201308;4219;14006;3400;12259;792;3177;1485;5490;2277;8667
500260;201308;2402;6823;2039;6256;487;1656;980;2816;1467;4472
500270;201308;97501;265164;69162;216338;22053;75076;18010;57006;40063;132082
500280;201308;1260;3805;1107;3588;232;800;655;2175;887;2975
500290;201308;3357;9311;2486;7743;755;2728;868;2472;1623;5200
500295;201308;2193;7113;1728;5972;464;1826;493;1511;957;3337
500310;201308;789;2182;716;2083;170;541;405;1131;575;1672
500315;201308;2756;8889;2413;8421;567;1914;1394;5232;1961;7146
500320;201308;12557;43632;11288;41346;4021;15491;4126;16104;8147;31595
500325;201308;3850;10730;3029;9390;937;3230;1202;3528;2139;6758
500330;201308;5073;14688;4406;13556;1419;4753;1962;5901;3381;10654
500345;201308;2297;7258;2054;6803;540;1973;1016;3278;1556;5251
500348;201308;2328;7157;2193;6934;293;1017;1645;5205;1938;6222
500350;201308;1178;3692;771;2752;136;503;230;862;366;1365
500370;201308;21685;70213;17904;62800;4807;18728;7178;25118;11985;43846
500375;201308;2444;7090;1947;6184;481;1604;943;3099;1424;4703
500380;201308;2864;8578;2474;7766;739;2466;916;2876;1655;5342
500390;201308;525;1194;356;948;56;192;247;602;303;794
500400;201308;1205;3995;1047;3612;348;1323;300;945;648;2268
500410;201308;2036;5848;1719;5401;466;1585;767;2439;1233;4024
500430;201308;2377;7585;2043;7077;594;2158;924;3320;1518;5478
500440;201308;1287;3882;1115;3601;316;1160;585;1805;901;2965
500450;201308;2107;6704;1675;5779;462;1791;343;1066;805;2857
500460;201308;3522;11033;2912;10074;767;2884;1280;4442;2047;7326
500470;201308;3326;10597;2785;9316;940;3409;597;1828;1537;5237
500480;201308;1970;6469;1832;6249;199;713;1431;4977;1630;5690
500490;201308;1026;3072;888;2844;301;1065;312;1011;613;2076
500500;201308;2970;9621;2522;9017;987;3965;909;3137;1896;7102
500510;201308;779;2204;583;1894;159;616;245;712;404;1328
500515;201308;1710;4912;1424;4503;277;849;903;3032;1180;3881
500520;201308;2617;9510;2364;9174;605;2452;1399;5661;2004;8113
500525;201308;1085;3698;967;3475;239;929;480;1810;719;2739
500540;201308;4396;13626;3164;11195;983;3893;855;2920;1838;6813
500560;201308;4258;15114;3914;14618;896;3536;2454;9323;3350;12859
500568;201308;3585;9827;2770;8632;639;2143;1299;4135;1938;6278
500570;201308;7270;20660;5394;17381;1652;5716;2089;6754;3741;12470
500580;201308;3193;9810;2585;8676;551;1974;1433;4830;1984;6804
500600;201308;2485;7446;2048;6744;669;2380;772;2495;1441;4875
500620;201308;7541;21826;5670;18775;1465;5477;2740;8912;4205;14389
500625;201308;870;2643;607;2094;168;629;193;623;361;1252
500630;201308;5956;17153;4870;15612;1789;6369;1379;4379;3168;10748
500635;201308;2231;9080;2002;8735;323;1340;1287;6100;1610;7440
500640;201308;1247;3398;1039;3088;174;579;654;1895;828;2474
500660;201308;13882;44002;11985;40675;2726;10139;6364;21613;9090;31752
500690;201308;2909;8678;2439;8091;639;2213;1345;4683;1984;6896
500710;201308;3166;10336;2998;10064;864;3069;1536;5187;2400;8256
500720;201308;4248;13142;3406;11447;1118;4131;1127;3755;2245;7886
500730;201308;911;2698;749;2379;192;685;302;927;494;1612
500740;201308;3464;9990;2633;8551;632;2357;1172;3604;1804;5961
500750;201308;781;2439;726;2358;189;669;406;1329;595;1998
500755;201308;1212;3720;956;3233;240;870;379;1245;619;2115
500769;201308;4346;12107;3076;9610;750;2636;1019;2912;1769;5548
500770;201308;1556;4867;1305;4380;389;1408;454;1545;843;2953
500780;201308;977;3243;902;3084;310;1146;384;1266;694;2412
500790;201308;8089;23873;6864;21691;1502;5582;3640;10924;5142;16506
500793;201308;2379;7065;1926;6297;370;1372;850;2601;1220;3973
500795;201308;2197;6730;1987;6419;250;701;1486;5095;1736;5796
500797;201308;863;2487;698;2223;164;579;322;1032;486;1611
500800;201308;2150;6670;1862;6261;611;2280;822;2750;1433;5030
500830;201308;14261;44172;11056;37311;3531;12909;3048;10020;6579;22929
500840;201308;1226;3800;1017;3390;202;742;510;1686;712;2428
510010;201308;1232;3995;1156;3867;393;1397;506;1727;899;3124
510020;201308;2463;7447;1918;6506;592;2156;517;1679;1109;3835
510025;201308;8742;27227;7797;25638;2543;9237;3135;10027;5678;19264
510030;201308;2038;5651;1750;5233;539;1680;855;2609;1394;4289
510035;201308;894;2737;771;2550;177;596;429;1496;606;2092
510040;201308;1571;4468;1254;3997;294;1077;633;1968;927;3045
510050;201308;1632;5035;1299;4442;380;1433;511;1758;891;3191
510060;201308;1162;3536;928;3097;288;1080;290;912;578;1992
510080;201308;1271;4036;1078;3711;329;1325;387;1199;716;2524
510100;201308;581;1590;397;1235;101;347;146;444;247;791
510120;201308;281;592;199;501;14;24;174;450;188;474
510125;201308;2836;7751;2358;6977;487;1767;1160;3255;1647;5022
510130;201308;1971;5662;1742;5329;539;1729;745;2303;1284;4032
510140;201308;2911;9834;2459;9118;912;3526;937;3563;1849;7089
510160;201308;1262;4344;1209;4283;91;362;1063;3763;1154;4125
510170;201308;5534;17785;4859;16529;1288;4906;2214;7289;3502;12195
510180;201308;9939;28449;7676;24654;2497;8542;2778;9634;5275;18176
510185;201308;1071;3424;1003;3327;253;819;607;2140;860;2959
510190;201308;1517;5309;1281;4918;336;1451;568;2248;904;3699
510250;201308;13125;43022;11539;40856;3658;13688;5651;20460;9309;34148
510260;201308;2509;9474;2340;9131;717;2907;1121;4571;1838;7478
510263;201308;3971;11359;3144;10005;932;3225;1107;3435;2039;6660
510267;201308;4277;13219;3615;11856;919;3360;1533;4801;2452;8161
510268;201308;845;2512;735;2362;216;761;367;1174;583;1935
510269;201308;804;2684;727;2553;233;855;299;1089;532;1944
510270;201308;2400;7676;2161;7313;476;1644;1200;4306;1676;5950
510279;201308;2024;6691;1864;6420;709;2704;621;1971;1330;4675
510285;201308;1418;4536;1231;4175;376;1374;431;1401;807;2775
510300;201308;2946;9444;2706;9116;407;1544;1992;6652;2399;8196
510305;201308;1592;5212;1327;4701;389;1526;438;1583;827;3109
510310;201308;1071;3153;860;2817;312;1141;267;845;579;1986
510320;201308;3830;11719;3134;10326;992;3779;603;1697;1595;5476
510325;201308;5354;17526;4720;16597;627;2173;3580;13047;4207;15220
510330;201308;2590;8756;2281;8189;624;2488;904;3307;1528;5795
510335;201308;4295;14050;3865;13466;680;2349;2762;10004;3442;12353
510336;201308;487;1573;443;1487;101;363;225;755;326;1118
510337;201308;2203;7590;1999;7211;824;3024;723;2820;1547;5844
510340;201308;56811;174614;46964;159682;19203;70892;11059;39732;30262;110624
510343;201308;1065;3307;1000;3228;129;398;796;2653;925;3051
510345;201308;1619;4839;1419;4508;396;1352;584;1857;980;3209
510350;201308;3108;9509;2673;8925;798;2842;1347;4579;2145;7421
510360;201308;1694;4772;1353;4347;286;985;885;2830;1171;3815
510370;201308;813;2975;725;2825;230;947;328;1305;558;2252
510380;201308;470;1570;385;1390;142;574;70;233;212;807
510385;201308;856;3283;740;2984;132;578;357;1537;489;2115
510390;201308;1046;3386;958;3279;254;847;534;1969;788;2816
510395;201308;818;2206;643;1981;126;412;391;1257;517;1669
510410;201308;3724;12581;3552;12294;1107;4147;1799;6154;2906;10301
510420;201308;2197;5923;1699;5098;302;1072;912;2707;1214;3779
510450;201308;573;1631;446;1452;145;533;142;451;287;984
510452;201308;590;1884;444;1554;113;444;163;522;276;966
510454;201308;688;2276;615;2168;164;601;342;1255;506;1856
510455;201308;933;2967;758;2664;192;788;311;1069;503;1857
510460;201308;1687;5233;1577;5086;371;1376;984;3049;1355;4425
510480;201308;3870;10914;3075;9409;798;2668;1145;3397;1943;6065
510490;201308;1429;4853;1301;4665;390;1477;715;2556;1105;4033
510500;201308;1220;3968;1014;3629;294;1190;499;1728;793;2918
510510;201308;2893;10397;2602;9908;1022;4084;1016;3885;2038;7969
510515;201308;5194;16420;4358;14727;1233;4669;1337;4247;2570;8916
510517;201308;1610;5114;1461;4894;437;1434;875;3056;1312;4490
510520;201308;2085;5582;1681;5009;142;499;1282;3788;1424;4287
510523;201308;1001;3139;852;2887;278;1002;363;1209;641;2211
510525;201308;7574;19468;4821;15066;1236;4221;1724;5283;2960;9504
510530;201308;544;1611;484;1522;92;335;282;887;374;1222
510550;201308;2525;8634;2263;8206;650;2421;1102;4156;1752;6577
510558;201308;1969;5874;1569;5278;514;1883;563;1860;1077;3743
510560;201308;1457;5004;1148;4445;430;1740;263;1078;693;2818
510562;201308;4855;15170;4372;14213;1576;5596;1443;4739;3019;10335
510590;201308;2657;7827;2136;7158;625;2321;934;3158;1559;5479
510600;201308;1389;3652;1004;3071;184;627;542;1594;726;2221
510610;201308;2483;7803;2354;7655;297;1119;1912;6144;2209;7263
510615;201308;2068;7006;1858;6634;626;2417;807;2833;1433;5250
510617;201308;481;1590;448;1545;82;312;331;1132;413;1444
510618;201308;1246;3786;939;3175;249;932;404;1363;653;2295
510619;201308;761;2173;507;1703;109;403;159;543;268;946
510620;201308;1161;3218;811;2711;297;1113;170;530;467;1643
510621;201308;1081;3841;944;3521;297;1203;325;1166;622;2369
510622;201308;3334;10585;2320;8209;611;2413;419;1296;1030;3709
510623;201308;3373;10039;2999;9495;1149;3814;1034;3291;2183;7105
510624;201308;1008;3404;897;3172;215;843;405;1351;620;2194
510625;201308;2242;6735;1826;5955;551;2012;534;1651;1085;3663
510626;201308;1136;3790;971;3523;329;1294;449;1641;778;2935
510627;201308;625;2049;523;1846;202;771;172;600;374;1371
510628;201308;1405;3849;1179;3571;175;616;827;2460;1002;3076
510629;201308;1719;5823;1512;5382;585;2261;336;1141;921;3402
510630;201308;2562;8704;2178;8034;737;3012;647;2439;1384;5451
510631;201308;399;1198;359;1135;78;246;231;735;309;981
510637;201308;2426;7658;2250;7326;713;2573;1061;3334;1774;5907
510642;201308;4472;15003;3869;14198;1386;5273;1740;6706;3126;11979
510645;201308;655;1687;538;1543;206;623;168;529;374;1152
510650;201308;5636;19812;5336;19425;1343;5191;3229;12126;4572;17317
510665;201308;1184;3177;870;2739;208;746;454;1433;662;2179
510670;201308;344;863;207;661;52;193;87;253;139;446
510675;201308;5906;20014;5178;18628;1866;7341;1524;5385;3390;12726
510677;201308;2430;6353;1843;5607;273;862;1323;4122;1596;4984
510680;201308;757;2432;659;2283;169;650;273;870;442;1520
510682;201308;2236;7358;1897;6731;523;1952;861;3211;1384;5163
510685;201308;736;2338;705;2293;134;467;468;1551;602;2018
510700;201308;3056;9176;2547;8447;571;2101;1535;5037;2106;7138
510704;201308;7522;22210;6415;20230;1820;6455;3015;9176;4835;15631
510706;201308;1526;4961;1295;4578;408;1531;613;2135;1021;3666
510710;201308;3438;10084;2856;8933;855;3056;1006;2831;1861;5887
510715;201308;676;1810;461;1453;123;429;163;466;286;895
510718;201308;1627;5078;1477;4862;348;1213;925;3074;1273;4287
510719;201308;433;1015;265;786;36;147;125;335;161;482
510720;201308;1225;2970;919;2607;91;291;703;2007;794;2298
510724;201308;803;2538;695;2330;152;559;422;1393;574;1952
510726;201308;644;1790;565;1658;164;504;236;668;400;1172
510729;201308;593;1741;511;1605;158;535;215;669;373;1204
510730;201308;2093;6787;1939;6509;467;1820;1118;3571;1585;5391
510735;201308;1059;3754;910;3507;345;1410;358;1382;703;2792
510740;201308;957;2539;798;2317;179;522;479;1425;658;1947
510757;201308;644;2316;601;2217;165;644;302;1094;467;1738
510760;201308;24970;74635;21010;67651;7903;27156;6998;22501;14901;49657
510770;201308;3536;10937;3383;10734;593;1888;2314;7726;2907;9614
510774;201308;363;1054;301;959;61;223;166;517;227;740
510775;201308;842;2413;690;2186;271;954;265;856;536;1810
510776;201308;355;1117;309;1034;80;297;148;466;228;763
510777;201308;1365;4397;1110;4078;240;1049;688;2463;928;3512
510779;201308;601;1823;466;1575;91;336;180;628;271;964
510780;201308;3574;11001;3215;10495;761;2654;1894;6285;2655;8939
510785;201308;1791;5441;1499;4955;507;1763;562;1896;1069;3659
510787;201308;1882;6118;1689;5764;521;1951;627;2075;1148;4026
510788;201308;338;1085;311;1048;133;421;106;389;239;810
510790;201308;13855;42173;9890;34477;3044;12164;1502;5034;4546;17198
510792;201308;5328;18099;4118;15456;1161;4985;776;2712;1937;7697
510794;201308;1322;4198;1053;3767;513;1925;208;685;721;2610
510795;201308;7674;26621;6585;24315;2378;9348;1811;6815;4189;16163
510800;201308;1680;5016;1469;4737;416;1497;718;2217;1134;3714
510805;201308;1663;4885;1377;4461;301;1125;868;2719;1169;3844
510810;201308;639;1619;519;1454;161;483;260;715;421;1198
510820;201308;818;2093;637;1820;163;554;253;655;416;1209
510830;201308;529;1894;482;1817;171;696;216;854;387;1550
510835;201308;658;2128;536;1901;202;793;210;682;412;1475
510840;201308;46276;120963;38245;111025;10083;30928;20295;60870;30378;91798
510850;201308;1626;4893;1337;4449;596;2218;205;542;801;2760
510860;201308;2374;8152;2005;7354;745;2916;389;1424;1134;4340
510880;201308;791;2735;707;2578;269;1029;248;900;517;1929
510885;201308;516;1528;396;1343;93;351;177;593;270;944
510890;201308;882;3054;763;2819;262;1082;196;661;458;1743
510895;201308;1049;3474;962;3321;309;1190;405;1319;714;2509
520005;201308;1140;3799;1069;3685;364;1314;445;1553;809;2867
520010;201308;1766;6311;1579;5882;730;3019;232;718;962;3737
520013;201308;3928;11184;3073;9684;780;2629;1460;4646;2240;7275
520015;201308;573;1592;461;1429;127;404;209;675;336;1079
520017;201308;1154;3747;1015;3508;297;1119;427;1453;724;2572
520020;201308;388;1062;302;920;88;281;151;478;239;759
520025;201308;19883;67316;19475;66795;3357;12170;14800;50828;18157;62998
520030;201308;4323;14493;3895;13768;1408;5335;1368;4996;2776;10331
520050;201308;331;1011;312;971;64;224;207;623;271;847
520055;201308;660;1994;568;1839;153;496;284;957;437;1453
520060;201308;1592;5130;1414;4785;349;1318;566;1957;915;3275
520080;201308;1474;5061;1374;4843;356;1307;711;2551;1067;3858
520082;201308;595;2098;568;2039;161;577;332;1234;493;1811
520085;201308;984;3166;863;2875;213;780;358;1200;571;1980
520090;201308;765;2129;706;2029;120;327;466;1376;586;1703
520110;201308;36414;113495;29145;102423;12018;46054;7656;27219;19674;73273
520120;201308;258;677;150;485;37;141;38;129;75;270
520130;201308;3488;10687;3320;10419;787;2686;1940;6087;2727;8773
520140;201308;41600;142899;38032;135686;14305;54918;11757;41813;26062;96731
520145;201308;533;1401;396;1213;97;322;165;489;262;811
520150;201308;664;1764;550;1624;165;537;257;742;422;1279
520160;201308;788;2430;713;2324;257;890;288;958;545;1848
520170;201308;3623;9241;2957;8531;645;1976;1941;5735;2586;7711
520180;201308;1470;4854;1359;4653;435;1610;578;1948;1013;3558
520215;201308;1442;4016;1276;3770;272;902;767;2270;1039;3172
520235;201308;771;2179;627;1965;197;689;269;812;466;1501
520250;201308;1095;3738;1020;3606;358;1338;484;1751;842;3089
520260;201308;710;1925;558;1654;98;332;284;814;382;1146
520280;201308;542;1631;493;1553;237;780;133;460;370;1240
520310;201308;910;2425;747;2231;209;633;446;1394;655;2027
520320;201308;1366;4535;1184;4185;292;1080;581;2103;873;3183
520330;201308;2624;8453;2127;7593;703;2736;586;2031;1289;4767
520340;201308;1833;4785;1496;4390;230;654;1142;3447;1372;4101
520350;201308;2799;8829;2481;8185;943;3335;1022;3287;1965;6622
520355;201308;1092;3873;1066;3812;430;1606;442;1577;872;3183
520357;201308;884;2484;768;2320;78;272;537;1601;615;1873
520360;201308;555;1545;490;1439;136;402;224;659;360;1061
520380;201308;994;2763;785;2448;157;533;451;1425;608;1958
520390;201308;1162;3157;817;2685;279;1049;297;892;576;1941
520393;201308;561;1519;512;1437;99;291;339;956;438;1247
520396;201308;662;2205;637;2161;85;331;454;1549;539;1880
520400;201308;1717;5003;1465;4653;280;955;943;3026;1223;3981
520410;201308;1385;3926;1143;3567;356;1226;512;1555;868;2781
520420;201308;321;907;258;802;57;211;127;370;184;581
520425;201308;1401;3963;1325;3819;445;1381;636;1796;1081;3177
520430;201308;1825;5012;1418;4352;331;1172;650;1929;981;3101
520440;201308;2685;7771;2194;6993;839;2923;623;1948;1462;4871
520450;201308;8991;26865;7260;23648;2246;8162;1785;5431;4031;13593
520455;201308;655;2001;547;1825;227;814;148;495;375;1309
520460;201308;751;2293;641;2103;196;709;242;781;438;1490
520465;201308;803;2238;706;2108;182;656;317;870;499;1526
520470;201308;1615;5391;1488;5202;373;1322;909;3307;1282;4629
520480;201308;935;2800;822;2618;193;641;499;1618;692;2259
520485;201308;1106;3810;1037;3696;411;1559;449;1587;860;3146
520490;201308;4265;13469;3477;12238;1498;5691;1085;3807;2583;9498
520495;201308;1384;3805;1166;3545;55;132;1065;3327;1120;3459
520500;201308;2001;5405;1797;5121;626;1904;718;2223;1344;4127
520505;201308;888;2577;769;2394;126;377;535;1730;661;2107
520510;201308;10585;30563;7170;24624;2292;8631;1826;6234;4118;14865
520520;201308;984;2949;861;2775;342;1180;328;1069;670;2249
520530;201308;2345;7383;2042;6884;491;1691;995;3708;1486;5399
520540;201308;2807;8905;2513;8374;852;2981;1039;3440;1891;6421
520545;201308;1276;4052;1107;3697;350;1275;337;1062;687;2337
520547;201308;801;2548;639;2252;220;855;186;613;406;1468
520549;201308;7860;24851;6977;23782;1760;6498;4243;14365;6003;20863
520551;201308;3545;11078;3416;10913;1054;3512;1869;6225;2923;9737
520552;201308;677;2320;663;2300;136;521;436;1498;572;2019
520570;201308;562;1693;424;1461;182;664;82;288;264;952
520580;201308;1881;5646;1552;5136;480;1794;471;1465;951;3259
520590;201308;1431;4179;1265;3919;354;1174;547;1591;901;2765
520620;201308;6718;22384;6177;21538;1458;5471;3622;12791;5080;18262
520630;201308;606;1705;523;1605;156;467;303;963;459;1430
520640;201308;2288;7070;2130;6837;791;2616;921;3113;1712;5729
520650;201308;777;2326;684;2151;298;992;246;763;544;1755
520660;201308;356;1159;316;1075;108;401;97;327;205;728
520670;201308;748;2277;732;2253;78;193;624;1980;702;2173
520680;201308;529;1687;481;1618;182;665;178;588;360;1253
520690;201308;305;807;215;684;29;97;124;407;153;504
520710;201308;312;864;273;802;9;29;200;569;209;598
520725;201308;1692;4604;1350;4111;332;1133;703;2104;1035;3237
520735;201308;582;1835;501;1691;188;669;153;497;341;1166
520740;201308;1625;4890;1392;4552;397;1377;662;2169;1059;3546
520750;201308;665;1822;509;1617;147;528;295;926;442;1454
520753;201308;1091;3290;1071;3260;172;476;820;2590;992;3066
520760;201308;1117;3194;994;3038;329;1079;535;1610;864;2689
520780;201308;1823;4810;1618;4543;189;531;1280;3655;1469;4186
520790;201308;2365;7122;2145;6804;340;1191;1506;4821;1846;6012
520800;201308;16554;50530;14855;48481;3491;11350;8915;31192;12406;42542
520810;201308;795;2427;780;2398;116;379;603;1879;719;2258
520815;201308;373;1325;302;1180;161;688;47;186;208;874
520830;201308;1650;4352;1297;3983;63;169;1173;3688;1236;3857
520840;201308;1616;5536;1463;5230;493;1867;547;2010;1040;3877
520850;201308;776;2295;618;2075;192;690;282;927;474;1617
520860;201308;6814;20226;5300;18225;1585;5894;2547;8894;4132;14788
520870;201308;117290;337157;84584;276959;28086;99800;25290;82299;53376;182099
520880;201308;5999;17979;4533;15553;1428;5465;639;1964;2067;7429
520890;201308;3366;10466;3107;10053;784;2696;1660;5354;2444;8050
520910;201308;3662;12078;3242;11190;1164;4347;938;3080;2102;7427
520915;201308;875;2518;648;2068;159;534;241;739;400;1273
520920;201308;2824;8056;2166;6975;595;2072;729;2387;1324;4459
520929;201308;428;1294;397;1256;119;391;201;633;320;1024
520940;201308;913;2852;852;2763;121;442;636;2032;757;2474
520945;201308;607;1560;543;1456;205;560;195;493;400;1053
520960;201308;857;2566;722;2366;119;413;460;1515;579;1928
520970;201308;3276;9684;2666;8574;598;2169;1119;3518;1717;5687
520980;201308;1002;2768;941;2684;155;473;734;2088;889;2561
520990;201308;3622;11504;3222;10806;725;2630;1701;6177;2426;8807
520993;201308;1025;2946;838;2575;149;510;479;1430;628;1940
520995;201308;2474;6904;2238;6584;372;1145;1616;4783;1988;5928
521000;201308;7347;22649;6396;21118;1572;5647;3488;11600;5060;17247
521010;201308;3430;11199;3070;10471;868;3197;1316;4495;2184;7692
521015;201308;693;2016;596;1865;159;518;298;936;457;1454
521020;201308;4169;12676;3439;11163;1318;4615;755;2204;2073;6819
521030;201308;783;2143;700;2028;143;434;476;1400;619;1834
521040;201308;5061;15282;4633;14591;1729;5505;2222;7275;3951;12780
521056;201308;969;3036;830;2807;281;1003;356;1226;637;2229
521060;201308;1107;3187;959;2932;237;780;391;1158;628;1938
521080;201308;1112;2879;749;2260;176;630;266;687;442;1317
521090;201308;3007;9199;2627;8660;920;3243;1066;3531;1986;6774
521100;201308;1363;3632;1269;3528;226;626;916;2608;1142;3234
521120;201308;4595;13623;4222;12981;1007;3027;2424;7769;3431;10796
521130;201308;1039;3047;897;2809;195;678;470;1503;665;2181
521140;201308;864;2972;784;2782;313;1175;166;559;479;1734
521150;201308;10855;30117;8554;26000;2703;8970;4010;12107;6713;21077
521160;201308;693;1816;498;1421;93;290;298;817;391;1107
521170;201308;1297;3194;1129;2989;321;833;655;1744;976;2577
521180;201308;6104;21319;5617;20292;2147;8222;1603;5801;3750;14023
521190;201308;8144;25060;6304;21839;2309;8381;1983;6944;4292;15325
521200;201308;776;2140;734;2087;115;336;531;1531;646;1867
521205;201308;460;1535;429;1468;72;262;265;926;337;1188
521210;201308;800;2436;593;2012;224;859;213;635;437;1494
521220;201308;3552;10511;3109;9879;1128;3857;1165;3635;2293;7492
521225;201308;366;976;298;884;47;159;195;587;242;746
521230;201308;1254;4062;1194;3922;456;1591;523;1654;979;3245
521250;201308;24725;84977;23766;83365;9882;36809;9189;32691;19071;69500
521260;201308;754;1946;615;1677;112;398;341;857;453;1255
521270;201308;1657;5529;1564;5369;141;428;1269;4527;1410;4955
521280;201308;1637;5274;1441;4948;477;1743;597;2044;1074;3787
521290;201308;494;1475;375;1271;102;413;156;507;258;920
521295;201308;1060;3057;993;2963;190;620;688;2033;878;2653
521300;201308;1738;5206;1595;4965;547;1772;662;2143;1209;3915
521305;201308;813;2184;688;2012;165;489;412;1244;577;1733
521308;201308;4674;14366;3877;13079;763;2873;2345;7780;3108;10653
521310;201308;6574;20839;5669;19302;2277;8249;1581;5312;3858;13561
521340;201308;238;785;218;749;76;288;84;270;160;558
521350;201308;2058;5529;1706;5069;241;813;1111;3458;1352;4271
521370;201308;977;3193;903;3044;322;1163;331;1081;653;2244
521375;201308;1263;3686;1101;3425;275;928;583;1784;858;2712
521377;201308;928;2893;904;2859;92;281;764;2459;856;2740
521380;201308;3473;10504;2899;9608;696;2572;1258;4058;1954;6630
521385;201308;574;1670;519;1593;158;512;262;807;420;1319
521390;201308;1095;2940;834;2569;310;1083;255;782;565;1865
521400;201308;2324;6371;2015;6026;273;865;1598;4772;1871;5637
521405;201308;1042;3259;1001;3198;194;623;652;2140;846;2763
521410;201308;734;2402;676;2306;342;1142;210;774;552;1916
521440;201308;1419;4009;1394;3983;147;377;1197;3497;1344;3874
521450;201308;4811;14787;4048;13356;1348;4799;987;3058;2335;7857
521460;201308;6629;21438;6126;20638;1968;7100;2920;9901;4888;17001
521470;201308;716;2082;548;1764;132;473;128;437;260;910
521480;201308;511;1513;384;1294;132;461;96;326;228;787
521483;201308;2941;8011;2519;7300;641;1962;1214;3484;1855;5446
521486;201308;1520;4408;1385;4143;385;1300;809;2287;1194;3587
521487;201308;543;1522;416;1332;98;319;216;703;314;1022
521490;201308;793;2366;660;2190;131;478;408;1371;539;1849
521500;201308;1127;3811;1058;3684;154;585;756;2573;910;3158
521520;201308;864;2083;774;1982;187;389;444;1288;631;1677
521523;201308;10838;40997;10167;39814;3422;14603;4144;16097;7566;30700
521525;201308;1029;2711;929;2577;128;408;627;1683;755;2091
521530;201308;1913;5778;1359;4680;552;2017;230;747;782;2764
521540;201308;864;2574;654;2143;212;809;163;458;375;1267
521550;201308;859;2237;780;2124;227;696;424;1089;651;1785
521560;201308;4879;15125;3905;13817;1679;6476;996;3368;2675;9844
521565;201308;599;1739;549;1673;92;305;392;1199;484;1504
521570;201308;4134;11811;3234;10152;1159;3924;1077;3399;2236;7323
521580;201308;595;1556;459;1360;168;530;162;483;330;1013
521590;201308;712;2071;618;1912;242;809;123;402;365;1211
521600;201308;613;1650;442;1344;120;400;151;413;271;813
521630;201308;1734;4827;1472;4409;600;2075;271;658;871;2733
521640;201308;1707;5044;1506;4728;530;1922;402;1287;932;3209
521645;201308;619;1986;548;1829;159;592;224;685;383;1277
521680;201308;1324;4436;1232;4219;731;2620;212;685;943;3305
521690;201308;557;1682;502;1575;117;433;257;752;374;1185
521710;201308;2075;6651;1866;6251;400;1426;1130;3763;1530;5189
521720;201308;1973;6012;1817;5797;449;1471;1098;3588;1547;5059
521730;201308;3603;12422;3433;12079;1548;5934;1018;3323;2566;9257
521740;201308;3237;9180;2641;8406;1275;4169;887;2929;2162;7098
521760;201308;11751;41229;11195;40381;2041;8183;7668;27759;9709;35942
521770;201308;2708;8345;2333;7611;1042;3625;513;1566;1555;5191
521800;201308;8280;25315;7268;23837;2754;9466;3303;11184;6057;20650
521805;201308;835;2015;739;1853;246;552;372;1088;618;1640
521810;201308;812;2437;713;2261;180;623;365;1138;545;1761
521830;201308;5363;18454;5098;18030;1068;4096;3431;12110;4499;16206
521839;201308;637;2008;546;1808;156;544;223;711;379;1255
521850;201308;6200;18075;5670;17291;1335;4047;3409;10654;4744;14701
521860;201308;1665;5202;1463;4773;425;1528;531;1638;956;3166
521870;201308;542;1913;503;1808;159;620;140;459;299;1079
521878;201308;421;1424;391;1372;147;580;125;410;272;990
521880;201308;23030;63004;16145;51548;6012;20590;4674;15058;10686;35648
521890;201308;3508;11170;3013;10165;1197;4321;708;2369;1905;6690
521900;201308;1634;4372;1344;3958;362;1192;535;1449;897;2641
521910;201308;1156;3362;1016;3197;263;908;581;1858;844;2766
521920;201308;405;1313;396;1294;166;571;179;581;345;1152
521925;201308;585;1840;536;1724;120;425;289;888;409;1313
521930;201308;3874;12803;3550;12161;1406;5122;1114;3791;2520;8913
521935;201308;670;2033;637;1967;191;630;342;1026;533;1656
521940;201308;1145;3119;949;2804;358;1123;326;970;684;2093
521945;201308;648;2285;604;2232;127;421;438;1712;565;2133
521950;201308;481;1592;423;1482;158;593;157;547;315;1140
521960;201308;915;2714;788;2481;211;713;373;1152;584;1865
521970;201308;2378;6945;2212;6722;379;1189;1561;4871;1940;6060
521971;201308;894;2550;745;2299;199;680;321;937;520;1617
521973;201308;801;2766;738;2641;224;837;236;843;460;1680
521975;201308;12572;37472;11879;36566;2422;8159;7696;23713;10118;31872
521980;201308;1682;5524;1646;5480;291;935;1275;4379;1566;5314
521990;201308;996;3232;945;3133;192;697;579;1879;771;2576
522000;201308;2052;6208;1833;5924;398;1347;1112;3760;1510;5107
522005;201308;305;887;246;790;65;228;127;392;192;620
522010;201308;2782;8593;2471;8085;931;3334;756;2390;1687;5724
522015;201308;964;2925;818;2703;237;877;422;1381;659;2258
522020;201308;4060;11894;3621;11325;1010;3338;1999;6238;3009;9576
522026;201308;607;1765;436;1589;209;807;130;482;339;1289
522028;201308;519;1572;471;1492;123;429;273;839;396;1268
522040;201308;2878;7478;2088;6447;769;2564;801;2459;1570;5023
522045;201308;12003;40714;10556;37561;3641;14091;2304;8007;5945;22098
522050;201308;1017;3040;855;2768;295;1059;334;1029;629;2088
522060;201308;2704;8964;2482;8641;796;2955;1349;4698;2145;7653
522068;201308;1377;4699;1299;4609;120;383;1105;4044;1225;4427
522070;201308;814;2518;745;2403;132;508;470;1486;602;1994
522100;201308;795;2214;705;2074;262;879;323;879;585;1758
522108;201308;902;2661;803;2517;90;300;594;1899;684;2199
522119;201308;1432;4427;1247;4191;143;479;1002;3440;1145;3919
522130;201308;502;1465;434;1389;132;469;221;708;353;1177
522140;201308;16079;46914;14361;44620;4295;14320;7487;23242;11782;37562
522145;201308;901;2634;852;2550;454;1437;212;622;666;2059
522150;201308;1246;3294;1025;3008;355;1115;392;1197;747;2312
522155;201308;700;2127;642;2043;155;517;377;1232;532;1749
522157;201308;661;1999;608;1913;72;252;466;1472;538;1724
522160;201308;5732;16919;4425;14775;1978;7270;837;2627;2815;9897
522170;201308;3169;8859;2712;8227;749;2317;1275;4075;2024;6392
522180;201308;431;1296;340;1172;166;630;114;379;280;1009
522185;201308;13645;44544;12927;43548;2842;10393;8029;27232;10871;37625
522190;201308;698;2056;631;1910;121;385;385;1171;506;1556
522200;201308;1505;5136;1398;4902;525;1979;438;1487;963;3466
522205;201308;1282;3751;1079;3410;324;1060;486;1555;810;2615
522220;201308;1013;3237;930;3124;228;817;517;1836;745;2653
522230;201308;914;3020;862;2929;201;744;510;1770;711;2514
530010;201308;245413;813544;221411;763898;69951;265862;72300;248634;142251;514496
110001;201307;4196;14090;3643;13202;1075;4056;1987;7293;3062;11349
110002;201307;12121;40305;10951;38186;3763;14014;4747;16687;8510;30701
110003;201307;979;3210;915;3108;276;992;384;1275;660;2267
110004;201307;9088;30652;8051;28480;2663;10262;2943;10395;5606;20657
110005;201307;2279;7897;2187;7719;827;2988;959;3425;1786;6413
110006;201307;3409;9204;2159;7464;726;2652;639;2102;1365;4754
110007;201307;1403;4656;1299;4506;346;1223;776;2753;1122;3976
110008;201307;2419;8586;2276;8378;563;1978;1504;5814;2067;7792
110009;201307;4940;14763;4029;13469;886;3080;2490;8397;3376;11477
110010;201307;8240;23970;7335;22856;1353;3752;5049;17041;6402;20793
110011;201307;10587;33356;8866;30421;3495;12674;3086;10633;6581;23307
110012;201307;15379;49369;13837;46442;5117;18191;5420;18143;10537;36334
110013;201307;5079;16492;4281;15364;1292;4833;2139;7845;3431;12678
110014;201307;4099;12478;3498;11632;851;2930;2099;7060;2950;9990
110015;201307;4853;16145;4106;14847;1627;6235;1461;5289;3088;11524
110018;201307;4981;15003;4106;13876;1322;4957;1845;5994;3167;10951
110020;201307;50713;156218;44697;148636;10448;35814;27068;92653;37516;128467
110025;201307;4184;12737;3585;11623;611;2173;2562;8248;3173;10421
110026;201307;781;2371;668;2242;160;534;442;1528;602;2062
110028;201307;7239;21823;5568;19158;1735;6480;1843;6316;3578;12796
110029;201307;1636;4926;1319;4383;446;1535;574;1936;1020;3471
110030;201307;10939;32151;9038;29724;2681;9434;4575;15582;7256;25016
110032;201307;3962;13259;3614;12497;1030;3722;1706;5930;2736;9652
110033;201307;5146;16755;4850;16317;1544;5212;2507;8949;4051;14161
110034;201307;3699;9739;3162;9122;473;1308;2479;7295;2952;8603
110037;201307;2015;6977;1795;6566;518;1888;974;3649;1492;5537
110040;201307;3439;11615;3274;11302;1107;4070;1535;5303;2642;9373
110045;201307;4965;17935;4729;17631;1309;5121;2907;10912;4216;16033
110050;201307;1759;5809;1488;5465;564;2078;755;2859;1319;4937
110060;201307;970;3445;868;3251;250;964;467;1767;717;2731
110070;201307;1876;6574;1840;6485;314;1154;1341;4745;1655;5899
110080;201307;3201;10568;3116;10461;528;1667;2437;8399;2965;10066
110090;201307;927;2828;755;2555;231;875;321;1017;552;1892
110092;201307;1651;5463;1510;5270;378;1338;867;3172;1245;4510
110094;201307;2748;9366;2569;9111;692;2587;1538;5503;2230;8090
110100;201307;2614;8555;2287;8013;674;2453;1247;4424;1921;6877
110110;201307;1699;5752;1599;5636;680;2438;737;2691;1417;5129
110120;201307;1616;5543;1427;5092;399;1498;561;1983;960;3481
110130;201307;2731;8000;2131;7142;579;2074;1066;3590;1645;5664
110140;201307;2337;8277;2254;8151;544;2004;1423;5229;1967;7233
110143;201307;1493;5087;1235;4649;303;1205;725;2705;1028;3910
110145;201307;949;2987;853;2828;176;614;536;1788;712;2402
110146;201307;444;1454;401;1385;111;399;215;751;326;1150
110147;201307;868;2680;710;2432;202;744;283;922;485;1666
110148;201307;1324;4025;1104;3593;361;1292;388;1200;749;2492
110149;201307;3397;10437;2858;9688;666;2337;1879;6499;2545;8836
110150;201307;2738;8352;2271;7647;426;1543;1487;5014;1913;6557
110155;201307;864;2980;837;2919;305;1121;379;1290;684;2411
110160;201307;2061;6786;1778;6360;518;1889;977;3566;1495;5455
110170;201307;3088;9171;2473;8144;550;1921;1549;5143;2099;7064
110175;201307;1568;5206;1243;4802;117;491;946;3672;1063;4163
110180;201307;1644;5319;1443;4968;342;1216;876;3031;1218;4247
120001;201307;2738;10124;2667;9981;713;2812;1523;5822;2236;8634
120005;201307;1472;6200;1432;6123;182;722;1093;4893;1275;5615
120010;201307;4118;15084;3957;14789;874;3133;2538;9946;3412;13079
120013;201307;1748;6882;1722;6836;316;1242;1219;5019;1535;6261
120017;201307;2004;7317;1918;7164;542;2095;951;3841;1493;5936
120020;201307;13769;60922;13585;60487;2606;10894;9748;45502;12354;56396
120025;201307;2509;8981;2443;8877;653;2464;1442;5366;2095;7830
120030;201307;5341;22648;5308;22577;649;2543;4321;18930;4970;21473
120032;201307;1326;6356;1283;6246;177;977;953;4691;1130;5668
120033;201307;3467;13452;3441;13404;180;726;3100;12205;3280;12931
120034;201307;1804;7290;1803;7289;69;279;1694;6892;1763;7171
120035;201307;2399;11885;2380;11833;279;1308;1893;9829;2172;11137
120038;201307;3125;11546;3021;11328;852;3269;1650;6383;2502;9652
120039;201307;1335;7645;1313;7590;182;1087;1026;6051;1208;7138
120040;201307;42268;156977;39657;151225;12366;49150;19331;75852;31697;125002
120042;201307;2596;11597;2513;11391;290;1394;1954;9037;2244;10431
120043;201307;780;3760;769;3732;75;367;644;3183;719;3550
120045;201307;4270;15301;4237;15243;983;3493;2985;11023;3968;14516
120050;201307;7921;33280;7726;32849;1768;7232;4842;22023;6610;29255
120060;201307;5364;26575;5305;26461;814;3941;4050;21004;4864;24945
120070;201307;2659;10321;2618;10223;606;2237;1647;6824;2253;9061
120080;201307;3503;13473;3380;13281;605;2416;2409;9743;3014;12159
130002;201307;2705;11612;2556;11349;323;1473;1956;8826;2279;10299
130006;201307;1682;7325;1527;7003;192;979;1115;5150;1307;6129
130008;201307;1845;7802;1786;7685;198;906;1379;6085;1577;6991
130010;201307;2727;9275;2372;8856;255;871;1951;7506;2206;8377
130014;201307;3208;10693;2797;10097;436;1731;1895;6886;2331;8617
130020;201307;2312;8335;2297;8318;64;245;2209;8001;2273;8246
130030;201307;6344;25770;6162;25523;570;1967;5261;22552;5831;24519
130040;201307;3504;11174;3334;10918;182;642;2959;9725;3141;10367
130050;201307;5627;23210;5033;22213;801;3421;3498;16420;4299;19841
130060;201307;5552;23945;5248;23535;563;2422;4322;19893;4885;22315
130063;201307;2838;12893;2818;12850;403;1745;2270;10641;2673;12386
130068;201307;2863;12322;2692;11959;375;1806;1952;8754;2327;10560
130070;201307;6200;21478;5830;20989;599;2095;4749;17520;5348;19615
130080;201307;4794;21564;4673;21380;800;3777;3386;15900;4186;19677
130083;201307;1650;7031;1591;6931;290;1297;1137;5015;1427;6312
130090;201307;2263;8452;2163;8309;187;823;1844;7070;2031;7893
130100;201307;5151;20316;4960;20044;477;2065;4093;16747;4570;18812
130110;201307;6291;20555;5910;20084;983;3211;4416;15602;5399;18813
130115;201307;3453;13283;3293;13062;211;668;2981;12052;3192;12720
130120;201307;12375;48809;12129;48464;1165;4252;10308;42449;11473;46701
130130;201307;3316;14572;3213;14376;488;2130;2459;11310;2947;13440
130140;201307;5695;23128;5652;23072;145;438;5457;22529;5602;22967
130150;201307;3222;12371;3159;12287;292;1425;2635;10160;2927;11585
130160;201307;3811;15753;3754;15666;210;747;3454;14616;3664;15363
130165;201307;2709;11172;2671;11108;520;2183;2024;8525;2544;10708
130170;201307;7788;30235;6973;29215;1310;5429;4926;21567;6236;26996
130180;201307;3281;10476;3214;10380;129;387;2968;9659;3097;10046
130185;201307;8006;30089;7786;29772;1665;6119;5388;21564;7053;27683
130190;201307;16111;57802;14429;55619;3145;11680;9246;37916;12391;49596
130195;201307;1732;7110;1675;7023;99;445;1484;6264;1583;6709
130200;201307;1916;7068;1796;6861;325;1295;1212;4697;1537;5992
130210;201307;1101;4321;1045;4219;170;673;779;3261;949;3934
130220;201307;1973;8175;1838;7937;338;1640;1184;5134;1522;6774
130230;201307;3264;14909;3112;14624;303;1496;2480;11891;2783;13387
130240;201307;7912;31323;7362;30501;558;2568;6192;26069;6750;28637
130250;201307;16648;62911;16350;62434;2439;8651;12717;50509;15156;59160
130255;201307;3740;14066;3554;13742;234;844;3095;12270;3329;13114
130260;201307;230134;757295;211384;728759;59365;206991;115794;415775;175159;622766
130270;201307;7231;30486;6557;29418;1106;4838;4653;21909;5759;26747
130280;201307;2884;11416;2824;11326;168;569;2526;10403;2694;10972
130290;201307;10291;37837;10084;37506;227;725;9491;35805;9718;36530
130300;201307;4200;16669;3983;16357;356;1534;3269;13656;3625;15190
130310;201307;4328;17675;4019;17276;660;2673;2948;13272;3608;15945
130320;201307;2627;9214;2407;8906;355;1368;1720;6525;2075;7893
130330;201307;3300;12329;2961;11856;272;1145;2450;9980;2722;11125
130340;201307;16609;65735;16220;65111;2772;10478;11617;49273;14389;59751
130350;201307;3189;12874;3060;12730;161;408;2838;12181;2999;12589
130353;201307;4877;16482;4435;15870;1238;4395;2496;9469;3734;13864
130356;201307;3706;13935;3564;13705;543;2029;2720;10869;3263;12898
130360;201307;2652;8147;2390;7839;66;196;2211;7407;2277;7603
130370;201307;4549;18148;3886;17264;304;1643;3162;14095;3466;15738
130380;201307;6609;27997;6379;27614;493;2320;5383;23509;5876;25829
130390;201307;4380;19489;4129;19060;486;2165;3310;15755;3796;17920
130395;201307;1913;7414;1777;7148;316;1404;1119;4497;1435;5901
130400;201307;2109;7635;2040;7531;98;384;1826;6819;1924;7203
130406;201307;8561;33778;7734;32382;1984;8103;4405;19713;6389;27816
130410;201307;4026;15506;3730;14952;907;3777;2097;8722;3004;12499
130420;201307;9187;40162;8914;39543;2438;10728;5164;24048;7602;34776
130423;201307;2858;11489;2734;11312;258;1255;2253;9338;2511;10593
130426;201307;1899;8369;1826;8237;310;1377;1298;6135;1608;7512
130430;201307;3272;12126;3103;11877;376;1563;2296;8982;2672;10545
130440;201307;3538;13234;3262;12930;234;777;2856;11739;3090;12516
140002;201307;1252;4609;1214;4541;275;933;797;3213;1072;4146
140005;201307;2264;7410;2134;7266;134;438;1896;6556;2030;6994
140010;201307;41861;139327;38378;133432;8712;32247;22955;81401;31667;113648
140015;201307;2480;8769;2402;8667;180;534;2101;7804;2281;8338
140017;201307;2798;9304;2715;9196;201;650;2369;8165;2570;8815
140020;201307;3958;13766;3717;13433;515;1865;2781;10333;3296;12198
140023;201307;1843;6739;1746;6590;215;811;1369;5322;1584;6133
140028;201307;2012;5801;1948;5726;112;278;1751;5271;1863;5549
140030;201307;3356;11157;3240;11003;354;855;2750;9848;3104;10703
140040;201307;1452;7106;1397;6934;132;736;1031;5229;1163;5965
140045;201307;2187;8335;2124;8250;223;709;1762;7199;1985;7908
140047;201307;4881;14894;4728;14692;925;2541;3346;11095;4271;13636
140050;201307;1424;4531;1352;4426;145;454;1102;3694;1247;4148
140060;201307;1243;4076;1159;3962;228;759;807;2871;1035;3630
140070;201307;1427;7049;1424;7043;58;235;1352;6764;1410;6999
150010;201307;30646;104335;29522;102811;2201;7984;25312;89390;27513;97374
150013;201307;1453;4727;1410;4677;134;455;1174;3930;1308;4385
150020;201307;10171;36880;9971;36564;1344;4893;7845;29417;9189;34310
150030;201307;5813;26002;5668;25747;617;2432;4676;22158;5293;24590
150034;201307;4337;11941;4124;11688;148;343;3915;11238;4063;11581
150040;201307;11591;41793;10263;40103;2101;7499;6974;29185;9075;36684
150050;201307;5834;22668;5707;22428;683;2902;4536;17972;5219;20874
150060;201307;13670;46028;13075;45147;3516;11843;7715;28015;11231;39858
150070;201307;4968;21671;4592;21209;583;2581;3673;17459;4256;20040
150080;201307;56818;158311;50746;150653;6490;17567;38579;118264;45069;135831
150085;201307;4603;16863;4442;16626;785;2507;3314;13193;4099;15700
150090;201307;9400;37489;8934;36847;1165;4618;7053;29861;8218;34479
150095;201307;4922;17464;4612;16989;543;2000;3665;13833;4208;15833
150100;201307;3308;12670;3132;12416;307;1418;2545;10008;2852;11426
150110;201307;3134;15140;3122;15110;160;668;2890;14182;3050;14850
150120;201307;5653;22875;5555;22673;753;3024;4400;18208;5153;21232
150125;201307;760;2420;699;2318;155;543;420;1394;575;1937
150130;201307;17629;59580;17102;58771;1867;6448;13889;48378;15756;54826
150140;201307;132662;410346;128535;405140;19313;61411;99935;318946;119248;380357
150145;201307;4609;15083;4286;14655;633;2219;3166;11057;3799;13276
150150;201307;8595;29447;8161;28731;1822;6686;5236;18692;7058;25378
150157;201307;2436;8409;2286;8195;341;1313;1778;6392;2119;7705
150160;201307;2545;9003;2460;8875;652;2251;1511;5712;2163;7963
150170;201307;21468;80617;20478;79407;3165;12051;15891;62610;19056;74661
150172;201307;2815;10019;2557;9643;293;1129;2111;8077;2404;9206
150175;201307;1928;6256;1866;6180;152;471;1628;5515;1780;5986
150178;201307;10335;32996;9057;31496;549;1663;8149;29014;8698;30677
150180;201307;16125;67707;15720;67154;1531;6949;13224;57064;14755;64013
150190;201307;6855;22455;6495;21941;423;1070;5687;19971;6110;21041
150195;201307;4108;15500;3868;15056;459;1777;3037;12031;3496;13808
150200;201307;4441;15376;4395;15317;99;332;4189;14692;4288;15024
150210;201307;21504;83010;21256;82653;1978;7334;18415;72708;20393;80042
150215;201307;5084;17082;4719;16533;1229;4378;2771;9961;4000;14339
150220;201307;11735;39575;11087;38500;2616;9253;6619;23534;9235;32787
150230;201307;10428;37306;9638;36186;805;3687;8110;30177;8915;33864
150240;201307;31260;99090;29089;95355;8393;28705;14759;49406;23152;78111
150250;201307;3504;14251;3415;14104;653;2476;2442;10669;3095;13145
150260;201307;1785;7698;1752;7622;294;1402;1185;5177;1479;6579
150270;201307;9070;28440;7215;26114;1652;6372;4515;16603;6167;22975
150275;201307;5403;20627;5177;20249;865;3433;3773;15070;4638;18503
150276;201307;2001;6083;1907;5967;278;916;1507;4724;1785;5640
150277;201307;4878;15435;4315;14772;501;1782;3483;12131;3984;13913
150280;201307;5653;24840;5553;24613;638;2763;4468;20211;5106;22974
150285;201307;2542;10319;2520;10274;196;804;2223;9131;2419;9935
150290;201307;7604;25628;7469;25437;848;2804;6107;21280;6955;24084
150293;201307;8355;27444;7494;26100;2529;9022;3556;12998;6085;22020
150295;201307;5759;20348;5232;19631;1324;5008;3187;12369;4511;17377
150300;201307;1697;6110;1663;6061;116;408;1442;5306;1558;5714
150304;201307;3851;12501;3399;11897;528;1876;2532;9017;3060;10893
150307;201307;6372;22457;5970;21869;489;1747;4960;18698;5449;20445
150309;201307;6134;22879;5804;22390;1613;6173;3596;14469;5209;20642
150310;201307;4806;22733;4736;22609;537;2399;3906;19205;4443;21604
150320;201307;7571;22649;7431;22479;483;1512;6650;20191;7133;21703
150330;201307;12306;46824;11830;46029;1456;5698;9356;37195;10812;42893
150340;201307;2002;7215;1909;7081;494;1930;1135;4270;1629;6200
150345;201307;6252;22580;5889;22078;695;2636;4775;18264;5470;20900
150350;201307;6847;23612;6564;23180;906;3260;4937;17690;5843;20950
150360;201307;19897;64675;17616;61871;2524;8984;13370;48351;15894;57335
150370;201307;9401;36712;9116;36309;1136;4214;7420;30559;8556;34773
150375;201307;2654;11281;2600;11213;235;796;2228;10079;2463;10875
150380;201307;9118;29122;8307;28011;913;3343;6928;23331;7841;26674
150390;201307;7643;33702;7342;33071;1756;7525;4502;21433;6258;28958
150400;201307;5125;21911;4977;21566;636;2646;3709;16617;4345;19263
150405;201307;7894;25279;7219;24417;1505;4631;4899;17630;6404;22261
150410;201307;1600;6345;1572;6297;256;1070;1095;4501;1351;5571
150420;201307;29990;111465;27611;107604;7348;29864;15507;62691;22855;92555
150430;201307;6028;23382;5921;23182;828;3594;4532;17730;5360;21324
150440;201307;5123;18315;5034;18169;759;2685;3784;13950;4543;16635
150442;201307;20781;60404;19165;58381;3061;9504;13776;43086;16837;52590
150445;201307;4828;17572;4487;17087;650;2362;3481;13641;4131;16003
150450;201307;4075;19842;3952;19672;376;1857;3344;16974;3720;18831
150460;201307;6321;24388;5449;23470;367;1686;4892;21246;5259;22932
150470;201307;14983;49771;14627;49286;1536;4418;12419;43182;13955;47600
150480;201307;13573;47239;13139;46632;883;2847;11550;41890;12433;44737
150490;201307;6080;23890;5986;23767;366;1422;5400;21657;5766;23079
150495;201307;4286;16397;4204;16239;428;1741;3518;13650;3946;15391
150497;201307;3221;11417;2974;11013;805;2964;1761;6835;2566;9799
150500;201307;2789;8711;2689;8540;386;1284;2042;6477;2428;7761
150503;201307;3627;11700;3120;11042;1198;4411;1350;4996;2548;9407
150506;201307;11410;42013;10931;41360;2614;8680;7501;30371;10115;39051
150510;201307;9136;37162;8656;36324;1450;6141;6132;26728;7582;32869
150520;201307;5685;24243;5602;24115;431;1529;4979;21987;5410;23516
150530;201307;10627;39613;9796;38393;1386;4939;7345;29982;8731;34921
150540;201307;4365;14221;4061;13752;350;1245;3399;11508;3749;12753
150543;201307;4545;14997;4246;14573;1321;4539;2437;8624;3758;13163
150548;201307;7651;25036;7246;24513;729;2334;6090;21067;6819;23401
150549;201307;2132;6959;2041;6848;106;271;1856;6387;1962;6658
150550;201307;20119;65931;18398;63100;5346;18986;9551;33533;14897;52519
150553;201307;20203;76449;18523;72022;7695;31703;3636;14080;11331;45783
150555;201307;1585;5187;1408;4924;253;978;959;3368;1212;4346
150560;201307;1937;6403;1885;6279;226;830;1445;4776;1671;5606
150563;201307;2760;9484;2621;9233;628;2382;1594;5595;2222;7977
150565;201307;3200;11881;3045;11644;247;1071;2508;9636;2755;10707
150570;201307;4833;19300;4776;19200;417;1651;4027;16589;4444;18240
150580;201307;8859;36685;8736;36519;803;2913;7527;32567;8330;35480
150590;201307;4956;20645;4853;20519;173;810;4517;19191;4690;20001
150600;201307;7026;28525;6913;28327;661;2441;5872;24791;6533;27232
150610;201307;2400;8419;2248;8106;286;1168;1576;5617;1862;6785
150611;201307;2510;9677;2426;9474;313;1299;1813;7158;2126;8457
150613;201307;10736;34515;9622;32876;3334;11660;4569;16391;7903;28051
150616;201307;2923;8519;2383;7932;569;1841;1585;5482;2154;7323
150618;201307;7221;25831;6962;25364;2285;8663;3441;12808;5726;21471
150619;201307;4928;17540;4662;17138;751;2885;3305;12335;4056;15220
150620;201307;5871;21872;5407;21258;778;3085;4123;16792;4901;19877
150630;201307;5007;16488;4801;16212;443;1493;4025;13783;4468;15276
150635;201307;4200;14325;3988;13920;819;2919;2540;9155;3359;12074
150640;201307;1390;4590;1377;4569;34;96;1308;4388;1342;4484
150650;201307;11430;36671;10571;35112;2912;10102;5652;19041;8564;29143
150655;201307;4988;17492;4639;16991;792;2932;3372;12618;4164;15550
150658;201307;3839;13118;3692;12888;351;1469;2945;10173;3296;11642
150660;201307;5476;17877;5039;17314;1401;4742;2927;10483;4328;15225
150670;201307;5760;17711;5065;16865;1715;5759;2682;9498;4397;15257
150680;201307;46471;189436;44539;185754;15872;65524;20754;92824;36626;158348
150690;201307;1783;6002;1668;5786;278;988;1083;3863;1361;4851
150700;201307;5405;17650;5194;17348;1091;3634;3506;11999;4597;15633
150710;201307;3627;12135;3468;11915;364;1006;2951;10482;3315;11488
150715;201307;4684;16078;4353;15649;557;1982;3499;12878;4056;14860
150720;201307;6000;25478;5759;25044;873;3564;4286;19443;5159;23007
150730;201307;8537;30518;8084;29899;1179;4227;6437;24386;7616;28613
150740;201307;3375;11386;3211;11070;493;1798;2247;7870;2740;9668
150745;201307;5837;18715;5456;18203;904;3155;4017;13541;4921;16696
150746;201307;1293;4579;1240;4475;185;768;887;3206;1072;3974
150747;201307;4826;16287;4525;15888;445;1520;3671;13295;4116;14815
150750;201307;2496;9007;2445;8948;119;279;2291;8592;2410;8871
150760;201307;10729;35913;10376;35404;2516;8453;6624;23350;9140;31803
150770;201307;5101;20488;4964;20278;912;3369;3700;15831;4612;19200
150775;201307;1044;3467;963;3314;197;820;583;1926;780;2746
150780;201307;2950;10065;2929;10042;87;221;2775;9655;2862;9876
150790;201307;4715;15467;4460;15153;334;971;3850;13483;4184;14454
150795;201307;13665;44337;12677;42815;2018;6593;9324;32459;11342;39052
150796;201307;2651;8428;2589;8350;390;1152;2008;6747;2398;7899
150797;201307;3604;12389;3469;12174;185;680;3056;10843;3241;11523
150800;201307;13143;45603;12157;44362;2863;9925;8032;30830;10895;40755
150803;201307;6308;23973;6120;23694;871;3571;4592;18087;5463;21658
150805;201307;2608;9361;2441;9123;376;1330;1779;6896;2155;8226
150808;201307;5638;19737;4909;18362;2160;8486;1257;4942;3417;13428
150810;201307;18293;59169;15701;56021;2653;9152;11201;41972;13854;51124
150812;201307;4706;15348;4434;15020;457;1871;3446;11491;3903;13362
150815;201307;8275;27021;7515;26088;1067;3342;5918;21399;6985;24741
150820;201307;9931;30140;9106;29241;524;1132;8239;27270;8763;28402
150830;201307;11862;46998;11415;46212;964;3715;9273;39019;10237;42734
150835;201307;1904;7198;1779;6898;506;2067;852;3318;1358;5385
150840;201307;6325;19170;5227;17778;1359;5112;2916;9607;4275;14719
160005;201307;682;2658;647;2582;111;516;395;1558;506;2074
160010;201307;1476;5332;1465;5320;194;546;1205;4605;1399;5151
160015;201307;1501;5722;1469;5664;270;981;1049;4275;1319;5256
160020;201307;2238;7547;2092;7349;295;1077;1567;5621;1862;6698
160021;201307;791;3562;771;3526;142;708;524;2463;666;3171
160023;201307;900;3470;891;3457;110;391;745;2963;855;3354
160025;201307;1177;3296;1145;3262;26;85;1099;3124;1125;3209
160027;201307;7602;25529;7234;25093;1597;5652;4887;17371;6484;23023
160030;201307;35939;138588;35310;137297;8319;31370;23971;96229;32290;127599
160040;201307;3184;13613;3130;13520;217;1001;2754;11964;2971;12965
160050;201307;3034;11825;2760;11394;987;3733;1329;6208;2316;9941
160053;201307;2021;8611;2001;8577;561;2393;1224;5427;1785;7820
160055;201307;764;3033;748;3010;144;631;527;2136;671;2767
160060;201307;17216;57967;16246;56880;4310;14268;10387;38487;14697;52755
160070;201307;1918;8589;1903;8564;207;845;1636;7545;1843;8390
160080;201307;2378;9662;2360;9632;156;548;2152;8948;2308;9496
170025;201307;560;1968;517;1902;190;733;235;893;425;1626
170030;201307;1133;3839;1054;3701;300;1079;562;1999;862;3078
170035;201307;1508;4673;1245;4166;438;1578;401;1371;839;2949
170040;201307;1700;5862;1538;5615;345;1417;908;3336;1253;4753
170070;201307;1999;5598;1660;5172;412;1392;921;2930;1333;4322
170100;201307;2452;6810;2191;6352;270;890;1726;4954;1996;5844
170105;201307;717;2418;615;2212;132;589;331;1141;463;1730
170110;201307;1180;3713;1045;3492;203;684;661;2234;864;2918
170130;201307;1343;4347;1206;4166;181;621;869;3111;1050;3732
170190;201307;1590;4733;1346;4382;558;1845;409;1484;967;3329
170200;201307;1443;4582;1143;4034;307;1208;375;1292;682;2500
170210;201307;25285;83038;22540;78084;9416;35033;6400;22733;15816;57766
170215;201307;1097;3643;1004;3489;146;518;736;2622;882;3140
170220;201307;6369;21514;5898;20784;853;3150;4190;15154;5043;18304
170230;201307;1405;4892;1263;4639;354;1466;593;2117;947;3583
170240;201307;2968;8445;2435;7798;328;1170;1703;5506;2031;6676
170255;201307;3456;11389;2964;10549;1076;3772;1192;4588;2268;8360
170270;201307;1032;2732;758;2361;202;654;434;1379;636;2033
170290;201307;2860;8924;2537;8527;220;675;2120;7397;2340;8072
170300;201307;2000;6475;1791;6138;309;1179;1209;4146;1518;5325
170305;201307;679;2221;574;2013;117;462;348;1193;465;1655
170307;201307;1048;3723;920;3496;303;1172;353;1514;656;2686
170310;201307;1591;4461;1292;3979;331;1088;605;1946;936;3034
170320;201307;933;2826;780;2558;188;631;423;1424;611;2055
170330;201307;794;2454;672;2313;117;389;458;1633;575;2022
170360;201307;448;1597;425;1557;94;367;217;794;311;1161
170370;201307;1364;4126;1158;3833;196;768;703;2312;899;3080
170380;201307;2051;6661;1722;6170;437;1766;906;3207;1343;4973
170382;201307;561;1921;508;1851;53;190;418;1543;471;1733
170384;201307;1440;6220;1378;6104;318;1456;910;4131;1228;5587
170386;201307;801;2492;668;2288;203;762;246;876;449;1638
170388;201307;639;1952;563;1830;133;514;229;727;362;1241
170389;201307;943;3303;886;3213;104;463;669;2384;773;2847
170390;201307;1289;3959;1131;3757;192;652;820;2795;1012;3447
170410;201307;462;1557;444;1525;68;261;302;1031;370;1292
170460;201307;491;1412;380;1232;105;362;132;446;237;808
170510;201307;747;2577;644;2419;135;583;346;1284;481;1867
170550;201307;5211;16745;4425;15317;1820;6740;1233;4360;3053;11100
170555;201307;1307;3940;1098;3621;283;1036;611;2011;894;3047
170560;201307;1019;3512;868;3341;177;681;615;2459;792;3140
170600;201307;1295;3769;1163;3612;74;254;973;3078;1047;3332
170610;201307;1595;4893;1267;4374;208;805;740;2583;948;3388
170625;201307;389;1285;313;1119;88;326;86;306;174;632
170650;201307;1236;4105;1155;3947;285;1040;621;2161;906;3201
170700;201307;3808;12998;3238;12042;884;3610;1486;5736;2370;9346
170710;201307;1661;5056;1421;4705;176;685;1021;3397;1197;4082
170720;201307;1770;4766;1566;4447;312;899;1074;3097;1386;3996
170730;201307;1135;3292;943;3007;296;1048;422;1339;718;2387
170740;201307;2113;7887;1959;7641;292;1262;1402;5506;1694;6768
170755;201307;869;2798;740;2516;205;748;291;970;496;1718
170765;201307;1561;4281;1271;3815;336;1086;535;1662;871;2748
170770;201307;1804;6419;1690;6198;404;1544;974;3688;1378;5232
170820;201307;4077;13266;3700;12660;1053;3815;1679;5849;2732;9664
170825;201307;727;2274;564;1962;136;526;240;811;376;1337
170830;201307;1278;3870;1224;3788;49;115;1130;3538;1179;3653
170900;201307;2771;10002;2663;9788;349;1273;2015;7620;2364;8893
170930;201307;4167;12839;3433;11787;1390;5020;1155;3986;2545;9006
170950;201307;10581;33087;8634;29828;3913;14898;1988;6391;5901;21289
170980;201307;422;1396;370;1297;98;357;159;564;257;921
171050;201307;1221;4456;1165;4354;60;277;1041;3843;1101;4120
171070;201307;1654;5454;1539;5297;342;1245;940;3300;1282;4545
171090;201307;857;2645;765;2501;154;516;493;1638;647;2154
171110;201307;627;1892;521;1724;165;597;282;891;447;1488
171150;201307;855;2558;642;2152;128;463;364;1222;492;1685
171180;201307;574;1873;470;1647;122;475;206;740;328;1215
171190;201307;1829;6646;1571;6107;397;1619;742;3022;1139;4641
171195;201307;850;3113;780;2986;114;475;493;1958;607;2433
171200;201307;647;2156;549;1970;154;640;257;866;411;1506
171215;201307;425;1323;349;1192;65;243;169;587;234;830
171240;201307;866;2961;830;2901;67;156;710;2601;777;2757
171245;201307;664;2224;556;1961;120;461;279;979;399;1440
171250;201307;1121;3255;1015;3131;68;217;862;2692;930;2909
171270;201307;394;1649;369;1593;84;327;212;996;296;1323
171280;201307;845;2727;770;2593;178;609;400;1463;578;2072
171320;201307;3775;11960;3307;11289;1144;4102;1554;5314;2698;9416
171330;201307;2713;8495;2444;8083;632;2189;1363;4588;1995;6777
171360;201307;1478;4942;1267;4630;321;1260;704;2615;1025;3875
171370;201307;693;1989;622;1871;144;528;335;945;479;1473
171380;201307;1271;4476;1155;4251;298;1087;631;2429;929;3516
171395;201307;881;2835;756;2598;157;617;401;1367;558;1984
171420;201307;2249;6912;1844;6200;478;1749;838;2818;1316;4567
171430;201307;1014;3257;928;3130;213;726;556;1909;769;2635
171488;201307;2366;7441;2192;7178;576;1892;1184;4046;1760;5938
171500;201307;878;2729;777;2526;133;395;443;1492;576;1887
171510;201307;879;3235;803;3117;155;621;509;2076;664;2697
171515;201307;607;1815;490;1645;113;399;235;802;348;1201
171525;201307;581;2008;499;1852;103;413;268;1000;371;1413
171550;201307;315;1125;282;1034;127;511;51;195;178;706
171570;201307;1067;3556;967;3412;176;621;656;2372;832;2993
171575;201307;1894;5553;1533;4912;459;1535;627;2089;1086;3624
171610;201307;5895;20687;5489;19903;1972;7483;1915;7009;3887;14492
171620;201307;2118;7008;1999;6816;195;735;1622;5561;1817;6296
171630;201307;892;3018;747;2758;173;711;334;1229;507;1940
171650;201307;2242;7258;1902;6673;532;2006;860;2951;1392;4957
171660;201307;2533;7230;2106;6482;509;1651;1089;3440;1598;5091
171665;201307;1336;4258;1194;4014;221;826;761;2594;982;3420
171670;201307;2244;6200;1889;5752;453;1496;1163;3488;1616;4984
171700;201307;1087;3710;995;3558;158;644;650;2315;808;2959
171720;201307;658;2099;585;1957;157;586;315;1047;472;1633
171750;201307;1185;4007;1068;3768;399;1474;378;1347;777;2821
171780;201307;1112;3294;833;2888;142;543;514;1777;656;2320
171790;201307;1718;5596;1407;5140;289;1077;841;3213;1130;4290
171800;201307;706;2318;653;2241;98;376;445;1530;543;1906
171820;201307;9105;29215;8490;28468;2062;7429;4994;17016;7056;24445
171830;201307;1600;5944;1471;5663;357;1445;718;2768;1075;4213
171840;201307;741;2267;672;2172;77;273;502;1623;579;1896
171845;201307;782;2142;612;1847;90;328;358;1041;448;1369
171850;201307;1008;3681;927;3504;116;523;607;2285;723;2808
171855;201307;1217;3988;1111;3810;124;509;828;2788;952;3297
171865;201307;475;1580;408;1481;102;420;200;714;302;1134
171870;201307;644;2130;550;1966;119;453;282;1034;401;1487
171875;201307;1346;4378;1150;4079;180;704;822;2912;1002;3616
171880;201307;980;3596;959;3563;121;473;747;2838;868;3311
171884;201307;829;2486;648;2211;162;608;244;846;406;1454
171886;201307;1442;5020;1326;4767;456;1725;455;1673;911;3398
171888;201307;630;1980;549;1837;110;382;335;1162;445;1544
171889;201307;461;1586;449;1553;84;266;289;1057;373;1323
171890;201307;1074;3703;986;3573;141;623;676;2401;817;3024
171900;201307;425;1692;408;1658;101;421;232;950;333;1371
172000;201307;633;2062;545;1937;86;373;336;1160;422;1533
172010;201307;1140;3950;1085;3852;111;446;859;3064;970;3510
172015;201307;349;1315;306;1250;63;249;177;777;240;1026
172020;201307;2277;7628;2048;7285;301;1176;1467;5275;1768;6451
172025;201307;694;2129;594;1950;101;372;358;1167;459;1539
172030;201307;1054;3697;973;3547;173;712;622;2290;795;3002
172049;201307;1076;3148;1016;3064;140;432;767;2334;907;2766
172065;201307;1123;3462;955;3247;147;571;720;2426;867;2997
172080;201307;2657;8247;2286;7631;313;1227;1545;5068;1858;6295
172085;201307;497;1406;398;1234;114;415;117;342;231;757
172090;201307;3313;10180;2631;9313;542;2080;1599;5786;2141;7866
172093;201307;561;1873;449;1666;170;698;187;696;357;1394
172097;201307;660;2008;561;1833;177;619;186;605;363;1224
172100;201307;23919;84712;21818;80424;7879;31528;6531;24160;14410;55688
172110;201307;1619;5944;1518;5800;150;569;1213;4762;1363;5331
172120;201307;5412;16508;4581;15454;479;1701;3584;12348;4063;14049
172125;201307;316;984;257;894;59;225;124;452;183;677
172130;201307;484;1458;433;1380;79;267;279;926;358;1193
172208;201307;2123;6723;2010;6533;445;1541;1128;3739;1573;5280
172210;201307;2246;6826;2149;6710;146;493;1899;5929;2045;6422
210005;201307;20308;68580;18674;65898;5671;21163;9650;34427;15321;55590
210010;201307;1588;5630;1441;5446;175;632;1127;4413;1302;5045
210015;201307;3365;10475;3124;10138;217;469;2683;9159;2900;9628
210020;201307;6925;18026;6529;17545;443;1387;5416;14704;5859;16091
210030;201307;5767;19605;5528;19273;438;1854;4655;16115;5093;17969
210040;201307;1919;5683;1760;5494;178;566;1400;4428;1578;4994
210043;201307;5628;17814;5404;17463;346;1208;4692;15257;5038;16465
210047;201307;6594;26214;6227;25561;936;4139;4226;17520;5162;21659
210050;201307;2449;8536;2013;8017;228;931;1556;6314;1784;7245
210055;201307;1599;5674;1529;5572;198;681;1199;4448;1397;5129
210060;201307;7795;29004;7098;27939;820;3578;5300;21269;6120;24847
210070;201307;6493;20899;6274;20636;290;1062;5729;18930;6019;19992
210080;201307;3593;12476;3524;12370;98;384;3288;11586;3386;11970
210083;201307;3364;12490;3312;12423;250;891;2900;11053;3150;11944
210087;201307;2333;7748;2251;7645;183;669;1956;6642;2139;7311
210090;201307;9263;31141;9011;30726;552;2007;7859;26944;8411;28951
210095;201307;6044;24012;5940;23829;669;2726;4870;19857;5539;22583
210100;201307;7390;22271;7074;21917;270;1037;6463;20012;6733;21049
210110;201307;3105;10972;3012;10837;205;799;2545;9312;2750;10111
210120;201307;22403;71890;19943;68612;2191;7989;15274;53533;17465;61522
210125;201307;3204;10927;3098;10803;232;777;2714;9626;2946;10403
210130;201307;3436;10819;3369;10741;272;864;2863;9214;3135;10078
210135;201307;1579;4825;1428;4599;111;360;1206;3958;1317;4318
210140;201307;15997;53547;13925;50854;3053;11420;8998;33937;12051;45357
210150;201307;4340;11907;4116;11643;187;497;3766;10712;3953;11209
210160;201307;17625;59323;16607;57818;2165;7290;13027;46572;15192;53862
210170;201307;13611;51240;13405;50942;1041;3607;11714;45435;12755;49042
210173;201307;1723;7555;1678;7458;166;761;1419;6372;1585;7133
210177;201307;2821;9702;2682;9518;382;1478;2037;7209;2419;8687
210180;201307;1397;4496;1335;4395;124;429;1098;3621;1222;4050
210190;201307;5010;16585;4772;16187;388;1741;3749;12436;4137;14177
210193;201307;1400;4570;1320;4437;91;359;1102;3736;1193;4095
210197;201307;1653;6170;1589;6097;108;473;1402;5369;1510;5842
210200;201307;8818;30585;8231;29735;1220;4160;6024;22740;7244;26900
210203;201307;6006;20807;5660;20359;478;1561;4852;17848;5330;19409
210207;201307;2930;10048;2792;9811;389;1338;2106;7560;2495;8898
210210;201307;8433;29345;8185;28947;342;1301;7179;25778;7521;27079
210215;201307;1732;6993;1695;6937;154;692;1428;5875;1582;6567
210220;201307;6046;23886;5869;23590;490;1997;4827;19870;5317;21867
210230;201307;5258;18315;4922;17756;506;1878;3904;14267;4410;16145
210232;201307;10871;41459;10431;40762;2318;8922;7145;28815;9463;37737
210235;201307;3278;10697;3027;10369;208;740;2637;9100;2845;9840
210237;201307;2489;9099;2467;9066;44;107;2384;8869;2428;8976
210240;201307;2781;9151;2686;9006;261;812;2182;7478;2443;8290
210250;201307;4444;15264;4307;15091;159;607;3977;14035;4136;14642
210255;201307;2546;8563;2350;8233;614;2313;1364;4837;1978;7150
210260;201307;5089;16610;4746;16101;646;2102;3655;12708;4301;14810
210270;201307;5130;15095;4661;14472;184;647;4176;13073;4360;13720
210275;201307;3187;8605;2989;8389;102;268;2828;7988;2930;8256
210280;201307;5817;17337;5137;16484;376;1289;4383;14216;4759;15505
210290;201307;5797;18690;5376;18158;534;1771;4407;15198;4941;16969
210300;201307;34744;110436;30295;104583;3249;11955;24425;85714;27674;97669
210310;201307;2711;8128;2603;7951;131;417;2294;7031;2425;7448
210312;201307;1821;6379;1798;6339;146;574;1545;5456;1691;6030
210315;201307;2169;7989;2095;7877;88;403;1869;7037;1957;7440
210317;201307;4256;12935;4162;12825;161;463;3908;12130;4069;12593
210320;201307;18487;60150;17484;58945;1145;3921;15366;52661;16511;56582
210325;201307;3441;11263;3153;10830;367;1362;2457;8503;2824;9865
210330;201307;30244;85971;26197;81495;3863;10891;19380;64582;23243;75473
210340;201307;11488;36998;10635;35936;1282;3868;8280;29427;9562;33295
210350;201307;9795;32435;9316;31756;840;2939;7640;26539;8480;29478
210355;201307;3901;14195;3600;13820;129;340;3342;13163;3471;13503
210360;201307;16348;51544;15472;50247;1418;4832;12480;41216;13898;46048
210370;201307;7520;21921;6927;21284;280;857;6357;19751;6637;20608
210375;201307;3164;9912;2798;9482;480;1744;2059;7072;2539;8816
210380;201307;5990;18144;5467;17320;521;1550;4489;14498;5010;16048
210390;201307;2615;9776;2490;9568;98;436;2280;8805;2378;9241
210400;201307;4695;15564;4529;15346;431;1305;3836;13343;4267;14648
210405;201307;8383;23921;6982;22012;2102;6680;3319;11381;5421;18061
210407;201307;2042;7249;1850;6950;192;679;1440;5650;1632;6329
210408;201307;2032;8412;1947;8310;81;333;1783;7784;1864;8117
210409;201307;3789;13859;3622;13593;319;1206;2882;11125;3201;12331
210410;201307;3450;11321;3246;11056;357;1182;2702;9324;3059;10506
210420;201307;4007;13706;3794;13326;379;1289;3051;10950;3430;12239
210430;201307;1835;6060;1806;6018;142;502;1569;5266;1711;5768
210440;201307;4061;13207;3967;13059;209;726;3521;11697;3730;12423
210450;201307;2732;8966;2543;8666;232;862;2070;7061;2302;7923
210455;201307;3995;12254;3428;11353;625;2120;2287;7788;2912;9908
210460;201307;4046;13227;3861;12997;201;745;3399;11558;3600;12303
210462;201307;1741;6374;1693;6288;184;705;1299;4937;1483;5642
210465;201307;2701;9036;2564;8856;336;987;2053;7407;2389;8394
210467;201307;5778;20237;5432;19747;497;1764;4497;16789;4994;18553
210470;201307;1703;5198;1500;4897;101;388;1199;3926;1300;4314
210480;201307;12843;45318;11657;43694;3116;11807;6856;26898;9972;38705
210490;201307;3218;10182;3021;9886;381;1306;2327;7666;2708;8972
210500;201307;6593;26243;6332;25779;735;2933;4932;20773;5667;23706
210510;201307;6429;22288;6316;22153;181;566;5864;21010;6045;21576
210515;201307;3525;11576;3470;11494;282;854;3015;10190;3297;11044
210520;201307;2594;8487;2474;8318;245;857;2012;6873;2257;7730
210530;201307;38593;132370;34349;125674;11326;44156;17165;64034;28491;108190
210535;201307;2978;10913;2923;10809;144;579;2597;9667;2741;10246
210540;201307;11559;42554;10586;40912;2340;8935;6339;26084;8679;35019
210542;201307;6266;18676;5548;17877;337;1025;4905;16150;5242;17175
210545;201307;2159;7489;2074;7350;93;409;1806;6414;1899;6823
210547;201307;3325;12510;3181;12292;206;905;2695;10499;2901;11404
210550;201307;6121;18102;5328;17213;267;763;4824;15918;5091;16681
210560;201307;3671;12483;3466;12157;272;1081;2903;10169;3175;11250
210565;201307;1535;5306;1364;5044;117;526;1032;3808;1149;4334
210570;201307;12165;36591;11172;35422;1039;2987;9375;30633;10414;33620
210580;201307;2717;9010;2437;8638;285;980;1944;7041;2229;8021
210590;201307;4348;13817;4149;13573;262;884;3662;12134;3924;13018
210592;201307;2396;7785;2346;7705;110;424;2094;6850;2204;7274
210594;201307;2639;7859;2272;7398;149;507;1966;6486;2115;6993
210596;201307;2810;10783;2688;10553;350;1393;2003;7996;2353;9389
210598;201307;1986;6180;1895;6075;107;460;1730;5450;1837;5910
210600;201307;3248;9736;3044;9451;331;1078;2415;7500;2746;8578
210610;201307;2555;8308;2312;8013;263;932;1875;6555;2138;7487
210620;201307;1731;5492;1618;5342;52;153;1499;4996;1551;5149
210630;201307;3285;12424;2885;11615;547;2220;1701;7137;2248;9357
210632;201307;4696;16522;4352;16039;526;1954;3415;12776;3941;14730
210635;201307;1870;6951;1833;6898;69;225;1702;6512;1771;6737
210637;201307;2647;9211;2552;9075;137;522;2278;8178;2415;8700
210640;201307;4140;13945;4089;13877;30;92;3983;13594;4013;13686
210650;201307;6442;20242;6355;20122;261;812;5913;18858;6174;19670
210660;201307;7149;23203;6754;22568;287;878;6161;20706;6448;21584
210663;201307;2706;8228;2624;8138;57;166;2498;7853;2555;8019
210667;201307;1590;6080;1542;6011;113;496;1315;5173;1428;5669
210670;201307;4600;17705;4476;17481;424;1705;3606;14416;4030;16121
210675;201307;4490;13017;4327;12814;267;758;3807;11463;4074;12221
210680;201307;4252;12841;3881;12392;200;691;3439;11001;3639;11692
210690;201307;6562;23494;6328;23247;357;1325;5725;21202;6082;22527
210700;201307;2557;7354;2285;7036;193;393;1885;6290;2078;6683
210710;201307;4814;15820;4667;15594;179;558;4291;14467;4470;15025
210720;201307;2330;8942;2249;8827;153;646;1964;7738;2117;8384
210725;201307;1159;4339;1002;4057;138;611;628;2563;766;3174
210730;201307;1140;3709;1038;3598;88;281;891;3136;979;3417
210735;201307;3585;13661;3442;13395;651;2579;2397;9564;3048;12143
210740;201307;4724;13179;4440;12891;183;395;4112;12223;4295;12618
210745;201307;3375;10962;3266;10787;283;966;2687;8883;2970;9849
210750;201307;19419;55601;17963;53901;2113;6441;14499;44045;16612;50486
210760;201307;5672;15734;5429;15469;87;260;5272;15042;5359;15302
210770;201307;6018;16801;5214;15885;381;1193;4491;13765;4872;14958
210780;201307;8478;29435;7999;28558;1083;4171;5866;21191;6949;25362
210790;201307;4502;14077;3967;13488;196;686;3569;12314;3765;13000
210800;201307;4688;14346;4301;13929;198;745;3755;12489;3953;13234
210805;201307;3629;15843;3568;15724;189;813;3142;14134;3331;14947
210810;201307;5431;17191;4927;16614;537;1422;4127;14531;4664;15953
210820;201307;8732;25692;8320;25150;1371;4118;6029;18735;7400;22853
210825;201307;5337;18222;5241;18103;203;723;4792;16714;4995;17437
210830;201307;7929;26382;7667;26087;336;936;7155;24697;7491;25633
210840;201307;3655;10280;3376;9877;325;797;2669;7931;2994;8728
210845;201307;5380;17593;5202;17378;271;811;4631;15868;4902;16679
210850;201307;5684;21848;5389;21321;973;4299;3689;14608;4662;18907
210860;201307;16107;52909;15629;52196;1404;5007;13006;43569;14410;48576
210870;201307;6002;20377;5518;19718;749;2717;4063;14807;4812;17524
210880;201307;3729;12430;3681;12368;199;614;3345;11412;3544;12026
210890;201307;5216;16118;4919;15726;482;1658;4024;12843;4506;14501
210900;201307;4401;14904;4149;14462;1434;5104;1967;7138;3401;12242
210905;201307;1756;5624;1696;5545;103;266;1539;5154;1642;5420
210910;201307;10321;33281;9772;32419;1984;7036;6392;21392;8376;28428
210920;201307;3428;11576;3347;11468;145;427;3051;10653;3196;11080
210923;201307;1486;5661;1433;5570;201;823;1040;4185;1241;5008
210927;201307;4620;14884;4535;14799;41;108;4459;14610;4500;14718
210930;201307;2484;9348;2418;9252;199;906;2054;7835;2253;8741
210940;201307;2839;11418;2801;11346;320;1195;2271;9456;2591;10651
210945;201307;5718;17074;5538;16890;145;207;5340;16584;5485;16791
210950;201307;5273;17334;4720;16507;688;2459;3333;12000;4021;14459
210955;201307;1789;6218;1650;5970;280;1122;1126;4079;1406;5201
210960;201307;8887;30373;8624;29955;1854;6233;5974;21541;7828;27774
210970;201307;1321;4974;1189;4775;200;856;833;3412;1033;4268
210975;201307;1622;5961;1556;5829;157;668;1250;4678;1407;5346
210980;201307;8327;22133;8148;21922;333;854;7510;20318;7843;21172
210990;201307;14309;42395;12122;39950;1409;4747;9746;32409;11155;37156
211000;201307;15685;52370;14443;50741;1235;4543;12082;43062;13317;47605
211003;201307;5013;17953;4656;17394;780;3070;3195;12178;3975;15248
211010;201307;6506;21996;6356;21796;153;516;5948;20572;6101;21088
211020;201307;7247;22585;7184;22507;227;466;6858;21786;7085;22252
211023;201307;2344;8192;2262;8048;178;663;1898;6847;2076;7510
211027;201307;3002;11795;2870;11569;284;1086;2305;9635;2589;10721
211030;201307;4080;12898;3724;12480;823;2312;2675;9518;3498;11830
211040;201307;3998;15649;3909;15497;125;526;3535;14241;3660;14767
211050;201307;9625;27106;9503;26964;526;1384;8765;25065;9291;26449
211060;201307;5541;20975;5432;20744;553;1945;4511;17691;5064;19636
211065;201307;1636;5791;1509;5619;84;329;1367;5119;1451;5448
211070;201307;8421;28999;8077;28427;812;2954;6468;23120;7280;26074
211080;201307;1316;4241;1097;3941;94;459;904;3174;998;3633
211085;201307;1975;6783;1725;6458;309;1102;1289;5012;1598;6114
211090;201307;3403;11162;3243;10935;237;944;2724;9132;2961;10076
211100;201307;6258;17614;6132;17454;146;525;5726;16271;5872;16796
211102;201307;3045;11565;2958;11434;371;1418;2373;9390;2744;10808
211105;201307;2674;8729;2480;8482;167;612;2157;7395;2324;8007
211107;201307;4216;13477;4018;13222;142;464;3700;12288;3842;12752
211110;201307;6234;19387;5137;17996;877;3007;3521;12972;4398;15979
211120;201307;29847;85559;26730;81373;3517;10470;20049;62837;23566;73307
211125;201307;2015;6912;1916;6748;150;551;1604;5706;1754;6257
211130;201307;140266;426679;133289;417808;25761;80346;94746;303901;120507;384247
211140;201307;5607;18475;5391;18134;307;1138;4702;15830;5009;16968
211150;201307;9488;30723;9185;30343;730;2403;8029;26858;8759;29261
211153;201307;3153;9626;2897;9321;291;750;2408;8110;2699;8860
211157;201307;1201;4069;1039;3817;147;643;727;2729;874;3372
211160;201307;4042;14347;3590;13586;408;1791;2735;10358;3143;12149
211163;201307;1633;5508;1567;5425;66;252;1437;4986;1503;5238
211167;201307;1439;5009;1346;4853;61;266;1184;4265;1245;4531
211170;201307;6476;18023;6297;17803;155;557;5890;16574;6045;17131
211172;201307;2303;6921;2033;6499;169;633;1633;5137;1802;5770
211174;201307;2798;8484;2588;8213;133;546;2261;7110;2394;7656
211176;201307;5463;16281;4691;15379;507;1396;3823;13054;4330;14450
211178;201307;2841;9455;2777;9388;68;200;2650;9049;2718;9249
211180;201307;4154;15377;3921;14997;409;1730;3087;11865;3496;13595
211190;201307;2703;9467;2489;9159;149;651;2173;8019;2322;8670
211195;201307;1375;4523;1220;4354;110;384;993;3626;1103;4010
211200;201307;2067;7399;1880;7137;280;974;1359;5488;1639;6462
211210;201307;6687;22729;6525;22453;519;1841;5541;19263;6060;21104
211220;201307;33896;104141;30164;99187;7145;24274;18418;62388;25563;86662
211223;201307;5846;17025;5456;16379;718;2189;3812;12015;4530;14204
211227;201307;1466;5740;1439;5691;168;774;1114;4403;1282;5177
211230;201307;8611;30241;8106;29363;1403;5136;5606;20824;7009;25960
211240;201307;8340;28472;8140;28226;359;1310;7506;26161;7865;27471
211245;201307;4930;15778;4854;15680;226;641;4453;14620;4679;15261
211250;201307;11395;44167;10906;43591;1261;4228;9055;37732;10316;41960
211260;201307;7195;25134;7121;25011;369;1211;6526;23164;6895;24375
211270;201307;9764;35551;9353;35015;644;2725;7878;29805;8522;32530
211280;201307;11800;34413;11526;34098;1287;3089;9675;29796;10962;32885
211285;201307;1960;7063;1717;6611;421;1689;895;3629;1316;5318
211290;201307;7685;25464;7543;25298;543;1452;6685;23023;7228;24475
211300;201307;8220;26028;7451;24849;719;2526;5959;20006;6678;22532
211400;201307;11925;36313;10927;35168;2401;7662;6783;23724;9184;31386
220005;201307;1681;5028;1619;4931;60;279;1441;4260;1501;4539
220010;201307;1708;4596;1306;4096;146;549;1017;3128;1163;3677
220020;201307;3627;11386;3493;11146;630;2148;2362;7528;2992;9676
220025;201307;2104;5405;2008;5277;70;227;1813;4693;1883;4920
220027;201307;1353;3846;1276;3744;103;249;1092;3294;1195;3543
220030;201307;3240;10118;3181;10020;270;932;2689;8487;2959;9419
220040;201307;8196;25922;7865;25383;1474;5067;5075;16430;6549;21497
220045;201307;1416;4619;1299;4431;165;636;955;3225;1120;3861
220050;201307;4740;13773;4267;13134;358;1298;3520;10718;3878;12016
220060;201307;1917;5141;1826;5033;116;333;1616;4465;1732;4798
220070;201307;2544;7741;2282;7376;220;714;1833;6026;2053;6740
220080;201307;816;2583;770;2498;100;404;539;1673;639;2077
220090;201307;1679;4768;1520;4528;151;545;1179;3423;1330;3968
220095;201307;633;1879;616;1839;41;123;554;1645;595;1768
220100;201307;1388;4284;1220;4022;167;511;888;3029;1055;3540
220105;201307;2154;7285;2053;7094;214;781;1524;5285;1738;6066
220110;201307;3493;10319;3107;9768;296;1108;2522;7814;2818;8922
220115;201307;2162;8086;2083;7952;300;1195;1614;6229;1914;7424
220117;201307;1398;3797;1172;3465;94;317;928;2707;1022;3024
220120;201307;11952;35904;11245;34997;421;1594;10208;31784;10629;33378
220130;201307;775;2894;690;2781;67;194;589;2480;656;2674
220140;201307;1534;4221;1460;4132;255;575;1159;3433;1414;4008
220150;201307;6953;22723;6736;22402;482;1907;5742;19001;6224;20908
220155;201307;1027;3304;893;3046;88;375;634;2105;722;2480
220157;201307;1034;2787;959;2678;47;122;832;2345;879;2467
220160;201307;2791;8480;2524;8012;234;892;1912;6000;2146;6892
220170;201307;1220;4072;1167;3972;124;445;903;3111;1027;3556
220173;201307;2067;6370;1723;5707;92;414;1403;4572;1495;4986
220177;201307;1604;4914;1582;4879;88;279;1421;4400;1509;4679
220180;201307;1140;3167;1029;2994;80;278;784;2230;864;2508
220190;201307;4491;14994;3928;14269;489;1858;3008;11038;3497;12896
220191;201307;1399;4811;1347;4723;222;779;993;3509;1215;4288
220192;201307;1729;5177;1453;4720;184;574;1084;3597;1268;4171
220194;201307;1636;4826;1506;4591;195;660;1118;3326;1313;3986
220196;201307;1975;6046;1876;5880;216;800;1438;4442;1654;5242
220198;201307;1326;3655;1136;3401;41;130;1041;3142;1082;3272
220200;201307;4574;16022;4342;15640;765;3005;2962;10619;3727;13624
220202;201307;1976;6464;1831;6204;78;328;1607;5417;1685;5745
220205;201307;2767;7782;2474;7382;121;480;2156;6341;2277;6821
220207;201307;907;2816;800;2630;100;370;600;1967;700;2337
220208;201307;1579;5772;1500;5609;306;1258;955;3589;1261;4847
220209;201307;1532;4953;1417;4749;104;417;1094;3671;1198;4088
220210;201307;1852;5001;1629;4707;101;355;1299;3767;1400;4122
220211;201307;1623;4942;1544;4831;114;499;1264;3922;1378;4421
220213;201307;1775;5282;1669;5088;120;402;1324;3997;1444;4399
220217;201307;1766;5662;1720;5600;85;257;1543;5087;1628;5344
220220;201307;11216;33520;10577;32473;1422;4338;7632;23955;9054;28293
220225;201307;962;3055;941;3022;42;182;844;2674;886;2856
220230;201307;5879;15921;4886;14566;258;799;4308;12897;4566;13696
220240;201307;2627;8608;2534;8439;217;805;2011;6639;2228;7444
220245;201307;1385;3878;1322;3794;64;155;1196;3475;1260;3630
220250;201307;3318;9034;3042;8677;61;136;2869;8294;2930;8430
220253;201307;1823;5560;1598;5147;118;457;1190;3858;1308;4315
220255;201307;1715;5062;1532;4753;129;489;1225;3717;1354;4206
220260;201307;5169;16810;4762;16062;506;1980;3587;12020;4093;14000
220265;201307;1179;4366;1128;4279;103;476;861;3248;964;3724
220270;201307;6238;22013;6101;21762;438;1970;5161;18106;5599;20076
220271;201307;1361;4074;1326;4022;87;274;1147;3515;1234;3789
220272;201307;1753;5504;1640;5334;114;473;1300;4178;1414;4651
220273;201307;1255;3693;1119;3485;103;363;856;2647;959;3010
220275;201307;2026;5541;1749;5180;89;290;1510;4495;1599;4785
220277;201307;2503;6995;2158;6492;177;595;1650;4995;1827;5590
220280;201307;1746;4617;1538;4326;99;368;1252;3456;1351;3824
220285;201307;1638;4450;1496;4252;104;299;1235;3601;1339;3900
220290;201307;6495;21249;5526;20007;500;1897;4475;16436;4975;18333
220300;201307;1872;6181;1672;5913;99;443;1434;5065;1533;5508
220310;201307;2511;8226;2071;7699;110;352;1871;7128;1981;7480
220320;201307;3340;9997;2851;9187;413;1346;2065;6732;2478;8078
220323;201307;1406;5364;1300;5209;232;989;918;3703;1150;4692
220325;201307;1255;3966;1158;3790;164;583;765;2582;929;3165
220327;201307;1305;4281;1190;4080;91;416;965;3272;1056;3688
220330;201307;3566;10483;3423;10285;302;1014;2859;8611;3161;9625
220335;201307;1967;5877;1777;5629;124;459;1522;4797;1646;5256
220340;201307;1733;5054;1565;4830;181;634;1203;3680;1384;4314
220342;201307;1198;3969;1138;3880;112;456;865;3029;977;3485
220345;201307;2837;8055;2437;7399;97;277;2115;6442;2212;6719
220350;201307;4414;12129;3906;11429;313;1017;3116;9103;3429;10120
220360;201307;1440;4025;1147;3561;124;425;829;2562;953;2987
220370;201307;8920;26231;8289;25434;432;1246;7534;23295;7966;24541
220375;201307;1505;4756;1410;4625;89;337;1244;4053;1333;4390
220380;201307;1276;3693;1130;3480;76;262;877;2709;953;2971
220385;201307;668;1884;607;1764;44;147;494;1382;538;1529
220390;201307;10181;32779;9455;31342;2192;7763;5120;17030;7312;24793
220400;201307;1421;3489;1297;3320;64;211;1126;2825;1190;3036
220410;201307;1375;4075;1186;3816;109;472;943;2937;1052;3409
220415;201307;853;2358;772;2242;91;255;573;1693;664;1948
220420;201307;2149;6463;2054;6294;148;471;1736;5332;1884;5803
220430;201307;2909;8724;2764;8530;439;1406;2007;6209;2446;7615
220435;201307;1562;4745;1484;4646;76;237;1282;4046;1358;4283
220440;201307;2780;8323;2301;7773;142;382;2042;7025;2184;7407
220450;201307;2693;8100;2356;7656;569;1901;1444;4769;2013;6670
220455;201307;1386;4359;1245;4156;59;200;1117;3766;1176;3966
220460;201307;997;2854;947;2780;57;181;828;2422;885;2603
220465;201307;2419;8085;2274;7888;379;1404;1682;5895;2061;7299
220470;201307;3971;12247;3628;11628;253;953;2856;9021;3109;9974
220480;201307;2224;6989;2062;6737;174;603;1699;5564;1873;6167
220490;201307;2306;7027;2231;6929;130;480;1959;6054;2089;6534
220500;201307;3390;9357;2965;8666;218;832;2416;6870;2634;7702
220510;201307;2892;8183;2258;7284;106;471;1793;5749;1899;6220
220515;201307;1907;4901;1690;4622;80;230;1443;3962;1523;4192
220520;201307;4851;14074;4603;13712;259;742;4007;12075;4266;12817
220525;201307;1414;4160;1336;4049;102;366;1101;3292;1203;3658
220527;201307;1375;4468;1318;4347;127;401;1087;3633;1214;4034
220530;201307;1065;3233;1020;3161;141;517;808;2409;949;2926
220535;201307;854;2764;828;2724;74;316;668;2156;742;2472
220540;201307;3539;12040;3431;11851;293;1166;2791;9656;3084;10822
220545;201307;1374;4888;1327;4801;220;895;903;3223;1123;4118
220550;201307;8846;29764;8422;28965;1740;6300;5384;18606;7124;24906
220551;201307;1378;4881;1316;4764;134;567;1028;3676;1162;4243
220552;201307;1605;5109;1399;4773;140;638;1011;3313;1151;3951
220553;201307;1576;4785;1393;4511;66;229;1189;3843;1255;4072
220554;201307;919;2614;806;2456;124;382;566;1760;690;2142
220555;201307;2364;7168;2237;6988;104;368;1905;6046;2009;6414
220556;201307;1438;4649;1313;4409;103;429;984;3257;1087;3686
220557;201307;1569;5318;1449;5084;186;782;1026;3549;1212;4331
220558;201307;1013;3201;958;3104;86;326;774;2493;860;2819
220559;201307;1522;4397;1417;4242;84;292;1216;3624;1300;3916
220560;201307;1733;4394;1467;4020;85;247;1248;3398;1333;3645
220570;201307;7206;23377;6841;22928;658;1837;5810;20134;6468;21971
220580;201307;6289;21228;6122;21020;430;1445;5402;18811;5832;20256
220585;201307;1761;6965;1718;6877;118;494;1484;5974;1602;6468
220590;201307;1386;4441;1258;4248;220;780;844;2892;1064;3672
220595;201307;2414;7140;2251;6918;90;305;2030;6263;2120;6568
220600;201307;1262;3316;1106;3124;173;430;781;2299;954;2729
220605;201307;1982;6053;1799;5766;127;430;1416;4559;1543;4989
220610;201307;2598;8638;2524;8526;191;745;2127;7159;2318;7904
220620;201307;7693;26565;7484;26239;399;1629;6584;23056;6983;24685
220630;201307;374;1168;324;1081;83;292;163;555;246;847
220635;201307;1834;6659;1707;6362;171;763;1134;4216;1305;4979
220640;201307;2704;8206;2641;8098;284;986;2055;6287;2339;7273
220650;201307;2451;6944;2214;6577;136;468;1842;5457;1978;5925
220660;201307;2467;8567;2044;8050;151;597;1833;7282;1984;7879
220665;201307;1204;4192;1157;4118;59;240;1006;3567;1065;3807
220667;201307;1743;6003;1656;5876;93;381;1428;5052;1521;5433
220669;201307;1852;6217;1731;5975;230;903;1240;4255;1470;5158
220670;201307;2086;6451;1993;6342;154;405;1752;5762;1906;6167
220672;201307;2143;6408;2095;6339;226;671;1756;5364;1982;6035
220675;201307;1311;3894;1233;3763;134;370;920;2859;1054;3229
220680;201307;2216;7461;2141;7355;115;454;1886;6494;2001;6948
220690;201307;1703;4993;1556;4744;130;495;1264;3792;1394;4287
220695;201307;840;2652;804;2589;63;216;627;2031;690;2247
220700;201307;8928;26612;8212;25539;781;2681;6492;20234;7273;22915
220710;201307;739;2241;656;2112;80;244;476;1554;556;1798
220720;201307;2093;5767;1987;5615;104;238;1764;5079;1868;5317
220730;201307;1328;3776;1211;3597;63;207;1018;3017;1081;3224
220735;201307;1015;2732;878;2509;91;282;650;1869;741;2151
220740;201307;1319;4452;1150;4223;128;432;927;3517;1055;3949
220750;201307;3829;11761;3687;11543;486;1430;2845;9190;3331;10620
220755;201307;1146;3501;1100;3428;67;199;962;3017;1029;3216
220760;201307;2547;9217;2378;8951;120;494;2071;7861;2191;8355
220770;201307;22721;79936;21515;77719;7395;27700;9524;35404;16919;63104
220775;201307;1124;2861;1114;2851;18;27;1090;2809;1108;2836
220777;201307;1653;4861;1585;4762;137;435;1304;3889;1441;4324
220779;201307;1119;3549;1097;3513;70;277;968;3075;1038;3352
220780;201307;6207;16481;5658;15767;508;1293;4699;13374;5207;14667
220785;201307;1273;3570;1230;3477;70;198;1100;3093;1170;3291
220790;201307;8925;30522;8728;30137;915;3512;6973;24019;7888;27531
220793;201307;851;2567;798;2470;71;245;643;1979;714;2224
220795;201307;1460;4298;1411;4221;108;347;1182;3564;1290;3911
220800;201307;16475;48371;15551;46938;2017;7089;11773;34779;13790;41868
220810;201307;3250;9707;2845;8970;254;994;2210;6849;2464;7843
220820;201307;5375;15863;4948;15300;359;1169;4178;13046;4537;14215
220830;201307;7628;22164;7338;21689;895;2615;5701;17155;6596;19770
220840;201307;14321;47188;13311;45177;3557;12348;6279;22098;9836;34446
220850;201307;2556;9670;2465;9527;347;1471;1867;7262;2214;8733
220855;201307;585;1930;541;1844;69;276;396;1338;465;1614
220860;201307;918;2641;861;2549;55;218;708;2051;763;2269
220865;201307;2630;7594;2239;6969;128;571;1831;5587;1959;6158
220870;201307;2364;7897;2078;7535;157;622;1765;6405;1922;7027
220880;201307;5270;14164;4852;13643;265;908;4246;11916;4511;12824
220885;201307;1316;4705;1172;4448;118;555;862;3271;980;3826
220887;201307;1217;3454;1094;3278;52;168;967;2912;1019;3080
220890;201307;1581;5745;1432;5503;119;441;1193;4712;1312;5153
220900;201307;1809;5633;1637;5225;124;382;1319;4278;1443;4660
220910;201307;1718;5049;1545;4778;85;292;1339;4177;1424;4469
220915;201307;1031;3043;927;2871;55;242;744;2239;799;2481
220920;201307;1276;4865;1221;4785;123;561;943;3689;1066;4250
220930;201307;1451;4789;1284;4571;121;499;1029;3683;1150;4182
220935;201307;1086;3435;991;3222;79;343;710;2201;789;2544
220937;201307;1492;4291;1308;3957;86;302;1044;3115;1130;3417
220940;201307;1457;4564;1366;4366;99;364;1103;3534;1202;3898
220945;201307;471;1742;440;1642;59;259;315;1162;374;1421
220950;201307;1238;3219;915;2656;49;201;690;1930;739;2131
220955;201307;1536;4411;1312;4059;147;513;1004;3091;1151;3604
220960;201307;785;2290;708;2157;75;296;539;1584;614;1880
220965;201307;1610;5090;1530;4975;78;321;1314;4262;1392;4583
220970;201307;2083;5764;1599;4986;196;610;1132;3599;1328;4209
220975;201307;466;1907;463;1900;61;234;377;1576;438;1810
220980;201307;1477;4493;1314;4201;131;486;898;2937;1029;3423
220985;201307;1347;3946;1295;3873;113;383;1031;3081;1144;3464
220987;201307;1458;4948;1383;4809;133;557;1051;3591;1184;4148
220990;201307;1783;5403;1613;5117;105;445;1292;4042;1397;4487
220995;201307;1142;3605;971;3311;84;348;761;2591;845;2939
220997;201307;2068;6676;2000;6570;158;532;1753;5757;1911;6289
221000;201307;4047;13122;3768;12624;454;1670;2786;9296;3240;10966
221005;201307;1380;4466;1315;4351;371;1168;751;2591;1122;3759
221010;201307;1237;3453;1102;3282;67;217;951;2853;1018;3070
221020;201307;1886;5979;1791;5807;142;631;1380;4355;1522;4986
221030;201307;1814;5052;1594;4732;87;349;1305;3822;1392;4171
221035;201307;1501;4212;1366;4040;101;299;1173;3513;1274;3812
221037;201307;610;1945;579;1886;36;155;469;1464;505;1619
221038;201307;599;1786;502;1626;50;174;356;1162;406;1336
221039;201307;893;2732;858;2678;65;225;743;2301;808;2526
221040;201307;5067;15919;4836;15538;431;1536;3815;12367;4246;13903
221050;201307;3557;11325;3302;10952;230;950;2811;9213;3041;10163
221060;201307;8957;24824;7816;23349;874;2657;6197;18705;7071;21362
221062;201307;1248;4425;1198;4358;33;100;1129;4132;1162;4232
221063;201307;1084;3599;1042;3528;357;1162;564;2035;921;3197
221065;201307;2608;8014;2502;7830;269;893;1956;6099;2225;6992
221070;201307;4363;13674;4019;13153;295;1113;3239;10588;3534;11701
221080;201307;3264;9518;3006;9174;264;849;2440;7520;2704;8369
221090;201307;1318;3696;1190;3509;73;292;1005;2897;1078;3189
221093;201307;1765;5384;1695;5255;249;902;1163;3521;1412;4423
221095;201307;950;2653;828;2482;44;118;732;2230;776;2348
221097;201307;778;2324;705;2203;66;255;540;1669;606;1924
221100;201307;119462;374475;114372;365949;25490;90304;73980;231173;99470;321477
221110;201307;9283;32818;9140;32587;736;3022;7679;27275;8415;30297
221120;201307;4029;13941;3914;13728;1219;4116;2233;8252;3452;12368
221130;201307;4564;13936;4104;13004;989;3264;2327;7313;3316;10577
221135;201307;1407;4594;1325;4462;194;734;940;3145;1134;3879
221140;201307;1378;3565;1276;3430;171;369;987;2755;1158;3124
221150;201307;1213;3211;1049;2919;33;135;855;2360;888;2495
221160;201307;904;2502;864;2438;62;194;676;1920;738;2114
221170;201307;1080;3632;1044;3558;85;341;863;2910;948;3251
230010;201307;3255;9290;2817;8574;182;632;2257;6932;2439;7564
230015;201307;2980;10481;2774;10039;505;2105;1735;6186;2240;8291
230020;201307;13795;47405;13330;46471;1331;5018;10473;36738;11804;41756
230030;201307;11964;36987;11468;36161;1215;4151;9046;28568;10261;32719
230040;201307;4475;13131;3851;12014;374;1320;2982;9254;3356;10574
230050;201307;2540;8869;2225;8086;422;1721;1211;4399;1633;6120
230060;201307;1923;5985;1743;5628;186;704;1295;4139;1481;4843
230070;201307;4556;12849;4085;12188;397;1271;3120;9509;3517;10780
230075;201307;8559;33224;8214;32516;1120;5020;6029;23940;7149;28960
230080;201307;2301;6626;1986;6174;121;445;1637;5068;1758;5513
230090;201307;3197;10314;2936;9832;351;1361;2202;7262;2553;8623
230100;201307;16431;53139;15499;51441;4647;16302;7587;25498;12234;41800
230110;201307;13754;46804;12922;45004;2597;9840;7878;27427;10475;37267
230120;201307;7499;21741;6892;20925;807;2787;5191;15701;5998;18488
230125;201307;2814;8537;2381;7700;205;788;1798;5778;2003;6566
230130;201307;5882;19801;4923;17712;482;2078;3436;12238;3918;14316
230140;201307;3240;11174;2943;10651;498;1891;1928;7121;2426;9012
230150;201307;1705;5595;1513;5206;281;1134;976;3194;1257;4328
230160;201307;6111;19208;5459;18228;590;2185;4125;13818;4715;16003
230170;201307;6354;20932;5594;19533;564;2262;4055;14032;4619;16294
230180;201307;1878;5628;1705;5325;157;615;1213;3766;1370;4381
230185;201307;4047;14016;3784;13490;712;2609;2374;8710;3086;11319
230190;201307;12173;41163;11246;39293;2072;8246;6778;23464;8850;31710
230195;201307;4731;15271;4332;14646;398;1708;3342;10938;3740;12646
230200;201307;5514;16651;5023;15690;728;2398;3513;10972;4241;13370
230205;201307;4296;14169;3875;13444;429;1745;2807;9817;3236;11562
230210;201307;8913;26726;8087;25459;1939;6294;4684;15215;6623;21509
230220;201307;13133;40777;12307;39374;2113;7573;8281;26151;10394;33724
230230;201307;7114;24540;6453;23088;1136;4259;3910;14206;5046;18465
230240;201307;12875;39154;11818;37165;877;3416;9242;28543;10119;31959
230250;201307;10171;31768;9939;31409;570;2069;8488;26811;9058;28880
230260;201307;14570;51212;13631;49213;3277;12605;7107;26291;10384;38896
230270;201307;6853;21517;6195;20384;706;2598;4624;15293;5330;17891
230280;201307;19699;61730;18416;59603;2496;8828;13767;44540;16263;53368
230290;201307;5018;15957;4444;14803;616;2200;3038;10158;3654;12358
230300;201307;4592;14901;4425;14652;568;2128;3317;10974;3885;13102
230310;201307;4780;14750;4279;13921;413;1667;3262;10409;3675;12076
230320;201307;7170;24012;6804;23353;876;3374;4984;17157;5860;20531
230330;201307;4562;14115;4199;13390;448;1656;3083;9675;3531;11331
230340;201307;3290;11903;3139;11560;522;2203;2011;7247;2533;9450
230350;201307;17647;55716;15989;52779;3246;11481;9707;32417;12953;43898
230360;201307;2847;8831;2593;8378;287;1072;2007;6416;2294;7488
230365;201307;2834;8728;2522;8199;233;907;1872;6053;2105;6960
230370;201307;52032;179405;48851;174045;15033;55848;24546;90266;39579;146114
230380;201307;6970;20674;6053;19115;607;2249;4305;13558;4912;15807
230390;201307;3611;11762;3248;11159;455;1852;2209;7516;2664;9368
230393;201307;3285;11341;2910;10538;307;1479;2061;7230;2368;8709
230395;201307;4851;15911;4561;15333;651;2608;3141;10434;3792;13042
230400;201307;5002;16211;4455;15461;435;1914;3591;12228;4026;14142
230410;201307;15878;51417;14432;48782;2460;9043;9115;30876;11575;39919
230420;201307;23301;80208;22166;77904;5831;22379;11429;39960;17260;62339
230423;201307;4737;15964;4398;15353;542;2084;3096;10936;3638;13020
230425;201307;5219;18242;4929;17605;741;2881;3441;12269;4182;15150
230426;201307;2765;7969;2381;7281;149;615;1841;5511;1990;6126
230427;201307;1724;5395;1326;4481;164;615;875;2887;1039;3502
230428;201307;8784;29803;8589;29463;1825;7038;5518;18647;7343;25685
230430;201307;4511;15004;4297;14566;430;1779;3179;10608;3609;12387
230435;201307;4615;15971;4233;15297;1130;4418;2047;7669;3177;12087
230440;201307;348564;1114435;331693;1083675;87765;309825;169878;554919;257643;864744
230445;201307;4607;13098;4058;12333;424;1285;3029;9451;3453;10736
230450;201307;3567;11805;3078;10909;513;2014;1928;6897;2441;8911
230460;201307;1861;6336;1736;6092;199;763;1279;4519;1478;5282
230465;201307;4022;12818;3388;11612;403;1636;2240;7617;2643;9253
230470;201307;10420;40121;10121;39536;1495;6268;7273;28984;8768;35252
230480;201307;1437;4779;1301;4517;226;825;858;3000;1084;3825
230490;201307;2927;8801;2607;8219;460;1647;1460;4604;1920;6251
230495;201307;5624;19333;5129;18511;978;4124;3109;11222;4087;15346
230500;201307;10607;36868;10169;36159;883;3249;8147;29650;9030;32899
230510;201307;1461;5424;1283;4971;376;1543;575;2312;951;3855
230520;201307;4949;15491;4352;14424;507;1945;3032;10005;3539;11950
230523;201307;12833;44356;12008;42502;3823;14999;3642;13045;7465;28044
230526;201307;3920;12858;3502;12075;481;1844;2367;8253;2848;10097
230530;201307;5004;17270;4668;16788;893;3219;3182;11658;4075;14877
230533;201307;3716;11311;3513;10911;307;1110;2735;8436;3042;9546
230535;201307;5230;16194;4658;15128;511;1808;3419;11224;3930;13032
230540;201307;18235;54432;16559;51984;1286;4714;13574;42322;14860;47036
230550;201307;19990;62054;18464;59147;4437;15415;10147;32432;14584;47847
230560;201307;6545;19552;6031;18582;349;1383;4799;14635;5148;16018
230565;201307;3436;10277;3021;9480;289;1100;2183;6755;2472;7855
230570;201307;3855;10868;3491;10405;256;950;2878;8462;3134;9412
230580;201307;10023;31891;9696;31441;580;2023;8483;27701;9063;29724
230590;201307;9374;30943;8788;29897;850;3569;6610;22051;7460;25620
230600;201307;3577;10417;2891;9014;337;1195;1913;5905;2250;7100
230610;201307;5922;20123;5566;19539;844;3254;3973;14032;4817;17286
230620;201307;1977;5804;1710;5275;184;673;1137;3424;1321;4097
230625;201307;7212;24782;6653;23489;1863;7175;2706;9511;4569;16686
230630;201307;10702;36478;9925;34839;2030;7124;5743;20808;7773;27932
230640;201307;25087;88277;24176;86778;4129;15661;16793;60987;20922;76648
230650;201307;4834;16007;4482;15315;432;1852;3420;11465;3852;13317
230655;201307;8204;32252;7972;31852;899;3548;6492;26478;7391;30026
230660;201307;6214;20091;5514;18804;608;2461;3947;13534;4555;15995
230670;201307;5831;16447;4837;14728;300;1098;3827;11456;4127;12554
230680;201307;2872;8778;2496;8099;446;1603;1491;4837;1937;6440
230690;201307;6660;22340;6329;21735;605;2579;4534;15246;5139;17825
230700;201307;8947;26824;7964;25030;956;3638;5379;16468;6335;20106
230710;201307;7225;24547;6670;23435;902;3266;4789;17166;5691;20432
230720;201307;1900;6129;1639;5622;248;913;1083;3757;1331;4670
230725;201307;3814;12919;3577;12421;606;2396;2398;8197;3004;10593
230730;201307;55637;174496;48002;162730;12328;45555;25076;86332;37404;131887
230740;201307;4933;16695;4848;16525;368;1598;4040;13583;4408;15181
230750;201307;8719;26251;7554;24295;781;3019;5631;17970;6412;20989
230760;201307;9622;30797;9391;30263;1391;5539;6766;20733;8157;26272
230763;201307;4121;13314;3919;12925;353;1606;3011;9511;3364;11117
230765;201307;42708;144146;40366;139303;13844;50679;15036;52864;28880;103543
230770;201307;22150;64837;21251;63543;1726;6487;17230;50867;18956;57354
230780;201307;5891;23964;5670;23444;1315;5522;3198;13913;4513;19435
230790;201307;2460;8714;2375;8579;301;1171;1869;6805;2170;7976
230800;201307;7688;28810;7173;27641;1759;7434;3586;13862;5345;21296
230810;201307;12185;40887;11752;40151;1449;5298;8969;30991;10418;36289
230820;201307;3303;11572;2964;10837;663;2664;1613;5956;2276;8620
230830;201307;7613;23796;6974;22660;748;2897;5087;16409;5835;19306
230835;201307;4053;11420;3525;10737;326;1081;2764;8446;3090;9527
230837;201307;3118;10970;2725;10159;406;1721;1789;6679;2195;8400
230840;201307;9125;31306;8403;30002;1578;5963;5242;19175;6820;25138
230850;201307;11052;34755;10525;34085;1369;4963;7933;25628;9302;30591
230860;201307;4998;15464;4598;14642;438;1683;3440;10781;3878;12464
230870;201307;18474;53141;16827;50301;1954;6645;12526;37149;14480;43794
230880;201307;1893;6750;1782;6528;285;1189;1177;4308;1462;5497
230890;201307;4037;15105;3781;14578;520;2383;2677;10181;3197;12564
230900;201307;2999;10288;2659;9564;453;1748;1606;5776;2059;7524
230910;201307;2922;9104;2430;8132;285;1133;1699;5578;1984;6711
230920;201307;4534;13785;4205;13365;353;1191;3414;11015;3767;12206
230930;201307;7562;23856;6976;22767;938;3300;4892;16058;5830;19358
230940;201307;7484;21596;6707;20484;328;1007;5813;17962;6141;18969
230945;201307;6160;19078;5408;18076;687;2443;3865;13114;4552;15557
230950;201307;6742;19161;5929;18084;388;1357;4701;14334;5089;15691
230960;201307;11736;39135;10982;37565;2715;10209;5308;18070;8023;28279
230970;201307;12930;42991;11997;41119;2670;10457;6314;21186;8984;31643
230980;201307;2733;9389;2564;9029;734;2672;1291;4683;2025;7355
230990;201307;1553;5069;1322;4572;179;741;842;2827;1021;3568
231000;201307;2783;7800;2291;6857;266;948;1541;4487;1807;5435
231010;201307;2846;8661;2555;8217;339;1323;1824;5751;2163;7074
231020;201307;7857;26719;7457;25891;1391;5156;4783;16882;6174;22038
231025;201307;7546;24701;6899;23615;816;2892;5105;17866;5921;20758
231030;201307;7811;26649;6715;24308;1309;5017;4070;14922;5379;19939
231040;201307;2917;10149;2680;9630;320;1378;1849;6544;2169;7922
231050;201307;11590;35240;10476;33185;1136;4073;7653;24240;8789;28313
231060;201307;2362;7670;2198;7387;218;994;1659;5390;1877;6384
231070;201307;8933;29369;8490;28539;1477;5325;5594;18992;7071;24317
231080;201307;4147;13533;3852;12963;318;1455;2851;9237;3169;10692
231085;201307;4571;15205;4428;14938;719;2665;3233;10933;3952;13598
231090;201307;4135;11908;3533;10695;246;925;2666;7948;2912;8873
231095;201307;2143;7298;1898;6817;220;862;1351;4885;1571;5747
231100;201307;3039;9638;2574;8699;251;986;1856;6234;2107;7220
231110;201307;3686;12670;3587;12490;421;1586;2641;9256;3062;10842
231120;201307;2411;8082;2251;7797;385;1400;1493;5197;1878;6597
231123;201307;2163;6221;1897;5795;148;487;1517;4649;1665;5136
231126;201307;6590;18793;5524;17314;482;1736;4335;13445;4817;15181
231130;201307;19676;63893;18212;61281;4778;17006;9623;33383;14401;50389
231135;201307;4543;13806;3900;12804;395;1522;2864;9286;3259;10808
231140;201307;15128;50820;14386;49363;1683;7626;10313;34112;11996;41738
231150;201307;5760;17439;4954;15850;1063;3762;2553;8006;3616;11768
231160;201307;5745;20160;5526;19737;1629;6043;3057;10937;4686;16980
231170;201307;4661;15289;4386;14757;544;2235;3070;10176;3614;12411
231180;201307;13813;44708;13156;43385;2691;9883;8041;26054;10732;35937
231190;201307;4919;14129;4195;13078;409;1446;3225;9957;3634;11403
231195;201307;4632;16262;4060;15146;433;1889;3060;11470;3493;13359
231200;201307;7424;26901;6842;25780;831;3736;4991;18691;5822;22427
231210;201307;4783;15622;4173;14729;349;1510;3147;11212;3496;12722
231220;201307;13850;40764;11890;37434;1355;5017;7762;24461;9117;29478
231230;201307;9390;34372;8900;33391;1272;5264;6319;23766;7591;29030
231240;201307;11403;37264;10463;35601;1446;5536;7080;24333;8526;29869
231250;201307;2049;6102;1421;4541;279;942;605;1817;884;2759
231260;201307;4029;11610;3681;11136;498;1605;2568;7931;3066;9536
231270;201307;7423;21933;6864;21075;772;3021;5000;14976;5772;17997
231280;201307;1697;5777;1628;5638;166;602;1261;4431;1427;5033
231290;201307;32078;117647;29789;111841;8159;33592;12762;46989;20921;80581
231300;201307;4406;13390;3724;11959;406;1616;2674;8297;3080;9913
231310;201307;7090;21592;6332;20061;1456;4853;3401;10749;4857;15602
231320;201307;6957;22023;6237;20640;483;1915;4779;15738;5262;17653
231325;201307;2535;8017;2305;7609;209;756;1765;5885;1974;6641
231330;201307;13844;43976;11783;39976;2045;7148;7312;25068;9357;32216
231335;201307;4914;14615;4439;13740;359;1410;3552;10761;3911;12171
231340;201307;17381;58375;16487;57078;1584;5309;13296;47301;14880;52610
231350;201307;11949;41786;11773;41502;1440;4911;9509;34264;10949;39175
231355;201307;4317;14170;4186;13960;246;811;3650;12350;3896;13161
231360;201307;6737;23078;6399;22556;1544;5323;3903;14382;5447;19705
231370;201307;2307;6843;1906;6259;144;573;1447;4669;1591;5242
231375;201307;4034;14286;3843;13914;475;2068;2878;10275;3353;12343
231380;201307;5208;17250;4911;16835;887;3264;3349;11689;4236;14953
231390;201307;3332;10853;3200;10676;225;905;2683;8971;2908;9876
231395;201307;4153;13687;3755;13062;813;2979;2285;8134;3098;11113
231400;201307;10154;31291;9369;29908;1091;4072;6649;21222;7740;25294
231410;201307;14500;49018;13236;47244;1496;5392;9879;36444;11375;41836
240010;201307;2341;7550;2154;7122;593;2204;974;3108;1567;5312
240020;201307;11620;37226;10478;35054;2945;10628;4796;16364;7741;26992
240030;201307;2724;8228;2630;8077;290;1100;1991;5956;2281;7056
240040;201307;770;2375;671;2178;67;302;480;1475;547;1777
240050;201307;3453;9923;3140;9386;260;968;2386;6973;2646;7941
240060;201307;1405;4315;1347;4215;139;543;1024;3091;1163;3634
240070;201307;2722;7994;2603;7763;392;1289;1731;5070;2123;6359
240080;201307;2954;8161;2762;7874;241;720;2252;6467;2493;7187
240090;201307;2160;6121;1878;5559;90;371;1468;4243;1558;4614
240100;201307;9940;29729;9326;28488;1279;4666;5862;17794;7141;22460
240110;201307;5030;15596;4629;14934;971;3567;2839;8835;3810;12402
240120;201307;2923;9867;2845;9721;624;2320;1763;6107;2387;8427
240130;201307;2653;7583;2313;7047;186;705;1827;5451;2013;6156
240140;201307;2205;7061;2038;6757;472;1771;1082;3525;1554;5296
240145;201307;6114;19353;5575;18387;1513;5554;2949;9710;4462;15264
240150;201307;1004;3129;835;2788;127;532;489;1555;616;2087
240160;201307;1428;4804;1311;4596;160;640;911;3206;1071;3846
240165;201307;864;2876;789;2734;100;381;531;1865;631;2246
240170;201307;2532;7833;2311;7419;605;2061;1194;3913;1799;5974
240180;201307;2880;9325;2723;9066;680;2364;1516;5247;2196;7611
240185;201307;1480;4992;1433;4918;198;710;1048;3629;1246;4339
240190;201307;890;2784;859;2728;118;476;601;1844;719;2320
240200;201307;13478;36393;11597;34028;2327;6936;7362;22433;9689;29369
240210;201307;2684;7817;2497;7569;243;871;2042;6101;2285;6972
240220;201307;7312;23612;7107;23366;299;1189;6493;21279;6792;22468
240230;201307;5262;15549;4950;14984;502;1803;3797;11307;4299;13110
240240;201307;1712;5499;1335;4480;409;1481;308;936;717;2417
240250;201307;2802;8215;2649;7976;217;819;2132;6263;2349;7082
240260;201307;14495;49876;13877;48832;2463;9917;9139;32007;11602;41924
240270;201307;2298;7798;2194;7626;270;947;1638;5809;1908;6756
240280;201307;1578;4649;1413;4343;147;540;1015;3079;1162;3619
240290;201307;1419;4532;1227;4174;113;553;823;2665;936;3218
240300;201307;1998;5585;1685;5053;348;1164;897;2622;1245;3786
240310;201307;10055;29140;9295;27946;2249;7440;4983;14860;7232;22300
240320;201307;2013;6138;1732;5566;142;635;1199;3692;1341;4327
240325;201307;35202;100776;28664;89649;8620;29753;10224;32162;18844;61915
240330;201307;1520;4668;1297;4215;169;674;773;2404;942;3078
240340;201307;1552;4797;1408;4610;297;1060;878;2868;1175;3928
240350;201307;2027;6414;1937;6256;309;1157;1452;4580;1761;5737
240360;201307;7026;21950;6268;20781;1049;3779;4227;14320;5276;18099
240370;201307;1930;5427;1730;5112;135;488;1316;3873;1451;4361
240375;201307;868;2333;780;2209;139;468;460;1235;599;1703
240380;201307;2575;7837;2228;7116;357;1167;1368;4386;1725;5553
240390;201307;883;2593;740;2306;84;321;480;1477;564;1798
240400;201307;1430;3940;1264;3706;138;510;960;2751;1098;3261
240410;201307;512;1697;463;1589;78;313;294;993;372;1306
240420;201307;4810;18479;4651;18126;1345;5293;2468;10161;3813;15454
240430;201307;3407;10034;3160;9597;386;1336;2253;6754;2639;8090
240440;201307;2613;7298;2456;7003;622;1778;1298;3774;1920;5552
240450;201307;3626;11208;3368;10745;568;2151;2074;6567;2642;8718
240460;201307;2756;9310;2688;9187;316;1267;2051;6979;2367;8246
240470;201307;3759;11579;3200;10473;617;2203;1762;5814;2379;8017
240480;201307;340;915;327;898;39;105;246;695;285;800
240485;201307;2087;6365;1862;5930;308;1104;1149;3660;1457;4764
240490;201307;1641;4290;1462;4044;90;347;1167;3118;1257;3465
240500;201307;1965;6220;1917;6136;186;675;1510;4841;1696;5516
240510;201307;1755;5484;1641;5263;263;888;1145;3702;1408;4590
240520;201307;1423;4263;1260;4029;217;806;863;2697;1080;3503
240530;201307;2106;6980;1936;6694;283;1071;1340;4627;1623;5698
240540;201307;1836;5639;1751;5498;156;571;1345;4166;1501;4737
240550;201307;711;2145;674;2079;52;205;534;1606;586;1811
240560;201307;3152;9396;3025;9201;284;964;2465;7467;2749;8431
240570;201307;3064;8924;2549;7779;564;1958;1151;3235;1715;5193
240580;201307;7939;25114;7556;24495;1368;4649;5359;17385;6727;22034
240590;201307;823;2376;743;2241;57;222;539;1585;596;1807
240600;201307;1449;4442;1209;3931;213;791;665;2055;878;2846
240610;201307;5013;14193;4465;13209;465;1554;3178;9261;3643;10815
240615;201307;1007;2954;883;2726;147;459;524;1633;671;2092
240620;201307;1552;5351;1480;5205;309;1166;1017;3593;1326;4759
240630;201307;1985;6261;1901;6118;167;535;1486;4937;1653;5472
240640;201307;846;2634;743;2470;94;424;492;1559;586;1983
240650;201307;3650;11539;3418;11224;320;1213;2755;9007;3075;10220
240660;201307;2378;7970;2296;7841;262;987;1746;6038;2008;7025
240670;201307;2707;8247;2355;7534;365;1365;1395;4349;1760;5714
240680;201307;1468;4394;1204;3900;156;535;744;2425;900;2960
240690;201307;1064;3085;943;2890;108;395;680;2064;788;2459
240700;201307;2586;7954;2184;7162;153;677;1665;5291;1818;5968
240710;201307;18130;46113;16180;43738;2950;8098;10282;28698;13232;36796
240720;201307;5418;16065;5187;15699;1309;4382;2974;8949;4283;13331
240725;201307;1060;3201;831;2690;92;300;463;1479;555;1779
240730;201307;2245;7088;2033;6680;209;782;1419;4599;1628;5381
240740;201307;2232;6825;2017;6434;259;908;1350;4283;1609;5191
240750;201307;2155;8151;2001;7855;459;1915;1159;4628;1618;6543
240760;201307;1171;3613;1119;3534;108;306;901;2947;1009;3253
240770;201307;3454;10353;3197;9963;450;1559;2215;6907;2665;8466
240780;201307;5457;16380;4660;15037;955;3217;2584;8637;3539;11854
240790;201307;828;2684;701;2456;63;256;528;1837;591;2093
240800;201307;38229;114118;35660;109535;10527;34709;15786;49060;26313;83769
240810;201307;92171;283432;87401;274482;29355;95833;39307;125756;68662;221589
240820;201307;6685;20327;5863;19000;981;3573;3465;11506;4446;15079
240830;201307;9105;28467;8680;27845;838;2815;7033;22938;7871;25753
240840;201307;1234;3567;1094;3311;104;385;708;2112;812;2497
240850;201307;1118;3516;878;3015;173;676;459;1490;632;2166
240860;201307;1267;3704;1103;3444;97;360;802;2460;899;2820
240870;201307;1100;3169;970;2921;125;486;666;1871;791;2357
240880;201307;1117;3900;1068;3830;151;657;748;2644;899;3301
240890;201307;5391;15397;4847;14503;803;2741;2892;8554;3695;11295
240895;201307;2730;9462;2513;9078;385;1504;1746;6374;2131;7878
240910;201307;2458;8212;2335;7980;263;1074;1774;6026;2037;7100
240920;201307;838;2766;781;2624;192;730;415;1356;607;2086
240930;201307;3509;9764;3225;9372;318;998;2542;7439;2860;8437
240933;201307;1333;4248;1225;4061;325;1152;596;2066;921;3218
240940;201307;6442;18654;5551;17121;1179;3886;3008;9256;4187;13142
240950;201307;1108;3589;1047;3484;104;438;764;2546;868;2984
240960;201307;761;2475;700;2350;110;410;490;1640;600;2050
240970;201307;1981;5766;1729;5300;162;633;1201;3646;1363;4279
240980;201307;3321;11051;3109;10642;753;2797;1808;6179;2561;8976
240990;201307;3016;9218;2846;8865;619;2159;1769;5370;2388;7529
241000;201307;1040;3029;928;2835;98;378;679;2026;777;2404
241010;201307;2893;9941;2625;9454;455;1859;1715;6085;2170;7944
241020;201307;2026;5878;1707;5272;180;677;1072;3150;1252;3827
241025;201307;1495;4684;1408;4528;146;607;982;3094;1128;3701
241030;201307;2495;8337;2316;8023;173;658;1888;6581;2061;7239
241040;201307;2061;7328;1910;7038;216;927;1428;5249;1644;6176
241050;201307;1266;3880;1160;3695;113;466;876;2691;989;3157
241060;201307;990;2882;908;2746;124;397;682;2070;806;2467
241070;201307;909;2691;787;2459;100;389;554;1669;654;2058
241080;201307;1160;3561;1052;3369;81;340;764;2390;845;2730
241090;201307;2040;6005;1814;5612;130;563;1487;4496;1617;5059
241100;201307;1156;3542;1059;3321;103;380;745;2297;848;2677
241105;201307;1100;3397;1043;3292;149;514;715;2305;864;2819
241110;201307;833;2723;713;2466;134;529;377;1278;511;1807
241120;201307;8006;24251;7330;23178;1436;4663;4925;15937;6361;20600
241140;201307;3192;9481;2917;8924;398;1375;1968;5890;2366;7265
241142;201307;691;2113;526;1760;171;669;150;446;321;1115
241150;201307;5552;17237;5196;16639;839;2874;3544;11398;4383;14272
241160;201307;1081;3206;1035;3122;167;556;706;2124;873;2680
241170;201307;1329;3974;1216;3765;163;577;766;2458;929;3035
241180;201307;1017;2783;822;2445;108;378;493;1405;601;1783
241190;201307;1023;2890;938;2748;90;349;647;1786;737;2135
241200;201307;19715;61197;18488;59176;4947;17114;9668;31393;14615;48507
241210;201307;1445;4424;1260;4054;257;920;695;2221;952;3141
241220;201307;7885;27125;7555;26476;1817;6831;4228;15133;6045;21964
241230;201307;2939;9370;2716;9031;254;1006;2159;7155;2413;8161
241240;201307;1120;3262;861;2723;92;299;524;1678;616;1977
241250;201307;5447;17788;4910;16726;401;1807;3985;13317;4386;15124
241255;201307;1861;7204;1786;7040;434;1785;922;3784;1356;5569
241260;201307;4475;12838;3735;11612;425;1530;2560;7863;2985;9393
241270;201307;1992;6144;1800;5781;293;1089;1090;3546;1383;4635
241280;201307;2107;6231;1972;5960;393;1238;1217;3745;1610;4983
241290;201307;3206;9054;2630;8143;491;1658;1554;4776;2045;6434
241300;201307;1286;3899;1223;3800;92;334;974;3024;1066;3358
241310;201307;1466;4823;1423;4746;208;697;1043;3574;1251;4271
241320;201307;834;2834;799;2764;163;615;461;1614;624;2229
241330;201307;1487;4805;1409;4697;157;632;1134;3730;1291;4362
241335;201307;2438;7837;2376;7723;198;642;2016;6590;2214;7232
241340;201307;1904;6051;1742;5715;468;1699;869;2782;1337;4481
241350;201307;1899;6175;1796;5963;187;781;1362;4399;1549;5180
241355;201307;1219;3459;1107;3258;71;231;943;2742;1014;2973
241360;201307;2065;5839;1877;5472;160;603;1374;3829;1534;4432
241370;201307;1316;4160;1093;3693;202;800;652;2136;854;2936
241380;201307;705;2101;616;1920;92;358;337;1020;429;1378
241390;201307;2799;9657;2667;9392;720;2582;1504;5489;2224;8071
241400;201307;3646;11180;3478;10935;487;1734;2552;8047;3039;9781
241410;201307;2588;7884;2402;7612;444;1559;1631;5108;2075;6667
241415;201307;1537;4926;1427;4695;157;599;1014;3298;1171;3897
241420;201307;2021;7285;1846;7019;572;2399;889;3376;1461;5775
241430;201307;419;1299;401;1249;53;181;274;820;327;1001
241440;201307;6466;23419;6120;22799;1122;4372;4206;15875;5328;20247
241445;201307;1012;3227;964;3157;176;488;703;2460;879;2948
241450;201307;3170;9172;2972;8880;488;1665;2106;6197;2594;7862
241460;201307;3428;10210;3065;9494;292;1101;2217;6739;2509;7840
241470;201307;1321;3853;1169;3664;121;484;896;2734;1017;3218
241475;201307;1206;3989;1099;3802;87;415;819;2771;906;3186
241480;201307;3166;10455;2917;10071;956;3411;1151;4326;2107;7737
241490;201307;622;1718;511;1543;56;235;352;994;408;1229
241500;201307;747;2394;733;2373;18;65;688;2229;706;2294
250010;201307;2598;8493;2329;8045;263;1115;1656;5584;1919;6699
250020;201307;1651;4881;1304;4234;128;551;913;2879;1041;3430
250030;201307;7532;22323;6825;21318;869;2925;5057;16095;5926;19020
250040;201307;4369;15136;4076;14571;776;2975;2629;9462;3405;12437
250050;201307;3517;11481;3263;11120;563;2122;2184;7494;2747;9616
250053;201307;1228;3856;1182;3795;178;645;828;2650;1006;3295
250057;201307;768;2524;747;2496;74;252;605;2073;679;2325
250060;201307;4633;15279;4507;15069;623;2447;3417;11169;4040;13616
250070;201307;4148;13083;3917;12670;472;1934;3017;9426;3489;11360
250073;201307;767;2350;701;2228;83;309;491;1561;574;1870
250077;201307;2211;6594;1860;6005;282;998;1074;3487;1356;4485
250080;201307;4627;13778;4469;13546;622;2002;3266;9910;3888;11912
250090;201307;2550;7862;2482;7758;149;606;2103;6416;2252;7022
250100;201307;3881;13395;3722;13107;440;1754;2862;10039;3302;11793
250110;201307;5615;17579;5376;17236;895;3174;3913;12486;4808;15660
250115;201307;554;1845;486;1683;60;273;299;972;359;1245
250120;201307;2179;6550;1891;6004;205;777;1347;4205;1552;4982
250130;201307;5435;17211;5129;16765;362;1319;4269;14068;4631;15387
250135;201307;1054;3286;966;3128;120;397;683;2269;803;2666
250140;201307;1984;6649;1835;6454;257;883;1376;4990;1633;5873
250150;201307;4985;17171;4666;16579;552;2234;3512;12456;4064;14690
250153;201307;1572;4171;1420;3947;133;457;1125;3096;1258;3553
250157;201307;1586;5639;1449;5334;364;1352;791;3018;1155;4370
250160;201307;3239;10369;3111;10171;221;823;2666;8706;2887;9529
250170;201307;1583;4711;1491;4558;325;1053;923;2855;1248;3908
250180;201307;15887;51211;15514;50486;2932;10804;10274;32628;13206;43432
250190;201307;4237;12674;3975;12225;735;2487;2464;7499;3199;9986
250200;201307;2187;6109;1779;5594;139;504;1506;4694;1645;5198
250205;201307;1002;3368;878;3148;93;435;612;2175;705;2610
250210;201307;1615;5389;1497;5217;199;859;1069;3627;1268;4486
250215;201307;1388;4849;1349;4773;212;857;857;3022;1069;3879
250220;201307;810;2310;688;2164;48;167;602;1879;650;2046
250230;201307;1672;4346;1374;3857;164;571;1055;2851;1219;3422
250240;201307;2587;8547;2314;8142;262;986;1745;6231;2007;7217
250250;201307;4271;13443;3968;13012;486;1679;3056;10144;3542;11823
250260;201307;1894;5939;1686;5593;137;514;1289;4285;1426;4799
250270;201307;1214;3991;1143;3903;161;588;856;2940;1017;3528
250280;201307;3716;11359;3453;10944;737;2414;2153;7091;2890;9505
250290;201307;2125;5690;1763;5212;60;227;1546;4558;1606;4785
250300;201307;5370;16041;5079;15664;642;2540;3950;11723;4592;14263
250310;201307;1134;3726;1040;3571;164;667;747;2532;911;3199
250320;201307;7535;24342;7179;23551;1315;4841;4528;14444;5843;19285
250330;201307;2458;7921;2155;7488;273;1089;1621;5563;1894;6652
250340;201307;1121;3337;1084;3290;73;259;888;2719;961;2978
250350;201307;4501;12501;4144;12050;201;702;3603;10566;3804;11268
250355;201307;2110;6536;1935;6262;139;585;1535;4926;1674;5511
250360;201307;2014;6056;1875;5850;123;469;1465;4576;1588;5045
250370;201307;13476;38432;11895;36506;796;2497;10371;32129;11167;34626
250375;201307;1074;3443;1027;3363;75;314;850;2764;925;3078
250380;201307;1612;4645;1540;4557;108;389;1330;3902;1438;4291
250390;201307;1950;5302;1622;4744;218;707;1093;3188;1311;3895
250400;201307;59379;176116;55944;170996;14864;47211;30844;96904;45708;144115
250403;201307;1399;4942;1368;4893;172;727;1076;3795;1248;4522
250407;201307;1055;3197;950;3010;97;312;737;2325;834;2637
250410;201307;653;2144;575;2005;72;311;427;1467;499;1778
250415;201307;1783;5768;1663;5523;102;440;1272;4141;1374;4581
250420;201307;1294;4118;1209;3976;99;404;1008;3243;1107;3647
250430;201307;6477;18390;6147;17910;503;1821;5082;14477;5585;16298
250435;201307;1602;4946;1441;4629;191;716;878;2887;1069;3603
250440;201307;4384;13491;4243;13285;296;1078;3603;11272;3899;12350
250450;201307;2046;5878;1836;5598;85;324;1640;4970;1725;5294
250460;201307;5898;18504;5533;17983;875;3031;3959;13035;4834;16066
250470;201307;1567;4373;1426;4170;135;477;1064;3060;1199;3537
250480;201307;3815;11694;3452;11155;180;732;2988;9576;3168;10308
250485;201307;590;1613;495;1441;27;115;390;1081;417;1196
250490;201307;4057;13478;3954;13312;600;2246;2933;9854;3533;12100
250500;201307;1886;5861;1749;5631;381;1289;1038;3384;1419;4673
250510;201307;4915;14036;4349;13250;344;1283;3562;10739;3906;12022
250520;201307;1840;5834;1751;5681;366;1408;1052;3304;1418;4712
250523;201307;1771;5731;1691;5626;216;778;1316;4429;1532;5207
250527;201307;1417;4447;1327;4319;67;304;1174;3760;1241;4064
250530;201307;671;2097;596;1999;55;215;482;1613;537;1828
250535;201307;1227;4071;1189;3990;102;420;950;3129;1052;3549
250540;201307;2432;7252;2284;7083;99;350;2080;6455;2179;6805
250550;201307;905;3049;836;2938;79;345;627;2157;706;2502
250560;201307;1703;5637;1668;5583;145;541;1398;4692;1543;5233
250570;201307;2497;8351;2282;7938;212;870;1726;5921;1938;6791
250580;201307;1083;3156;905;2855;138;543;592;1794;730;2337
250590;201307;1034;3215;932;3077;80;348;738;2382;818;2730
250600;201307;7483;22906;7103;22302;1183;3737;5018;16170;6201;19907
250610;201307;3237;10092;3068;9834;410;1408;2237;7222;2647;8630
250620;201307;861;2553;796;2424;136;450;532;1616;668;2066
250625;201307;2023;6875;1988;6824;83;270;1822;6315;1905;6585
250630;201307;9985;32955;9510;32076;2245;8221;5320;17872;7565;26093
250640;201307;3850;11405;3604;11112;264;1030;3109;9445;3373;10475
250650;201307;886;2691;838;2594;170;623;440;1405;610;2028
250660;201307;2185;5267;1679;4655;25;70;1604;4455;1629;4525
250670;201307;2582;9066;2470;8854;293;1234;1780;6380;2073;7614
250680;201307;4824;14195;4565;13814;313;1152;3842;11541;4155;12693
250690;201307;6070;17146;5884;16884;649;2163;4847;13660;5496;15823
250700;201307;5236;16194;4959;15761;695;2504;3594;11274;4289;13778
250710;201307;4450;14566;4121;14141;624;2269;2940;10287;3564;12556
250720;201307;2570;8205;2454;7997;229;895;1927;6242;2156;7137
250730;201307;3532;11427;3392;11199;485;1800;2519;8292;3004;10092
250740;201307;2016;6136;1779;5706;267;956;1199;3795;1466;4751
250750;201307;99005;301137;94494;294036;19127;65578;61128;187848;80255;253426
250760;201307;2116;6597;1974;6356;271;1035;1359;4320;1630;5355
250770;201307;3716;13162;3543;12916;750;2883;2207;8165;2957;11048
250780;201307;1880;5755;1659;5338;175;706;1162;3642;1337;4348
250790;201307;2434;8069;2308;7881;616;2092;1419;4969;2035;7061
250800;201307;2654;7901;2355;7394;179;674;1765;5411;1944;6085
250810;201307;1331;4019;1166;3775;118;491;944;2980;1062;3471
250820;201307;1937;6227;1884;6143;113;428;1571;5191;1684;5619
250830;201307;5767;19461;5518;18975;765;3107;3725;12552;4490;15659
250840;201307;1036;3359;932;3141;127;485;590;1985;717;2470
250850;201307;2341;6994;2052;6509;240;944;1338;4376;1578;5320
250855;201307;1008;3057;952;2963;62;221;802;2475;864;2696
250860;201307;2836;9829;2655;9474;668;2617;1174;4227;1842;6844
250870;201307;1174;3448;1029;3208;86;338;746;2255;832;2593
250880;201307;1271;3884;1247;3848;120;409;1011;3091;1131;3500
250890;201307;8980;30057;8409;29275;1626;6482;5457;18829;7083;25311
250900;201307;3002;10209;2689;9606;327;1235;1897;6894;2224;8129
250905;201307;2096;6581;2010;6464;325;1113;1477;4767;1802;5880
250910;201307;5218;15606;4882;15086;614;2017;3602;11196;4216;13213
250915;201307;1704;5121;1568;4923;131;414;1313;4187;1444;4601
250920;201307;3491;10141;3299;9869;433;1349;2438;7451;2871;8800
250930;201307;1887;6270;1817;6150;378;1478;1206;3985;1584;5463
250933;201307;1122;3825;1086;3764;185;675;719;2550;904;3225
250937;201307;861;2729;778;2556;120;479;469;1533;589;2012
250939;201307;1695;5412;1547;5162;261;930;1011;3392;1272;4322
250940;201307;3897;11692;3619;11253;313;1123;2826;8762;3139;9885
250950;201307;1290;4154;1203;4044;84;292;1006;3432;1090;3724
250960;201307;1347;4278;1199;4083;77;304;1023;3503;1100;3807
250970;201307;8566;24185;7848;23260;1089;3305;5788;17404;6877;20709
250980;201307;2621;8136;2429;7805;304;1233;1670;5165;1974;6398
250990;201307;2042;7348;1936;7133;301;1275;1327;4824;1628;6099
251000;201307;2520;7296;2086;6679;136;524;1674;5337;1810;5861
251010;201307;2785;8204;2551;7883;230;830;2021;6253;2251;7083
251020;201307;1644;5263;1542;5140;169;627;1258;4219;1427;4846
251030;201307;1291;3707;1175;3512;132;471;759;2263;891;2734
251040;201307;1939;6280;1755;5988;195;921;1251;4078;1446;4999
251050;201307;1114;3368;977;3116;173;602;541;1796;714;2398
251060;201307;988;2548;818;2337;100;370;606;1644;706;2014
251065;201307;571;1740;502;1632;73;277;308;959;381;1236
251070;201307;581;1717;555;1676;49;204;433;1234;482;1438
251080;201307;21004;59309;19915;57550;5265;16201;11325;33021;16590;49222
251090;201307;3007;9637;2727;9124;329;1265;1937;6404;2266;7669
251100;201307;957;3214;847;3009;125;502;551;1908;676;2410
251110;201307;2080;6131;1912;5876;238;819;1363;4189;1601;5008
251120;201307;5865;20180;5710;19914;822;3391;4431;15124;5253;18515
251130;201307;3860;10175;3496;9758;67;248;3347;9282;3414;9530
251140;201307;4325;13598;4046;13154;281;1141;3180;10285;3461;11426
251150;201307;2829;9298;2618;9012;327;1318;1973;6844;2300;8162
251160;201307;1847;6172;1778;6080;106;421;1552;5308;1658;5729
251170;201307;1406;4450;1371;4411;112;419;1162;3705;1274;4124
251180;201307;2879;8773;2656;8492;642;2164;1570;5130;2212;7294
251190;201307;4158;12362;4039;12211;292;971;3525;10677;3817;11648
251200;201307;4202;12932;4007;12671;268;970;3452;10923;3720;11893
251203;201307;1305;4214;1187;3966;125;521;717;2485;842;3006
251207;201307;1220;3904;1060;3582;93;394;752;2495;845;2889
251210;201307;7660;22835;6958;21862;1050;3296;5071;16294;6121;19590
251220;201307;1271;3520;1147;3328;180;577;724;2146;904;2723
251230;201307;5107;15828;4520;15128;475;1791;3765;12532;4240;14323
251240;201307;3084;10303;3009;10177;329;1362;2357;7827;2686;9189
251250;201307;10056;31246;9480;30313;1744;6032;6461;20553;8205;26585
251260;201307;531;1670;481;1603;39;146;366;1224;405;1370
251270;201307;4075;12802;3852;12510;177;699;3504;11342;3681;12041
251272;201307;1352;4226;1265;4097;119;413;997;3281;1116;3694
251274;201307;954;3099;909;3010;133;555;506;1713;639;2268
251275;201307;1353;3918;1280;3801;148;551;962;2775;1110;3326
251276;201307;1457;4429;1381;4280;243;813;804;2584;1047;3397
251278;201307;578;1900;509;1736;91;351;276;990;367;1341
251280;201307;2256;7334;2185;7208;322;1188;1576;5201;1898;6389
251290;201307;5914;17347;5626;16972;861;3099;4039;11811;4900;14910
251300;201307;773;2673;723;2596;73;348;511;1778;584;2126
251310;201307;3139;9474;2892;9104;239;900;2329;7249;2568;8149
251315;201307;1611;5937;1575;5858;329;1306;985;3709;1314;5015
251320;201307;2098;6008;1773;5487;147;554;1292;4027;1439;4581
251330;201307;2019;5317;1686;4884;141;597;1381;3801;1522;4398
251335;201307;953;3370;927;3316;120;482;722;2562;842;3044
251340;201307;3874;10933;3319;10104;367;1432;2363;6992;2730;8424
251350;201307;1615;5057;1465;4838;268;976;941;3127;1209;4103
251360;201307;1818;6017;1758;5938;124;492;1494;5061;1618;5553
251365;201307;904;2684;731;2315;69;280;483;1483;552;1763
251370;201307;20977;73923;20655;73344;4386;17085;13900;48771;18286;65856
251380;201307;1294;4130;1171;3924;122;519;869;2821;991;3340
251385;201307;857;2443;789;2326;89;321;534;1527;623;1848
251390;201307;5661;20463;5395;20064;1055;4257;3628;13417;4683;17674
251392;201307;1026;3092;954;2968;128;430;654;2067;782;2497
251394;201307;613;1922;521;1738;47;189;368;1218;415;1407
251396;201307;863;2515;804;2414;68;233;639;1894;707;2127
251398;201307;1116;3283;931;2935;97;377;628;1946;725;2323
251400;201307;1351;3963;1253;3834;176;683;879;2612;1055;3295
251410;201307;1576;4237;1444;4019;182;573;967;2746;1149;3319
251420;201307;2183;6389;1881;6040;194;750;1405;4439;1599;5189
251430;201307;1675;6121;1527;5885;126;566;1251;4815;1377;5381
251440;201307;1448;4510;1264;4173;178;679;891;2903;1069;3582
251445;201307;1504;4859;1436;4755;137;544;1171;3827;1308;4371
251450;201307;4757;15106;4289;14510;166;672;3821;12953;3987;13625
251455;201307;1206;3789;1044;3522;97;411;767;2550;864;2961
251460;201307;872;2749;850;2703;158;522;622;2001;780;2523
251465;201307;501;1601;458;1515;54;216;298;962;352;1178
251470;201307;1257;3694;1049;3307;150;567;626;1969;776;2536
251480;201307;1118;3104;1018;2939;67;256;815;2305;882;2561
251490;201307;2072;6234;1817;5887;341;1268;1146;3647;1487;4915
251500;201307;1656;5752;1610;5679;230;932;1198;4173;1428;5105
251510;201307;2475;8524;2341;8230;490;1889;1387;4928;1877;6817
251520;201307;1075;3029;990;2895;139;419;606;1806;745;2225
251530;201307;11383;34840;10956;34203;1003;3879;9014;27604;10017;31483
251540;201307;2764;9344;2610;9002;306;1290;1887;6452;2193;7742
251550;201307;3946;10101;3379;9382;215;765;2819;7670;3034;8435
251560;201307;912;2763;832;2635;181;698;443;1289;624;1987
251570;201307;1027;3144;927;2967;124;462;594;1959;718;2421
251580;201307;2177;6085;2032;5892;226;654;1632;4769;1858;5423
251590;201307;1676;5618;1644;5581;113;410;1441;4937;1554;5347
251593;201307;983;3205;938;3129;136;515;627;2046;763;2561
251597;201307;1965;6152;1900;6053;237;884;1477;4627;1714;5511
251600;201307;7059;21643;6763;21157;1062;3411;4777;15382;5839;18793
251610;201307;3542;10860;3259;10482;392;1360;2428;7901;2820;9261
251615;201307;1195;3549;1056;3304;86;253;785;2590;871;2843
251620;201307;16790;49164;15105;46952;2456;8085;10685;33621;13141;41706
251630;201307;5307;13684;4673;12918;398;1203;3750;10437;4148;11640
251640;201307;2651;7861;2173;6997;280;1051;1463;4669;1743;5720
251650;201307;4309;12439;3895;11912;338;1197;3162;9766;3500;10963
251660;201307;3520;11966;3244;11534;277;1311;2615;9071;2892;10382
251670;201307;3801;11324;3432;10764;287;1017;2749;8570;3036;9587
251675;201307;740;2554;710;2501;131;540;459;1572;590;2112
251680;201307;2834;7979;2317;7203;147;621;1888;5746;2035;6367
251690;201307;3295;10689;3086;10309;463;1671;2069;6941;2532;8612
251700;201307;2058;6997;1969;6872;240;923;1534;5337;1774;6260
251710;201307;920;2473;705;2087;97;362;390;1072;487;1434
251720;201307;1335;4216;1261;4104;124;489;974;3148;1098;3637
251740;201307;733;2081;596;1831;117;392;328;1023;445;1415
260005;201307;24121;60513;21683;57351;4492;12221;13842;36966;18334;49187
260010;201307;9361;26041;7705;23994;742;2585;6130;19018;6872;21603
260020;201307;5675;17279;5101;16389;693;2113;3685;12425;4378;14538
260030;201307;5474;16705;5086;16165;606;2094;3886;12334;4492;14428
260040;201307;9715;24105;8390;22601;586;1395;7082;19619;7668;21014
260050;201307;10554;35006;9966;34335;677;2514;8712;30274;9389;32788
260060;201307;4026;11378;3773;10999;321;993;3078;9100;3399;10093
260070;201307;9073;28325;8734;27837;2328;7952;5130;16446;7458;24398
260080;201307;5202;15529;4677;14730;575;2116;3278;10197;3853;12313
260090;201307;5150;14096;4898;13756;818;2111;3668;10708;4486;12819
260100;201307;3431;9340;3163;8982;269;982;2512;7146;2781;8128
260105;201307;4192;13096;4074;12882;779;2636;2729;8600;3508;11236
260110;201307;20828;64020;19513;62423;1643;5235;16549;53621;18192;58856
260120;201307;11201;35439;10892;34886;3190;10498;5557;18501;8747;28999
260130;201307;3028;8848;2901;8635;394;1150;2134;6485;2528;7635
260140;201307;12283;33741;10868;31952;1345;4446;8148;24167;9493;28613
260150;201307;2867;8948;2605;8535;259;962;1982;6582;2241;7544
260160;201307;5895;18033;5393;17447;503;1735;4441;14655;4944;16390
260170;201307;16881;48090;16252;47237;1426;3950;13498;39920;14924;43870
260180;201307;3350;10678;3095;10278;209;854;2590;8540;2799;9394
260190;201307;15521;38249;14824;37352;1170;3183;12524;31520;13694;34703
260200;201307;10717;32672;9539;30893;1292;4297;6792;22673;8084;26970
260210;201307;11229;35679;10456;34553;841;3132;8617;28796;9458;31928
260220;201307;8908;28764;8724;28494;771;3162;7407;23749;8178;26911
260230;201307;9518;28767;9180;28307;716;2336;7626;23858;8342;26194
260240;201307;2782;9089;2521;8688;383;1427;1719;5944;2102;7371
260250;201307;2719;7440;2509;7180;188;516;2115;6148;2303;6664
260260;201307;11260;33704;11082;33477;944;3154;9282;28590;10226;31744
260270;201307;3457;10982;3278;10719;409;1627;2557;8196;2966;9823
260280;201307;12182;41922;11315;40533;848;3441;9359;33812;10207;37253
260290;201307;32945;101799;32011;100314;5911;21135;22010;67424;27921;88559
260300;201307;8327;25853;7522;24717;782;2909;5805;19228;6587;22137
260310;201307;5062;15573;4763;15099;1464;4386;2419;8253;3883;12639
260320;201307;6531;22781;6136;22206;580;2237;4904;17990;5484;20227
260330;201307;3071;9741;2818;9301;303;1166;1881;6458;2184;7624
260340;201307;1839;5590;1765;5490;110;419;1554;4790;1664;5209
260345;201307;25178;85083;24337;83406;7707;28698;11346;37731;19053;66429
260350;201307;4198;12746;4027;12480;615;2089;2778;8641;3393;10730
260360;201307;2281;7405;2219;7302;585;2038;1219;4158;1804;6196
260370;201307;5960;18802;5533;18046;833;2775;3886;12998;4719;15773
260380;201307;4803;16236;4508;15856;420;1348;3752;13527;4172;14875
260390;201307;4707;15066;4125;14154;504;1969;3006;10188;3510;12157
260392;201307;3184;10666;3037;10462;201;782;2636;9097;2837;9879
260400;201307;13230;40231;12822;39589;2564;8840;8692;26360;11256;35200
260410;201307;60705;182826;58092;178507;18924;58590;28537;90952;47461;149542
260415;201307;3965;13300;3561;12556;583;2387;2256;7950;2839;10337
260420;201307;11202;27036;10300;26073;887;2543;8416;21265;9303;23808
260430;201307;2667;9080;2462;8755;262;1086;1889;6632;2151;7718
260440;201307;3374;10624;3178;10250;553;2025;1964;6259;2517;8284
260450;201307;4785;15322;4555;14920;531;1902;3439;11335;3970;13237
260460;201307;5809;18279;5553;17906;880;3242;3876;12291;4756;15533
260470;201307;4894;14648;4621;14266;446;1527;3659;11478;4105;13005
260480;201307;3701;11102;3427;10693;679;2295;2292;7078;2971;9373
260490;201307;6020;16047;5327;14955;754;2487;3508;9865;4262;12352
260500;201307;6615;18622;6210;18049;653;2021;4748;14100;5401;16121
260510;201307;9906;27458;9194;26463;994;3115;6955;20650;7949;23765
260515;201307;4723;15136;3919;13492;571;2143;2316;8161;2887;10304
260520;201307;15131;42089;14825;41676;2530;6777;11004;31726;13534;38503
260530;201307;10117;30429;9001;28952;539;1643;7841;25708;8380;27351
260540;201307;5627;14863;5391;14598;678;1602;4271;11943;4949;13545
260545;201307;40;156;28;115;4;19;6;23;10;42
260550;201307;2728;9427;2480;8990;716;2883;1175;4218;1891;7101
260560;201307;6654;17491;6065;16661;367;991;5310;14656;5677;15647
260570;201307;5871;21626;5582;21094;1082;4446;3734;14235;4816;18681
260580;201307;3877;10878;3705;10623;332;1095;3081;8671;3413;9766
260590;201307;5956;15864;5765;15629;452;1169;4954;13720;5406;14889
260600;201307;24446;78836;23364;76937;5214;18001;13938;46845;19152;64846
260610;201307;6986;21082;6687;20675;1311;4250;4658;14513;5969;18763
260620;201307;16867;53673;16330;52776;3041;11191;11031;34748;14072;45939
260630;201307;2262;6961;1986;6524;253;1005;1454;4725;1707;5730
260640;201307;16938;47496;16238;46480;2083;6389;12365;35399;14448;41788
260650;201307;5589;18025;5381;17687;837;2772;3546;12475;4383;15247
260660;201307;7878;23280;7159;22314;759;2444;5675;17985;6434;20429
260670;201307;2372;6915;2034;6450;312;1095;1345;4312;1657;5407
260680;201307;22771;62511;21685;60776;4834;14475;12953;36026;17787;50501
260690;201307;3438;9744;3016;9072;257;941;2358;7003;2615;7944
260700;201307;5124;15876;5069;15817;104;244;4869;15391;4973;15635
260710;201307;1290;4064;1169;3883;151;602;863;2800;1014;3402
260720;201307;17236;57297;16417;55767;4734;16566;8726;30333;13460;46899
260730;201307;7292;24435;6599;23420;910;3368;4896;17634;5806;21002
260740;201307;1351;4165;1186;3864;191;683;716;2370;907;3053
260750;201307;6540;22036;6384;21793;571;1939;5332;18533;5903;20472
260760;201307;4560;13072;4296;12714;566;1790;3152;9383;3718;11173
260765;201307;7631;28457;7402;28098;1648;6783;4666;17935;6314;24718
260770;201307;4222;11194;3876;10727;248;900;3118;8438;3366;9338
260775;201307;5259;15634;5040;15291;574;2073;3779;11219;4353;13292
260780;201307;3889;13214;3766;13006;859;3237;2263;7803;3122;11040
260790;201307;116208;306238;112311;300639;26809;75542;68402;183561;95211;259103
260795;201307;2971;9861;2825;9636;472;1730;1928;6705;2400;8435
260800;201307;4531;12752;4252;12368;262;1042;3622;10263;3884;11305
260805;201307;4007;12061;3676;11538;595;1947;2490;7902;3085;9849
260810;201307;7342;21571;7149;21301;497;1817;6207;18273;6704;20090
260820;201307;4520;13613;4330;13341;1266;3981;2412;7565;3678;11546
260825;201307;2998;9846;2853;9630;276;923;2358;8079;2634;9002
260830;201307;3575;11942;3362;11574;897;2951;1942;7046;2839;9997
260840;201307;4085;12277;3851;11931;239;910;3370;10381;3609;11291
260845;201307;4105;12462;3827;11902;656;2188;2596;8090;3252;10278
260850;201307;4799;17064;4428;16264;1182;4838;2161;7847;3343;12685
260860;201307;2931;9917;2747;9623;355;1256;2024;7249;2379;8505
260870;201307;4135;11712;3783;11264;587;1620;2726;8382;3313;10002
260875;201307;7241;19508;6664;18628;858;2394;4674;13510;5532;15904
260880;201307;8398;27501;8027;26950;1107;3736;6123;20897;7230;24633
260890;201307;14637;42543;14081;41731;1651;5601;10602;31355;12253;36956
260900;201307;5959;18832;5218;17608;1083;3797;3118;10779;4201;14576
260910;201307;2912;9253;2664;8903;308;1191;2072;6864;2380;8055
260915;201307;4407;14929;4305;14786;111;335;4014;14027;4125;14362
260920;201307;3277;10490;3140;10282;575;2063;2133;7102;2708;9165
260930;201307;4063;13247;3670;12680;549;1945;2624;9203;3173;11148
260940;201307;13447;39790;12433;37980;2558;9224;6884;20435;9442;29659
260950;201307;6140;20305;5929;19901;1054;4412;3902;12278;4956;16690
260960;201307;66102;187834;62922;182831;13732;42628;37461;109709;51193;152337
260970;201307;5255;17467;4925;16933;660;2671;3547;12065;4207;14736
260980;201307;3915;12666;3763;12459;268;993;3144;10588;3412;11581
260990;201307;16678;55187;15459;53470;2072;6753;11433;41645;13505;48398
261000;201307;13795;42040;12260;39456;2930;10192;6783;22039;9713;32231
261010;201307;2762;7852;2589;7616;260;597;2136;6618;2396;7215
261020;201307;6037;18693;5697;18155;420;1734;4693;14563;5113;16297
261030;201307;3307;11223;3202;11049;346;1320;2550;8737;2896;10057
261040;201307;5199;17354;4537;16309;657;2656;3185;11419;3842;14075
261050;201307;8671;24693;8154;23897;1259;3846;5479;15993;6738;19839
261060;201307;10809;34648;10504;34159;2155;7593;7020;22592;9175;30185
261070;201307;46794;125177;43093;120081;10439;30640;24562;69352;35001;99992
261080;201307;5538;17493;5286;17080;445;1404;4394;14472;4839;15876
261090;201307;15719;45257;14845;44072;1540;4800;12002;35868;13542;40668
261100;201307;7162;23540;6756;22939;562;2304;5509;18622;6071;20926
261110;201307;64741;188661;59854;181810;14346;44346;34922;111959;49268;156305
261120;201307;3401;9571;3202;9307;158;488;2835;8298;2993;8786
261130;201307;6781;17992;6534;17721;289;803;5956;16155;6245;16958
261140;201307;3170;9165;2983;8883;653;2134;1829;5415;2482;7549
261150;201307;5370;16752;4893;16100;529;2007;3791;12513;4320;14520
261153;201307;1931;5652;1662;5283;110;422;1409;4510;1519;4932
261160;201307;221297;587184;212825;575982;42711;117887;138198;384318;180909;502205
261170;201307;5833;16709;5487;16191;776;2408;4189;12383;4965;14791
261180;201307;8987;26324;8829;26116;1189;3488;6916;20835;8105;24323
261190;201307;5273;17086;5058;16789;821;3613;3523;11014;4344;14627
261200;201307;3764;9971;3620;9783;492;1289;2737;7576;3229;8865
261210;201307;1852;5168;1777;5063;158;439;1498;4345;1656;4784
261220;201307;12128;40916;10909;38227;2263;8622;5959;20772;8222;29394
261230;201307;4263;13017;3979;12682;193;623;3563;11481;3756;12104
261240;201307;4776;14423;4538;13980;823;2488;3129;9837;3952;12325
261245;201307;3789;12390;3325;11610;316;1324;2449;8673;2765;9997
261247;201307;3418;11004;3048;10308;473;1668;2043;7013;2516;8681
261250;201307;18682;51191;18222;50564;2495;7188;14657;40692;17152;47880
261255;201307;4236;13472;3835;12817;394;1490;2897;9834;3291;11324
261260;201307;11740;35047;10915;34085;626;1852;9693;30702;10319;32554
261270;201307;3749;10960;3526;10604;502;1630;2478;7460;2980;9090
261280;201307;2682;8520;2439;8152;274;1066;1812;6012;2086;7078
261290;201307;2882;8492;2597;8118;234;838;2107;6644;2341;7482
261300;201307;9969;34892;9176;33464;1556;6211;6260;22972;7816;29183
261310;201307;8245;25604;7913;25029;1839;6140;4794;15183;6633;21323
261320;201307;5790;18401;5503;17859;742;2377;3994;13303;4736;15680
261330;201307;5493;16661;5377;16510;406;1393;4539;13981;4945;15374
261340;201307;4519;14996;4322;14680;737;2856;2838;9665;3575;12521
261350;201307;7776;27041;7415;26397;707;3055;5816;20486;6523;23541
261360;201307;9266;24492;8568;23539;1275;3706;5915;16551;7190;20257
261370;201307;20233;61897;19339;60606;2981;10097;14129;44448;17110;54545
261380;201307;4091;14380;3845;13981;642;2364;2639;9896;3281;12260
261390;201307;16594;52651;15360;50483;2809;10242;9592;31257;12401;41499
261400;201307;4777;17077;4394;16337;661;2742;2989;11190;3650;13932
261410;201307;7906;24523;7636;24090;869;2828;5892;19006;6761;21834
261420;201307;7626;26229;7405;25896;1925;7379;4284;15201;6209;22580
261430;201307;3515;11087;3011;10420;425;1529;2177;7706;2602;9235
261440;201307;1624;5000;1532;4856;129;520;1235;3862;1364;4382
261450;201307;13839;41341;13471;40831;1152;3708;11624;35258;12776;38966
261460;201307;8349;24388;7836;23670;823;2387;5794;18849;6617;21236
261470;201307;3891;10660;3578;10277;274;910;3017;8609;3291;9519
261480;201307;3275;12393;3105;12087;385;1731;2384;9105;2769;10836
261485;201307;4793;15352;4573;14977;1083;3799;2620;8670;3703;12469
261500;201307;5718;16267;5194;15560;771;2130;3896;12208;4667;14338
261510;201307;2027;6832;1952;6726;121;353;1697;5998;1818;6351
261520;201307;2513;8396;2289;8051;229;933;1679;5897;1908;6830
261530;201307;12352;40740;11094;38293;2554;9790;5488;18870;8042;28660
261540;201307;7098;23041;6924;22757;2034;6320;4231;14618;6265;20938
261550;201307;3284;10432;3183;10273;515;2083;2362;7268;2877;9351
261560;201307;6426;21458;6009;20939;1300;4223;4172;15244;5472;19467
261570;201307;3551;11398;3293;10979;483;1673;2337;7944;2820;9617
261580;201307;5629;18641;5071;17716;453;1771;4039;14373;4492;16144
261590;201307;2754;7916;2438;7470;254;840;1794;5589;2048;6429
261600;201307;4968;14326;4291;13325;556;1823;3107;9777;3663;11600
261610;201307;2195;6912;1979;6608;183;744;1607;5251;1790;5995
261618;201307;2460;7257;2342;7091;290;946;1794;5395;2084;6341
261620;201307;4469;14014;4264;13693;494;1719;3105;10155;3599;11874
261630;201307;8014;24004;7218;22639;1502;5393;4093;12545;5595;17938
261640;201307;32357;85564;30354;83243;1935;5537;26145;72797;28080;78334
261650;201307;3659;12334;3538;12153;469;1811;2763;9501;3232;11312
270010;201307;4420;17171;4086;16465;530;2505;2879;11568;3409;14073
270020;201307;3819;11998;3600;11630;547;2052;2586;8200;3133;10252
270030;201307;44024;134311;42399;131901;11769;37451;24194;77316;35963;114767
270040;201307;10326;32232;10023;31904;1178;3219;8303;27320;9481;30539
270050;201307;3784;11317;3557;11017;419;1614;2684;8124;3103;9738
270060;201307;1503;5278;1447;5194;383;1514;840;2998;1223;4512
270070;201307;4033;12791;3812;12472;141;641;3401;11037;3542;11678
270080;201307;1259;4097;1148;3946;266;1029;679;2309;945;3338
270090;201307;2014;6495;1968;6438;62;231;1847;6042;1909;6273
270100;201307;6293;20179;6055;19860;1244;4426;4160;13572;5404;17998
270110;201307;3381;9702;3132;9404;624;1948;1952;6277;2576;8225
270120;201307;3023;8953;2736;8562;166;619;2311;7250;2477;7869
270130;201307;4912;15571;4688;15308;724;2358;3500;11753;4224;14111
270135;201307;1685;4988;1608;4896;74;183;1471;4566;1545;4749
270140;201307;8933;24289;8125;23236;998;4015;6283;16865;7281;20880
270150;201307;2544;9029;2481;8940;269;1118;2041;7283;2310;8401
270160;201307;4708;16650;4392;16217;332;1136;3771;14168;4103;15304
270170;201307;3965;13389;3667;12928;809;3272;2102;7353;2911;10625
270180;201307;2121;7364;1912;7098;202;877;1482;5498;1684;6375
270190;201307;1849;6273;1768;6132;185;697;1352;4754;1537;5451
270200;201307;2685;9134;2545;8913;245;1109;2053;7008;2298;8117
270210;201307;4059;14194;3965;14059;502;2057;3179;11217;3681;13274
270220;201307;1675;5363;1588;5189;312;1192;877;2917;1189;4109
270230;201307;10873;36680;9743;34943;1478;6105;6925;24677;8403;30782
270235;201307;6377;21534;6097;21073;366;1660;5226;17942;5592;19602
270240;201307;9599;29345;8678;28089;1620;5537;5738;18684;7358;24221
270250;201307;3359;8989;3123;8731;158;460;2839;7940;2997;8400
270255;201307;5035;15816;4243;14440;464;1989;3008;10081;3472;12070
270260;201307;6106;20041;5947;19755;934;3617;4221;14025;5155;17642
270270;201307;1224;3630;1152;3517;195;650;826;2497;1021;3147
270280;201307;3625;11149;3464;10912;565;2060;2494;7783;3059;9843
270290;201307;8254;29708;7924;29129;793;3225;6336;23371;7129;26596
270300;201307;3235;11273;3096;11103;194;876;2744;9779;2938;10655
270310;201307;6988;22378;6369;21312;458;2077;5101;16643;5559;18720
270320;201307;6143;20680;5951;20326;1716;6513;2853;9927;4569;16440
270330;201307;4644;15768;4431;15478;398;1483;3675;12976;4073;14459
270340;201307;1748;5571;1609;5401;229;807;1191;4079;1420;4886
270350;201307;2066;5961;1927;5777;355;1109;1211;3868;1566;4977
270360;201307;2039;6453;2007;6414;203;639;1692;5527;1895;6166
270370;201307;1690;5675;1555;5430;199;793;1077;3853;1276;4646
270375;201307;2875;9211;2748;9009;512;2054;1844;5758;2356;7812
270380;201307;6087;18600;5853;18285;621;2037;4555;14541;5176;16578
270390;201307;1386;3952;1289;3832;204;727;866;2446;1070;3173
270400;201307;6038;18946;5617;18336;547;2134;4250;13729;4797;15863
270410;201307;4790;15160;4611;14821;603;2165;3453;11061;4056;13226
270420;201307;5177;17469;5045;17276;304;1432;4338;14606;4642;16038
270430;201307;138714;408554;133947;401935;35185;108123;78715;242274;113900;350397
270440;201307;4868;15441;4618;15047;403;1509;3732;12202;4135;13711
270450;201307;6244;20178;6113;20008;703;2662;4828;15785;5531;18447
270460;201307;3428;9809;3121;9371;266;1065;2499;7270;2765;8335
270470;201307;10546;34835;10159;34137;1332;4262;7617;26637;8949;30899
270480;201307;3068;9987;2890;9683;377;1562;2004;6502;2381;8064
270490;201307;978;3165;925;3085;101;413;686;2233;787;2646
270500;201307;5400;19060;5236;18820;480;1722;4327;15970;4807;17692
270510;201307;5903;18797;5451;18162;997;4226;3865;12214;4862;16440
270520;201307;3575;12050;3396;11736;951;3495;1812;6369;2763;9864
270530;201307;1527;4599;1357;4375;235;731;904;3055;1139;3786
270540;201307;1954;7031;1809;6800;195;942;1412;5193;1607;6135
270550;201307;6893;21647;6185;20670;1138;3974;4052;13955;5190;17929
270560;201307;2885;9497;2803;9384;567;2180;1891;6182;2458;8362
270570;201307;4211;13938;3897;13433;507;2110;2649;9045;3156;11155
270580;201307;1945;6725;1878;6609;334;1231;1338;4777;1672;6008
270590;201307;1267;4583;1196;4453;113;535;967;3561;1080;4096
270600;201307;2805;9582;2577;9246;230;1134;2008;6986;2238;8120
270610;201307;3158;10212;2980;9943;364;1303;2293;7628;2657;8931
270620;201307;1423;4924;1291;4727;163;771;969;3449;1132;4220
270630;201307;17824;50620;17121;49645;2298;6531;13296;39219;15594;45750
270640;201307;5738;18094;5276;17559;459;1949;4351;14191;4810;16140
270642;201307;2460;8511;2316;8289;402;1625;1526;5470;1928;7095
270644;201307;2259;7018;2136;6880;388;1160;1615;5388;2003;6548
270650;201307;3830;12736;3714;12567;929;3622;2159;7202;3088;10824
270660;201307;2496;6657;2038;5947;207;724;1417;4065;1624;4789
270670;201307;13747;40664;12501;39026;1644;5794;9343;29247;10987;35041
270680;201307;4071;12709;3966;12583;254;748;3540;11370;3794;12118
270690;201307;8327;24562;7948;24094;2439;7052;4288;14116;6727;21168
270700;201307;793;2563;756;2503;134;542;479;1544;613;2086
270710;201307;5309;18492;5132;18257;528;1873;4235;15331;4763;17204
270720;201307;3236;11372;3032;11019;301;1378;2404;8605;2705;9983
270730;201307;6399;20545;6097;20145;1246;4388;4141;13685;5387;18073
270740;201307;2365;7151;2228;6931;379;1345;1470;4523;1849;5868
270750;201307;4773;15706;4492;15282;582;2206;3334;11312;3916;13518
270760;201307;3255;10200;3070;9932;403;1395;2290;7436;2693;8831
270770;201307;17083;47267;14859;44556;2833;9184;9662;29370;12495;38554
270780;201307;1886;6118;1761;5919;199;714;1342;4557;1541;5271
270790;201307;1594;5138;1468;4929;406;1480;706;2392;1112;3872
270800;201307;10865;33662;10321;32943;1009;3624;8361;26638;9370;30262
270810;201307;3280;10411;2771;9464;420;1648;1725;5904;2145;7552
270820;201307;1875;6513;1740;6273;264;1118;1214;4322;1478;5440
270830;201307;4972;16567;4640;16119;1448;5705;2467;8439;3915;14144
270840;201307;7158;25537;6624;24838;518;2440;5485;20397;6003;22837
270850;201307;7409;25004;7278;24840;1564;6529;5019;16272;6583;22801
270860;201307;10998;34452;10431;33618;1832;6873;7316;23017;9148;29890
270870;201307;2207;6523;1842;5807;270;938;1148;3623;1418;4561
270880;201307;7952;26248;7598;25728;645;2616;6323;21211;6968;23827
270890;201307;2543;8022;2392;7785;408;1577;1634;5171;2042;6748
270895;201307;2963;11194;2828;11015;277;1047;2360;9400;2637;10447
270900;201307;1881;5294;1569;4843;119;464;1205;3612;1324;4076
270910;201307;3209;11582;3169;11505;344;1535;2622;9299;2966;10834
270915;201307;9677;33806;8963;32495;2065;8368;4854;17589;6919;25957
270920;201307;5901;19734;5553;19214;418;1870;4671;16005;5089;17875
270930;201307;16627;46381;13984;43010;3061;10078;7972;25042;11033;35120
270940;201307;5695;19721;5542;19534;924;3434;4045;14399;4969;17833
280010;201307;704;2105;628;1986;70;282;409;1266;479;1548
280020;201307;4754;14882;4339;14136;880;3073;2702;8799;3582;11872
280030;201307;68395;187291;62399;178444;15862;47964;33517;97247;49379;145211
280040;201307;3086;10016;2828;9674;370;1301;2116;7459;2486;8760
280050;201307;4046;13248;3799;12892;1097;3759;2137;7573;3234;11332
280060;201307;4122;14219;3996;14004;980;3778;2357;8262;3337;12040
280067;201307;7315;21446;6289;20027;656;2361;4813;15278;5469;17639
280070;201307;1786;6406;1720;6308;338;1317;1131;4196;1469;5513
280100;201307;3929;12756;3598;12159;888;3088;1953;6766;2841;9854
280110;201307;1323;4200;1229;4043;115;481;956;3097;1071;3578
280120;201307;7442;24511;6995;23774;1466;4711;4609;16636;6075;21347
280130;201307;7637;22593;7249;22040;1233;4362;4938;14726;6171;19088
280140;201307;5340;15319;4900;14752;435;1315;4052;12354;4487;13669
280150;201307;3238;10398;2993;9912;490;1965;1877;5934;2367;7899
280160;201307;1519;4411;1388;4198;181;616;994;3007;1175;3623
280170;201307;4363;13903;4027;13486;538;1852;3058;10530;3596;12382
280190;201307;1076;3222;983;3071;119;469;685;2060;804;2529
280200;201307;1029;3324;979;3254;161;674;706;2255;867;2929
280210;201307;11519;38781;11108;38118;2488;9054;6999;24379;9487;33433
280220;201307;1496;4691;1448;4628;97;369;1272;4041;1369;4410
280230;201307;3802;11326;3447;10738;746;2475;2014;6436;2760;8911
280240;201307;3349;10370;3118;10013;265;827;2497;8162;2762;8989
280250;201307;727;1996;680;1926;76;222;512;1416;588;1638
280260;201307;1907;5346;1753;5147;129;392;1492;4386;1621;4778
280270;201307;2149;6905;1894;6458;140;573;1492;5008;1632;5581
280280;201307;3958;13455;3742;13085;802;2499;2239;8604;3041;11103
280290;201307;15571;52392;14701;50891;2719;10198;10221;35461;12940;45659
280300;201307;9615;30032;9066;29405;712;2525;7826;25409;8538;27934
280310;201307;1396;4044;1260;3835;118;458;922;2725;1040;3183
280320;201307;7140;25253;6814;24643;1258;5162;4296;15498;5554;20660
280330;201307;4352;12910;4130;12626;558;1876;3156;9678;3714;11554
280340;201307;3572;11367;3468;11218;310;1086;2830;9355;3140;10441
280350;201307;20449;63164;19541;61723;3195;10444;13662;44147;16857;54591
280360;201307;5707;18510;5409;18047;1205;4565;3306;10866;4511;15431
280370;201307;1865;5501;1734;5283;214;781;1264;3731;1478;4512
280380;201307;886;2949;834;2867;137;557;608;2018;745;2575
280390;201307;3154;9585;2867;9081;728;2140;1724;5658;2452;7798
280400;201307;4306;12610;3973;12168;816;2407;2596;8307;3412;10714
280410;201307;2273;7677;2108;7399;365;1478;1286;4411;1651;5889
280420;201307;3901;11803;3685;11491;266;888;3165;9950;3431;10838
280430;201307;1946;5701;1850;5578;251;862;1368;4144;1619;5006
280440;201307;4840;14943;4597;14620;419;1486;3874;12299;4293;13785
280445;201307;2422;7107;2270;6845;126;499;1886;5582;2012;6081
280450;201307;8509;24166;7954;23526;791;2025;6665;20386;7456;22411
280460;201307;6556;18764;5960;17962;1324;4185;3805;11683;5129;15868
280470;201307;1713;5382;1579;5176;178;656;1192;3877;1370;4533
280480;201307;29682;92534;28792;91244;4936;18426;19735;60867;24671;79293
280490;201307;3641;11467;3420;11058;408;1523;2607;8396;3015;9919
280500;201307;855;2350;815;2302;38;133;709;1975;747;2108
280510;201307;2638;7976;2285;7487;306;1160;1695;5560;2001;6720
280520;201307;1633;4885;1511;4724;184;583;1126;3634;1310;4217
280530;201307;1958;6365;1864;6238;236;885;1448;4892;1684;5777
280540;201307;8566;24563;8160;24008;368;1317;7305;21361;7673;22678
280550;201307;6773;19312;6263;18498;551;2007;4795;14038;5346;16045
280560;201307;7621;23177;7265;22574;547;1910;5946;18443;6493;20353
280570;201307;6458;18713;6017;18146;916;3252;4263;12632;5179;15884
280580;201307;5557;17222;4878;16120;724;2529;3417;11465;4141;13994
280590;201307;2312;7199;2148;7007;268;1069;1616;5251;1884;6320
280600;201307;3924;12330;3690;11905;405;1620;2662;8379;3067;9999
280610;201307;2266;6791;2165;6638;380;1266;1358;4189;1738;5455
280620;201307;4584;14875;4324;14338;846;3017;2762;9181;3608;12198
280630;201307;3709;12604;3613;12462;395;1298;2893;10303;3288;11601
280640;201307;2085;6186;1966;6039;170;476;1685;5270;1855;5746
280650;201307;1056;3420;984;3282;198;715;600;2041;798;2756
280660;201307;2506;7559;2413;7403;241;844;2014;6093;2255;6937
280670;201307;15194;41169;14559;40388;1480;4403;11723;32570;13203;36973
280680;201307;2669;7299;2377;6937;188;597;2007;5851;2195;6448
280690;201307;937;2795;835;2636;126;470;552;1657;678;2127
280700;201307;1149;3463;1020;3273;90;298;766;2509;856;2807
280710;201307;9761;28294;9316;27741;592;1929;8035;23926;8627;25855
280720;201307;2416;6721;2168;6409;208;664;1709;5099;1917;5763
280730;201307;900;2775;873;2737;89;300;716;2272;805;2572
280740;201307;12244;34635;10909;32673;1717;5061;7648;23636;9365;28697
280750;201307;3463;11241;3258;10867;297;1263;2434;7988;2731;9251
280760;201307;5538;17372;5127;16835;699;2317;3829;13018;4528;15335
290010;201307;2939;6709;2166;5494;95;383;1725;4131;1820;4514
290020;201307;4793;15418;4364;14972;376;1211;3798;13267;4174;14478
290030;201307;3046;10221;2983;10095;394;1448;2274;7661;2668;9109
290035;201307;4389;12523;4005;12015;261;917;3427;10269;3688;11186
290040;201307;3610;10973;3418;10712;282;1100;2835;8724;3117;9824
290050;201307;2689;8949;2532;8707;256;992;1960;6783;2216;7775
290060;201307;1227;3295;1042;3078;85;237;898;2671;983;2908
290070;201307;29150;79690;25948;75649;5597;17068;14795;45125;20392;62193
290080;201307;5687;18008;5132;17294;638;2282;3900;13381;4538;15663
290090;201307;2283;5139;1836;4664;248;651;1470;3777;1718;4428
290100;201307;9944;29249;8720;27149;1914;6003;4816;15710;6730;21713
290110;201307;5138;16010;4987;15750;895;3062;3410;10695;4305;13757
290115;201307;4774;14929;4282;14270;348;1239;3290;11192;3638;12431
290120;201307;6540;18581;6177;18142;419;1284;5386;15932;5805;17216
290130;201307;4490;12011;4017;11443;321;835;3429;9966;3750;10801
290135;201307;4943;13269;4360;12305;467;1570;2976;8359;3443;9929
290140;201307;3673;12418;3318;11954;418;1616;2615;9488;3033;11104
290150;201307;2063;6267;2006;6173;194;658;1685;5158;1879;5816
290160;201307;3422;9743;3352;9659;378;761;2853;8599;3231;9360
290170;201307;2732;9402;2534;9076;253;1045;2020;7240;2273;8285
290180;201307;2846;8417;2612;8109;318;1115;1891;5853;2209;6968
290190;201307;4123;13833;3985;13589;443;1576;3110;10731;3553;12307
290195;201307;2119;6106;1861;5723;136;455;1502;4676;1638;5131
290200;201307;3709;12441;3447;11963;455;1710;2512;8755;2967;10465
290205;201307;2717;9055;2572;8841;427;1761;1809;6059;2236;7820
290210;201307;15340;43286;14662;42495;2478;5808;10614;33683;13092;39491
290220;201307;2271;7209;2190;7084;339;1276;1562;4936;1901;6212
290225;201307;2978;8194;2816;8016;257;579;2406;7111;2663;7690
290230;201307;2299;7795;2263;7742;249;863;1864;6476;2113;7339
290240;201307;3832;10312;3487;9842;430;1347;2550;7147;2980;8494
290250;201307;3714;12159;3173;11286;316;1215;2393;8604;2709;9819
290260;201307;4543;14549;4316;14190;499;1764;3394;11159;3893;12923
290265;201307;3260;10880;3127;10643;330;1320;2385;8082;2715;9402
290270;201307;11512;43810;10924;42957;1363;5851;8439;33558;9802;39409
290280;201307;4854;16736;4648;16318;716;2643;3155;11369;3871;14012
290290;201307;9391;31027;8702;29906;1648;5994;5765;20135;7413;26129
290300;201307;4325;12541;3454;11045;326;1073;2525;8267;2851;9340
290310;201307;1500;4682;1433;4602;221;826;1049;3303;1270;4129
290320;201307;23895;78073;22172;75694;4998;18065;13771;47864;18769;65929
290323;201307;3927;10972;3259;10268;209;774;2793;8784;3002;9558
290327;201307;3875;12840;3654;12379;510;1840;2574;8753;3084;10593
290330;201307;1825;5032;1757;4955;287;895;1355;3761;1642;4656
290340;201307;5475;17732;5141;17248;1276;4365;2930;10172;4206;14537
290350;201307;4831;15085;4000;13940;526;1877;2887;10336;3413;12213
290360;201307;4032;13062;3724;12657;233;825;3274;11268;3507;12093
290370;201307;4461;13789;4149;13333;566;1847;3243;10570;3809;12417
290380;201307;5346;16254;4834;15585;390;1413;4047;13055;4437;14468
290390;201307;14523;49078;14005;48199;2931;9802;9100;32922;12031;42724
290395;201307;2707;9018;2466;8621;259;1108;1848;6453;2107;7561
290400;201307;3411;11347;3124;10938;447;1587;2307;8271;2754;9858
290405;201307;4210;13905;3713;13052;535;1963;2467;8916;3002;10879
290410;201307;5815;18032;5023;16875;570;2449;3746;12231;4316;14680
290420;201307;3128;9665;2659;8979;274;1104;2039;6810;2313;7914
290430;201307;3326;10934;3059;10563;659;2255;1941;6991;2600;9246
290440;201307;2811;7850;2391;7325;222;760;1969;6070;2191;6830
290450;201307;3442;10389;3147;9972;678;2070;1983;6567;2661;8637
290460;201307;12659;40880;12047;39840;3191;11274;6312;20715;9503;31989
290470;201307;4589;13468;3729;12380;882;3318;2035;6815;2917;10133
290475;201307;5012;18140;4587;17373;555;2232;3364;12944;3919;15176
290480;201307;2582;6873;2319;6525;382;1196;1584;4466;1966;5662
290485;201307;4373;14942;4131;14588;480;2146;3163;11072;3643;13218
290490;201307;7366;21176;7170;20901;927;2945;5663;16500;6590;19445
290500;201307;4542;14859;3967;13854;742;2799;2212;7758;2954;10557
290510;201307;3392;10143;2991;9556;265;1013;2361;7527;2626;8540
290515;201307;2633;8631;2548;8463;151;492;2102;7168;2253;7660
290520;201307;11566;36884;9635;33258;1339;5395;6133;21038;7472;26433
290530;201307;5143;15280;4448;14281;384;1339;3606;11606;3990;12945
290540;201307;3924;11442;3755;11217;512;1488;2837;8705;3349;10193
290550;201307;4211;11430;3742;10838;249;716;3190;9305;3439;10021
290560;201307;5876;17936;5287;17091;1137;3890;3240;10603;4377;14493
290570;201307;38018;114946;35800;111538;4914;16548;26456;82174;31370;98722
290580;201307;7233;26167;6981;25780;1198;4451;5094;19321;6292;23772
290590;201307;7258;23976;6254;22375;468;2013;5094;18161;5562;20174
290600;201307;17755;56763;16877;55408;2472;8230;11902;40270;14374;48500
290610;201307;2276;8182;1959;7550;211;1004;1468;5559;1679;6563
290620;201307;7179;21709;6495;20736;552;1911;5425;17344;5977;19255
290630;201307;8029;22549;7188;21646;846;2511;5770;17640;6616;20151
290640;201307;2680;8031;2256;7287;258;895;1597;5183;1855;6078
290650;201307;11501;35064;10832;34032;3347;10575;5687;18708;9034;29283
290660;201307;3623;10521;3054;9698;217;792;2436;7774;2653;8566
290670;201307;6257;20480;5785;19741;836;2659;4424;15765;5260;18424
290680;201307;9998;30320;9420;29639;560;1760;8235;26250;8795;28010
290682;201307;4131;12966;3807;12504;227;913;3176;10396;3403;11309
290685;201307;3124;8381;2445;7434;310;1063;1561;4808;1871;5871
290687;201307;8247;22637;6725;20845;1047;3548;4544;14307;5591;17855
290689;201307;3087;8905;2617;8143;278;929;1991;6232;2269;7161
290690;201307;5149;15673;4772;15151;630;2196;3632;11556;4262;13752
290700;201307;2202;7099;2117;6975;245;866;1619;5392;1864;6258
290710;201307;7470;24845;7018;24130;407;1392;6180;21483;6587;22875
290720;201307;17190;52926;15594;50933;2429;7342;11791;40047;14220;47389
290730;201307;7221;20602;6666;19896;1372;3964;4287;13358;5659;17322
290740;201307;984;3030;855;2815;171;549;497;1730;668;2279
290750;201307;9385;28529;8448;26854;1717;6376;5003;15131;6720;21507
290755;201307;2378;6961;2048;6412;137;550;1674;5173;1811;5723
290760;201307;4400;13361;3710;12407;387;1328;2834;9584;3221;10912
290770;201307;2516;8900;2363;8695;153;626;2000;7411;2153;8037
290780;201307;8510;23359;7719;22284;1032;2766;5759;17163;6791;19929
290790;201307;4377;13779;4143;13473;533;1649;3165;10732;3698;12381
290800;201307;7040;16213;5492;14567;1128;2781;3798;10569;4926;13350
290810;201307;4726;15652;4247;14947;354;1338;3319;11878;3673;13216
290820;201307;5228;15634;4712;14880;623;2206;3375;10636;3998;12842
290830;201307;4113;12775;3979;12524;526;2065;2861;8747;3387;10812
290840;201307;16895;49026;15852;47600;2363;6836;11494;35913;13857;42749
290850;201307;6550;20216;6413;20011;1588;4921;4132;13307;5720;18228
290860;201307;4653;17225;4478;16988;754;2847;3247;12725;4001;15572
290870;201307;4640;14543;3930;13590;475;1925;2917;10036;3392;11961
290880;201307;1362;3904;1120;3517;124;405;750;2404;874;2809
290890;201307;6070;17584;5875;17324;602;1875;4814;14227;5416;16102
290900;201307;2350;7077;1806;6205;306;1208;956;3234;1262;4442
290910;201307;4641;13468;4056;12628;349;1196;3281;10228;3630;11424
290920;201307;4626;14147;4225;13611;332;987;3480;11401;3812;12388
290930;201307;7131;23662;6662;22874;781;3053;4880;16548;5661;19601
290940;201307;3308;11008;3137;10785;272;1021;2650;9220;2922;10241
290950;201307;1572;4572;1488;4462;227;730;1084;3234;1311;3964
290960;201307;5654;16957;5220;16379;418;1345;4204;13428;4622;14773
290970;201307;3697;12287;3470;11892;525;1872;2312;8150;2837;10022
290980;201307;10322;32489;9430;30694;2798;9632;4100;13307;6898;22939
290990;201307;9005;27653;8320;26569;931;3147;6518;20923;7449;24070
291000;201307;2818;9279;2697;9118;453;1491;1979;6944;2432;8435
291005;201307;11801;35576;10951;34279;2155;7242;7141;22594;9296;29836
291010;201307;2892;10030;2495;9123;503;1980;1353;4962;1856;6942
291020;201307;1325;3705;1046;3183;131;504;606;1786;737;2290
291030;201307;2033;5951;1729;5314;188;638;1151;3501;1339;4139
291040;201307;5172;17162;4908;16755;713;2610;3573;12255;4286;14865
291050;201307;7810;26752;7252;25709;1898;7227;3911;13927;5809;21154
291060;201307;6077;23109;5840;22825;798;3538;4509;17581;5307;21119
291070;201307;15386;47136;14358;45619;1951;5815;10780;35420;12731;41235
291072;201307;18497;60734;16556;56909;6363;23215;5362;19545;11725;42760
291075;201307;5029;15160;4609;14575;329;1050;3612;11688;3941;12738
291077;201307;1485;4512;1281;4193;146;586;895;2863;1041;3449
291080;201307;79566;247511;73257;237342;18770;64241;37404;121014;56174;185255
291085;201307;5442;15245;4802;14379;619;1971;3679;11032;4298;13003
291090;201307;1219;3475;1082;3267;175;739;724;2007;899;2746
291100;201307;2627;7246;2226;6820;132;534;1920;5832;2052;6366
291110;201307;4846;17901;4422;17230;594;2596;3224;12535;3818;15131
291120;201307;7357;20190;6983;19659;1013;3001;5195;14666;6208;17667
291125;201307;1630;3745;1345;3445;132;320;1053;2821;1185;3141
291130;201307;2948;9177;2601;8595;269;1040;1861;6115;2130;7155
291140;201307;3980;12317;3764;11937;543;1841;2703;8596;3246;10437
291150;201307;1959;5270;1892;5190;184;541;1498;4073;1682;4614
291160;201307;5415;16876;4824;16010;1132;3943;2941;9767;4073;13710
291165;201307;2258;7122;1949;6530;179;766;1398;4562;1577;5328
291170;201307;20102;53041;17672;50116;1414;4805;14270;40198;15684;45003
291180;201307;6220;17104;5242;15773;579;1982;4044;12078;4623;14060
291185;201307;3567;10385;3426;10204;237;844;2946;8685;3183;9529
291190;201307;7334;21255;6690;20503;908;2654;4997;16011;5905;18665
291200;201307;3035;9461;2664;8859;364;1420;1882;6198;2246;7618
291210;201307;7475;18211;6670;17334;690;1904;5189;13595;5879;15499
291220;201307;3971;13069;3792;12754;608;2317;2675;8885;3283;11202
291230;201307;3700;10102;3330;9650;219;656;2877;8402;3096;9058
291240;201307;4631;13083;3982;11944;334;1062;3080;9167;3414;10229
291250;201307;3659;11268;2945;10094;317;1126;2118;7373;2435;8499
291260;201307;1155;3523;1100;3451;103;360;885;2772;988;3132
291270;201307;4346;14996;4179;14723;268;1062;3548;12537;3816;13599
291280;201307;2331;6024;1793;5416;535;1568;1043;3285;1578;4853
291290;201307;5779;17015;5333;16474;634;1916;4045;12853;4679;14769
291300;201307;4366;13370;3665;12188;485;1761;2507;8374;2992;10135
291310;201307;5158;15344;4615;14468;453;1518;3533;11102;3986;12620
291320;201307;5494;18778;4969;17741;1420;5475;2397;8495;3817;13970
291330;201307;1559;4937;1471;4777;222;845;930;2883;1152;3728
291340;201307;3730;11475;3042;10491;403;1608;2274;7743;2677;9351
291345;201307;3336;11403;3213;11269;257;926;2785;9906;3042;10832
291350;201307;5941;18073;5354;17181;698;2343;3575;11793;4273;14136
291360;201307;35601;105965;33523;102905;7978;24505;21441;67975;29419;92480
291370;201307;8879;27189;8549;26764;1349;3936;6258;20478;7607;24414
291380;201307;3696;11695;3330;11087;335;1166;2381;8153;2716;9319
291390;201307;10162;29328;9354;28387;1268;3880;7218;22187;8486;26067
291400;201307;16289;44128;13413;40293;2052;6423;8891;27643;10943;34066
291410;201307;3192;8473;2375;7272;210;863;1757;5188;1967;6051
291420;201307;2197;5879;2004;5646;104;251;1827;5229;1931;5480
291430;201307;3275;9950;2920;9480;268;1050;2287;7359;2555;8409
291440;201307;5695;18803;4901;17303;608;2286;3645;13049;4253;15335
291450;201307;7077;22723;6747;22145;482;1553;5485;18407;5967;19960
291460;201307;12138;38688;11002;37033;2652;9311;6584;22558;9236;31869
291465;201307;7478;22825;6941;22220;969;3363;5325;17140;6294;20503
291470;201307;15182;43671;13700;41848;1186;3686;10986;34519;12172;38205
291480;201307;33683;94210;30285;89411;5765;18587;19229;56635;24994;75222
291490;201307;3993;14192;3934;14101;537;1953;3145;11411;3682;13364
291500;201307;4091;12240;3620;11591;298;1033;2924;9422;3222;10455
291510;201307;3358;10769;3190;10527;171;615;2863;9498;3034;10113
291520;201307;3947;11340;3572;10825;649;1856;2361;7672;3010;9528
291530;201307;2032;6265;1765;5851;511;1808;866;2967;1377;4775
291535;201307;4253;12795;3882;12248;414;1388;2908;9540;3322;10928
291540;201307;2193;5560;1910;5264;154;394;1622;4576;1776;4970
291550;201307;5509;15643;5017;14949;1242;3993;2809;8455;4051;12448
291560;201307;16140;43747;13043;40174;1787;5635;9527;30139;11314;35774
291570;201307;2266;6350;2212;6277;118;297;2015;5781;2133;6078
291580;201307;5743;18129;5140;17156;860;3448;3264;10722;4124;14170
291590;201307;1953;6276;1752;5935;345;1326;1077;3717;1422;5043
291600;201307;5388;15424;4031;13519;1042;3792;1998;6651;3040;10443
291610;201307;5113;14904;4961;14677;516;1802;4001;11611;4517;13413
291620;201307;2968;7161;2506;6663;207;548;1992;5464;2199;6012
291630;201307;3161;8138;2831;7764;261;675;2413;6777;2674;7452
291640;201307;16651;47548;14265;44494;3958;13525;6517;20450;10475;33975
291650;201307;7870;24046;7326;23413;623;1603;6207;20623;6830;22226
291660;201307;2370;6465;2131;6147;270;905;1518;4297;1788;5202
291670;201307;2488;7151;2302;6843;375;1173;1311;4204;1686;5377
291680;201307;4923;14409;4505;13767;1183;4059;2144;6837;3327;10896
291685;201307;4129;11219;3732;10739;242;731;3144;9280;3386;10011
291690;201307;3929;11065;3273;10027;338;1079;2268;7007;2606;8086
291700;201307;9085;29751;8544;28857;966;3436;6527;22394;7493;25830
291710;201307;5714;15704;5038;14788;1313;4209;2481;7558;3794;11767
291720;201307;3564;13012;3391;12646;406;1709;2534;9336;2940;11045
291730;201307;5642;18884;5309;18445;1371;4809;3202;11586;4573;16395
291733;201307;2462;7692;2184;7313;272;1005;1520;5136;1792;6141
291735;201307;2160;6550;1917;6180;121;471;1628;5183;1749;5654
291740;201307;3914;11618;3125;10400;327;1282;2216;7339;2543;8621
291750;201307;21209;58066;17400;52530;3916;12230;9786;30143;13702;42373
291760;201307;11837;38830;11202;37701;3806;13782;5314;18247;9120;32029
291770;201307;7805;23139;7276;22252;1133;3770;4999;15182;6132;18952
291780;201307;4201;13400;4060;13148;593;1861;3079;10125;3672;11986
291790;201307;2350;7777;2243;7631;199;777;1842;6255;2041;7032
291800;201307;29988;91234;27633;87853;6467;21353;16639;54381;23106;75734
291810;201307;10169;30651;8986;29283;708;2492;7316;24219;8024;26711
291820;201307;3491;10830;3250;10498;399;1299;2476;8106;2875;9405
291830;201307;4319;12012;4063;11626;604;1897;3010;8588;3614;10485
291835;201307;6002;19215;5113;17792;1065;4025;3331;11570;4396;15595
291840;201307;45702;130778;39964;124713;4975;15527;31834;101467;36809;116994
291845;201307;2979;8905;2702;8606;222;666;2371;7662;2593;8328
291850;201307;4805;13835;4123;12912;432;1325;3253;10483;3685;11808
291855;201307;1867;5116;1647;4850;290;996;1136;3277;1426;4273
291860;201307;1868;5813;1716;5548;199;723;1153;3711;1352;4434
291870;201307;1313;3675;1060;3222;108;405;716;2147;824;2552
291875;201307;2745;9236;2545;8911;262;1090;1887;6513;2149;7603
291880;201307;4432;14408;4292;14195;299;1006;3737;12504;4036;13510
291890;201307;1423;3643;1215;3387;170;498;874;2456;1044;2954
291900;201307;1238;3717;1119;3536;119;436;844;2627;963;3063
291905;201307;2834;7811;2424;7161;252;847;1684;5061;1936;5908
291910;201307;2440;6968;2216;6672;190;719;1801;5291;1991;6010
291915;201307;6478;20776;5888;19578;517;1802;4900;16490;5417;18292
291920;201307;32087;95054;29890;91864;5894;18400;19108;60587;25002;78987
291930;201307;2463;7561;2266;7283;249;839;1763;5758;2012;6597
291940;201307;3527;10298;2720;8877;420;1608;1673;5298;2093;6906
291950;201307;8980;31365;8232;30147;2202;8227;4367;16438;6569;24665
291955;201307;7323;24660;7206;24494;1462;5077;4856;16828;6318;21905
291960;201307;3291;10085;2874;9526;363;1157;2041;7133;2404;8290
291970;201307;4372;13312;3923;12775;624;2075;2759;9228;3383;11303
291980;201307;11181;33162;8807;29797;1093;3882;6286;21737;7379;25619
291990;201307;2065;7007;1930;6804;218;793;1410;5128;1628;5921
291992;201307;2751;8645;2695;8527;506;1650;1915;6059;2421;7709
291995;201307;2071;6293;1895;6060;226;750;1461;4755;1687;5505
292000;201307;2226;6837;2043;6557;538;1887;1154;3636;1692;5523
292010;201307;5985;16031;4680;14047;430;1417;3618;10844;4048;12261
292020;201307;4430;15443;4090;14869;586;2299;2989;11028;3575;13327
292030;201307;2106;6904;1924;6642;269;1008;1287;4517;1556;5525
292040;201307;4492;12908;4058;12440;347;1039;3413;10799;3760;11838
292045;201307;2311;8534;2284;8486;126;421;2089;7838;2215;8259
292050;201307;5979;19518;5494;18561;625;2573;3883;12906;4508;15479
292060;201307;10662;30713;10300;30225;952;2928;8594;25200;9546;28128
292070;201307;4249;13900;4152;13777;400;1180;3599;12188;3999;13368
292080;201307;3585;9798;3137;9186;307;917;2529;7493;2836;8410
292090;201307;4188;11523;3642;10899;366;1262;2924;8746;3290;10008
292100;201307;10352;30142;9216;28729;2398;7827;5572;17695;7970;25522
292105;201307;3113;9705;2735;9176;223;901;2179;7262;2402;8163
292110;201307;6910;18610;5351;16400;1147;3705;3151;9908;4298;13613
292120;201307;8241;24271;7382;22913;1517;4914;4386;13958;5903;18872
292130;201307;3188;8694;2949;8382;393;924;2276;6768;2669;7692
292140;201307;5295;14326;4713;13548;526;1586;3418;10077;3944;11663
292145;201307;2630;8274;2419;7943;215;693;1829;6282;2044;6975
292150;201307;13259;41312;12413;39941;913;3456;9813;31746;10726;35202
292160;201307;2622;7749;2260;7248;201;611;1839;6077;2040;6688
292170;201307;8506;26306;7412;24413;1116;4087;4791;15978;5907;20065
292180;201307;3436;10498;2893;9674;333;1194;2090;7110;2423;8304
292190;201307;3099;8900;2751;8412;565;1909;1776;5419;2341;7328
292200;201307;5328;18528;4885;17535;1615;6198;1831;6553;3446;12751
292205;201307;3960;12530;3663;12133;299;1136;2909;9635;3208;10771
292210;201307;6382;19210;5671;18225;592;1978;4413;14568;5005;16546
292220;201307;1888;5515;1796;5384;422;1228;1087;3296;1509;4524
292225;201307;2839;9311;2630;8984;216;776;2114;7337;2330;8113
292230;201307;6083;18645;5829;18250;719;2661;4418;13533;5137;16194
292240;201307;4206;13870;3946;13271;635;2272;2426;8156;3061;10428
292250;201307;5247;16367;4966;15836;1052;3489;2775;8955;3827;12444
292260;201307;2885;9581;2775;9399;342;1241;2110;7146;2452;8387
292265;201307;3048;10336;2813;9904;250;1030;2120;7442;2370;8472
292270;201307;3713;10644;3050;9864;282;1126;2441;7880;2723;9006
292273;201307;2730;6765;2116;5980;319;890;1477;4353;1796;5243
292275;201307;1875;4955;1763;4796;226;707;1330;3580;1556;4287
292280;201307;2009;6231;1873;6088;199;551;1479;5115;1678;5666
292285;201307;2449;7176;2194;6807;328;1109;1516;4829;1844;5938
292290;201307;7337;22699;6272;21345;274;1051;5383;18709;5657;19760
292300;201307;8119;25734;7218;24756;2374;8223;4003;14279;6377;22502
292303;201307;2705;8885;2553;8661;104;416;2231;7588;2335;8004
292305;201307;3091;8598;2934;8388;111;339;2639;7573;2750;7912
292310;201307;5825;18526;5376;17922;381;1313;4572;15415;4953;16728
292320;201307;5579;17860;5215;17222;596;2323;3961;12947;4557;15270
292330;201307;1861;5662;1758;5539;282;982;1273;3957;1555;4939
292335;201307;5150;13919;4751;13385;407;1173;4002;11343;4409;12516
292340;201307;6340;18892;5591;17749;533;1840;4185;13308;4718;15148
292350;201307;2022;6532;1912;6399;208;789;1521;5091;1729;5880
292360;201307;4763;14454;4618;13958;203;619;4026;12467;4229;13086
292370;201307;8091;26275;7434;25294;963;3139;5313;19112;6276;22251
292380;201307;7145;21246;6784;20715;568;1633;5662;17513;6230;19146
292390;201307;3495;8180;3118;7772;110;224;2916;7342;3026;7566
292400;201307;21697;65263;20801;63826;3143;10209;14740;46176;17883;56385
292405;201307;4304;11912;3795;11294;277;842;3196;9643;3473;10485
292410;201307;1650;4915;1612;4870;127;460;1411;4203;1538;4663
292420;201307;3596;11886;3475;11748;198;560;3131;10846;3329;11406
292430;201307;5112;16789;4432;15921;332;1347;3526;12714;3858;14061
292440;201307;8428;28069;7956;27408;305;1192;7099;24771;7404;25963
292450;201307;4261;13021;3518;11832;352;1317;2516;8578;2868;9895
292460;201307;5542;17042;4978;16009;905;3035;3185;10364;4090;13399
292465;201307;2266;7170;1980;6705;250;983;1437;4879;1687;5862
292467;201307;2163;7175;2057;6992;449;1660;1285;4390;1734;6050
292470;201307;3136;8630;2654;7862;241;864;2007;5841;2248;6705
292480;201307;5610;16296;4872;15227;399;1418;3951;12396;4350;13814
292490;201307;2193;6485;1918;6075;227;852;1412;4424;1639;5276
292500;201307;6427;19881;5659;18553;599;2294;4148;13671;4747;15965
292510;201307;12807;37903;11520;36072;1167;4042;9022;28608;10189;32650
292520;201307;5506;17443;5154;16806;1565;5222;2528;8367;4093;13589
292525;201307;5371;14526;4751;13803;461;1462;3780;11077;4241;12539
292530;201307;24136;74132;22377;72109;4390;14581;15227;50558;19617;65139
292540;201307;2683;8314;2466;7984;580;2028;1524;4966;2104;6994
292550;201307;5953;20347;5455;19539;995;3751;3600;13165;4595;16916
292560;201307;4163;11749;3591;11003;313;1158;2913;8791;3226;9949
292570;201307;3837;11697;3765;11621;144;455;3284;10472;3428;10927
292575;201307;5795;20319;5656;20037;1228;4461;3707;13170;4935;17631
292580;201307;6869;21104;6443;20560;581;1900;5313;17152;5894;19052
292590;201307;6996;22987;6753;22560;1098;3602;4725;16152;5823;19754
292593;201307;3184;8631;2737;7971;253;773;2110;6133;2363;6906
292595;201307;5455;16400;4968;15741;486;1690;3821;12119;4307;13809
292600;201307;10174;29547;9725;28996;1396;3283;7741;24289;9137;27572
292610;201307;4267;12631;3598;11507;600;2035;2238;7285;2838;9320
292620;201307;5740;18215;5121;17495;380;1470;4528;15487;4908;16957
292630;201307;9753;25138;8610;23470;728;2136;6685;18422;7413;20558
292640;201307;8180;26894;7267;25691;673;2457;5703;20650;6376;23107
292650;201307;4585;13203;4441;13031;502;1124;3568;11188;4070;12312
292660;201307;10817;33985;10423;33379;1552;4954;7652;25153;9204;30107
292665;201307;2840;8623;2771;8516;98;274;2599;8054;2697;8328
292670;201307;3766;11007;3015;9734;370;1366;2001;6482;2371;7848
292680;201307;3479;10824;3343;10642;248;875;2847;8999;3095;9874
292690;201307;3309;9250;2456;7950;323;1160;1668;5485;1991;6645
292700;201307;8674;27604;7776;26352;1012;3289;5833;20596;6845;23885
292710;201307;1870;6278;1803;6177;104;395;1597;5478;1701;5873
292720;201307;9302;24752;8314;23625;805;2402;6860;19660;7665;22062
292730;201307;3255;10224;3165;10077;607;1853;2108;6971;2715;8824
292740;201307;341393;992745;326506;970509;80277;251976;195105;582514;275382;834490
292750;201307;5656;16113;5205;15521;414;1215;4245;12963;4659;14178
292760;201307;4177;13681;3865;13111;572;2146;2579;8839;3151;10985
292770;201307;5790;18346;5513;17913;1392;4567;3216;10869;4608;15436
292780;201307;1768;4625;1434;4226;220;773;1018;2946;1238;3719
292790;201307;3050;8750;2952;8640;257;657;2447;7499;2704;8156
292800;201307;9196;28483;8676;27637;958;3295;6708;21423;7666;24718
292805;201307;3004;9292;2811;9004;543;1915;1900;6154;2443;8069
292810;201307;9505;30188;8288;28573;1269;4512;6114;21594;7383;26106
292820;201307;7162;21151;5359;18618;446;1726;4359;15236;4805;16962
292830;201307;1820;5561;1668;5349;132;531;1352;4292;1484;4823
292840;201307;6400;22821;5957;22192;520;1967;4950;18719;5470;20686
292850;201307;3046;8362;2640;7757;385;1193;1823;5333;2208;6526
292860;201307;14890;41560;14410;40975;2019;5708;11216;32450;13235;38158
292870;201307;17881;51803;16197;49058;3206;10835;9584;28469;12790;39304
292880;201307;11413;35216;10430;33611;2033;6739;6524;21327;8557;28066
292890;201307;5290;18781;4832;17887;1057;4089;2724;10366;3781;14455
292895;201307;2655;7022;2261;6437;318;970;1692;4787;2010;5757
292900;201307;3014;9582;2848;9307;470;1810;1871;5884;2341;7694
292905;201307;3917;12130;3331;11364;360;1133;2692;9487;3052;10620
292910;201307;4905;15721;4602;15157;818;2879;2999;9835;3817;12714
292920;201307;7690;23438;7362;22940;703;2480;5938;18283;6641;20763
292925;201307;4968;16073;4464;15391;381;1430;3572;12391;3953;13821
292930;201307;6299;20758;6044;20278;890;3631;4316;14113;5206;17744
292935;201307;2056;5950;1764;5624;187;531;1398;4673;1585;5204
292937;201307;3261;8572;2810;8000;341;1095;2126;5974;2467;7069
292940;201307;3000;8557;2428;7768;300;971;1645;5487;1945;6458
292950;201307;8047;25078;7740;24566;1076;4033;5558;17156;6634;21189
292960;201307;4426;12933;4173;12549;498;1628;2977;8892;3475;10520
292970;201307;4110;13257;3830;12896;201;836;3253;10963;3454;11799
292975;201307;3132;9021;3040;8866;353;1090;2444;7142;2797;8232
292980;201307;3489;10137;2895;9426;413;1619;2011;6476;2424;8095
292990;201307;11749;34524;11013;33445;789;2507;9432;28779;10221;31286
293000;201307;2875;7847;2392;7224;138;485;2067;6222;2205;6707
293010;201307;17126;51426;15738;49102;3275;11190;9634;29878;12909;41068
293015;201307;7653;25861;6264;23826;1108;4547;4084;15521;5192;20068
293020;201307;9229;31084;8662;30258;651;2577;7147;25222;7798;27799
293030;201307;5426;16290;4459;14866;502;1824;3090;10631;3592;12455
293040;201307;3596;11807;3475;11674;259;942;3001;10097;3260;11039
293050;201307;18659;54987;16806;52538;2635;8396;11497;37016;14132;45412
293060;201307;4241;11053;3643;10102;427;1289;2521;6937;2948;8226
293070;201307;18800;59465;17864;57838;5009;16897;9670;31830;14679;48727
293075;201307;3510;11233;3209;10880;256;931;2749;9391;3005;10322
293076;201307;3645;10541;3434;10223;300;838;2869;8730;3169;9568
293077;201307;5125;16066;4479;15250;762;2786;3053;10453;3815;13239
293080;201307;4736;15221;4379;14615;359;1549;3431;11191;3790;12740
293090;201307;3536;11232;2935;10397;300;1110;2297;8254;2597;9364
293100;201307;5543;17498;4815;16223;493;1797;3645;12476;4138;14273
293105;201307;3732;12834;3334;12051;519;1994;2259;8274;2778;10268
293110;201307;1934;5904;1844;5758;110;413;1560;4860;1670;5273
293120;201307;3915;13505;3673;13165;359;1322;2927;10641;3286;11963
293130;201307;3881;11556;3190;10777;200;783;2784;9522;2984;10305
293135;201307;24561;69303;20422;63729;4095;15205;11054;33698;15149;48903
293140;201307;2020;6251;1968;6170;201;821;1531;4646;1732;5467
293150;201307;5783;19234;5292;18301;1073;3804;3190;11393;4263;15197
293160;201307;2973;8979;2823;8796;446;1119;2133;7011;2579;8130
293170;201307;3333;10465;3147;10175;479;1667;2289;7515;2768;9182
293180;201307;5276;15139;4495;13962;424;1566;3523;10785;3947;12351
293190;201307;13228;41362;12764;40601;652;2852;11044;34452;11696;37304
293200;201307;6035;18357;5455;17445;357;1306;4686;14897;5043;16203
293210;201307;4552;14279;4306;13864;578;1954;3064;10031;3642;11985
293220;201307;4945;15513;4587;14981;1193;4091;2502;8388;3695;12479
293230;201307;3906;12559;3640;12194;395;1540;2906;9682;3301;11222
293240;201307;4415;11724;3541;10541;196;596;2808;8385;3004;8981
293245;201307;4270;12819;3939;12273;515;1660;2791;8964;3306;10624
293250;201307;5843;17191;5474;16680;938;2990;3784;11656;4722;14646
293260;201307;4634;14258;3912;13218;367;1373;2943;10091;3310;11464
293270;201307;5674;15961;5421;15685;565;1552;4575;13475;5140;15027
293280;201307;5553;16205;4924;15377;433;1294;3873;12506;4306;13800
293290;201307;15920;55331;15352;54146;3268;11770;9497;34351;12765;46121
293300;201307;6048;15929;5284;15089;522;1438;4191;12205;4713;13643
293305;201307;4503;11852;4164;11404;431;1282;3269;9019;3700;10301
293310;201307;2637;7014;2205;6313;315;1009;1472;4163;1787;5172
293315;201307;4739;12409;4290;11704;773;2083;2649;7630;3422;9713
293317;201307;2443;7541;2260;7200;329;1099;1475;4743;1804;5842
293320;201307;8033;26541;7837;26270;1003;3660;6217;20766;7220;24426
293325;201307;1874;5608;1567;5125;293;1041;1005;3328;1298;4369
293330;201307;52541;170934;47829;162974;11055;40854;26791;92591;37846;133445
293340;201307;2652;7762;2150;6901;309;1126;1473;4637;1782;5763
293345;201307;3319;10336;2810;9593;364;1229;1946;6905;2310;8134
293350;201307;6552;18697;6316;18402;358;997;5685;16808;6043;17805
293360;201307;13439;41617;12415;40255;795;2620;10558;34974;11353;37594
310010;201307;1221;3377;884;2827;248;944;391;1151;639;2095
310020;201307;3711;12034;3188;10858;1161;4282;633;1964;1794;6246
310030;201307;2371;8160;2157;7759;744;2793;898;3289;1642;6082
310040;201307;932;2691;797;2504;119;446;534;1633;653;2079
310050;201307;1883;6798;1665;6254;359;1570;803;2974;1162;4544
310060;201307;3013;10844;2911;10685;345;1323;2301;8581;2646;9904
310070;201307;309;945;233;798;40;169;99;308;139;477
310080;201307;737;2328;604;2065;172;681;195;614;367;1295
310090;201307;4431;14022;3966;13210;716;2656;2453;8200;3169;10856
310100;201307;3186;10288;2822;9753;415;1589;1984;6869;2399;8458
310110;201307;5759;16695;4896;15404;1162;4196;2641;8183;3803;12379
310120;201307;559;1891;535;1850;239;943;187;546;426;1489
310130;201307;452;1486;414;1426;118;463;209;689;327;1152
310140;201307;250;883;216;817;76;321;44;150;120;471
310150;201307;4546;14782;4172;14090;962;3723;2192;7343;3154;11066
310160;201307;6646;22103;5931;20891;1705;6751;2741;9452;4446;16203
310163;201307;656;2316;621;2249;162;682;290;1022;452;1704
310170;201307;9465;27992;8776;26916;1898;6268;5181;16420;7079;22688
310180;201307;1772;5324;1442;4873;387;1499;715;2339;1102;3838
310190;201307;2438;8319;2233;7975;688;2737;291;1035;979;3772
310200;201307;1805;6270;1545;5722;506;2026;509;1870;1015;3896
310205;201307;923;3005;848;2842;182;642;499;1699;681;2341
310210;201307;2340;7750;2185;7496;414;1540;1466;5024;1880;6564
310220;201307;1247;3617;1010;3316;182;652;651;2134;833;2786
310230;201307;2802;9495;2474;8766;817;3334;876;2828;1693;6162
310240;201307;996;3603;839;3282;147;634;461;1908;608;2542
310250;201307;948;3370;921;3326;185;769;571;1968;756;2737
310260;201307;3230;10829;2854;10065;949;3686;1050;3593;1999;7279
310270;201307;2237;7024;2055;6765;335;1229;1427;4749;1762;5978
310280;201307;2033;6157;1855;5866;675;2484;666;1935;1341;4419
310285;201307;2234;7972;2136;7839;267;923;1647;6257;1914;7180
310290;201307;1298;4211;1210;4075;400;1578;545;1626;945;3204
310300;201307;1818;6442;1730;6248;497;1978;957;3408;1454;5386
310310;201307;386;1095;288;891;59;200;143;433;202;633
310320;201307;342;1236;313;1163;86;349;145;539;231;888
310330;201307;470;1255;358;1055;48;165;206;571;254;736
310340;201307;8158;26727;7316;25357;1427;5196;4514;16167;5941;21363
310350;201307;13576;41597;11383;37517;4262;15220;2944;9772;7206;24992
310360;201307;422;1426;411;1406;107;423;245;795;352;1218
310370;201307;1350;5063;1303;4966;517;2025;491;1912;1008;3937
310375;201307;1254;3476;958;2975;144;548;546;1661;690;2209
310380;201307;388;1135;314;1026;143;519;116;342;259;861
310390;201307;469;1726;397;1560;119;508;69;250;188;758
310400;201307;9782;30205;7936;26843;2776;10324;2080;6861;4856;17185
310410;201307;1024;3344;677;2809;288;1291;126;504;414;1795
310420;201307;5469;16244;3173;10724;870;3317;480;1454;1350;4771
310430;201307;1528;5386;1311;4900;477;1900;362;1343;839;3243
310440;201307;620;1848;543;1727;160;582;203;600;363;1182
310445;201307;1157;4069;1001;3798;155;664;640;2463;795;3127
310450;201307;4276;13161;3626;12156;832;2971;2121;7290;2953;10261
310460;201307;1462;4896;1292;4580;478;1827;309;1161;787;2988
310470;201307;3700;9866;3144;9179;330;1132;2480;7204;2810;8336
310480;201307;980;3185;887;3028;229;898;404;1303;633;2201
310490;201307;3199;11099;2791;10296;962;3807;982;3712;1944;7519
310500;201307;1424;5121;1334;4939;460;1849;487;1786;947;3635
310510;201307;2470;8306;2175;7630;861;3306;491;1611;1352;4917
310520;201307;1238;3650;1114;3444;95;322;738;2287;833;2609
310530;201307;786;2634;541;1984;129;530;90;313;219;843
310540;201307;3585;12115;3343;11763;1207;4510;1231;4392;2438;8902
310550;201307;1088;3494;931;3223;329;1306;305;979;634;2285
310560;201307;15355;49698;13531;46138;4708;17770;4576;14864;9284;32634
310570;201307;1260;4002;1186;3898;178;683;864;2787;1042;3470
310590;201307;3927;11956;3198;10495;716;2702;1152;3567;1868;6269
310600;201307;1602;5522;1532;5353;538;2094;522;1724;1060;3818
310610;201307;541;1892;497;1793;170;718;164;526;334;1244
310620;201307;181963;594414;150392;528652;44088;172568;57460;193668;101548;366236
310630;201307;3990;13563;3800;13192;949;3722;2237;7501;3186;11223
310640;201307;1419;4492;1165;4034;380;1440;380;1250;760;2690
310650;201307;2730;9341;2316;8666;465;1899;1346;5174;1811;7073
310660;201307;1260;4062;1133;3881;210;834;797;2657;1007;3491
310665;201307;1094;3588;1022;3493;205;743;663;2309;868;3052
310670;201307;53758;174516;50528;167144;16230;57081;22585;73122;38815;130203
310680;201307;798;2446;734;2346;165;588;411;1272;576;1860
310690;201307;1169;4106;986;3698;291;1285;250;871;541;2156
310700;201307;499;1433;429;1327;108;386;218;639;326;1025
310710;201307;7148;24202;6003;22578;1370;5535;3245;12729;4615;18264
310720;201307;817;2600;753;2497;220;824;374;1163;594;1987
310730;201307;9158;30025;8561;29089;1984;7311;5187;17695;7171;25006
310740;201307;4825;16968;4221;15672;1687;6801;1010;3579;2697;10380
310750;201307;1534;4127;1293;3799;263;826;801;2347;1064;3173
310760;201307;607;1970;532;1839;142;523;227;774;369;1297
310770;201307;674;2594;667;2583;223;906;345;1348;568;2254
310780;201307;3501;10511;3233;10069;399;1182;2414;7678;2813;8860
310790;201307;1647;5533;1548;5379;490;1755;793;2848;1283;4603
310800;201307;2974;9957;2462;8906;1071;4212;395;1420;1466;5632
310810;201307;1501;4291;1406;4141;363;1200;707;2001;1070;3201
310820;201307;1427;4215;1082;3622;329;1199;356;1134;685;2333
310825;201307;2230;8021;1897;7433;177;893;1406;5460;1583;6353
310830;201307;1486;5154;1261;4692;485;1945;412;1496;897;3441
310840;201307;2154;7423;1981;7069;762;2989;591;1979;1353;4968
310850;201307;1423;4577;1249;4339;246;976;812;2774;1058;3750
310855;201307;2993;10104;2753;9709;783;2899;1427;5222;2210;8121
310860;201307;7561;24515;6851;23315;1222;4414;4059;14213;5281;18627
310870;201307;969;2967;851;2745;208;744;397;1275;605;2019
310880;201307;1225;3894;941;3355;209;846;457;1623;666;2469
310890;201307;2640;8661;2104;7605;669;2715;441;1515;1110;4230
310900;201307;4036;14123;3633;13243;1179;4702;1419;5013;2598;9715
310910;201307;1778;5474;1423;4836;442;1657;385;1282;827;2939
310920;201307;1768;5771;1482;5338;420;1710;707;2537;1127;4247
310925;201307;892;3043;807;2889;322;1262;222;790;544;2052
310930;201307;4696;15147;4155;14275;1036;3682;2334;8204;3370;11886
310940;201307;6090;18619;5343;17478;1037;3825;3053;9898;4090;13723
310945;201307;1241;3641;1007;3316;225;855;555;1768;780;2623
310950;201307;1795;6356;1541;5833;641;2634;417;1510;1058;4144
310960;201307;444;1547;395;1454;141;570;131;486;272;1056
310970;201307;1451;5206;1128;4304;464;1912;144;506;608;2418
310980;201307;436;1177;317;960;62;224;140;378;202;602
310990;201307;1111;3921;976;3658;224;960;377;1325;601;2285
311000;201307;4553;16245;4089;15258;1344;5553;1484;5320;2828;10873
311010;201307;926;3068;820;2869;268;996;369;1260;637;2256
311020;201307;865;2783;750;2587;86;341;517;1774;603;2115
311030;201307;1659;5365;1418;4837;488;1844;518;1581;1006;3425
311040;201307;475;1648;412;1479;123;457;111;390;234;847
311050;201307;2477;8211;2087;7391;692;2678;788;2782;1480;5460
311060;201307;2185;7109;1839;6341;558;2058;426;1431;984;3489
311070;201307;1699;6171;1498;5741;465;1995;472;1789;937;3784
311080;201307;1195;3283;1076;3103;170;555;711;2070;881;2625
311090;201307;1614;6331;1422;5925;525;2452;325;1310;850;3762
311100;201307;2230;8043;2034;7641;959;3744;509;1932;1468;5676
311110;201307;3649;9257;2812;8143;658;2180;1493;4167;2151;6347
311115;201307;1057;3402;923;3194;119;498;629;2210;748;2708
311120;201307;8198;24952;7043;22852;2506;9117;2085;6327;4591;15444
311130;201307;2358;7340;1936;6802;697;2769;780;2621;1477;5390
311140;201307;1205;3610;1043;3411;196;759;703;2237;899;2996
311150;201307;2389;8054;2208;7765;486;1702;1313;4818;1799;6520
311160;201307;4752;16405;4088;15307;1538;6149;1335;4955;2873;11104
311170;201307;730;2354;602;2105;76;302;370;1343;446;1645
311180;201307;1550;4422;1123;3563;355;1238;214;587;569;1825
311190;201307;1083;3360;926;3031;231;858;429;1357;660;2215
311200;201307;2450;7737;2185;7220;975;3515;515;1531;1490;5046
311205;201307;1169;3900;1048;3665;263;1041;395;1453;658;2494
311210;201307;900;2999;836;2896;142;488;606;2154;748;2642
311220;201307;879;2903;715;2530;188;697;251;879;439;1576
311230;201307;8660;27186;7557;25315;1658;6101;4032;13797;5690;19898
311240;201307;1320;4177;1119;3834;395;1508;327;1061;722;2569
311250;201307;1300;4446;1180;4234;380;1483;388;1284;768;2767
311260;201307;2883;8035;2204;6814;718;2430;675;1984;1393;4414
311265;201307;1281;3578;1026;3245;151;592;730;2292;881;2884
311270;201307;3256;11207;2974;10834;608;2551;1946;7006;2554;9557
311280;201307;1346;3839;1043;3308;290;1019;319;975;609;1994
311290;201307;2283;7630;2116;7271;406;1380;1235;4447;1641;5827
311300;201307;4907;16924;4520;16338;737;3046;2980;10793;3717;13839
311310;201307;485;1770;466;1736;106;489;211;723;317;1212
311320;201307;3905;13533;3412;12408;1043;4259;1084;3732;2127;7991
311330;201307;5328;16863;4675;15851;1720;6293;1758;5914;3478;12207
311340;201307;11645;38829;10819;37211;4132;15329;3124;10671;7256;26000
311350;201307;2158;6777;1901;6332;475;1854;872;2782;1347;4636
311360;201307;1293;3753;1033;3397;474;1644;294;992;768;2636
311370;201307;4369;13599;3969;12904;1059;4162;1721;5332;2780;9494
311380;201307;460;1577;396;1450;139;568;116;389;255;957
311390;201307;1905;7244;1826;7072;800;3414;552;2043;1352;5457
311400;201307;1670;5704;1550;5489;482;1930;660;2156;1142;4086
311410;201307;1962;7268;1848;7105;700;2889;822;3169;1522;6058
311420;201307;2182;7871;1998;7416;784;3083;427;1415;1211;4498
311430;201307;3643;11882;2883;10153;699;2710;568;1952;1267;4662
311440;201307;2093;7576;1808;7132;858;3722;446;1723;1304;5445
311450;201307;2347;8542;2101;7990;841;3443;636;2314;1477;5757
311455;201307;1496;4200;1334;3958;290;982;743;2149;1033;3131
311460;201307;593;2021;483;1776;128;585;125;435;253;1020
311470;201307;576;1882;472;1665;146;605;146;479;292;1084
311480;201307;773;2291;749;2252;241;766;350;1011;591;1777
311490;201307;308;1256;298;1218;108;460;99;407;207;867
311500;201307;490;1537;400;1356;178;656;113;370;291;1026
311510;201307;2998;9670;2542;8815;983;3801;667;2170;1650;5971
311520;201307;670;2346;639;2282;257;982;252;875;509;1857
311530;201307;9982;28045;7177;22868;2255;8475;1986;5946;4241;14421
311535;201307;657;2111;502;1787;140;565;123;427;263;992
311540;201307;677;2538;647;2489;233;927;296;1145;529;2072
311545;201307;1964;6662;1911;6577;391;1462;1257;4340;1648;5802
311547;201307;1627;4676;1405;4325;158;525;965;3009;1123;3534
311550;201307;3199;10839;2874;10209;1039;4139;907;3127;1946;7266
311560;201307;251;695;233;674;66;213;128;352;194;565
311570;201307;1913;5032;1684;4785;138;424;1443;4123;1581;4547
311580;201307;2013;4874;1865;4702;539;1316;1111;2871;1650;4187
311590;201307;350;1169;311;1112;88;369;86;301;174;670
311600;201307;1299;3994;1128;3768;236;782;661;2352;897;3134
311610;201307;3614;12641;3352;12225;934;3384;1714;6756;2648;10140
311615;201307;2487;8618;2236;8195;289;1129;1604;5969;1893;7098
311620;201307;435;1446;391;1381;107;449;191;634;298;1083
311630;201307;1443;4392;1244;4007;268;898;687;2216;955;3114
311640;201307;860;2707;733;2499;103;387;552;1880;655;2267
311650;201307;2400;7069;2017;6437;331;1207;1189;3841;1520;5048
311660;201307;2463;8969;2241;8433;707;2992;530;1745;1237;4737
311670;201307;1292;4222;1157;3967;460;1745;432;1403;892;3148
311680;201307;2203;7141;1886;6705;425;1631;1122;4067;1547;5698
311690;201307;489;1410;425;1343;93;334;261;798;354;1132
311700;201307;2104;6378;1905;6093;219;873;1445;4531;1664;5404
311710;201307;1581;5132;1293;4598;574;2212;362;1279;936;3491
311720;201307;385;1354;369;1328;68;254;252;898;320;1152
311730;201307;4332;12477;3063;10167;923;3361;1122;3515;2045;6876
311740;201307;999;2932;873;2783;382;1214;377;1280;759;2494
311750;201307;3729;13013;3509;12712;616;2500;2377;8622;2993;11122
311760;201307;782;2768;730;2646;266;1111;214;642;480;1753
311770;201307;2562;8312;2153;7606;656;2609;723;2465;1379;5074
311780;201307;932;3620;809;3292;291;1322;107;419;398;1741
311783;201307;2020;6827;1817;6439;214;939;1194;4330;1408;5269
311787;201307;671;2353;519;1917;121;474;116;380;237;854
311790;201307;1158;3924;980;3534;305;1182;200;690;505;1872
311800;201307;3831;13558;2866;10471;940;3670;425;1297;1365;4967
311810;201307;1012;3476;990;3438;38;182;899;3086;937;3268
311820;201307;803;2705;690;2448;241;969;301;975;542;1944
311830;201307;10077;37194;9392;35456;4027;15971;2185;8168;6212;24139
311840;201307;3334;10218;2858;9485;1019;3698;1012;3274;2031;6972
311850;201307;305;950;264;884;72;262;122;401;194;663
311860;201307;54072;179018;48615;168245;15397;58055;20060;67558;35457;125613
311870;201307;2247;6944;1875;6236;515;1964;666;2100;1181;4064
311880;201307;6594;21260;6148;20682;896;3142;4488;15557;5384;18699
311890;201307;1560;5079;1342;4625;445;1696;526;1745;971;3441
311900;201307;782;2500;706;2388;158;551;423;1494;581;2045
311910;201307;4609;14065;3799;12911;1232;4567;1505;5172;2737;9739
311920;201307;1959;6693;1724;6360;241;1013;1217;4456;1458;5469
311930;201307;4632;14409;4210;13714;1608;5689;1369;4433;2977;10122
311940;201307;13456;42771;12022;39829;4393;15819;3411;11081;7804;26900
311950;201307;2163;6767;1917;6448;166;585;1581;5358;1747;5943
311960;201307;359;1301;331;1240;118;473;118;427;236;900
311970;201307;453;1682;402;1577;157;670;67;241;224;911
311980;201307;725;2075;570;1852;135;467;263;881;398;1348
311990;201307;455;1458;426;1406;180;607;149;484;329;1091
311995;201307;996;3139;787;2690;245;940;233;697;478;1637
312000;201307;662;2149;636;2110;123;474;372;1222;495;1696
312010;201307;1008;3323;934;3186;205;763;432;1476;637;2239
312015;201307;1535;4920;1344;4589;208;840;825;2828;1033;3668
312020;201307;889;2978;799;2849;231;919;411;1424;642;2343
312030;201307;1700;5391;1544;5188;335;1250;1012;3338;1347;4588
312040;201307;681;2682;633;2549;248;1085;176;692;424;1777
312050;201307;1470;5185;1283;4785;478;1965;345;1242;823;3207
312060;201307;782;2449;710;2363;235;864;388;1243;623;2107
312070;201307;887;2838;605;2216;182;734;209;737;391;1471
312080;201307;2542;7345;2029;6511;527;2065;919;2658;1446;4723
312083;201307;877;2693;753;2512;96;371;485;1607;581;1978
312087;201307;2216;7104;2006;6827;405;1466;1338;4621;1743;6087
312090;201307;9513;31812;8813;30577;2745;10638;3791;12592;6536;23230
312100;201307;1334;4639;1199;4430;272;1127;657;2485;929;3612
312110;201307;1149;4225;1041;3994;403;1688;203;715;606;2403
312120;201307;882;3144;802;2962;266;1119;204;650;470;1769
312125;201307;1115;3722;996;3445;270;1031;400;1343;670;2374
312130;201307;731;2340;615;2097;178;682;227;737;405;1419
312140;201307;1392;4489;1195;4022;319;1129;427;1376;746;2505
312150;201307;589;1739;527;1630;101;369;304;890;405;1259
312160;201307;7732;27602;7214;26528;2403;9598;2779;10444;5182;20042
312170;201307;1000;3123;925;2975;164;573;579;1893;743;2466
312180;201307;1526;4968;1458;4863;493;1700;583;1975;1076;3675
312190;201307;618;2119;502;1894;214;896;96;339;310;1235
312200;201307;4410;14069;3907;13147;576;2076;2602;8805;3178;10881
312210;201307;1113;3202;918;2929;247;890;443;1359;690;2249
312220;201307;1812;6146;1652;5958;299;1092;1168;4414;1467;5506
312230;201307;17022;58877;14784;54169;7243;28129;2645;9999;9888;38128
312235;201307;1733;5085;1438;4610;203;786;960;3084;1163;3870
312240;201307;1086;3811;943;3507;294;1168;319;1186;613;2354
312245;201307;2309;6951;2031;6567;176;513;1666;5537;1842;6050
312247;201307;864;2661;695;2408;216;801;340;1224;556;2025
312250;201307;1079;3349;993;3207;207;759;543;1721;750;2480
312260;201307;874;2990;768;2848;115;524;539;1969;654;2493
312270;201307;772;2536;675;2340;188;786;217;630;405;1416
312280;201307;462;1617;423;1516;183;706;44;153;227;859
312290;201307;698;2505;654;2445;309;1281;127;471;436;1752
312300;201307;1046;3572;909;3258;311;1179;132;416;443;1595
312310;201307;910;3603;830;3391;279;1231;336;1347;615;2578
312320;201307;2380;6822;2009;6158;591;2076;618;1622;1209;3698
312330;201307;1077;3441;994;3309;371;1386;400;1307;771;2693
312340;201307;301;814;283;790;54;200;194;492;248;692
312350;201307;360;966;344;943;52;169;272;710;324;879
312352;201307;1581;5401;1488;5264;506;1831;780;2830;1286;4661
312360;201307;3549;12370;3131;11476;1088;4273;722;2627;1810;6900
312370;201307;1608;5432;1495;5228;518;2024;547;1835;1065;3859
312380;201307;1875;5742;1772;5590;284;981;1192;3853;1476;4834
312385;201307;1138;3751;1098;3678;156;631;781;2536;937;3167
312390;201307;1968;6849;1750;6402;611;2398;429;1530;1040;3928
312400;201307;3260;11212;3050;10814;1044;3829;1401;5106;2445;8935
312410;201307;10063;34920;9142;33017;3020;11860;3030;10701;6050;22561
312420;201307;3883;12944;3712;12742;690;2450;2605;9174;3295;11624
312430;201307;8242;25477;7316;24087;1492;5163;4528;15441;6020;20604
312440;201307;534;1836;475;1721;173;673;168;590;341;1263
312450;201307;1103;4252;1049;4119;503;1973;333;1333;836;3306
312460;201307;380;1211;339;1160;92;369;159;505;251;874
312470;201307;720;2111;500;1661;147;568;96;301;243;869
312480;201307;1247;4014;1090;3826;425;1563;444;1545;869;3108
312490;201307;2290;6128;1841;5543;296;1070;1105;3217;1401;4287
312500;201307;576;2112;544;2054;161;687;266;988;427;1675
312510;201307;1794;6480;1609;6041;491;2090;498;1676;989;3766
312520;201307;359;1293;331;1232;121;476;111;419;232;895
312530;201307;554;1885;528;1828;112;457;285;933;397;1390
312540;201307;1434;4791;1212;4335;244;967;694;2445;938;3412
312550;201307;584;1989;548;1904;78;311;343;1160;421;1471
312560;201307;2008;5645;1806;5383;269;832;1306;3987;1575;4819
312570;201307;2604;8309;2324;7782;790;2869;687;2219;1477;5088
312580;201307;515;1778;422;1587;115;501;173;613;288;1114
312590;201307;1790;6293;1588;5844;571;2348;526;1787;1097;4135
312595;201307;1982;6952;1803;6523;382;1495;1013;3622;1395;5117
312600;201307;738;2779;695;2679;231;987;248;896;479;1883
312610;201307;8272;26750;7191;24590;2778;10238;2042;6760;4820;16998
312620;201307;1927;5848;1525;5348;108;354;1262;4617;1370;4971
312630;201307;488;1682;459;1630;130;532;200;668;330;1200
312640;201307;561;1893;477;1713;118;494;199;664;317;1158
312650;201307;2295;7033;1668;5823;197;810;877;3036;1074;3846
312660;201307;1190;3466;1033;3254;217;809;612;1867;829;2676
312670;201307;5811;18818;5487;18304;1004;3913;3562;11719;4566;15632
312675;201307;1425;4669;1296;4413;280;1036;706;2437;986;3473
312680;201307;1681;5258;1507;4953;275;1033;888;2953;1163;3986
312690;201307;2338;6609;1981;6121;418;1525;1108;3270;1526;4795
312695;201307;865;3174;816;3100;140;558;548;2130;688;2688
312700;201307;2094;6310;1621;5385;352;1339;811;2634;1163;3973
312705;201307;1354;4165;1209;3969;219;736;805;2681;1024;3417
312707;201307;1789;5675;1521;5213;341;1319;748;2569;1089;3888
312710;201307;7716;22666;5940;19498;2402;8765;1412;4300;3814;13065
312720;201307;730;2507;665;2387;204;812;261;879;465;1691
312730;201307;1825;4810;1434;4374;233;842;902;2749;1135;3591
312733;201307;1727;4802;1406;4223;133;502;984;2852;1117;3354
312735;201307;832;2662;745;2509;263;940;321;1071;584;2011
312737;201307;972;2458;720;2115;168;516;393;1208;561;1724
312738;201307;494;1640;407;1476;145;614;151;491;296;1105
312740;201307;485;1424;336;1223;129;516;94;337;223;853
312750;201307;1266;4766;1217;4664;337;1428;571;2179;908;3607
312760;201307;2303;7774;1900;7004;657;2675;457;1703;1114;4378
312770;201307;42264;120161;33503;107080;10441;36249;11052;35408;21493;71657
312780;201307;2403;9109;2175;8723;472;2077;1275;5258;1747;7335
312790;201307;298;889;243;798;81;285;66;208;147;493
312800;201307;4868;17271;4358;16190;1487;5934;1382;5225;2869;11159
312810;201307;2129;6728;1659;5956;650;2554;419;1434;1069;3988
312820;201307;2026;6336;1937;6179;280;1057;1259;3885;1539;4942
312825;201307;1487;4178;1326;3977;138;454;1063;3169;1201;3623
312830;201307;2586;8526;1935;7221;644;2716;256;885;900;3601
312840;201307;1088;3776;934;3463;265;1115;317;1120;582;2235
312850;201307;668;2275;597;2121;181;711;196;685;377;1396
312860;201307;1304;3847;1021;3430;365;1449;385;1130;750;2579
312870;201307;5476;17704;4338;15574;1388;5649;1216;4141;2604;9790
312880;201307;1102;3417;934;3129;301;1149;377;1151;678;2300
312890;201307;1504;4798;1215;4272;472;1843;376;1267;848;3110
312900;201307;1290;4530;1258;4487;472;1709;582;2134;1054;3843
312910;201307;1448;3486;1185;3136;330;1052;556;1352;886;2404
312920;201307;947;3177;841;3013;300;1177;330;1151;630;2328
312930;201307;2124;6559;1919;6249;455;1586;1008;3354;1463;4940
312940;201307;903;3136;810;2951;248;1053;247;835;495;1888
312950;201307;3370;9832;2776;8949;986;3457;1125;3629;2111;7086
312960;201307;1848;5839;1664;5590;225;771;1235;4252;1460;5023
312965;201307;1699;5716;1498;5350;363;1393;812;2971;1175;4364
312970;201307;1120;3922;1009;3771;458;1908;171;639;629;2547
312980;201307;19928;72160;19311;70667;7822;30511;7159;25560;14981;56071
312990;201307;362;1166;291;1043;116;474;84;284;200;758
313000;201307;493;1746;456;1678;154;660;133;441;287;1101
313005;201307;2473;8377;2215;7940;332;1375;1513;5397;1845;6772
313010;201307;3820;13215;3455;12590;1127;4541;1379;4723;2506;9264
313020;201307;1011;3491;933;3333;316;1294;336;1063;652;2357
313030;201307;1533;4462;1254;4066;352;1282;653;2022;1005;3304
313040;201307;942;3375;802;2966;213;870;206;725;419;1595
313050;201307;1786;6049;1522;5619;523;2118;500;1766;1023;3884
313055;201307;1409;4925;1328;4804;140;502;1014;3794;1154;4296
313060;201307;909;3262;864;3163;429;1611;149;555;578;2166
313065;201307;1853;6388;1739;6219;256;1078;1280;4506;1536;5584
313070;201307;1141;3546;982;3255;261;1043;515;1585;776;2628
313080;201307;437;1446;366;1305;122;497;97;281;219;778
313090;201307;5007;15895;4785;15508;871;3057;3173;10419;4044;13476
313100;201307;1019;3410;961;3328;179;727;651;2173;830;2900
313110;201307;1623;5031;1311;4438;343;1388;531;1661;874;3049
313115;201307;2827;10288;2711;10053;953;3917;1164;4078;2117;7995
313120;201307;3737;11061;3217;10285;1187;4013;1303;4241;2490;8254
313130;201307;25317;83243;23169;78723;7214;27186;8471;27328;15685;54514
313140;201307;741;1980;549;1671;59;224;341;1016;400;1240
313150;201307;1614;5191;1470;4931;659;2282;408;1419;1067;3701
313160;201307;1157;3566;1048;3399;249;945;594;1835;843;2780
313170;201307;9353;35414;8814;34025;3693;14850;1932;7530;5625;22380
313180;201307;2631;7146;2065;6421;683;2399;705;2137;1388;4536
313190;201307;3315;12592;3215;12359;969;3932;1379;5345;2348;9277
313200;201307;1441;4698;1302;4474;209;880;816;2784;1025;3664
313210;201307;4483;14664;3866;13821;958;3828;2062;7327;3020;11155
313220;201307;1118;3593;955;3269;289;1130;238;714;527;1844
313230;201307;2391;8796;2301;8643;438;1735;1434;5592;1872;7327
313240;201307;7440;26715;6601;25042;2088;8610;2572;9758;4660;18368
313250;201307;7489;24435;6995;23764;932;3099;5101;18078;6033;21177
313260;201307;563;1854;485;1698;157;625;133;446;290;1071
313270;201307;5247;16230;4809;15567;1040;3534;2979;9821;4019;13355
313280;201307;510;1778;443;1619;114;483;163;573;277;1056
313290;201307;1027;3808;881;3501;299;1277;221;815;520;2092
313300;201307;1912;6729;1707;6239;567;2249;453;1568;1020;3817
313310;201307;1029;3721;948;3542;290;1221;222;781;512;2002
313320;201307;2321;7327;2001;6756;472;1680;855;2920;1327;4600
313330;201307;3751;12956;3436;12344;784;3170;1727;6222;2511;9392
313340;201307;2131;5278;1677;4636;373;1111;950;2557;1323;3668
313350;201307;3268;10460;2595;8965;780;2952;530;1648;1310;4600
313360;201307;1155;3668;907;3167;330;1335;356;1104;686;2439
313370;201307;1413;5076;1351;4903;307;1276;593;2010;900;3286
313375;201307;1861;5166;1311;4399;299;1229;633;2067;932;3296
313380;201307;6451;22799;5684;21112;2392;9496;1439;5057;3831;14553
313390;201307;883;3331;848;3269;143;659;540;2039;683;2698
313400;201307;3618;11095;3351;10770;437;1496;2563;8327;3000;9823
313410;201307;1351;3992;1164;3738;257;917;704;2244;961;3161
313420;201307;18328;47048;12168;35851;3147;10577;3221;9053;6368;19630
313430;201307;1278;4297;1160;4090;386;1514;416;1425;802;2939
313440;201307;6282;15576;4867;13941;816;2542;3420;9829;4236;12371
313450;201307;682;2087;581;1896;164;658;201;574;365;1232
313460;201307;2624;9562;2386;9143;911;3779;728;2652;1639;6431
313470;201307;3349;9645;3209;9483;378;1032;2631;7976;3009;9008
313480;201307;1114;3414;861;2951;187;727;364;1207;551;1934
313490;201307;1234;4608;1064;4237;470;1836;199;823;669;2659
313500;201307;426;1398;404;1358;104;403;233;760;337;1163
313505;201307;8519;25880;8055;25305;562;1416;7079;23015;7641;24431
313507;201307;1277;3975;1158;3791;273;1011;658;2170;931;3181
313510;201307;15449;47484;14014;45679;2637;9036;9545;31711;12182;40747
313520;201307;15585;48741;13590;45572;2044;8000;9124;30458;11168;38458
313530;201307;513;1834;455;1686;68;292;204;715;272;1007
313535;201307;2426;7558;2199;7188;404;1418;1369;4549;1773;5967
313540;201307;1135;3656;937;3177;288;1047;258;817;546;1864
313545;201307;1354;5098;1212;4848;237;1115;752;2922;989;4037
313550;201307;1889;6670;1827;6536;520;2033;968;3332;1488;5365
313560;201307;2223;5715;1990;5447;212;569;1592;4494;1804;5063
313570;201307;762;2926;686;2772;271;1185;257;1011;528;2196
313580;201307;5943;17560;5333;16753;681;2286;4059;12870;4740;15156
313590;201307;1053;3261;871;3047;339;1195;458;1668;797;2863
313600;201307;3817;11921;3422;11290;705;2604;2043;6784;2748;9388
313610;201307;1132;3641;982;3341;283;1047;397;1331;680;2378
313620;201307;7369;25224;6961;24345;2445;9113;2337;8036;4782;17149
313630;201307;8149;26526;7263;25226;2420;9192;2511;9050;4931;18242
313640;201307;834;2728;742;2606;276;1042;293;1025;569;2067
313650;201307;2265;7590;2025;7194;305;1132;1459;5305;1764;6437
313652;201307;990;3650;915;3484;179;728;550;2102;729;2830
313655;201307;927;3224;797;3009;188;823;498;1834;686;2657
313657;201307;1065;3798;1023;3726;191;905;664;2210;855;3115
313660;201307;856;3093;794;2984;227;987;399;1425;626;2412
313665;201307;3539;12127;3334;11707;921;3652;1542;5195;2463;8847
313670;201307;50862;152891;37297;130089;12874;48875;11583;39458;24457;88333
313680;201307;1081;3315;962;3140;131;448;678;2242;809;2690
313690;201307;884;3261;832;3172;244;937;338;1359;582;2296
313695;201307;1467;4978;1276;4671;200;860;896;3243;1096;4103
313700;201307;3717;12944;3237;12258;473;1904;2337;8931;2810;10835
313710;201307;1364;3956;1169;3677;371;1298;576;1737;947;3035
313720;201307;5032;17553;4492;16340;1309;5333;1421;4681;2730;10014
313730;201307;1224;3544;1010;3271;150;532;677;2221;827;2753
313740;201307;2011;7482;1675;6579;656;2891;234;855;890;3746
313750;201307;2873;9057;2560;8460;861;3112;698;2135;1559;5247
313753;201307;1762;5531;1540;5138;498;1793;626;2102;1124;3895
313760;201307;4418;15153;3852;13939;1384;5558;1157;3959;2541;9517
313770;201307;3578;12366;3423;12011;1266;4697;1033;3644;2299;8341
313780;201307;3754;11184;3083;10172;924;3424;1263;4089;2187;7513
313790;201307;547;1953;531;1926;111;431;311;1140;422;1571
313800;201307;1243;3620;1117;3414;190;673;695;2107;885;2780
313810;201307;1415;4567;1368;4493;292;998;846;2829;1138;3827
313820;201307;12607;38202;10476;34299;3397;12298;3425;11201;6822;23499
313830;201307;464;1658;400;1518;154;658;108;388;262;1046
313835;201307;1058;3645;1021;3583;241;923;558;1956;799;2879
313840;201307;7056;22246;6172;20787;1943;7366;2157;7010;4100;14376
313850;201307;1233;3552;1132;3374;252;887;655;1856;907;2743
313860;201307;2528;8170;2239;7570;730;2738;548;1685;1278;4423
313862;201307;931;2747;689;2345;236;867;190;618;426;1485
313865;201307;2173;7118;2042;6890;317;1227;1439;4784;1756;6011
313867;201307;972;3471;841;3194;286;1142;291;1126;577;2268
313868;201307;1481;5460;1363;5214;201;864;886;3422;1087;4286
313870;201307;911;2885;808;2714;220;864;357;1117;577;1981
313880;201307;2238;7332;2051;7060;508;2072;1042;3302;1550;5374
313890;201307;1944;5524;1681;5195;294;908;1094;3471;1388;4379
313900;201307;4508;16987;4270;16485;1756;7442;1145;4401;2901;11843
313910;201307;751;2619;649;2398;290;1177;130;440;420;1617
313920;201307;3513;11721;3286;11312;512;1751;2187;7906;2699;9657
313925;201307;2089;5723;1588;4809;147;521;1066;3202;1213;3723
313930;201307;5124;17478;4428;16263;863;3516;2591;9685;3454;13201
313940;201307;7673;27537;6739;26010;2657;10946;2349;9361;5006;20307
313950;201307;4607;13995;3944;12899;1244;4574;1392;4408;2636;8982
313960;201307;5749;16348;4883;15121;1715;5968;1317;4078;3032;10046
313970;201307;1440;4359;1228;4118;271;991;764;2572;1035;3563
313980;201307;1173;4013;1016;3715;326;1343;271;943;597;2286
313990;201307;1991;7717;1803;7293;702;3075;517;1972;1219;5047
314000;201307;7604;27374;7133;26445;2227;9004;3525;12991;5752;21995
314010;201307;1034;3138;872;2935;184;724;450;1452;634;2176
314015;201307;1576;6037;1461;5770;572;2376;427;1709;999;4085
314020;201307;482;1603;416;1456;158;612;129;427;287;1039
314030;201307;815;2695;653;2315;153;636;207;665;360;1301
314040;201307;658;2019;585;1890;185;644;294;905;479;1549
314050;201307;1862;6244;1574;5638;512;2052;430;1403;942;3455
314053;201307;1355;4787;1298;4711;245;850;917;3444;1162;4294
314055;201307;2195;6738;1989;6451;224;739;1490;4963;1714;5702
314060;201307;1068;3524;936;3282;149;613;568;1961;717;2574
314070;201307;3584;11879;2981;10628;953;3761;839;2878;1792;6639
314080;201307;1768;5708;1339;4781;330;1323;332;1087;662;2410
314085;201307;1769;6483;1566;6199;549;2416;600;2393;1149;4809
314090;201307;3440;12097;3164;11560;1062;4184;1217;4538;2279;8722
314100;201307;3377;9477;2985;8907;411;1253;2217;6734;2628;7987
314110;201307;4327;14720;3835;13664;1053;4319;1460;4809;2513;9128
314120;201307;965;2392;554;1758;209;765;138;401;347;1166
314130;201307;639;1955;421;1450;124;483;83;258;207;741
314140;201307;4923;15932;4507;15162;1122;4086;2358;7999;3480;12085
314150;201307;1666;4620;1354;4154;234;808;831;2520;1065;3328
314160;201307;2225;6365;1922;5978;195;678;1551;4843;1746;5521
314170;201307;1032;3340;899;3051;180;718;482;1556;662;2274
314180;201307;6331;21164;5824;20405;1716;6560;2678;9543;4394;16103
314190;201307;803;2615;714;2466;230;905;279;925;509;1830
314200;201307;2989;10023;2743;9581;472;1879;1823;6285;2295;8164
314210;201307;1886;6223;1714;5888;460;1705;816;2727;1276;4432
314220;201307;1619;5553;1436;5157;508;2005;427;1366;935;3371
314225;201307;1155;3656;1046;3502;68;185;939;3219;1007;3404
314230;201307;698;2488;650;2389;214;844;230;822;444;1666
314240;201307;1094;3596;1002;3444;253;846;602;2145;855;2991
314250;201307;498;1609;430;1475;161;610;138;427;299;1037
314260;201307;1285;4751;1239;4658;439;1748;510;1953;949;3701
314270;201307;2673;9579;2529;9313;383;1542;1655;6154;2038;7696
314280;201307;3137;9294;2348;7795;770;2937;662;1938;1432;4875
314290;201307;5241;15315;4551;14223;628;2156;3223;10096;3851;12252
314300;201307;1895;6614;1793;6372;646;2458;696;2413;1342;4871
314310;201307;6220;20742;5581;19354;2394;8818;1227;4139;3621;12957
314315;201307;960;3736;895;3608;162;734;518;2125;680;2859
314320;201307;3231;10230;2717;9507;1045;3981;887;3031;1932;7012
314330;201307;50873;171087;48596;166917;15984;59514;21885;74324;37869;133838
314340;201307;2157;6252;1292;4436;351;1372;160;370;511;1742
314345;201307;1278;4509;1144;4293;387;1494;539;2125;926;3619
314350;201307;1235;4009;1086;3742;489;1817;273;920;762;2737
314360;201307;689;2249;535;1959;176;755;130;431;306;1186
314370;201307;543;1985;511;1942;170;705;256;955;426;1660
314380;201307;992;3202;808;2894;338;1268;227;817;565;2085
314390;201307;14766;46403;12551;42120;4288;15595;3751;12355;8039;27950
314400;201307;5252;15316;4357;14068;1183;3763;2652;8940;3835;12703
314410;201307;2435;8231;2202;7765;728;2874;858;2848;1586;5722
314420;201307;754;2274;627;2096;97;397;462;1514;559;1911
314430;201307;8070;24750;7276;23281;2564;8959;2261;7398;4825;16357
314435;201307;1123;3906;1020;3689;226;1006;543;1855;769;2861
314437;201307;1139;3019;1033;2870;102;290;813;2270;915;2560
314440;201307;738;2075;519;1787;201;772;115;374;316;1146
314450;201307;1704;5225;1473;4890;479;1874;677;2088;1156;3962
314460;201307;4530;16183;4081;15189;1483;6000;796;2990;2279;8990
314465;201307;2338;7708;2150;7358;238;973;1616;5449;1854;6422
314467;201307;1062;3204;960;3036;424;1382;358;1164;782;2546
314470;201307;2316;7831;1836;6664;583;2417;396;1195;979;3612
314480;201307;7087;25174;5494;20802;1466;6006;585;2033;2051;8039
314490;201307;923;2941;804;2702;253;989;325;1016;578;2005
314500;201307;2738;7997;2229;7000;720;2517;745;2316;1465;4833
314505;201307;1715;5600;1634;5445;415;1520;898;2974;1313;4494
314510;201307;1448;4762;1253;4406;541;2001;344;1203;885;3204
314520;201307;3490;14059;3062;12798;1208;5459;583;2258;1791;7717
314530;201307;7109;25989;6557;25074;1267;5082;3957;15647;5224;20729
314535;201307;2637;7903;2376;7559;374;1359;1588;5065;1962;6424
314537;201307;1419;4442;1208;4070;272;1019;601;2107;873;3126
314540;201307;462;1446;405;1317;128;476;129;391;257;867
314545;201307;1286;4320;1193;4170;270;1040;637;2234;907;3274
314550;201307;504;1634;429;1524;156;643;111;371;267;1014
314560;201307;5163;18864;4512;17114;1372;5660;980;3676;2352;9336
314570;201307;372;1201;336;1128;102;369;157;507;259;876
314580;201307;454;1609;395;1491;164;683;99;359;263;1042
314585;201307;649;2370;547;2158;175;755;141;541;316;1296
314587;201307;1678;5610;1554;5352;273;1024;894;3072;1167;4096
314590;201307;4111;14618;3104;11840;827;3383;412;1437;1239;4820
314600;201307;2025;7157;1708;6591;666;2874;303;1074;969;3948
314610;201307;7987;29539;7545;28481;2699;10978;2302;8457;5001;19435
314620;201307;1617;5111;1517;4986;229;733;1129;3828;1358;4561
314625;201307;1447;4815;1409;4760;224;833;933;3208;1157;4041
314630;201307;4934;15173;4341;14185;652;2399;2945;9771;3597;12170
314640;201307;805;2416;714;2255;264;904;214;637;478;1541
314650;201307;1234;3911;1022;3491;288;1151;433;1332;721;2483
314655;201307;1670;5127;1338;4505;259;951;703;2362;962;3313
314660;201307;161;472;144;435;25;86;90;267;115;353
314670;201307;1385;4034;1163;3644;231;799;637;1976;868;2775
314675;201307;1882;5912;1686;5567;237;868;1106;3715;1343;4583
314690;201307;2715;8860;2321;8141;747;2970;699;2280;1446;5250
314700;201307;9702;37966;8836;36144;4249;18126;1967;8459;6216;26585
314710;201307;7799;26121;5731;21371;1570;6575;738;2543;2308;9118
314720;201307;2594;8956;2207;8191;752;3091;895;3254;1647;6345
314730;201307;2386;7770;2078;7321;724;2842;664;2240;1388;5082
314740;201307;2918;10204;2714;9812;935;3641;1008;3537;1943;7178
314750;201307;316;1083;294;1031;65;284;155;513;220;797
314760;201307;1801;6623;1416;5555;351;1581;263;859;614;2440
314770;201307;1170;3835;793;2792;142;585;108;305;250;890
314780;201307;289;837;221;750;79;292;89;304;168;596
314790;201307;13199;41618;10226;36268;4206;16829;2392;7936;6598;24765
314795;201307;1502;4703;1350;4460;154;676;1019;3220;1173;3896
314800;201307;16741;52627;14204;47586;6029;21253;2912;10009;8941;31262
314810;201307;12565;39224;9992;34445;3376;13105;2487;8448;5863;21553
314820;201307;1071;3095;769;2673;317;1210;233;737;550;1947
314830;201307;1632;5754;1438;5366;561;2284;492;1832;1053;4116
314840;201307;1133;4055;910;3717;189;891;533;2183;722;3074
314850;201307;2174;6568;1907;6152;411;1528;1049;3354;1460;4882
314860;201307;3244;11569;3021;11216;607;2470;1869;6992;2476;9462
314870;201307;5569;18714;5038;17966;885;3535;3354;12185;4239;15720
314875;201307;1635;5810;1605;5766;275;920;1248;4602;1523;5522
314880;201307;762;2366;699;2239;102;354;461;1469;563;1823
314890;201307;580;1842;427;1527;137;541;98;296;235;837
314900;201307;384;1237;313;1118;90;349;153;536;243;885
314910;201307;1652;5923;1485;5658;689;2854;364;1301;1053;4155
314915;201307;2412;7781;2162;7431;218;910;1768;6034;1986;6944
314920;201307;648;1945;493;1717;100;403;243;798;343;1201
314930;201307;4966;17451;4399;16198;1623;6558;928;3362;2551;9920
314940;201307;411;1247;388;1205;87;269;214;666;301;935
314950;201307;361;1318;320;1225;102;446;59;197;161;643
314960;201307;760;2572;652;2353;209;827;174;590;383;1417
314970;201307;813;3016;725;2803;315;1323;212;783;527;2106
314980;201307;2200;6895;2014;6590;863;3027;303;946;1166;3973
314990;201307;3055;10122;2501;8839;989;3798;404;1286;1393;5084
314995;201307;1480;4891;1370;4730;297;1221;845;2782;1142;4003
315000;201307;965;3044;844;2880;170;691;528;1751;698;2442
315010;201307;466;1567;399;1418;140;578;140;436;280;1014
315015;201307;1759;5667;1665;5557;346;1216;1145;3934;1491;5150
315020;201307;728;2478;662;2352;200;815;258;818;458;1633
315030;201307;998;3135;868;2894;353;1286;174;570;527;1856
315040;201307;916;2902;849;2793;113;421;604;1967;717;2388
315050;201307;1509;4737;1311;4387;499;1831;381;1223;880;3054
315053;201307;1100;3311;954;3078;272;1065;355;1053;627;2118
315057;201307;1859;6604;1544;6129;245;1007;1007;4137;1252;5144
315060;201307;938;3249;785;2844;248;976;198;746;446;1722
315070;201307;625;1927;582;1863;147;509;351;1103;498;1612
315080;201307;3354;12010;3095;11481;929;3685;1394;5191;2323;8876
315090;201307;743;2746;665;2585;191;807;222;901;413;1708
315100;201307;1151;4093;943;3620;275;1188;275;1023;550;2211
315110;201307;1598;4993;1420;4701;420;1496;593;1943;1013;3439
315120;201307;12867;32556;9768;28587;1970;6301;5269;16298;7239;22599
315130;201307;1736;5906;1583;5607;617;2413;435;1506;1052;3919
315140;201307;2308;7987;1929;7123;575;2462;526;1686;1101;4148
315150;201307;4487;12872;3532;11148;945;3422;1348;4067;2293;7489
315160;201307;1334;3863;1213;3704;243;838;729;2180;972;3018
315170;201307;1315;4070;1155;3852;298;1108;636;2150;934;3258
315180;201307;12770;41430;10370;36253;3250;12912;2620;8739;5870;21651
315190;201307;2334;6441;1910;5822;608;2001;850;2595;1458;4596
315200;201307;4200;14649;3647;13467;1210;4889;1012;3607;2222;8496
315210;201307;8160;26236;7222;24545;2883;10516;2153;7179;5036;17695
315213;201307;1079;3630;1046;3576;110;353;859;3031;969;3384
315217;201307;2607;9205;2263;8587;396;1682;1334;5076;1730;6758
315220;201307;9816;30148;8850;28872;1329;4732;6236;20555;7565;25287
315230;201307;2315;6505;2167;6331;147;429;1865;5526;2012;5955
315240;201307;3031;10454;2890;10213;649;2505;1692;5958;2341;8463
315250;201307;8192;27818;6587;24837;2412;10148;2087;7780;4499;17928
315260;201307;1047;3599;912;3289;373;1468;151;494;524;1962
315270;201307;862;3139;752;2898;260;1076;163;590;423;1666
315280;201307;3783;12034;3173;10655;1176;4184;806;2564;1982;6748
315290;201307;1307;3830;1033;3396;419;1529;172;548;591;2077
315300;201307;474;1431;388;1323;205;742;103;323;308;1065
315310;201307;1168;4051;1090;3927;151;619;740;2635;891;3254
315320;201307;796;2817;695;2672;252;1022;285;1151;537;2173
315330;201307;830;3059;683;2743;299;1359;111;418;410;1777
315340;201307;4099;12213;3567;11391;704;2412;2095;6810;2799;9222
315350;201307;1800;5293;1540;4937;174;523;1219;4059;1393;4582
315360;201307;1657;5764;1409;5095;367;1410;472;1637;839;3047
315370;201307;609;1876;541;1775;137;511;294;935;431;1446
315380;201307;271;994;254;944;96;373;48;176;144;549
315390;201307;1919;6947;1664;6320;618;2507;347;1310;965;3817
315400;201307;4302;14020;4001;13432;1183;4227;1906;6565;3089;10792
315410;201307;1644;4749;1399;4333;294;1106;767;2250;1061;3356
315415;201307;1029;3627;968;3516;421;1561;384;1435;805;2996
315420;201307;1502;4821;1156;4200;368;1466;268;928;636;2394
315430;201307;3908;11047;3084;9683;811;2856;1182;3646;1993;6502
315440;201307;947;2986;875;2889;157;602;556;1841;713;2443
315445;201307;2052;6244;1788;5891;294;1080;1244;4133;1538;5213
315450;201307;2459;8100;2348;7938;454;1585;1594;5529;2048;7114
315460;201307;37510;129153;33747;120993;11592;45168;9690;33489;21282;78657
315470;201307;471;1548;440;1495;94;338;257;863;351;1201
315480;201307;1210;4068;920;3403;222;911;223;777;445;1688
315490;201307;3202;9362;2823;8852;543;2064;1727;5210;2270;7274
315500;201307;458;1519;317;1158;79;343;130;409;209;752
315510;201307;1446;4341;1256;4020;184;722;786;2449;970;3171
315520;201307;1124;3689;965;3482;192;785;632;2220;824;3005
315530;201307;475;1721;451;1682;221;876;133;470;354;1346
315540;201307;1258;3893;1001;3456;222;942;374;1242;596;2184
315550;201307;1610;4893;1416;4636;480;1727;622;2014;1102;3741
315560;201307;6827;23513;6372;22884;995;3992;4340;15594;5335;19586
315570;201307;2346;7577;2218;7389;388;1431;1496;5010;1884;6441
315580;201307;2594;8316;2143;7450;650;2642;767;2495;1417;5137
315590;201307;862;2586;809;2504;118;441;587;1791;705;2232
315600;201307;2513;9405;2146;8840;341;1533;1400;6002;1741;7535
315610;201307;951;2955;836;2709;232;881;280;768;512;1649
315620;201307;335;1208;329;1194;108;411;152;559;260;970
315630;201307;980;3214;845;2980;243;904;229;789;472;1693
315640;201307;731;2394;642;2204;242;952;191;600;433;1552
315645;201307;790;2667;704;2443;279;1067;150;488;429;1555
315650;201307;1794;5580;1691;5446;166;694;1306;4092;1472;4786
315660;201307;2584;7328;2376;7038;412;1358;1569;4600;1981;5958
315670;201307;11223;41181;10380;39476;4011;16401;3261;12108;7272;28509
315680;201307;2817;10143;2348;9220;926;3803;589;2439;1515;6242
315690;201307;2969;9953;2557;9189;969;3823;687;2440;1656;6263
315700;201307;6904;23083;6208;21637;1499;5933;3011;10062;4510;15995
315710;201307;1807;5558;1493;5055;242;982;861;2862;1103;3844
315720;201307;2860;9940;2653;9505;845;3417;940;3121;1785;6538
315725;201307;1579;5047;1307;4701;316;1126;848;3123;1164;4249
315727;201307;642;2107;585;1987;143;518;302;1025;445;1543
315730;201307;969;3136;878;2947;256;905;412;1423;668;2328
315733;201307;1107;3649;1023;3466;468;1677;314;1042;782;2719
315737;201307;1340;4272;1157;3962;169;656;727;2502;896;3158
315740;201307;1010;3362;881;3107;276;1112;351;1149;627;2261
315750;201307;1099;3427;989;3277;120;480;708;2282;828;2762
315760;201307;870;2652;857;2631;36;106;792;2454;828;2560
315765;201307;1416;4630;1330;4485;188;659;982;3380;1170;4039
315770;201307;1629;5339;1498;5058;469;1723;555;1811;1024;3534
315780;201307;26440;89565;24969;86471;9319;34095;8483;29999;17802;64094
315790;201307;3052;10851;2838;10397;345;1221;1911;7257;2256;8478
315800;201307;1509;6049;1276;5346;426;1958;221;884;647;2842
315810;201307;1447;4311;1255;3992;273;931;730;2259;1003;3190
315820;201307;3033;10270;2625;9673;659;2594;1429;5341;2088;7935
315830;201307;1470;5057;1350;4792;353;1443;450;1522;803;2965
315840;201307;664;1907;532;1630;109;368;150;439;259;807
315850;201307;1337;4858;1293;4756;404;1551;503;1822;907;3373
315860;201307;404;1531;352;1419;116;528;96;392;212;920
315870;201307;456;1420;401;1332;111;420;156;481;267;901
315880;201307;1064;2975;896;2765;278;974;398;1201;676;2175
315890;201307;1608;5689;1471;5480;419;1594;798;3124;1217;4718
315895;201307;4876;15731;4563;15122;1518;5515;1885;6090;3403;11605
315900;201307;744;2486;690;2391;222;889;317;1011;539;1900
315910;201307;598;2194;552;2098;240;941;198;744;438;1685
315920;201307;1156;3766;1009;3468;352;1325;383;1225;735;2550
315930;201307;1059;3094;910;2822;305;1026;296;899;601;1925
315935;201307;1123;3901;1050;3741;356;1391;323;1115;679;2506
315940;201307;608;2021;572;1964;160;604;310;1034;470;1638
315950;201307;1186;3796;1115;3657;333;1120;611;2049;944;3169
315960;201307;2753;9861;2304;8891;1076;4713;230;807;1306;5520
315970;201307;784;2300;655;2100;84;275;484;1595;568;1870
315980;201307;3916;10243;2869;8445;828;2823;925;2387;1753;5210
315990;201307;4236;13103;3764;12332;878;3357;2053;6592;2931;9949
316000;201307;558;1901;492;1775;243;940;118;409;361;1349
316010;201307;427;1605;385;1506;125;561;72;227;197;788
316020;201307;1167;3872;940;3483;180;739;538;2036;718;2775
316030;201307;3581;10456;2646;8953;406;1536;1448;5031;1854;6567
316040;201307;3288;10514;2455;8588;470;1872;383;1063;853;2935
316045;201307;2032;6812;1908;6630;299;947;1358;5029;1657;5976
316050;201307;319;1125;302;1092;63;257;176;628;239;885
316060;201307;749;2370;635;2215;129;552;383;1265;512;1817
316070;201307;5880;20217;5502;19440;1864;7231;2366;8017;4230;15248
316080;201307;717;2732;649;2545;177;777;154;602;331;1379
316090;201307;587;1793;456;1527;128;497;117;348;245;845
316095;201307;1168;4076;1108;3940;240;885;713;2597;953;3482
316100;201307;2818;9862;2357;8678;782;3195;488;1691;1270;4886
316105;201307;862;2517;677;2234;171;619;304;1016;475;1635
316110;201307;12045;44054;10990;42028;1518;6567;7853;30485;9371;37052
316120;201307;1245;4479;1217;4437;433;1615;571;2145;1004;3760
316130;201307;925;2414;729;2105;223;760;277;741;500;1501
316140;201307;1015;3157;807;2815;164;627;453;1605;617;2232
316150;201307;1249;4020;1192;3929;328;1249;616;1954;944;3203
316160;201307;1199;3740;1009;3359;140;516;610;2048;750;2564
316165;201307;876;2567;769;2389;163;577;418;1265;581;1842
316170;201307;1315;4043;1051;3525;250;972;429;1304;679;2276
316180;201307;1166;3867;1004;3581;310;1301;344;1133;654;2434
316190;201307;2560;7978;1619;5682;378;1454;332;1024;710;2478
316200;201307;4081;13559;3297;12021;965;4109;951;3270;1916;7379
316210;201307;4892;16294;4570;15622;2181;7969;936;3178;3117;11147
316220;201307;635;2020;477;1739;154;632;76;302;230;934
316225;201307;1021;3159;923;3018;162;604;594;1912;756;2516
316230;201307;438;1361;365;1228;68;255;204;688;272;943
316240;201307;5999;20081;5305;19236;655;2294;4172;15511;4827;17805
316245;201307;2844;10601;2718;10417;257;1133;2181;8401;2438;9534
316250;201307;8553;27962;7691;26158;3432;12480;2025;6516;5457;18996
316255;201307;2273;7469;2044;7200;321;1066;1510;5476;1831;6542
316257;201307;1252;3701;1004;3258;304;1125;347;1031;651;2156
316260;201307;1756;5135;1369;4589;430;1592;712;2358;1142;3950
316265;201307;1149;3447;1037;3220;94;343;742;2272;836;2615
316270;201307;5136;16955;4822;16325;1516;5585;2018;6906;3534;12491
316280;201307;3210;11028;2902;10409;673;2696;1446;5181;2119;7877
316290;201307;3028;10334;2859;10009;809;3197;1262;4173;2071;7370
316292;201307;3655;12524;3391;12004;1034;4105;1421;4753;2455;8858
316294;201307;877;3009;591;2291;159;716;87;329;246;1045
316295;201307;1891;6893;1769;6630;496;2140;846;2952;1342;5092
316300;201307;896;3066;822;2923;101;373;561;2067;662;2440
316310;201307;680;2226;536;1921;138;556;189;669;327;1225
316320;201307;540;1868;485;1788;144;594;146;513;290;1107
316330;201307;914;2882;806;2692;165;556;455;1584;620;2140
316340;201307;1116;3754;1012;3549;385;1521;253;788;638;2309
316350;201307;1456;4943;1334;4736;277;1010;752;2840;1029;3850
316360;201307;744;2025;601;1835;76;239;456;1410;532;1649
316370;201307;4891;16670;4452;15743;1541;5821;1103;3983;2644;9804
316380;201307;1375;4010;1137;3638;155;554;757;2436;912;2990
316390;201307;867;2732;745;2522;274;995;292;1008;566;2003
316400;201307;1451;4998;1300;4732;385;1475;562;2129;947;3604
316410;201307;1184;4131;1112;4017;220;882;701;2529;921;3411
316420;201307;1950;6855;1836;6690;315;1263;1189;4425;1504;5688
316430;201307;879;2788;764;2595;246;906;284;937;530;1843
316440;201307;582;2014;521;1934;210;912;215;719;425;1631
316443;201307;657;2103;575;1926;153;572;203;652;356;1224
316447;201307;1289;4441;1234;4337;206;799;924;3222;1130;4021
316450;201307;2152;7811;1938;7381;500;1901;1040;4147;1540;6048
316460;201307;779;2544;733;2472;202;783;421;1342;623;2125
316470;201307;6819;24182;6012;22376;2225;9332;1799;6269;4024;15601
316480;201307;252;895;225;838;70;274;69;249;139;523
316490;201307;354;1170;339;1137;133;473;139;455;272;928
316500;201307;1061;3948;758;3005;213;908;60;222;273;1130
316510;201307;929;3465;848;3309;384;1562;270;1048;654;2610
316520;201307;1101;3606;940;3360;299;1226;344;1130;643;2356
316530;201307;1184;3945;1005;3553;288;1222;404;1236;692;2458
316540;201307;989;3319;888;3143;285;1201;303;958;588;2159
316550;201307;1244;4352;1148;4196;251;1012;729;2668;980;3680
316553;201307;2182;8202;1854;7365;697;2964;387;1500;1084;4464
316555;201307;2555;9583;2371;9361;209;813;1943;7881;2152;8694
316556;201307;575;1699;481;1512;59;229;314;940;373;1169
316557;201307;863;3212;839;3167;309;1213;403;1511;712;2724
316560;201307;345;1191;300;1102;76;334;84;269;160;603
316570;201307;1330;4420;1239;4219;248;934;688;2330;936;3264
316580;201307;232;775;215;736;76;272;72;223;148;495
316590;201307;1288;4035;1110;3696;210;825;628;2034;838;2859
316600;201307;1136;3896;1029;3666;259;992;529;1829;788;2821
316610;201307;593;2278;556;2211;152;689;310;1197;462;1886
316620;201307;2044;6926;1897;6605;547;2070;866;3007;1413;5077
316630;201307;1448;5043;1311;4725;551;2104;388;1394;939;3498
316640;201307;251;857;227;809;70;292;87;285;157;577
316650;201307;914;3678;819;3507;207;892;437;1984;644;2876
316660;201307;134;419;116;388;31;128;43;127;74;255
316670;201307;1583;4975;1345;4497;533;2028;340;993;873;3021
316680;201307;1880;5816;1675;5498;235;805;1279;4246;1514;5051
316690;201307;1082;3784;999;3656;397;1620;323;1129;720;2749
316695;201307;1244;3940;1114;3708;119;379;781;2725;900;3104
316700;201307;352;1222;328;1166;101;433;151;496;252;929
316710;201307;3354;13257;2962;12360;1049;4500;925;4071;1974;8571
316720;201307;19831;68790;17230;62926;6461;24856;4556;16597;11017;41453
316730;201307;422;1387;370;1273;97;374;187;593;284;967
316740;201307;726;2605;666;2489;277;1111;174;617;451;1728
316750;201307;400;1452;374;1394;128;544;130;441;258;985
316760;201307;3518;12214;3032;11669;1801;6931;883;3646;2684;10577
316770;201307;1443;4456;1284;4235;243;899;827;2783;1070;3682
316780;201307;679;2411;642;2337;282;1090;157;551;439;1641
316790;201307;826;2475;624;2120;182;727;232;756;414;1483
316800;201307;5935;20239;5443;19303;1213;5040;2918;9926;4131;14966
316805;201307;884;2390;840;2334;154;415;607;1745;761;2160
316810;201307;510;1629;480;1573;142;514;226;730;368;1244
316820;201307;351;1057;259;899;115;432;43;136;158;568
316830;201307;574;2147;553;2100;210;839;204;765;414;1604
316840;201307;3284;9963;2863;9283;869;3210;1182;3656;2051;6866
316850;201307;2047;6725;1911;6480;488;1853;989;3295;1477;5148
316860;201307;22869;73883;21443;71315;6325;23363;9745;32289;16070;55652
316870;201307;6866;23685;6172;22000;2446;9364;1380;4784;3826;14148
316880;201307;865;3019;838;2977;372;1425;236;806;608;2231
316890;201307;1379;3696;1106;3324;501;1659;354;1018;855;2677
316900;201307;2535;8348;2334;7942;767;2905;729;2238;1496;5143
316905;201307;410;1489;384;1429;158;621;116;421;274;1042
316910;201307;666;2364;567;2158;156;632;247;958;403;1590
316920;201307;1462;4646;1189;4175;195;764;588;2046;783;2810
316930;201307;9344;33017;8391;31112;2720;11454;2585;9194;5305;20648
316935;201307;4710;14432;3529;12335;1286;5001;901;2952;2187;7953
316940;201307;6517;22958;5739;21302;1613;6770;1717;6053;3330;12823
316950;201307;1434;4423;1278;4212;228;874;825;2672;1053;3546
316960;201307;5141;13900;4433;13018;985;3153;2691;7922;3676;11075
316970;201307;3391;11622;3212;11285;1418;5537;800;2590;2218;8127
316980;201307;912;2977;758;2725;363;1389;216;782;579;2171
316990;201307;9509;32828;8798;31245;3786;14567;1443;4940;5229;19507
317000;201307;2448;9256;2383;9170;295;909;1980;7978;2275;8887
317005;201307;2292;7795;2215;7687;443;1607;1535;5368;1978;6975
317010;201307;27144;78484;19244;64398;5896;21882;4876;16889;10772;38771
317020;201307;40235;126664;29451;103220;8716;33675;6398;21051;15114;54726
317030;201307;861;2487;727;2283;137;532;408;1260;545;1792
317040;201307;12354;38983;11206;36880;4331;14890;4062;13668;8393;28558
317043;201307;775;2270;651;2100;212;729;298;957;510;1686
317047;201307;1128;3140;917;2800;176;602;447;1371;623;1973
317050;201307;1758;6524;1566;6051;500;2131;492;1807;992;3938
317052;201307;2304;7825;2071;7483;397;1501;1431;5284;1828;6785
317057;201307;1713;5159;1363;4554;253;1004;687;2272;940;3276
317060;201307;382;1161;291;955;87;328;107;325;194;653
317065;201307;1206;4167;1103;3996;151;602;825;3000;976;3602
317070;201307;8934;30624;7240;26860;2412;9898;1704;6338;4116;16236
317075;201307;1197;3926;1096;3756;423;1576;392;1279;815;2855
317080;201307;6715;20246;6268;19522;2109;7114;2544;7983;4653;15097
317090;201307;4684;16622;4414;16107;749;2862;2955;10998;3704;13860
317100;201307;3157;9601;2781;8983;934;3374;1184;3628;2118;7002
317103;201307;1977;7101;1693;6469;393;1805;778;2909;1171;4714
317107;201307;1244;4105;1122;3858;291;1176;535;1732;826;2908
317110;201307;694;1933;507;1587;146;550;193;536;339;1086
317115;201307;1022;3380;921;3159;137;490;616;2133;753;2623
317120;201307;12714;44348;11203;40832;4060;15729;4088;14720;8148;30449
317130;201307;8736;28809;8009;27475;2312;8935;3504;11665;5816;20600
317140;201307;637;2287;596;2195;87;360;377;1376;464;1736
317150;201307;1017;2868;868;2693;121;445;609;1862;730;2307
317160;201307;3711;10379;2892;9322;446;1674;1924;6126;2370;7800
317170;201307;1904;5886;1805;5691;276;1017;1080;3277;1356;4294
317180;201307;1778;6253;1448;5476;447;1834;416;1544;863;3378
317190;201307;1259;3931;1172;3813;105;394;983;3185;1088;3579
317200;201307;4180;14588;3978;14135;1519;5848;984;3360;2503;9208
317210;201307;1051;3405;900;3161;299;1162;371;1290;670;2452
317220;201307;343;1265;337;1256;126;475;166;639;292;1114
320010;201307;5850;18822;5246;17402;868;3149;2921;9707;3789;12856
320013;201307;1805;5571;1434;4977;212;791;885;3119;1097;3910
320016;201307;3402;9698;2948;9051;527;1645;1989;6220;2516;7865
320020;201307;4133;13772;3833;13124;1379;5030;1417;4842;2796;9872
320030;201307;1708;5733;1559;5399;450;1691;706;2377;1156;4068
320035;201307;1596;5254;1461;5001;543;2003;446;1516;989;3519
320040;201307;3134;10907;2697;9858;807;3152;852;3073;1659;6225
320050;201307;1855;5410;1591;4868;344;1180;806;2411;1150;3591
320060;201307;11016;36114;9135;31739;2750;10407;3129;10348;5879;20755
320070;201307;1767;6137;1598;5729;557;2146;424;1424;981;3570
320080;201307;5153;15972;4402;14445;1412;5024;1550;4941;2962;9965
320090;201307;8147;24079;6945;21938;2046;6996;3309;10121;5355;17117
320100;201307;3206;9852;2670;8785;655;2374;1247;4002;1902;6376
320110;201307;1533;4774;1407;4522;394;1386;458;1437;852;2823
320115;201307;1907;7149;1855;7024;635;2454;985;3803;1620;6257
320120;201307;16510;58005;14918;54810;5741;22415;4247;15683;9988;38098
320130;201307;37947;130634;35895;126230;11563;43799;16102;55533;27665;99332
320140;201307;3975;13350;2926;10640;806;3201;362;1265;1168;4466
320150;201307;17429;51052;13203;42824;4564;15860;2129;6831;6693;22691
320160;201307;5278;16572;4665;15586;1274;4740;2170;6935;3444;11675
320170;201307;1958;6581;1810;6256;698;2496;559;1973;1257;4469
320180;201307;902;3042;824;2916;281;1048;359;1269;640;2317
320190;201307;4138;15389;3851;14628;1492;5891;1130;4287;2622;10178
320200;201307;1083;3649;982;3443;311;1172;411;1457;722;2629
320210;201307;6118;17264;5348;15968;1414;4702;2657;7766;4071;12468
320220;201307;2668;8484;2108;7443;671;2582;718;2579;1389;5161
320225;201307;1394;5062;1228;4594;458;1843;241;903;699;2746
320230;201307;4145;14238;3892;13758;1330;5041;1439;5222;2769;10263
320240;201307;11450;37811;9770;34455;3661;13615;2456;9024;6117;22639
320245;201307;4119;14368;3910;13876;1268;4679;1754;6244;3022;10923
320250;201307;1687;5391;1298;4463;373;1434;283;888;656;2322
320255;201307;1953;6674;1710;6258;709;2762;600;2262;1309;5024
320260;201307;1354;4438;1145;3884;334;1257;409;1234;743;2491
320265;201307;2403;7577;2056;7152;276;1012;1528;5446;1804;6458
320270;201307;2165;7340;2006;6950;523;1908;992;3437;1515;5345
320280;201307;7079;21837;6616;21154;1256;4277;4246;13859;5502;18136
320290;201307;1504;5269;1386;4933;542;2007;387;1305;929;3312
320300;201307;4412;15281;4145;14741;1194;4504;2033;7290;3227;11794
320305;201307;4482;15237;4127;14384;1183;4553;1828;6191;3011;10744
320310;201307;1913;5966;1772;5751;409;1448;1034;3295;1443;4743
320313;201307;2191;6942;1668;5696;490;1933;273;836;763;2769
320316;201307;2195;7092;2092;6844;587;2031;969;3156;1556;5187
320320;201307;17749;59584;15888;55944;4984;19596;6689;22845;11673;42441
320330;201307;2751;8859;2481;8345;618;2093;1332;4634;1950;6727
320332;201307;4711;16493;4365;15867;1433;5427;1918;7202;3351;12629
320334;201307;1506;5421;1265;4812;476;2002;219;743;695;2745
320335;201307;1993;6255;1614;5439;607;2237;305;982;912;3219
320340;201307;5471;16154;4522;14496;1138;4052;2109;6711;3247;10763
320350;201307;5349;14090;4068;11989;870;2916;1930;5511;2800;8427
320360;201307;1704;4725;1360;4112;304;1047;655;1870;959;2917
320370;201307;3414;11659;2994;10809;911;3431;1236;4504;2147;7935
320380;201307;2610;8428;2344;7871;685;2434;1016;3378;1701;5812
320390;201307;8035;25077;6889;22824;1942;7180;2888;9306;4830;16486
320400;201307;4103;12060;3538;11277;674;2406;2244;7050;2918;9456
320405;201307;4094;12449;3796;12046;1159;4089;2055;6371;3214;10460
320410;201307;5933;15372;4524;13753;662;2020;3299;10243;3961;12263
320420;201307;2382;7734;1924;7019;876;3415;343;1215;1219;4630
320425;201307;2441;6399;2037;5841;322;1116;1304;3708;1626;4824
320430;201307;2209;6773;2039;6467;342;1235;1203;3745;1545;4980
320435;201307;2052;7411;1897;7038;602;2291;873;3363;1475;5654
320440;201307;1473;5084;1358;4750;448;1699;438;1444;886;3143
320450;201307;2355;7946;2117;7435;626;2392;930;3191;1556;5583
320455;201307;4456;16225;3655;14190;1185;4777;727;2795;1912;7572
320460;201307;2817;9600;2373;8628;822;3238;697;2399;1519;5637
320465;201307;1450;4856;1258;4358;290;1054;510;1726;800;2780
320470;201307;4069;13148;3121;11013;1080;4128;493;1661;1573;5789
320480;201307;1972;6089;1663;5495;423;1640;736;2278;1159;3918
320490;201307;17188;56129;14740;51237;5159;19155;5181;18577;10340;37732
320495;201307;1275;4281;1151;4003;507;1906;338;1139;845;3045
320500;201307;40921;133905;37009;126415;13187;48546;15486;51679;28673;100225
320501;201307;4007;13477;3767;13036;1433;5439;1550;5259;2983;10698
320503;201307;2192;8213;1941;7499;696;2846;495;1770;1191;4616
320506;201307;3068;9952;2218;7744;657;2432;394;1366;1051;3798
320510;201307;7885;25927;7203;24585;2627;9574;2589;8739;5216;18313
320515;201307;2046;5943;1845;5559;518;1652;759;2316;1277;3968
320517;201307;2016;7073;1802;6567;654;2554;471;1687;1125;4241
320520;201307;30058;100774;26526;93824;9150;35383;11219;39483;20369;74866
320530;201307;26349;85233;23015;78375;6772;25989;9788;31920;16560;57909
330010;201307;14448;47676;13592;45848;3377;12931;7455;24016;10832;36947
330015;201307;1919;5514;1697;5081;544;1824;557;1580;1101;3404
330020;201307;15730;48662;14542;46718;3870;13381;7771;24762;11641;38143
330022;201307;1497;4934;1374;4703;332;1358;735;2373;1067;3731
330023;201307;3195;10633;3045;10322;892;3320;1275;4201;2167;7521
330025;201307;3145;9974;2937;9656;717;2559;1838;6010;2555;8569
330030;201307;7157;25310;6611;24156;2177;8715;2685;9338;4862;18053
330040;201307;13962;40695;12001;37630;3266;11088;6313;19474;9579;30562
330045;201307;59975;178893;56061;173109;9333;30764;38611;119645;47944;150409
330050;201307;2869;9365;2558;8730;987;3790;704;2225;1691;6015
330060;201307;5249;16770;4800;16116;1158;4357;2877;9690;4035;14047
330070;201307;24451;77998;22555;74557;6831;24295;9757;32227;16588;56522
330080;201307;8651;26038;8324;25584;2179;6739;5015;15915;7194;22654
330090;201307;3019;8822;2884;8568;961;3055;1304;3800;2265;6855
330093;201307;1897;5650;1697;5332;417;1431;802;2497;1219;3928
330095;201307;1172;4157;1091;3946;427;1712;204;651;631;2363
330100;201307;51229;177886;48691;173239;12653;49645;24809;88385;37462;138030
330110;201307;2596;8376;2384;7974;862;3098;717;2384;1579;5482
330115;201307;2412;7548;2258;7263;791;2776;904;2817;1695;5593
330120;201307;2320;7095;2148;6848;555;1924;1165;3656;1720;5580
330130;201307;3833;12893;3511;12247;1233;4624;1261;4369;2494;8993
330140;201307;3293;10222;3003;9818;780;2843;1461;4763;2241;7606
330150;201307;2877;8915;2332;7758;827;2978;528;1697;1355;4675
330160;201307;1340;4772;1264;4596;497;1963;382;1324;879;3287
330170;201307;97181;303131;91726;294650;13749;47859;66514;213628;80263;261487
330180;201307;1598;5024;1470;4782;279;1149;939;2823;1218;3972
330185;201307;7529;24422;7106;23726;1969;6931;3841;13152;5810;20083
330187;201307;4025;11706;3676;11141;841;2951;2102;6215;2943;9166
330190;201307;27074;84065;26010;82236;7001;23584;14924;46378;21925;69962
330200;201307;12639;41054;11756;39258;2726;9377;6605;22491;9331;31868
330205;201307;2511;6992;2295;6638;538;1805;1188;3293;1726;5098
330210;201307;4585;12331;3495;10316;1091;3537;984;2883;2075;6420
330220;201307;10821;35199;10265;34120;3776;13538;3464;11115;7240;24653
330225;201307;3887;12591;3678;12259;661;2554;2513;8337;3174;10891
330227;201307;17010;48919;15621;47119;3384;11033;9961;29468;13345;40501
330230;201307;1487;4473;1380;4296;434;1517;529;1519;963;3036
330240;201307;19712;62189;17683;58678;7065;25522;3334;10849;10399;36371
330245;201307;1175;3840;986;3447;312;1188;228;798;540;1986
330250;201307;36023;107343;34344;104706;9294;28608;19853;61868;29147;90476
330260;201307;3350;10840;3183;10497;877;3180;1467;4674;2344;7854
330270;201307;13088;40388;11668;38057;3651;12597;4842;15956;8493;28553
330280;201307;1891;6217;1651;5717;413;1651;797;2596;1210;4247
330285;201307;17188;52747;15928;50975;3678;12486;9886;31752;13564;44238
330290;201307;3361;9587;3020;9152;613;2145;1812;5208;2425;7353
330300;201307;4100;13745;3935;13466;1033;3773;2065;7218;3098;10991
330310;201307;2681;8087;2478;7733;646;2140;1212;3722;1858;5862
330320;201307;15233;45794;14507;44665;3754;11789;8640;27234;12394;39023
330330;201307;30075;88243;28176;85291;7472;24299;16448;49169;23920;73468
330340;201307;13676;43632;11560;39256;3735;13770;3604;12038;7339;25808
330350;201307;89678;295603;87616;292718;16923;56594;61928;211247;78851;267841
330360;201307;5239;16921;5125;16736;870;3130;3621;11698;4491;14828
330370;201307;3668;13974;3494;13511;1426;5735;1215;4724;2641;10459
330380;201307;3937;13271;3539;12605;1149;4338;1569;5695;2718;10033
330385;201307;3916;13867;3630;13263;1206;4735;1317;4776;2523;9511
330390;201307;22694;78202;21151;75154;5350;21223;11088;38609;16438;59832
330395;201307;3204;9935;3008;9599;527;1808;1901;6141;2428;7949
330400;201307;2477;8486;2268;8085;562;2283;1091;3589;1653;5872
330410;201307;3000;9753;2620;8955;644;2303;1252;4295;1896;6598
330411;201307;2449;7885;2225;7438;495;1919;1175;3691;1670;5610
330412;201307;1343;4731;1091;4236;254;1141;452;1678;706;2819
330414;201307;25089;72435;21561;67647;4536;15261;13193;41462;17729;56723
330415;201307;3591;11511;3198;10795;846;3206;1404;4702;2250;7908
330420;201307;6655;22695;5647;20601;1877;7523;1033;3826;2910;11349
330430;201307;7983;24157;7215;22769;1840;6474;3482;10651;5322;17125
330440;201307;2069;7103;1751;6443;605;2458;417;1472;1022;3930
330450;201307;1556;5547;1474;5366;500;2050;521;1818;1021;3868
330452;201307;10471;32833;8767;29401;2547;9463;3595;11516;6142;20979
330455;201307;443053;1338764;386699;1245475;107882;371525;196437;631150;304319;1002675
330460;201307;1370;4723;1290;4566;376;1513;613;2119;989;3632
330470;201307;4122;14007;3926;13593;1529;5673;1098;3704;2627;9377
330475;201307;7922;26179;7339;25264;1879;7064;4066;14086;5945;21150
330480;201307;6416;19728;6021;18990;1796;6110;2399;7488;4195;13598
330490;201307;94922;272671;89255;264429;13580;42429;66494;197635;80074;240064
330500;201307;6599;20502;6198;19697;1498;5114;3124;10219;4622;15333
330510;201307;39767;132603;37856;129349;13824;48010;17554;61715;31378;109725
330513;201307;1565;4779;1445;4542;537;1776;558;1757;1095;3533
330515;201307;2913;9379;2708;9026;913;3255;1065;3494;1978;6749
330520;201307;12581;38671;11879;37658;2667;8961;7532;24109;10199;33070
330530;201307;1543;4679;1430;4485;397;1375;745;2246;1142;3621
330540;201307;3169;9917;2782;9314;919;3296;1039;3398;1958;6694
330550;201307;8744;29426;7846;27792;3183;11886;2124;7677;5307;19563
330555;201307;10050;31296;9133;29864;1890;6481;5798;19202;7688;25683
330560;201307;4067;12756;3820;12338;828;3129;2213;6948;3041;10077
330570;201307;3558;10508;3168;9885;817;2676;1718;5458;2535;8134
330575;201307;5252;16408;4902;15764;1137;3929;2969;9298;4106;13227
330580;201307;15866;52712;14256;49523;5191;18915;4881;17430;10072;36345
330590;201307;1907;5958;1806;5785;544;1818;888;2873;1432;4691
330600;201307;8977;27731;7822;25925;1257;5241;5040;15826;6297;21067
330610;201307;8604;28476;7947;27231;2335;8818;3652;12320;5987;21138
330615;201307;1685;6052;1563;5717;607;2282;643;2464;1250;4746
330620;201307;3876;13871;3593;13319;1289;4977;1209;4737;2498;9714
330630;201307;19723;67215;18181;63842;5492;21415;8332;27952;13824;49367
350010;201307;2842;9247;2331;8059;759;2826;450;1487;1209;4313
350020;201307;555;1662;454;1449;126;458;159;467;285;925
350030;201307;4151;13837;3823;13244;1458;5469;1321;4614;2779;10083
350040;201307;567;2116;502;1973;182;781;102;360;284;1141
350050;201307;1366;4570;1142;4151;328;1349;368;1220;696;2569
350055;201307;565;1984;546;1951;175;672;243;864;418;1536
350060;201307;78;269;71;256;23;104;22;64;45;168
350070;201307;2669;9047;2247;8097;600;2391;525;1713;1125;4104
350075;201307;474;1770;431;1667;163;673;117;410;280;1083
350080;201307;581;1758;484;1566;129;482;192;609;321;1091
350090;201307;573;1705;455;1505;136;478;141;444;277;922
350100;201307;1753;6320;1626;6050;631;2530;532;1922;1163;4452
350110;201307;445;1384;354;1175;110;407;113;335;223;742
350115;201307;1264;4272;1129;3917;285;1121;473;1496;758;2617
350120;201307;723;2068;554;1756;169;588;121;391;290;979
350130;201307;3641;11405;3323;10786;917;3320;1374;4137;2291;7457
350140;201307;683;2162;619;2030;151;575;248;762;399;1337
350150;201307;394;1366;363;1294;149;554;85;297;234;851
350160;201307;6246;20432;4930;17520;1628;6359;1656;5413;3284;11772
350170;201307;2187;7920;1972;7373;764;2959;465;1650;1229;4609
350180;201307;1443;3835;1203;3419;299;891;530;1493;829;2384
350190;201307;2977;10507;2556;9641;912;3818;923;3182;1835;7000
350200;201307;403;1429;371;1382;144;596;139;492;283;1088
350210;201307;7290;21148;5986;18831;2425;8188;1915;5730;4340;13918
350220;201307;3081;10128;2790;9591;1051;4025;778;2410;1829;6435
350230;201307;723;2520;667;2427;243;960;209;761;452;1721
350240;201307;586;1827;510;1708;127;497;268;856;395;1353
350250;201307;2703;10189;2591;9957;1137;4624;823;3135;1960;7759
350260;201307;1012;2774;878;2561;217;654;398;1212;615;1866
350270;201307;5153;16457;4691;15517;1255;4510;2151;7089;3406;11599
350275;201307;1940;6499;1741;6215;545;2136;707;2369;1252;4505
350280;201307;21588;59110;14256;44980;3917;13240;2973;9465;6890;22705
350290;201307;1448;5154;1345;4912;488;1875;455;1708;943;3583
350300;201307;479;1555;444;1473;161;577;129;428;290;1005
350310;201307;996;3390;938;3266;250;1024;402;1322;652;2346
350315;201307;553;1797;455;1586;82;360;153;485;235;845
350320;201307;11717;39292;10729;36939;3587;13186;1935;6459;5522;19645
350330;201307;9305;28208;8363;26224;1863;6594;4701;13843;6564;20437
350335;201307;533;1590;492;1505;135;438;192;639;327;1077
350340;201307;1006;3285;802;2896;260;1025;192;676;452;1701
350350;201307;745;2461;658;2323;191;772;242;850;433;1622
350360;201307;747;2692;654;2478;217;874;237;908;454;1782
350370;201307;689;2172;517;1753;110;417;121;363;231;780
350380;201307;3590;11821;3042;10974;1371;5290;623;2155;1994;7445
350390;201307;8334;27798;7564;26395;1865;7164;4038;13598;5903;20762
350395;201307;294;967;239;844;73;275;44;145;117;420
350400;201307;7842;23837;6594;21553;2109;7495;2333;7321;4442;14816
350410;201307;7141;27103;6456;25510;2442;10335;1715;6606;4157;16941
350420;201307;1003;3266;826;2909;404;1503;76;267;480;1770
350430;201307;884;2826;777;2639;224;900;381;1230;605;2130
350440;201307;1346;4449;1279;4330;465;1675;581;1922;1046;3597
350450;201307;7930;24880;6824;22718;2409;8661;1946;6304;4355;14965
350460;201307;1433;4335;1070;3556;342;1263;301;870;643;2133
350470;201307;207;644;187;615;54;202;78;235;132;437
350480;201307;769;2425;524;1813;102;404;94;271;196;675
350490;201307;2069;6111;1801;5767;473;1737;1033;3172;1506;4909
350500;201307;600;1820;529;1710;149;545;234;696;383;1241
350510;201307;1096;3583;965;3307;315;1224;348;1055;663;2279
350520;201307;1248;4921;1146;4699;459;1967;286;1150;745;3117
350530;201307;2454;7549;2044;6628;813;2844;520;1531;1333;4375
350535;201307;1467;4377;1429;4325;77;251;1264;3851;1341;4102
350540;201307;2023;5981;1760;5529;515;1806;724;2246;1239;4052
350550;201307;10597;31955;8627;28485;2678;9906;3146;9689;5824;19595
350560;201307;3341;11369;3097;10948;617;2340;1782;6483;2399;8823
350570;201307;19975;70846;18406;67169;6224;24263;6623;23204;12847;47467
350580;201307;1924;6489;1669;5950;535;2104;266;815;801;2919
350590;201307;3916;13252;3189;11605;1051;4244;1132;3751;2183;7995
350600;201307;33365;90103;24549;75994;5641;19254;11847;35745;17488;54999
350610;201307;8923;26690;7345;24144;2066;7662;3475;10970;5541;18632
350620;201307;424;1401;381;1320;94;370;163;539;257;909
350630;201307;1596;5157;1282;4532;418;1684;131;421;549;2105
350635;201307;4528;15265;3780;13777;1227;4680;1463;5446;2690;10126
350640;201307;672;2170;605;2011;197;711;245;790;442;1501
350650;201307;3784;12877;2956;10889;1219;4875;294;1056;1513;5931
350660;201307;3657;12057;3250;11326;935;3486;1511;5213;2446;8699
350670;201307;1815;5795;1709;5606;354;1344;1078;3369;1432;4713
350680;201307;1162;3692;954;3278;291;1179;382;1247;673;2426
350690;201307;1038;3592;890;3260;283;1157;214;724;497;1881
350700;201307;2783;9854;2477;9149;965;3920;902;2935;1867;6855
350710;201307;2063;6686;1886;6407;372;1446;1189;3965;1561;5411
350715;201307;1112;3460;985;3210;246;893;397;1234;643;2127
350720;201307;121;393;116;378;48;166;42;123;90;289
350730;201307;405;1598;389;1551;130;563;101;373;231;936
350740;201307;2295;7082;2077;6582;589;2035;845;2676;1434;4711
350745;201307;345;1108;291;984;68;272;135;406;203;678
350750;201307;9257;29483;7254;25334;2240;8591;1794;5897;4034;14488
350760;201307;11406;37628;10473;35966;3717;14171;4314;13983;8031;28154
350770;201307;867;2663;646;2206;153;597;229;765;382;1362
350775;201307;622;1874;563;1758;143;509;243;753;386;1262
350780;201307;2016;6308;1552;5308;363;1365;322;1079;685;2444
350790;201307;2033;6793;1694;6101;597;2271;373;1218;970;3489
350800;201307;2911;10137;2786;9914;713;2875;1562;5408;2275;8283
350810;201307;2575;7653;2262;7071;777;2641;780;2493;1557;5134
350820;201307;504;1450;395;1228;89;327;149;405;238;732
350830;201307;862;2812;628;2201;133;513;128;396;261;909
350840;201307;3024;11477;2631;10416;1022;4365;543;1964;1565;6329
350850;201307;6690;23080;5616;20421;1883;7311;1465;5037;3348;12348
350860;201307;3235;10881;3121;10708;556;2138;2252;7669;2808;9807
350870;201307;2334;8275;2126;7953;789;3114;1004;3777;1793;6891
350880;201307;1648;5700;1409;5145;453;1759;263;975;716;2734
350890;201307;623;1909;503;1649;102;363;163;456;265;819
350900;201307;4542;15479;3888;14089;1136;4476;1323;4502;2459;8978
350910;201307;863;2757;828;2682;373;1249;270;868;643;2117
350920;201307;9203;28585;8621;27629;1603;5781;5599;17303;7202;23084
350925;201307;5236;16692;4761;15770;1466;5348;2090;6717;3556;12065
350930;201307;1496;4296;1266;3909;173;646;866;2572;1039;3218
350940;201307;2285;7757;2098;7445;425;1792;1329;4501;1754;6293
350945;201307;921;3133;824;2926;248;973;321;1084;569;2057
350950;201307;68442;225418;59271;206461;18308;69437;23791;80474;42099;149911
350960;201307;4436;16008;3973;14992;862;3715;2077;7516;2939;11231
350970;201307;4073;15287;3764;14512;1542;6402;1166;4366;2708;10768
350980;201307;651;2154;609;2080;283;1037;118;414;401;1451
350990;201307;1725;6230;1554;5896;559;2307;558;2077;1117;4384
350995;201307;797;2953;757;2876;230;987;351;1259;581;2246
351000;201307;3458;10876;3061;10088;561;2184;1764;5535;2325;7719
351010;201307;413;1296;309;1073;127;476;59;211;186;687
351015;201307;933;3167;819;2946;316;1296;229;738;545;2034
351020;201307;7537;25347;6744;24104;1890;7296;3572;12912;5462;20208
351030;201307;1289;4974;1206;4786;402;1739;411;1604;813;3343
351040;201307;3551;11717;3300;11280;849;3403;1903;6079;2752;9482
351050;201307;7933;27219;6914;25164;2649;10363;2312;8331;4961;18694
351060;201307;31015;100053;26410;91518;9384;34322;8760;30822;18144;65144
351070;201307;1769;5197;1311;4360;497;1806;249;738;746;2544
351080;201307;2730;8366;2157;7660;708;2726;846;2932;1554;5658
351090;201307;380;1351;304;1186;113;506;46;160;159;666
351100;201307;1782;5930;1692;5785;655;2296;693;2435;1348;4731
351110;201307;7087;21855;5706;19204;2069;7606;1730;5528;3799;13134
351120;201307;566;1797;483;1602;76;306;239;706;315;1012
351130;201307;831;2320;445;1523;106;414;101;304;207;718
351140;201307;1966;6978;1809;6651;712;2861;572;2046;1284;4907
351150;201307;2098;7389;1746;6464;522;2136;430;1451;952;3587
351160;201307;1472;5309;1336;4978;467;1939;444;1590;911;3529
351170;201307;1438;4973;1252;4524;381;1487;492;1649;873;3136
351190;201307;1050;3481;953;3228;260;955;217;683;477;1638
351200;201307;2204;6721;1900;6143;364;1398;945;2776;1309;4174
351210;201307;1003;3315;886;3068;308;1154;274;898;582;2052
351220;201307;3451;11862;3025;10933;940;3721;1140;4013;2080;7734
351230;201307;1844;6341;1668;5984;571;2254;734;2573;1305;4827
351240;201307;998;3340;737;2686;226;932;196;630;422;1562
351250;201307;838;2473;637;2057;147;518;287;890;434;1408
351260;201307;1192;3628;1061;3350;296;1031;409;1230;705;2261
351270;201307;377;1378;340;1299;125;540;110;379;235;919
351280;201307;4235;13754;3659;12327;1148;4139;1088;3310;2236;7449
351290;201307;968;3047;855;2812;293;999;235;736;528;1735
351300;201307;9702;36635;8585;33966;2576;11018;3293;12951;5869;23969
351310;201307;3312;10633;2800;9674;760;3004;1312;4210;2072;7214
351320;201307;964;3554;877;3330;347;1424;192;645;539;2069
351330;201307;281;848;255;795;106;334;71;215;177;549
351340;201307;6403;22893;5851;21789;1729;6816;3002;11227;4731;18043
351350;201307;8960;30554;8159;28787;2692;9896;3053;10525;5745;20421
351360;201307;4807;15010;4545;14577;1237;4373;2355;7511;3592;11884
351370;201307;1896;6340;1548;5569;542;2174;366;1157;908;3331
351380;201307;36101;116522;33842;111846;9451;34174;15899;50336;25350;84510
351385;201307;249;802;243;792;96;322;86;281;182;603
351390;201307;1200;4181;1078;3919;438;1685;334;1166;772;2851
351400;201307;1204;3978;1135;3830;381;1367;435;1522;816;2889
351410;201307;2821;8952;2564;8474;644;2292;1240;4051;1884;6343
351420;201307;453;1349;314;1033;73;258;50;151;123;409
351430;201307;854;2779;774;2630;200;745;437;1448;637;2193
351440;201307;4607;14452;4088;13365;1651;5651;1082;3361;2733;9012
351450;201307;1797;5241;1588;4967;488;1558;843;2732;1331;4290
351460;201307;808;2607;676;2340;335;1255;188;591;523;1846
351470;201307;1069;3398;960;3192;410;1482;282;917;692;2399
351480;201307;2907;9762;2666;9357;714;3011;1280;4324;1994;7335
351490;201307;1932;6720;1751;6335;404;1721;938;3220;1342;4941
351492;201307;293;1023;219;813;55;241;58;170;113;411
351495;201307;146;525;128;474;42;162;46;168;88;330
351500;201307;19338;64123;17521;60596;5537;20602;7353;25032;12890;45634
351510;201307;7110;23798;6269;22412;1602;6248;3340;11829;4942;18077
351512;201307;329;1052;300;992;85;298;110;346;195;644
351515;201307;1811;6357;1603;5873;563;2214;455;1608;1018;3822
351518;201307;1953;7062;1559;6344;504;2214;280;1106;784;3320
351519;201307;743;2489;652;2281;195;783;275;920;470;1703
351520;201307;763;2211;384;1393;69;290;48;155;117;445
351530;201307;453;1468;406;1349;91;329;119;340;210;669
351535;201307;2518;6730;2101;6142;217;703;1565;4568;1782;5271
351540;201307;2062;6754;1879;6429;974;3501;370;1267;1344;4768
351550;201307;5605;17637;4474;15235;1706;6116;1107;3685;2813;9801
351560;201307;422;1426;370;1295;146;555;62;207;208;762
351565;201307;228;789;210;740;69;286;78;242;147;528
351570;201307;12665;42815;11233;39787;3822;13950;4650;16608;8472;30558
351580;201307;381;1119;301;929;54;182;113;315;167;497
351590;201307;448;1266;388;1125;141;440;90;249;231;689
351600;201307;1837;5516;1691;5239;449;1635;799;2226;1248;3861
351610;201307;643;1815;550;1651;126;427;273;775;399;1202
351620;201307;22760;78091;19116;69903;6651;26340;4811;16317;11462;42657
351630;201307;14303;49442;13189;47590;3603;13438;7446;27306;11049;40744
351640;201307;8091;27631;7044;25760;1994;7853;3559;12950;5553;20803
351650;201307;335;1032;236;791;62;232;51;159;113;391
351660;201307;932;3018;747;2591;183;708;201;628;384;1336
351670;201307;4066;13210;3523;12106;865;3377;1667;5408;2532;8785
351680;201307;707;2266;542;1857;158;580;113;352;271;932
351685;201307;440;1349;349;1186;104;369;125;436;229;805
351690;201307;1285;3850;1032;3302;477;1547;258;774;735;2321
351700;201307;1379;4313;1267;4100;432;1472;406;1279;838;2751
351710;201307;768;2470;652;2209;172;600;184;579;356;1179
351720;201307;1573;5148;1235;4236;289;1104;427;1397;716;2501
351730;201307;985;3251;947;3175;357;1309;342;1113;699;2422
351740;201307;4471;13177;3904;11981;1129;3695;1319;3809;2448;7504
351750;201307;1484;5003;1296;4589;412;1581;332;1090;744;2671
351760;201307;3744;12405;3340;11490;871;3275;1547;5141;2418;8416
351770;201307;2216;7372;1921;6827;748;2751;812;2895;1560;5646
351780;201307;1580;4630;1138;3705;344;1237;256;799;600;2036
351790;201307;1116;3447;963;3235;297;1088;478;1573;775;2661
351800;201307;311;782;269;700;40;136;167;385;207;521
351810;201307;1183;3694;1121;3617;296;1116;687;2085;983;3201
351820;201307;2496;7459;1764;6086;704;2594;219;714;923;3308
351830;201307;3880;13110;3561;12404;982;3784;1579;5298;2561;9082
351840;201307;8755;30962;7897;29132;2738;10726;2688;9764;5426;20490
351850;201307;1166;4152;1028;3839;326;1353;188;635;514;1988
351860;201307;3516;11469;3283;11026;764;2938;1912;6103;2676;9041
351870;201307;34518;109955;32021;105618;7327;26272;19624;64269;26951;90541
351880;201307;113032;378296;100541;352512;33894;125063;31671;110610;65565;235673
351885;201307;605;2303;565;2210;170;705;254;969;424;1674
351890;201307;811;2468;650;2107;235;802;140;428;375;1230
351900;201307;1442;4537;1289;4292;484;1712;493;1650;977;3362
351905;201307;343;1286;298;1198;115;510;85;309;200;819
351907;201307;14048;46081;12339;42611;3120;12039;5735;18937;8855;30976
351910;201307;1113;3677;1021;3498;264;1022;306;973;570;1995
351920;201307;1181;3497;1122;3411;279;970;673;1969;952;2939
351925;201307;978;2873;924;2777;116;451;684;1951;800;2402
351930;201307;3107;10917;2867;10389;897;3656;1161;3821;2058;7477
351940;201307;994;3082;940;2975;285;1004;554;1664;839;2668
351950;201307;997;3159;895;2961;238;866;377;1172;615;2038
351960;201307;3686;12216;3209;11240;1268;4697;1123;3836;2391;8533
351970;201307;6847;26516;6333;25402;2461;10411;2064;8198;4525;18609
351980;201307;900;2869;770;2623;181;721;325;1032;506;1753
351990;201307;1544;4582;1272;4034;384;1410;376;1045;760;2455
352000;201307;2400;7891;2204;7482;543;2006;1058;3459;1601;5465
352010;201307;2272;7873;2088;7421;785;2934;491;1768;1276;4702
352020;201307;1463;4842;1336;4590;438;1585;432;1517;870;3102
352030;201307;4302;13880;3953;13431;904;3328;2338;8076;3242;11404
352040;201307;1670;6016;1448;5435;462;1850;336;1180;798;3030
352042;201307;1938;5777;1577;5047;406;1450;819;2575;1225;4025
352044;201307;1330;4615;1092;3977;290;1144;252;833;542;1977
352050;201307;7220;25081;5390;20814;1706;7336;1079;3644;2785;10980
352060;201307;788;2414;709;2293;218;820;278;811;496;1631
352070;201307;710;1982;655;1891;304;950;176;542;480;1492
352080;201307;530;1687;456;1553;128;493;162;499;290;992
352090;201307;1666;5511;1391;4940;370;1496;481;1547;851;3043
352100;201307;1738;6099;1558;5731;544;2238;558;1813;1102;4051
352110;201307;410;1552;375;1475;115;511;112;402;227;913
352115;201307;352;1183;298;1065;96;386;128;424;224;810
352120;201307;980;2942;855;2767;193;663;509;1687;702;2350
352130;201307;1705;4879;1327;4257;338;1200;603;1795;941;2995
352140;201307;1185;4024;1012;3634;337;1276;384;1371;721;2647
352150;201307;607;1845;503;1659;185;664;185;584;370;1248
352160;201307;1206;3532;1112;3390;287;964;597;1816;884;2780
352170;201307;3060;9651;2815;9234;822;2902;1310;4143;2132;7045
352180;201307;3418;10005;3019;9282;876;2961;1364;3990;2240;6951
352190;201307;1016;3234;928;3068;229;913;432;1274;661;2187
352200;201307;385;1352;333;1242;77;324;139;516;216;840
352210;201307;15496;43141;12511;38707;2620;8712;7462;23558;10082;32270
352215;201307;554;1809;498;1723;90;336;294;1042;384;1378
352220;201307;14753;50389;13841;48518;4769;17676;5681;19919;10450;37595
352230;201307;13394;47032;11948;44314;3916;15848;4627;16829;8543;32677
352240;201307;12591;40708;11711;39139;4034;14982;4718;15166;8752;30148
352250;201307;25524;84397;22846;79270;6346;23935;10086;34837;16432;58772
352260;201307;4775;15343;3678;13215;1096;4412;1080;3512;2176;7924
352265;201307;923;3031;815;2865;148;598;509;1756;657;2354
352270;201307;2525;8748;2200;7967;892;3406;500;1710;1392;5116
352280;201307;2414;7707;2090;7150;615;2330;713;2377;1328;4707
352290;201307;1297;4328;1128;3948;305;1210;325;1008;630;2218
352300;201307;894;2736;767;2514;251;879;325;1050;576;1929
352310;201307;30362;106524;27891;102160;8015;31591;15707;56345;23722;87936
352320;201307;6578;21189;5856;19862;2082;7671;1891;5925;3973;13596
352330;201307;2151;7295;1894;6986;737;2931;676;2500;1413;5431
352340;201307;5639;19715;4717;17443;1705;6774;950;3250;2655;10024
352350;201307;1675;6336;1520;5963;444;1891;504;1918;948;3809
352360;201307;1161;3970;1033;3701;303;1278;530;1743;833;3021
352370;201307;889;3057;817;2899;197;796;390;1347;587;2143
352380;201307;1006;3285;883;3066;361;1386;247;827;608;2213
352390;201307;11915;37463;9662;33156;2536;10005;4240;13430;6776;23435
352400;201307;2909;8969;2015;7204;627;2473;831;2859;1458;5332
352410;201307;3917;11859;3062;10385;1135;4161;953;3111;2088;7272
352420;201307;1271;3764;1185;3633;472;1601;418;1254;890;2855
352430;201307;6126;19768;5424;18551;2207;8154;1692;5626;3899;13780
352440;201307;14965;48582;12567;43794;3465;13090;5086;17168;8551;30258
352450;201307;601;1854;422;1514;113;432;88;299;201;731
352460;201307;2607;9020;2379;8616;904;3654;910;3061;1814;6715
352470;201307;4876;13980;3038;10144;642;2329;1361;4441;2003;6770
352480;201307;5351;15533;4493;13920;1278;4552;1909;5434;3187;9986
352490;201307;719;2633;608;2358;159;686;116;437;275;1123
352500;201307;9727;32878;9251;32034;3940;14691;3314;10772;7254;25463
352510;201307;3286;11695;2726;10456;1011;4164;673;2499;1684;6663
352520;201307;2398;8671;2203;8241;565;2293;1323;4874;1888;7167
352530;201307;7151;24110;5635;20731;1768;7050;1187;4112;2955;11162
352540;201307;493;1673;413;1493;112;445;145;526;257;971
352550;201307;1022;3540;840;3144;320;1288;200;728;520;2016
352560;201307;544;1697;471;1559;94;374;224;658;318;1032
352570;201307;1675;5412;1206;4302;291;1162;333;1041;624;2203
352580;201307;913;2811;798;2608;287;1060;329;995;616;2055
352585;201307;199;658;160;584;41;171;49;161;90;332
352590;201307;13338;44260;12025;41749;2873;11211;6598;22260;9471;33471
352600;201307;1833;6066;1701;5772;615;2181;569;1871;1184;4052
352610;201307;3524;11643;3161;11029;1273;4803;1037;3559;2310;8362
352620;201307;5370;17589;5101;17214;1246;4469;3217;10859;4463;15328
352630;201307;826;2828;783;2726;242;927;359;1222;601;2149
352640;201307;2981;9791;2419;8477;597;2331;925;3125;1522;5456
352650;201307;820;2478;613;2054;158;575;174;532;332;1107
352660;201307;1075;3833;891;3401;293;1196;282;1066;575;2262
352670;201307;7679;26583;6769;24823;2577;9812;2047;7636;4624;17448
352680;201307;3108;11549;2664;10315;735;3122;806;2796;1541;5918
352690;201307;23095;71169;18957;63439;5334;19641;8050;26169;13384;45810
352700;201307;764;2337;613;2104;184;718;268;884;452;1602
352710;201307;5060;15438;3786;12824;1089;4101;1377;4388;2466;8489
352720;201307;8498;29384;8020;28404;2708;10223;3215;11316;5923;21539
352725;201307;403;1230;273;923;53;217;65;207;118;424
352730;201307;2482;8780;2170;7917;625;2490;653;2123;1278;4613
352740;201307;2190;6692;1912;6161;535;2057;853;2449;1388;4506
352750;201307;354;1149;307;1073;120;450;55;164;175;614
352760;201307;897;3219;838;3111;287;1155;420;1516;707;2671
352770;201307;907;2871;857;2773;250;879;315;1029;565;1908
352780;201307;590;2079;521;1917;168;687;155;501;323;1188
352790;201307;635;1888;522;1709;170;629;129;420;299;1049
352800;201307;1068;4154;893;3636;303;1262;155;593;458;1855
352810;201307;1002;2728;763;2285;148;518;328;947;476;1465
352820;201307;525;1637;447;1486;205;732;76;247;281;979
352830;201307;400;1212;312;1013;94;319;50;153;144;472
352840;201307;3347;11950;2962;11091;944;3803;1066;3983;2010;7786
352850;201307;9503;31755;8413;29783;2635;9892;3042;10962;5677;20854
352860;201307;1025;3460;939;3261;401;1490;235;734;636;2224
352870;201307;996;2664;821;2339;147;536;437;1119;584;1655
352880;201307;2188;6755;1773;5829;445;1603;446;1301;891;2904
352885;201307;296;1041;282;1008;97;372;98;332;195;704
352890;201307;699;2063;613;1887;150;516;204;574;354;1090
352900;201307;18057;56757;14262;48809;4093;15185;5685;18727;9778;33912
352910;201307;284;935;249;855;81;291;34;96;115;387
352920;201307;3376;10579;2915;9661;986;3617;998;3063;1984;6680
352930;201307;6913;22565;5518;19403;1746;6570;1055;3548;2801;10118
352940;201307;27350;95362;24077;87420;8875;33847;5038;17962;13913;51809
352950;201307;318;1024;231;834;68;294;63;205;131;499
352960;201307;483;1603;383;1346;80;304;86;280;166;584
352965;201307;359;1020;292;896;77;252;46;136;123;388
352970;201307;3312;8874;2946;8393;366;1103;2180;6346;2546;7449
352980;201307;1441;4349;1252;4045;429;1455;498;1635;927;3090
352990;201307;3573;12219;3342;11794;1166;4419;1205;4160;2371;8579
353000;201307;516;1485;401;1246;93;328;112;297;205;625
353010;201307;2847;8438;2268;7260;754;2682;775;2277;1529;4959
353020;201307;4264;12298;3216;10024;598;2084;1330;3813;1928;5897
353030;201307;4923;15156;4354;14011;1607;5584;1098;3329;2705;8913
353040;201307;678;1987;583;1832;204;698;206;631;410;1329
353050;201307;5262;18998;4695;17814;1921;7795;1452;5249;3373;13044
353060;201307;32344;108031;30226;104585;5822;23607;19760;65428;25582;89035
353070;201307;8418;29548;6715;25524;2461;9834;1583;6089;4044;15923
353080;201307;4573;16146;3877;14488;1368;5491;1065;3755;2433;9246
353090;201307;574;1981;511;1853;98;434;242;799;340;1233
353100;201307;263;801;218;697;100;318;40;128;140;446
353110;201307;7710;24666;6927;23190;1538;5489;3951;13458;5489;18947
353120;201307;472;1655;409;1502;154;636;96;317;250;953
353130;201307;2946;9350;2612;8756;999;3655;955;3005;1954;6660
353140;201307;2485;7201;2006;6206;681;2294;578;1595;1259;3889
353150;201307;1890;6087;1590;5499;645;2342;358;1262;1003;3604
353160;201307;567;1787;486;1602;152;524;107;323;259;847
353170;201307;511;1867;466;1783;198;843;154;558;352;1401
353180;201307;4726;15607;4196;14600;823;3374;2465;8180;3288;11554
353190;201307;3520;11548;3087;10523;825;3115;1368;4271;2193;7386
353200;201307;834;2990;756;2819;240;1004;284;998;524;2002
353205;201307;538;1758;434;1516;112;405;143;502;255;907
353210;201307;990;2744;830;2450;136;492;484;1366;620;1858
353215;201307;552;1782;481;1628;107;417;169;584;276;1001
353220;201307;893;2807;815;2647;227;820;308;963;535;1783
353230;201307;1172;3745;1099;3616;327;1194;391;1216;718;2410
353240;201307;2097;7240;1923;6874;661;2621;765;2521;1426;5142
353250;201307;1158;3355;997;3061;291;974;344;970;635;1944
353260;201307;1149;3456;1018;3235;342;1146;377;1157;719;2303
353270;201307;619;1926;538;1771;179;643;156;471;335;1114
353280;201307;543;1820;477;1705;171;642;128;458;299;1100
353282;201307;1721;5870;1675;5797;325;1251;1152;3906;1477;5157
353284;201307;331;975;266;859;85;294;83;260;168;554
353286;201307;142;435;96;324;27;88;19;66;46;154
353290;201307;427;1564;389;1483;169;678;136;504;305;1182
353300;201307;1859;6026;1680;5626;599;2162;560;1717;1159;3879
353310;201307;346;1104;327;1060;144;490;87;263;231;753
353320;201307;476;1371;417;1272;111;409;191;527;302;936
353325;201307;472;1703;401;1560;135;573;50;202;185;775
353330;201307;488;1527;408;1353;98;370;170;513;268;883
353340;201307;3067;10137;2638;9241;945;3569;866;2920;1811;6489
353350;201307;3286;10185;2918;9507;1020;3587;1308;4107;2328;7694
353360;201307;416;1485;366;1366;103;446;183;623;286;1069
353370;201307;693;2288;628;2139;192;695;287;972;479;1667
353380;201307;395;1334;357;1265;113;446;153;523;266;969
353390;201307;4908;13957;3912;12056;1063;3603;1494;4188;2557;7791
353400;201307;602;1885;507;1683;117;435;177;517;294;952
353410;201307;670;2117;575;1967;195;733;277;919;472;1652
353420;201307;609;1885;528;1660;169;567;163;471;332;1038
353430;201307;2447;8576;1869;6885;608;2285;133;400;741;2685
353440;201307;58492;195413;53562;183585;17382;62891;17870;59730;35252;122621
353450;201307;454;1421;408;1339;112;435;146;449;258;884
353460;201307;3917;11411;3421;10509;990;3293;1558;4728;2548;8021
353470;201307;11003;35654;8692;30698;2834;10959;2023;6925;4857;17884
353475;201307;1613;4840;1232;3980;353;1252;324;939;677;2191
353480;201307;1507;4637;1372;4385;323;1194;740;2234;1063;3428
353490;201307;1641;4789;1387;4283;395;1358;386;1076;781;2434
353500;201307;1167;3470;1085;3323;484;1575;359;1040;843;2615
353510;201307;1350;4488;1177;4023;341;1290;379;1148;720;2438
353520;201307;1122;3537;955;3219;393;1419;246;823;639;2242
353530;201307;2680;8290;2400;7765;695;2519;1031;3171;1726;5690
353540;201307;1884;5919;1736;5657;702;2376;609;2032;1311;4408
353550;201307;6557;19456;5876;18325;1273;4661;3192;9213;4465;13874
353560;201307;2244;7530;1903;6890;483;2023;764;2625;1247;4648
353570;201307;476;1548;397;1378;100;400;198;613;298;1013
353580;201307;2311;7788;2183;7550;807;3130;1089;3534;1896;6664
353590;201307;781;2291;668;2090;271;923;170;546;441;1469
353600;201307;1824;5431;1675;5171;404;1392;848;2623;1252;4015
353610;201307;569;2090;512;1982;168;743;189;710;357;1453
353620;201307;2306;8208;2122;7870;733;2979;773;2699;1506;5678
353625;201307;351;991;259;829;106;386;65;184;171;570
353630;201307;1764;6136;1458;5436;414;1723;332;1149;746;2872
353640;201307;1504;4395;1413;4235;416;1340;693;2129;1109;3469
353650;201307;5460;17286;4245;14518;1071;3952;1793;5756;2864;9708
353657;201307;287;992;263;934;70;291;90;302;160;593
353660;201307;1331;3465;1010;3016;464;1513;146;303;610;1816
353670;201307;4747;15983;4176;14719;1332;5074;1419;4784;2751;9858
353680;201307;624;2296;593;2235;330;1281;139;530;469;1811
353690;201307;493;1403;343;1140;115;433;111;334;226;767
353700;201307;2260;7516;2011;6945;519;2064;640;2028;1159;4092
353710;201307;1859;6752;1622;6198;627;2627;524;1959;1151;4586
353715;201307;471;1421;414;1326;70;260;222;708;292;968
353720;201307;2049;6570;1808;6197;381;1299;1072;3850;1453;5149
353730;201307;4369;13992;3550;12061;946;3449;929;2960;1875;6409
353740;201307;2284;7103;1838;6155;660;2318;494;1593;1154;3911
353750;201307;609;2224;535;2059;189;787;138;541;327;1328
353760;201307;6504;21899;5447;19778;1779;6798;2042;7509;3821;14307
353770;201307;819;2597;564;1963;136;514;84;227;220;741
353780;201307;5665;20722;5168;19706;2562;9987;1208;4859;3770;14846
353790;201307;3077;11233;2770;10587;1038;4358;510;1989;1548;6347
353800;201307;13680;45312;11231;40445;3141;12481;4878;17116;8019;29597
353810;201307;1173;3959;1046;3673;330;1218;412;1455;742;2673
353820;201307;1192;4329;1143;4232;439;1808;416;1442;855;3250
353830;201307;776;2194;612;1873;130;436;261;792;391;1228
353850;201307;1781;6036;1666;5823;474;1790;766;2589;1240;4379
353860;201307;2356;8233;2034;7495;737;2937;715;2593;1452;5530
353870;201307;23101;74799;18013;64163;4476;17900;6377;20672;10853;38572
353880;201307;2546;8630;2340;8309;527;2147;1342;4623;1869;6770
353890;201307;2310;6220;1743;5290;544;1848;733;2078;1277;3926
353900;201307;1130;3617;852;2977;239;929;186;571;425;1500
353910;201307;2079;7490;1979;7211;661;2577;834;3052;1495;5629
353920;201307;2577;7850;2004;6641;509;1752;396;1224;905;2976
353930;201307;3630;13268;3211;12370;1248;5126;753;2772;2001;7898
353940;201307;1493;4872;1325;4536;351;1401;531;1655;882;3056
353950;201307;3606;12085;3327;11567;613;2463;2117;7149;2730;9612
353960;201307;571;1869;471;1630;123;476;134;395;257;871
353970;201307;514;1551;452;1469;52;206;335;1062;387;1268
353980;201307;13842;41731;11770;38463;3015;10620;6158;19873;9173;30493
353990;201307;508;1626;463;1511;149;540;165;476;314;1016
354000;201307;1842;5608;1281;4474;314;1228;129;387;443;1615
354010;201307;379;1219;341;1151;174;604;87;294;261;898
354020;201307;4574;14342;4175;13498;1424;4983;1688;5139;3112;10122
354025;201307;1040;3063;827;2660;231;824;203;629;434;1453
354030;201307;592;1606;437;1390;154;546;138;402;292;948
354040;201307;770;2144;620;1878;99;375;373;1047;472;1422
354050;201307;900;3114;829;2952;342;1291;222;781;564;2072
354060;201307;4159;14040;3480;12591;1031;4049;1388;4804;2419;8853
354070;201307;3522;11919;3095;10957;1186;4505;755;2626;1941;7131
354075;201307;2248;8634;2151;8461;767;3263;913;3515;1680;6778
354080;201307;1847;5784;1513;4973;423;1458;517;1601;940;3059
354085;201307;295;851;265;796;35;141;179;487;214;628
354090;201307;1068;3314;1027;3251;163;584;746;2296;909;2880
354100;201307;16452;57601;14321;53650;3833;15351;6848;25656;10681;41007
354105;201307;841;2738;697;2449;194;818;239;726;433;1544
354110;201307;760;2335;647;2149;183;667;202;627;385;1294
354120;201307;2156;6314;1890;5859;590;2039;654;1883;1244;3922
354130;201307;6140;19352;5501;18071;1996;6986;1835;5837;3831;12823
354140;201307;18251;50056;12384;38358;2582;9112;5280;15164;7862;24276
354150;201307;4366;12702;3599;11358;1144;3999;1397;4241;2541;8240
354160;201307;3888;13176;3476;12296;1055;4024;1413;4811;2468;8835
354165;201307;386;1462;354;1380;126;510;90;371;216;881
354170;201307;1585;5323;1308;4640;315;1260;457;1456;772;2716
354180;201307;503;1562;480;1514;48;175;351;1061;399;1236
354190;201307;1617;5545;1406;5050;487;1845;414;1428;901;3273
354200;201307;1135;3377;943;3020;230;885;364;1018;594;1903
354210;201307;846;3016;765;2827;200;866;305;1030;505;1896
354220;201307;3017;9782;2756;9275;1024;3651;1037;3399;2061;7050
354230;201307;775;2622;735;2554;240;889;338;1172;578;2061
354240;201307;1252;4370;1049;3932;333;1380;271;977;604;2357
354250;201307;515;1698;432;1559;189;758;118;401;307;1159
354260;201307;9304;28839;8468;27477;2711;9635;3469;11186;6180;20821
354270;201307;1109;4017;1034;3846;338;1399;403;1486;741;2885
354280;201307;875;2652;819;2557;179;629;432;1351;611;1980
354290;201307;1302;4736;1202;4516;412;1659;306;1125;718;2784
354300;201307;3846;13656;3757;13480;1046;3981;2009;7159;3055;11140
354310;201307;770;2624;615;2228;179;703;140;502;319;1205
354320;201307;809;2515;713;2322;219;803;241;726;460;1529
354323;201307;323;983;268;895;96;352;98;293;194;645
354325;201307;1281;4487;1171;4239;356;1460;419;1385;775;2845
354330;201307;7833;25018;7189;23755;2009;7123;3831;12435;5840;19558
354340;201307;29160;97347;25172;89926;9781;37533;8812;30492;18593;68025
354350;201307;1133;3504;1064;3376;317;1062;543;1661;860;2723
354360;201307;435;1442;361;1308;97;382;45;158;142;540
354370;201307;1141;3895;1025;3660;179;768;708;2447;887;3215
354380;201307;1293;3961;1085;3585;422;1561;190;545;612;2106
354390;201307;11086;36913;8538;31044;2350;9418;2664;9245;5014;18663
354400;201307;2073;7467;1823;6846;483;1994;584;2080;1067;4074
354410;201307;6198;19500;5285;18105;1306;4889;2894;9878;4200;14767
354420;201307;1641;4923;1407;4419;470;1581;452;1361;922;2942
354425;201307;3483;10279;3051;9492;1081;3583;953;3040;2034;6623
354430;201307;1288;4346;1192;4203;310;1218;583;1996;893;3214
354440;201307;505;1578;421;1413;111;409;153;491;264;900
354450;201307;447;1316;327;1045;56;232;99;273;155;505
354460;201307;715;2277;672;2197;267;907;333;1084;600;1991
354470;201307;437;1334;376;1213;75;305;164;478;239;783
354480;201307;729;2265;652;2128;153;592;290;823;443;1415
354490;201307;721;2494;558;2073;153;619;179;581;332;1200
354500;201307;2515;8680;2311;8296;870;3431;725;2614;1595;6045
354510;201307;656;2282;588;2126;195;759;212;757;407;1516
354515;201307;336;1202;281;1075;77;330;88;312;165;642
354520;201307;5049;18432;4358;16802;1478;6301;1481;5473;2959;11774
354530;201307;2639;9804;2476;9475;740;3014;1317;5049;2057;8063
354540;201307;1344;4286;1188;4011;411;1467;424;1481;835;2948
354550;201307;516;1793;455;1626;103;388;159;536;262;924
354560;201307;1336;4146;1080;3558;344;1163;315;1007;659;2170
354570;201307;596;1915;496;1668;191;694;115;366;306;1060
354580;201307;8613;26004;7335;23490;1685;6155;3634;10995;5319;17150
354600;201307;1685;5983;1506;5627;509;2158;606;2139;1115;4297
354610;201307;470;1332;336;1070;76;253;97;271;173;524
354620;201307;410;1459;339;1327;102;463;112;408;214;871
354625;201307;274;931;235;851;59;244;61;209;120;453
354630;201307;1825;6533;1650;6097;687;2559;518;1827;1205;4386
354640;201307;4079;13971;3529;12757;1102;4476;827;2764;1929;7240
354650;201307;978;3048;887;2851;192;715;478;1475;670;2190
354660;201307;1907;5908;1504;5112;535;2030;493;1582;1028;3612
354670;201307;1712;5745;1379;4876;425;1644;362;1106;787;2750
354680;201307;5116;17734;4752;16936;1438;5435;1823;6353;3261;11788
354690;201307;630;2389;522;2076;133;563;176;634;309;1197
354700;201307;1164;3377;822;2626;132;520;351;969;483;1489
354710;201307;616;1881;537;1731;151;576;183;528;334;1104
354720;201307;185;543;148;465;58;181;39;128;97;309
354730;201307;7173;26142;6467;24646;2130;8642;2504;9272;4634;17914
354740;201307;227;763;193;687;47;173;45;161;92;334
354750;201307;2264;7448;1933;6983;695;2713;683;2420;1378;5133
354760;201307;2161;7348;1865;6678;643;2441;490;1696;1133;4137
354765;201307;248;701;186;595;38;149;42;114;80;263
354770;201307;2749;8284;2219;7393;1019;3648;375;1170;1394;4818
354780;201307;32056;106927;30249;102684;8197;30633;14990;48506;23187;79139
354790;201307;875;2888;795;2775;233;909;415;1363;648;2272
354800;201307;2089;6637;1932;6413;620;2212;1056;3494;1676;5706
354805;201307;847;2703;668;2312;126;502;133;420;259;922
354810;201307;645;2190;519;1941;202;823;80;286;282;1109
354820;201307;1020;3757;928;3556;311;1346;226;791;537;2137
354830;201307;423;1344;379;1261;105;400;144;455;249;855
354840;201307;783;2415;731;2308;242;826;243;737;485;1563
354850;201307;14566;48759;11496;42178;3418;13924;3959;13558;7377;27482
354860;201307;1237;4142;1128;3951;333;1383;497;1631;830;3014
354870;201307;41892;138396;39596;133613;12146;44119;19754;64757;31900;108876
354880;201307;3942;12775;2951;10515;938;3659;720;2320;1658;5979
354890;201307;14514;45833;12614;41974;3719;13705;4556;14432;8275;28137
354900;201307;598;1712;485;1551;174;611;169;539;343;1150
354910;201307;5127;16938;3750;13789;1063;4278;531;1860;1594;6138
354920;201307;491;1474;383;1270;114;404;91;289;205;693
354925;201307;358;1062;211;744;40;155;37;119;77;274
354930;201307;249;770;229;721;75;273;60;177;135;450
354940;201307;2467;8837;1946;7423;839;3367;344;1267;1183;4634
354950;201307;1438;4905;1319;4734;260;1099;809;2818;1069;3917
354960;201307;780;2505;690;2363;194;752;343;1137;537;1889
354970;201307;3930;13555;3487;12619;913;3724;1676;5772;2589;9496
354980;201307;32427;82180;18220;57181;4260;14858;6110;17805;10370;32663
354990;201307;33468;116816;31478;112615;7665;30583;17020;59006;24685;89589
354995;201307;1921;6163;1816;6007;489;1719;914;3038;1403;4757
355000;201307;1614;5581;1430;5254;563;2200;396;1439;959;3639
355010;201307;3516;11392;3070;10469;786;2990;1483;4924;2269;7914
355020;201307;3141;11633;2757;10866;1395;5802;745;2960;2140;8762
355030;201307;762545;2335186;706780;2225268;211090;718571;286897;882952;497987;1601523
355040;201307;2783;9480;2485;8903;947;3726;1069;3641;2016;7367
355050;201307;1214;3977;1012;3551;307;1177;282;957;589;2134
355060;201307;4707;16619;3822;14511;1169;4925;794;2711;1963;7636
355070;201307;6119;20009;5517;18985;1379;5452;2920;9504;4299;14956
355080;201307;1265;4789;1084;4291;419;1838;159;531;578;2369
355090;201307;1049;3887;896;3509;209;890;391;1476;600;2366
355100;201307;29077;96733;26212;91551;9658;35298;8806;31679;18464;66977
355110;201307;1288;4578;1181;4346;424;1693;392;1386;816;3079
355120;201307;641;2096;566;1943;181;676;232;767;413;1443
355130;201307;449;1294;344;1078;102;349;103;267;205;616
355140;201307;998;3678;961;3591;301;1237;435;1574;736;2811
355150;201307;3188;11236;2862;10563;1001;3856;1066;3796;2067;7652
355160;201307;1457;5210;1281;4905;561;2382;349;1185;910;3567
355170;201307;8557;26236;6616;22563;2362;8717;1909;6312;4271;15029
355180;201307;2789;8956;2464;8356;766;2970;915;2941;1681;5911
355190;201307;1251;4493;1156;4283;488;1864;335;1200;823;3064
355200;201307;890;3409;853;3328;428;1748;206;789;634;2537
355210;201307;2671;9496;2429;8959;781;3233;924;3141;1705;6374
355220;201307;28137;98915;26132;94951;11994;45040;7350;27514;19344;72554
355230;201307;991;3089;664;2329;135;558;159;473;294;1031
355240;201307;21099;66857;16488;56350;4130;15865;6639;20908;10769;36773
355250;201307;23614;82016;21630;78219;6528;25264;10300;36799;16828;62063
355255;201307;867;2471;638;1976;121;428;196;562;317;990
355260;201307;1568;4692;1408;4392;400;1389;536;1558;936;2947
355270;201307;1635;5136;1552;5001;245;993;1091;3319;1336;4312
355280;201307;21538;67501;19463;63554;5277;19365;8932;28002;14209;47367
355290;201307;852;2798;787;2678;170;646;384;1238;554;1884
355300;201307;826;2787;658;2414;168;678;154;518;322;1196
355310;201307;1013;3221;916;3038;257;885;396;1362;653;2247
355320;201307;722;2378;640;2183;195;736;219;646;414;1382
355330;201307;1458;5486;1264;5100;516;2299;310;1138;826;3437
355340;201307;2922;8188;2758;7911;741;2398;1480;4000;2221;6398
355350;201307;1326;4879;1200;4594;447;1841;297;1167;744;3008
355360;201307;1108;4000;1048;3879;287;1186;649;2346;936;3532
355365;201307;311;1004;264;907;80;312;68;224;148;536
355370;201307;6755;18176;5078;16237;2019;7049;1861;5923;3880;12972
355380;201307;3645;11356;2853;9506;853;3060;617;1825;1470;4885
355385;201307;969;3251;922;3163;387;1467;224;709;611;2176
355390;201307;1397;4009;1206;3617;336;1085;408;1202;744;2287
355395;201307;1507;4839;1249;4201;235;918;570;1755;805;2673
355400;201307;8522;30235;7891;28929;2516;10178;3805;13483;6321;23661
355410;201307;12208;46163;11578;44862;4835;19780;3368;13184;8203;32964
355420;201307;806;3017;774;2949;334;1320;253;991;587;2311
355430;201307;3536;10832;3107;10048;914;3249;1286;4019;2200;7268
355440;201307;870;2963;724;2577;226;846;204;650;430;1496
355450;201307;2457;8374;2081;7588;679;2702;623;2141;1302;4843
355460;201307;556;1640;433;1404;125;478;122;344;247;822
355465;201307;429;1316;363;1183;109;380;100;320;209;700
355470;201307;913;2921;747;2628;292;1135;223;732;515;1867
355475;201307;140;542;120;477;31;129;37;161;68;290
355480;201307;3171;11818;2988;11396;1000;4121;1255;4641;2255;8762
355490;201307;773;2338;624;2035;192;689;140;457;332;1146
355495;201307;694;2364;664;2314;206;789;274;911;480;1700
355500;201307;8090;25203;5745;19875;1479;5665;1176;3718;2655;9383
355510;201307;1671;5162;1424;4589;343;1264;382;1163;725;2427
355520;201307;366;1006;263;799;68;244;72;185;140;429
355530;201307;171;475;109;356;30;110;22;69;52;179
355535;201307;737;2298;614;2059;178;710;199;572;377;1282
355540;201307;10036;33354;9545;32511;2800;10268;4804;16079;7604;26347
355550;201307;703;2276;661;2191;199;736;306;976;505;1712
355560;201307;1425;4297;1109;3682;286;1079;252;713;538;1792
355570;201307;184;637;163;584;47;183;37;115;84;298
355580;201307;1196;3713;1048;3403;437;1560;323;997;760;2557
355590;201307;241;699;216;648;47;169;110;324;157;493
355600;201307;1004;3383;862;3057;394;1469;201;677;595;2146
355610;201307;1407;4212;1204;3893;379;1340;492;1527;871;2867
355620;201307;3737;12431;3072;10911;792;3249;1278;4107;2070;7356
355630;201307;3178;9435;2047;7018;436;1695;750;2385;1186;4080
355635;201307;957;3272;848;3070;219;877;448;1582;667;2459
355640;201307;3727;12729;3191;11460;1211;4550;617;2212;1828;6762
355645;201307;3353;12368;3201;12067;710;2977;1944;7227;2654;10204
355650;201307;6299;20536;5555;19060;1399;5698;3075;9741;4474;15439
355660;201307;1266;4216;1059;3800;368;1491;343;1133;711;2624
355670;201307;2011;6718;1426;5285;400;1688;448;1453;848;3141
355680;201307;1706;6039;1446;5388;602;2359;291;1028;893;3387
355690;201307;349;1232;317;1173;201;776;24;69;225;845
355695;201307;325;996;239;789;44;158;28;74;72;232
355700;201307;6186;22702;5750;21609;1818;7464;2519;9035;4337;16499
355710;201307;11711;31417;7904;24419;2816;9261;1949;5869;4765;15130
355715;201307;187;611;148;534;46;175;29;102;75;277
355720;201307;1535;5226;1309;4747;485;1948;383;1248;868;3196
355730;201307;765;2721;699;2592;287;1126;166;631;453;1757
410010;201307;1586;5212;1470;4981;424;1548;589;2004;1013;3552
410020;201307;1195;4209;1127;4083;376;1418;398;1425;774;2843
410030;201307;1139;4092;1003;3758;360;1436;211;820;571;2256
410040;201307;12053;41680;11209;39984;4293;16413;3196;11261;7489;27674
410045;201307;1060;3148;811;2685;261;930;288;911;549;1841
410050;201307;2893;8688;2115;7205;736;2752;646;2137;1382;4889
410060;201307;1833;6056;1676;5719;526;2010;600;1970;1126;3980
410070;201307;2108;6186;1748;5434;672;2292;347;943;1019;3235
410080;201307;1403;4351;1218;4040;304;1085;683;2216;987;3301
410090;201307;1105;3621;1007;3410;379;1388;307;986;686;2374
410100;201307;2801;8714;2307;7687;733;2789;527;1663;1260;4452
410105;201307;488;1617;401;1401;110;441;77;239;187;680
410110;201307;2389;7650;2158;7164;569;2136;826;2681;1395;4817
410115;201307;528;1505;460;1364;118;424;147;365;265;789
410120;201307;2826;9980;2689;9765;1095;4217;1042;3858;2137;8075
410130;201307;1342;4647;1236;4397;344;1181;644;2346;988;3527
410140;201307;13884;40586;10333;33809;3473;12585;3602;11624;7075;24209
410150;201307;16509;43560;8534;26686;1899;6775;1735;4862;3634;11637
410160;201307;3248;10736;2979;10268;1022;3866;1085;3767;2107;7633
410165;201307;752;2354;650;2129;137;491;323;1026;460;1517
410170;201307;1613;5124;1399;4669;564;2031;397;1281;961;3312
410180;201307;8185;27071;7182;24851;1941;7668;3337;10725;5278;18393
410185;201307;655;1854;603;1770;140;433;374;1117;514;1550
410190;201307;2127;6559;1953;6194;658;2267;574;1728;1232;3995
410200;201307;4928;14578;4161;13094;1538;5338;745;2260;2283;7598
410210;201307;2519;7805;2023;6735;527;1995;426;1241;953;3236
410220;201307;599;1797;493;1583;103;362;185;575;288;937
410230;201307;1778;5914;1650;5693;669;2513;559;1867;1228;4380
410240;201307;4943;15900;4627;15260;1575;5606;1704;5562;3279;11168
410250;201307;2394;6988;1807;5810;624;2238;365;1034;989;3272
410260;201307;1612;5131;1441;4828;458;1649;503;1649;961;3298
410270;201307;526;1595;464;1480;157;547;180;573;337;1120
410275;201307;872;2673;663;2267;118;450;376;1286;494;1736
410280;201307;2705;8294;1933;6584;488;1885;308;1008;796;2893
410290;201307;3079;9937;2795;9398;842;3049;1120;3785;1962;6834
410300;201307;601;1769;547;1661;90;342;313;875;403;1217
410302;201307;532;1626;475;1546;58;188;315;1055;373;1243
410304;201307;1404;4754;1296;4539;395;1424;571;2077;966;3501
410305;201307;2118;5841;1822;5408;561;1750;951;2884;1512;4634
410310;201307;2230;7740;2070;7424;702;2722;699;2587;1401;5309
410315;201307;596;1942;509;1772;140;536;228;761;368;1297
410320;201307;1182;3564;851;2903;211;848;95;265;306;1113
410322;201307;535;1645;415;1366;119;419;121;388;240;807
410330;201307;1406;4114;1220;3744;373;1261;366;1071;739;2332
410335;201307;1030;3119;884;2850;251;928;316;956;567;1884
410337;201307;757;2103;667;1947;139;485;287;779;426;1264
410340;201307;565;1755;434;1412;90;332;105;286;195;618
410345;201307;1669;5184;1443;4740;513;1846;327;993;840;2839
410347;201307;806;2352;600;1963;194;706;128;376;322;1082
410350;201307;952;3097;743;2678;239;948;112;377;351;1325
410360;201307;3236;10299;2963;9842;1030;3711;862;2893;1892;6604
410370;201307;12261;37114;9579;31476;2732;10139;2793;8547;5525;18686
410380;201307;1307;4251;1221;4083;318;1145;635;2109;953;3254
410390;201307;2754;8286;2269;7437;857;2995;643;1956;1500;4951
410395;201307;861;3026;796;2886;212;851;408;1480;620;2331
410400;201307;4961;16496;4422;15411;1478;5744;1281;4307;2759;10051
410405;201307;930;2829;766;2492;201;763;325;984;526;1747
410410;201307;1319;4621;1263;4517;488;1914;319;1095;807;3009
410420;201307;9466;31672;8518;29546;3032;11490;2412;7889;5444;19379
410425;201307;3654;12036;2825;10131;798;3170;462;1637;1260;4807
410430;201307;14524;41830;11341;35942;3543;12268;3382;10671;6925;22939
410440;201307;3453;11352;3218;10935;861;3066;1611;5576;2472;8642
410442;201307;2884;10286;2669;9772;965;3744;891;3267;1856;7011
410445;201307;2292;7986;2016;7481;652;2598;811;3126;1463;5724
410450;201307;2478;7363;2084;6616;690;2393;565;1654;1255;4047
410460;201307;2302;7097;1947;6353;531;1869;762;2407;1293;4276
410465;201307;1651;6415;1526;6104;618;2554;443;1683;1061;4237
410470;201307;1845;6017;1667;5628;496;1766;632;2133;1128;3899
410480;201307;27690;84398;23483;76257;9322;33091;6372;19841;15694;52932
410490;201307;10709;36428;9293;33254;3165;12279;3121;11110;6286;23389
410500;201307;1390;4596;1222;4235;468;1767;325;1144;793;2911
410510;201307;2235;6190;1734;5219;502;1648;696;1960;1198;3608
410520;201307;3147;11274;3012;11000;1194;4592;1026;3767;2220;8359
410530;201307;1596;4720;1369;4266;376;1350;529;1531;905;2881
410540;201307;3746;11170;2778;9377;756;2742;1039;3529;1795;6271
410550;201307;6161;19733;4955;16990;1688;6374;717;2218;2405;8592
410560;201307;1186;3987;960;3376;251;939;233;693;484;1632
410570;201307;2683;9176;2476;8817;773;2828;1083;4085;1856;6913
410580;201307;24274;79469;21853;74569;7773;28988;6619;21625;14392;50613
410590;201307;1200;3938;851;2956;175;689;210;652;385;1341
410600;201307;1800;5625;1577;5183;477;1630;712;2383;1189;4013
410610;201307;809;2597;724;2433;225;817;306;988;531;1805
410620;201307;1666;6169;1522;5799;528;2124;396;1488;924;3612
410630;201307;2435;7415;2140;6868;612;2202;887;2784;1499;4986
410640;201307;4558;14016;3876;12781;1379;5130;954;2980;2333;8110
410645;201307;1257;4583;1212;4487;491;1965;399;1498;890;3463
410650;201307;2375;7512;2027;6829;749;2650;590;1932;1339;4582
410655;201307;861;2753;756;2535;250;901;209;689;459;1590
410657;201307;559;1797;512;1700;166;644;201;598;367;1242
410660;201307;3698;11040;2971;9460;1117;3799;624;1851;1741;5650
410670;201307;974;2889;756;2445;218;788;205;625;423;1413
410680;201307;2255;8141;1944;7296;562;2156;714;2819;1276;4975
410685;201307;642;2002;607;1940;125;403;388;1256;513;1659
410690;201307;100646;299908;72557;242126;19103;71118;19296;58492;38399;129610
410700;201307;2180;7360;2069;7138;748;2815;781;2556;1529;5371
410710;201307;1034;3367;866;2961;223;869;247;799;470;1668
410712;201307;726;2324;650;2164;311;1122;162;557;473;1679
410715;201307;1048;3384;930;3131;268;979;317;1040;585;2019
410720;201307;3805;12370;3278;11233;1003;3655;980;3223;1983;6878
410725;201307;1058;3094;818;2641;229;799;266;766;495;1565
410730;201307;683;2123;630;2011;282;959;168;514;450;1473
410740;201307;890;2777;659;2298;163;648;280;958;443;1606
410750;201307;1743;5446;1576;5043;558;1998;444;1285;1002;3283
410752;201307;237;744;219;718;53;207;109;331;162;538
410753;201307;486;1545;410;1387;108;421;148;461;256;882
410754;201307;1006;3210;887;3006;144;542;575;2017;719;2559
410755;201307;661;1919;544;1715;132;491;252;733;384;1224
410760;201307;2391;8016;2290;7818;909;3268;814;2750;1723;6018
410765;201307;14807;45725;11636;39293;3135;11776;2365;7891;5500;19667
410770;201307;829;2445;715;2234;250;867;234;684;484;1551
410773;201307;1201;3909;1088;3689;316;1188;474;1497;790;2685
410775;201307;1759;5369;1730;5327;449;1316;1137;3661;1586;4977
410780;201307;600;1922;531;1782;159;560;149;536;308;1096
410785;201307;889;2981;735;2514;265;938;271;933;536;1871
410790;201307;720;2287;623;2063;222;825;136;394;358;1219
410800;201307;2130;6341;1873;5924;833;2852;548;1651;1381;4503
410810;201307;302;943;244;808;33;132;103;329;136;461
410820;201307;1030;3213;917;2959;286;1015;270;852;556;1867
410830;201307;29316;92177;25082;84406;7945;29094;8680;29030;16625;58124
410832;201307;1129;3490;1042;3325;248;933;509;1501;757;2434
410840;201307;7282;23875;6483;22118;2319;8687;1564;4904;3883;13591
410845;201307;1545;4788;1369;4424;283;1001;758;2451;1041;3452
410850;201307;2623;7994;2409;7701;527;1980;1333;4210;1860;6190
410855;201307;702;2070;613;1890;175;590;209;636;384;1226
410860;201307;3141;9688;2837;9146;778;2629;1329;4420;2107;7049
410865;201307;1610;5723;1457;5409;326;1324;792;2988;1118;4312
410870;201307;1355;4337;1289;4229;611;2187;371;1150;982;3337
410880;201307;4991;15013;4138;13434;1337;4880;1175;3534;2512;8414
410890;201307;1075;3414;839;2969;297;1153;111;329;408;1482
410895;201307;1204;4362;1108;4129;414;1616;335;1212;749;2828
410900;201307;840;2453;666;2173;146;549;199;606;345;1155
410910;201307;307;982;272;917;63;230;124;397;187;627
410920;201307;785;2499;648;2242;203;751;174;556;377;1307
410930;201307;1983;6463;1775;6120;553;2182;677;2258;1230;4440
410940;201307;19769;69402;18154;66443;6097;24238;7918;29118;14015;53356
410950;201307;1867;6346;1713;6054;370;1358;1030;3715;1400;5073
410960;201307;5878;17304;4370;14671;1585;5679;1416;4883;3001;10562
410965;201307;1044;3494;957;3317;247;933;494;1743;741;2676
410970;201307;4905;15463;4196;13992;1502;5609;962;3225;2464;8834
410975;201307;1341;4085;1152;3736;213;823;601;1934;814;2757
410980;201307;4947;15181;3474;11982;994;3820;869;2822;1863;6642
410990;201307;1026;3238;794;2718;262;1005;190;564;452;1569
411000;201307;392;1260;306;1065;78;300;51;161;129;461
411005;201307;454;1393;368;1179;101;323;67;191;168;514
411007;201307;2102;6990;1995;6800;622;2232;1010;3572;1632;5804
411010;201307;3703;12951;3475;12452;1436;5619;911;3097;2347;8716
411020;201307;2549;8454;2347;8098;796;3037;891;3099;1687;6136
411030;201307;802;2294;706;2124;233;775;200;556;433;1331
411040;201307;336;1115;289;1003;108;396;62;206;170;602
411050;201307;2099;7803;1912;7358;774;3171;418;1599;1192;4770
411060;201307;2039;6644;1805;6163;617;2360;335;1038;952;3398
411065;201307;375;1168;303;1018;53;196;108;327;161;523
411070;201307;3820;12943;3011;11164;1018;4165;367;1225;1385;5390
411080;201307;1963;6337;1834;6068;478;1773;822;2688;1300;4461
411090;201307;1035;2935;898;2744;260;918;252;706;512;1624
411095;201307;1534;4561;1230;3984;340;1221;316;983;656;2204
411100;201307;1480;4354;1135;3676;280;1020;275;875;555;1895
411110;201307;903;2779;715;2379;218;781;132;371;350;1152
411120;201307;1620;5281;1454;4917;492;1789;464;1546;956;3335
411125;201307;4569;15171;4455;14945;1599;5641;2137;7109;3736;12750
411130;201307;742;2321;628;2076;204;711;229;765;433;1476
411140;201307;2205;8108;1966;7481;740;2929;433;1802;1173;4731
411150;201307;5588;16486;5018;15438;1597;5348;1478;4208;3075;9556
411155;201307;1120;3461;1021;3237;370;1280;320;930;690;2210
411160;201307;299;918;273;868;117;388;81;247;198;635
411170;201307;758;2656;697;2503;215;814;226;804;441;1618
411180;201307;5893;18727;5265;17581;1727;6305;1642;5467;3369;11772
411190;201307;1757;5337;1486;4825;470;1699;438;1336;908;3035
411200;201307;3710;12168;3300;11489;1289;4874;1146;3915;2435;8789
411210;201307;2739;8082;2263;7217;905;3146;311;927;1216;4073
411220;201307;1172;3481;950;3064;257;946;387;1130;644;2076
411230;201307;953;3024;805;2707;286;1062;225;702;511;1764
411240;201307;810;2614;736;2454;322;1169;175;507;497;1676
411250;201307;3059;8733;2545;7772;788;2494;824;2523;1612;5017
411260;201307;256;746;204;657;64;238;90;268;154;506
411270;201307;1981;6468;1841;6225;625;2356;780;2551;1405;4907
411275;201307;1502;4638;1362;4344;418;1404;452;1406;870;2810
411280;201307;1691;5322;1357;4601;418;1612;208;637;626;2249
411290;201307;1018;2948;858;2638;246;816;298;948;544;1764
411295;201307;1082;3338;1009;3221;217;779;461;1430;678;2209
411300;201307;1269;3374;902;2655;89;306;388;1055;477;1361
411310;201307;819;2449;664;2185;164;637;304;961;468;1598
411320;201307;5566;17638;4651;15791;1349;4799;1319;4350;2668;9149
411325;201307;1480;4975;1351;4725;175;723;926;3247;1101;3970
411330;201307;3396;11489;3135;11047;1229;4682;984;3423;2213;8105
411340;201307;956;2863;653;2144;130;476;269;890;399;1366
411342;201307;886;2598;729;2242;210;720;203;547;413;1267
411345;201307;1000;3354;942;3244;277;1029;481;1656;758;2685
411350;201307;2430;7943;1961;6996;686;2621;281;918;967;3539
411360;201307;498;1286;326;966;37;153;161;411;198;564
411370;201307;40768;122196;31274;103892;7633;29834;10558;32021;18191;61855
411373;201307;1366;4490;1174;4069;350;1382;268;873;618;2255
411375;201307;1297;3694;1048;3197;305;983;299;868;604;1851
411380;201307;1230;3338;792;2437;162;563;237;705;399;1268
411390;201307;1716;5502;1583;5315;252;991;1153;3746;1405;4737
411400;201307;1579;4926;1335;4389;332;1216;475;1537;807;2753
411410;201307;2342;7503;2098;6958;737;2814;592;1668;1329;4482
411420;201307;4342;12907;3546;11265;1111;3957;837;2412;1948;6369
411430;201307;2695;9007;2355;8380;707;2719;1054;3630;1761;6349
411435;201307;526;1765;460;1594;137;521;145;480;282;1001
411440;201307;2503;8445;2308;8077;872;3303;686;2416;1558;5719
411450;201307;1852;5903;1701;5649;447;1557;878;2981;1325;4538
411460;201307;3948;13092;3312;11586;1403;5189;614;2048;2017;7237
411470;201307;886;2782;696;2335;208;746;151;472;359;1218
411480;201307;4322;13838;3679;12590;1709;6304;788;2566;2497;8870
411490;201307;1599;5222;1444;4934;650;2480;318;977;968;3457
411500;201307;1365;4294;1085;3648;374;1378;257;817;631;2195
411510;201307;2385;7161;1936;6296;641;2316;404;1151;1045;3467
411520;201307;26702;78213;18658;61353;6373;23225;3920;12142;10293;35367
411530;201307;846;2499;599;2029;267;1005;114;344;381;1349
411535;201307;474;1474;277;995;65;251;26;78;91;329
411540;201307;2640;7546;2175;6719;478;1619;1097;3451;1575;5070
411545;201307;943;3507;922;3462;214;888;602;2239;816;3127
411550;201307;671;1940;555;1750;253;854;114;344;367;1198
411560;201307;2482;7717;2131;6899;623;2214;528;1592;1151;3806
411570;201307;4770;14272;4026;13077;1397;4962;1083;3716;2480;8678
411573;201307;945;3058;906;2996;242;860;471;1588;713;2448
411575;201307;1356;4538;1224;4224;341;1260;483;1652;824;2912
411580;201307;3315;10339;2650;8999;663;2612;510;1542;1173;4154
411585;201307;423;1515;345;1283;94;377;44;139;138;516
411590;201307;552;1704;501;1596;146;538;133;393;279;931
411600;201307;347;1071;291;959;71;284;67;219;138;503
411605;201307;2192;6374;1704;5454;480;1708;665;2033;1145;3741
411610;201307;2134;6447;2042;6295;502;1655;1314;4005;1816;5660
411620;201307;2634;8964;2503;8738;881;3347;988;3494;1869;6841
411630;201307;672;1857;421;1446;143;566;78;234;221;800
411640;201307;555;1761;466;1575;140;526;166;524;306;1050
411650;201307;258;859;214;755;66;264;67;212;133;476
411660;201307;739;2253;662;2112;184;614;268;885;452;1499
411670;201307;1620;4910;1470;4638;509;1817;498;1447;1007;3264
411680;201307;1641;5238;1458;4924;399;1338;780;2817;1179;4155
411690;201307;3383;10553;2980;9789;1095;3871;843;2782;1938;6653
411695;201307;794;2606;688;2396;144;516;358;1259;502;1775
411700;201307;1758;5383;1389;4676;416;1562;405;1306;821;2868
411705;201307;2203;7732;1954;7269;485;1852;1140;4340;1625;6192
411710;201307;2123;6682;1695;5673;533;1967;346;1003;879;2970
411720;201307;826;2559;664;2172;173;629;172;518;345;1147
411721;201307;659;2056;585;1924;167;618;217;669;384;1287
411722;201307;653;2040;539;1814;149;583;171;523;320;1106
411725;201307;1234;4140;912;3367;266;1093;279;1038;545;2131
411727;201307;2307;6787;1920;5991;498;1727;836;2505;1334;4232
411729;201307;497;1438;408;1280;77;276;161;460;238;736
411730;201307;5290;16320;4573;14925;1403;4937;1755;5732;3158;10669
411740;201307;511;1548;422;1364;125;474;168;493;293;967
411745;201307;813;2644;699;2382;212;797;177;554;389;1351
411750;201307;3686;11793;3146;10636;1041;3891;534;1625;1575;5516
411760;201307;8315;25794;7634;24649;2969;10127;2433;8277;5402;18404
411770;201307;3629;13358;3369;12730;1412;5590;779;2986;2191;8576
411780;201307;2885;9974;2809;9872;441;1492;2018;7474;2459;8966
411790;201307;2488;7815;2101;7085;737;2818;591;1914;1328;4732
411800;201307;1174;3659;775;2652;153;585;110;287;263;872
411810;201307;1422;4598;1252;4204;352;1362;309;863;661;2225
411820;201307;15758;50698;13354;46304;4804;17137;4290;15770;9094;32907
411830;201307;435;1235;361;1134;118;377;145;487;263;864
411840;201307;8077;25013;6779;22502;2180;8012;2094;6744;4274;14756
411845;201307;471;1573;384;1385;117;460;81;279;198;739
411850;201307;5771;18470;5055;17076;1521;5647;1703;5708;3224;11355
411860;201307;801;2706;711;2493;236;887;185;602;421;1489
411870;201307;936;3490;812;3141;146;606;206;748;352;1354
411880;201307;2430;7111;2077;6536;493;1746;1083;3423;1576;5169
411885;201307;1370;3876;1144;3544;380;1318;326;902;706;2220
411890;201307;1199;3806;924;3190;286;1115;217;657;503;1772
411900;201307;853;2824;699;2445;222;824;152;523;374;1347
411910;201307;1140;4070;1045;3824;321;1280;358;1250;679;2530
411915;201307;11146;33674;8026;26883;2226;8326;1949;5874;4175;14200
411920;201307;953;3505;879;3309;313;1273;204;755;517;2028
411925;201307;556;1672;457;1496;138;468;194;647;332;1115
411930;201307;5905;20212;5280;18898;1791;6842;1989;7260;3780;14102
411940;201307;3475;12063;3166;11385;1077;4069;909;3286;1986;7355
411950;201307;10291;34138;9097;32065;3010;11525;3972;13820;6982;25345
411960;201307;5504;17332;5201;16772;1543;5543;2392;7482;3935;13025
411965;201307;409;1442;362;1337;108;431;102;380;210;811
411970;201307;711;2166;584;1953;192;675;185;609;377;1284
411980;201307;2033;5697;1460;4789;187;686;842;2761;1029;3447
411990;201307;26484;94713;23571;88452;9294;37081;6267;23992;15561;61073
411995;201307;2884;9404;2684;9021;1138;4083;740;2500;1878;6583
412000;201307;1828;5402;1514;4822;346;1267;621;1756;967;3023
412010;201307;705;2432;633;2271;206;784;216;767;422;1551
412015;201307;584;1931;508;1765;100;391;278;940;378;1331
412020;201307;405;1251;324;1085;119;434;127;402;246;836
412030;201307;540;1739;383;1363;81;346;118;390;199;736
412033;201307;674;2165;537;1835;146;550;92;289;238;839
412035;201307;903;2740;769;2486;198;741;329;995;527;1736
412040;201307;693;2351;638;2211;262;969;195;659;457;1628
412050;201307;1562;4811;1270;4183;335;1242;298;922;633;2164
412060;201307;7145;25847;6635;24642;2160;8518;2775;10396;4935;18914
412065;201307;920;2924;829;2735;267;1006;236;714;503;1720
412070;201307;1036;3041;935;2827;206;679;385;1147;591;1826
412080;201307;1878;6092;1413;5058;442;1758;163;507;605;2265
412085;201307;259;744;162;555;49;182;40;132;89;314
412090;201307;4685;15959;4502;15624;1013;3783;2865;10062;3878;13845
412100;201307;2157;7033;1922;6614;662;2415;671;2291;1333;4706
412110;201307;778;2592;727;2492;287;1019;261;871;548;1890
412120;201307;2311;8054;2137;7643;549;2150;1082;3744;1631;5894
412125;201307;941;3009;848;2861;268;983;330;1133;598;2116
412130;201307;748;2175;555;1808;133;491;161;515;294;1006
412135;201307;538;1590;416;1329;83;302;194;566;277;868
412140;201307;1768;5534;1515;5032;468;1660;444;1475;912;3135
412150;201307;2646;8241;2381;7704;411;1484;1375;4322;1786;5806
412160;201307;1057;3488;906;3157;287;1105;336;1135;623;2240
412170;201307;4115;14409;3680;13545;1461;5685;1217;4420;2678;10105
412175;201307;1420;5164;1319;4933;390;1586;539;2034;929;3620
412180;201307;1665;5495;1320;4857;543;2176;335;1179;878;3355
412190;201307;2843;8981;2455;8343;978;3498;706;2542;1684;6040
412200;201307;2107;7435;1631;6052;411;1632;506;1813;917;3445
412210;201307;649;1967;468;1560;147;560;88;262;235;822
412215;201307;3014;10324;2765;9840;538;1992;1726;6323;2264;8315
412217;201307;1126;3463;1080;3380;244;884;644;1881;888;2765
412220;201307;6636;21977;6361;21443;2386;8428;2876;9808;5262;18236
412230;201307;2764;9859;2498;9265;878;3548;677;2421;1555;5969
412240;201307;7779;22382;4748;15906;1121;4176;668;2008;1789;6184
412250;201307;2053;6532;1888;6192;716;2543;522;1622;1238;4165
412260;201307;1225;3778;841;2912;212;831;232;701;444;1532
412265;201307;1104;3632;1036;3510;291;1172;485;1571;776;2743
412270;201307;724;2507;579;2125;147;621;98;330;245;951
412280;201307;855;2747;753;2561;188;677;352;1190;540;1867
412290;201307;1182;3427;1016;3118;224;786;422;1249;646;2035
412300;201307;1685;5141;1405;4575;441;1651;422;1267;863;2918
412310;201307;1183;3448;1042;3262;227;606;671;2348;898;2954
412320;201307;713;2011;528;1691;114;428;237;753;351;1181
412330;201307;1925;5443;1504;4732;406;1381;667;2070;1073;3451
412340;201307;835;2756;638;2263;150;595;119;391;269;986
412350;201307;2306;7657;1971;6879;653;2456;366;1162;1019;3618
412360;201307;323;1087;292;999;74;267;71;213;145;480
412370;201307;1088;3465;872;3039;320;1169;249;862;569;2031
412380;201307;1915;5988;1736;5640;392;1330;835;2839;1227;4169
412382;201307;714;2082;555;1744;149;539;164;458;313;997
412385;201307;2394;7895;2243;7586;663;2326;910;3218;1573;5544
412390;201307;2339;7229;2170;6945;808;2816;790;2502;1598;5318
412395;201307;948;2691;774;2414;102;325;518;1655;620;1980
412400;201307;1186;3744;1068;3528;338;1205;446;1498;784;2703
412402;201307;1949;6286;1679;5704;532;1915;413;1308;945;3223
412405;201307;3835;11493;2541;8597;672;2616;261;768;933;3384
412410;201307;5987;20215;5512;19250;2516;9551;1068;3665;3584;13216
412420;201307;507;1550;434;1441;144;537;132;390;276;927
412430;201307;453;1395;381;1239;127;461;153;455;280;916
412440;201307;3930;12020;3503;11278;690;2460;1559;5257;2249;7717
412450;201307;536;1731;474;1575;136;501;132;381;268;882
412460;201307;961;2732;665;2178;164;634;178;545;342;1179
412470;201307;1954;6869;1825;6574;589;2302;763;2701;1352;5003
412480;201307;1283;3870;955;3163;234;852;192;539;426;1391
412490;201307;1261;3822;1131;3522;318;1038;328;1018;646;2056
412500;201307;1937;5960;1663;5428;544;1957;411;1228;955;3185
412510;201307;3099;10509;2794;9703;975;3688;774;2693;1749;6381
412520;201307;1756;5075;1382;4469;389;1340;567;1825;956;3165
412530;201307;774;2345;664;2113;223;768;178;545;401;1313
412535;201307;365;1120;272;891;76;271;101;294;177;565
412540;201307;1187;3624;975;3164;199;751;388;1233;587;1984
412545;201307;869;2561;747;2308;144;498;290;811;434;1309
412550;201307;23105;72351;16847;58212;5129;19152;3412;10925;8541;30077
412555;201307;305;981;224;771;61;220;41;120;102;340
412560;201307;4324;15242;3862;14234;1283;5126;900;3062;2183;8188
412570;201307;3890;12426;3182;10866;1094;4035;734;2498;1828;6533
412575;201307;1008;3285;858;2917;221;848;276;874;497;1722
412580;201307;1435;4036;1081;3438;276;939;363;1106;639;2045
412590;201307;458;1457;389;1330;163;591;88;297;251;888
412600;201307;1423;4666;1267;4358;449;1694;389;1285;838;2979
412610;201307;719;2396;604;2119;215;826;149;459;364;1285
412620;201307;1319;4446;1188;4177;472;1775;305;1050;777;2825
412625;201307;13256;38442;11275;34736;4340;14432;2555;7823;6895;22255
412627;201307;919;2937;682;2422;234;894;85;288;319;1182
412630;201307;3401;11202;3041;10390;888;3266;907;2997;1795;6263
412635;201307;488;1532;384;1307;105;360;55;171;160;531
412640;201307;887;2784;696;2366;204;791;174;541;378;1332
412650;201307;2240;6475;1836;5759;509;1732;726;2098;1235;3830
412660;201307;2957;9147;2482;8153;672;2526;637;1962;1309;4488
412665;201307;702;1918;456;1499;136;501;130;399;266;900
412667;201307;1533;4768;1259;4216;351;1378;394;1184;745;2562
412670;201307;620;2005;424;1514;103;415;62;190;165;605
412680;201307;1346;4596;1174;4165;357;1345;334;1080;691;2425
412690;201307;612;1986;491;1711;182;692;66;219;248;911
412700;201307;1775;6067;1577;5701;614;2440;542;1909;1156;4349
412710;201307;8716;27955;7286;24965;2194;8200;1855;6184;4049;14384
412720;201307;1535;4954;1143;3978;297;1113;123;338;420;1451
412730;201307;2737;8470;1956;6796;636;2377;252;793;888;3170
412740;201307;2032;6821;1857;6416;788;2899;235;843;1023;3742
412750;201307;3194;11311;3065;11077;654;2637;2078;7343;2732;9980
412760;201307;2151;7401;2065;7251;697;2708;786;2622;1483;5330
412770;201307;10965;33316;7654;25979;1943;7378;1573;4847;3516;12225
412780;201307;1449;4910;1296;4536;414;1537;402;1343;816;2880
412785;201307;2295;7027;1801;6028;586;2106;731;2426;1317;4532
412788;201307;1317;4503;1240;4354;333;1381;547;1789;880;3170
412790;201307;1083;3526;928;3175;217;826;304;944;521;1770
412795;201307;988;3019;865;2791;313;1103;283;868;596;1971
412796;201307;3095;9822;2930;9527;837;3001;1377;4395;2214;7396
412800;201307;3346;10316;2750;9189;818;3000;804;2510;1622;5510
412810;201307;8436;24600;5983;19388;1873;6659;1455;4355;3328;11014
412820;201307;5745;18302;4456;15717;1446;5527;1026;3657;2472;9184
412830;201307;370;1271;336;1200;105;430;74;227;179;657
412840;201307;2300;6777;1932;6066;611;2151;501;1541;1112;3692
412850;201307;2735;8551;2448;8155;522;1965;1300;4280;1822;6245
412853;201307;1715;5285;1533;4975;347;1364;792;2371;1139;3735
412855;201307;1637;4865;1341;4295;469;1717;378;1087;847;2804
412860;201307;1210;3812;1077;3577;299;1113;479;1520;778;2633
412862;201307;727;2098;623;1903;185;618;216;630;401;1248
412863;201307;1188;4211;1151;4140;175;667;805;2891;980;3558
412865;201307;611;2003;462;1611;103;394;172;596;275;990
412870;201307;1001;2992;862;2777;325;1128;285;927;610;2055
412880;201307;1562;4330;1326;3967;396;1326;391;1125;787;2451
420005;201307;479;1552;368;1306;90;352;157;521;247;873
420010;201307;3120;10093;2707;9370;440;1650;1870;6525;2310;8175
420020;201307;722;2525;513;1930;108;455;79;260;187;715
420030;201307;432;1371;282;1046;82;347;56;182;138;529
420040;201307;960;3053;673;2514;236;959;171;584;407;1543
420050;201307;713;2390;626;2183;199;739;234;797;433;1536
420055;201307;258;905;206;761;56;212;46;153;102;365
420060;201307;371;1331;285;1104;73;308;44;157;117;465
420070;201307;1914;6310;1680;5725;281;1062;773;2759;1054;3821
420075;201307;147;487;109;385;31;121;32;103;63;224
420080;201307;542;1915;493;1798;187;746;100;359;287;1105
420090;201307;665;2428;521;2059;148;607;100;405;248;1012
420100;201307;1444;4893;1352;4770;326;1160;868;3138;1194;4298
420110;201307;421;1475;386;1395;128;461;163;609;291;1070
420120;201307;302;1079;252;965;113;467;35;114;148;581
420125;201307;346;1469;332;1435;132;603;89;360;221;963
420127;201307;542;1731;277;1046;95;381;31;122;126;503
420130;201307;2665;9372;2409;8858;762;3157;908;3048;1670;6205
420140;201307;6020;18447;4607;15884;1601;6125;1152;3802;2753;9927
420150;201307;679;2182;516;1756;183;675;132;396;315;1071
420160;201307;273;860;184;643;55;231;41;109;96;340
420165;201307;169;591;137;500;27;104;33;127;60;231
420170;201307;226;761;162;624;63;282;18;48;81;330
420180;201307;400;1375;268;1006;82;318;65;230;147;548
420190;201307;474;1610;349;1352;132;559;64;236;196;795
420195;201307;1360;3954;1082;3568;289;1064;512;1712;801;2776
420200;201307;2776;9288;1852;7131;653;2809;319;1075;972;3884
420205;201307;1003;3459;907;3269;301;1181;387;1409;688;2590
420207;201307;1145;3515;883;2986;277;1057;246;770;523;1827
420208;201307;494;1631;409;1440;168;614;118;420;286;1034
420209;201307;321;1098;212;797;45;180;49;190;94;370
420210;201307;1695;5714;1145;4504;325;1469;158;548;483;2017
420213;201307;838;3220;801;3136;177;722;506;1998;683;2720
420215;201307;471;1640;366;1315;113;436;63;210;176;646
420220;201307;412;1660;392;1607;170;748;80;279;250;1027
420230;201307;4262;13693;3451;12192;894;3523;1800;6233;2694;9756
420240;201307;11981;38044;8349;30362;2027;8677;3223;10529;5250;19206
420243;201307;482;1670;425;1522;140;563;141;488;281;1051
420245;201307;978;3219;760;2780;212;910;157;498;369;1408
420250;201307;842;2766;793;2686;304;1111;321;1109;625;2220
420253;201307;647;1723;538;1573;120;372;261;834;381;1206
420257;201307;407;1322;341;1196;100;350;156;552;256;902
420260;201307;1293;4527;1193;4330;383;1506;551;2010;934;3516
420270;201307;392;1373;254;956;37;141;22;74;59;215
420280;201307;2540;7698;1857;6493;579;2290;574;1780;1153;4070
420285;201307;142;431;57;211;11;47;2;5;13;52
420287;201307;622;1973;541;1812;146;533;216;708;362;1241
420290;201307;5626;17184;3862;13242;1018;3877;1349;4362;2367;8239
420300;201307;5516;18048;3870;14401;1183;4988;766;2798;1949;7786
420310;201307;775;2464;738;2396;186;649;423;1332;609;1981
420315;201307;862;3093;727;2788;197;859;327;1233;524;2092
420320;201307;4600;15370;3988;14241;1284;5209;1558;5296;2842;10505
420325;201307;474;1569;456;1520;160;597;140;449;300;1046
420330;201307;1217;4388;1012;3820;371;1525;180;569;551;2094
420340;201307;1441;4609;1220;4104;297;1100;453;1457;750;2557
420350;201307;1530;5144;1382;4847;400;1485;610;2152;1010;3637
420360;201307;3406;11437;2794;10068;1111;4390;498;1680;1609;6070
420370;201307;1889;5450;1718;5244;217;687;1393;4225;1610;4912
420380;201307;5172;18087;4468;16374;1511;6076;1164;4183;2675;10259
420390;201307;1966;6044;1244;4477;433;1700;273;877;706;2577
420395;201307;2224;7031;1756;5974;530;2052;408;1262;938;3314
420400;201307;1440;4469;1129;3856;353;1394;358;1143;711;2537
420410;201307;739;2178;572;1905;142;536;279;911;421;1447
420415;201307;474;1554;400;1359;118;424;148;500;266;924
420417;201307;766;2591;696;2438;153;547;349;1232;502;1779
420419;201307;400;1349;316;1198;155;624;85;325;240;949
420420;201307;14264;45544;11400;39336;3951;14737;3463;11795;7414;26532
420425;201307;1199;3514;802;2632;119;488;330;984;449;1472
420430;201307;4014;12922;2765;9914;869;3392;752;2640;1621;6032
420435;201307;190;671;144;544;70;296;21;73;91;369
420440;201307;1452;4370;905;3202;332;1262;157;503;489;1765
420445;201307;430;1298;337;1133;104;370;146;493;250;863
420450;201307;1228;3711;729;2658;182;761;140;405;322;1166
420455;201307;2193;7039;1983;6654;622;2377;840;2734;1462;5111
420460;201307;9377;30692;7925;27880;2403;9523;3075;10303;5478;19826
420470;201307;1061;3094;791;2617;258;931;232;752;490;1683
420475;201307;161;549;118;434;47;181;29;114;76;295
420480;201307;5904;18129;4951;16527;2105;7756;837;2748;2942;10504
420490;201307;662;2386;578;2159;177;692;146;517;323;1209
420500;201307;2052;6570;1780;6086;531;1919;942;3280;1473;5199
420510;201307;180;790;176;771;78;348;36;145;114;493
420515;201307;159;591;130;515;41;172;22;86;63;258
420517;201307;915;2917;835;2739;117;392;571;1913;688;2305
420519;201307;392;1156;301;963;60;192;129;433;189;625
420520;201307;657;2103;571;1943;157;575;236;790;393;1365
420530;201307;1345;4791;1120;4190;397;1628;264;880;661;2508
420535;201307;250;827;215;745;67;263;59;189;126;452
420540;201307;19005;60364;14955;51632;5428;20475;4506;15008;9934;35483
420543;201307;422;1266;329;1113;50;182;228;770;278;952
420545;201307;1426;4674;1194;4164;370;1464;361;1166;731;2630
420550;201307;4530;15512;3966;14177;1333;5343;1235;4310;2568;9653
420555;201307;443;1485;380;1339;152;577;108;374;260;951
420560;201307;564;1715;482;1555;76;275;258;848;334;1123
420570;201307;1825;6213;1507;5435;482;1932;438;1460;920;3392
420580;201307;902;3233;798;3036;256;1092;342;1286;598;2378
420590;201307;3080;10081;2323;8294;592;2320;505;1711;1097;4031
420600;201307;671;2500;629;2404;203;847;263;989;466;1836
420610;201307;561;1918;428;1602;149;612;72;239;221;851
420620;201307;1178;3827;1055;3589;410;1517;243;805;653;2322
420630;201307;1000;3353;807;2850;256;993;227;682;483;1675
420640;201307;573;2024;354;1409;93;414;41;169;134;583
420650;201307;2169;7098;1354;5017;341;1411;268;825;609;2236
420660;201307;667;2039;556;1831;111;410;300;971;411;1381
420665;201307;747;2257;502;1719;93;365;184;560;277;925
420670;201307;1648;5472;1284;4619;362;1457;220;723;582;2180
420675;201307;225;736;166;594;39;155;79;261;118;416
420680;201307;531;1443;382;1210;95;345;137;417;232;762
420690;201307;825;2991;642;2465;182;783;199;717;381;1500
420700;201307;6282;19748;5294;17667;1942;7158;1291;4100;3233;11258
420710;201307;702;2645;619;2461;246;1047;152;576;398;1623
420720;201307;1896;6079;1690;5802;481;1722;955;3276;1436;4998
420730;201307;4471;14318;3959;13410;1554;5595;1356;4547;2910;10142
420740;201307;647;2337;632;2310;181;690;378;1382;559;2072
420750;201307;2351;7872;1730;6338;433;1812;542;1746;975;3558
420757;201307;108;384;93;356;27;115;21;71;48;186
420760;201307;423;1417;331;1163;77;297;113;391;190;688
420765;201307;524;1910;399;1544;128;524;87;327;215;851
420768;201307;1216;4500;1085;4188;362;1440;414;1678;776;3118
420770;201307;833;2737;585;2141;194;774;167;570;361;1344
420775;201307;581;1933;513;1774;136;478;241;846;377;1324
420780;201307;1658;5226;1206;4118;366;1345;364;1174;730;2519
420785;201307;390;1282;314;1082;73;280;127;416;200;696
420790;201307;1306;4892;1100;4294;324;1349;448;1705;772;3054
420800;201307;860;2608;552;1909;156;593;126;406;282;999
420810;201307;2429;8836;2031;7842;730;3128;546;2012;1276;5140
420820;201307;7370;26467;6388;24638;2343;10062;2326;8836;4669;18898
420830;201307;2588;8963;2254;8315;894;3556;739;2630;1633;6186
420840;201307;862;2940;657;2492;233;986;192;657;425;1643
420845;201307;1034;3705;884;3390;336;1403;148;534;484;1937
420850;201307;1695;5891;1272;4997;456;1945;281;1110;737;3055
420860;201307;642;1966;450;1582;190;742;151;511;341;1253
420870;201307;1340;4069;1096;3715;439;1621;329;1099;768;2720
420880;201307;1426;4919;1202;4328;360;1356;260;916;620;2272
420890;201307;12169;29429;5822;18576;1218;4632;2288;6626;3506;11258
420895;201307;218;608;107;354;30;105;37;119;67;224
420900;201307;2216;6654;1535;5300;485;1837;383;1254;868;3091
420910;201307;21545;68903;14884;54222;4193;17340;3769;12935;7962;30275
420915;201307;657;2618;610;2489;169;696;281;1215;450;1911
420917;201307;396;1248;230;765;55;216;73;189;128;405
420920;201307;172;519;107;380;42;161;17;58;59;219
420930;201307;19306;61392;16957;56976;5892;21577;5759;19281;11651;40858
420940;201307;4412;14145;3909;13022;1238;4575;1307;4063;2545;8638
420945;201307;228;731;155;546;52;211;40;130;92;341
420950;201307;499;1619;293;1135;81;341;53;208;134;549
420960;201307;1398;4531;1198;4149;435;1659;355;1121;790;2780
420970;201307;2573;8506;2311;8096;672;2461;1196;4328;1868;6789
420980;201307;373;1352;343;1277;105;389;183;718;288;1107
420985;201307;458;1502;336;1229;111;435;79;279;190;714
420990;201307;859;2646;595;2167;151;598;177;582;328;1180
421000;201307;669;2443;489;1957;160;705;58;177;218;882
421003;201307;598;1802;268;977;67;269;40;132;107;401
421005;201307;233;802;216;770;66;258;106;374;172;632
421010;201307;6502;21085;5266;18481;1844;6932;1599;5395;3443;12327
421020;201307;504;1726;410;1527;85;310;223;898;308;1208
421030;201307;1043;3873;952;3628;347;1394;294;1140;641;2534
421040;201307;830;2688;750;2553;248;927;280;898;528;1825
421050;201307;1833;5191;1193;4124;325;1269;458;1489;783;2758
421055;201307;259;899;194;723;46;197;57;185;103;382
421060;201307;530;2024;439;1756;138;593;91;333;229;926
421070;201307;761;2494;540;1958;148;606;167;622;315;1228
421080;201307;619;2078;586;2004;201;733;240;799;441;1532
421085;201307;510;1455;290;1043;79;312;61;232;140;544
421090;201307;416;1262;320;1044;88;301;138;455;226;756
421100;201307;931;3040;731;2573;219;803;187;597;406;1400
421105;201307;1337;4527;1208;4283;329;1247;536;1984;865;3231
421110;201307;1616;5421;1410;5079;530;2082;444;1533;974;3615
421120;201307;1530;5216;1226;4445;316;1348;387;1280;703;2628
421125;201307;341;1202;319;1141;120;456;111;369;231;825
421130;201307;4456;15263;3861;14163;1596;6294;1159;4338;2755;10632
421140;201307;424;1401;347;1218;109;420;121;408;230;828
421145;201307;477;1639;411;1462;76;306;190;647;266;953
421150;201307;478;1683;380;1487;108;453;152;593;260;1046
421160;201307;779;2535;549;2030;134;548;161;573;295;1121
421165;201307;317;1167;261;975;65;259;105;403;170;662
421170;201307;1818;6050;1561;5347;500;1808;720;2412;1220;4220
421175;201307;1247;3926;1031;3572;366;1427;326;1054;692;2481
421180;201307;467;1458;311;1118;108;446;114;362;222;808
421185;201307;417;1300;353;1170;68;218;181;627;249;845
421187;201307;308;1007;261;909;75;275;97;322;172;597
421189;201307;522;1640;467;1526;135;483;178;568;313;1051
421190;201307;9230;31017;7481;27243;2538;9852;2311;8373;4849;18225
421200;201307;1042;3655;929;3398;286;1162;419;1502;705;2664
421205;201307;196;661;152;557;34;145;36;108;70;253
421210;201307;1988;6389;1784;5857;617;2155;582;1908;1199;4063
421220;201307;2388;8460;2160;8009;733;2897;729;2757;1462;5654
421223;201307;799;2396;549;1957;176;663;266;946;442;1609
421225;201307;1142;3627;985;3311;296;1064;384;1270;680;2334
421227;201307;931;3277;875;3185;256;929;505;1917;761;2846
421230;201307;743;2581;676;2408;196;753;254;862;450;1615
421240;201307;511;1779;370;1366;101;395;50;164;151;559
421250;201307;1835;5862;1334;4933;493;1988;372;1326;865;3314
421260;201307;234;778;162;631;39;156;37;137;76;293
421270;201307;613;1798;393;1407;148;565;80;303;228;868
421280;201307;1541;5007;1277;4591;473;1979;324;1125;797;3104
421290;201307;1912;5617;1313;4427;447;1615;296;901;743;2516
421300;201307;296;992;266;929;118;456;90;282;208;738
421310;201307;514;1802;443;1604;153;558;110;396;263;954
421315;201307;346;1085;234;840;49;183;61;205;110;388
421320;201307;518;1803;355;1336;75;319;65;185;140;504
421330;201307;609;2215;542;2072;236;1018;67;243;303;1261
421335;201307;550;1885;448;1679;134;542;98;369;232;911
421340;201307;1625;5593;1503;5357;532;2038;579;2044;1111;4082
421350;201307;1009;3542;851;3203;322;1346;236;833;558;2179
421360;201307;3017;9604;2134;7753;522;2178;720;2493;1242;4671
421370;201307;1068;3894;932;3584;332;1399;257;969;589;2368
421380;201307;1003;3028;842;2714;182;629;412;1328;594;1957
421390;201307;186;622;150;532;23;87;45;165;68;252
421400;201307;369;1477;307;1320;134;587;76;312;210;899
421410;201307;365;1183;297;1039;73;264;135;494;208;758
421415;201307;319;1066;209;826;73;302;59;220;132;522
421420;201307;1389;4499;1102;3758;274;996;246;786;520;1782
421430;201307;265;915;210;799;78;336;40;145;118;481
421440;201307;785;2468;565;2050;193;735;214;773;407;1508
421450;201307;607;2185;516;1956;224;907;128;482;352;1389
421460;201307;586;2040;458;1761;131;560;101;354;232;914
421470;201307;473;1882;440;1790;143;610;180;708;323;1318
421480;201307;2451;8331;1836;6934;604;2549;562;1936;1166;4485
421490;201307;227;871;195;788;95;400;37;147;132;547
421500;201307;2610;9595;2350;9050;1032;4332;554;2082;1586;6414
421505;201307;397;1391;361;1297;136;495;120;434;256;929
421507;201307;582;2077;507;1884;124;470;201;748;325;1218
421510;201307;277;1088;256;1041;85;387;99;355;184;742
421520;201307;707;2043;532;1671;65;247;299;886;364;1133
421530;201307;445;1548;320;1271;99;443;110;420;209;863
421535;201307;624;2047;444;1668;102;414;212;790;314;1204
421540;201307;370;1198;326;1108;80;308;120;386;200;694
421545;201307;1176;4221;996;3842;334;1419;208;759;542;2178
421550;201307;2063;7359;1917;7053;760;3023;617;2220;1377;5243
421555;201307;219;746;130;482;34;141;34;116;68;257
421560;201307;188;657;118;464;40;164;16;62;56;226
421565;201307;1047;3402;961;3246;449;1618;287;934;736;2552
421567;201307;940;3635;821;3304;409;1682;155;627;564;2309
421568;201307;378;1434;359;1386;129;521;119;456;248;977
421569;201307;145;535;124;470;31;133;38;122;69;255
421570;201307;914;3256;746;2853;281;1173;191;687;472;1860
421575;201307;606;2102;543;1968;118;446;282;1041;400;1487
421580;201307;4128;14161;3368;12456;1364;5591;748;2523;2112;8114
421590;201307;245;818;210;725;49;177;93;305;142;482
421600;201307;747;2423;613;2139;206;759;166;563;372;1322
421605;201307;647;2086;463;1703;145;603;108;380;253;983
421610;201307;1808;4811;1422;4240;219;717;886;2644;1105;3361
421620;201307;4613;14661;3471;12270;1260;4783;1141;4069;2401;8852
421625;201307;328;1171;253;948;80;332;83;283;163;615
421630;201307;2362;7539;1638;5806;464;1797;414;1426;878;3223
421635;201307;280;1014;242;950;67;287;96;345;163;632
421640;201307;1088;3604;975;3410;220;782;594;2124;814;2906
421650;201307;2372;8283;2120;7715;891;3531;346;1202;1237;4733
421660;201307;8717;30545;7235;27545;2622;10941;2144;7762;4766;18703
421670;201307;1087;3811;889;3300;257;1047;267;982;524;2029
421680;201307;1399;4774;1274;4458;534;2014;221;695;755;2709
421690;201307;1997;6850;1587;5819;506;1997;308;1102;814;3099
421700;201307;736;2403;511;1929;183;751;130;429;313;1180
421710;201307;323;1188;276;1059;113;442;65;242;178;684
421715;201307;224;753;182;645;50;182;54;198;104;380
421720;201307;1510;5085;1301;4697;541;2165;412;1385;953;3550
421725;201307;125;460;120;446;38;149;51;184;89;333
421730;201307;542;1793;322;1228;91;393;84;263;175;656
421740;201307;668;2198;525;1853;157;644;129;365;286;1009
421750;201307;1309;4220;1095;3754;352;1294;353;1106;705;2400
421755;201307;409;1417;343;1228;100;381;104;356;204;737
421760;201307;347;1198;278;1054;90;385;123;430;213;815
421770;201307;3553;11206;3000;10134;1397;4923;738;2580;2135;7503
421775;201307;525;1703;396;1436;98;365;124;450;222;815
421780;201307;1703;6075;1395;5378;594;2462;368;1339;962;3801
421790;201307;910;2765;616;2234;208;855;142;470;350;1325
421795;201307;342;1107;280;926;50;174;87;284;137;458
421800;201307;2311;8008;1906;7151;572;2417;617;2078;1189;4495
421810;201307;692;2398;592;2137;197;765;124;423;321;1188
421820;201307;1013;3432;880;3132;215;907;320;1037;535;1944
421825;201307;1274;4479;1191;4266;214;863;649;2266;863;3129
421830;201307;3004;10712;2843;10396;695;2582;1586;6139;2281;8721
421835;201307;162;562;137;512;55;228;50;164;105;392
421840;201307;512;1864;460;1731;192;798;156;539;348;1337
421850;201307;556;1650;436;1451;145;503;139;488;284;991
421860;201307;434;1493;336;1270;77;318;95;347;172;665
421870;201307;5043;15391;3700;12555;1216;4435;687;2262;1903;6697
421875;201307;256;876;185;687;49;207;49;156;98;363
421880;201307;980;3374;817;2979;277;1145;189;608;466;1753
421885;201307;353;1275;321;1182;93;357;143;521;236;878
421890;201307;1054;3734;915;3430;319;1282;290;1061;609;2343
421895;201307;412;1456;400;1435;116;425;212;784;328;1209
421900;201307;860;2873;712;2503;196;736;260;840;456;1576
421910;201307;497;1700;385;1425;114;491;100;311;214;802
421915;201307;586;1876;518;1741;100;383;277;911;377;1294
421917;201307;500;1694;424;1543;153;639;122;387;275;1026
421920;201307;719;2356;611;2201;297;1150;176;578;473;1728
421930;201307;3616;11090;2730;9314;859;3251;455;1521;1314;4772
421935;201307;844;3129;705;2773;208;885;254;987;462;1872
421940;201307;292;1176;251;1039;95;423;58;210;153;633
421950;201307;4159;12154;2544;8876;828;3068;529;1873;1357;4941
421960;201307;240;800;202;709;57;216;56;191;113;407
421970;201307;1910;6162;1559;5356;557;2061;356;1116;913;3177
421985;201307;407;1204;264;899;45;184;94;333;139;517
430003;201307;902;2675;727;2375;217;801;266;862;483;1663
430005;201307;272;962;248;905;60;245;130;439;190;684
430010;201307;1951;6060;1558;5216;518;1786;567;1945;1085;3731
430020;201307;1084;3023;957;2831;241;803;514;1443;755;2246
430030;201307;1461;4253;1311;3930;409;1283;499;1440;908;2723
430040;201307;12688;33147;11316;31333;3523;10048;5560;15912;9083;25960
430045;201307;700;1991;580;1777;105;359;349;1034;454;1393
430047;201307;194;577;169;525;42;136;88;280;130;416
430050;201307;886;2613;603;2039;108;443;291;916;399;1359
430055;201307;254;763;199;637;47;166;105;326;152;492
430057;201307;68;182;29;97;7;30;11;24;18;54
430060;201307;13486;46068;12474;44327;4348;15990;5729;20841;10077;36831
430063;201307;1019;3163;870;2814;270;907;374;1250;644;2157
430064;201307;1645;5041;1416;4642;364;1195;778;2666;1142;3861
430066;201307;149;403;120;360;35;117;57;163;92;280
430070;201307;476;1658;421;1535;108;418;151;524;259;942
430080;201307;549;1903;464;1690;128;529;117;390;245;919
430085;201307;519;1685;449;1555;144;553;205;667;349;1220
430087;201307;939;2896;921;2862;94;315;766;2369;860;2684
430090;201307;712;1955;277;931;42;155;95;321;137;476
430100;201307;921;3145;818;2910;314;1224;207;633;521;1857
430105;201307;641;2196;556;2029;219;844;131;466;350;1310
430107;201307;252;854;205;713;41;153;98;325;139;478
430110;201307;2130;6488;1998;6283;661;2252;953;2971;1614;5223
430120;201307;1658;5297;1411;4765;269;956;890;2981;1159;3937
430130;201307;4424;11548;4112;11155;712;2050;2774;7664;3486;9714
430140;201307;1123;3763;906;3225;310;1105;314;1134;624;2239
430150;201307;832;2373;633;1997;164;546;210;657;374;1203
430155;201307;488;1574;373;1314;98;337;157;560;255;897
430160;201307;17961;54192;16870;52412;3804;13015;9572;30308;13376;43323
430163;201307;1780;5563;1549;5118;371;1382;716;2387;1087;3769
430165;201307;277;1003;242;934;109;429;44;166;153;595
430170;201307;731;2208;408;1447;113;452;98;303;211;755
430175;201307;985;3285;836;2953;220;743;439;1651;659;2394
430180;201307;1136;3212;1006;3027;202;648;590;1822;792;2470
430185;201307;723;1846;406;1227;64;232;140;350;204;582
430187;201307;746;2355;685;2263;188;736;311;991;499;1727
430190;201307;2228;6798;1978;6356;523;1921;955;3083;1478;5004
430192;201307;185;589;106;348;21;74;36;112;57;186
430195;201307;194;628;84;326;14;58;12;39;26;97
430200;201307;1745;5843;1530;5431;576;2158;287;1038;863;3196
430205;201307;477;1488;396;1343;47;201;269;894;316;1095
430210;201307;5794;17349;3559;12368;1036;3825;674;2174;1710;5999
430215;201307;306;960;259;869;72;263;122;391;194;654
430220;201307;603;1621;316;1080;73;285;56;174;129;459
430222;201307;309;975;243;833;73;284;98;311;171;595
430223;201307;295;954;276;920;67;230;175;586;242;816
430225;201307;39;134;35;118;4;9;7;20;11;29
430230;201307;2148;6882;2025;6751;376;1173;1508;5211;1884;6384
430235;201307;228;794;194;713;70;279;43;134;113;413
430237;201307;366;1085;328;1015;41;169;235;686;276;855
430240;201307;991;3134;824;2785;314;1198;233;681;547;1879
430245;201307;794;2837;703;2604;200;763;294;1115;494;1878
430250;201307;1585;4516;1454;4274;499;1556;606;1836;1105;3392
430258;201307;173;542;136;458;24;83;66;212;90;295
430260;201307;788;2305;547;1799;77;300;311;1015;388;1315
430265;201307;319;1046;266;905;109;398;35;91;144;489
430270;201307;3371;9888;3095;9433;889;3075;1502;4488;2391;7563
430280;201307;5053;15077;4553;14108;1458;4861;1978;6015;3436;10876
430290;201307;2344;6763;2229;6638;331;1003;1776;5388;2107;6391
430300;201307;9442;30010;8311;27878;3490;12262;3018;10484;6508;22746
430310;201307;8094;26365;7431;25105;2610;9478;3033;10026;5643;19504
430320;201307;784;2479;590;2077;97;332;300;1106;397;1438
430330;201307;935;2648;839;2468;228;735;371;1012;599;1747
430340;201307;672;1856;454;1546;119;461;214;714;333;1175
430350;201307;6009;19771;5278;18133;1963;7176;1905;6407;3868;13583
430355;201307;214;618;143;487;29;125;33;101;62;226
430360;201307;1056;2864;957;2698;162;505;595;1664;757;2169
430367;201307;331;951;236;769;40;150;85;249;125;399
430370;201307;574;1748;488;1567;169;590;136;396;305;986
430380;201307;849;2236;470;1539;143;489;158;541;301;1030
430390;201307;3908;12180;3166;10552;824;3039;1022;3187;1846;6226
430400;201307;1241;3046;895;2558;194;669;492;1312;686;1981
430410;201307;667;1894;537;1678;113;390;288;908;401;1298
430420;201307;4339;13048;3666;11526;1155;3713;1479;4686;2634;8399
430430;201307;649;1949;501;1660;171;605;130;396;301;1001
430435;201307;1834;5185;1651;4854;359;1053;1037;3107;1396;4160
430440;201307;4201;13449;3638;12533;913;3471;1545;5451;2458;8922
430450;201307;8947;26776;7635;23981;2618;8542;2926;9227;5544;17769
430460;201307;23372;73732;19834;67394;7062;25650;7219;24741;14281;50391
430461;201307;467;1330;157;517;34;112;37;128;71;240
430462;201307;323;994;280;918;113;392;92;296;205;688
430463;201307;3697;12524;3319;11736;919;3563;1589;5597;2508;9160
430465;201307;589;1705;496;1536;135;461;283;871;418;1332
430466;201307;4117;12623;3912;12253;1289;4344;1770;5561;3059;9905
430467;201307;551;1762;487;1643;139;512;222;739;361;1251
430468;201307;1391;4227;1249;3990;539;1873;253;785;792;2658
430469;201307;124;342;40;158;11;44;11;44;22;88
430470;201307;6699;18576;5359;16431;1894;6293;1940;5969;3834;12262
430471;201307;920;3165;830;2960;311;1164;187;666;498;1830
430480;201307;789;2294;500;1654;97;345;115;347;212;692
430485;201307;216;688;129;480;25;87;51;210;76;297
430490;201307;516;1560;368;1270;114;416;118;411;232;827
430495;201307;394;1235;289;1004;77;295;74;247;151;542
430500;201307;1591;4622;1416;4317;406;1380;697;2076;1103;3456
430510;201307;25760;82723;20278;68861;7173;26591;5684;18457;12857;45048
430511;201307;460;1447;292;1015;83;279;57;198;140;477
430512;201307;1278;3450;1147;3233;342;987;487;1442;829;2429
430513;201307;629;1859;467;1520;88;293;217;703;305;996
430515;201307;575;1798;499;1616;103;356;220;724;323;1080
430517;201307;1282;4463;1219;4314;244;931;756;2636;1000;3567
430520;201307;1694;5195;1447;4683;490;1697;606;1929;1096;3626
430530;201307;918;2676;607;1992;153;564;180;540;333;1104
430535;201307;2249;7596;1980;6941;571;2179;677;2369;1248;4548
430537;201307;581;1715;424;1457;58;195;329;1161;387;1356
430540;201307;724;1844;575;1641;132;431;329;893;461;1324
430543;201307;580;1580;528;1527;133;407;331;977;464;1384
430544;201307;675;2382;599;2160;147;553;299;1057;446;1610
430545;201307;1291;4291;1152;4119;395;1276;625;2537;1020;3813
430550;201307;575;1888;471;1631;125;480;195;653;320;1133
430558;201307;117;350;88;291;32;115;13;33;45;148
430560;201307;333;928;257;779;53;204;115;329;168;533
430570;201307;1091;3025;849;2596;215;727;437;1265;652;1992
430580;201307;976;2920;709;2376;257;886;209;728;466;1614
430583;201307;116;331;56;187;5;20;13;43;18;63
430585;201307;321;935;249;770;82;295;113;317;195;612
430587;201307;300;966;266;893;125;437;77;252;202;689
430590;201307;1538;4410;1462;4287;319;1069;871;2463;1190;3532
430593;201307;36;139;34;132;14;58;9;31;23;89
430595;201307;160;501;103;378;38;146;16;50;54;196
430597;201307;363;1170;312;1053;57;210;142;455;199;665
430600;201307;1815;5377;1379;4373;338;1137;502;1568;840;2705
430605;201307;1276;4176;1079;3747;278;1055;443;1583;721;2638
430607;201307;666;1877;589;1734;122;407;356;1001;478;1408
430610;201307;7880;22293;6530;20112;1508;5188;3315;10126;4823;15314
430613;201307;202;548;139;422;36;122;61;167;97;289
430620;201307;935;2996;798;2683;254;960;304;933;558;1893
430630;201307;430;1361;279;963;81;284;61;192;142;476
430632;201307;704;2022;480;1556;78;302;281;867;359;1169
430635;201307;628;1850;477;1551;95;328;263;860;358;1188
430637;201307;485;1414;450;1351;68;233;319;924;387;1157
430640;201307;1732;5154;1062;3567;261;931;219;618;480;1549
430642;201307;458;1276;350;1109;71;239;196;639;267;878
430645;201307;168;524;107;377;29;111;23;74;52;185
430650;201307;1973;6817;1749;6268;418;1551;949;3507;1367;5058
430655;201307;295;927;271;867;62;227;101;269;163;496
430660;201307;5673;17696;4709;15832;1628;5950;1813;6044;3441;11994
430670;201307;500;1487;454;1399;45;132;348;1108;393;1240
430673;201307;686;1772;455;1412;134;425;210;661;344;1086
430675;201307;174;528;132;438;23;89;64;206;87;295
430676;201307;4426;13853;4140;13393;1283;4471;1966;6528;3249;10999
430680;201307;1191;3618;931;3048;219;832;380;1139;599;1971
430690;201307;4285;12840;3696;11728;1221;4002;1564;5172;2785;9174
430692;201307;276;975;211;826;38;156;128;510;166;666
430693;201307;1747;5097;1403;4313;320;1062;477;1434;797;2496
430695;201307;495;1462;413;1296;94;335;195;571;289;906
430697;201307;411;1199;334;1076;117;381;135;460;252;841
430700;201307;10139;27829;5744;18901;1290;4768;916;2800;2206;7568
430705;201307;408;1296;380;1246;132;467;156;512;288;979
430710;201307;1796;4851;1482;4343;311;980;852;2618;1163;3598
430720;201307;757;2087;547;1774;167;567;237;793;404;1360
430730;201307;1667;4857;1476;4554;349;1070;850;2741;1199;3811
430740;201307;559;1706;403;1356;131;450;74;233;205;683
430745;201307;518;1525;403;1291;67;220;228;717;295;937
430750;201307;1716;5116;1538;4788;458;1597;779;2296;1237;3893
430755;201307;630;1853;470;1497;124;460;196;554;320;1014
430760;201307;3381;9116;2819;8420;607;1975;1631;4989;2238;6964
430770;201307;6523;20308;5562;18571;1448;5293;2567;8426;4015;13719
430780;201307;1863;5743;1591;5239;529;1895;623;1888;1152;3783
430781;201307;618;1955;478;1670;152;557;172;588;324;1145
430783;201307;546;1483;442;1302;91;299;204;549;295;848
430786;201307;115;404;103;370;40;157;13;43;53;200
430790;201307;3106;8988;2247;7284;530;1984;1007;3110;1537;5094
430800;201307;709;2310;625;2110;179;646;234;778;413;1424
430805;201307;436;1318;353;1158;28;107;246;814;274;921
430807;201307;266;858;239;799;59;232;107;324;166;556
430810;201307;496;1531;308;1087;62;255;56;173;118;428
430820;201307;1120;3846;977;3494;320;1239;323;1105;643;2344
430825;201307;445;1309;255;840;52;189;75;224;127;413
430830;201307;2713;8145;2517;7809;418;1343;1612;5285;2030;6628
430840;201307;923;2942;871;2837;236;736;412;1440;648;2176
430843;201307;98;326;77;255;15;48;31;99;46;147
430845;201307;463;1406;393;1276;140;481;80;247;220;728
430850;201307;3210;10167;2926;9629;943;3275;1156;3825;2099;7100
430860;201307;612;2117;537;1935;188;793;125;388;313;1181
430865;201307;703;2004;657;1916;196;586;343;1014;539;1600
430870;201307;447;1427;359;1246;130;460;124;417;254;877
430880;201307;1330;4018;1121;3589;469;1617;279;911;748;2528
430885;201307;166;563;142;515;51;190;37;138;88;328
430890;201307;1843;5182;1591;4757;198;672;1075;3245;1273;3917
430900;201307;3197;8888;3040;8686;583;1724;2071;6071;2654;7795
430905;201307;1001;3103;764;2574;273;988;201;648;474;1636
430910;201307;1674;5571;1486;5231;603;2300;524;1793;1127;4093
430912;201307;567;1687;456;1494;88;344;236;739;324;1083
430915;201307;394;1441;319;1269;90;394;94;362;184;756
430920;201307;16312;53781;15563;52552;5680;19789;8360;28268;14040;48057
430925;201307;92;264;75;230;21;71;39;117;60;188
430930;201307;8701;28407;7563;26075;2324;8510;3173;11230;5497;19740
430940;201307;1026;3308;881;3045;223;886;297;970;520;1856
430950;201307;1582;4607;1239;3853;384;1261;395;1208;779;2469
430955;201307;90;307;72;259;28;110;16;53;44;163
430957;201307;306;1075;263;977;69;261;127;474;196;735
430960;201307;1652;4945;1416;4529;565;1884;489;1580;1054;3464
430965;201307;1178;3908;1028;3584;227;908;594;1997;821;2905
430970;201307;498;1482;342;1144;96;355;99;323;195;678
430975;201307;603;2036;526;1852;107;396;331;1164;438;1560
430980;201307;546;1393;349;1102;98;354;129;357;227;711
430990;201307;625;2093;488;1726;166;613;107;376;273;989
430995;201307;688;2121;639;2028;213;683;280;920;493;1603
431000;201307;1575;4449;1020;3304;282;1041;153;426;435;1467
431010;201307;2549;7928;1888;6537;565;2167;613;1999;1178;4166
431020;201307;13730;35439;9874;28394;2988;9037;3122;9264;6110;18301
431030;201307;401;1261;265;933;55;202;69;258;124;460
431033;201307;2813;8370;2592;8047;629;2029;1500;4908;2129;6937
431036;201307;161;495;93;322;25;93;21;58;46;151
431040;201307;986;2979;856;2750;249;877;425;1338;674;2215
431041;201307;575;1628;514;1536;192;604;174;548;366;1152
431043;201307;367;1255;301;1096;139;554;103;334;242;888
431046;201307;110;343;86;291;24;86;35;116;59;202
431050;201307;1771;4567;1572;4320;307;832;1067;3051;1374;3883
431053;201307;586;1995;514;1844;172;683;194;672;366;1355
431055;201307;614;1835;594;1803;80;247;446;1377;526;1624
431057;201307;300;893;185;657;55;214;75;254;130;468
431060;201307;6111;18358;5840;18037;1120;3088;4212;13712;5332;16800
431065;201307;431;1350;413;1316;49;165;285;908;334;1073
431070;201307;737;2224;530;1748;124;401;199;636;323;1037
431075;201307;262;811;180;620;35;138;58;200;93;338
431080;201307;636;2117;536;1904;158;599;97;324;255;923
431085;201307;893;2473;731;2199;146;466;398;1196;544;1662
431087;201307;591;1762;548;1683;34;86;461;1445;495;1531
431090;201307;474;1297;298;954;98;336;83;247;181;583
431100;201307;4609;13156;3987;12077;1125;3643;1808;5578;2933;9221
431110;201307;1476;4243;1279;3855;348;1101;705;2077;1053;3178
431112;201307;730;2331;697;2276;252;839;324;1088;576;1927
431113;201307;629;1949;475;1583;164;536;130;456;294;992
431115;201307;1433;4462;1348;4307;333;1125;790;2496;1123;3621
431120;201307;2575;8611;2366;8206;756;2916;1016;3381;1772;6297
431123;201307;511;1676;442;1535;123;442;215;769;338;1211
431125;201307;1289;4231;1106;3841;341;1215;487;1784;828;2999
431127;201307;113;328;70;221;15;48;15;44;30;92
431130;201307;3811;11265;3271;10367;994;3460;1453;4647;2447;8107
431140;201307;3410;9613;2234;7462;497;1944;753;2297;1250;4241
431142;201307;549;1677;511;1619;66;232;358;1149;424;1381
431150;201307;1298;4045;1082;3642;313;1077;398;1378;711;2455
431160;201307;863;2697;735;2410;154;511;419;1396;573;1907
431162;201307;422;1221;267;900;54;201;59;184;113;385
431164;201307;77;226;33;123;11;38;1;4;12;42
431170;201307;879;2712;750;2448;243;839;233;752;476;1591
431171;201307;851;2663;776;2514;263;923;197;588;460;1511
431173;201307;469;1461;443;1412;99;329;274;877;373;1206
431175;201307;1302;3713;1144;3469;387;1239;492;1486;879;2725
431177;201307;963;3269;881;3098;296;1108;390;1390;686;2498
431179;201307;113;315;88;265;19;67;37;94;56;161
431180;201307;3136;9801;2650;8649;769;2780;865;2658;1634;5438
431190;201307;755;2143;495;1640;144;529;181;589;325;1118
431198;201307;342;1156;311;1093;146;577;59;187;205;764
431200;201307;237;727;118;409;25;96;18;61;43;157
431205;201307;284;959;229;800;65;233;75;251;140;484
431210;201307;737;2190;649;2001;164;527;348;1058;512;1585
431213;201307;317;1008;267;915;79;301;106;347;185;648
431215;201307;325;980;172;591;46;169;29;88;75;257
431217;201307;216;705;193;651;69;252;50;172;119;424
431220;201307;1179;3102;934;2671;133;430;549;1527;682;1957
431225;201307;1311;4078;1182;3858;292;1016;682;2263;974;3279
431230;201307;934;2880;758;2512;130;479;420;1395;550;1874
431235;201307;44;131;37;116;12;42;13;38;25;80
431237;201307;406;1396;366;1331;151;628;130;439;281;1067
431238;201307;51;171;43;154;10;41;15;50;25;91
431240;201307;2828;9257;2493;8620;919;3387;819;2818;1738;6205
431242;201307;426;1416;407;1382;182;689;27;80;209;769
431244;201307;431;1090;339;948;68;232;166;432;234;664
431245;201307;948;2739;817;2520;178;573;504;1577;682;2150
431247;201307;190;616;170;580;63;228;65;214;128;442
431250;201307;1879;6117;1692;5836;578;2137;684;2446;1262;4583
431260;201307;309;981;270;903;68;259;62;192;130;451
431261;201307;229;830;201;768;50;216;72;266;122;482
431262;201307;327;969;171;620;28;130;70;250;98;380
431265;201307;1184;3349;823;2555;216;765;278;733;494;1498
431267;201307;191;601;161;546;45;167;67;207;112;374
431270;201307;2275;6718;2066;6403;690;2286;990;3090;1680;5376
431275;201307;211;702;154;548;52;181;35;116;87;297
431280;201307;146;485;107;389;32;135;24;68;56;203
431290;201307;310;1023;245;850;69;273;59;193;128;466
431295;201307;204;673;125;429;25;100;26;72;51;172
431300;201307;127;469;98;378;36;142;9;37;45;179
431301;201307;231;815;182;671;60;221;33;113;93;334
431303;201307;608;1734;524;1599;146;504;229;673;375;1177
431306;201307;2042;5849;1580;4994;343;1295;591;1668;934;2963
431308;201307;54;191;52;186;39;141;10;34;49;175
431310;201307;736;2445;571;2049;106;415;239;874;345;1289
431320;201307;798;2409;521;1840;160;635;122;381;282;1016
431330;201307;1814;4879;1023;3364;302;1106;238;765;540;1871
431333;201307;303;866;227;710;64;210;75;223;139;433
431335;201307;100;313;86;284;18;58;30;94;48;152
431337;201307;2411;7760;2131;7180;681;2429;711;2398;1392;4827
431339;201307;616;1845;489;1546;114;368;242;785;356;1153
431340;201307;26317;72986;20248;62636;5295;18252;8612;26000;13907;44252
431342;201307;577;1610;533;1528;118;354;340;959;458;1313
431344;201307;359;1043;290;924;23;77;186;606;209;683
431346;201307;279;784;184;556;55;169;55;163;110;332
431349;201307;517;1595;443;1416;89;281;219;710;308;991
431350;201307;3649;11354;3377;10903;535;1996;2279;7156;2814;9152
431360;201307;709;2053;583;1836;186;618;209;646;395;1264
431365;201307;1254;4018;1107;3764;452;1673;396;1321;848;2994
431370;201307;5396;16279;4746;15235;1227;4207;2500;8243;3727;12450
431380;201307;1125;3435;1072;3305;166;576;772;2338;938;2914
431390;201307;3289;10030;2544;8510;881;3216;729;2319;1610;5535
431395;201307;1563;4845;1422;4621;361;1252;629;2100;990;3352
431400;201307;146;532;111;439;40;175;13;42;53;217
431402;201307;1150;3006;774;2321;151;504;378;1091;529;1595
431403;201307;314;941;240;806;85;320;48;149;133;469
431405;201307;4364;12781;3549;11528;859;3268;1714;5334;2573;8602
431406;201307;770;2526;600;2087;208;752;215;733;423;1485
431407;201307;634;2020;493;1672;163;563;135;443;298;1006
431410;201307;16131;51762;13561;46668;5668;20740;3351;12066;9019;32806
431413;201307;189;499;102;331;11;42;49;155;60;197
431415;201307;841;2523;757;2365;193;662;410;1256;603;1918
431417;201307;658;1745;530;1541;95;301;289;868;384;1169
431420;201307;1578;4477;1422;4226;354;1127;782;2354;1136;3481
431430;201307;560;1610;446;1426;129;463;181;549;310;1012
431440;201307;31583;95464;29035;91174;9874;32405;13212;43006;23086;75411
431442;201307;199;658;154;538;48;189;19;50;67;239
431445;201307;454;1306;362;1098;65;217;170;505;235;722
431446;201307;482;1446;371;1223;88;299;195;640;283;939
431447;201307;832;2453;629;1990;120;402;298;959;418;1361
431449;201307;848;2544;738;2352;133;459;405;1311;538;1770
431450;201307;2174;5916;2028;5698;562;1604;1182;3337;1744;4941
431455;201307;586;1569;446;1304;110;359;210;578;320;937
431460;201307;3644;10561;3226;9761;909;2895;1394;4300;2303;7195
431470;201307;2129;6422;1914;5944;568;1754;867;2835;1435;4589
431475;201307;92;316;58;233;13;53;4;18;17;71
431477;201307;595;1762;493;1551;134;433;242;754;376;1187
431478;201307;170;455;93;284;24;78;37;109;61;187
431480;201307;2437;7492;1965;6569;673;2403;493;1641;1166;4044
431490;201307;101907;300633;91283;284865;18047;64015;58669;179709;76716;243724
431500;201307;1185;3150;959;2730;293;851;331;943;624;1794
431505;201307;350;1042;338;1026;36;105;273;838;309;943
431507;201307;436;1109;381;1010;103;289;225;589;328;878
431510;201307;2187;6171;1899;5705;329;1086;1183;3496;1512;4582
431513;201307;211;655;184;590;45;152;77;254;122;406
431514;201307;105;263;63;196;12;41;33;105;45;146
431515;201307;747;2323;599;1970;142;514;301;927;443;1441
431517;201307;86;294;82;283;36;126;19;54;55;180
431520;201307;448;1437;345;1191;107;383;89;320;196;703
431530;201307;4417;11271;3657;10434;888;2500;2257;6936;3145;9436
431531;201307;265;773;198;640;54;198;80;270;134;468
431532;201307;512;1528;485;1472;99;328;284;851;383;1179
431535;201307;374;1118;258;812;62;226;62;171;124;397
431540;201307;2079;6987;1903;6746;214;628;1403;5370;1617;5998
431545;201307;132;405;62;229;5;21;11;44;16;65
431550;201307;2405;7469;2262;7193;570;2050;1078;3377;1648;5427
431555;201307;753;2077;681;1961;148;425;362;1045;510;1470
431560;201307;22857;73807;20836;69855;9069;30881;6762;23962;15831;54843
431570;201307;5424;16078;5146;15633;965;2918;3603;11147;4568;14065
431575;201307;374;1130;328;1058;58;214;190;591;248;805
431580;201307;690;2264;601;2058;158;607;227;721;385;1328
431590;201307;898;2723;724;2331;84;292;400;1295;484;1587
431595;201307;606;1791;539;1639;134;433;208;649;342;1082
431600;201307;2132;6684;1731;5796;503;1916;378;1074;881;2990
431610;201307;1568;4607;1215;3971;314;1116;608;1975;922;3091
431620;201307;297;952;239;777;87;295;94;292;181;587
431630;201307;1341;3795;1106;3288;258;797;592;1771;850;2568
431640;201307;5593;17698;5235;17090;1616;5787;2628;8363;4244;14150
431642;201307;488;1525;448;1427;67;249;259;795;326;1044
431643;201307;176;536;165;515;48;164;87;248;135;412
431645;201307;1788;5597;1656;5370;411;1361;962;3215;1373;4576
431647;201307;170;490;139;426;45;142;38;98;83;240
431650;201307;198;663;143;544;37;159;32;109;69;268
431660;201307;1433;4407;1159;3826;401;1394;427;1338;828;2732
431670;201307;1316;3815;1107;3436;335;1181;452;1322;787;2503
431673;201307;186;609;144;506;42;164;37;130;79;294
431675;201307;286;967;222;765;59;212;60;179;119;391
431680;201307;9581;28556;7803;25303;2561;8905;2891;9451;5452;18356
431690;201307;24564;72909;20645;66949;6818;23616;8305;27346;15123;50962
431695;201307;135;489;111;413;28;105;26;74;54;179
431697;201307;479;1408;454;1364;136;435;209;625;345;1060
431700;201307;1630;4710;1432;4330;305;1019;771;2261;1076;3280
431710;201307;12632;38165;10841;35053;3160;10716;4977;16733;8137;27449
431720;201307;6954;20427;6022;18764;1473;5229;3209;9715;4682;14944
431725;201307;40;148;39;145;21;80;6;22;27;102
431730;201307;3594;11499;3051;10467;915;3477;1220;4178;2135;7655
431740;201307;5959;18064;5398;16984;1862;6295;1954;6037;3816;12332
431750;201307;10166;29908;8838;27705;1817;6153;4817;15379;6634;21532
431755;201307;239;648;82;283;24;95;22;60;46;155
431760;201307;3750;11873;3214;10795;981;3548;930;3071;1911;6619
431770;201307;2278;6493;1993;6026;505;1667;1065;3146;1570;4813
431775;201307;242;711;194;615;74;248;59;169;133;417
431780;201307;2499;6976;2043;6110;645;2074;589;1687;1234;3761
431790;201307;1114;3650;1025;3491;288;1062;533;1796;821;2858
431795;201307;458;1426;379;1224;55;188;224;724;279;912
431800;201307;9316;28439;8080;26191;2656;9392;2832;9021;5488;18413
431805;201307;247;604;69;249;18;75;14;49;32;124
431810;201307;3710;10773;3240;9789;863;2803;1527;4572;2390;7375
431820;201307;2680;8731;2442;8259;779;2852;823;2724;1602;5576
431830;201307;10167;28373;8890;26292;3348;10749;3168;9369;6516;20118
431840;201307;3513;10891;3120;10091;1011;3367;1334;4392;2345;7759
431842;201307;712;1909;437;1363;96;323;153;463;249;786
431843;201307;311;980;288;939;78;278;150;477;228;755
431844;201307;165;509;129;437;37;141;38;131;75;272
431845;201307;535;1688;507;1633;51;165;370;1220;421;1385
431846;201307;498;1567;446;1456;82;305;257;834;339;1139
431848;201307;193;527;95;326;19;79;22;67;41;146
431849;201307;303;801;133;419;24;84;36;100;60;184
431850;201307;4929;14736;4438;13822;1122;3891;2303;6961;3425;10852
431860;201307;968;2830;831;2604;230;788;399;1196;629;1984
431861;201307;81;269;57;197;17;64;9;29;26;93
431862;201307;474;1678;420;1558;165;663;123;439;288;1102
431870;201307;26234;75636;22295;68544;6353;21472;9698;29072;16051;50544
431880;201307;4609;15146;3942;13557;1257;4754;1564;5207;2821;9961
431890;201307;5766;17221;5188;16123;2102;6867;1608;5116;3710;11983
431900;201307;924;3036;805;2806;253;988;315;1001;568;1989
431910;201307;847;2115;472;1399;109;362;193;522;302;884
431912;201307;596;1761;479;1515;146;458;168;546;314;1004
431915;201307;1287;3673;1029;3182;309;993;352;1097;661;2090
431920;201307;1462;4355;1410;4279;201;594;1093;3394;1294;3988
431930;201307;1249;3593;1016;3195;143;442;620;2065;763;2507
431935;201307;96;375;91;362;43;179;18;56;61;235
431936;201307;487;1408;445;1332;74;214;292;949;366;1163
431937;201307;291;823;204;644;50;171;64;190;114;361
431940;201307;2661;7582;1948;6238;576;1966;556;1747;1132;3713
431950;201307;1862;6095;1672;5724;514;1918;640;2088;1154;4006
431960;201307;3704;11314;3416;10739;1108;3700;1226;3892;2334;7592
431970;201307;503;1422;286;964;53;189;87;273;140;462
431971;201307;129;402;114;380;20;70;61;198;81;268
431973;201307;467;1699;418;1595;69;270;241;998;310;1268
431975;201307;13;56;10;48;2;12;3;13;5;25
431980;201307;1513;4523;1402;4305;368;1326;675;1981;1043;3307
431990;201307;8664;25007;7371;23053;1483;5334;3853;11895;5336;17229
432000;201307;10341;31462;8756;28647;2981;10077;3715;12359;6696;22436
432010;201307;2465;7520;2184;6979;542;1993;1053;3212;1595;5205
432020;201307;1979;5624;1809;5400;356;1139;1120;3338;1476;4477
432023;201307;511;1526;402;1282;114;413;156;465;270;878
432026;201307;1202;3799;1075;3541;243;813;599;2027;842;2840
432030;201307;408;1262;352;1136;102;356;146;444;248;800
432032;201307;459;1264;346;1077;62;204;212;654;274;858
432035;201307;831;2763;767;2622;208;774;429;1427;637;2201
432040;201307;686;2106;512;1708;119;441;127;324;246;765
432045;201307;191;656;168;606;49;189;70;249;119;438
432050;201307;758;2258;684;2115;144;464;395;1253;539;1717
432055;201307;757;2457;692;2317;158;583;424;1394;582;1977
432057;201307;472;1306;409;1179;56;186;246;666;302;852
432060;201307;415;1227;197;716;66;255;48;163;114;418
432065;201307;204;653;177;600;43;169;80;243;123;412
432067;201307;948;3193;712;2624;218;834;291;1041;509;1875
432070;201307;2227;6578;1984;6067;682;2292;742;2262;1424;4554
432080;201307;4074;12259;3705;11619;1164;3870;1661;5180;2825;9050
432085;201307;251;830;222;777;82;333;66;214;148;547
432090;201307;1645;5318;1444;4866;577;2090;388;1131;965;3221
432100;201307;1088;3373;678;2410;202;752;133;416;335;1168
432110;201307;3010;9257;2508;8251;925;3314;526;1695;1451;5009
432120;201307;4928;15604;4294;14354;1530;5613;1225;3942;2755;9555
432130;201307;1989;6355;1871;6155;540;1927;1062;3491;1602;5418
432132;201307;406;1289;265;940;45;164;101;329;146;493
432135;201307;782;2392;742;2321;148;489;476;1490;624;1979
432140;201307;2889;8731;2434;7893;710;2381;965;3496;1675;5877
432143;201307;1330;4220;1181;3983;262;917;763;2640;1025;3557
432145;201307;898;2914;657;2371;235;926;132;428;367;1354
432146;201307;242;803;196;683;71;259;54;185;125;444
432147;201307;826;2665;678;2338;202;727;283;996;485;1723
432149;201307;385;1209;292;968;85;296;109;352;194;648
432150;201307;3054;9540;2568;8760;1036;3734;779;2742;1815;6476
432160;201307;4390;14777;3982;14069;1479;5526;1493;5541;2972;11067
432162;201307;313;787;96;320;25;94;23;62;48;156
432163;201307;323;848;106;340;22;71;22;69;44;140
432166;201307;759;2345;644;2113;148;550;289;874;437;1424
432170;201307;762;2607;564;2147;141;596;122;404;263;1000
432180;201307;2717;7398;2029;6292;636;2183;649;1914;1285;4097
432183;201307;396;1353;370;1296;159;573;101;365;260;938
432185;201307;808;2411;556;1853;135;495;202;653;337;1148
432190;201307;3373;9653;2612;7957;721;2356;825;2367;1546;4723
432195;201307;1262;3666;1145;3490;201;664;734;2227;935;2891
432200;201307;3061;9789;2534;8860;869;3227;1011;3643;1880;6870
432210;201307;422;1286;378;1227;110;414;179;541;289;955
432215;201307;857;2768;790;2662;155;504;508;1791;663;2295
432218;201307;304;878;238;742;50;163;103;301;153;464
432220;201307;3726;10390;3184;9495;568;1966;1923;5583;2491;7549
432225;201307;60;214;53;204;31;122;6;29;37;151
432230;201307;998;2910;881;2727;290;999;406;1175;696;2174
432232;201307;551;1666;445;1460;103;384;240;780;343;1164
432234;201307;562;1593;432;1263;108;329;179;494;287;823
432235;201307;68;226;43;163;20;86;10;38;30;124
432237;201307;492;1405;456;1347;39;145;380;1105;419;1250
432240;201307;14894;51590;13258;49381;3424;13727;7793;29650;11217;43377
432250;201307;5359;19409;5115;18895;2487;9803;1224;4628;3711;14431
432252;201307;420;1314;386;1247;127;425;187;624;314;1049
432253;201307;1226;4230;1013;3666;348;1307;331;1191;679;2498
432254;201307;378;1013;170;564;50;178;20;62;70;240
432255;201307;169;447;99;336;26;98;40;138;66;236
432260;201307;6255;17293;4997;15247;1195;3883;2556;7871;3751;11754
432270;201307;2544;8320;2334;7941;662;2322;1242;4301;1904;6623
432280;201307;1050;3205;742;2545;196;771;203;580;399;1351
432285;201307;106;340;70;240;23;87;15;42;38;129
432290;201307;590;1835;424;1443;95;360;166;539;261;899
432300;201307;22324;70642;20836;68086;5921;20522;10839;35463;16760;55985
432310;201307;981;3192;866;2968;220;823;434;1434;654;2257
432320;201307;261;772;193;634;59;194;67;231;126;425
432330;201307;202;628;107;385;25;99;10;32;35;131
432335;201307;207;607;103;356;31;112;13;38;44;150
432340;201307;280;746;154;476;48;153;38;108;86;261
432345;201307;720;2135;674;2072;176;643;364;1041;540;1684
432350;201307;423;1266;321;1071;85;303;89;282;174;585
432360;201307;45;151;38;136;16;58;12;39;28;97
432370;201307;447;1313;399;1226;35;103;272;848;307;951
432375;201307;804;2157;707;1996;125;365;440;1265;565;1630
432377;201307;73;261;35;126;6;24;8;20;14;44
432380;201307;824;2992;758;2834;349;1432;236;819;585;2251
500020;201307;1825;6245;1513;5561;524;2126;391;1335;915;3461
500025;201307;894;2419;617;1923;133;437;260;781;393;1218
500060;201307;5578;16729;4844;15834;445;1427;4001;13486;4446;14913
500070;201307;3475;11052;3044;10335;807;3099;1402;4623;2209;7722
500080;201307;1616;5061;1316;4539;454;1699;399;1425;853;3124
500085;201307;2195;6042;1675;5217;253;861;991;2986;1244;3847
500090;201307;2127;6606;1767;5934;409;1421;924;3193;1333;4614
500100;201307;2318;7247;2189;7058;789;2879;919;2788;1708;5667
500110;201307;7611;22977;6397;21143;1079;4001;3811;13037;4890;17038
500124;201307;1583;5514;1422;5237;283;1009;823;3307;1106;4316
500150;201307;1265;3541;1074;3267;310;1023;513;1527;823;2550
500190;201307;4558;12607;3647;11486;842;2865;2057;6677;2899;9542
500200;201307;2466;6632;1853;5758;437;1529;963;2903;1400;4432
500210;201307;4660;14628;4132;13848;1019;3676;2108;7296;3127;10972
500215;201307;1681;5428;1445;4935;369;1438;619;1992;988;3430
500220;201307;2519;8306;2115;7529;557;2157;840;3033;1397;5190
500230;201307;1705;5237;1488;4929;698;2506;473;1547;1171;4053
500240;201307;4120;13824;3356;12187;806;3265;1463;5438;2269;8703
500260;201307;2370;6781;2015;6221;506;1730;946;2732;1452;4462
500270;201307;95657;261369;68554;214822;22095;75394;18159;57672;40254;133066
500280;201307;1229;3753;1087;3546;248;864;610;2034;858;2898
500290;201307;3329;9277;2480;7746;759;2739;874;2506;1633;5245
500295;201307;2160;7057;1722;5965;463;1826;492;1513;955;3339
500310;201307;792;2198;719;2099;172;556;408;1136;580;1692
500315;201307;2719;8763;2382;8304;558;1886;1388;5196;1946;7082
500320;201307;12364;43221;11149;41044;3966;15309;4123;16225;8089;31534
500325;201307;3737;10536;2972;9284;926;3205;1133;3326;2059;6531
500330;201307;4966;14452;4388;13494;1392;4676;1995;6009;3387;10685
500345;201307;2236;7158;2038;6772;546;2002;999;3234;1545;5236
500348;201307;2318;7177;2186;6959;295;1030;1642;5232;1937;6262
500350;201307;1123;3549;762;2729;137;506;225;858;362;1364
500370;201307;21291;69295;17724;62324;4806;18769;7263;25506;12069;44275
500375;201307;2387;6995;1943;6175;485;1622;947;3109;1432;4731
500380;201307;2850;8537;2467;7747;744;2485;968;3041;1712;5526
500390;201307;524;1192;356;947;55;187;249;610;304;797
500400;201307;1191;3966;1048;3621;347;1313;300;954;647;2267
500410;201307;2010;5773;1713;5356;467;1589;771;2418;1238;4007
500430;201307;2348;7542;2027;7057;605;2207;901;3252;1506;5459
500440;201307;1278;3867;1111;3594;315;1159;584;1802;899;2961
500450;201307;2108;6712;1684;5821;475;1848;349;1085;824;2933
500460;201307;3490;10968;2903;10063;755;2841;1320;4588;2075;7429
500470;201307;3325;10669;2843;9512;978;3554;642;1982;1620;5536
500480;201307;1966;6532;1831;6318;195;731;1430;5018;1625;5749
500490;201307;988;2999;868;2797;299;1049;326;1065;625;2114
500500;201307;2955;9587;2514;8999;978;3928;921;3183;1899;7111
500510;201307;759;2157;573;1864;163;636;238;684;401;1320
500515;201307;1692;4901;1414;4503;275;849;892;3019;1167;3868
500520;201307;2548;9258;2305;8946;600;2429;1374;5561;1974;7990
500525;201307;1061;3654;952;3453;238;920;473;1817;711;2737
500540;201307;4088;12969;3070;10965;982;3876;922;3263;1904;7139
500560;201307;4264;15154;3920;14658;902;3569;2454;9328;3356;12897
500568;201307;3517;9690;2724;8535;642;2174;1304;4190;1946;6364
500570;201307;7195;20459;5362;17290;1642;5670;2096;6789;3738;12459
500580;201307;3014;9421;2486;8442;554;2011;1353;4589;1907;6600
500600;201307;2410;7304;2010;6667;668;2374;771;2514;1439;4888
500620;201307;7457;21635;5611;18636;1467;5475;2700;8828;4167;14303
500625;201307;851;2604;600;2078;165;625;197;632;362;1257
500630;201307;5895;17042;4848;15550;1793;6381;1363;4347;3156;10728
500635;201307;2183;9038;1987;8729;323;1351;1277;6092;1600;7443
500640;201307;1228;3376;1030;3085;172;574;657;1918;829;2492
500660;201307;13390;42801;11694;39829;2590;9609;6552;22321;9142;31930
500690;201307;2891;8638;2423;8054;615;2135;1360;4737;1975;6872
500710;201307;3114;10193;2958;9947;879;3121;1505;5099;2384;8220
500720;201307;4122;12856;3344;11287;1101;4080;1140;3810;2241;7890
500730;201307;879;2622;734;2342;195;697;301;931;496;1628
500740;201307;3423;9908;2618;8510;630;2362;1169;3581;1799;5943
500750;201307;774;2418;721;2339;185;656;405;1317;590;1973
500755;201307;1203;3717;953;3244;245;889;379;1263;624;2152
500769;201307;4292;12054;3062;9623;756;2657;1046;3027;1802;5684
500770;201307;1528;4806;1297;4369;385;1399;479;1642;864;3041
500780;201307;921;3129;868;3019;315;1171;362;1221;677;2392
500790;201307;7898;23537;6732;21455;1506;5613;3541;10747;5047;16360
500793;201307;2350;7012;1912;6258;369;1372;849;2616;1218;3988
500795;201307;2145;6619;1945;6325;231;665;1478;5061;1709;5726
500797;201307;847;2471;698;2236;168;590;323;1052;491;1642
500800;201307;2109;6574;1832;6181;591;2196;826;2789;1417;4985
500830;201307;13938;43481;10932;37036;3530;12925;3015;9993;6545;22918
500840;201307;1218;3815;1022;3430;205;754;521;1739;726;2493
510010;201307;1227;3981;1152;3855;387;1381;510;1738;897;3119
510020;201307;2402;7309;1896;6441;589;2149;523;1704;1112;3853
510025;201307;8665;27017;7739;25463;2542;9234;3119;10006;5661;19240
510030;201307;2041;5669;1756;5259;536;1670;867;2660;1403;4330
510035;201307;894;2734;771;2547;180;612;428;1486;608;2098
510040;201307;1555;4428;1243;3970;301;1103;618;1923;919;3026
510050;201307;1625;5025;1297;4435;383;1451;511;1759;894;3210
510060;201307;1149;3506;918;3072;285;1061;286;912;571;1973
510080;201307;1270;4018;1080;3702;325;1310;411;1273;736;2583
510100;201307;576;1578;396;1230;99;340;149;449;248;789
510120;201307;278;588;201;502;14;24;179;460;193;484
510125;201307;2806;7694;2338;6937;485;1754;1159;3274;1644;5028
510130;201307;1941;5612;1731;5318;532;1721;758;2354;1290;4075
510140;201307;2886;9777;2447;9087;895;3459;954;3649;1849;7108
510160;201307;1261;4349;1208;4288;89;353;1065;3779;1154;4132
510170;201307;5466;17624;4809;16414;1289;4942;2189;7253;3478;12195
510180;201307;9647;28000;7515;24393;2474;8516;2761;9661;5235;18177
510185;201307;1049;3377;983;3283;255;824;590;2100;845;2924
510190;201307;1495;5277;1279;4928;344;1481;571;2254;915;3735
510250;201307;13110;43096;11543;40972;3657;13702;5691;20675;9348;34377
510260;201307;2476;9365;2344;9102;711;2833;1169;4752;1880;7585
510263;201307;3936;11282;3134;9980;928;3210;1112;3456;2040;6666
510267;201307;4154;12832;3538;11597;903;3317;1538;4823;2441;8140
510268;201307;827;2450;720;2308;218;771;358;1137;576;1908
510269;201307;803;2684;727;2556;236;864;295;1078;531;1942
510270;201307;2309;7422;2085;7092;485;1680;1138;4105;1623;5785
510279;201307;2017;6685;1863;6427;715;2737;638;2038;1353;4775
510285;201307;1415;4543;1231;4186;379;1390;426;1387;805;2777
510300;201307;2922;9417;2688;9100;410;1556;1973;6632;2383;8188
510305;201307;1583;5202;1329;4718;383;1506;449;1636;832;3142
510310;201307;1058;3112;851;2782;309;1124;263;839;572;1963
510320;201307;3763;11543;3115;10254;1006;3839;596;1651;1602;5490
510325;201307;5348;17530;4710;16594;620;2147;3575;13057;4195;15204
510330;201307;2589;8747;2286;8192;626;2491;906;3311;1532;5802
510335;201307;4276;13987;3847;13406;679;2347;2751;9961;3430;12308
510336;201307;481;1557;439;1473;101;368;221;734;322;1102
510337;201307;2206;7602;2011;7243;830;3052;727;2821;1557;5873
510340;201307;55877;172703;46490;158534;19135;70779;11109;39975;30244;110754
510343;201307;1053;3281;992;3207;131;404;789;2632;920;3036
510345;201307;1600;4804;1416;4507;396;1332;588;1891;984;3223
510350;201307;3056;9464;2651;8920;810;2912;1344;4580;2154;7492
510360;201307;1680;4746;1348;4330;283;967;885;2839;1168;3806
510370;201307;811;2967;724;2819;232;956;325;1290;557;2246
510380;201307;469;1573;388;1400;147;597;72;236;219;833
510385;201307;849;3293;756;3057;140;597;373;1631;513;2228
510390;201307;1025;3367;947;3272;266;901;514;1908;780;2809
510395;201307;809;2173;636;1950;128;420;384;1225;512;1645
510410;201307;3679;12526;3516;12250;1097;4143;1781;6136;2878;10279
510420;201307;2143;5813;1672;5026;287;1031;921;2732;1208;3763
510450;201307;559;1587;435;1411;140;507;138;441;278;948
510452;201307;590;1888;449;1566;119;472;163;519;282;991
510454;201307;685;2273;612;2165;165;611;334;1227;499;1838
510455;201307;927;2957;754;2656;197;815;307;1056;504;1871
510460;201307;1677;5202;1571;5061;370;1368;972;3012;1342;4380
510480;201307;3834;10850;3072;9402;822;2732;1231;3693;2053;6425
510490;201307;1423;4848;1305;4676;391;1476;712;2552;1103;4028
510500;201307;1218;3971;1013;3636;293;1184;509;1783;802;2967
510510;201307;2863;10291;2586;9829;1014;4034;1032;3944;2046;7978
510515;201307;5162;16391;4356;14772;1244;4715;1345;4309;2589;9024
510517;201307;1590;5071;1444;4854;439;1439;859;3018;1298;4457
510520;201307;2090;5612;1688;5041;145;514;1289;3811;1434;4325
510523;201307;991;3111;842;2861;266;980;363;1213;629;2193
510525;201307;7500;19267;4759;14884;1218;4163;1688;5179;2906;9342
510530;201307;544;1615;484;1526;91;334;284;896;375;1230
510550;201307;2466;8476;2236;8116;629;2316;1139;4322;1768;6638
510558;201307;1962;5864;1562;5268;516;1896;555;1844;1071;3740
510560;201307;1438;4958;1143;4425;437;1766;257;1050;694;2816
510562;201307;4825;15049;4357;14124;1572;5563;1464;4797;3036;10360
510590;201307;2635;7764;2119;7104;631;2345;918;3102;1549;5447
510600;201307;1360;3593;996;3053;182;621;553;1638;735;2259
510610;201307;2442;7763;2326;7632;295;1125;1893;6135;2188;7260
510615;201307;2045;6973;1848;6620;610;2369;804;2825;1414;5194
510617;201307;480;1600;448;1556;82;317;331;1138;413;1455
510618;201307;1237;3772;937;3179;249;932;405;1374;654;2306
510619;201307;761;2176;509;1708;109;405;165;555;274;960
510620;201307;1161;3223;816;2725;304;1131;171;534;475;1665
510621;201307;1079;3848;943;3528;297;1203;334;1214;631;2417
510622;201307;3253;10407;2314;8181;625;2470;426;1317;1051;3787
510623;201307;3305;9919;2947;9398;1152;3833;993;3198;2145;7031
510624;201307;992;3375;887;3158;215;862;402;1351;617;2213
510625;201307;1908;6069;1648;5543;542;1992;534;1679;1076;3671
510626;201307;1133;3786;973;3526;326;1272;456;1669;782;2941
510627;201307;623;2047;523;1847;200;758;179;628;379;1386
510628;201307;1399;3831;1175;3555;175;613;823;2452;998;3065
510629;201307;1698;5782;1499;5359;584;2250;337;1164;921;3414
510630;201307;2550;8695;2178;8065;759;3087;656;2496;1415;5583
510631;201307;397;1200;358;1138;79;252;229;733;308;985
510637;201307;2404;7618;2245;7315;710;2577;1065;3345;1775;5922
510642;201307;4367;14734;3787;13965;1340;5132;1753;6777;3093;11909
510645;201307;644;1669;526;1526;184;564;188;597;372;1161
510650;201307;5620;19789;5324;19406;1332;5169;3219;12098;4551;17267
510665;201307;1136;3072;854;2696;208;748;453;1432;661;2180
510670;201307;344;863;207;661;53;194;86;253;139;447
510675;201307;5880;19968;5159;18598;1870;7374;1526;5393;3396;12767
510677;201307;2408;6307;1828;5573;265;837;1324;4132;1589;4969
510680;201307;754;2425;657;2277;173;669;263;834;436;1503
510682;201307;2214;7328;1887;6720;517;1927;858;3222;1375;5149
510685;201307;729;2320;700;2279;147;516;451;1490;598;2006
510700;201307;2927;8958;2498;8347;574;2122;1514;4989;2088;7111
510704;201307;7392;21943;6348;20077;1825;6473;2990;9127;4815;15600
510706;201307;1367;4702;1268;4512;412;1541;614;2138;1026;3679
510710;201307;3429;10074;2858;8947;861;3084;1015;2870;1876;5954
510715;201307;675;1818;460;1458;125;433;160;464;285;897
510718;201307;1578;5039;1477;4876;347;1212;928;3094;1275;4306
510719;201307;433;1018;264;784;36;147;125;337;161;484
510720;201307;1223;2976;920;2618;95;306;699;2000;794;2306
510724;201307;804;2548;704;2361;149;537;432;1439;581;1976
510726;201307;641;1785;569;1667;166;510;248;707;414;1217
510729;201307;566;1702;499;1592;156;528;219;688;375;1216
510730;201307;2085;6773;1936;6508;472;1848;1131;3617;1603;5465
510735;201307;1060;3776;918;3541;350;1436;363;1395;713;2831
510740;201307;959;2540;802;2326;182;534;483;1440;665;1974
510757;201307;628;2284;593;2200;170;673;299;1086;469;1759
510760;201307;24201;73344;20702;67142;7865;27221;6922;22380;14787;49601
510770;201307;3467;10852;3329;10664;592;1912;2280;7652;2872;9564
510774;201307;365;1064;303;969;61;223;168;527;229;750
510775;201307;838;2407;690;2190;267;943;273;883;540;1826
510776;201307;354;1113;309;1033;81;302;147;460;228;762
510777;201307;1367;4407;1112;4088;242;1060;689;2466;931;3526
510779;201307;602;1826;470;1586;94;338;187;657;281;995
510780;201307;3519;10907;3194;10449;750;2616;1884;6267;2634;8883
510785;201307;1795;5466;1508;4989;506;1760;574;1951;1080;3711
510787;201307;1874;6098;1686;5753;523;1954;622;2060;1145;4014
510788;201307;338;1082;311;1045;133;422;105;383;238;805
510790;201307;13640;41747;9811;34321;3049;12193;1492;5042;4541;17235
510792;201307;5226;17843;4065;15292;1146;4935;762;2660;1908;7595
510794;201307;1319;4206;1054;3781;529;2001;204;677;733;2678
510795;201307;7348;25894;6465;23988;2384;9387;1801;6804;4185;16191
510800;201307;1666;4993;1461;4720;412;1491;721;2222;1133;3713
510805;201307;1627;4812;1347;4402;302;1134;841;2657;1143;3791
510810;201307;638;1619;517;1453;160;484;259;713;419;1197
510820;201307;820;2097;639;1823;164;555;256;663;420;1218
510830;201307;526;1892;480;1816;170;697;218;861;388;1558
510835;201307;658;2128;536;1900;205;800;209;681;414;1481
510840;201307;45175;119139;37622;109817;9986;30790;20017;60399;30003;91189
510850;201307;1622;4895;1333;4451;594;2216;207;552;801;2768
510860;201307;2317;8007;1989;7304;758;2964;400;1477;1158;4441
510880;201307;790;2737;706;2580;272;1043;250;908;522;1951
510885;201307;505;1504;388;1320;93;355;170;568;263;923
510890;201307;875;3027;758;2796;258;1059;193;657;451;1716
510895;201307;1004;3344;929;3221;296;1148;404;1326;700;2474
520005;201307;1112;3724;1043;3617;346;1261;442;1549;788;2810
520010;201307;1753;6274;1571;5867;712;2939;233;732;945;3671
520013;201307;3888;11066;3074;9657;782;2624;1468;4669;2250;7293
520015;201307;575;1605;464;1439;124;397;218;708;342;1105
520017;201307;1161;3793;1025;3562;298;1132;435;1484;733;2616
520020;201307;389;1067;303;925;88;280;154;486;242;766
520025;201307;19591;66663;19213;66176;3388;12339;14518;50039;17906;62378
520030;201307;4251;14335;3859;13666;1379;5228;1359;5003;2738;10231
520050;201307;325;998;307;960;65;230;201;607;266;837
520055;201307;656;1994;569;1854;153;502;283;961;436;1463
520060;201307;1582;5115;1407;4773;348;1324;564;1956;912;3280
520080;201307;1481;5090;1385;4881;353;1292;732;2626;1085;3918
520082;201307;597;2102;570;2043;163;583;332;1232;495;1815
520085;201307;980;3166;861;2880;218;796;358;1205;576;2001
520090;201307;764;2132;704;2030;121;331;462;1367;583;1698
520110;201307;35698;111893;28683;101258;11919;45832;7616;27186;19535;73018
520120;201307;257;675;150;485;37;138;36;126;73;264
520130;201307;3436;10575;3279;10327;808;2765;1887;5937;2695;8702
520140;201307;41270;142200;37842;135257;14240;54784;11924;42461;26164;97245
520145;201307;531;1395;394;1207;94;312;166;494;260;806
520150;201307;659;1761;548;1624;166;539;257;748;423;1287
520160;201307;781;2413;707;2307;254;880;292;969;546;1849
520170;201307;3584;9170;2923;8466;658;2004;1890;5630;2548;7634
520180;201307;1449;4816;1346;4631;432;1605;572;1937;1004;3542
520215;201307;1426;3992;1262;3746;264;880;763;2276;1027;3156
520235;201307;770;2178;628;1971;198;693;275;833;473;1526
520250;201307;1097;3749;1022;3617;359;1345;485;1753;844;3098
520260;201307;702;1909;556;1648;96;325;286;819;382;1144
520280;201307;544;1634;494;1554;235;773;138;472;373;1245
520310;201307;904;2427;746;2239;214;652;443;1395;657;2047
520320;201307;1345;4456;1170;4123;296;1096;567;2041;863;3137
520330;201307;2595;8411;2125;7623;715;2796;662;2343;1377;5139
520340;201307;1822;4773;1493;4386;233;669;1138;3433;1371;4102
520350;201307;2794;8840;2479;8202;948;3352;1020;3297;1968;6649
520355;201307;1078;3834;1055;3781;428;1613;441;1570;869;3183
520357;201307;882;2482;767;2319;78;272;537;1603;615;1875
520360;201307;561;1563;496;1456;134;396;233;685;367;1081
520380;201307;983;2740;779;2437;163;548;442;1410;605;1958
520390;201307;1159;3167;817;2699;282;1061;295;899;577;1960
520393;201307;554;1510;510;1443;99;295;346;986;445;1281
520396;201307;666;2207;643;2167;78;306;477;1620;555;1926
520400;201307;1718;5015;1471;4671;277;938;984;3155;1261;4093
520410;201307;1364;3933;1123;3574;360;1265;504;1550;864;2815
520420;201307;316;900;255;800;58;215;126;375;184;590
520425;201307;1394;3955;1322;3822;436;1362;641;1818;1077;3180
520430;201307;1800;4965;1401;4328;336;1204;640;1917;976;3121
520440;201307;2638;7674;2168;6937;832;2914;629;1971;1461;4885
520450;201307;8883;26587;7229;23545;2280;8275;1823;5547;4103;13822
520455;201307;656;2005;548;1829;228;818;146;488;374;1306
520460;201307;741;2264;634;2082;204;742;232;752;436;1494
520465;201307;796;2220;700;2091;182;656;316;868;498;1524
520470;201307;1617;5413;1490;5224;374;1336;910;3315;1284;4651
520480;201307;888;2719;810;2602;190;631;514;1675;704;2306
520485;201307;1099;3804;1031;3692;407;1549;442;1571;849;3120
520490;201307;4248;13437;3473;12223;1494;5673;1088;3822;2582;9495
520495;201307;1375;3777;1158;3516;55;129;1061;3309;1116;3438
520500;201307;1985;5375;1794;5113;622;1883;748;2322;1370;4205
520505;201307;869;2542;758;2372;127;375;535;1734;662;2109
520510;201307;10535;30439;7129;24515;2276;8592;1804;6163;4080;14755
520520;201307;976;2932;857;2765;342;1180;325;1063;667;2243
520530;201307;2335;7353;2045;6876;491;1686;998;3699;1489;5385
520540;201307;2792;8865;2509;8358;855;2998;1039;3429;1894;6427
520545;201307;1270;4034;1101;3679;352;1279;331;1042;683;2321
520547;201307;799;2558;638;2263;216;847;191;631;407;1478
520549;201307;7728;24513;6893;23514;1689;6252;4373;14786;6062;21038
520551;201307;3523;11024;3394;10856;1040;3461;1865;6227;2905;9688
520552;201307;678;2321;664;2301;139;535;435;1489;574;2024
520570;201307;561;1694;423;1462;183;667;80;285;263;952
520580;201307;1869;5631;1538;5115;470;1771;451;1414;921;3185
520590;201307;1429;4180;1264;3921;359;1194;560;1627;919;2821
520620;201307;6671;22293;6145;21472;1459;5500;3591;12703;5050;18203
520630;201307;599;1686;516;1586;152;452;307;982;459;1434
520640;201307;2272;7043;2123;6821;790;2610;923;3126;1713;5736
520650;201307;770;2310;684;2150;300;999;248;769;548;1768
520660;201307;351;1142;313;1063;111;412;95;317;206;729
520670;201307;713;2211;702;2195;76;191;599;1935;675;2126
520680;201307;488;1628;461;1589;178;666;169;568;347;1234
520690;201307;304;807;216;688;28;94;123;408;151;502
520710;201307;305;858;276;811;9;29;204;579;213;608
520725;201307;1673;4561;1341;4089;337;1139;702;2119;1039;3258
520735;201307;577;1826;501;1692;188;667;153;499;341;1166
520740;201307;1617;4886;1388;4553;393;1365;668;2204;1061;3569
520750;201307;662;1819;509;1621;146;524;298;937;444;1461
520753;201307;1079;3254;1060;3225;170;475;817;2575;987;3050
520760;201307;1118;3200;996;3046;332;1091;533;1603;865;2694
520780;201307;1819;4814;1617;4551;189;534;1282;3669;1471;4203
520790;201307;2375;7164;2157;6848;345;1205;1513;4855;1858;6060
520800;201307;16400;50276;14732;48269;3480;11433;8839;30952;12319;42385
520810;201307;798;2446;783;2417;111;366;611;1911;722;2277
520815;201307;357;1284;297;1158;165;696;43;171;208;867
520830;201307;1650;4360;1297;3991;67;182;1168;3682;1235;3864
520840;201307;1599;5505;1451;5209;486;1853;552;2030;1038;3883
520850;201307;778;2305;620;2085;193;693;283;934;476;1627
520860;201307;6777;20171;5283;18199;1588;5936;2547;8888;4135;14824
520870;201307;116623;336054;84243;276385;28019;99719;25212;82283;53231;182002
520880;201307;5852;17696;4458;15385;1413;5434;623;1904;2036;7338
520890;201307;3328;10391;3082;10002;771;2662;1658;5354;2429;8016
520910;201307;3658;12064;3248;11205;1164;4348;962;3170;2126;7518
520915;201307;875;2513;647;2061;160;534;237;729;397;1263
520920;201307;2755;7906;2140;6924;576;2009;761;2506;1337;4515
520929;201307;422;1290;393;1254;116;390;200;632;316;1022
520940;201307;896;2838;846;2764;113;416;637;2051;750;2467
520945;201307;631;1611;566;1507;211;583;203;496;414;1079
520960;201307;859;2574;724;2374;121;421;460;1515;581;1936
520970;201307;3259;9642;2657;8551;589;2149;1142;3598;1731;5747
520980;201307;1002;2773;941;2689;153;465;737;2103;890;2568
520990;201307;3618;11500;3218;10801;729;2640;1702;6185;2431;8825
520993;201307;993;2920;815;2562;160;555;442;1346;602;1901
520995;201307;2464;6898;2233;6587;365;1119;1628;4830;1993;5949
521000;201307;7329;22620;6387;21109;1563;5621;3495;11646;5058;17267
521010;201307;3355;10989;3012;10305;843;3115;1339;4584;2182;7699
521015;201307;684;2001;590;1857;164;539;293;927;457;1466
521020;201307;4146;12639;3440;11190;1342;4731;761;2216;2103;6947
521030;201307;785;2154;702;2039;143;433;478;1412;621;1845
521040;201307;5034;15214;4606;14526;1680;5355;2238;7332;3918;12687
521056;201307;962;3015;827;2792;283;1003;351;1210;634;2213
521060;201307;1106;3189;957;2931;232;767;392;1162;624;1929
521080;201307;1101;2872;753;2278;176;635;272;709;448;1344
521090;201307;2998;9200;2627;8674;915;3241;1082;3580;1997;6821
521100;201307;1364;3634;1270;3530;226;626;918;2612;1144;3238
521120;201307;4586;13634;4215;12995;1002;3019;2422;7791;3424;10810
521130;201307;1023;3016;887;2795;192;672;469;1511;661;2183
521140;201307;860;2976;782;2791;325;1225;163;556;488;1781
521150;201307;10666;29656;8555;26009;2697;8959;4086;12356;6783;21315
521160;201307;685;1798;500;1425;96;298;303;833;399;1131
521170;201307;1293;3199;1128;2998;318;826;660;1765;978;2591
521180;201307;5984;21092;5545;20150;2138;8244;1596;5812;3734;14056
521190;201307;8033;24825;6257;21724;2322;8471;1998;7006;4320;15477
521200;201307;773;2134;733;2084;113;328;534;1539;647;1867
521205;201307;457;1522;427;1459;68;254;270;935;338;1189
521210;201307;777;2384;587;2006;225;866;215;648;440;1514
521220;201307;3512;10412;3088;9810;1135;3880;1145;3585;2280;7465
521225;201307;369;988;300;896;49;170;195;587;244;757
521230;201307;1251;4057;1194;3927;444;1547;535;1710;979;3257
521250;201307;24486;84386;23554;82821;9783;36454;9124;32627;18907;69081
521260;201307;613;1598;498;1362;100;347;257;656;357;1003
521270;201307;1656;5526;1565;5369;143;429;1263;4510;1406;4939
521280;201307;1630;5255;1435;4930;480;1750;606;2078;1086;3828
521290;201307;495;1480;376;1278;104;422;157;512;261;934
521295;201307;1058;3062;990;2965;204;676;666;1967;870;2643
521300;201307;1690;5095;1550;4857;522;1703;630;2063;1152;3766
521305;201307;810;2176;689;2011;167;489;413;1250;580;1739
521308;201307;4646;14347;3860;13077;761;2858;2340;7819;3101;10677
521310;201307;6505;20698;5649;19262;2314;8375;1591;5372;3905;13747
521340;201307;236;775;216;739;73;275;86;277;159;552
521350;201307;2048;5521;1701;5068;237;799;1114;3479;1351;4278
521370;201307;980;3220;913;3088;341;1234;335;1098;676;2332
521375;201307;1273;3711;1114;3452;284;940;594;1827;878;2767
521377;201307;935;2919;911;2885;92;281;771;2485;863;2766
521380;201307;3451;10447;2888;9579;710;2603;1281;4154;1991;6757
521385;201307;574;1673;519;1596;159;516;263;814;422;1330
521390;201307;1089;2939;835;2580;320;1116;256;784;576;1900
521400;201307;2321;6365;2016;6024;279;885;1590;4741;1869;5626
521405;201307;1019;3212;993;3174;178;570;675;2212;853;2782
521410;201307;726;2386;672;2294;331;1108;216;789;547;1897
521440;201307;1407;3979;1382;3952;142;366;1192;3483;1334;3849
521450;201307;4787;14733;4031;13314;1342;4763;991;3088;2333;7851
521460;201307;6581;21394;6091;20615;1956;7075;2929;9999;4885;17074
521470;201307;715;2081;549;1768;129;465;132;448;261;913
521480;201307;509;1503;382;1283;131;458;98;331;229;789
521483;201307;2915;7969;2512;7295;618;1903;1248;3595;1866;5498
521486;201307;1514;4405;1380;4141;389;1318;798;2255;1187;3573
521487;201307;535;1487;411;1304;97;315;215;688;312;1003
521490;201307;785;2343;656;2172;133;480;398;1340;531;1820
521500;201307;1104;3752;1041;3645;125;459;801;2774;926;3233
521520;201307;866;2091;776;1990;187;390;445;1294;632;1684
521523;201307;10781;40785;10117;39617;3122;13301;4554;17797;7676;31098
521525;201307;1017;2686;916;2551;130;417;613;1650;743;2067
521530;201307;1879;5734;1349;4674;554;2032;231;761;785;2793
521540;201307;861;2568;656;2147;214;807;164;460;378;1267
521550;201307;810;2155;749;2068;219;681;412;1070;631;1751
521560;201307;4991;15475;3992;14134;1714;6621;1008;3394;2722;10015
521565;201307;597;1737;548;1675;95;314;390;1200;485;1514
521570;201307;4032;11645;3218;10170;1174;3978;1074;3420;2248;7398
521580;201307;565;1511;453;1355;175;558;158;480;333;1038
521590;201307;708;2061;618;1911;244;816;126;414;370;1230
521600;201307;612;1649;445;1352;119;398;155;421;274;819
521630;201307;1725;4816;1469;4403;603;2090;270;656;873;2746
521640;201307;1673;4991;1489;4707;534;1945;396;1283;930;3228
521645;201307;603;1952;540;1809;160;596;218;668;378;1264
521680;201307;1318;4429;1239;4246;751;2695;231;754;982;3449
521690;201307;555;1682;501;1576;112;409;261;773;373;1182
521710;201307;2057;6600;1850;6202;397;1416;1121;3735;1518;5151
521720;201307;1973;6025;1817;5810;449;1472;1098;3600;1547;5072
521730;201307;3585;12383;3423;12063;1536;5894;1040;3430;2576;9324
521740;201307;3221;9154;2631;8389;1274;4179;880;2908;2154;7087
521760;201307;11706;41127;11160;40301;1994;8016;7721;27987;9715;36003
521770;201307;2694;8311;2327;7593;1030;3584;523;1608;1553;5192
521800;201307;8273;25347;7273;23894;2767;9525;3312;11231;6079;20756
521805;201307;758;1889;701;1795;245;557;365;1092;610;1649
521810;201307;802;2433;705;2260;179;628;361;1143;540;1771
521830;201307;5353;18436;5094;18024;1058;4068;3457;12190;4515;16258
521839;201307;634;2000;544;1802;148;530;231;727;379;1257
521850;201307;6181;18086;5699;17409;1318;3969;3549;11166;4867;15135
521860;201307;1646;5159;1451;4746;427;1537;534;1650;961;3187
521870;201307;541;1914;506;1821;163;637;140;463;303;1100
521878;201307;412;1417;385;1369;151;603;115;377;266;980
521880;201307;22654;62177;15998;51136;6005;20570;4646;15001;10651;35571
521890;201307;3483;11118;3000;10143;1197;4323;702;2357;1899;6680
521900;201307;1630;4366;1348;3964;362;1189;534;1449;896;2638
521910;201307;1153;3357;1012;3191;265;915;578;1855;843;2770
521920;201307;402;1310;394;1293;161;561;186;604;347;1165
521925;201307;583;1845;536;1731;119;421;291;901;410;1322
521930;201307;4096;13528;3763;12862;1504;5461;1168;3944;2672;9405
521935;201307;667;2029;634;1963;181;602;359;1074;540;1676
521940;201307;1150;3136;960;2837;362;1132;333;998;695;2130
521945;201307;646;2284;603;2232;128;425;437;1710;565;2135
521950;201307;470;1575;420;1477;159;602;153;529;312;1131
521960;201307;911;2708;786;2478;206;696;377;1166;583;1862
521970;201307;2349;6885;2197;6677;382;1200;1550;4834;1932;6034
521971;201307;885;2535;737;2286;201;686;318;935;519;1621
521973;201307;801;2764;738;2639;222;830;237;846;459;1676
521975;201307;12421;37292;11747;36412;2369;8067;7657;23752;10026;31819
521980;201307;1677;5528;1642;5485;287;924;1276;4393;1563;5317
521990;201307;992;3219;942;3121;195;706;571;1850;766;2556
522000;201307;2041;6191;1830;5918;396;1347;1113;3760;1509;5107
522005;201307;305;888;246;791;66;232;127;392;193;624
522010;201307;2780;8596;2470;8092;922;3305;766;2424;1688;5729
522015;201307;963;2929;818;2710;237;873;432;1419;669;2292
522020;201307;3968;11703;3559;11180;1015;3362;1935;6064;2950;9426
522026;201307;524;1660;427;1558;209;802;137;503;346;1305
522028;201307;513;1567;467;1489;122;426;268;831;390;1257
522040;201307;2877;7480;2086;6448;773;2578;794;2442;1567;5020
522045;201307;12012;40866;10589;37754;3655;14200;2302;7996;5957;22196
522050;201307;1010;3032;852;2764;292;1049;340;1053;632;2102
522060;201307;2653;8859;2467;8610;802;2973;1384;4832;2186;7805
522068;201307;1372;4672;1293;4581;119;375;1101;4029;1220;4404
522070;201307;809;2504;743;2395;132;511;468;1477;600;1988
522100;201307;796;2218;706;2078;266;896;324;877;590;1773
522108;201307;900;2661;802;2518;92;307;595;1906;687;2213
522119;201307;1429;4420;1252;4196;140;468;1012;3465;1152;3933
522130;201307;500;1456;432;1380;130;464;221;704;351;1168
522140;201307;15877;46498;14217;44334;4247;14206;7544;23507;11791;37713
522145;201307;899;2626;850;2541;456;1446;208;605;664;2051
522150;201307;1230;3252;1008;2962;344;1076;404;1228;748;2304
522155;201307;699;2128;642;2047;156;527;377;1229;533;1756
522157;201307;659;1994;606;1908;76;265;460;1454;536;1719
522160;201307;5516;16382;4316;14472;1977;7285;849;2679;2826;9964
522170;201307;3155;8837;2713;8237;736;2278;1310;4193;2046;6471
522180;201307;429;1291;341;1177;169;639;115;383;284;1022
522185;201307;13617;44708;12928;43744;2812;10322;8114;27673;10926;37995
522190;201307;677;2007;611;1860;120;381;368;1131;488;1512
522200;201307;1507;5146;1406;4929;536;2012;442;1509;978;3521
522205;201307;1289;3778;1086;3436;325;1062;493;1582;818;2644
522220;201307;973;3138;897;3032;226;811;496;1762;722;2573
522230;201307;885;2935;839;2852;208;763;484;1688;692;2451
530010;201307;243623;809516;220191;760998;69631;264848;71553;246902;141184;511750
110001;201306;4124;13917;3594;13078;1091;4157;1953;7190;3044;11347
110002;201306;11783;39521;10713;37583;3740;13966;4628;16387;8368;30353
110003;201306;981;3221;917;3118;273;978;388;1291;661;2269
110004;201306;8982;30403;8021;28393;2650;10242;3018;10656;5668;20898
110005;201306;2259;7855;2172;7686;817;2956;969;3474;1786;6430
110006;201306;3403;9199;2151;7455;722;2642;648;2138;1370;4780
110007;201306;1405;4681;1301;4531;357;1260;769;2748;1126;4008
110008;201306;2388;8532;2248;8328;555;1970;1488;5780;2043;7750
110009;201306;4841;14525;3985;13335;894;3086;2544;8613;3438;11699
110010;201306;8207;23908;7326;22838;1321;3608;5156;17421;6477;21029
110011;201306;10451;33143;8809;30360;3515;12802;3039;10531;6554;23333
110012;201306;15258;49184;13795;46425;5149;18312;5564;18738;10713;37050
110013;201306;5044;16452;4256;15341;1286;4841;2153;7903;3439;12744
110014;201306;4088;12554;3496;11726;799;2786;2210;7490;3009;10276
110015;201306;4817;16046;4087;14786;1621;6217;1465;5300;3086;11517
110018;201306;4893;14829;4054;13763;1327;4982;1811;5909;3138;10891
110020;201306;49693;154149;43976;146954;10304;35448;26741;91923;37045;127371
110025;201306;4144;12672;3558;11579;608;2172;2544;8220;3152;10392
110026;201306;780;2374;668;2247;162;543;438;1518;600;2061
110028;201306;7212;21805;5565;19195;1732;6482;1933;6657;3665;13139
110029;201306;1627;4935;1309;4388;436;1526;579;1968;1015;3494
110030;201306;10915;32114;9019;29694;2693;9467;4565;15590;7258;25057
110032;201306;3952;13260;3617;12531;1014;3700;1774;6155;2788;9855
110033;201306;5054;16436;4777;16030;1443;4821;2681;9525;4124;14346
110034;201306;3682;9756;3154;9154;463;1283;2493;7368;2956;8651
110037;201306;2003;6975;1795;6589;487;1766;1036;3915;1523;5681
110040;201306;3408;11558;3259;11276;1103;4058;1545;5356;2648;9414
110045;201306;4949;17935;4719;17638;1299;5084;2921;11002;4220;16086
110050;201306;1751;5809;1487;5477;561;2076;753;2861;1314;4937
110060;201306;974;3467;872;3273;221;846;514;1960;735;2806
110070;201306;1849;6517;1817;6434;313;1148;1346;4773;1659;5921
110080;201306;3090;10343;3018;10247;511;1628;2363;8250;2874;9878
110090;201306;923;2826;752;2553;233;881;312;992;545;1873
110092;201306;1636;5436;1495;5243;377;1328;860;3173;1237;4501
110094;201306;2665;9218;2508;9004;692;2596;1495;5422;2187;8018
110100;201306;2609;8593;2295;8094;610;2206;1376;4956;1986;7162
110110;201306;1691;5761;1595;5649;674;2442;735;2686;1409;5128
110120;201306;1590;5486;1418;5074;400;1507;554;1967;954;3474
110130;201306;2711;7985;2139;7181;580;2091;1084;3649;1664;5740
110140;201306;2313;8239;2237;8128;545;2010;1417;5228;1962;7238
110143;201306;1472;5057;1228;4642;304;1212;724;2730;1028;3942
110145;201306;926;2952;845;2816;177;615;528;1774;705;2389
110146;201306;444;1462;401;1393;112;403;216;757;328;1160
110147;201306;860;2659;719;2458;211;780;320;1051;531;1831
110148;201306;1331;4043;1147;3707;370;1318;415;1272;785;2590
110149;201306;3350;10353;2822;9628;632;2242;1895;6585;2527;8827
110150;201306;2617;8140;2214;7554;424;1522;1483;5072;1907;6594
110155;201306;858;2959;833;2902;303;1111;379;1292;682;2403
110160;201306;2066;6832;1790;6427;462;1697;1077;3942;1539;5639
110170;201306;3019;9066;2456;8146;553;1936;1549;5185;2102;7121
110175;201306;1551;5198;1241;4813;114;478;952;3703;1066;4181
110180;201306;1646;5349;1449;5005;345;1230;882;3062;1227;4292
120001;201306;2704;10078;2635;9937;713;2824;1504;5797;2217;8621
120005;201306;1478;6277;1437;6199;186;740;1096;4955;1282;5695
120010;201306;4007;14774;3849;14484;806;2930;2487;9788;3293;12718
120013;201306;1687;6695;1661;6649;307;1195;1182;4924;1489;6119
120017;201306;1987;7266;1904;7119;523;2031;959;3869;1482;5900
120020;201306;13592;60270;13419;59869;2586;10857;9655;45125;12241;55982
120025;201306;2495;8963;2433;8865;650;2452;1441;5388;2091;7840
120030;201306;5123;22106;5096;22041;663;2628;4094;18294;4757;20922
120032;201306;1308;6314;1268;6211;176;977;944;4686;1120;5663
120033;201306;3457;13409;3431;13361;172;690;3103;12226;3275;12916
120034;201306;1830;7304;1827;7301;73;286;1706;6867;1779;7153
120035;201306;2379;11845;2362;11798;282;1305;1878;9817;2160;11122
120038;201306;3121;11564;3021;11355;838;3215;1671;6479;2509;9694
120039;201306;1331;7602;1309;7547;181;1076;1023;6016;1204;7092
120040;201306;41911;156087;39406;150541;12353;49067;19272;75817;31625;124884
120042;201306;2538;11453;2474;11296;284;1349;1965;9140;2249;10489
120043;201306;764;3730;756;3708;74;364;633;3163;707;3527
120045;201306;4145;15025;4120;14978;938;3361;2940;10964;3878;14325
120050;201306;7893;33224;7698;32793;1792;7340;4796;21864;6588;29204
120060;201306;5128;25799;5082;25708;796;3890;3859;20338;4655;24228
120070;201306;2597;10100;2560;10012;601;2214;1605;6669;2206;8883
120080;201306;3451;13294;3330;13105;595;2389;2377;9617;2972;12006
130002;201306;2623;11454;2480;11206;331;1556;1864;8551;2195;10107
130006;201306;1675;7321;1524;7016;193;980;1115;5171;1308;6151
130008;201306;1842;7773;1782;7655;199;910;1373;6049;1572;6959
130010;201306;2722;9283;2369;8866;255;876;1948;7509;2203;8385
130014;201306;3149;10567;2747;9986;425;1697;1873;6851;2298;8548
130020;201306;2303;8323;2287;8305;65;247;2197;7983;2262;8230
130030;201306;6182;25356;6006;25119;559;1946;5116;22151;5675;24097
130040;201306;3434;11028;3282;10796;181;633;2909;9617;3090;10250
130050;201306;5548;23188;4960;22200;791;3463;3450;16366;4241;19829
130060;201306;5523;23820;5221;23411;565;2431;4295;19763;4860;22194
130063;201306;2815;12856;2794;12812;401;1750;2253;10611;2654;12361
130068;201306;2813;12211;2667;11909;370;1784;1942;8762;2312;10546
130070;201306;6101;21345;5781;20913;545;1925;4778;17692;5323;19617
130080;201306;4760;21439;4642;21255;805;3802;3355;15766;4160;19568
130083;201306;1639;6997;1581;6902;290;1285;1138;5038;1428;6323
130090;201306;2249;8438;2151;8299;187;829;1831;7052;2018;7881
130100;201306;5050;20132;4865;19871;498;2168;3980;16477;4478;18645
130110;201306;6189;20330;5822;19875;1005;3290;4300;15301;5305;18591
130115;201306;3459;13309;3300;13090;203;651;2995;12095;3198;12746
130120;201306;12232;48273;11998;47943;1158;4238;10201;42010;11359;46248
130130;201306;3311;14589;3191;14316;485;2142;2439;11225;2924;13367
130140;201306;5692;23123;5649;23067;146;444;5453;22518;5599;22962
130150;201306;3200;12380;3138;12297;303;1460;2597;10097;2900;11557
130160;201306;3799;15767;3743;15678;207;741;3444;14628;3651;15369
130165;201306;2710;11188;2672;11124;526;2206;2018;8514;2544;10720
130170;201306;7554;29782;6786;28823;1318;5504;4727;21067;6045;26571
130180;201306;3228;10341;3167;10253;144;428;2910;9497;3054;9925
130185;201306;7741;29476;7534;29174;1683;6258;5128;20798;6811;27056
130190;201306;16098;57805;14435;55653;3142;11693;9269;37999;12411;49692
130195;201306;1729;7108;1672;7021;100;438;1485;6290;1585;6728
130200;201306;1881;6947;1768;6755;312;1237;1216;4705;1528;5942
130210;201306;1086;4282;1031;4181;176;695;760;3204;936;3899
130220;201306;1960;8140;1834;7936;287;1369;1278;5617;1565;6986
130230;201306;3264;14957;3120;14688;238;1094;2652;12810;2890;13904
130240;201306;7866;31245;7320;30429;563;2601;6142;25953;6705;28554
130250;201306;16572;62915;16351;62576;2350;8316;12940;51393;15290;59709
130255;201306;3709;13948;3524;13626;238;891;3061;12097;3299;12988
130260;201306;224852;742044;206907;715168;57884;201681;114983;414273;172867;615954
130270;201306;7236;30523;6564;29458;1109;4852;4652;21921;5761;26773
130280;201306;2862;11381;2801;11290;177;624;2489;10294;2666;10918
130290;201306;10183;37758;10118;37672;228;691;9610;36366;9838;37057
130300;201306;4158;16562;3958;16276;362;1543;3248;13593;3610;15136
130310;201306;4300;17507;3998;17121;625;2575;2964;13213;3589;15788
130320;201306;2546;9006;2336;8713;326;1268;1693;6474;2019;7742
130330;201306;3275;12350;2943;11887;282;1216;2426;9953;2708;11169
130340;201306;16619;65778;16235;65166;2695;10202;11731;49687;14426;59889
130350;201306;3159;12783;3031;12640;143;343;2833;12184;2976;12527
130353;201306;4639;15989;4240;15436;1206;4331;2363;9143;3569;13474
130356;201306;3569;13438;3436;13213;550;2101;2572;10245;3122;12346
130360;201306;2631;8196;2365;7880;71;225;2180;7416;2251;7641
130370;201306;4505;18012;3853;17140;317;1733;3119;13900;3436;15633
130380;201306;6265;27031;6080;26700;496;2382;5072;22481;5568;24863
130390;201306;4372;19427;4127;19015;481;2117;3337;15861;3818;17978
130395;201306;1914;7422;1777;7148;308;1378;1133;4541;1441;5919
130400;201306;2091;7619;2025;7518;101;393;1810;6805;1911;7198
130406;201306;8221;32975;7436;31645;1913;7887;4219;19274;6132;27161
130410;201306;3982;15340;3691;14794;901;3759;2064;8579;2965;12338
130420;201306;9133;40025;8857;39387;2093;9270;5523;25560;7616;34830
130423;201306;2766;11384;2643;11197;268;1299;2163;9212;2431;10511
130426;201306;1861;8241;1792;8113;307;1351;1269;6045;1576;7396
130430;201306;3232;12051;3068;11815;371;1496;2284;9053;2655;10549
130440;201306;3511;13144;3237;12842;234;776;2824;11633;3058;12409
140002;201306;1261;4635;1223;4567;277;938;802;3229;1079;4167
140005;201306;2278;7464;2148;7320;134;438;1910;6610;2044;7048
140010;201306;41389;138197;38035;132503;8560;31732;22961;81604;31521;113336
140015;201306;2491;8812;2413;8710;181;538;2110;7841;2291;8379
140017;201306;2745;9203;2669;9105;188;637;2342;8102;2530;8739
140020;201306;3957;13791;3718;13461;505;1824;2796;10422;3301;12246
140023;201306;1817;6784;1752;6686;192;731;1434;5594;1626;6325
140028;201306;2021;5842;1957;5767;111;278;1761;5311;1872;5589
140030;201306;3314;11122;3210;10985;322;739;2767;9977;3089;10716
140040;201306;1452;7117;1397;6945;132;735;1030;5230;1162;5965
140045;201306;2141;8255;2088;8179;207;653;1763;7236;1970;7889
140047;201306;4804;14932;4707;14807;771;1983;3630;12161;4401;14144
140050;201306;1424;4547;1357;4450;144;445;1115;3739;1259;4184
140060;201306;1228;4067;1151;3965;218;731;829;2946;1047;3677
140070;201306;1430;7061;1427;7055;58;235;1355;6776;1413;7011
150010;201306;30072;103795;28971;102301;2186;7972;24833;89024;27019;96996
150013;201306;1453;4731;1411;4682;131;448;1178;3944;1309;4392
150020;201306;9946;36322;9767;36036;1214;4489;7840;29454;9054;33943
150030;201306;5785;25934;5643;25684;625;2445;4645;22088;5270;24533
150034;201306;4364;12036;4151;11783;148;343;3945;11336;4093;11679
150040;201306;11513;41727;10216;40065;2057;7377;6969;29262;9026;36639
150050;201306;5808;22550;5684;22319;701;2959;4494;17798;5195;20757
150060;201306;13309;45457;12738;44608;3493;11954;7473;27543;10966;39497
150070;201306;4913;21463;4538;21003;588;2582;3618;17269;4206;19851
150080;201306;56133;156904;50146;149359;6147;16655;38512;118325;44659;134980
150085;201306;4546;16802;4396;16585;777;2498;3284;13175;4061;15673
150090;201306;9315;37269;8862;36640;1135;4511;7032;29826;8167;34337
150095;201306;4881;17344;4578;16880;534;1960;3656;13814;4190;15774
150100;201306;3291;12665;3117;12416;310;1438;2541;10043;2851;11481
150110;201306;3124;15160;3114;15134;152;638;2903;14287;3055;14925
150120;201306;5621;22772;5523;22570;728;2929;4405;18251;5133;21180
150125;201306;764;2436;703;2334;156;547;422;1403;578;1950
150130;201306;17051;58367;16585;57635;1879;6558;13400;47226;15279;53784
150140;201306;132245;409813;128136;404619;19450;61884;99383;317878;118833;379762
150145;201306;4575;15014;4261;14601;620;2180;3163;11072;3783;13252
150150;201306;8368;28883;7957;28205;1787;6621;5120;18393;6907;25014
150157;201306;2423;8394;2276;8184;342;1327;1768;6369;2110;7696
150160;201306;2482;8882;2404;8769;631;2223;1503;5707;2134;7930
150170;201306;21295;79945;20337;78798;3050;11561;15950;62796;19000;74357
150172;201306;2806;9999;2554;9634;295;1134;2108;8072;2403;9206
150175;201306;1914;6237;1852;6161;156;481;1611;5484;1767;5965
150178;201306;10279;33015;9030;31551;557;1689;8137;29093;8694;30782
150180;201306;15801;66724;15403;66181;1493;6852;12979;56308;14472;63160
150190;201306;6836;22400;6478;21888;428;1089;5663;19892;6091;20981
150195;201306;4032;15263;3794;14820;452;1758;2968;11794;3420;13552
150200;201306;4255;14979;4216;14927;104;342;4018;14326;4122;14668
150210;201306;21453;82758;21207;82404;1856;6880;18524;73029;20380;79909
150215;201306;5075;17079;4712;16532;1239;4417;2765;9948;4004;14365
150220;201306;11534;39302;11034;38457;2581;9188;6709;23834;9290;33022
150230;201306;10283;37120;9600;36140;794;3645;8122;30253;8916;33898
150240;201306;30377;97122;28433;93755;8029;27718;14953;50086;22982;77804
150250;201306;3349;13536;3263;13392;598;2210;2363;10286;2961;12496
150260;201306;1780;7737;1755;7687;275;1313;1245;5471;1520;6784
150270;201306;9012;28348;7176;26052;1632;6301;4513;16631;6145;22932
150275;201306;5330;20479;5123;20129;855;3388;3735;14995;4590;18383
150276;201306;1985;6098;1899;5990;273;909;1511;4779;1784;5688
150277;201306;4850;15393;4298;14747;512;1822;3464;12090;3976;13912
150280;201306;5592;24651;5496;24434;593;2571;4478;20314;5071;22885
150285;201306;2535;10329;2513;10284;183;763;2257;9290;2440;10053
150290;201306;7439;25314;7310;25128;862;2874;5924;20852;6786;23726
150293;201306;8315;27463;7507;26224;2541;9039;3613;13248;6154;22287
150295;201306;5735;20348;5217;19646;1299;4951;3211;12470;4510;17421
150300;201306;1685;6055;1652;6007;114;393;1434;5269;1548;5662
150304;201306;3819;12441;3374;11845;521;1851;2522;9015;3043;10866
150307;201306;6362;22463;5973;21889;489;1749;4962;18707;5451;20456
150309;201306;6077;22799;5761;22328;1592;6131;3586;14471;5178;20602
150310;201306;4808;22738;4738;22614;539;2404;3908;19217;4447;21621
150320;201306;7475;22573;7342;22412;481;1520;6564;20111;7045;21631
150330;201306;12130;46524;11692;45780;1406;5499;9328;37300;10734;42799
150340;201306;1971;7192;1887;7071;503;1949;1108;4248;1611;6197
150345;201306;6171;22455;5821;21973;685;2630;4726;18183;5411;20813
150350;201306;6828;23596;6553;23173;894;3220;4932;17704;5826;20924
150360;201306;19465;63810;17273;61127;2503;8982;13100;47727;15603;56709
150370;201306;9308;36498;9039;36112;1146;4267;7341;30328;8487;34595
150375;201306;2621;11188;2570;11122;235;794;2207;10016;2442;10810
150380;201306;9138;29194;8333;28090;930;3390;6941;23374;7871;26764
150390;201306;7578;33464;7290;32857;1720;7393;4517;21477;6237;28870
150400;201306;5077;21831;4934;21489;639;2672;3683;16553;4322;19225
150405;201306;7872;25253;7194;24389;1556;4777;4819;17418;6375;22195
150410;201306;1587;6302;1563;6262;247;1020;1096;4507;1343;5527
150420;201306;29449;109990;27107;106188;7270;29675;15211;61862;22481;91537
150430;201306;6018;23363;5914;23168;830;3627;4527;17690;5357;21317
150440;201306;5061;18196;4980;18061;723;2612;3793;14001;4516;16613
150442;201306;20646;60136;19043;58140;3064;9544;13679;42888;16743;52432
150445;201306;4772;17441;4436;16965;645;2351;3432;13511;4077;15862
150450;201306;4034;19712;3912;19540;368;1831;3321;16897;3689;18728
150460;201306;6250;24234;5389;23329;358;1656;4857;21164;5215;22820
150470;201306;14534;49088;14225;48662;1585;4623;11991;42364;13576;46987
150480;201306;13381;46979;13028;46481;852;2749;11532;42002;12384;44751
150490;201306;5967;23384;5871;23259;360;1407;5301;21196;5661;22603
150495;201306;4176;16120;4094;15954;459;1881;3367;13185;3826;15066
150497;201306;3211;11388;2967;10992;794;2925;1771;6869;2565;9794
150500;201306;2787;8733;2688;8563;392;1322;2035;6466;2427;7788
150503;201306;3633;11731;3128;11075;1208;4440;1351;5007;2559;9447
150506;201306;11288;41864;10825;41237;2553;8506;7507;30557;10060;39063
150510;201306;9017;36849;8545;36032;1428;6095;6074;26581;7502;32676
150520;201306;5538;23871;5462;23751;426;1524;4852;21658;5278;23182
150530;201306;10515;39403;9693;38200;1344;4867;7319;29969;8663;34836
150540;201306;4312;14210;4030;13782;350;1260;3379;11551;3729;12811
150543;201306;4535;14992;4230;14555;1307;4512;2430;8637;3737;13149
150548;201306;7412;24675;7013;24155;752;2400;5829;20627;6581;23027
150549;201306;2132;6992;2042;6882;105;282;1859;6409;1964;6691
150550;201306;19970;65616;18337;62976;5262;18729;9740;34197;15002;52926
150553;201306;20136;76362;18483;71986;7608;31397;3745;14562;11353;45959
150555;201306;1584;5199;1407;4936;253;978;957;3376;1210;4354
150560;201306;1926;6366;1876;6249;220;813;1452;4787;1672;5600
150563;201306;2755;9500;2618;9249;634;2404;1606;5659;2240;8063
150565;201306;3196;11890;3043;11660;254;1102;2504;9632;2758;10734
150570;201306;4812;19235;4757;19141;423;1682;4011;16526;4434;18208
150580;201306;8848;36593;8722;36415;816;2963;7496;32402;8312;35365
150590;201306;4922;20527;4819;20401;182;849;4474;19036;4656;19885
150600;201306;6992;28455;6886;28267;680;2511;5834;24689;6514;27200
150610;201306;2407;8435;2255;8122;290;1183;1583;5637;1873;6820
150611;201306;2466;9579;2386;9381;312;1304;1780;7075;2092;8379
150613;201306;10531;34238;9459;32671;3237;11377;4727;17084;7964;28461
150616;201306;2923;8531;2387;7957;580;1874;1583;5492;2163;7366
150618;201306;7191;25781;6940;25331;2270;8614;3452;12891;5722;21505
150619;201306;4852;17404;4595;17018;757;2905;3268;12311;4025;15216
150620;201306;5855;21837;5403;21244;780;3097;4119;16775;4899;19872
150630;201306;4985;16452;4779;16173;446;1525;3999;13711;4445;15236
150635;201306;4118;14194;3935;13829;821;2957;2526;9141;3347;12098
150640;201306;1354;4537;1341;4516;33;94;1276;4338;1309;4432
150650;201306;11342;36510;10502;34982;2878;10024;5648;19064;8526;29088
150655;201306;4969;17480;4628;16999;842;3101;3320;12483;4162;15584
150658;201306;3829;13161;3702;12960;343;1440;2976;10313;3319;11753
150660;201306;5417;17753;4987;17198;1393;4729;2903;10429;4296;15158
150670;201306;5700;17648;5019;16817;1713;5787;2649;9439;4362;15226
150680;201306;46245;189513;44371;185945;15741;65285;20897;93790;36638;159075
150690;201306;1786;6020;1674;5813;280;995;1090;3894;1370;4889
150700;201306;5335;17489;5158;17228;1062;3528;3510;12015;4572;15543
150710;201306;3508;11801;3417;11673;357;958;2931;10361;3288;11319
150715;201306;4603;15977;4319;15616;545;1921;3490;12935;4035;14856
150720;201306;5875;25235;5654;24845;854;3536;4238;19393;5092;22929
150730;201306;8494;30428;8043;29810;1194;4280;6382;24244;7576;28524
150740;201306;3355;11354;3199;11051;495;1816;2244;7859;2739;9675
150745;201306;5846;18769;5466;18259;855;2967;4097;13854;4952;16821
150746;201306;1296;4587;1243;4484;186;773;890;3212;1076;3985
150747;201306;4827;16332;4528;15937;437;1492;3689;13397;4126;14889
150750;201306;2454;8974;2409;8922;123;289;2254;8566;2377;8855
150760;201306;10664;35646;10329;35174;2417;8088;6744;23710;9161;31798
150770;201306;5071;20360;4935;20148;856;3160;3727;15899;4583;19059
150775;201306;1021;3409;944;3265;197;820;568;1889;765;2709
150780;201306;2945;10065;2924;10042;87;224;2769;9650;2856;9874
150790;201306;4702;15361;4457;15077;342;993;3868;13496;4210;14489
150795;201306;13295;43431;12392;42112;1953;6430;9230;32304;11183;38734
150796;201306;2615;8353;2563;8287;399;1186;1977;6652;2376;7838
150797;201306;3589;12334;3454;12119;196;718;3033;10761;3229;11479
150800;201306;13049;45466;12079;44246;2841;9867;7994;30785;10835;40652
150803;201306;6283;23991;6100;23723;848;3478;4638;18339;5486;21817
150805;201306;2589;9327;2425;9095;376;1337;1766;6866;2142;8203
150808;201306;5572;19604;4862;18272;2150;8466;1290;5111;3440;13577
150810;201306;18155;58877;15608;55786;2635;9128;11145;41802;13780;50930
150812;201306;4647;15254;4387;14946;448;1842;3447;11579;3895;13421
150815;201306;8065;26575;7325;25666;859;2749;5983;21696;6842;24445
150820;201306;9896;30096;9073;29199;529;1154;8205;27219;8734;28373
150830;201306;11817;46849;11374;46068;972;3775;9227;38826;10199;42601
150835;201306;1911;7232;1786;6932;510;2090;857;3338;1367;5428
150840;201306;6208;19008;5118;17632;1420;5416;2841;9499;4261;14915
160005;201306;683;2665;648;2589;113;524;396;1563;509;2087
160010;201306;1478;5343;1467;5331;195;548;1207;4614;1402;5162
160015;201306;1503;5746;1471;5688;265;964;1061;4331;1326;5295
160020;201306;2203;7433;2061;7241;288;1015;1547;5587;1835;6602
160021;201306;763;3490;744;3455;134;678;513;2444;647;3122
160023;201306;902;3482;893;3469;110;391;747;2975;857;3366
160025;201306;1173;3255;1141;3221;26;85;1096;3086;1122;3171
160027;201306;7511;25479;7160;25068;1521;5454;4916;17603;6437;23057
160030;201306;35758;138120;35177;136954;8205;30912;24111;96896;32316;127808
160040;201306;3121;13420;3066;13325;211;986;2700;11798;2911;12784
160050;201306;2951;11625;2691;11212;1004;3790;1249;5989;2253;9779
160053;201306;1928;8268;1908;8230;523;2242;1216;5435;1739;7677
160055;201306;752;3026;736;3003;141;615;520;2149;661;2764
160060;201306;17188;57648;16223;56569;4029;13226;10686;39367;14715;52593
160070;201306;1908;8554;1894;8530;185;774;1650;7586;1835;8360
160080;201306;2388;9712;2370;9682;157;550;2161;8993;2318;9543
170025;201306;557;1957;514;1891;193;747;234;889;427;1636
170030;201306;1124;3821;1052;3700;299;1078;569;2033;868;3111
170035;201306;1506;4676;1245;4174;442;1593;398;1370;840;2963
170040;201306;1677;5814;1522;5571;350;1435;891;3273;1241;4708
170070;201306;1990;5589;1656;5170;416;1404;923;2946;1339;4350
170100;201306;2448;6806;2194;6362;270;898;1730;4958;2000;5856
170105;201306;703;2374;609;2183;136;597;337;1160;473;1757
170110;201306;1188;3746;1053;3523;199;662;676;2306;875;2968
170130;201306;1323;4288;1190;4111;178;605;865;3103;1043;3708
170190;201306;1547;4657;1329;4353;494;1623;489;1768;983;3391
170200;201306;1434;4584;1142;4055;314;1242;371;1286;685;2528
170210;201306;24667;81796;22125;77167;9416;35239;6290;22441;15706;57680
170215;201306;1097;3651;1005;3498;152;545;733;2611;885;3156
170220;201306;6189;21071;5734;20374;799;3005;4133;15065;4932;18070
170230;201306;1410;4916;1269;4664;355;1470;597;2135;952;3605
170240;201306;2961;8398;2435;7758;326;1155;1734;5582;2060;6737
170255;201306;3417;11290;2933;10462;1084;3792;1161;4496;2245;8288
170270;201306;1032;2733;758;2362;201;647;437;1393;638;2040
170290;201306;2839;8887;2517;8491;240;753;2081;7284;2321;8037
170300;201306;1997;6498;1789;6164;315;1202;1197;4138;1512;5340
170305;201306;677;2221;573;2015;120;469;347;1195;467;1664
170307;201306;1049;3731;921;3504;300;1155;356;1533;656;2688
170310;201306;1587;4459;1295;3991;327;1068;614;1985;941;3053
170320;201306;920;2814;777;2561;182;620;437;1463;619;2083
170330;201306;790;2436;668;2297;121;402;463;1656;584;2058
170360;201306;445;1592;424;1558;98;377;211;778;309;1155
170370;201306;1358;4112;1153;3817;194;760;694;2287;888;3047
170380;201306;2033;6610;1710;6133;432;1754;900;3193;1332;4947
170382;201306;559;1927;508;1859;52;186;420;1558;472;1744
170384;201306;1306;5871;1270;5805;296;1391;852;3986;1148;5377
170386;201306;805;2508;672;2303;206;773;247;880;453;1653
170388;201306;635;1949;560;1830;134;521;228;726;362;1247
170389;201306;939;3299;881;3207;103;461;667;2387;770;2848
170390;201306;1286;3957;1127;3754;188;641;821;2803;1009;3444
170410;201306;451;1542;438;1518;68;264;300;1036;368;1300
170460;201306;469;1356;375;1211;105;364;132;438;237;802
170510;201306;753;2599;650;2440;137;585;353;1311;490;1896
170550;201306;5153;16678;4395;15301;1834;6797;1221;4373;3055;11170
170555;201306;1296;3916;1094;3612;284;1047;608;2000;892;3047
170560;201306;1015;3505;866;3336;178;682;615;2461;793;3143
170600;201306;1299;3778;1166;3619;71;240;977;3091;1048;3331
170610;201306;1596;4904;1268;4387;211;817;739;2583;950;3400
170625;201306;388;1277;313;1112;90;335;87;306;177;641
170650;201306;1235;4107;1155;3949;282;1035;625;2170;907;3205
170700;201306;3788;12988;3234;12067;870;3550;1522;5908;2392;9458
170710;201306;1649;5038;1414;4698;179;702;1018;3398;1197;4100
170720;201306;1772;4804;1571;4487;309;893;1087;3149;1396;4042
170730;201306;1138;3325;947;3041;296;1051;431;1382;727;2433
170740;201306;2115;7956;1969;7724;286;1243;1425;5637;1711;6880
170755;201306;872;2804;743;2523;205;748;295;983;500;1731
170765;201306;1554;4271;1265;3807;333;1079;535;1666;868;2745
170770;201306;1784;6377;1673;6161;401;1547;960;3647;1361;5194
170820;201306;4053;13234;3689;12645;1004;3652;1745;6094;2749;9746
170825;201306;713;2255;559;1960;138;542;239;804;377;1346
170830;201306;1274;3875;1223;3803;50;123;1127;3544;1177;3667
170900;201306;2759;9997;2653;9785;348;1264;2014;7642;2362;8906
170930;201306;4149;12827;3416;11785;1377;4983;1162;4043;2539;9026
170950;201306;10206;32203;8379;29196;3902;14885;1930;6256;5832;21141
170980;201306;417;1367;362;1265;105;375;148;516;253;891
171050;201306;1214;4427;1162;4332;63;290;1038;3822;1101;4112
171070;201306;1651;5465;1543;5314;352;1276;931;3274;1283;4550
171090;201306;851;2643;760;2500;151;507;492;1648;643;2155
171110;201306;628;1906;522;1735;169;618;283;899;452;1517
171150;201306;855;2571;645;2169;130;469;367;1240;497;1709
171180;201306;572;1873;472;1652;120;465;211;756;331;1221
171190;201306;1832;6664;1574;6125;395;1617;747;3037;1142;4654
171195;201306;852;3115;781;2986;111;463;496;1963;607;2426
171200;201306;626;2096;530;1915;152;634;242;820;394;1454
171215;201306;423;1323;349;1195;61;226;174;604;235;830
171240;201306;865;2968;836;2919;71;157;726;2656;797;2813
171245;201306;663;2228;557;1971;117;446;282;998;399;1444
171250;201306;1113;3238;1010;3118;71;229;857;2676;928;2905
171270;201306;386;1610;364;1561;83;322;219;1000;302;1322
171280;201306;836;2700;770;2581;170;560;410;1497;580;2057
171320;201306;3759;11937;3299;11282;1153;4129;1549;5313;2702;9442
171330;201306;2700;8484;2445;8095;626;2166;1376;4640;2002;6806
171360;201306;1475;4950;1264;4638;327;1290;696;2592;1023;3882
171370;201306;692;1991;622;1877;141;521;338;957;479;1478
171380;201306;1226;4384;1134;4214;285;1053;648;2516;933;3569
171395;201306;874;2823;753;2595;149;598;413;1406;562;2004
171420;201306;2215;6838;1832;6182;410;1526;964;3257;1374;4783
171430;201306;1004;3257;926;3141;218;755;558;1914;776;2669
171488;201306;2340;7378;2174;7130;568;1863;1183;4036;1751;5899
171500;201306;871;2715;770;2512;135;399;434;1474;569;1873
171510;201306;874;3227;800;3113;156;619;508;2081;664;2700
171515;201306;601;1801;486;1635;114;402;232;794;346;1196
171525;201306;578;2008;500;1858;101;406;270;1006;371;1412
171550;201306;314;1125;281;1034;126;511;49;185;175;696
171570;201306;1048;3521;947;3375;165;597;656;2381;821;2978
171575;201306;1875;5527;1537;4931;465;1549;640;2147;1105;3696
171610;201306;5813;20476;5440;19767;1976;7515;1904;6976;3880;14491
171620;201306;2101;6979;1986;6794;201;772;1604;5506;1805;6278
171630;201306;856;2913;718;2668;158;657;336;1243;494;1900
171650;201306;2189;7149;1875;6623;519;1984;872;3026;1391;5010
171660;201306;2523;7227;2112;6519;512;1663;1090;3459;1602;5122
171665;201306;1305;4198;1176;3974;222;835;754;2568;976;3403
171670;201306;2237;6182;1887;5746;453;1484;1173;3544;1626;5028
171700;201306;1077;3689;988;3542;156;638;647;2312;803;2950
171720;201306;641;2068;571;1933;154;582;308;1035;462;1617
171750;201306;1180;4000;1065;3765;394;1453;385;1381;779;2834
171780;201306;1104;3282;833;2894;140;536;522;1814;662;2350
171790;201306;1715;5609;1404;5152;288;1072;840;3227;1128;4299
171800;201306;693;2291;642;2218;95;364;441;1530;536;1894
171820;201306;9049;29172;8462;28454;1980;7180;5140;17507;7120;24687
171830;201306;1595;5958;1466;5676;352;1427;726;2837;1078;4264
171840;201306;732;2264;666;2171;79;280;496;1620;575;1900
171845;201306;776;2143;609;1854;90;331;355;1034;445;1365
171850;201306;1006;3721;926;3549;114;532;621;2358;735;2890
171855;201306;1210;3986;1107;3812;123;514;829;2802;952;3316
171865;201306;478;1591;411;1492;103;423;202;721;305;1144
171870;201306;635;2135;544;1976;130;510;285;1058;415;1568
171875;201306;1349;4398;1154;4100;179;698;827;2939;1006;3637
171880;201306;984;3608;963;3575;123;483;749;2840;872;3323
171884;201306;818;2461;637;2186;150;568;258;913;408;1481
171886;201306;1440;5015;1326;4769;457;1735;456;1672;913;3407
171888;201306;605;1935;533;1807;109;381;325;1148;434;1529
171889;201306;462;1590;451;1563;83;258;293;1077;376;1335
171890;201306;1063;3691;983;3573;143;636;672;2390;815;3026
171900;201306;415;1643;398;1609;95;393;227;925;322;1318
172000;201306;619;2020;531;1895;84;374;327;1131;411;1505
172010;201306;1104;3843;1050;3749;112;454;818;2939;930;3393
172015;201306;350;1320;308;1256;63;253;179;781;242;1034
172020;201306;2264;7592;2039;7257;297;1177;1466;5263;1763;6440
172025;201306;692;2125;591;1944;103;379;355;1163;458;1542
172030;201306;1056;3701;975;3551;175;718;625;2297;800;3015
172049;201306;1038;3099;994;3041;135;436;759;2337;894;2773
172065;201306;1113;3450;948;3239;161;621;696;2360;857;2981
172080;201306;2652;8245;2285;7640;320;1249;1541;5069;1861;6318
172085;201306;495;1413;400;1254;116;436;121;350;237;786
172090;201306;3284;10115;2605;9253;536;2061;1587;5769;2123;7830
172093;201306;560;1874;449;1669;173;711;186;694;359;1405
172097;201306;654;1981;559;1818;182;639;187;607;369;1246
172100;201306;23386;83287;21477;79404;7762;31075;6754;25064;14516;56139
172110;201306;1610;5924;1512;5782;154;583;1199;4717;1353;5300
172120;201306;5406;16528;4586;15493;484;1712;3594;12412;4078;14124
172125;201306;313;975;254;885;59;222;123;451;182;673
172130;201306;466;1437;427;1378;82;288;276;917;358;1205
172208;201306;2124;6741;2014;6552;443;1539;1136;3768;1579;5307
172210;201306;2240;6824;2148;6713;144;488;1897;5935;2041;6423
210005;201306;20165;68358;18607;65790;5353;20015;10073;36067;15426;56082
210010;201306;1576;5597;1429;5414;162;586;1130;4429;1292;5015
210015;201306;3324;10322;3090;9999;210;465;2659;9033;2869;9498
210020;201306;6785;17950;6393;17472;444;1420;5276;14589;5720;16009
210030;201306;5706;19488;5497;19194;458;1969;4613;15941;5071;17910
210040;201306;1922;5701;1762;5511;180;576;1401;4439;1581;5015
210043;201306;5559;17700;5343;17358;325;1165;4671;15238;4996;16403
210047;201306;6587;26181;6220;25525;938;4152;4230;17519;5168;21671
210050;201306;2410;8388;1991;7912;197;799;1597;6471;1794;7270
210055;201306;1595;5669;1527;5571;194;664;1207;4484;1401;5148
210060;201306;7783;28934;7090;27878;819;3577;5300;21226;6119;24803
210070;201306;6403;20841;6198;20597;297;1099;5656;18876;5953;19975
210080;201306;3563;12440;3495;12335;101;402;3270;11584;3371;11986
210083;201306;3268;12238;3217;12173;249;888;2822;10860;3071;11748
210087;201306;2294;7670;2220;7575;179;650;1947;6643;2126;7293
210090;201306;9166;30930;8925;30536;580;2098;7751;26677;8331;28775
210095;201306;6024;24070;5925;23892;682;2810;4838;19817;5520;22627
210100;201306;7340;22221;7046;21891;230;917;6491;20140;6721;21057
210110;201306;3079;10936;2988;10803;206;805;2522;9278;2728;10083
210120;201306;21996;71485;19760;68493;2129;7829;15320;53979;17449;61808
210125;201306;3193;10919;3089;10797;234;793;2705;9606;2939;10399
210130;201306;3410;10756;3352;10690;239;771;2906;9338;3145;10109
210135;201306;1529;4750;1397;4545;106;357;1182;3912;1288;4269
210140;201306;15842;53338;13825;50727;3000;11243;9029;34205;12029;45448
210150;201306;4271;11847;4072;11614;193;519;3714;10663;3907;11182
210160;201306;17529;59231;16534;57761;2092;7134;13058;46772;15150;53906
210170;201306;13554;51205;13351;50911;1044;3615;11655;45386;12699;49001
210173;201306;1711;7539;1670;7449;172;770;1403;6345;1575;7115
210177;201306;2807;9684;2668;9500;387;1501;2019;7173;2406;8674
210180;201306;1385;4481;1322;4376;124;427;1085;3604;1209;4031
210190;201306;5005;16603;4773;16219;391;1754;3753;12477;4144;14231
210193;201306;1390;4549;1314;4423;91;359;1102;3733;1193;4092
210197;201306;1661;6211;1598;6139;111;486;1412;5413;1523;5899
210200;201306;8618;30229;8080;29459;1175;4077;5965;22675;7140;26752
210203;201306;5990;20793;5649;20354;468;1513;4853;17897;5321;19410
210207;201306;2874;9965;2741;9735;368;1335;2084;7497;2452;8832
210210;201306;8368;29245;8135;28863;348;1330;7138;25660;7486;26990
210215;201306;1741;7039;1704;6983;152;684;1439;5928;1591;6612
210220;201306;6022;23859;5849;23568;474;1951;4837;19935;5311;21886
210230;201306;5195;18231;4871;17688;502;1867;3851;14190;4353;16057
210232;201306;10809;41373;10388;40696;2326;8982;7111;28732;9437;37714
210235;201306;3210;10533;2971;10221;216;765;2577;8946;2793;9711
210237;201306;2469;9040;2447;9007;45;108;2363;8808;2408;8916
210240;201306;2738;9088;2652;8955;247;804;2162;7428;2409;8232
210250;201306;4447;15332;4312;15163;160;611;3981;14103;4141;14714
210255;201306;2508;8465;2315;8142;614;2322;1330;4743;1944;7065
210260;201306;5061;16555;4719;16045;637;2078;3646;12694;4283;14772
210270;201306;5111;15080;4662;14487;189;656;4191;13146;4380;13802
210275;201306;3179;8605;2982;8390;103;272;2821;7986;2924;8258
210280;201306;5779;17296;5124;16473;377;1304;4378;14219;4755;15523
210290;201306;5790;18710;5380;18195;538;1776;4414;15247;4952;17023
210300;201306;34497;110259;30220;104633;3254;12015;24413;85877;27667;97892
210310;201306;2629;8049;2568;7957;154;496;2296;7140;2450;7636
210312;201306;1784;6321;1761;6281;145;572;1508;5397;1653;5969
210315;201306;2089;7825;2021;7724;83;381;1809;6942;1892;7323
210317;201306;4186;12766;4094;12659;163;479;3839;11946;4002;12425
210320;201306;18112;59714;17214;58618;1101;3899;15180;52380;16281;56279
210325;201306;3373;11165;3099;10758;367;1372;2429;8507;2796;9879
210330;201306;29955;85954;25985;81554;3781;10819;19366;64884;23147;75703
210340;201306;11403;36992;10583;35975;1260;3839;8304;29570;9564;33409
210350;201306;9754;32388;9289;31734;843;2936;7619;26552;8462;29488
210355;201306;3889;14150;3590;13779;129;339;3333;13126;3462;13465
210360;201306;16201;51246;15354;49985;1425;4881;12361;40919;13786;45800
210370;201306;7455;21864;6884;21250;276;859;6328;19728;6604;20587
210375;201306;3153;9906;2797;9489;486;1757;2059;7085;2545;8842
210380;201306;5885;18024;5397;17239;453;1444;4485;14502;4938;15946
210390;201306;2542;9653;2445;9492;97;424;2249;8795;2346;9219
210400;201306;4546;15397;4398;15205;393;1274;3761;13253;4154;14527
210405;201306;8245;23714;6920;21916;2065;6578;3332;11476;5397;18054
210407;201306;2028;7205;1842;6916;199;708;1422;5576;1621;6284
210408;201306;2014;8349;1931;8250;82;329;1767;7728;1849;8057
210409;201306;3756;13800;3596;13550;322;1237;2849;11034;3171;12271
210410;201306;3384;11200;3192;10956;314;1039;2731;9497;3045;10536
210420;201306;3997;13714;3793;13352;388;1334;3045;10946;3433;12280
210430;201306;1814;5966;1788;5928;133;465;1571;5248;1704;5713
210440;201306;3977;13051;3882;12900;225;787;3410;11451;3635;12238
210450;201306;2637;8849;2484;8596;228;870;2018;6999;2246;7869
210455;201306;3980;12225;3416;11329;612;2089;2293;7801;2905;9890
210460;201306;4040;13240;3861;13018;200;736;3411;11623;3611;12359
210462;201306;1736;6367;1691;6287;184;705;1299;4951;1483;5656
210465;201306;2684;8986;2554;8818;323;944;2059;7410;2382;8354
210467;201306;5731;20231;5388;19739;555;2005;4371;16444;4926;18449
210470;201306;1658;5190;1474;4920;101;381;1195;4019;1296;4400
210480;201306;12677;45059;11568;43533;3010;11486;6958;27287;9968;38773
210490;201306;3161;10071;2976;9791;388;1339;2283;7554;2671;8893
210500;201306;6526;26060;6270;25608;728;2905;4878;20627;5606;23532
210510;201306;6388;22218;6287;22106;167;546;5853;20993;6020;21539
210515;201306;3504;11547;3451;11463;280;855;2995;10152;3275;11007
210520;201306;2546;8383;2428;8217;250;886;1960;6740;2210;7626
210530;201306;38358;131976;34228;125462;11345;44233;17169;64159;28514;108392
210535;201306;2961;10894;2907;10791;143;580;2580;9641;2723;10221
210540;201306;11381;42137;10432;40547;2257;8668;6345;26236;8602;34904
210542;201306;6158;18646;5517;17926;306;945;4915;16296;5221;17241
210545;201306;2139;7468;2057;7336;91;400;1793;6411;1884;6811
210547;201306;3256;12384;3117;12172;208;908;2656;10464;2864;11372
210550;201306;6080;18025;5287;17136;275;790;4772;15807;5047;16597
210560;201306;3592;12317;3405;12025;284;1126;2849;10055;3133;11181
210565;201306;1528;5313;1361;5061;107;479;1051;3912;1158;4391
210570;201306;11945;36470;10976;35329;991;3001;9266;30583;10257;33584
210580;201306;2660;8929;2388;8568;277;1007;1900;6943;2177;7950
210590;201306;4345;13841;4147;13598;260;875;3663;12171;3923;13046
210592;201306;2379;7744;2332;7670;113;439;2079;6805;2192;7244
210594;201306;2608;7801;2255;7365;146;499;1954;6465;2100;6964
210596;201306;2801;10777;2679;10547;348;1394;2007;8026;2355;9420
210598;201306;1989;6220;1901;6120;113;482;1739;5504;1852;5986
210600;201306;3193;9651;3003;9386;306;1025;2413;7518;2719;8543
210610;201306;2546;8308;2311;8022;263;928;1889;6616;2152;7544
210620;201306;1726;5468;1614;5319;52;159;1497;4975;1549;5134
210630;201306;3261;12370;2869;11578;538;2182;1692;7127;2230;9309
210632;201306;4647;16428;4308;15951;515;1950;3381;12686;3896;14636
210635;201306;1846;6887;1813;6840;65;211;1687;6469;1752;6680
210637;201306;2618;9159;2525;9025;131;507;2262;8164;2393;8671
210640;201306;4138;13888;4088;13821;29;88;3984;13546;4013;13634
210650;201306;6259;20041;6178;19927;290;905;5707;18557;5997;19462
210660;201306;7108;23209;6721;22585;273;865;6136;20705;6409;21570
210663;201306;2699;8202;2620;8116;59;173;2498;7835;2557;8008
210667;201306;1575;6048;1532;5987;116;506;1299;5128;1415;5634
210670;201306;4576;17678;4457;17466;429;1732;3595;14421;4024;16153
210675;201306;4581;13285;4439;13105;286;835;3863;11607;4149;12442
210680;201306;4219;12798;3859;12362;201;706;3418;10966;3619;11672
210690;201306;6473;23267;6246;23028;361;1356;5637;20946;5998;22302
210700;201306;2527;7302;2259;6987;187;398;1870;6246;2057;6644
210710;201306;4782;15732;4655;15548;166;509;4312;14533;4478;15042
210720;201306;2312;8916;2242;8819;157;659;1953;7713;2110;8372
210725;201306;1149;4314;1002;4051;145;644;624;2542;769;3186
210730;201306;1139;3708;1037;3596;82;261;897;3156;979;3417
210735;201306;3586;13675;3443;13407;645;2558;2408;9608;3053;12166
210740;201306;4592;12834;4313;12551;184;397;3984;11882;4168;12279
210745;201306;3309;10871;3218;10721;267;965;2680;8906;2947;9871
210750;201306;19345;55509;17890;53808;1977;6078;14589;44376;16566;50454
210760;201306;5502;15411;5292;15181;87;265;5140;14760;5227;15025
210770;201306;5998;16650;5214;15764;313;956;4605;14024;4918;14980
210780;201306;8392;29292;7958;28493;1069;4155;5873;21239;6942;25394
210790;201306;4476;14018;3952;13442;193;671;3563;12305;3756;12976
210800;201306;4618;14286;4251;13889;200;755;3705;12438;3905;13193
210805;201306;3612;15811;3557;15701;191;827;3127;14089;3318;14916
210810;201306;5389;17127;4901;16570;540;1448;4106;14469;4646;15917
210820;201306;8683;25620;8291;25097;1369;4115;6017;18725;7386;22840
210825;201306;5279;18126;5190;18017;196;703;4760;16678;4956;17381
210830;201306;7792;26039;7534;25746;304;836;7084;24534;7388;25370
210840;201306;3617;10208;3347;9815;310;770;2661;7907;2971;8677
210845;201306;5329;17525;5170;17330;255;784;4630;15868;4885;16652
210850;201306;5625;21749;5339;21235;980;4356;3637;14461;4617;18817
210860;201306;16041;52856;15586;52170;1434;5083;12956;43528;14390;48611
210870;201306;5907;20243;5439;19600;764;2793;3971;14596;4735;17389
210880;201306;3681;12314;3641;12261;199;610;3312;11328;3511;11938
210890;201306;5196;16093;4907;15712;454;1597;4048;12899;4502;14496
210900;201306;4386;14877;4138;14442;1426;5078;1965;7148;3391;12226
210905;201306;1750;5623;1694;5550;102;267;1538;5153;1640;5420
210910;201306;10259;33224;9745;32415;1998;7077;6381;21447;8379;28524
210920;201306;3384;11513;3310;11412;150;441;3007;10577;3157;11018
210923;201306;1473;5647;1424;5566;204;840;1032;4167;1236;5007
210927;201306;4574;14737;4492;14655;42;105;4415;14469;4457;14574
210930;201306;2452;9305;2397;9222;196;882;2039;7841;2235;8723
210940;201306;2828;11425;2792;11357;316;1173;2268;9500;2584;10673
210945;201306;5696;17025;5518;16843;150;218;5315;16526;5465;16744
210950;201306;5265;17326;4720;16515;694;2468;3322;11980;4016;14448
210955;201306;1775;6184;1641;5945;281;1123;1118;4049;1399;5172
210960;201306;8797;30175;8546;29771;1829;6181;5961;21494;7790;27675
210970;201306;1308;4966;1183;4780;205;886;827;3392;1032;4278
210975;201306;1609;5925;1544;5794;155;658;1237;4642;1392;5300
210980;201306;8070;21717;7914;21535;291;809;7338;20008;7629;20817
210990;201306;14167;41814;12023;39440;1226;4041;10006;33168;11232;37209
211000;201306;15189;51299;13997;49736;1272;4718;11594;41865;12866;46583
211003;201306;4997;17927;4649;17386;820;3197;3151;12060;3971;15257
211010;201306;6494;21930;6346;21733;157;529;5930;20484;6087;21013
211020;201306;7227;22507;7169;22437;236;479;6838;21718;7074;22197
211023;201306;2350;8230;2268;8086;182;682;1903;6873;2085;7555
211027;201306;2952;11735;2825;11521;293;1144;2265;9585;2558;10729
211030;201306;4063;12846;3713;12434;844;2364;2644;9424;3488;11788
211040;201306;3988;15551;3907;15412;125;534;3538;14165;3663;14699
211050;201306;9549;26999;9438;26869;531;1385;8695;24965;9226;26350
211060;201306;5465;20791;5366;20589;515;1806;4509;17758;5024;19564
211065;201306;1605;5739;1491;5581;86;335;1348;5078;1434;5413
211070;201306;8393;28938;8069;28394;818;2961;6454;23082;7272;26043
211080;201306;1303;4219;1091;3934;95;465;901;3174;996;3639
211085;201306;1965;6763;1719;6443;304;1081;1289;5027;1593;6108
211090;201306;3362;11144;3211;10929;237;934;2691;9125;2928;10059
211100;201306;6178;17603;6058;17451;154;538;5638;16241;5792;16779
211102;201306;3015;11526;2929;11393;356;1379;2366;9413;2722;10792
211105;201306;2655;8674;2463;8430;169;625;2149;7371;2318;7996
211107;201306;4190;13434;4005;13197;138;455;3714;12329;3852;12784
211110;201306;6184;19320;5116;17966;861;2955;3542;13073;4403;16028
211120;201306;29170;84465;26358;80626;3339;9978;20073;63037;23412;73015
211125;201306;1981;6902;1908;6774;134;512;1618;5794;1752;6306
211130;201306;139050;424772;132533;416473;25222;78828;94968;305245;120190;384073
211140;201306;5563;18414;5379;18117;312;1152;4691;15825;5003;16977
211150;201306;9376;30680;9127;30362;721;2355;7999;26972;8720;29327
211153;201306;3151;9628;2898;9327;286;746;2414;8119;2700;8865
211157;201306;1165;4013;1009;3773;139;611;723;2749;862;3360
211160;201306;4016;14287;3579;13547;417;1818;2733;10357;3150;12175
211163;201306;1610;5465;1545;5383;64;247;1416;4944;1480;5191
211167;201306;1417;4980;1328;4825;63;275;1159;4213;1222;4488
211170;201306;6405;17988;6237;17782;156;577;5832;16546;5988;17123
211172;201306;2268;6880;2013;6491;152;612;1639;5176;1791;5788
211174;201306;2755;8433;2565;8184;132;541;2241;7093;2373;7634
211176;201306;5463;16292;4690;15390;502;1399;3832;13076;4334;14475
211178;201306;2824;9482;2762;9415;66;195;2638;9082;2704;9277
211180;201306;4137;15368;3905;14990;411;1738;3069;11848;3480;13586
211190;201306;2688;9470;2478;9170;150;653;2171;8065;2321;8718
211195;201306;1371;4531;1219;4362;104;367;1001;3661;1105;4028
211200;201306;2032;7341;1850;7083;279;984;1332;5429;1611;6413
211210;201306;6681;22761;6522;22492;515;1842;5545;19301;6060;21143
211220;201306;33447;103605;29778;98712;6811;23447;18467;63010;25278;86457
211223;201306;5806;16937;5438;16337;725;2203;3803;11996;4528;14199
211227;201306;1458;5755;1432;5708;181;855;1094;4330;1275;5185
211230;201306;8323;29799;7976;29160;1384;5120;5567;20770;6951;25890
211240;201306;8315;28465;8125;28229;365;1335;7491;26157;7856;27492
211245;201306;4897;15778;4820;15679;230;661;4415;14600;4645;15261
211250;201306;11308;44000;10833;43443;1255;4252;8997;37579;10252;41831
211260;201306;6932;24870;6861;24750;371;1214;6266;22905;6637;24119
211270;201306;9705;35441;9309;34920;655;2749;7829;29710;8484;32459
211280;201306;11584;34245;11356;33971;1261;3061;9584;29792;10845;32853
211285;201306;1957;7072;1716;6624;424;1685;892;3648;1316;5333
211290;201306;7658;25432;7519;25269;544;1470;6670;23009;7214;24479
211300;201306;8085;25743;7323;24571;717;2557;5841;19717;6558;22274
211400;201306;11845;36120;10936;35099;2373;7536;6839;23816;9212;31352
220005;201306;1672;5024;1615;4935;58;271;1441;4276;1499;4547
220010;201306;1707;4598;1304;4097;145;543;1015;3130;1160;3673
220020;201306;3594;11261;3469;11035;629;2148;2342;7436;2971;9584
220025;201306;2069;5355;1987;5243;74;235;1788;4654;1862;4889
220027;201306;1336;3845;1266;3752;102;245;1082;3303;1184;3548
220030;201306;3207;10076;3148;9978;271;941;2662;8459;2933;9400
220040;201306;8164;25852;7843;25322;1458;5045;5091;16470;6549;21515
220045;201306;1403;4591;1291;4413;167;633;952;3228;1119;3861
220050;201306;4714;13720;4260;13116;356;1281;3541;10795;3897;12076
220060;201306;1893;5117;1801;5007;118;344;1585;4416;1703;4760
220070;201306;2526;7721;2273;7368;216;702;1832;6044;2048;6746
220080;201306;808;2565;764;2486;100;401;536;1677;636;2078
220090;201306;1662;4739;1506;4503;149;540;1168;3400;1317;3940
220095;201306;629;1871;612;1831;39;118;551;1637;590;1755
220100;201306;1385;4276;1218;4015;166;512;887;3027;1053;3539
220105;201306;2131;7291;2044;7127;206;781;1524;5308;1730;6089
220110;201306;3490;10319;3105;9769;299;1124;2518;7795;2817;8919
220115;201306;2136;8075;2059;7945;298;1196;1593;6225;1891;7421
220117;201306;1395;3792;1171;3464;95;324;923;2692;1018;3016
220120;201306;11753;35572;11076;34706;436;1652;10015;31406;10451;33058
220130;201306;775;2901;690;2788;69;203;587;2478;656;2681
220140;201306;1512;4183;1448;4108;235;530;1171;3462;1406;3992
220150;201306;6877;22648;6689;22363;495;1958;5701;18974;6196;20932
220155;201306;1028;3309;896;3055;90;380;634;2107;724;2487
220157;201306;1021;2776;948;2669;46;120;825;2346;871;2466
220160;201306;2798;8518;2535;8059;244;926;1919;6039;2163;6965
220170;201306;1218;4068;1166;3970;122;442;906;3117;1028;3559
220173;201306;2071;6380;1744;5756;97;439;1418;4607;1515;5046
220177;201306;1573;4885;1551;4850;99;320;1376;4321;1475;4641
220180;201306;1138;3181;1029;3010;82;280;788;2265;870;2545
220190;201306;4482;14963;3920;14239;483;1843;3005;11016;3488;12859
220191;201306;1393;4800;1341;4712;219;775;992;3508;1211;4283
220192;201306;1728;5198;1456;4747;182;570;1088;3623;1270;4193
220194;201306;1600;4778;1520;4635;172;600;1198;3577;1370;4177
220196;201306;1952;6054;1862;5904;214;804;1432;4479;1646;5283
220198;201306;1318;3634;1135;3386;43;140;1037;3117;1080;3257
220200;201306;4560;16011;4327;15628;755;2985;2960;10634;3715;13619
220202;201306;1971;6474;1830;6220;83;347;1601;5416;1684;5763
220205;201306;2742;7793;2450;7396;125;501;2129;6333;2254;6834
220207;201306;903;2818;800;2640;106;395;597;1964;703;2359
220208;201306;1569;5763;1491;5600;307;1261;948;3583;1255;4844
220209;201306;1533;4957;1420;4759;104;417;1096;3676;1200;4093
220210;201306;1845;4983;1624;4691;100;346;1295;3762;1395;4108
220211;201306;1570;4916;1496;4811;115;513;1224;3907;1339;4420
220213;201306;1768;5268;1663;5077;121;407;1320;3991;1441;4398
220217;201306;1757;5631;1713;5571;88;267;1532;5043;1620;5310
220220;201306;11132;33407;10546;32449;1433;4371;7637;24047;9070;28418
220225;201306;952;3061;932;3029;42;187;836;2681;878;2868
220230;201306;5704;15649;4713;14294;266;828;4136;12621;4402;13449
220240;201306;2616;8571;2523;8402;214;816;2005;6606;2219;7422
220245;201306;1363;3858;1302;3776;65;158;1177;3460;1242;3618
220250;201306;3296;8996;3027;8651;60;139;2856;8267;2916;8406
220253;201306;1822;5566;1598;5155;113;447;1199;3896;1312;4343
220255;201306;1686;5040;1507;4740;124;481;1204;3714;1328;4195
220260;201306;5145;16785;4754;16068;516;2023;3574;12006;4090;14029
220265;201306;1175;4363;1126;4283;101;466;869;3283;970;3749
220270;201306;6145;22010;6020;21782;437;1967;5109;18234;5546;20201
220271;201306;1340;4061;1307;4012;89;287;1127;3493;1216;3780
220272;201306;1746;5488;1635;5321;117;486;1294;4159;1411;4645
220273;201306;1237;3638;1119;3468;100;359;885;2735;985;3094
220275;201306;2015;5530;1743;5175;92;304;1499;4470;1591;4774
220277;201306;2490;6988;2152;6495;175;588;1646;4996;1821;5584
220280;201306;1736;4608;1528;4317;100;371;1244;3446;1344;3817
220285;201306;1631;4422;1496;4237;107;304;1237;3596;1344;3900
220290;201306;6478;21214;5510;19978;484;1831;4494;16536;4978;18367
220300;201306;1870;6173;1672;5907;98;444;1435;5056;1533;5500
220310;201306;2495;8162;2053;7633;108;349;1856;7068;1964;7417
220320;201306;3320;9965;2836;9170;406;1328;2059;6738;2465;8066
220323;201306;1406;5372;1303;5220;228;974;923;3720;1151;4694
220325;201306;1254;3969;1161;3799;163;577;784;2643;947;3220
220327;201306;1305;4291;1191;4090;92;420;967;3287;1059;3707
220330;201306;3558;10470;3419;10277;309;1041;2851;8589;3160;9630
220335;201306;1958;5850;1769;5603;127;465;1508;4756;1635;5221
220340;201306;1732;5051;1568;4833;180;629;1213;3704;1393;4333
220342;201306;1200;3982;1139;3892;113;450;868;3061;981;3511
220345;201306;2828;8057;2437;7412;94;274;2123;6468;2217;6742
220350;201306;4400;12120;3903;11445;315;1025;3115;9115;3430;10140
220360;201306;1422;4020;1141;3571;124;453;827;2562;951;3015
220370;201306;8880;26179;8273;25424;428;1238;7541;23351;7969;24589
220375;201306;1494;4741;1404;4614;90;343;1234;4030;1324;4373
220380;201306;1252;3667;1111;3458;79;268;852;2673;931;2941
220385;201306;642;1856;587;1744;47;163;472;1347;519;1510
220390;201306;9995;32300;9420;31211;2223;7868;5232;17416;7455;25284
220400;201306;1409;3467;1291;3307;63;206;1120;2815;1183;3021
220410;201306;1373;4085;1185;3828;111;480;939;2937;1050;3417
220415;201306;840;2345;764;2234;86;249;571;1689;657;1938
220420;201306;2139;6441;2058;6299;147;465;1743;5348;1890;5813
220430;201306;2893;8705;2751;8514;444;1437;1986;6152;2430;7589
220435;201306;1549;4704;1475;4610;76;239;1278;4027;1354;4266
220440;201306;2780;8339;2307;7801;146;401;2050;7067;2196;7468
220450;201306;2688;8087;2354;7647;553;1840;1476;4889;2029;6729
220455;201306;1379;4349;1236;4143;62;210;1108;3751;1170;3961
220460;201306;993;2855;943;2781;57;184;824;2420;881;2604
220465;201306;2379;8028;2241;7849;328;1223;1716;6072;2044;7295
220470;201306;3957;12226;3616;11611;259;980;2852;9032;3111;10012
220480;201306;2222;6985;2062;6736;176;612;1696;5552;1872;6164
220490;201306;2298;7023;2223;6925;137;505;1949;6041;2086;6546
220500;201306;3378;9353;2961;8680;227;867;2406;6867;2633;7734
220510;201306;2884;8206;2257;7321;118;517;1803;5806;1921;6323
220515;201306;1901;4921;1687;4650;83;241;1440;3987;1523;4228
220520;201306;4820;14033;4576;13677;261;741;3981;12042;4242;12783
220525;201306;1403;4138;1325;4027;102;367;1095;3281;1197;3648
220527;201306;1367;4480;1325;4398;129;415;1113;3738;1242;4153
220530;201306;1031;3187;994;3127;141;508;782;2384;923;2892
220535;201306;852;2769;829;2732;73;308;669;2172;742;2480
220540;201306;3520;12014;3413;11827;294;1170;2777;9641;3071;10811
220545;201306;1362;4869;1317;4786;222;909;890;3192;1112;4101
220550;201306;8777;29636;8371;28862;1750;6349;5335;18466;7085;24815
220551;201306;1354;4846;1297;4738;131;564;1019;3668;1150;4232
220552;201306;1593;5077;1389;4743;139;633;1003;3289;1142;3922
220553;201306;1574;4778;1397;4516;63;203;1211;3940;1274;4143
220554;201306;912;2596;801;2440;123;370;564;1760;687;2130
220555;201306;2345;7135;2230;6970;104;365;1899;6032;2003;6397
220556;201306;1434;4644;1309;4404;102;424;981;3253;1083;3677
220557;201306;1563;5324;1463;5126;185;796;1051;3627;1236;4423
220558;201306;1006;3192;956;3107;86;316;784;2542;870;2858
220559;201306;1509;4376;1408;4227;82;286;1210;3613;1292;3899
220560;201306;1727;4396;1466;4030;82;246;1248;3402;1330;3648
220570;201306;7212;23413;6849;22967;649;1798;5831;20219;6480;22017
220580;201306;6269;21213;6101;21004;430;1454;5379;18776;5809;20230
220585;201306;1729;6877;1689;6799;115;480;1466;5936;1581;6416
220590;201306;1380;4448;1253;4256;221;788;845;2908;1066;3696
220595;201306;2408;7132;2251;6919;92;315;2031;6270;2123;6585
220600;201306;1245;3310;1095;3126;152;400;798;2346;950;2746
220605;201306;1972;6044;1792;5764;132;451;1406;4549;1538;5000
220610;201306;2600;8644;2526;8532;191;745;2129;7164;2320;7909
220620;201306;7627;26465;7430;26155;380;1573;6577;23115;6957;24688
220630;201306;373;1171;330;1099;87;303;163;557;250;860
220635;201306;1829;6670;1702;6372;164;745;1134;4232;1298;4977
220640;201306;2676;8180;2624;8084;284;991;2045;6267;2329;7258
220650;201306;2445;6926;2215;6572;135;463;1851;5477;1986;5940
220660;201306;2468;8603;2045;8086;151;594;1835;7325;1986;7919
220665;201306;1202;4190;1156;4118;59;241;1009;3577;1068;3818
220667;201306;1740;6014;1653;5887;93;385;1425;5057;1518;5442
220669;201306;1834;6186;1715;5947;229;911;1231;4243;1460;5154
220670;201306;2060;6415;1990;6335;159;417;1743;5742;1902;6159
220672;201306;2116;6332;2069;6264;227;677;1728;5281;1955;5958
220675;201306;1296;3879;1226;3759;135;376;923;2870;1058;3246
220680;201306;2214;7462;2140;7357;116;457;1884;6492;2000;6949
220690;201306;1701;4994;1557;4749;134;509;1262;3786;1396;4295
220695;201306;825;2636;797;2585;63;218;620;2023;683;2241
220700;201306;8908;26604;8209;25559;790;2717;6507;20310;7297;23027
220710;201306;733;2241;658;2128;86;271;477;1558;563;1829
220720;201306;2083;5754;1979;5604;106;238;1758;5079;1864;5317
220730;201306;1327;3780;1211;3601;68;225;1014;3004;1082;3229
220735;201306;1019;2749;887;2536;92;287;658;1890;750;2177
220740;201306;1310;4444;1144;4221;117;376;937;3579;1054;3955
220750;201306;3782;11678;3646;11470;471;1407;2817;9126;3288;10533
220755;201306;1148;3512;1103;3440;67;200;965;3032;1032;3232
220760;201306;2521;9143;2352;8877;123;514;2041;7764;2164;8278
220770;201306;22430;79253;21249;77082;7288;27390;9521;35565;16809;62955
220775;201306;1112;2845;1102;2835;18;27;1078;2793;1096;2820
220777;201306;1656;4868;1588;4769;141;447;1306;3898;1447;4345
220779;201306;1116;3555;1095;3520;71;285;968;3083;1039;3368
220780;201306;6179;16432;5642;15739;505;1295;4700;13381;5205;14676
220785;201306;1275;3573;1231;3477;69;202;1103;3095;1172;3297
220790;201306;8814;30323;8625;29949;891;3472;6905;23902;7796;27374
220793;201306;825;2545;780;2463;73;256;622;1958;695;2214
220795;201306;1445;4285;1396;4208;105;340;1172;3561;1277;3901
220800;201306;16318;48160;15467;46806;2047;7180;11706;34686;13753;41866
220810;201306;3184;9604;2796;8896;254;1013;2162;6763;2416;7776
220820;201306;5331;15833;4905;15270;368;1198;4129;12998;4497;14196
220830;201306;7613;22141;7331;21682;894;2597;5698;17175;6592;19772
220840;201306;14197;46915;13228;44987;3544;12307;6274;22108;9818;34415
220850;201306;2533;9691;2446;9551;366;1521;1835;7254;2201;8775
220855;201306;587;1935;543;1850;72;292;395;1330;467;1622
220860;201306;919;2644;864;2557;55;220;711;2055;766;2275
220865;201306;2610;7558;2230;6948;128;571;1821;5566;1949;6137
220870;201306;2322;7836;2048;7486;161;644;1722;6303;1883;6947
220880;201306;5252;14158;4835;13641;265;911;4228;11905;4493;12816
220885;201306;1313;4705;1167;4443;116;547;858;3269;974;3816
220887;201306;1193;3398;1079;3234;52;171;947;2852;999;3023
220890;201306;1570;5724;1424;5485;122;453;1185;4690;1307;5143
220900;201306;1791;5616;1621;5214;129;399;1304;4264;1433;4663
220910;201306;1713;5051;1544;4787;88;306;1330;4155;1418;4461
220915;201306;1023;3036;924;2874;56;245;745;2253;801;2498
220920;201306;1281;4895;1226;4815;121;553;950;3726;1071;4279
220930;201306;1440;4770;1277;4557;117;484;1027;3684;1144;4168
220935;201306;1087;3453;1010;3279;84;363;727;2253;811;2616
220937;201306;1484;4268;1301;3936;86;302;1040;3104;1126;3406
220940;201306;1458;4576;1368;4380;102;377;1104;3543;1206;3920
220945;201306;470;1753;445;1669;56;237;330;1235;386;1472
220950;201306;1231;3201;910;2638;50;205;688;1921;738;2126
220955;201306;1527;4401;1304;4053;145;511;1005;3094;1150;3605
220960;201306;767;2260;694;2134;79;306;523;1554;602;1860
220965;201306;1591;5060;1513;4950;78;323;1297;4232;1375;4555
220970;201306;2090;5790;1608;5012;197;612;1136;3614;1333;4226
220975;201306;462;1896;459;1889;52;193;391;1642;443;1835
220980;201306;1453;4467;1307;4199;135;509;896;2937;1031;3446
220985;201306;1340;3940;1288;3867;116;392;1028;3086;1144;3478
220987;201306;1464;4951;1389;4812;137;571;1056;3591;1193;4162
220990;201306;1789;5429;1621;5145;106;449;1297;4057;1403;4506
220995;201306;1142;3602;972;3308;86;356;764;2589;850;2945
220997;201306;2060;6639;1991;6532;158;530;1744;5719;1902;6249
221000;201306;3973;12961;3700;12475;439;1640;2745;9208;3184;10848
221005;201306;1380;4467;1315;4352;369;1158;753;2604;1122;3762
221010;201306;1230;3456;1097;3288;69;224;945;2853;1014;3077
221020;201306;1878;5966;1786;5803;144;628;1376;4364;1520;4992
221030;201306;1813;5056;1593;4737;87;350;1305;3831;1392;4181
221035;201306;1487;4193;1353;4022;102;304;1159;3488;1261;3792
221037;201306;600;1923;577;1883;36;155;467;1461;503;1616
221038;201306;598;1787;502;1629;50;175;361;1178;411;1353
221039;201306;892;2740;858;2687;66;229;743;2311;809;2540
221040;201306;5059;15907;4833;15530;431;1537;3812;12362;4243;13899
221050;201306;3535;11301;3282;10931;231;958;2789;9180;3020;10138
221060;201306;8951;24822;7820;23364;879;2670;6194;18703;7073;21373
221062;201306;1238;4412;1190;4349;35;104;1119;4118;1154;4222
221063;201306;1080;3587;1037;3513;358;1171;563;2025;921;3196
221065;201306;2557;7957;2464;7788;270;906;1921;6049;2191;6955
221070;201306;4362;13699;4021;13181;297;1124;3245;10621;3542;11745
221080;201306;3152;9392;2910;9069;266;864;2344;7391;2610;8255
221090;201306;1322;3708;1194;3521;74;294;1007;2905;1081;3199
221093;201306;1758;5374;1691;5251;253;917;1159;3513;1412;4430
221095;201306;950;2659;827;2487;45;123;730;2229;775;2352
221097;201306;770;2312;697;2190;65;251;536;1668;601;1919
221100;201306;118475;373402;113494;365050;25437;90677;73396;230610;98833;321287
221110;201306;9199;32800;9069;32598;730;2967;7646;27459;8376;30426
221120;201306;3992;13840;3882;13639;1205;4062;2222;8239;3427;12301
221130;201306;4546;13905;4101;12993;997;3301;2325;7290;3322;10591
221135;201306;1389;4555;1313;4432;195;738;923;3100;1118;3838
221140;201306;1378;3580;1279;3449;176;384;985;2759;1161;3143
221150;201306;1209;3208;1055;2943;38;151;857;2368;895;2519
221160;201306;909;2513;869;2449;62;194;681;1931;743;2125
221170;201306;1079;3635;1043;3561;85;342;864;2919;949;3261
230010;201306;3239;9252;2802;8539;183;631;2246;6917;2429;7548
230015;201306;2943;10424;2739;9983;505;2110;1711;6151;2216;8261
230020;201306;13727;47326;13275;46413;1345;5118;10392;36523;11737;41641
230030;201306;11886;36865;11425;36094;1240;4244;8978;28408;10218;32652
230040;201306;4443;13080;3836;12002;372;1313;2973;9259;3345;10572
230050;201306;2526;8844;2220;8085;416;1686;1225;4460;1641;6146
230060;201306;1924;6016;1749;5670;193;728;1298;4171;1491;4899
230070;201306;4545;12840;4079;12188;397;1272;3116;9510;3513;10782
230075;201306;8493;33122;8151;32426;1111;4981;5983;23920;7094;28901
230080;201306;2296;6613;1985;6166;120;439;1633;5058;1753;5497
230090;201306;3182;10311;2924;9829;361;1398;2179;7222;2540;8620
230100;201306;16386;53073;15463;51397;4643;16306;7613;25635;12256;41941
230110;201306;13601;46573;12804;44851;2581;9827;7833;27430;10414;37257
230120;201306;7436;21685;6860;20915;788;2749;5205;15786;5993;18535
230125;201306;2803;8525;2384;7723;205;799;1808;5807;2013;6606
230130;201306;5855;19823;4902;17751;490;2123;3422;12281;3912;14404
230140;201306;3195;11053;2913;10570;480;1830;1928;7140;2408;8970
230150;201306;1694;5595;1507;5216;282;1154;980;3231;1262;4385
230160;201306;6083;19221;5444;18263;587;2195;4118;13858;4705;16053
230170;201306;6318;20877;5576;19507;571;2297;4037;14004;4608;16301
230180;201306;1873;5631;1704;5336;164;647;1214;3780;1378;4427
230185;201306;4047;14031;3784;13506;718;2627;2368;8704;3086;11331
230190;201306;12153;41089;11236;39254;2065;8222;6801;23548;8866;31770
230195;201306;4706;15204;4311;14585;404;1727;3326;10890;3730;12617
230200;201306;5356;16439;4998;15755;755;2523;3478;10962;4233;13485
230205;201306;4293;14225;3876;13507;439;1776;2800;9855;3239;11631
230210;201306;8911;26774;8095;25526;1958;6359;4696;15305;6654;21664
230220;201306;13073;40743;12265;39373;2138;7670;8240;26111;10378;33781
230230;201306;7002;24391;6365;22995;1102;4265;3913;14288;5015;18553
230240;201306;12791;39093;11769;37166;871;3442;9228;28578;10099;32020
230250;201306;10094;31629;9864;31273;581;2119;8439;26752;9020;28871
230260;201306;14518;51230;13601;49273;3269;12630;7097;26353;10366;38983
230270;201306;6983;21846;6279;20646;723;2646;4636;15369;5359;18015
230280;201306;19596;61461;18368;59463;2482;8818;13784;44584;16266;53402
230290;201306;4990;15920;4434;14807;617;2222;3041;10185;3658;12407
230300;201306;4555;14865;4400;14631;577;2150;3288;10939;3865;13089
230310;201306;4763;14714;4270;13894;417;1681;3251;10369;3668;12050
230320;201306;7132;23994;6776;23365;901;3473;4956;17156;5857;20629
230330;201306;4573;14205;4217;13496;443;1692;3148;9875;3591;11567
230340;201306;3239;11823;3094;11496;513;2204;1990;7223;2503;9427
230350;201306;17524;55610;15889;52713;3263;11620;9620;32249;12883;43869
230360;201306;2783;8726;2563;8327;281;1064;2005;6423;2286;7487
230365;201306;2815;8706;2511;8190;234;905;1865;6057;2099;6962
230370;201306;51731;179022;48659;173837;14967;55734;24609;90722;39576;146456
230380;201306;6920;20608;6032;19106;613;2275;4298;13571;4911;15846
230390;201306;3599;11756;3246;11169;451;1832;2213;7552;2664;9384
230393;201306;3274;11297;2908;10519;310;1489;2053;7198;2363;8687
230395;201306;4822;15888;4541;15328;653;2629;3127;10420;3780;13049
230400;201306;4988;16173;4444;15430;433;1910;3591;12228;4024;14138
230410;201306;15830;51460;14392;48856;2405;8919;9197;31272;11602;40191
230420;201306;23195;79958;22088;77715;5815;22353;11443;40065;17258;62418
230423;201306;4693;15891;4364;15306;544;2096;3072;10917;3616;13013
230425;201306;5121;18036;4902;17526;747;2924;3445;12290;4192;15214
230426;201306;2768;7995;2398;7336;155;634;1847;5535;2002;6169
230427;201306;1707;5370;1322;4490;164;617;886;2972;1050;3589
230428;201306;8744;29766;8554;29434;1836;7089;5488;18598;7324;25687
230430;201306;4446;14883;4242;14466;429;1789;3134;10515;3563;12304
230435;201306;4499;15769;4154;15174;1130;4469;2000;7584;3130;12053
230440;201306;347574;1114303;331039;1084134;87567;309865;170259;557748;257826;867613
230445;201306;4577;13079;4044;12340;424;1297;3018;9452;3442;10749
230450;201306;3545;11782;3060;10894;521;2037;1907;6869;2428;8906
230460;201306;1847;6324;1730;6094;204;787;1279;4536;1483;5323
230465;201306;3985;12806;3363;11622;410;1658;2223;7650;2633;9308
230470;201306;10332;39995;10048;39438;1507;6335;7195;28836;8702;35171
230480;201306;1427;4757;1311;4546;221;823;887;3072;1108;3895
230490;201306;2917;8775;2604;8210;465;1664;1472;4638;1937;6302
230495;201306;5611;19327;5116;18503;971;4118;3113;11251;4084;15369
230500;201306;10573;36768;10144;36079;882;3237;8131;29607;9013;32844
230510;201306;1447;5395;1290;5005;384;1574;578;2320;962;3894
230520;201306;4944;15496;4348;14430;504;1948;3033;10014;3537;11962
230523;201306;12764;44200;11953;42373;3848;15113;3664;13146;7512;28259
230526;201306;3898;12842;3490;12073;479;1841;2388;8367;2867;10208
230530;201306;4963;17218;4640;16756;670;2515;3422;12467;4092;14982
230533;201306;3688;11269;3488;10875;314;1145;2709;8373;3023;9518
230535;201306;5169;16118;4617;15082;519;1857;3383;11153;3902;13010
230540;201306;18121;54307;16471;51897;1303;4770;13477;42209;14780;46979
230550;201306;19968;62130;18464;59268;4470;15470;10151;32614;14621;48084
230560;201306;6499;19508;6044;18642;354;1413;4811;14685;5165;16098
230565;201306;3531;10545;3129;9790;297;1139;2267;6994;2564;8133
230570;201306;3846;10857;3485;10397;256;945;2871;8455;3127;9400
230580;201306;9943;31786;9637;31370;573;2007;8455;27712;9028;29719
230590;201306;9326;30960;8784;29988;863;3628;6604;22111;7467;25739
230600;201306;3532;10359;2910;9075;349;1234;1927;5944;2276;7178
230610;201306;5926;20215;5575;19641;843;3277;3992;14130;4835;17407
230620;201306;1950;5785;1698;5289;184;677;1151;3524;1335;4201
230625;201306;7097;24598;6585;23395;1869;7243;2703;9536;4572;16779
230630;201306;10613;36179;9870;34610;1978;6919;5818;21064;7796;27983
230640;201306;24626;88107;23869;86781;4113;15853;16508;60702;20621;76555
230650;201306;4818;15958;4473;15278;427;1848;3415;11437;3842;13285
230655;201306;7909;31651;7692;31289;879;3548;6262;26016;7141;29564
230660;201306;6161;20033;5496;18791;611;2465;3933;13535;4544;16000
230670;201306;5790;16454;4835;14815;319;1179;3822;11550;4141;12729
230680;201306;2871;8797;2503;8137;455;1630;1501;4880;1956;6510
230690;201306;6719;22501;6328;21809;626;2670;4530;15297;5156;17967
230700;201306;8779;26568;7852;24897;943;3664;5307;16383;6250;20047
230710;201306;7117;24381;6630;23405;881;3237;4768;17154;5649;20391
230720;201306;1903;6149;1644;5649;244;896;1096;3804;1340;4700
230725;201306;3751;12834;3598;12500;599;2380;2471;8467;3070;10847
230730;201306;55403;174070;47915;162611;12181;45026;25618;88400;37799;133426
230740;201306;4888;16609;4811;16449;372;1620;4003;13496;4375;15116
230750;201306;8665;26188;7535;24292;785;3047;5611;17948;6396;20995
230760;201306;9488;30493;9268;29980;1369;5521;6718;20627;8087;26148
230763;201306;4071;13297;3888;12945;354;1616;3012;9619;3366;11235
230765;201306;42143;142800;39919;138179;13724;50336;15078;53232;28802;103568
230770;201306;21912;64566;21078;63384;1729;6630;17202;51052;18931;57682
230780;201306;5834;23865;5620;23365;1278;5421;3210;14014;4488;19435
230790;201306;2434;8690;2349;8555;301;1186;1847;6779;2148;7965
230800;201306;7665;28820;7165;27690;1747;7436;3655;14184;5402;21620
230810;201306;12151;40863;11727;40146;1453;5327;8949;30986;10402;36313
230820;201306;3244;11472;2942;10859;662;2683;1645;6146;2307;8829
230830;201306;7573;23756;6943;22634;754;2926;5056;16375;5810;19301
230835;201306;4049;11446;3533;10783;335;1117;2773;8495;3108;9612
230837;201306;3114;10966;2726;10166;411;1737;1786;6671;2197;8408
230840;201306;9081;31255;8385;29986;1617;6076;5187;19049;6804;25125
230850;201306;11045;34788;10518;34122;1367;4960;7935;25677;9302;30637
230860;201306;4983;15415;4586;14601;440;1694;3425;10731;3865;12425
230870;201306;18499;53209;16857;50375;1975;6704;12547;37193;14522;43897
230880;201306;1892;6760;1781;6535;287;1192;1173;4312;1460;5504
230890;201306;4026;15076;3774;14561;510;2331;2696;10269;3206;12600
230900;201306;2982;10271;2655;9579;446;1745;1608;5787;2054;7532
230910;201306;2909;9086;2430;8147;290;1142;1694;5581;1984;6723
230920;201306;4495;13714;4171;13300;355;1209;3381;10935;3736;12144
230930;201306;7515;23788;6955;22752;935;3284;4886;16090;5821;19374
230940;201306;7492;21603;6739;20549;325;985;5906;18238;6231;19223
230945;201306;6180;19243;5485;18327;702;2532;3965;13392;4667;15924
230950;201306;6730;19132;5932;18078;391;1363;4712;14370;5103;15733
230960;201306;11627;38806;10908;37311;2695;10128;5312;18081;8007;28209
230970;201306;12852;42888;11940;41052;2662;10480;6296;21191;8958;31671
230980;201306;2698;9340;2545;9014;702;2573;1326;4837;2028;7410
230990;201306;1543;5066;1318;4577;176;734;838;2826;1014;3560
231000;201306;2772;7795;2296;6884;250;905;1595;4665;1845;5570
231010;201306;2836;8675;2551;8239;345;1347;1817;5756;2162;7103
231020;201306;7850;26720;7453;25902;1402;5217;4771;16843;6173;22060
231025;201306;7439;24488;6832;23478;707;2505;5236;18373;5943;20878
231030;201306;7651;26286;6623;24096;1294;4985;4034;14853;5328;19838
231040;201306;2905;10135;2676;9638;318;1371;1849;6571;2167;7942
231050;201306;11500;35131;10447;33185;1130;4094;7627;24210;8757;28304
231060;201306;2357;7668;2196;7388;219;999;1659;5399;1878;6398
231070;201306;8825;29270;8410;28480;1466;5338;5582;19051;7048;24389
231080;201306;4129;13555;3862;13036;324;1494;2873;9346;3197;10840
231085;201306;4529;15101;4385;14833;709;2668;3199;10809;3908;13477
231090;201306;4137;11883;3549;10711;249;937;2691;7997;2940;8934
231095;201306;2127;7285;1891;6819;223;876;1344;4886;1567;5762
231100;201306;3043;9655;2575;8708;248;977;1858;6247;2106;7224
231110;201306;3646;12603;3550;12431;412;1576;2626;9246;3038;10822
231120;201306;2403;8077;2244;7793;389;1416;1489;5197;1878;6613
231123;201306;2157;6216;1902;5817;148;494;1524;4676;1672;5170
231126;201306;6567;18766;5510;17305;489;1759;4324;13441;4813;15200
231130;201306;19595;63805;18175;61282;4800;17130;9621;33417;14421;50547
231135;201306;4535;13786;3906;12808;385;1480;2887;9351;3272;10831
231140;201306;15087;50752;14375;49360;1699;7701;10325;34167;12024;41868
231150;201306;5726;17454;4932;15884;1065;3777;2521;7975;3586;11752
231160;201306;5630;19982;5472;19650;1622;6023;3014;10856;4636;16879
231170;201306;4641;15267;4372;14747;550;2262;3059;10172;3609;12434
231180;201306;13695;44519;13053;43228;2696;9958;7985;25945;10681;35903
231190;201306;4863;14075;4159;13045;414;1469;3183;9900;3597;11369
231195;201306;4641;16289;4070;15183;434;1888;3070;11525;3504;13413
231200;201306;7403;26837;6840;25762;842;3779;5002;18748;5844;22527
231210;201306;4742;15604;4138;14724;359;1555;3120;11225;3479;12780
231220;201306;13749;40767;11820;37494;1354;5064;7726;24573;9080;29637
231230;201306;9283;34068;8804;33106;1281;5313;6220;23433;7501;28746
231240;201306;11365;37184;10423;35516;1449;5542;7044;24256;8493;29798
231250;201306;2039;6094;1413;4535;269;915;603;1813;872;2728
231260;201306;4017;11588;3676;11128;493;1594;2579;7970;3072;9564
231270;201306;7392;21892;6847;21064;779;3047;4983;14949;5762;17996
231280;201306;1698;5812;1642;5711;155;562;1315;4647;1470;5209
231290;201306;31837;117112;29642;111541;8193;33760;12725;47023;20918;80783
231300;201306;4342;13313;3698;11958;402;1638;2664;8321;3066;9959
231310;201306;7098;21658;6351;20157;1462;4869;3416;10835;4878;15704
231320;201306;6962;22072;6260;20737;499;1968;4802;15834;5301;17802
231325;201306;2530;8012;2315;7638;205;730;1811;6068;2016;6798
231330;201306;13773;43928;11736;39973;2039;7148;7284;25100;9323;32248
231335;201306;4894;14568;4454;13768;369;1431;3567;10792;3936;12223
231340;201306;17236;58140;16389;56918;1598;5373;13237;47231;14835;52604
231350;201306;11810;41587;11648;41329;1374;4732;9497;34394;10871;39126
231355;201306;4315;14164;4182;13952;250;828;3638;12311;3888;13139
231360;201306;6710;23069;6382;22569;1496;5208;3954;14589;5450;19797
231370;201306;2283;6822;1893;6251;142;580;1438;4654;1580;5234
231375;201306;4031;14293;3843;13930;482;2093;2873;10273;3355;12366
231380;201306;5178;17230;4889;16825;887;3285;3342;11698;4229;14983
231390;201306;3332;10867;3201;10693;214;840;2714;9112;2928;9952
231395;201306;4146;13698;3752;13082;825;3017;2282;8153;3107;11170
231400;201306;10131;31277;9360;29923;1099;4090;6641;21245;7740;25335
231410;201306;14522;49158;13252;47365;1487;5415;9925;36578;11412;41993
240010;201306;2287;7473;2137;7134;618;2296;949;3075;1567;5371
240020;201306;11492;36999;10403;34947;2957;10693;4794;16411;7751;27104
240030;201306;2715;8209;2621;8058;284;1083;1987;5947;2271;7030
240040;201306;759;2357;667;2177;83;365;472;1453;555;1818
240050;201306;3437;9888;3131;9363;263;982;2378;6945;2641;7927
240060;201306;1381;4296;1327;4203;142;553;1001;3073;1143;3626
240070;201306;2687;7932;2570;7708;383;1290;1710;5016;2093;6306
240080;201306;2939;8141;2759;7871;233;703;2254;6470;2487;7173
240090;201306;2136;6098;1865;5557;90;372;1450;4217;1540;4589
240100;201306;9864;29747;9261;28537;1293;4750;5808;17838;7101;22588
240110;201306;5006;15587;4633;14968;984;3602;2850;8906;3834;12508
240120;201306;2911;9844;2835;9704;623;2317;1754;6088;2377;8405
240130;201306;2615;7573;2294;7056;177;688;1826;5487;2003;6175
240140;201306;2198;7059;2038;6771;472;1782;1086;3545;1558;5327
240145;201306;6082;19267;5567;18359;1497;5490;3000;9877;4497;15367
240150;201306;994;3123;846;2831;136;564;482;1547;618;2111
240160;201306;1419;4790;1306;4591;159;644;914;3216;1073;3860
240165;201306;860;2873;785;2731;101;387;530;1868;631;2255
240170;201306;2531;7861;2315;7454;615;2094;1208;3977;1823;6071
240180;201306;2863;9288;2717;9046;676;2349;1520;5264;2196;7613
240185;201306;1468;4957;1423;4887;193;693;1047;3626;1240;4319
240190;201306;877;2755;849;2705;122;486;586;1807;708;2293
240200;201306;13434;36403;11577;34072;2267;6731;7460;22848;9727;29579
240210;201306;2673;7812;2490;7568;246;891;2031;6077;2277;6968
240220;201306;7299;23535;7111;23316;258;1005;6593;21605;6851;22610
240230;201306;5240;15563;4933;15005;506;1817;3777;11315;4283;13132
240240;201306;1691;5457;1336;4495;410;1481;320;987;730;2468
240250;201306;2780;8199;2640;7975;217;821;2126;6268;2343;7089
240260;201306;14390;49661;13807;48679;2460;9910;9088;31916;11548;41826
240270;201306;2287;7796;2185;7627;270;954;1626;5792;1896;6746
240280;201306;1571;4644;1407;4339;148;544;1008;3066;1156;3610
240290;201306;1420;4538;1230;4183;122;597;823;2653;945;3250
240300;201306;1965;5515;1679;5021;343;1143;917;2669;1260;3812
240310;201306;9958;29057;9254;27960;2214;7390;5073;15217;7287;22607
240320;201306;2008;6127;1734;5568;139;622;1203;3708;1342;4330
240325;201306;34896;100241;28522;89370;8559;29598;10339;32612;18898;62210
240330;201306;1503;4653;1297;4239;172;705;789;2463;961;3168
240340;201306;1552;4809;1410;4625;302;1081;879;2871;1181;3952
240350;201306;2009;6405;1919;6247;311;1173;1436;4567;1747;5740
240360;201306;6943;21809;6213;20672;1039;3770;4219;14321;5258;18091
240370;201306;1919;5406;1724;5099;136;493;1315;3881;1451;4374
240375;201306;864;2330;777;2208;146;494;445;1200;591;1694
240380;201306;2565;7806;2228;7107;356;1175;1370;4370;1726;5545
240390;201306;883;2595;740;2309;82;317;479;1474;561;1791
240400;201306;1419;3931;1256;3703;137;517;952;2739;1089;3256
240410;201306;507;1687;454;1572;86;343;272;928;358;1271
240420;201306;4820;18502;4664;18157;1342;5284;2491;10240;3833;15524
240430;201306;3386;10012;3141;9579;387;1355;2234;6718;2621;8073
240440;201306;2555;7258;2405;6968;598;1723;1266;3766;1864;5489
240450;201306;3581;11102;3347;10685;565;2135;2061;6533;2626;8668
240460;201306;2737;9313;2671;9194;316;1264;2033;6986;2349;8250
240470;201306;3754;11585;3209;10507;758;2611;1660;5563;2418;8174
240480;201306;331;903;321;893;39;106;243;694;282;800
240485;201306;2075;6357;1853;5925;289;1030;1181;3791;1470;4821
240490;201306;1631;4279;1452;4031;90;346;1166;3131;1256;3477
240500;201306;1942;6190;1900;6117;183;666;1498;4836;1681;5502
240510;201306;1752;5493;1639;5273;268;905;1128;3666;1396;4571
240520;201306;1420;4259;1260;4032;213;794;867;2713;1080;3507
240530;201306;2042;6889;1876;6608;288;1114;1276;4494;1564;5608
240540;201306;1830;5621;1745;5480;153;561;1340;4153;1493;4714
240550;201306;693;2122;665;2075;52;204;530;1618;582;1822
240560;201306;3134;9379;3011;9193;275;939;2464;7495;2739;8434
240570;201306;3052;8901;2543;7772;555;1925;1154;3254;1709;5179
240580;201306;7914;25103;7547;24512;1373;4685;5343;17360;6716;22045
240590;201306;824;2387;748;2259;57;225;543;1595;600;1820
240600;201306;1441;4421;1208;3922;217;799;663;2043;880;2842
240610;201306;5016;14228;4474;13256;461;1546;3195;9325;3656;10871
240615;201306;996;2936;877;2716;149;471;517;1612;666;2083
240620;201306;1543;5321;1474;5180;313;1177;1009;3565;1322;4742
240630;201306;1980;6262;1899;6124;169;555;1486;4935;1655;5490
240640;201306;831;2611;731;2450;95;430;480;1533;575;1963
240650;201306;3656;11562;3423;11245;317;1211;2767;9043;3084;10254
240660;201306;2362;7976;2282;7849;262;998;1742;6067;2004;7065
240670;201306;2697;8233;2350;7531;378;1422;1397;4354;1775;5776
240680;201306;1457;4361;1196;3870;154;529;741;2413;895;2942
240690;201306;1064;3090;944;2896;109;397;681;2071;790;2468
240700;201306;2583;7939;2183;7152;155;685;1663;5274;1818;5959
240710;201306;17983;45844;16072;43534;2929;8071;10228;28621;13157;36692
240720;201306;5379;15993;5157;15648;1302;4367;2945;8891;4247;13258
240725;201306;1058;3193;830;2685;94;304;461;1477;555;1781
240730;201306;2246;7086;2039;6695;214;804;1434;4641;1648;5445
240740;201306;2228;6818;2014;6429;258;908;1347;4276;1605;5184
240750;201306;2147;8145;2001;7869;450;1876;1178;4720;1628;6596
240760;201306;1172;3602;1120;3523;109;318;903;2923;1012;3241
240770;201306;3445;10337;3189;9950;452;1575;2210;6896;2662;8471
240780;201306;5338;16235;4594;14967;958;3233;2532;8606;3490;11839
240790;201306;825;2694;702;2470;70;293;523;1819;593;2112
240800;201306;38138;114000;35604;109489;10531;34786;15820;49205;26351;83991
240810;201306;91883;282988;87174;274147;29364;96000;39218;125690;68582;221690
240820;201306;6636;20252;5829;18948;949;3467;3491;11644;4440;15111
240830;201306;9044;28373;8636;27770;843;2833;6986;22848;7829;25681
240840;201306;1230;3553;1090;3297;100;373;707;2107;807;2480
240850;201306;1112;3511;870;3006;176;694;453;1475;629;2169
240860;201306;1263;3678;1105;3429;96;357;809;2458;905;2815
240870;201306;1097;3162;976;2937;132;515;671;1891;803;2406
240880;201306;1111;3885;1065;3818;157;678;736;2602;893;3280
240890;201306;5362;15383;4849;14550;813;2786;2910;8626;3723;11412
240895;201306;2715;9439;2511;9076;378;1489;1761;6416;2139;7905
240910;201306;2428;8168;2310;7947;262;1080;1760;6020;2022;7100
240920;201306;839;2774;782;2632;193;734;417;1363;610;2097
240930;201306;3496;9753;3219;9369;317;997;2540;7440;2857;8437
240933;201306;1325;4254;1221;4074;343;1211;580;2047;923;3258
240940;201306;6424;18656;5551;17167;1175;3876;3051;9437;4226;13313
240950;201306;1103;3569;1043;3465;102;426;764;2547;866;2973
240960;201306;752;2451;692;2327;115;424;478;1601;593;2025
240970;201306;1942;5717;1721;5300;153;609;1217;3710;1370;4319
240980;201306;3315;11059;3105;10649;753;2794;1805;6180;2558;8974
240990;201306;3008;9190;2843;8850;637;2216;1752;5313;2389;7529
241000;201306;1026;3016;915;2822;100;386;666;2006;766;2392
241010;201306;2861;9904;2597;9425;458;1868;1694;6064;2152;7932
241020;201306;2018;5861;1705;5265;177;669;1080;3177;1257;3846
241025;201306;1487;4666;1405;4523;149;622;979;3092;1128;3714
241030;201306;2481;8314;2301;7998;179;682;1868;6531;2047;7213
241040;201306;2030;7248;1887;6973;217;934;1425;5239;1642;6173
241050;201306;1270;3906;1173;3744;118;482;884;2728;1002;3210
241060;201306;988;2885;907;2753;125;403;681;2074;806;2477
241070;201306;907;2688;787;2458;100;391;555;1667;655;2058
241080;201306;1156;3560;1051;3376;87;365;763;2390;850;2755
241090;201306;2028;5984;1810;5609;129;545;1487;4517;1616;5062
241100;201306;1156;3546;1060;3327;106;396;750;2315;856;2711
241105;201306;1069;3339;1015;3238;135;475;707;2299;842;2774
241110;201306;835;2739;717;2487;141;555;377;1282;518;1837
241120;201306;8003;24233;7337;23177;1415;4579;4970;16070;6385;20649
241140;201306;3142;9428;2874;8883;378;1372;1948;5856;2326;7228
241142;201306;688;2115;524;1762;169;663;160;486;329;1149
241150;201306;5507;17176;5178;16622;803;2782;3591;11562;4394;14344
241160;201306;1052;3179;1012;3111;172;583;693;2122;865;2705
241170;201306;1333;3985;1221;3778;164;579;770;2469;934;3048
241180;201306;1009;2758;815;2423;102;361;494;1405;596;1766
241190;201306;1017;2892;938;2763;96;371;645;1794;741;2165
241200;201306;19588;60990;18398;59016;4957;17164;9634;31368;14591;48532
241210;201306;1437;4408;1262;4061;254;909;702;2253;956;3162
241220;201306;7852;27075;7528;26446;1829;6900;4204;15100;6033;22000
241230;201306;2900;9311;2683;8985;260;1026;2130;7119;2390;8145
241240;201306;1117;3255;867;2743;102;339;522;1665;624;2004
241250;201306;5436;17774;4912;16743;404;1807;3995;13371;4399;15178
241255;201306;1859;7200;1788;7044;432;1775;944;3876;1376;5651
241260;201306;4364;12681;3664;11503;487;1695;2430;7573;2917;9268
241270;201306;1986;6140;1798;5785;296;1098;1082;3531;1378;4629
241280;201306;2093;6194;1961;5930;391;1242;1206;3703;1597;4945
241290;201306;3197;9040;2623;8134;497;1684;1545;4752;2042;6436
241300;201306;1276;3926;1219;3841;102;381;970;3048;1072;3429
241310;201306;1465;4820;1424;4745;207;698;1049;3581;1256;4279
241320;201306;829;2827;796;2761;164;615;465;1636;629;2251
241330;201306;1480;4787;1404;4684;158;630;1129;3718;1287;4348
241335;201306;2415;7793;2358;7689;204;664;1998;6558;2202;7222
241340;201306;1900;6043;1745;5726;472;1706;874;2803;1346;4509
241350;201306;1883;6154;1785;5953;183;760;1354;4405;1537;5165
241355;201306;1190;3401;1111;3262;62;198;969;2820;1031;3018
241360;201306;2048;5810;1869;5458;161;616;1370;3817;1531;4433
241370;201306;1314;4158;1094;3701;197;787;660;2159;857;2946
241380;201306;705;2103;616;1921;91;355;337;1022;428;1377
241390;201306;2784;9615;2654;9356;745;2668;1463;5358;2208;8026
241400;201306;3584;11081;3425;10850;493;1773;2495;7919;2988;9692
241410;201306;2583;7867;2399;7598;445;1562;1629;5096;2074;6658
241415;201306;1539;4928;1429;4697;160;607;1014;3296;1174;3903
241420;201306;1959;7156;1799;6907;566;2393;869;3327;1435;5720
241430;201306;415;1280;398;1231;58;204;272;804;330;1008
241440;201306;6418;23308;6073;22689;1112;4354;4181;15813;5293;20167
241445;201306;1003;3221;957;3155;173;487;700;2463;873;2950
241450;201306;3084;9086;2960;8869;489;1666;2100;6199;2589;7865
241460;201306;3359;10069;3016;9386;299;1124;2187;6674;2486;7798
241470;201306;1316;3850;1168;3665;120;473;900;2753;1020;3226
241475;201306;1207;4001;1100;3814;90;430;816;2762;906;3192
241480;201306;3151;10424;2908;10052;953;3390;1144;4311;2097;7701
241490;201306;614;1707;508;1537;56;234;350;989;406;1223
241500;201306;744;2404;730;2383;20;75;683;2229;703;2304
250010;201306;2587;8481;2322;8036;266;1126;1646;5560;1912;6686
250020;201306;1636;4862;1290;4217;125;534;907;2886;1032;3420
250030;201306;7502;22306;6797;21302;864;2930;5032;16066;5896;18996
250040;201306;4334;15074;4049;14530;782;2984;2615;9463;3397;12447
250050;201306;3503;11451;3249;11090;539;2055;2206;7565;2745;9620
250053;201306;1231;3872;1187;3813;180;655;839;2688;1019;3343
250057;201306;772;2516;751;2488;74;259;606;2045;680;2304
250060;201306;4593;15199;4469;14992;616;2433;3398;11134;4014;13567
250070;201306;4160;13125;3930;12714;479;1970;3013;9404;3492;11374
250073;201306;764;2345;700;2227;83;311;493;1569;576;1880
250077;201306;2212;6606;1867;6032;278;970;1104;3588;1382;4558
250080;201306;4612;13783;4455;13552;619;1972;3269;10014;3888;11986
250090;201306;2557;7898;2491;7798;154;619;2106;6440;2260;7059
250100;201306;3874;13381;3715;13093;439;1750;2852;10019;3291;11769
250110;201306;5598;17576;5364;17241;899;3198;3903;12482;4802;15680
250115;201306;554;1847;484;1682;58;266;298;972;356;1238
250120;201306;2164;6537;1876;5992;211;799;1324;4158;1535;4957
250130;201306;5424;17261;5133;16843;379;1396;4274;14136;4653;15532
250135;201306;1048;3280;961;3125;116;392;691;2300;807;2692
250140;201306;1967;6648;1819;6453;258;898;1358;4970;1616;5868
250150;201306;4965;17175;4648;16585;560;2262;3501;12488;4061;14750
250153;201306;1574;4174;1426;3959;134;462;1132;3110;1266;3572
250157;201306;1580;5628;1443;5323;363;1352;786;3005;1149;4357
250160;201306;3231;10378;3104;10181;222;821;2660;8723;2882;9544
250170;201306;1581;4705;1490;4553;327;1051;919;2851;1246;3902
250180;201306;15808;51162;15441;50448;2997;11010;10133;32363;13130;43373
250190;201306;4222;12650;3971;12224;717;2449;2497;7606;3214;10055
250200;201306;2169;6073;1769;5566;146;523;1498;4670;1644;5193
250205;201306;1004;3377;881;3159;95;447;618;2192;713;2639
250210;201306;1612;5398;1494;5226;205;900;1061;3602;1266;4502
250215;201306;1378;4833;1341;4763;217;886;848;2997;1065;3883
250220;201306;802;2298;682;2154;50;179;596;1864;646;2043
250230;201306;1662;4351;1368;3872;161;569;1050;2852;1211;3421
250240;201306;2570;8520;2300;8118;272;1023;1729;6202;2001;7225
250250;201306;4227;13357;3929;12933;500;1727;3004;10025;3504;11752
250260;201306;1887;5936;1683;5599;140;527;1286;4284;1426;4811
250270;201306;1214;3986;1143;3898;161;589;854;2931;1015;3520
250280;201306;3685;11294;3430;10889;703;2339;2180;7169;2883;9508
250290;201306;2115;5655;1752;5175;59;224;1536;4524;1595;4748
250300;201306;5343;16005;5053;15627;644;2535;3921;11691;4565;14226
250310;201306;1125;3695;1034;3547;165;665;742;2514;907;3179
250320;201306;7528;24348;7172;23557;1325;4873;4512;14420;5837;19293
250330;201306;2452;7910;2151;7479;279;1104;1612;5544;1891;6648
250340;201306;1115;3324;1078;3277;75;263;880;2700;955;2963
250350;201306;4489;12497;4139;12054;200;700;3601;10577;3801;11277
250355;201306;2105;6531;1931;6258;140;590;1530;4917;1670;5507
250360;201306;2015;6075;1876;5869;123;470;1464;4587;1587;5057
250370;201306;13397;38377;11849;36486;801;2507;10330;32119;11131;34626
250375;201306;1072;3448;1026;3368;78;323;848;2764;926;3087
250380;201306;1599;4621;1530;4537;105;379;1326;3898;1431;4277
250390;201306;1921;5252;1597;4702;214;705;1080;3171;1294;3876
250400;201306;57669;173395;54911;169151;14914;47489;30146;95578;45060;143067
250403;201306;1355;4879;1329;4840;182;778;1035;3714;1217;4492
250407;201306;1055;3199;952;3021;101;324;739;2345;840;2669
250410;201306;654;2148;577;2012;72;311;429;1474;501;1785
250415;201306;1780;5788;1670;5564;107;455;1281;4188;1388;4643
250420;201306;1284;4103;1205;3977;101;416;1002;3231;1103;3647
250430;201306;6455;18400;6130;17928;507;1835;5078;14525;5585;16360
250435;201306;1602;4954;1443;4642;195;731;874;2881;1069;3612
250440;201306;4330;13464;4208;13279;309;1116;3556;11233;3865;12349
250450;201306;2040;5861;1830;5580;84;322;1634;4952;1718;5274
250460;201306;5817;18350;5455;17829;895;3092;3851;12782;4746;15874
250470;201306;1562;4370;1426;4172;133;476;1072;3084;1205;3560
250480;201306;3755;11573;3398;11041;186;751;2936;9470;3122;10221
250485;201306;590;1611;495;1439;28;120;389;1074;417;1194
250490;201306;4037;13498;3936;13338;588;2222;2945;9950;3533;12172
250500;201306;1884;5862;1749;5639;389;1322;1026;3351;1415;4673
250510;201306;4904;14048;4341;13266;353;1318;3562;10773;3915;12091
250520;201306;1831;5830;1743;5677;373;1443;1059;3339;1432;4782
250523;201306;1767;5724;1687;5619;217;782;1312;4420;1529;5202
250527;201306;1412;4449;1322;4321;65;302;1171;3763;1236;4065
250530;201306;671;2098;596;2000;55;215;482;1614;537;1829
250535;201306;1218;4074;1181;3997;102;423;943;3136;1045;3559
250540;201306;2429;7264;2285;7100;96;333;2083;6492;2179;6825
250550;201306;899;3047;833;2942;81;361;621;2140;702;2501
250560;201306;1693;5621;1661;5573;154;586;1384;4641;1538;5227
250570;201306;2505;8406;2292;7998;219;896;1739;5994;1958;6890
250580;201306;1066;3145;902;2878;137;546;603;1843;740;2389
250590;201306;1030;3211;929;3074;80;348;739;2392;819;2740
250600;201306;7469;22976;7091;22372;1210;3855;4982;16127;6192;19982
250610;201306;3237;10115;3071;9860;409;1420;2242;7239;2651;8659
250620;201306;865;2557;801;2431;135;448;538;1625;673;2073
250625;201306;2016;6868;1981;6817;84;270;1815;6309;1899;6579
250630;201306;9893;32784;9425;31913;2211;8167;5298;17846;7509;26013
250640;201306;3839;11401;3593;11108;262;1023;3100;9448;3362;10471
250650;201306;886;2694;838;2597;171;625;439;1406;610;2031
250660;201306;2178;5272;1672;4660;26;70;1600;4464;1626;4534
250670;201306;2566;9046;2456;8838;294;1238;1765;6354;2059;7592
250680;201306;4794;14178;4536;13798;316;1179;3807;11485;4123;12664
250690;201306;6011;17051;5827;16791;650;2183;4785;13534;5435;15717
250700;201306;5177;16136;4914;15723;670;2445;3605;11382;4275;13827
250710;201306;4409;14512;4112;14129;620;2266;2936;10283;3556;12549
250720;201306;2540;8222;2425;8017;242;940;1878;6200;2120;7140
250730;201306;3525;11421;3386;11195;473;1767;2526;8327;2999;10094
250740;201306;2008;6121;1771;5690;274;974;1185;3755;1459;4729
250750;201306;98362;300621;94002;293747;19090;65673;60970;188278;80060;253951
250760;201306;2102;6581;1963;6344;284;1099;1341;4267;1625;5366
250770;201306;3686;13089;3526;12856;774;2960;2165;8032;2939;10992
250780;201306;1878;5744;1663;5337;175;707;1168;3645;1343;4352
250790;201306;2430;8058;2305;7871;621;2120;1411;4931;2032;7051
250800;201306;2652;7897;2353;7390;179;676;1766;5415;1945;6091
250810;201306;1324;4024;1159;3780;119;495;939;2989;1058;3484
250820;201306;1933;6231;1881;6148;114;433;1566;5189;1680;5622
250830;201306;5711;19482;5475;19023;808;3311;3747;12778;4555;16089
250840;201306;1036;3366;934;3154;128;490;590;1991;718;2481
250850;201306;2327;6966;2045;6498;239;935;1331;4367;1570;5302
250855;201306;995;3034;940;2943;60;209;795;2479;855;2688
250860;201306;2830;9826;2651;9472;681;2685;1165;4190;1846;6875
250870;201306;1175;3457;1030;3217;92;362;745;2252;837;2614
250880;201306;1268;3880;1245;3845;118;409;1014;3094;1132;3503
250890;201306;8911;29941;8370;29218;1647;6551;5486;18993;7133;25544
250900;201306;2997;10223;2688;9626;326;1241;1901;6920;2227;8161
250905;201306;2085;6549;1997;6427;327;1118;1472;4750;1799;5868
250910;201306;5183;15602;4854;15090;665;2148;3544;11118;4209;13266
250915;201306;1689;5113;1555;4915;130;419;1311;4184;1441;4603
250920;201306;3460;10093;3268;9823;426;1340;2428;7452;2854;8792
250930;201306;1880;6260;1812;6144;380;1490;1198;3963;1578;5453
250933;201306;1114;3854;1077;3790;191;709;705;2551;896;3260
250937;201306;861;2737;781;2572;121;481;476;1559;597;2040
250939;201306;1683;5420;1540;5180;281;989;1025;3467;1306;4456
250940;201306;3892;11697;3621;11275;312;1123;2838;8828;3150;9951
250950;201306;1289;4135;1204;4029;85;292;1008;3428;1093;3720
250960;201306;1340;4268;1193;4075;76;302;1016;3489;1092;3791
250970;201306;8488;24045;7786;23149;1048;3170;5817;17572;6865;20742
250980;201306;2611;8127;2428;7818;307;1249;1686;5226;1993;6475
250990;201306;2035;7342;1931;7131;308;1298;1326;4839;1634;6137
251000;201306;2509;7277;2075;6659;138;534;1665;5318;1803;5852
251010;201306;2771;8185;2544;7875;207;745;2047;6362;2254;7107
251020;201306;1642;5266;1541;5146;169;629;1256;4216;1425;4845
251030;201306;1290;3705;1175;3512;133;470;760;2269;893;2739
251040;201306;1931;6260;1747;5970;197;922;1255;4112;1452;5034
251050;201306;1111;3362;974;3110;174;607;541;1798;715;2405
251060;201306;984;2546;815;2336;105;388;598;1626;703;2014
251065;201306;571;1732;502;1624;74;283;308;951;382;1234
251070;201306;566;1695;539;1651;46;195;426;1233;472;1428
251080;201306;20950;59257;19890;57546;5249;16133;11367;33232;16616;49365
251090;201306;2990;9604;2712;9097;324;1254;1932;6399;2256;7653
251100;201306;954;3206;845;3002;126;510;548;1893;674;2403
251110;201306;2077;6128;1917;5898;234;810;1401;4325;1635;5135
251120;201306;5872;20170;5718;19905;829;3411;4427;15080;5256;18491
251130;201306;3841;10137;3483;9725;68;250;3330;9238;3398;9488
251140;201306;4310;13564;4034;13127;287;1165;3174;10270;3461;11435
251150;201306;2829;9302;2618;9016;329;1324;1972;6841;2301;8165
251160;201306;1841;6172;1772;6080;101;396;1551;5335;1652;5731
251170;201306;1411;4507;1378;4470;105;388;1184;3823;1289;4211
251180;201306;2883;8800;2660;8519;627;2125;1600;5234;2227;7359
251190;201306;4146;12357;4028;12207;293;977;3513;10667;3806;11644
251200;201306;4173;12881;3983;12626;275;991;3423;10861;3698;11852
251203;201306;1303;4214;1185;3966;125;521;715;2484;840;3005
251207;201306;1221;3910;1061;3590;98;410;754;2507;852;2917
251210;201306;7574;22801;6939;21949;959;3032;5268;17023;6227;20055
251220;201306;1264;3512;1141;3321;181;578;716;2135;897;2713
251230;201306;5070;15770;4495;15082;473;1782;3748;12511;4221;14293
251240;201306;3068;10277;2993;10151;332;1379;2337;7781;2669;9160
251250;201306;9979;31073;9413;30156;1740;6069;6425;20442;8165;26511
251260;201306;528;1670;480;1605;39;146;365;1225;404;1371
251270;201306;4055;12742;3834;12452;182;723;3479;11255;3661;11978
251272;201306;1337;4191;1250;4062;118;413;980;3236;1098;3649
251274;201306;946;3088;903;3002;132;554;501;1702;633;2256
251275;201306;1349;3912;1277;3796;154;580;952;2735;1106;3315
251276;201306;1455;4420;1380;4272;252;835;794;2554;1046;3389
251278;201306;578;1905;509;1741;88;347;279;1000;367;1347
251280;201306;2247;7313;2177;7191;319;1180;1569;5183;1888;6363
251290;201306;5881;17282;5595;16909;853;3080;4022;11781;4875;14861
251300;201306;770;2664;721;2588;70;333;509;1772;579;2105
251310;201306;3135;9457;2891;9094;241;902;2323;7227;2564;8129
251315;201306;1585;5904;1551;5830;324;1298;975;3722;1299;5020
251320;201306;2088;5989;1769;5477;148;558;1291;4027;1439;4585
251330;201306;2016;5318;1685;4887;142;603;1379;3799;1521;4402
251335;201306;949;3358;927;3313;110;448;738;2615;848;3063
251340;201306;3927;11102;3365;10266;379;1461;2373;7054;2752;8515
251350;201306;1616;5070;1466;4849;268;975;943;3143;1211;4118
251360;201306;1817;6008;1757;5929;127;497;1488;5041;1615;5538
251365;201306;906;2694;735;2328;71;294;487;1492;558;1786
251370;201306;20588;73110;20299;72564;4316;16944;13659;48264;17975;65208
251380;201306;1286;4120;1167;3922;135;559;852;2781;987;3340
251385;201306;854;2445;789;2337;94;339;540;1546;634;1885
251390;201306;5639;20417;5381;20032;1063;4300;3625;13399;4688;17699
251392;201306;1018;3070;947;2947;131;444;643;2033;774;2477
251394;201306;613;1925;525;1753;50;212;370;1221;420;1433
251396;201306;860;2512;805;2419;69;235;639;1896;708;2131
251398;201306;1118;3291;935;2947;102;394;638;1979;740;2373
251400;201306;1345;3950;1249;3824;174;678;881;2618;1055;3296
251410;201306;1576;4249;1445;4034;188;580;965;2766;1153;3346
251420;201306;2201;6479;1899;6130;196;766;1452;4624;1648;5390
251430;201306;1665;6091;1520;5861;131;594;1239;4762;1370;5356
251440;201306;1451;4517;1269;4186;180;686;894;2907;1074;3593
251445;201306;1503;4853;1435;4749;141;560;1167;3813;1308;4373
251450;201306;4758;15129;4296;14546;166;665;3862;13105;4028;13770
251455;201306;1199;3768;1038;3505;95;412;766;2541;861;2953
251460;201306;871;2738;850;2696;160;528;624;2003;784;2531
251465;201306;502;1601;459;1515;53;213;300;961;353;1174
251470;201306;1234;3647;1033;3272;150;566;622;1968;772;2534
251480;201306;1111;3100;1012;2936;69;264;807;2294;876;2558
251490;201306;2066;6231;1814;5892;348;1293;1141;3640;1489;4933
251500;201306;1635;5738;1589;5664;231;959;1190;4175;1421;5134
251510;201306;2471;8546;2344;8268;494;1915;1400;4981;1894;6896
251520;201306;1080;3039;996;2906;137;413;618;1836;755;2249
251530;201306;11178;34503;10828;33975;1031;3968;8909;27389;9940;31357
251540;201306;2753;9324;2598;8980;312;1311;1867;6406;2179;7717
251550;201306;3935;10071;3372;9356;219;784;2811;7637;3030;8421
251560;201306;910;2764;831;2640;180;696;451;1326;631;2022
251570;201306;1022;3135;934;2982;131;494;601;1971;732;2465
251580;201306;2174;6083;2028;5887;207;587;1655;4857;1862;5444
251590;201306;1676;5616;1644;5579;114;419;1439;4924;1553;5343
251593;201306;976;3185;931;3109;136;518;625;2037;761;2555
251597;201306;1957;6131;1894;6034;239;899;1467;4584;1706;5483
251600;201306;7010;21649;6716;21164;1099;3546;4698;15267;5797;18813
251610;201306;3522;10782;3243;10408;392;1369;2417;7829;2809;9198
251615;201306;1192;3544;1053;3299;87;259;783;2585;870;2844
251620;201306;16650;48995;15052;46876;2460;8107;10653;33572;13113;41679
251630;201306;5300;13676;4668;12912;404;1219;3738;10416;4142;11635
251640;201306;2644;7856;2168;6994;281;1062;1457;4657;1738;5719
251650;201306;4298;12422;3883;11891;342;1203;3145;9733;3487;10936
251660;201306;3519;11952;3242;11519;276;1300;2615;9070;2891;10370
251670;201306;3764;11273;3409;10730;286;1028;2730;8552;3016;9580
251675;201306;737;2549;708;2499;133;551;454;1560;587;2111
251680;201306;2822;7960;2308;7187;149;633;1879;5725;2028;6358
251690;201306;3279;10716;3076;10343;473;1710;2054;6948;2527;8658
251700;201306;2055;6996;1968;6873;243;938;1535;5344;1778;6282
251710;201306;910;2468;700;2084;98;369;387;1070;485;1439
251720;201306;1324;4207;1252;4097;130;515;958;3112;1088;3627
251740;201306;726;2073;590;1826;111;384;327;1022;438;1406
260005;201306;24010;60336;21597;57206;4471;12168;13828;36986;18299;49154
260010;201306;9298;25967;7669;23960;731;2567;6126;19062;6857;21629
260020;201306;5629;17242;5074;16386;685;2093;3666;12453;4351;14546
260030;201306;5447;16683;5073;16162;608;2085;3899;12428;4507;14513
260040;201306;9448;23763;8351;22528;545;1249;7193;19951;7738;21200
260050;201306;10498;34868;9918;34205;674;2505;8678;30182;9352;32687
260060;201306;4013;11339;3766;10974;325;1004;3073;9079;3398;10083
260070;201306;9021;28280;8699;27813;2325;7959;5102;16430;7427;24389
260080;201306;5164;15495;4653;14714;568;2128;3276;10214;3844;12342
260090;201306;5131;14036;4883;13706;787;2020;3710;10823;4497;12843
260100;201306;3421;9302;3156;8951;267;981;2508;7122;2775;8103
260105;201306;4151;13061;4042;12870;771;2626;2733;8681;3504;11307
260110;201306;20735;63941;19432;62356;1652;5278;16475;53546;18127;58824
260120;201306;11023;34960;10737;34452;3128;10291;5552;18525;8680;28816
260130;201306;3017;8830;2893;8625;389;1147;2141;6510;2530;7657
260140;201306;11838;33356;10689;31867;1354;4523;8060;24211;9414;28734
260150;201306;2839;8976;2582;8575;208;786;2024;6828;2232;7614
260160;201306;5884;18031;5386;17452;506;1751;4435;14668;4941;16419
260170;201306;16774;47955;16147;47106;1447;4022;13380;39715;14827;43737
260180;201306;3316;10650;3070;10264;209;849;2575;8562;2784;9411
260190;201306;15430;38232;14743;37351;1224;3335;12368;31317;13592;34652
260200;201306;10625;32589;9453;30815;1279;4308;6706;22526;7985;26834
260210;201306;11180;35524;10428;34436;839;3132;8593;28685;9432;31817
260220;201306;8901;28757;8719;28491;766;3129;7416;23820;8182;26949
260230;201306;9501;28735;9171;28286;721;2347;7625;23862;8346;26209
260240;201306;2778;9104;2522;8708;386;1440;1713;5937;2099;7377
260250;201306;2718;7449;2509;7190;186;509;2116;6162;2302;6671
260260;201306;11184;33568;11008;33344;946;3160;9214;28478;10160;31638
260270;201306;3451;11000;3274;10741;412;1641;2551;8208;2963;9849
260280;201306;12148;42012;11300;40657;868;3527;9323;33844;10191;37371
260290;201306;32848;101592;31923;100119;5917;21158;21965;67370;27882;88528
260300;201306;8301;25853;7505;24729;802;2966;5777;19202;6579;22168
260310;201306;5054;15572;4759;15103;1452;4337;2433;8333;3885;12670
260320;201306;6490;22793;6108;22246;562;2166;4910;18166;5472;20332
260330;201306;3063;9771;2815;9339;314;1212;1879;6498;2193;7710
260340;201306;1829;5576;1754;5475;112;429;1536;4750;1648;5179
260345;201306;25097;84948;24269;83292;7732;28786;11297;37664;19029;66450
260350;201306;4159;12681;3998;12435;627;2126;2751;8622;3378;10748
260360;201306;2267;7392;2206;7290;588;2049;1243;4252;1831;6301
260370;201306;5947;18807;5526;18063;844;2806;3875;13004;4719;15810
260380;201306;4785;16232;4502;15865;416;1329;3769;13609;4185;14938
260390;201306;4697;15072;4122;14175;506;1986;3020;10260;3526;12246
260392;201306;2977;10464;2846;10275;200;795;2459;8930;2659;9725
260400;201306;13093;39990;12702;39373;2482;8645;8715;26484;11197;35129
260410;201306;60468;182478;57963;178355;18462;57112;29104;93023;47566;150135
260415;201306;3934;13253;3549;12537;572;2339;2262;8003;2834;10342
260420;201306;11084;27033;10205;26093;922;2661;8271;21136;9193;23797
260430;201306;2665;9100;2467;8790;270;1154;1906;6681;2176;7835
260440;201306;3367;10600;3172;10226;556;2046;1968;6254;2524;8300
260450;201306;4783;15338;4554;14938;544;1944;3431;11333;3975;13277
260460;201306;5783;18281;5533;17920;872;3206;3900;12434;4772;15640
260470;201306;4823;14565;4565;14208;417;1459;3657;11551;4074;13010
260480;201306;3691;11087;3427;10701;679;2289;2306;7135;2985;9424
260490;201306;6023;16022;5332;14933;756;2490;3515;9852;4271;12342
260500;201306;6600;18613;6204;18052;657;2049;4758;14121;5415;16170
260510;201306;9743;27469;9027;26467;1049;3335;6715;20387;7764;23722
260515;201306;4710;15141;3925;13547;581;2199;2325;8211;2906;10410
260520;201306;14903;41779;14618;41384;2336;6265;11153;32279;13489;38544
260530;201306;10084;30352;8985;28899;535;1647;7835;25673;8370;27320
260540;201306;5607;14853;5378;14593;666;1586;4262;11933;4928;13519
260545;201306;40;156;28;115;4;19;6;23;10;42
260550;201306;2713;9389;2475;8978;726;2907;1174;4210;1900;7117
260560;201306;6606;17414;6029;16610;365;975;5282;14629;5647;15604
260570;201306;5794;21565;5535;21086;1102;4530;3678;14177;4780;18707
260580;201306;3868;10859;3697;10605;329;1086;3076;8659;3405;9745
260590;201306;5898;15772;5721;15549;470;1206;4889;13591;5359;14797
260600;201306;23973;77838;22956;76042;5326;18422;13487;45728;18813;64150
260610;201306;6914;20943;6630;20568;1302;4239;4642;14502;5944;18741
260620;201306;16789;53592;16268;52729;2981;11063;11078;34973;14059;46036
260630;201306;2258;6967;1984;6536;253;1005;1452;4737;1705;5742
260640;201306;16853;47420;16185;46444;2012;6140;12479;35860;14491;42000
260650;201306;5554;18011;5369;17708;852;2832;3536;12484;4388;15316
260660;201306;7724;23146;7019;22198;734;2434;5552;17835;6286;20269
260670;201306;2338;6884;2010;6434;305;1094;1334;4298;1639;5392
260680;201306;22713;62282;21664;60637;4788;14294;13037;36265;17825;50559
260690;201306;3403;9710;2990;9051;306;1110;2286;6826;2592;7936
260700;201306;4989;15716;4936;15659;107;249;4733;15226;4840;15475
260710;201306;1286;4064;1165;3883;154;613;859;2799;1013;3412
260720;201306;17259;57384;16449;55871;4774;16716;8720;30306;13494;47022
260730;201306;7279;24473;6593;23467;904;3354;4920;17779;5824;21133
260740;201306;1343;4151;1182;3859;195;699;718;2380;913;3079
260750;201306;6495;22005;6362;21787;572;1946;5304;18511;5876;20457
260760;201306;4521;13037;4276;12703;573;1822;3133;9356;3706;11178
260765;201306;7488;28275;7269;27932;1719;7052;4451;17436;6170;24488
260770;201306;4215;11219;3873;10758;250;910;3121;8477;3371;9387
260775;201306;5254;15671;5045;15347;569;2053;3809;11369;4378;13422
260780;201306;3859;13191;3739;12987;849;3252;2242;7757;3091;11009
260790;201306;115792;305459;111976;299997;26882;75749;68156;183183;95038;258932
260795;201306;2943;9847;2803;9630;462;1730;1931;6733;2393;8463
260800;201306;4484;12713;4209;12334;277;1101;3571;10191;3848;11292
260805;201306;3993;12057;3666;11541;604;1977;2479;7891;3083;9868
260810;201306;7336;21708;7143;21438;512;1861;6184;18357;6696;20218
260820;201306;4489;13599;4310;13338;1251;3979;2429;7608;3680;11587
260825;201306;2990;9832;2848;9620;274;917;2357;8080;2631;8997
260830;201306;3573;11948;3361;11580;895;2933;1949;7090;2844;10023
260840;201306;4045;12219;3811;11874;242;921;3332;10332;3574;11253
260845;201306;4072;12418;3796;11861;632;2130;2590;8097;3222;10227
260850;201306;4789;17152;4419;16350;1201;4898;2157;7956;3358;12854
260860;201306;2914;9906;2735;9619;359;1278;2024;7281;2383;8559
260870;201306;4116;11712;3781;11296;561;1547;2774;8573;3335;10120
260875;201306;7199;19398;6641;18543;803;2245;4747;13687;5550;15932
260880;201306;8334;27340;7970;26799;1103;3739;6086;20791;7189;24530
260890;201306;14591;42591;14051;41804;1657;5660;10597;31453;12254;37113
260900;201306;5936;18786;5201;17574;1093;3821;3095;10732;4188;14553
260910;201306;2891;9228;2655;8893;316;1214;2055;6830;2371;8044
260915;201306;4368;14839;4267;14696;113;342;3979;13938;4092;14280
260920;201306;3272;10529;3136;10322;584;2100;2110;7067;2694;9167
260930;201306;4024;13191;3642;12641;540;1944;2607;9163;3147;11107
260940;201306;13366;39688;12355;37879;2575;9289;6783;20243;9358;29532
260950;201306;6102;20265;5895;19870;1063;4447;3890;12319;4953;16766
260960;201306;65764;187092;62667;182254;13654;42433;37549;110125;51203;152558
260970;201306;5233;17522;4907;16992;670;2707;3555;12211;4225;14918
260980;201306;3916;12678;3765;12472;267;994;3148;10600;3415;11594
260990;201306;16541;54968;15354;53295;1989;6538;11417;41691;13406;48229
261000;201306;13561;41805;12234;39594;2950;10336;6806;22192;9756;32528
261010;201306;2738;7830;2569;7598;264;615;2120;6601;2384;7216
261020;201306;6005;18699;5696;18212;408;1698;4724;14724;5132;16422
261030;201306;3184;11062;3094;10922;339;1333;2462;8629;2801;9962
261040;201306;5173;17316;4519;16293;668;2699;3161;11368;3829;14067
261050;201306;8518;24352;8059;23667;878;2709;6157;18036;7035;20745
261060;201306;10773;34588;10471;34102;2175;7656;6947;22418;9122;30074
261070;201306;46342;124367;42714;119396;10381;30608;24450;69272;34831;99880
261080;201306;5521;17520;5274;17115;444;1415;4381;14492;4825;15907
261090;201306;15621;45194;14773;44042;1472;4674;12034;36064;13506;40738
261100;201306;7106;23469;6727;22910;561;2312;5506;18655;6067;20967
261110;201306;64164;187580;59389;180899;14174;43898;34824;111972;48998;155870
261120;201306;3293;9459;3140;9251;140;431;2830;8381;2970;8812
261130;201306;6711;17959;6470;17698;284;809;5906;16145;6190;16954
261140;201306;3115;9041;2960;8813;637;2088;1862;5491;2499;7579
261150;201306;5363;16817;4886;16165;511;1916;3827;12732;4338;14648
261153;201306;1927;5652;1661;5288;111;423;1406;4512;1517;4935
261160;201306;220938;587092;212554;576067;42598;117618;138332;385456;180930;503074
261170;201306;5798;16664;5459;16158;714;2227;4240;12590;4954;14817
261180;201306;8935;26602;8781;26404;1239;3689;6870;21078;8109;24767
261190;201306;5285;17153;5071;16860;814;3557;3575;11258;4389;14815
261200;201306;3767;10040;3626;9852;490;1302;2751;7642;3241;8944
261210;201306;1838;5188;1764;5084;151;422;1495;4392;1646;4814
261220;201306;12063;40805;10885;38214;2276;8667;5931;20749;8207;29416
261230;201306;4246;12973;3970;12654;190;614;3561;11471;3751;12085
261240;201306;4761;14406;4531;13974;817;2473;3142;9895;3959;12368
261245;201306;3785;12392;3323;11617;320;1344;2448;8676;2768;10020
261247;201306;3413;11003;3048;10315;480;1693;2034;6983;2514;8676
261250;201306;18626;51161;18171;50535;2321;6729;14835;41240;17156;47969
261255;201306;4234;13466;3838;12815;413;1565;2869;9717;3282;11282
261260;201306;11675;34995;10857;34047;638;1896;9637;30674;10275;32570
261270;201306;3681;10839;3462;10490;502;1635;2428;7379;2930;9014
261280;201306;2674;8498;2438;8137;281;1090;1795;5938;2076;7028
261290;201306;2873;8458;2597;8095;220;774;2134;6715;2354;7489
261300;201306;9915;34819;9150;33451;1529;6106;6316;23279;7845;29385
261310;201306;8199;25452;7878;24895;1787;5934;4865;15432;6652;21366
261320;201306;5759;18327;5484;17804;750;2407;3967;13226;4717;15633
261330;201306;5500;16681;5390;16539;403;1380;4578;14086;4981;15466
261340;201306;4515;14992;4318;14679;747;2896;2828;9633;3575;12529
261350;201306;7760;27053;7398;26406;714;3074;5807;20525;6521;23599
261360;201306;9220;24465;8538;23520;1284;3736;5875;16501;7159;20237
261370;201306;20149;61722;19289;60494;2879;9735;14256;44909;17135;54644
261380;201306;4085;14379;3841;13985;652;2398;2633;9893;3285;12291
261390;201306;16494;52449;15283;50330;2804;10234;9523;31112;12327;41346
261400;201306;4761;17042;4387;16321;670;2782;2978;11157;3648;13939
261410;201306;7886;24531;7618;24106;831;2702;5942;19246;6773;21948
261420;201306;7502;25951;7311;25664;1903;7307;4257;15166;6160;22473
261430;201306;3501;11062;2997;10396;430;1545;2160;7667;2590;9212
261440;201306;1618;4989;1533;4859;129;520;1237;3868;1366;4388
261450;201306;13807;41578;13453;41086;1168;3784;11595;35441;12763;39225
261460;201306;8323;24308;7809;23589;828;2408;5758;18736;6586;21144
261470;201306;3859;10657;3548;10286;274;928;2982;8582;3256;9510
261480;201306;3240;12280;3071;11981;368;1650;2386;9156;2754;10806
261485;201306;4787;15358;4567;14982;1068;3739;2640;8770;3708;12509
261500;201306;5683;16203;5168;15510;783;2169;3866;12144;4649;14313
261510;201306;2016;6821;1946;6726;115;341;1708;6043;1823;6384
261520;201306;2501;8387;2284;8057;227;928;1690;5949;1917;6877
261530;201306;12304;40582;11075;38198;2569;9850;5491;18811;8060;28661
261540;201306;7026;22887;6878;22641;2112;6530;4143;14413;6255;20943
261550;201306;3252;10405;3152;10248;521;2110;2325;7215;2846;9325
261560;201306;6271;21176;5900;20715;1271;4070;4145;15332;5416;19402
261570;201306;3543;11390;3294;10984;484;1681;2337;7937;2821;9618
261580;201306;5614;18658;5078;17774;457;1805;4036;14378;4493;16183
261590;201306;2752;7918;2437;7474;251;836;1796;5597;2047;6433
261600;201306;4965;14352;4293;13359;560;1838;3102;9785;3662;11623
261610;201306;2175;6885;1974;6604;174;709;1612;5268;1786;5977
261618;201306;2461;7271;2348;7110;255;919;1837;5441;2092;6360
261620;201306;4451;13986;4248;13668;492;1716;3093;10140;3585;11856
261630;201306;7963;23997;7229;22738;1512;5471;4125;12686;5637;18157
261640;201306;32332;85585;30371;83335;1894;5414;26297;73290;28191;78704
261650;201306;3582;12190;3471;12024;456;1784;2740;9492;3196;11276
270010;201306;4422;17197;4089;16493;522;2483;2902;11657;3424;14140
270020;201306;3801;11982;3585;11620;547;2069;2576;8178;3123;10247
270030;201306;42779;132554;41266;130309;11446;37008;23731;76936;35177;113944
270040;201306;10323;32275;10029;31955;1148;3128;8354;27503;9502;30631
270050;201306;3729;11242;3529;10981;403;1569;2678;8140;3081;9709
270060;201306;1479;5229;1426;5151;372;1475;835;3017;1207;4492
270070;201306;4011;12713;3793;12398;138;618;3389;11003;3527;11621
270080;201306;1258;4103;1147;3953;276;1066;675;2299;951;3365
270090;201306;2000;6479;1955;6423;61;230;1835;6031;1896;6261
270100;201306;6289;20194;6070;19905;1209;4342;4245;13819;5454;18161
270110;201306;3369;9731;3120;9433;631;1994;1946;6289;2577;8283
270120;201306;3008;8947;2729;8559;171;646;2301;7225;2472;7871
270130;201306;4911;15618;4690;15355;720;2369;3504;11766;4224;14135
270135;201306;1683;4999;1609;4911;77;191;1471;4576;1548;4767
270140;201306;8826;24204;8055;23198;1014;4075;6208;16815;7222;20890
270150;201306;2526;8999;2463;8910;278;1156;2016;7220;2294;8376
270160;201306;4671;16637;4385;16244;324;1115;3779;14237;4103;15352
270170;201306;3954;13389;3658;12929;797;3240;2098;7351;2895;10591
270180;201306;2116;7382;1908;7117;214;932;1487;5538;1701;6470
270190;201306;1833;6243;1752;6103;204;760;1326;4684;1530;5444
270200;201306;2629;9043;2520;8864;242;1110;2042;6997;2284;8107
270210;201306;3922;14010;3831;13882;511;2085;3040;11020;3551;13105
270220;201306;1671;5355;1584;5181;310;1182;874;2911;1184;4093
270230;201306;10856;36626;9737;34915;1491;6155;6928;24681;8419;30836
270235;201306;6377;21532;6098;21072;365;1650;5233;17970;5598;19620
270240;201306;9583;29325;8665;28068;1614;5521;5715;18635;7329;24156
270250;201306;3360;9017;3125;8760;156;456;2842;7971;2998;8427
270255;201306;5039;15839;4251;14470;466;1995;3016;10109;3482;12104
270260;201306;6010;19910;5851;19621;941;3664;4119;13843;5060;17507
270270;201306;1225;3636;1153;3523;195;652;828;2505;1023;3157
270280;201306;3634;11207;3473;10970;567;2065;2503;7839;3070;9904
270290;201306;8238;29669;7911;29099;783;3190;6340;23401;7123;26591
270300;201306;3189;11195;3051;11026;192;873;2709;9731;2901;10604
270310;201306;6974;22410;6372;21375;459;2074;5106;16718;5565;18792
270320;201306;6092;20655;5905;20309;1708;6507;2838;9947;4546;16454
270330;201306;4632;15758;4420;15468;407;1521;3658;12939;4065;14460
270340;201306;1743;5558;1603;5387;232;818;1182;4054;1414;4872
270350;201306;2069;5991;1931;5811;356;1133;1222;3901;1578;5034
270360;201306;2019;6434;1993;6402;189;606;1700;5559;1889;6165
270370;201306;1692;5682;1557;5437;199;799;1080;3855;1279;4654
270375;201306;2876;9218;2749;9016;519;2089;1838;5732;2357;7821
270380;201306;5998;18562;5774;18260;623;2079;4497;14514;5120;16593
270390;201306;1380;3954;1283;3829;208;740;857;2429;1065;3169
270400;201306;6012;18935;5624;18384;535;2083;4309;13976;4844;16059
270410;201306;4765;15219;4593;14893;618;2224;3449;11167;4067;13391
270420;201306;5096;17307;4972;17125;310;1412;4312;14649;4622;16061
270430;201306;138148;407307;133498;400858;35191;108178;78675;242249;113866;350427
270440;201306;4836;15417;4593;15035;406;1532;3713;12186;4119;13718
270450;201306;6201;20195;6074;20029;718;2726;4783;15774;5501;18500
270460;201306;3354;9717;3052;9286;263;1066;2433;7189;2696;8255
270470;201306;10511;34813;10132;34133;1316;4216;7647;26802;8963;31018
270480;201306;3062;10017;2888;9722;370;1524;2033;6653;2403;8177
270490;201306;970;3156;917;3077;104;427;677;2214;781;2641
270500;201306;5403;19152;5244;18920;472;1698;4363;16154;4835;17852
270510;201306;5855;18732;5412;18109;1018;4337;3818;12095;4836;16432
270520;201306;3665;12314;3480;11991;978;3594;1851;6483;2829;10077
270530;201306;1530;4623;1360;4399;237;735;909;3092;1146;3827
270540;201306;1942;7012;1797;6779;198;953;1399;5172;1597;6125
270550;201306;6865;21706;6165;20741;1145;4008;4041;14033;5186;18041
270560;201306;2871;9489;2794;9383;545;2110;1920;6295;2465;8405
270570;201306;4184;13944;3874;13444;507;2140;2640;9066;3147;11206
270580;201306;1945;6763;1879;6647;321;1186;1361;4884;1682;6070
270590;201306;1271;4602;1201;4473;113;535;971;3578;1084;4113
270600;201306;2801;9590;2581;9270;230;1141;2014;7009;2244;8150
270610;201306;3163;10249;2988;9983;361;1284;2306;7692;2667;8976
270620;201306;1409;4914;1279;4721;165;782;958;3435;1123;4217
270630;201306;17691;50308;17027;49405;2194;6187;13457;39726;15651;45913
270640;201306;5689;18054;5233;17528;440;1885;4356;14322;4796;16207
270642;201306;2446;8492;2309;8280;406;1645;1524;5471;1930;7116
270644;201306;2262;7038;2139;6900;385;1156;1620;5410;2005;6566
270650;201306;3824;12755;3711;12594;941;3641;2167;7285;3108;10926
270660;201306;2493;6692;2033;5978;218;764;1417;4117;1635;4881
270670;201306;13604;40497;12421;38926;1590;5664;9350;29312;10940;34976
270680;201306;4053;12658;3951;12535;250;737;3532;11335;3782;12072
270690;201306;8174;24403;7858;24005;2429;7064;4271;14170;6700;21234
270700;201306;787;2553;753;2496;139;542;476;1555;615;2097
270710;201306;5312;18517;5139;18289;525;1864;4256;15411;4781;17275
270720;201306;3215;11359;3017;11016;299;1352;2392;8637;2691;9989
270730;201306;6328;20442;6027;20041;1246;4431;4079;13537;5325;17968
270740;201306;2346;7117;2219;6920;388;1386;1460;4500;1848;5886
270750;201306;4752;15696;4478;15285;580;2222;3325;11311;3905;13533
270760;201306;3211;10114;3033;9859;385;1341;2296;7488;2681;8829
270770;201306;16909;46936;14770;44336;2825;9191;9638;29287;12463;38478
270780;201306;1923;6161;1804;5974;162;575;1455;4856;1617;5431
270790;201306;1585;5120;1461;4914;385;1382;728;2498;1113;3880
270800;201306;10823;33619;10284;32905;1009;3639;8330;26596;9339;30235
270810;201306;3235;10340;2737;9418;415;1645;1713;5912;2128;7557
270820;201306;1867;6495;1735;6259;257;1114;1227;4353;1484;5467
270830;201306;4939;16634;4612;16191;1468;5828;2440;8429;3908;14257
270840;201306;7094;25508;6564;24817;528;2438;5425;20412;5953;22850
270850;201306;7326;25019;7204;24861;1559;6587;5025;16467;6584;23054
270860;201306;10897;34312;10333;33482;1858;6974;7201;22792;9059;29766
270870;201306;2197;6506;1857;5855;283;989;1153;3637;1436;4626
270880;201306;7907;26285;7559;25773;655;2666;6281;21223;6936;23889
270890;201306;2533;8009;2385;7779;410;1583;1633;5176;2043;6759
270895;201306;2957;11224;2822;11044;277;1054;2357;9430;2634;10484
270900;201306;1871;5288;1568;4851;121;473;1214;3648;1335;4121
270910;201306;3238;11764;3198;11688;361;1601;2634;9418;2995;11019
270915;201306;9672;33870;8962;32565;2147;8723;4763;17301;6910;26024
270920;201306;5814;19652;5470;19143;428;1887;4566;15861;4994;17748
270930;201306;16557;46390;13940;43053;3032;10052;7975;25104;11007;35156
270940;201306;5705;19830;5554;19646;886;3267;4131;14802;5017;18069
280010;201306;704;2104;628;1985;72;291;408;1260;480;1551
280020;201306;4728;14859;4330;14147;872;3054;2708;8852;3580;11906
280030;201306;67839;186298;62011;177731;15807;47847;33348;97027;49155;144874
280040;201306;3050;9954;2799;9623;365;1285;2099;7443;2464;8728
280050;201306;4028;13211;3786;12863;1095;3759;2139;7588;3234;11347
280060;201306;4128;14231;4005;14024;983;3782;2371;8307;3354;12089
280067;201306;7296;21432;6278;20027;648;2360;4813;15299;5461;17659
280070;201306;1781;6413;1717;6317;330;1290;1139;4241;1469;5531
280100;201306;3902;12699;3593;12150;886;3094;1956;6777;2842;9871
280110;201306;1312;4198;1226;4052;115;483;946;3084;1061;3567
280120;201306;7406;24501;6970;23789;1495;4806;4574;16636;6069;21442
280130;201306;7601;22540;7223;22002;1208;4275;4946;14804;6154;19079
280140;201306;5295;15280;4857;14717;400;1221;4075;12514;4475;13735
280150;201306;3232;10401;2987;9913;499;2007;1857;5886;2356;7893
280160;201306;1507;4401;1383;4199;185;633;987;2998;1172;3631
280170;201306;4351;13879;4018;13467;546;1891;3044;10482;3590;12373
280190;201306;1079;3235;987;3086;121;472;686;2071;807;2543
280200;201306;1004;3280;965;3232;165;699;692;2223;857;2922
280210;201306;11412;38668;11021;38028;2492;9137;6926;24244;9418;33381
280220;201306;1495;4677;1446;4613;97;369;1271;4030;1368;4399
280230;201306;3772;11246;3428;10681;746;2483;2003;6396;2749;8879
280240;201306;3347;10368;3118;10018;263;840;2502;8166;2765;9006
280250;201306;718;1992;675;1929;66;204;535;1502;601;1706
280260;201306;1898;5341;1746;5144;131;399;1485;4379;1616;4778
280270;201306;2135;6848;1886;6415;142;578;1486;4965;1628;5543
280280;201306;3937;13392;3733;13042;796;2473;2262;8686;3058;11159
280290;201306;15312;51785;14543;50467;2652;10012;10215;35481;12867;45493
280300;201306;9563;29943;9020;29325;658;2349;7873;25611;8531;27960
280310;201306;1394;4047;1261;3844;119;466;925;2737;1044;3203
280320;201306;7086;25224;6782;24648;1231;5068;4364;15841;5595;20909
280330;201306;4283;12830;4071;12558;559;1873;3107;9640;3666;11513
280340;201306;3534;11311;3444;11185;307;1090;2816;9319;3123;10409
280350;201306;20334;63050;19467;61681;3149;10317;13679;44370;16828;54687
280360;201306;5690;18447;5396;17992;1202;4554;3304;10842;4506;15396
280370;201306;1845;5468;1723;5262;217;792;1254;3711;1471;4503
280380;201306;876;2918;824;2836;139;570;598;1977;737;2547
280390;201306;3136;9566;2860;9081;712;2102;1744;5719;2456;7821
280400;201306;4264;12521;3934;12083;817;2410;2561;8227;3378;10637
280410;201306;2254;7632;2093;7363;361;1468;1278;4386;1639;5854
280420;201306;3844;11697;3632;11393;262;871;3119;9875;3381;10746
280430;201306;1920;5689;1825;5567;267;926;1324;4061;1591;4987
280440;201306;4754;14832;4519;14520;408;1469;3813;12217;4221;13686
280445;201306;2409;7085;2267;6849;127;506;1887;5606;2014;6112
280450;201306;8456;24089;7910;23459;787;2024;6638;20340;7425;22364
280460;201306;6510;18715;5927;17930;1340;4211;3779;11695;5119;15906
280470;201306;1704;5366;1574;5166;177;655;1186;3864;1363;4519
280480;201306;29420;92038;28560;90796;4824;18177;19722;60940;24546;79117
280490;201306;3622;11382;3413;10996;417;1555;2610;8353;3027;9908
280500;201306;840;2330;802;2284;40;142;692;1939;732;2081
280510;201306;2624;7950;2275;7469;311;1177;1685;5540;1996;6717
280520;201306;1595;4841;1474;4681;179;611;1082;3524;1261;4135
280530;201306;1936;6344;1852;6228;235;892;1444;4886;1679;5778
280540;201306;8445;24421;8056;23886;374;1339;7207;21231;7581;22570
280550;201306;6739;19251;6264;18505;555;2027;4780;13984;5335;16011
280560;201306;7587;23148;7238;22555;553;1946;5918;18398;6471;20344
280570;201306;6447;18802;6028;18263;885;3186;4383;13077;5268;16263
280580;201306;5536;17199;4879;16125;691;2417;3465;11622;4156;14039
280590;201306;2293;7169;2136;6987;268;1079;1612;5254;1880;6333
280600;201306;3919;12344;3688;11921;410;1635;2653;8372;3063;10007
280610;201306;2257;6781;2157;6629;377;1269;1352;4181;1729;5450
280620;201306;4559;14849;4309;14328;863;3094;2736;9112;3599;12206
280630;201306;3702;12602;3605;12458;408;1363;2875;10241;3283;11604
280640;201306;2064;6189;1952;6051;150;406;1701;5389;1851;5795
280650;201306;1053;3412;982;3277;197;714;597;2025;794;2739
280660;201306;2485;7535;2392;7379;228;823;2007;6094;2235;6917
280670;201306;15103;40965;14475;40195;1437;4283;11730;32626;13167;36909
280680;201306;2636;7253;2363;6916;192;602;1991;5824;2183;6426
280690;201306;935;2792;835;2638;124;463;560;1679;684;2142
280700;201306;1156;3496;1034;3324;87;276;796;2634;883;2910
280710;201306;9647;28098;9223;27570;577;1915;7975;23798;8552;25713
280720;201306;2404;6697;2158;6385;201;655;1706;5085;1907;5740
280730;201306;892;2760;870;2729;90;304;711;2256;801;2560
280740;201306;12141;34474;10845;32572;1718;5066;7626;23629;9344;28695
280750;201306;3460;11266;3260;10900;292;1239;2447;8057;2739;9296
280760;201306;5480;17262;5082;16747;684;2287;3829;13034;4513;15321
290010;201306;2924;6680;2154;5469;90;369;1732;4154;1822;4523
290020;201306;4797;15455;4369;15010;371;1200;3809;13319;4180;14519
290030;201306;3027;10209;2964;10083;372;1392;2279;7713;2651;9105
290035;201306;4367;12533;3996;12042;264;942;3416;10267;3680;11209
290040;201306;3510;10871;3327;10622;277;1086;2752;8656;3029;9742
290050;201306;2688;8949;2531;8707;256;992;1958;6781;2214;7773
290060;201306;1229;3302;1046;3087;82;232;905;2688;987;2920
290070;201306;28670;79057;25712;75312;5512;16911;14843;45362;20355;62273
290080;201306;5571;17786;5054;17129;622;2234;3873;13341;4495;15575
290090;201306;2297;5164;1849;4688;245;639;1485;3809;1730;4448
290100;201306;9900;29188;8679;27085;1903;5988;4780;15631;6683;21619
290110;201306;5120;15961;4971;15706;890;3052;3405;10684;4295;13736
290115;201306;4773;14945;4293;14312;351;1252;3300;11222;3651;12474
290120;201306;6474;18464;6119;18036;411;1273;5349;15867;5760;17140
290130;201306;4468;12031;4002;11477;320;832;3415;10001;3735;10833
290135;201306;4935;13312;4359;12360;469;1605;2984;8433;3453;10038
290140;201306;3594;12261;3252;11813;419;1641;2556;9347;2975;10988
290150;201306;2063;6265;2008;6176;184;617;1705;5231;1889;5848
290160;201306;3408;9740;3345;9665;376;750;2850;8619;3226;9369
290170;201306;2700;9335;2507;9012;256;1069;1977;7114;2233;8183
290180;201306;2842;8417;2607;8106;316;1108;1888;5858;2204;6966
290190;201306;4127;13827;3989;13583;445;1581;3114;10731;3559;12312
290195;201306;2113;6107;1857;5727;128;419;1510;4725;1638;5144
290200;201306;3691;12399;3432;11922;466;1753;2490;8679;2956;10432
290205;201306;2695;9009;2557;8812;435;1780;1799;6048;2234;7828
290210;201306;15226;43196;14586;42442;2493;5884;10535;33571;13028;39455
290220;201306;2242;7172;2168;7059;341;1296;1537;4891;1878;6187
290225;201306;2949;8152;2789;7976;264;594;2369;7047;2633;7641
290230;201306;2284;7771;2251;7723;257;897;1844;6426;2101;7323
290240;201306;3817;10265;3480;9806;430;1344;2551;7138;2981;8482
290250;201306;3695;12121;3157;11254;317;1223;2375;8559;2692;9782
290260;201306;4531;14536;4312;14189;505;1775;3385;11141;3890;12916
290265;201306;3251;10864;3121;10634;334;1329;2385;8096;2719;9425
290270;201306;11383;43569;10811;42749;1268;5560;8490;33828;9758;39388
290280;201306;4852;16723;4647;16306;732;2698;3135;11294;3867;13992
290290;201306;9377;31008;8690;29887;1638;5959;5790;20238;7428;26197
290300;201306;4309;12549;3466;11115;325;1061;2547;8386;2872;9447
290310;201306;1499;4684;1437;4612;217;813;1064;3350;1281;4163
290320;201306;23310;77141;21807;75045;4900;17810;13711;48065;18611;65875
290323;201306;3909;10956;3249;10262;210;769;2783;8783;2993;9552
290327;201306;3868;12822;3651;12368;524;1882;2560;8706;3084;10588
290330;201306;1811;5005;1743;4928;289;920;1337;3704;1626;4624
290340;201306;5463;17718;5141;17247;1273;4364;2940;10197;4213;14561
290350;201306;4811;15049;3984;13909;515;1844;2889;10364;3404;12208
290360;201306;3981;12971;3710;12629;231;822;3268;11262;3499;12084
290370;201306;4441;13810;4135;13361;573;1881;3219;10543;3792;12424
290380;201306;5299;16226;4796;15570;406;1472;4009;13030;4415;14502
290390;201306;14458;49012;13960;48178;2907;9747;9183;33306;12090;43053
290395;201306;2699;9000;2461;8609;258;1100;1844;6452;2102;7552
290400;201306;3379;11391;3098;10989;425;1557;2310;8372;2735;9929
290405;201306;4178;13825;3694;13005;537;1964;2460;8919;2997;10883
290410;201306;5792;18023;5012;16878;574;2468;3731;12212;4305;14680
290420;201306;3068;9599;2645;8983;270;1100;2026;6813;2296;7913
290430;201306;3314;10935;3058;10583;638;2194;1994;7177;2632;9371
290440;201306;2742;7802;2346;7306;219;760;1946;6094;2165;6854
290450;201306;3426;10368;3141;9968;689;2103;1968;6542;2657;8645
290460;201306;12579;40782;11993;39785;3121;11052;6447;21240;9568;32292
290470;201306;4567;13420;3717;12354;880;3306;2032;6815;2912;10121
290475;201306;5003;18166;4585;17417;559;2256;3353;12956;3912;15212
290480;201306;2566;6850;2306;6505;391;1222;1568;4436;1959;5658
290485;201306;4359;14917;4121;14567;484;2152;3151;11048;3635;13200
290490;201306;7284;21056;7098;20809;950;3008;5575;16366;6525;19374
290500;201306;4515;14806;3950;13831;741;2784;2218;7833;2959;10617
290510;201306;3370;10108;2981;9534;263;1013;2356;7509;2619;8522
290515;201306;2612;8582;2531;8420;144;471;2089;7139;2233;7610
290520;201306;11531;36847;9640;33310;1339;5404;6165;21182;7504;26586
290530;201306;5114;15243;4429;14260;376;1332;3596;11601;3972;12933
290540;201306;3918;11445;3756;11227;515;1500;2837;8704;3352;10204
290550;201306;4127;11343;3672;10764;274;787;3078;9113;3352;9900
290560;201306;6767;20078;5939;18964;1419;4744;3433;11202;4852;15946
290570;201306;37450;114000;35311;110697;4846;16432;26105;81634;30951;98066
290580;201306;7219;26170;6969;25785;1202;4471;5089;19340;6291;23811
290590;201306;7199;23860;6222;22330;471;2023;5067;18141;5538;20164
290600;201306;17676;56724;16810;55385;2437;8180;11912;40418;14349;48598
290610;201306;2271;8196;1966;7597;216;1027;1484;5636;1700;6663
290620;201306;7131;21647;6458;20687;546;1881;5400;17330;5946;19211
290630;201306;7974;22430;7150;21546;795;2372;5828;17812;6623;20184
290640;201306;2677;8035;2253;7291;259;902;1596;5185;1855;6087
290650;201306;11445;34973;10783;33952;3323;10521;5703;18792;9026;29313
290660;201306;3620;10511;3053;9691;219;802;2432;7756;2651;8558
290670;201306;6229;20462;5758;19723;842;2687;4404;15757;5246;18444
290680;201306;9946;30260;9395;29614;563;1733;8255;26388;8818;28121
290682;201306;4093;12903;3779;12461;233;936;3153;10366;3386;11302
290685;201306;3118;8383;2447;7447;306;1042;1577;4868;1883;5910
290687;201306;8215;22649;6739;20918;1060;3594;4556;14366;5616;17960
290689;201306;3075;8899;2612;8144;269;908;2007;6291;2276;7199
290690;201306;5106;15613;4740;15104;634;2244;3593;11456;4227;13700
290700;201306;2181;7070;2101;6951;247;878;1602;5353;1849;6231
290710;201306;7397;24735;6953;24032;408;1392;6144;21488;6552;22880
290720;201306;16998;52631;15421;50658;2454;7419;11615;39732;14069;47151
290730;201306;7184;20593;6639;19899;1348;3895;4307;13489;5655;17384
290740;201306;975;3026;849;2817;173;553;487;1720;660;2273
290750;201306;8825;27634;8206;26480;1707;6451;4946;15046;6653;21497
290755;201306;2373;6965;2045;6419;138;552;1673;5187;1811;5739
290760;201306;4382;13333;3699;12394;376;1308;2846;9626;3222;10934
290770;201306;2511;8889;2361;8692;157;646;1999;7405;2156;8051
290780;201306;8435;23294;7707;22317;1030;2787;5758;17184;6788;19971
290790;201306;4290;13630;4066;13340;511;1606;3125;10702;3636;12308
290800;201306;7007;16229;5470;14594;1121;2804;3792;10593;4913;13397
290810;201306;4685;15613;4240;14960;368;1381;3310;11891;3678;13272
290820;201306;5201;15619;4703;14910;637;2271;3408;10809;4045;13080
290830;201306;4071;12740;3938;12490;535;2097;2806;8665;3341;10762
290840;201306;16814;48891;15807;47511;2358;6836;11486;35906;13844;42742
290850;201306;6537;20244;6405;20044;1634;5056;4076;13200;5710;18256
290860;201306;4613;17186;4450;16965;725;2739;3258;12823;3983;15562
290870;201306;4595;14561;3898;13642;440;1813;2962;10331;3402;12144
290880;201306;1361;3907;1121;3522;121;396;756;2425;877;2821
290890;201306;6068;17585;5876;17330;597;1862;4829;14268;5426;16130
290900;201306;2341;7058;1802;6192;309;1216;950;3216;1259;4432
290910;201306;4620;13447;4042;12617;360;1229;3252;10171;3612;11400
290920;201306;4620;14276;4239;13769;320;939;3560;11796;3880;12735
290930;201306;7087;23589;6642;22855;763;3007;4912;16707;5675;19714
290940;201306;3288;10964;3118;10740;268;1013;2645;9207;2913;10220
290950;201306;1564;4574;1484;4469;224;732;1088;3252;1312;3984
290960;201306;5617;16926;5200;16367;411;1340;4202;13435;4613;14775
290970;201306;3686;12279;3465;11895;523;1868;2310;8160;2833;10028
290980;201306;10259;32469;9395;30723;2776;9644;4154;13522;6930;23166
290990;201306;8973;27565;8310;26530;947;3200;6494;20827;7441;24027
291000;201306;2809;9318;2686;9155;455;1503;1967;6970;2422;8473
291005;201306;11152;34512;10504;33508;2107;7219;6894;22151;9001;29370
291010;201306;2851;9993;2472;9113;507;1995;1309;4870;1816;6865
291020;201306;1325;3712;1047;3190;135;516;605;1786;740;2302
291030;201306;2024;5941;1727;5315;188;646;1151;3498;1339;4144
291040;201306;5101;17016;4853;16636;698;2588;3535;12158;4233;14746
291050;201306;7786;26713;7241;25698;1901;7265;3926;13989;5827;21254
291060;201306;6048;23048;5817;22771;796;3532;4490;17542;5286;21074
291070;201306;15281;46982;14292;45516;1963;5856;10746;35365;12709;41221
291072;201306;18023;59574;16217;56045;6344;23221;5261;19360;11605;42581
291075;201306;4989;15135;4575;14560;334;1077;3610;11696;3944;12773
291077;201306;1466;4483;1272;4186;146;589;882;2835;1028;3424
291080;201306;79310;246866;73192;237184;18630;63885;38032;123087;56662;186972
291085;201306;5395;15213;4769;14368;608;1958;3656;11045;4264;13003
291090;201306;1207;3454;1070;3245;172;730;711;1974;883;2704
291100;201306;2637;7272;2237;6848;130;527;1932;5864;2062;6391
291110;201306;4811;17818;4387;17146;567;2530;3223;12543;3790;15073
291120;201306;7306;20083;6936;19556;1019;3031;5154;14560;6173;17591
291125;201306;1627;3749;1346;3453;132;321;1057;2840;1189;3161
291130;201306;2945;9166;2598;8584;270;1044;1859;6106;2129;7150
291140;201306;3925;12204;3748;11896;555;1879;2723;8664;3278;10543
291150;201306;1955;5258;1888;5178;188;549;1504;4090;1692;4639
291160;201306;5398;16837;4818;15988;1131;3939;2933;9742;4064;13681
291165;201306;2236;7095;1953;6543;190;800;1398;4565;1588;5365
291170;201306;19986;52841;17620;50004;1410;4807;14275;40234;15685;45041
291180;201306;6171;17031;5216;15730;575;1968;4048;12112;4623;14080
291185;201306;3540;10361;3401;10182;236;842;2923;8666;3159;9508
291190;201306;7324;21295;6684;20550;909;2664;4996;16063;5905;18727
291200;201306;3023;9455;2666;8884;369;1436;1900;6274;2269;7710
291210;201306;7446;18222;6657;17364;702;1930;5170;13624;5872;15554
291220;201306;3884;12832;3710;12529;596;2293;2611;8715;3207;11008
291230;201306;3700;10113;3335;9666;224;675;2875;8393;3099;9068
291240;201306;4609;13071;3968;11946;327;1043;3070;9165;3397;10208
291250;201306;3655;11256;2943;10090;315;1129;2121;7379;2436;8508
291260;201306;1150;3515;1102;3455;105;371;893;2793;998;3164
291270;201306;4658;15792;4451;15482;297;1160;3747;13089;4044;14249
291280;201306;2315;5979;1779;5373;533;1556;1029;3245;1562;4801
291290;201306;5761;17066;5331;16546;558;1700;4171;13280;4729;14980
291300;201306;4343;13358;3647;12180;470;1743;2529;8463;2999;10206
291310;201306;5132;15330;4607;14492;455;1539;3527;11114;3982;12653
291320;201306;5397;18576;4919;17632;1406;5440;2382;8467;3788;13907
291330;201306;1558;4934;1469;4772;222;847;927;2873;1149;3720
291340;201306;3707;11441;3024;10463;406;1613;2254;7715;2660;9328
291345;201306;3278;11368;3159;11238;243;917;2759;9912;3002;10829
291350;201306;5941;18081;5355;17190;709;2377;3563;11758;4272;14135
291360;201306;35515;105952;33478;102948;7924;24339;21504;68316;29428;92655
291370;201306;8828;27215;8509;26803;1375;4006;6192;20451;7567;24457
291380;201306;3620;11559;3272;10984;323;1131;2367;8164;2690;9295
291390;201306;10042;29149;9248;28233;1257;3864;7159;22144;8416;26008
291400;201306;16270;44162;13421;40370;1987;6217;8984;27985;10971;34202
291410;201306;3172;8446;2366;7258;211;870;1751;5168;1962;6038
291420;201306;2189;5888;2004;5665;127;319;1808;5189;1935;5508
291430;201306;3279;9966;2927;9502;270;1047;2290;7379;2560;8426
291440;201306;5590;18622;4808;17134;602;2278;3556;12867;4158;15145
291450;201306;7045;22652;6733;22106;489;1565;5462;18345;5951;19910
291460;201306;12055;38562;10931;36924;2675;9395;6520;22460;9195;31855
291465;201306;7323;22621;6829;22063;1005;3494;5216;16989;6221;20483
291470;201306;15078;43579;13631;41799;1164;3627;10998;34667;12162;38294
291480;201306;33128;93212;29803;88515;5683;18436;18922;56111;24605;74547
291490;201306;3989;14205;3930;14114;532;1943;3148;11436;3680;13379
291500;201306;4073;12202;3610;11568;306;1066;2914;9384;3220;10450
291510;201306;3306;10670;3145;10441;173;625;2815;9394;2988;10019
291520;201306;3938;11388;3567;10878;648;1857;2368;7743;3016;9600
291530;201306;2022;6258;1759;5854;508;1796;870;3004;1378;4800
291535;201306;4238;12776;3876;12251;417;1388;2896;9536;3313;10924
291540;201306;2189;5555;1905;5258;156;403;1616;4562;1772;4965
291550;201306;5491;15601;5003;14912;1233;3965;2813;8456;4046;12421
291560;201306;16013;43601;12966;40076;1814;5727;9441;29978;11255;35705
291570;201306;2238;6283;2188;6215;95;243;2025;5799;2120;6042
291580;201306;5706;18069;5112;17111;867;3495;3227;10612;4094;14107
291590;201306;1898;6157;1705;5830;355;1397;1030;3564;1385;4961
291600;201306;5369;15395;4025;13518;1044;3797;2008;6698;3052;10495
291610;201306;5111;14866;4960;14640;539;1877;3964;11450;4503;13327
291620;201306;2955;7184;2501;6694;213;571;1988;5485;2201;6056
291630;201306;3160;8159;2836;7792;256;663;2428;6825;2684;7488
291640;201306;16558;47456;14223;44486;4031;13839;6478;20366;10509;34205
291650;201306;7860;24002;7316;23368;625;1612;6202;20588;6827;22200
291660;201306;2375;6499;2138;6184;265;889;1528;4342;1793;5231
291670;201306;2487;7164;2301;6857;385;1208;1304;4203;1689;5411
291680;201306;4904;14384;4493;13753;1198;4125;2133;6812;3331;10937
291685;201306;4086;11230;3712;10776;228;691;3164;9404;3392;10095
291690;201306;3907;11027;3256;9993;336;1088;2254;6964;2590;8052
291700;201306;9033;29705;8516;28846;951;3395;6547;22517;7498;25912
291710;201306;5635;15635;4973;14727;1362;4388;2342;7248;3704;11636
291720;201306;3541;12958;3382;12620;403;1698;2539;9354;2942;11052
291730;201306;5607;18833;5283;18403;1394;4899;3166;11480;4560;16379
291733;201306;2443;7684;2170;7312;258;979;1526;5181;1784;6160
291735;201306;2075;6381;1847;6029;112;449;1575;5067;1687;5516
291740;201306;3903;11590;3120;10383;327;1283;2206;7308;2533;8591
291750;201306;21080;57836;17337;52430;3876;12134;9818;30285;13694;42419
291760;201306;11825;38823;11205;37725;3794;13720;5372;18472;9166;32192
291770;201306;7773;23110;7260;22260;1121;3736;5009;15259;6130;18995
291780;201306;4191;13396;4057;13158;592;1854;3081;10158;3673;12012
291790;201306;2339;7787;2236;7650;206;816;1831;6250;2037;7066
291800;201306;29803;90928;27515;87651;6481;21427;16622;54407;23103;75834
291810;201306;10098;30543;8949;29212;710;2500;7309;24218;8019;26718
291820;201306;3482;10872;3246;10544;391;1262;2494;8241;2885;9503
291830;201306;4243;11878;3991;11496;590;1890;2961;8466;3551;10356
291835;201306;5990;19184;5127;17820;1080;4072;3344;11602;4424;15674
291840;201306;45228;129875;39665;124015;4968;15530;31678;101130;36646;116660
291845;201306;2976;8899;2699;8600;210;627;2384;7704;2594;8331
291850;201306;4796;13822;4118;12908;431;1324;3256;10490;3687;11814
291855;201306;1857;5087;1642;4827;289;996;1143;3288;1432;4284
291860;201306;1862;5800;1719;5562;201;745;1158;3726;1359;4471
291870;201306;1313;3713;1070;3279;110;422;728;2199;838;2621
291875;201306;2716;9190;2539;8899;267;1117;1886;6517;2153;7634
291880;201306;4408;14342;4277;14154;293;988;3738;12500;4031;13488
291890;201306;1416;3648;1212;3398;167;497;877;2477;1044;2974
291900;201306;1243;3733;1125;3553;115;411;850;2657;965;3068
291905;201306;2827;7822;2425;7182;262;876;1678;5064;1940;5940
291910;201306;2421;6924;2207;6646;188;709;1795;5281;1983;5990
291915;201306;6453;20750;5894;19616;518;1813;4910;16525;5428;18338
291920;201306;32054;94967;29887;91833;5883;18310;19199;60900;25082;79210
291930;201306;2428;7551;2250;7303;241;800;1774;5877;2015;6677
291940;201306;3512;10278;2714;8880;412;1589;1697;5391;2109;6980
291950;201306;8938;31372;8206;30181;2162;8120;4423;16694;6585;24814
291955;201306;7292;24648;7182;24492;1449;5011;4944;17189;6393;22200
291960;201306;3291;10095;2878;9539;363;1158;2047;7157;2410;8315
291970;201306;4309;13212;3864;12682;628;2114;2710;9128;3338;11242
291980;201306;11142;33114;8807;29813;1062;3783;6325;21870;7387;25653
291990;201306;2067;7011;1931;6806;218;793;1410;5127;1628;5920
291992;201306;2729;8597;2676;8485;501;1645;1903;6027;2404;7672
291995;201306;2045;6256;1873;6027;221;742;1455;4754;1676;5496
292000;201306;2205;6812;2030;6542;552;1931;1129;3582;1681;5513
292010;201306;5964;16021;4673;14058;425;1404;3606;10842;4031;12246
292020;201306;4415;15450;4077;14879;573;2269;2994;11085;3567;13354
292030;201306;2102;6902;1921;6640;262;988;1310;4611;1572;5599
292040;201306;4430;12850;4039;12428;339;1026;3411;10816;3750;11842
292045;201306;2264;8441;2238;8396;123;414;2048;7757;2171;8171
292050;201306;5911;19390;5465;18514;636;2610;3884;12946;4520;15556
292060;201306;10589;30615;10237;30142;938;2925;8553;25134;9491;28059
292070;201306;4203;13818;4107;13695;404;1200;3544;12062;3948;13262
292080;201306;3565;9782;3135;9195;310;937;2526;7486;2836;8423
292090;201306;4185;11558;3640;10937;378;1300;2913;8750;3291;10050
292100;201306;10367;30199;9230;28784;2399;7833;5583;17738;7982;25571
292105;201306;3108;9704;2734;9180;222;905;2178;7261;2400;8166
292110;201306;6892;18621;5341;16433;1101;3613;3211;10083;4312;13696
292120;201306;8214;24261;7375;22946;1517;4929;4408;14049;5925;18978
292130;201306;3183;8683;2949;8381;389;914;2290;6816;2679;7730
292140;201306;5266;14297;4714;13553;526;1586;3418;10074;3944;11660
292145;201306;2633;8311;2427;7987;221;717;1831;6297;2052;7014
292150;201306;13222;41219;12387;39872;910;3454;9791;31674;10701;35128
292160;201306;2575;7677;2223;7193;201;612;1799;6014;2000;6626
292170;201306;8477;26291;7415;24470;1105;4048;4811;16099;5916;20147
292180;201306;3428;10520;2890;9705;336;1216;2087;7123;2423;8339
292190;201306;3075;8880;2733;8400;570;1940;1764;5399;2334;7339
292200;201306;5104;18084;4695;17149;1601;6210;1738;6392;3339;12602
292205;201306;3951;12535;3667;12154;304;1156;2903;9619;3207;10775
292210;201306;6368;19234;5668;18263;594;1998;4416;14603;5010;16601
292220;201306;1886;5578;1797;5447;360;1105;1178;3564;1538;4669
292225;201306;2816;9264;2605;8935;223;808;2081;7246;2304;8054
292230;201306;5999;18508;5762;18133;702;2641;4382;13486;5084;16127
292240;201306;4168;13820;3915;13235;622;2232;2433;8242;3055;10474
292250;201306;5244;16372;4955;15809;1043;3465;2795;9022;3838;12487
292260;201306;2863;9553;2757;9376;342;1246;2091;7111;2433;8357
292265;201306;2980;10237;2794;9876;252;1036;2107;7432;2359;8468
292270;201306;3703;10620;3042;9842;278;1115;2444;7888;2722;9003
292273;201306;2712;6722;2101;5937;321;882;1463;4324;1784;5206
292275;201306;1872;4958;1762;4801;225;701;1330;3590;1555;4291
292280;201306;2007;6229;1874;6089;199;564;1480;5104;1679;5668
292285;201306;2415;7107;2169;6749;336;1117;1463;4715;1799;5832
292290;201306;7338;22729;6281;21389;267;1007;5422;18874;5689;19881
292300;201306;8094;25755;7198;24786;2381;8256;3999;14348;6380;22604
292303;201306;2694;8868;2546;8646;101;407;2229;7585;2330;7992
292305;201306;3065;8605;2909;8395;113;351;2616;7577;2729;7928
292310;201306;5809;18543;5365;17948;380;1299;4574;15491;4954;16790
292320;201306;5549;17848;5202;17235;598;2337;3951;12956;4549;15293
292330;201306;1835;5645;1735;5528;287;1004;1237;3900;1524;4904
292335;201306;5036;13810;4665;13310;402;1165;3926;11287;4328;12452
292340;201306;6277;18805;5563;17727;520;1810;4213;13457;4733;15267
292350;201306;2016;6533;1908;6403;206;785;1517;5095;1723;5880
292360;201306;4727;14406;4587;13915;200;616;4001;12423;4201;13039
292370;201306;8043;26323;7389;25346;955;3147;5286;19176;6241;22323
292380;201306;7103;21181;6759;20676;555;1614;5671;17563;6226;19177
292390;201306;3494;8183;3115;7773;106;214;2921;7361;3027;7575
292400;201306;21635;65201;20753;63781;3104;10094;14744;46276;17848;56370
292405;201306;4294;11907;3791;11297;291;878;3191;9652;3482;10530
292410;201306;1631;4899;1594;4855;120;452;1397;4187;1517;4639
292420;201306;3558;11795;3441;11661;212;590;3084;10733;3296;11323
292430;201306;5083;16787;4419;15944;336;1365;3514;12740;3850;14105
292440;201306;8342;27830;7875;27176;311;1209;7021;24558;7332;25767
292450;201306;4150;12830;3452;11710;353;1346;2459;8428;2812;9774
292460;201306;5534;17081;4981;16070;875;2980;3238;10529;4113;13509
292465;201306;2259;7160;1978;6705;249;981;1435;4877;1684;5858
292467;201306;2152;7171;2049;6994;450;1675;1281;4392;1731;6067
292470;201306;3128;8619;2650;7861;240;856;2004;5845;2244;6701
292480;201306;5551;16185;4823;15126;406;1439;3893;12288;4299;13727
292490;201306;2188;6472;1914;6063;228;859;1408;4410;1636;5269
292500;201306;6407;19888;5656;18582;603;2299;4143;13697;4746;15996
292510;201306;12699;37753;11439;35960;1153;4040;8977;28540;10130;32580
292520;201306;5505;17502;5153;16862;1555;5209;2540;8422;4095;13631
292525;201306;5355;14507;4748;13798;464;1475;3774;11062;4238;12537
292530;201306;23917;73738;22184;71751;4202;14008;15401;51321;19603;65329
292540;201306;2645;8260;2441;7953;624;2170;1442;4755;2066;6925
292550;201306;5921;20356;5436;19572;1024;3870;3558;13105;4582;16975
292560;201306;4148;11759;3579;11016;314;1167;2898;8785;3212;9952
292570;201306;3815;11680;3748;11609;146;465;3267;10456;3413;10921
292575;201306;5775;20289;5640;20012;1234;4482;3684;13125;4918;17607
292580;201306;6787;20995;6364;20454;567;1883;5266;17095;5833;18978
292590;201306;6957;22976;6729;22567;1096;3620;4695;16123;5791;19743
292593;201306;3164;8600;2728;7959;257;779;2103;6131;2360;6910
292595;201306;5432;16390;4949;15736;490;1710;3808;12124;4298;13834
292600;201306;10057;29375;9631;28846;1403;3284;7663;24189;9066;27473
292610;201306;4253;12618;3593;11507;619;2108;2212;7207;2831;9315
292620;201306;5700;18127;5107;17433;351;1310;4541;15582;4892;16892
292630;201306;9738;25110;8604;23451;697;2065;6731;18517;7428;20582
292640;201306;8185;26942;7276;25746;678;2465;5721;20753;6399;23218
292650;201306;4566;13179;4424;13009;501;1130;3551;11160;4052;12290
292660;201306;10776;33894;10400;33323;1547;4934;7648;25156;9195;30090
292665;201306;2831;8626;2764;8522;97;272;2594;8064;2691;8336
292670;201306;3755;10973;3013;9722;374;1381;2002;6486;2376;7867
292680;201306;3464;10791;3329;10610;244;865;2847;9008;3091;9873
292690;201306;3296;9229;2453;7944;325;1164;1670;5492;1995;6656
292700;201306;8626;27533;7762;26339;1005;3264;5867;20727;6872;23991
292710;201306;1876;6281;1812;6184;113;415;1589;5451;1702;5866
292720;201306;9264;24828;8289;23710;820;2446;6822;19714;7642;22160
292730;201306;3235;10176;3147;10030;620;1896;2075;6871;2695;8767
292740;201306;339805;991263;325295;969629;80047;251840;194770;583280;274817;835120
292750;201306;5627;16062;5189;15490;415;1222;4230;12932;4645;14154
292760;201306;4183;13732;3875;13171;571;2143;2602;8939;3173;11082
292770;201306;5757;18301;5487;17883;1397;4589;3195;10837;4592;15426
292780;201306;1758;4643;1430;4251;225;786;1013;2960;1238;3746
292790;201306;3024;8712;2933;8609;255;663;2432;7466;2687;8129
292800;201306;9183;28464;8666;27622;958;3298;6708;21441;7666;24739
292805;201306;2987;9268;2797;8985;536;1881;1903;6193;2439;8074
292810;201306;9390;30036;8236;28501;1262;4496;6091;21592;7353;26088
292820;201306;7119;21104;5338;18599;446;1741;4355;15258;4801;16999
292830;201306;1817;5552;1668;5351;133;535;1353;4296;1486;4831
292840;201306;6228;22430;5792;21814;545;2048;4760;18266;5305;20314
292850;201306;2972;8247;2626;7734;398;1233;1806;5285;2204;6518
292860;201306;14764;41383;14308;40823;2017;5723;11148;32359;13165;38082
292870;201306;17738;51571;16084;48869;3100;10569;9613;28620;12713;39189
292880;201306;11395;35183;10427;33605;2045;6792;6546;21402;8591;28194
292890;201306;5255;18787;4810;17913;1054;4077;2714;10429;3768;14506
292895;201306;2643;6997;2258;6427;320;979;1689;4771;2009;5750
292900;201306;3012;9581;2847;9311;476;1824;1865;5872;2341;7696
292905;201306;3884;12098;3295;11325;374;1180;2634;9382;3008;10562
292910;201306;4876;15662;4582;15119;812;2856;2996;9856;3808;12712
292920;201306;7562;23191;7243;22709;698;2488;5828;18056;6526;20544
292925;201306;4933;16032;4436;15359;384;1441;3563;12422;3947;13863
292930;201306;6272;20711;6025;20248;896;3652;4307;14096;5203;17748
292935;201306;2044;5962;1755;5639;203;609;1367;4594;1570;5203
292937;201306;3236;8545;2799;7987;343;1103;2110;5943;2453;7046
292940;201306;2990;8554;2423;7772;297;965;1642;5494;1939;6459
292950;201306;7987;25000;7684;24492;1093;4082;5492;17051;6585;21133
292960;201306;4412;12894;4169;12524;505;1658;2989;8905;3494;10563
292970;201306;4079;13202;3805;12850;211;880;3225;10893;3436;11773
292975;201306;3020;8857;2934;8709;341;1079;2350;6984;2691;8063
292980;201306;3473;10137;2881;9426;411;1625;2006;6494;2417;8119
292990;201306;11643;34382;10973;33407;797;2534;9432;28881;10229;31415
293000;201306;2850;7836;2394;7243;144;516;2061;6205;2205;6721
293010;201306;16947;51227;15692;49116;3266;11130;9646;30068;12912;41198
293015;201306;7608;25836;6231;23832;1096;4529;4125;15740;5221;20269
293020;201306;9223;31096;8660;30275;658;2609;7152;25264;7810;27873
293030;201306;5393;16281;4437;14874;513;1864;3067;10623;3580;12487
293040;201306;3591;11793;3470;11660;258;936;2997;10090;3255;11026
293050;201306;18461;54584;16647;52182;2547;8142;11545;37198;14092;45340
293060;201306;4225;11056;3641;10129;428;1299;2528;6992;2956;8291
293070;201306;18560;58958;17705;57479;4923;16704;9774;32153;14697;48857
293075;201306;3520;11242;3221;10897;228;820;2803;9562;3031;10382
293076;201306;3644;10584;3434;10267;310;872;2859;8737;3169;9609
293077;201306;5129;16097;4486;15285;721;2620;3140;10775;3861;13395
293080;201306;4697;15215;4346;14617;364;1570;3405;11204;3769;12774
293090;201306;3534;11254;2942;10440;296;1115;2314;8325;2610;9440
293100;201306;5515;17450;4801;16200;489;1798;3634;12448;4123;14246
293105;201306;3728;12854;3338;12088;508;1972;2281;8364;2789;10336
293110;201306;1928;5878;1839;5735;113;420;1558;4854;1671;5274
293120;201306;3898;13472;3660;13138;359;1324;2921;10640;3280;11964
293130;201306;3851;11491;3166;10722;202;785;2756;9459;2958;10244
293135;201306;23960;68528;20214;63498;4032;15124;11197;34295;15229;49419
293140;201306;2006;6245;1954;6164;201;833;1522;4647;1723;5480
293150;201306;5761;19204;5288;18304;1048;3703;3234;11561;4282;15264
293160;201306;2951;8960;2803;8779;441;1111;2123;7010;2564;8121
293170;201306;3329;10464;3148;10185;477;1654;2292;7540;2769;9194
293180;201306;5256;15092;4486;13935;433;1600;3515;10765;3948;12365
293190;201306;13151;41230;12697;40488;660;2885;10990;34366;11650;37251
293200;201306;5930;18237;5365;17346;362;1364;4594;14756;4956;16120
293210;201306;4543;14274;4305;13873;572;1959;3079;10070;3651;12029
293220;201306;4896;15425;4558;14934;1197;4099;2510;8426;3707;12525
293230;201306;3898;12568;3641;12216;383;1487;2932;9790;3315;11277
293240;201306;4396;11692;3531;10524;195;591;2796;8363;2991;8954
293245;201306;4256;12797;3927;12253;514;1661;2791;8968;3305;10629
293250;201306;5825;17150;5465;16651;936;2981;3797;11706;4733;14687
293260;201306;4598;14221;3885;13193;368;1392;2921;10059;3289;11451
293270;201306;5656;15985;5414;15722;561;1550;4576;13521;5137;15071
293280;201306;5525;16212;4908;15398;434;1292;3858;12542;4292;13834
293290;201306;15770;55084;15282;54071;3186;11454;9718;35236;12904;46690
293300;201306;6015;15899;5261;15067;524;1446;4169;12186;4693;13632
293305;201306;4477;11828;4150;11398;440;1320;3247;8972;3687;10292
293310;201306;2625;7002;2200;6311;323;1038;1464;4150;1787;5188
293315;201306;4721;12435;4284;11743;782;2115;2633;7626;3415;9741
293317;201306;2441;7546;2256;7201;331;1107;1475;4750;1806;5857
293320;201306;8023;26515;7832;26251;993;3645;6215;20733;7208;24378
293325;201306;1871;5613;1567;5132;281;1003;1019;3380;1300;4383
293330;201306;52218;170332;47589;162521;11004;40750;26788;92799;37792;133549
293340;201306;2644;7748;2140;6888;301;1100;1474;4654;1775;5754
293345;201306;3297;10309;2790;9562;368;1266;1930;6857;2298;8123
293350;201306;6546;18701;6313;18411;353;996;5682;16813;6035;17809
293360;201306;13411;41599;12407;40267;803;2649;10553;34990;11356;37639
310010;201306;1224;3406;893;2868;256;974;392;1162;648;2136
310020;201306;3701;12010;3189;10856;1168;4304;644;1986;1812;6290
310030;201306;2368;8150;2154;7749;753;2840;882;3223;1635;6063
310040;201306;931;2694;796;2505;122;459;531;1621;653;2080
310050;201306;1881;6827;1664;6281;357;1564;811;3023;1168;4587
310060;201306;2976;10764;2883;10619;329;1279;2308;8607;2637;9886
310070;201306;307;940;233;799;44;185;99;307;143;492
310080;201306;727;2302;601;2058;174;689;198;628;372;1317
310090;201306;4388;13969;3944;13196;735;2737;2449;8218;3184;10955
310100;201306;3146;10240;2799;9731;426;1625;1956;6830;2382;8455
310110;201306;5729;16654;4874;15375;1170;4224;2634;8190;3804;12414
310120;201306;556;1884;533;1847;235;926;198;595;433;1521
310130;201306;451;1485;414;1426;117;459;210;691;327;1150
310140;201306;250;887;217;822;77;326;44;150;121;476
310150;201306;4527;14770;4161;14090;965;3743;2195;7377;3160;11120
310160;201306;6567;21862;5870;20690;1680;6654;2778;9584;4458;16238
310163;201306;631;2240;601;2184;161;675;281;996;442;1671
310170;201306;9410;27953;8733;26894;1894;6285;5153;16399;7047;22684
310180;201306;1757;5316;1432;4879;371;1464;741;2443;1112;3907
310190;201306;2429;8329;2233;8007;678;2737;335;1204;1013;3941
310200;201306;1782;6215;1527;5677;509;2048;498;1833;1007;3881
310205;201306;916;2996;842;2836;172;608;506;1735;678;2343
310210;201306;2319;7714;2170;7466;415;1554;1451;4986;1866;6540
310220;201306;1244;3611;1007;3310;180;649;653;2141;833;2790
310230;201306;2767;9441;2470;8777;839;3415;852;2748;1691;6163
310240;201306;991;3591;841;3283;144;616;482;1979;626;2595
310250;201306;935;3352;913;3316;187;776;559;1945;746;2721
310260;201306;3212;10806;2844;10048;958;3722;1038;3560;1996;7282
310270;201306;2232;7022;2053;6768;343;1260;1414;4714;1757;5974
310280;201306;2024;6150;1847;5861;662;2467;677;1960;1339;4427
310285;201306;2232;7959;2138;7835;267;917;1655;6278;1922;7195
310290;201306;1292;4214;1205;4079;398;1576;544;1634;942;3210
310300;201306;1812;6438;1725;6247;496;1976;949;3390;1445;5366
310310;201306;379;1085;288;891;58;201;145;435;203;636
310320;201306;335;1227;307;1153;85;346;144;545;229;891
310330;201306;472;1269;362;1072;53;190;207;572;260;762
310340;201306;8103;26684;7285;25363;1410;5166;4561;16387;5971;21553
310350;201306;13356;41091;11270;37258;4240;15184;2911;9701;7151;24885
310360;201306;425;1436;414;1416;108;428;247;800;355;1228
310370;201306;1348;5069;1303;4974;512;2014;493;1920;1005;3934
310375;201306;1246;3455;959;2982;139;519;557;1710;696;2229
310380;201306;370;1107;312;1028;144;525;115;344;259;869
310390;201306;448;1652;383;1507;117;498;67;245;184;743
310400;201306;9537;29692;7821;26560;2792;10410;2042;6747;4834;17157
310410;201306;1022;3332;677;2807;293;1311;128;510;421;1821
310420;201306;5401;16094;3140;10624;879;3353;474;1436;1353;4789
310430;201306;1522;5378;1306;4892;474;1892;362;1342;836;3234
310440;201306;618;1848;541;1727;164;599;202;602;366;1201
310445;201306;1161;4078;1005;3807;156;673;642;2469;798;3142
310450;201306;4262;13150;3615;12147;839;3004;2116;7294;2955;10298
310460;201306;1446;4859;1279;4552;478;1823;308;1166;786;2989
310470;201306;3691;9851;3145;9177;333;1144;2480;7202;2813;8346
310480;201306;974;3165;883;3016;236;930;402;1292;638;2222
310490;201306;3185;11069;2780;10270;961;3794;968;3679;1929;7473
310500;201306;1420;5118;1332;4943;455;1828;492;1813;947;3641
310510;201306;2462;8280;2170;7613;863;3305;498;1644;1361;4949
310520;201306;1225;3625;1104;3422;96;332;728;2253;824;2585
310530;201306;783;2631;539;1984;128;528;93;326;221;854
310540;201306;3567;12068;3328;11724;1207;4519;1227;4378;2434;8897
310550;201306;1061;3458;912;3203;334;1342;283;931;617;2273
310560;201306;15201;49377;13408;45892;4669;17679;4584;14969;9253;32648
310570;201306;1248;3988;1177;3889;176;669;861;2804;1037;3473
310590;201306;3913;11968;3194;10523;721;2733;1149;3576;1870;6309
310600;201306;1594;5496;1528;5339;532;2077;525;1728;1057;3805
310610;201306;536;1880;492;1781;172;726;157;508;329;1234
310620;201306;183951;603167;152635;537916;46752;182374;57144;193436;103896;375810
310630;201306;3969;13549;3784;13195;982;3852;2189;7370;3171;11222
310640;201306;1420;4495;1166;4036;377;1429;384;1261;761;2690
310650;201306;2733;9361;2318;8680;466;1902;1347;5184;1813;7086
310660;201306;1254;4045;1128;3865;213;843;795;2653;1008;3496
310665;201306;1086;3572;1014;3476;208;755;651;2274;859;3029
310670;201306;53506;173963;50359;166782;16226;57106;22636;73376;38862;130482
310680;201306;795;2447;732;2349;166;596;411;1280;577;1876
310690;201306;1165;4090;989;3693;287;1271;255;877;542;2148
310700;201306;489;1415;424;1315;105;378;220;643;325;1021
310710;201306;7064;24057;5964;22547;1398;5564;3282;13069;4680;18633
310720;201306;797;2550;739;2460;215;810;373;1167;588;1977
310730;201306;9103;29923;8517;29012;1960;7253;5206;17803;7166;25056
310740;201306;4778;16828;4193;15583;1712;6897;986;3476;2698;10373
310750;201306;1518;4110;1285;3794;267;839;796;2351;1063;3190
310760;201306;602;1957;527;1826;143;531;223;762;366;1293
310770;201306;677;2604;670;2593;226;918;345;1345;571;2263
310780;201306;3489;10524;3232;10109;384;1124;2495;7980;2879;9104
310790;201306;1639;5510;1543;5364;490;1754;792;2846;1282;4600
310800;201306;3069;10324;2562;9285;1120;4416;435;1573;1555;5989
310810;201306;1500;4290;1406;4141;360;1192;712;2010;1072;3202
310820;201306;1434;4228;1087;3632;331;1206;363;1157;694;2363
310825;201306;2213;7980;1896;7416;179;904;1401;5429;1580;6333
310830;201306;1483;5147;1256;4681;485;1943;424;1553;909;3496
310840;201306;2156;7445;1987;7099;756;2964;598;2012;1354;4976
310850;201306;1410;4559;1237;4322;262;1017;778;2697;1040;3714
310855;201306;2974;10050;2733;9654;798;2958;1394;5118;2192;8076
310860;201306;7545;24515;6843;23327;1203;4369;4089;14325;5292;18694
310870;201306;961;2992;847;2780;200;753;414;1356;614;2109
310880;201306;1225;3905;941;3365;204;829;464;1663;668;2492
310890;201306;2606;8561;2081;7529;680;2763;430;1471;1110;4234
310900;201306;3996;14024;3611;13192;1176;4699;1427;5050;2603;9749
310910;201306;1761;5437;1418;4831;452;1711;412;1371;864;3082
310920;201306;1762;5761;1478;5333;419;1711;705;2529;1124;4240
310925;201306;891;3036;805;2880;323;1262;223;794;546;2056
310930;201306;4874;15808;4359;14980;1123;3978;2467;8672;3590;12650
310940;201306;6079;18694;5341;17567;1012;3796;3088;10021;4100;13817
310945;201306;1236;3632;1005;3312;222;842;561;1802;783;2644
310950;201306;1766;6313;1548;5861;648;2672;427;1546;1075;4218
310960;201306;445;1552;397;1460;143;579;137;504;280;1083
310970;201306;1446;5192;1126;4302;466;1918;144;509;610;2427
310980;201306;439;1190;319;971;61;217;144;398;205;615
310990;201306;1104;3902;969;3638;230;995;377;1319;607;2314
311000;201306;4531;16212;4074;15239;1337;5541;1487;5369;2824;10910
311010;201306;923;3058;816;2857;263;976;367;1259;630;2235
311020;201306;864;2786;749;2588;79;312;530;1831;609;2143
311030;201306;1644;5337;1405;4808;479;1804;522;1612;1001;3416
311040;201306;465;1639;410;1489;127;480;117;411;244;891
311050;201306;2459;8188;2071;7373;694;2694;764;2720;1458;5414
311060;201306;2140;6992;1808;6261;559;2076;419;1425;978;3501
311070;201306;1694;6170;1496;5746;471;2029;466;1768;937;3797
311080;201306;1189;3271;1071;3097;175;579;703;2045;878;2624
311090;201306;1579;6224;1395;5836;508;2387;326;1315;834;3702
311100;201306;2219;8000;2025;7601;953;3712;524;1995;1477;5707
311110;201306;3635;9234;2807;8133;658;2173;1500;4199;2158;6372
311115;201306;1057;3418;923;3211;124;525;627;2207;751;2732
311120;201306;8156;24900;7030;22858;2525;9206;2088;6354;4613;15560
311130;201306;2349;7329;1932;6798;700;2790;773;2605;1473;5395
311140;201306;1201;3615;1042;3420;197;762;700;2239;897;3001
311150;201306;2385;8039;2205;7751;491;1724;1306;4780;1797;6504
311160;201306;4717;16375;4068;15317;1546;6213;1372;5125;2918;11338
311170;201306;689;2287;587;2076;80;313;360;1323;440;1636
311180;201306;1534;4382;1112;3534;347;1211;211;576;558;1787
311190;201306;1080;3360;929;3044;229;849;439;1392;668;2241
311200;201306;2445;7730;2184;7220;982;3541;509;1518;1491;5059
311205;201306;1129;3834;1024;3638;263;1051;395;1481;658;2532
311210;201306;895;2995;836;2900;138;476;611;2173;749;2649
311220;201306;881;2940;741;2628;198;726;259;908;457;1634
311230;201306;8622;27098;7537;25263;1662;6128;4044;13833;5706;19961
311240;201306;1313;4175;1125;3853;391;1494;331;1082;722;2576
311250;201306;1298;4443;1178;4231;382;1491;386;1280;768;2771
311260;201306;2856;7971;2188;6783;720;2445;670;1969;1390;4414
311265;201306;1269;3556;1017;3227;151;592;723;2281;874;2873
311270;201306;3250;11229;2977;10868;621;2610;1939;7007;2560;9617
311280;201306;1335;3812;1041;3301;291;1027;319;977;610;2004
311290;201306;2277;7617;2109;7256;404;1374;1233;4446;1637;5820
311300;201306;4895;16963;4513;16386;723;2990;3024;11023;3747;14013
311310;201306;480;1756;461;1722;106;493;201;691;307;1184
311320;201306;3904;13563;3412;12447;1077;4424;1108;3847;2185;8271
311330;201306;5313;16842;4668;15842;1700;6229;1782;6020;3482;12249
311340;201306;11910;39761;11110;38211;4323;16005;3172;10844;7495;26849
311350;201306;2137;6747;1888;6316;485;1900;855;2730;1340;4630
311360;201306;1284;3734;1024;3378;472;1650;288;972;760;2622
311370;201306;4338;13558;3946;12883;1076;4214;1716;5377;2792;9591
311380;201306;459;1574;394;1445;134;549;121;411;255;960
311390;201306;1904;7235;1825;7061;789;3370;545;2011;1334;5381
311400;201306;1665;5700;1549;5493;488;1955;657;2152;1145;4107
311410;201306;1952;7245;1840;7084;702;2899;812;3135;1514;6034
311420;201306;2178;7877;1997;7427;786;3093;427;1420;1213;4513
311430;201306;3607;11816;2874;10147;704;2748;584;2024;1288;4772
311440;201306;2066;7518;1790;7088;856;3718;440;1712;1296;5430
311450;201306;2354;8581;2112;8041;868;3553;635;2314;1503;5867
311455;201306;1490;4176;1328;3934;289;983;740;2133;1029;3116
311460;201306;585;2000;475;1755;130;594;122;426;252;1020
311470;201306;559;1857;470;1665;146;605;154;514;300;1119
311480;201306;765;2290;742;2252;238;766;349;1016;587;1782
311490;201306;307;1255;297;1217;107;456;100;414;207;870
311500;201306;490;1533;400;1352;184;677;106;342;290;1019
311510;201306;2983;9643;2536;8801;997;3846;664;2176;1661;6022
311520;201306;668;2346;637;2282;257;984;255;889;512;1873
311530;201306;9695;27436;7004;22469;2277;8569;1881;5701;4158;14270
311535;201306;653;2107;501;1788;143;578;122;425;265;1003
311540;201306;663;2508;636;2468;224;902;309;1191;533;2093
311545;201306;1952;6652;1902;6571;393;1475;1250;4334;1643;5809
311547;201306;1622;4682;1409;4346;158;524;964;3012;1122;3536
311550;201306;3150;10782;2858;10213;1050;4207;916;3166;1966;7373
311560;201306;246;684;230;666;65;206;128;355;193;561
311570;201306;1858;4946;1643;4715;136;426;1416;4077;1552;4503
311580;201306;1991;4880;1855;4720;528;1317;1115;2891;1643;4208
311590;201306;346;1157;308;1101;90;380;88;302;178;682
311600;201306;1279;3976;1113;3759;235;796;657;2352;892;3148
311610;201306;3622;12705;3365;12298;939;3425;1732;6839;2671;10264
311615;201306;2427;8498;2205;8135;281;1102;1604;6029;1885;7131
311620;201306;430;1442;386;1377;103;436;197;667;300;1103
311630;201306;1444;4396;1250;4018;248;849;714;2281;962;3130
311640;201306;857;2697;731;2491;105;395;546;1858;651;2253
311650;201306;2399;7074;2017;6446;336;1225;1186;3830;1522;5055
311660;201306;2442;8936;2239;8447;720;3048;554;1833;1274;4881
311670;201306;1280;4189;1146;3935;452;1720;428;1391;880;3111
311680;201306;2194;7116;1878;6682;392;1501;1160;4213;1552;5714
311690;201306;469;1383;406;1317;91;327;250;790;341;1117
311700;201306;2099;6367;1901;6083;220;875;1440;4522;1660;5397
311710;201306;1568;5110;1287;4592;570;2187;369;1330;939;3517
311720;201306;381;1342;367;1321;58;225;264;938;322;1163
311730;201306;3785;11593;2904;9874;906;3369;1124;3626;2030;6995
311740;201306;996;2924;870;2775;381;1212;379;1285;760;2497
311750;201306;3708;12975;3503;12694;616;2504;2385;8663;3001;11167
311760;201306;773;2766;722;2645;264;1109;202;612;466;1721
311770;201306;2565;8342;2159;7645;656;2622;728;2481;1384;5103
311780;201306;918;3564;800;3254;287;1303;102;398;389;1701
311783;201306;2013;6817;1816;6440;213;931;1191;4328;1404;5259
311787;201306;667;2337;517;1905;124;494;116;380;240;874
311790;201306;1132;3851;965;3490;306;1188;196;673;502;1861
311800;201306;4093;14544;3257;11940;1048;4081;538;1670;1586;5751
311810;201306;1010;3475;988;3437;35;171;904;3111;939;3282
311820;201306;795;2675;682;2422;245;989;292;941;537;1930
311830;201306;10038;37121;9388;35480;4045;16073;2244;8392;6289;24465
311840;201306;3308;10172;2833;9441;1007;3669;1001;3268;2008;6937
311850;201306;305;949;264;883;73;269;122;398;195;667
311860;201306;53976;179243;48610;168675;15504;58617;20011;67600;35515;126217
311870;201306;2226;6908;1870;6228;515;1965;684;2172;1199;4137
311880;201306;6512;21209;6098;20675;896;3167;4472;15605;5368;18772
311890;201306;1550;5063;1338;4623;444;1695;530;1761;974;3456
311900;201306;780;2497;704;2385;163;564;418;1485;581;2049
311910;201306;4586;14045;3778;12895;1238;4604;1486;5136;2724;9740
311920;201306;1941;6655;1709;6329;253;1067;1198;4394;1451;5461
311930;201306;4612;14399;4205;13729;1609;5718;1386;4487;2995;10205
311940;201306;14005;44769;12589;41867;4679;16855;3710;12238;8389;29093
311950;201306;2140;6736;1903;6429;168;602;1565;5324;1733;5926
311960;201306;354;1292;330;1245;103;403;159;604;262;1007
311970;201306;450;1676;401;1574;157;671;64;230;221;901
311980;201306;712;2054;565;1847;143;499;256;864;399;1363
311990;201306;448;1447;419;1395;183;619;146;481;329;1100
311995;201306;989;3127;785;2689;247;948;237;708;484;1656
312000;201306;653;2128;628;2089;120;463;379;1250;499;1713
312010;201306;1003;3320;933;3194;211;789;431;1474;642;2263
312015;201306;1533;4914;1345;4590;205;827;826;2836;1031;3663
312020;201306;886;2977;797;2849;234;933;404;1401;638;2334
312030;201306;1686;5388;1536;5191;322;1222;1012;3354;1334;4576
312040;201306;676;2664;629;2535;247;1084;174;686;421;1770
312050;201306;1473;5206;1287;4814;483;1990;347;1252;830;3242
312060;201306;780;2444;708;2358;239;878;382;1224;621;2102
312070;201306;839;2707;579;2141;170;683;203;732;373;1415
312080;201306;2526;7345;2028;6548;551;2181;905;2635;1456;4816
312083;201306;861;2660;748;2501;86;343;503;1668;589;2011
312087;201306;2204;7113;1994;6836;410;1484;1332;4647;1742;6131
312090;201306;9475;31741;8790;30542;2667;10345;3864;12906;6531;23251
312100;201306;1328;4634;1195;4431;267;1118;662;2503;929;3621
312110;201306;1153;4247;1046;4015;415;1746;208;735;623;2481
312120;201306;883;3147;803;2965;268;1128;205;650;473;1778
312125;201306;1084;3641;973;3377;259;992;393;1319;652;2311
312130;201306;718;2305;603;2066;186;713;219;715;405;1428
312140;201306;1412;4544;1209;4064;322;1137;437;1405;759;2542
312150;201306;586;1726;524;1622;105;384;306;901;411;1285
312160;201306;7678;27534;7175;26495;2401;9613;2804;10592;5205;20205
312170;201306;999;3124;925;2977;164;570;580;1902;744;2472
312180;201306;1526;4980;1460;4878;497;1718;583;1975;1080;3693
312190;201306;603;2081;495;1869;214;888;97;344;311;1232
312200;201306;4323;13959;3838;13063;570;2075;2560;8787;3130;10862
312210;201306;1096;3178;911;2920;239;871;446;1375;685;2246
312220;201306;1793;6107;1641;5927;322;1169;1136;4314;1458;5483
312230;201306;16908;58599;14728;54020;7248;28156;2641;10019;9889;38175
312235;201306;1729;5091;1436;4619;197;779;969;3115;1166;3894
312240;201306;1086;3816;943;3509;293;1167;320;1191;613;2358
312245;201306;2300;6969;2034;6603;178;515;1681;5619;1859;6134
312247;201306;860;2655;694;2406;214;801;340;1220;554;2021
312250;201306;1053;3304;980;3185;202;758;553;1759;755;2517
312260;201306;873;2993;770;2857;114;522;542;1980;656;2502
312270;201306;768;2521;671;2325;186;775;213;619;399;1394
312280;201306;463;1622;426;1528;185;718;45;153;230;871
312290;201306;697;2512;653;2452;309;1285;127;471;436;1756
312300;201306;1044;3573;906;3256;311;1185;130;410;441;1595
312310;201306;907;3598;827;3386;279;1233;333;1340;612;2573
312320;201306;2377;6826;2015;6179;592;2083;638;1684;1230;3767
312330;201306;1062;3411;986;3293;372;1386;393;1291;765;2677
312340;201306;294;799;278;777;44;159;204;534;248;693
312350;201306;353;949;339;929;52;168;268;702;320;870
312352;201306;1582;5411;1491;5276;515;1862;782;2833;1297;4695
312360;201306;3499;12255;3101;11397;1087;4262;697;2556;1784;6818
312370;201306;1606;5431;1494;5230;512;1998;552;1858;1064;3856
312380;201306;1865;5728;1771;5595;287;989;1187;3842;1474;4831
312385;201306;1123;3734;1093;3688;152;619;799;2616;951;3235
312390;201306;1916;6776;1746;6393;624;2451;434;1546;1058;3997
312400;201306;3243;11187;3045;10811;1033;3805;1421;5172;2454;8977
312410;201306;9921;34609;9065;32845;3024;11939;2998;10607;6022;22546
312420;201306;3866;12929;3699;12732;693;2461;2596;9170;3289;11631
312430;201306;8209;25438;7287;24055;1498;5185;4495;15392;5993;20577
312440;201306;516;1779;459;1667;167;650;159;560;326;1210
312450;201306;1079;4172;1031;4048;497;1945;330;1316;827;3261
312460;201306;379;1208;339;1158;92;370;158;496;250;866
312470;201306;717;2101;498;1654;146;567;96;297;242;864
312480;201306;1237;4013;1084;3829;432;1596;432;1516;864;3112
312490;201306;2280;6117;1843;5556;303;1096;1108;3228;1411;4324
312500;201306;571;2109;541;2054;160;686;267;997;427;1683
312510;201306;1764;6395;1583;5969;484;2066;489;1656;973;3722
312520;201306;358;1290;331;1231;121;476;111;418;232;894
312530;201306;551;1882;525;1825;113;460;282;930;395;1390
312540;201306;1434;4802;1212;4347;249;991;691;2443;940;3434
312550;201306;579;2000;547;1926;80;320;355;1230;435;1550
312560;201306;1964;5576;1784;5341;261;825;1283;3923;1544;4748
312570;201306;2601;8297;2320;7772;790;2873;680;2193;1470;5066
312580;201306;514;1783;422;1595;114;498;174;623;288;1121
312590;201306;1782;6289;1578;5834;579;2389;518;1768;1097;4157
312595;201306;1985;6992;1807;6567;374;1467;1039;3742;1413;5209
312600;201306;746;2811;704;2711;233;989;251;904;484;1893
312610;201306;8202;26616;7159;24532;2781;10254;2035;6777;4816;17031
312620;201306;1913;5835;1526;5357;111;357;1268;4644;1379;5001
312630;201306;480;1663;451;1611;129;534;192;643;321;1177
312640;201306;561;1891;483;1733;121;510;215;718;336;1228
312650;201306;2272;6980;1654;5795;189;788;873;3020;1062;3808
312660;201306;1179;3441;1027;3236;219;810;601;1832;820;2642
312670;201306;5764;18835;5479;18387;918;3578;3782;12586;4700;16164
312675;201306;1428;4696;1302;4450;277;1020;723;2526;1000;3546
312680;201306;1676;5242;1502;4940;285;1057;884;2949;1169;4006
312690;201306;2314;6600;1976;6141;422;1561;1115;3303;1537;4864
312695;201306;847;3134;801;3063;139;552;538;2111;677;2663
312700;201306;2084;6285;1614;5366;356;1359;813;2643;1169;4002
312705;201306;1352;4160;1206;3963;224;758;798;2659;1022;3417
312707;201306;1782;5670;1522;5223;354;1377;739;2535;1093;3912
312710;201306;7664;22609;5917;19483;2426;8867;1406;4306;3832;13173
312720;201306;733;2524;668;2404;204;813;264;892;468;1705
312730;201306;1819;4822;1433;4391;239;873;899;2741;1138;3614
312733;201306;1708;4776;1394;4207;136;513;974;2842;1110;3355
312735;201306;820;2646;736;2496;255;928;325;1077;580;2005
312737;201306;950;2422;715;2116;169;531;386;1185;555;1716
312738;201306;493;1636;407;1474;145;611;151;496;296;1107
312740;201306;483;1418;336;1223;132;527;96;345;228;872
312750;201306;1260;4759;1211;4657;339;1441;572;2188;911;3629
312760;201306;2291;7752;1891;6982;658;2681;460;1717;1118;4398
312770;201306;41765;119069;33196;106385;10404;36215;10941;35164;21345;71379
312780;201306;2368;9029;2151;8662;458;2018;1277;5282;1735;7300
312790;201306;296;884;242;797;79;276;67;214;146;490
312800;201306;4794;17113;4310;16075;1487;5953;1363;5196;2850;11149
312810;201306;2129;6738;1665;5986;681;2669;449;1558;1130;4227
312820;201306;2024;6339;1936;6183;276;1043;1261;3902;1537;4945
312825;201306;1487;4187;1326;3984;138;458;1064;3173;1202;3631
312830;201306;2564;8479;1930;7198;638;2696;255;873;893;3569
312840;201306;1076;3760;928;3456;268;1137;314;1112;582;2249
312850;201306;666;2280;595;2125;178;713;201;703;379;1416
312860;201306;1292;3832;1016;3434;378;1503;380;1124;758;2627
312870;201306;5445;17670;4333;15630;1427;5868;1274;4368;2701;10236
312880;201306;1088;3388;923;3105;300;1151;377;1156;677;2307
312890;201306;1486;4758;1199;4239;465;1834;367;1237;832;3071
312900;201306;1275;4499;1242;4452;470;1719;571;2093;1041;3812
312910;201306;1439;3487;1194;3160;332;1063;571;1391;903;2454
312920;201306;926;3142;825;2986;294;1165;330;1163;624;2328
312930;201306;2100;6542;1910;6255;454;1596;1010;3374;1464;4970
312940;201306;898;3125;806;2942;258;1089;240;814;498;1903
312950;201306;3355;9804;2766;8925;936;3274;1190;3854;2126;7128
312960;201306;1836;5821;1654;5574;220;745;1231;4259;1451;5004
312965;201306;1691;5722;1494;5362;362;1397;821;3024;1183;4421
312970;201306;1121;3932;1011;3782;467;1949;168;622;635;2571
312980;201306;19677;71547;19087;70125;7811;30614;7023;25174;14834;55788
312990;201306;350;1130;279;1007;118;480;80;271;198;751
313000;201306;484;1722;449;1659;154;662;129;432;283;1094
313005;201306;2455;8337;2205;7917;313;1306;1540;5502;1853;6808
313010;201306;3711;12929;3351;12310;1093;4426;1316;4550;2409;8976
313020;201306;1002;3441;924;3281;312;1263;344;1086;656;2349
313030;201306;1520;4445;1248;4058;355;1300;643;1989;998;3289
313040;201306;934;3359;799;2964;210;854;208;733;418;1587
313050;201306;1771;6015;1512;5596;530;2152;490;1744;1020;3896
313055;201306;1386;4863;1308;4747;135;484;1005;3773;1140;4257
313060;201306;909;3261;864;3162;424;1590;151;562;575;2152
313065;201306;1851;6383;1737;6214;253;1072;1279;4496;1532;5568
313070;201306;1128;3539;973;3257;257;1032;517;1612;774;2644
313080;201306;437;1453;366;1312;122;503;100;294;222;797
313090;201306;4762;15434;4575;15110;952;3343;2975;10002;3927;13345
313100;201306;988;3329;931;3249;176;720;627;2102;803;2822
313110;201306;1611;5014;1306;4433;344;1393;530;1662;874;3055
313115;201306;2844;10372;2730;10146;974;4013;1170;4120;2144;8133
313120;201306;3693;10974;3187;10214;1187;4013;1300;4245;2487;8258
313130;201306;25192;82975;23097;78568;7197;27189;8527;27556;15724;54745
313140;201306;737;1972;546;1664;59;224;337;1004;396;1228
313150;201306;1606;5183;1466;4929;671;2329;395;1372;1066;3701
313160;201306;1151;3565;1043;3399;251;952;589;1834;840;2786
313170;201306;9277;35325;8798;34079;3727;14969;1938;7614;5665;22583
313180;201306;2610;7129;2064;6427;678;2391;707;2150;1385;4541
313190;201306;3211;12308;3128;12116;955;3881;1349;5268;2304;9149
313200;201306;1423;4672;1290;4455;211;895;806;2762;1017;3657
313210;201306;4482;14686;3867;13849;951;3803;2097;7472;3048;11275
313220;201306;1077;3524;943;3248;291;1147;229;693;520;1840
313230;201306;2376;8759;2286;8605;441;1751;1418;5547;1859;7298
313240;201306;7320;26446;6510;24843;2081;8620;2502;9562;4583;18182
313250;201306;7460;24464;7000;23863;864;2862;5282;18788;6146;21650
313260;201306;559;1851;482;1695;160;636;131;444;291;1080
313270;201306;5179;16093;4747;15432;1068;3670;2898;9587;3966;13257
313280;201306;509;1776;443;1618;115;485;162;569;277;1054
313290;201306;1029;3820;885;3517;299;1279;222;818;521;2097
313300;201306;1894;6688;1702;6230;566;2248;470;1636;1036;3884
313310;201306;1026;3706;945;3527;296;1245;223;782;519;2027
313320;201306;2311;7346;1996;6787;424;1518;932;3230;1356;4748
313330;201306;3731;12938;3433;12371;772;3117;1757;6364;2529;9481
313340;201306;2123;5271;1671;4631;363;1099;958;2577;1321;3676
313350;201306;3241;10421;2584;8966;828;3140;550;1738;1378;4878
313360;201306;1141;3649;902;3164;329;1332;354;1106;683;2438
313370;201306;1405;5050;1346;4888;304;1267;606;2051;910;3318
313375;201306;1847;5122;1304;4373;301;1237;629;2053;930;3290
313380;201306;6398;22675;5656;21045;2393;9494;1431;5056;3824;14550
313390;201306;878;3317;843;3255;146;672;531;2004;677;2676
313400;201306;3579;11081;3318;10763;448;1532;2518;8279;2966;9811
313410;201306;1343;3984;1158;3733;252;906;707;2264;959;3170
313420;201306;17980;46495;12036;35658;3157;10651;3213;9101;6370;19752
313430;201306;1274;4297;1157;4091;387;1520;412;1416;799;2936
313440;201306;6207;15457;4817;13855;818;2568;3377;9733;4195;12301
313450;201306;681;2093;581;1904;167;670;202;583;369;1253
313460;201306;2618;9549;2391;9159;928;3845;730;2659;1658;6504
313470;201306;3351;9662;3213;9502;376;1031;2640;8001;3016;9032
313480;201306;1102;3401;856;2950;190;743;364;1210;554;1953
313490;201306;1217;4586;1063;4238;472;1843;198;822;670;2665
313500;201306;425;1389;404;1352;105;406;233;756;338;1162
313505;201306;8203;25323;7757;24768;548;1461;6802;22435;7350;23896
313507;201306;1265;3964;1151;3787;271;1017;655;2164;926;3181
313510;201306;15336;47295;13920;45503;2655;9169;9432;31376;12087;40545
313520;201306;15486;48644;13550;45573;2031;7967;9136;30594;11167;38561
313530;201306;510;1824;453;1679;70;302;203;708;273;1010
313535;201306;2412;7541;2187;7174;403;1430;1365;4542;1768;5972
313540;201306;1128;3631;934;3165;288;1052;263;838;551;1890
313545;201306;1354;5108;1215;4867;238;1112;758;2957;996;4069
313550;201306;1870;6641;1819;6525;516;2020;974;3362;1490;5382
313560;201306;2213;5731;1988;5470;201;548;1608;4548;1809;5096
313570;201306;743;2886;672;2743;264;1155;265;1066;529;2221
313580;201306;5892;17486;5305;16718;680;2288;4046;12865;4726;15153
313590;201306;1051;3255;870;3042;339;1193;461;1677;800;2870
313600;201306;3799;11907;3408;11279;704;2608;2034;6774;2738;9382
313610;201306;1113;3611;974;3331;284;1046;392;1321;676;2367
313620;201306;7349;25175;6949;24314;2442;9105;2331;8016;4773;17121
313630;201306;8106;26457;7236;25180;2410;9184;2495;9014;4905;18198
313640;201306;833;2731;741;2609;273;1042;299;1044;572;2086
313650;201306;2263;7598;2023;7202;307;1142;1458;5309;1765;6451
313652;201306;986;3654;919;3507;181;740;552;2111;733;2851
313655;201306;917;3201;797;3009;185;814;504;1851;689;2665
313657;201306;1041;3734;1006;3671;190;893;656;2203;846;3096
313660;201306;851;3083;789;2974;227;985;396;1420;623;2405
313665;201306;3503;12048;3303;11636;928;3684;1508;5108;2436;8792
313670;201306;50507;152150;37141;129808;12895;49070;11579;39543;24474;88613
313680;201306;1071;3292;955;3123;128;434;674;2241;802;2675
313690;201306;875;3232;824;3146;244;937;336;1350;580;2287
313695;201306;1462;4978;1272;4672;203;874;889;3230;1092;4104
313700;201306;3718;12985;3240;12300;477;1927;2339;8960;2816;10887
313710;201306;1351;3961;1159;3685;358;1262;596;1830;954;3092
313720;201306;4993;17451;4470;16277;1304;5318;1419;4675;2723;9993
313730;201306;1218;3542;1009;3276;154;544;672;2213;826;2757
313740;201306;1994;7426;1665;6548;678;2977;233;860;911;3837
313750;201306;2864;9031;2554;8441;863;3122;703;2159;1566;5281
313753;201306;1759;5535;1542;5153;496;1791;633;2129;1129;3920
313760;201306;4391;15083;3834;13883;1389;5607;1164;3980;2553;9587
313770;201306;3572;12386;3417;12029;1264;4692;1045;3705;2309;8397
313780;201306;3721;11144;3063;10146;933;3452;1241;4054;2174;7506
313790;201306;548;1956;531;1928;109;426;312;1144;421;1570
313800;201306;1234;3618;1114;3419;188;665;707;2152;895;2817
313810;201306;1386;4505;1338;4430;316;1073;784;2664;1100;3737
313820;201306;12545;38061;10421;34179;3396;12339;3408;11157;6804;23496
313830;201306;462;1656;398;1517;156;668;107;387;263;1055
313835;201306;1049;3626;1012;3564;237;916;557;1954;794;2870
313840;201306;6989;22155;6126;20734;1925;7324;2174;7123;4099;14447
313850;201306;1233;3554;1133;3381;246;862;666;1899;912;2761
313860;201306;2511;8135;2227;7544;733;2748;554;1717;1287;4465
313862;201306;894;2675;664;2297;237;884;174;569;411;1453
313865;201306;2165;7125;2035;6900;320;1242;1427;4771;1747;6013
313867;201306;960;3446;832;3180;273;1103;306;1186;579;2289
313868;201306;1463;5423;1349;5183;210;891;867;3376;1077;4267
313870;201306;910;2882;808;2712;216;849;362;1134;578;1983
313880;201306;2223;7294;2043;7029;509;2074;1039;3289;1548;5363
313890;201306;1947;5572;1685;5250;258;807;1155;3698;1413;4505
313900;201306;4468;16863;4238;16381;1760;7457;1122;4321;2882;11778
313910;201306;743;2602;643;2384;291;1178;129;444;420;1622
313920;201306;3487;11676;3269;11288;506;1720;2183;7923;2689;9643
313925;201306;2086;5723;1588;4816;146;518;1067;3210;1213;3728
313930;201306;5108;17465;4429;16284;868;3537;2593;9714;3461;13251
313940;201306;7622;27524;6727;26057;2716;11205;2361;9436;5077;20641
313950;201306;4524;13820;3912;12804;1216;4461;1457;4648;2673;9109
313960;201306;5686;16248;4861;15077;1704;5926;1356;4226;3060;10152
313970;201306;1417;4328;1218;4101;262;966;760;2569;1022;3535
313980;201306;1153;3952;998;3655;324;1329;256;889;580;2218
313990;201306;1992;7716;1806;7301;711;3104;522;1997;1233;5101
314000;201306;7544;27239;7089;26355;2230;9022;3482;12876;5712;21898
314010;201306;1028;3144;868;2944;188;733;457;1505;645;2238
314015;201306;1565;6018;1454;5759;578;2407;420;1693;998;4100
314020;201306;477;1602;411;1455;161;626;127;428;288;1054
314030;201306;812;2688;649;2307;158;662;201;647;359;1309
314040;201306;657;2031;586;1907;138;496;345;1082;483;1578
314050;201306;1843;6198;1561;5601;509;2025;419;1386;928;3411
314053;201306;1336;4747;1281;4675;235;826;915;3442;1150;4268
314055;201306;2186;6745;1986;6466;222;731;1491;4984;1713;5715
314060;201306;1066;3531;934;3289;155;639;562;1946;717;2585
314070;201306;3545;11777;2963;10567;955;3759;869;2994;1824;6753
314080;201306;1750;5684;1343;4805;329;1339;341;1120;670;2459
314085;201306;1756;6473;1557;6202;544;2398;619;2484;1163;4882
314090;201306;3425;12088;3157;11564;1064;4177;1219;4575;2283;8752
314100;201306;3338;9429;2963;8888;426;1316;2185;6664;2611;7980
314110;201306;4312;14682;3823;13637;1048;4312;1462;4819;2510;9131
314120;201306;944;2340;547;1734;208;760;135;387;343;1147
314130;201306;630;1943;417;1455;127;502;77;249;204;751
314140;201306;4895;15893;4490;15146;1136;4151;2357;8024;3493;12175
314150;201306;1650;4594;1346;4136;233;798;826;2515;1059;3313
314160;201306;2182;6314;1907;5958;201;707;1531;4792;1732;5499
314170;201306;1029;3341;899;3055;179;717;485;1572;664;2289
314180;201306;6281;21139;5807;20422;1715;6566;2689;9620;4404;16186
314190;201306;802;2621;716;2479;231;909;280;929;511;1838
314200;201306;2980;10045;2744;9620;476;1891;1821;6315;2297;8206
314210;201306;1886;6240;1719;5915;460;1714;820;2737;1280;4451
314220;201306;1614;5538;1437;5160;505;1997;456;1469;961;3466
314225;201306;1146;3643;1036;3487;65;181;932;3208;997;3389
314230;201306;693;2483;648;2392;214;856;231;824;445;1680
314240;201306;1090;3584;999;3433;258;863;591;2105;849;2968
314250;201306;492;1595;426;1467;161;610;136;423;297;1033
314260;201306;1282;4750;1237;4662;443;1770;516;1977;959;3747
314270;201306;2663;9574;2520;9310;387;1559;1642;6127;2029;7686
314280;201306;3120;9289;2347;7820;779;2981;655;1917;1434;4898
314290;201306;5220;15295;4540;14216;613;2103;3233;10158;3846;12261
314300;201306;1887;6596;1789;6365;641;2435;703;2460;1344;4895
314310;201306;6161;20620;5553;19275;2386;8812;1213;4073;3599;12885
314315;201306;955;3718;892;3594;165;743;512;2105;677;2848
314320;201306;3211;10180;2702;9463;1047;3994;870;2966;1917;6960
314330;201306;50263;169823;48128;165923;15827;59119;21948;74787;37775;133906
314340;201306;2083;6146;1280;4431;347;1365;157;370;504;1735
314345;201306;1272;4494;1137;4276;388;1500;534;2112;922;3612
314350;201306;1238;4022;1090;3756;490;1820;275;930;765;2750
314360;201306;683;2253;542;1994;182;780;134;441;316;1221
314370;201306;536;1964;505;1925;168;702;256;954;424;1656
314380;201306;989;3206;808;2900;338;1269;230;829;568;2098
314390;201306;14648;46213;12545;42155;4301;15668;3801;12538;8102;28206
314400;201306;5219;15299;4342;14072;1134;3614;2696;9118;3830;12732
314410;201306;2424;8206;2198;7753;735;2909;855;2837;1590;5746
314420;201306;754;2287;636;2124;100;411;466;1523;566;1934
314430;201306;8071;24782;7282;23322;2573;8990;2276;7473;4849;16463
314435;201306;1119;3905;1016;3688;228;1020;534;1832;762;2852
314437;201306;1128;2987;1023;2841;102;290;810;2264;912;2554
314440;201306;736;2074;518;1788;203;782;112;365;315;1147
314450;201306;1700;5229;1470;4895;478;1886;679;2102;1157;3988
314460;201306;4512;16175;4073;15209;1494;6050;795;3010;2289;9060
314465;201306;2333;7704;2150;7362;236;964;1621;5476;1857;6440
314467;201306;1062;3209;962;3043;427;1384;356;1167;783;2551
314470;201306;2306;7811;1825;6639;579;2416;391;1181;970;3597
314480;201306;7046;25066;5492;20790;1478;6050;586;2042;2064;8092
314490;201306;920;2932;800;2692;253;986;318;995;571;1981
314500;201306;2738;7995;2232;7006;728;2549;742;2299;1470;4848
314505;201306;1699;5583;1619;5431;408;1509;886;2963;1294;4472
314510;201306;1428;4723;1244;4382;545;2017;349;1226;894;3243
314520;201306;3475;14035;3053;12790;1225;5546;577;2254;1802;7800
314530;201306;7066;25890;6516;24974;1270;5094;3916;15548;5186;20642
314535;201306;2624;7874;2364;7532;376;1374;1575;5026;1951;6400
314537;201306;1418;4461;1211;4096;280;1052;608;2145;888;3197
314540;201306;460;1446;403;1317;133;500;123;375;256;875
314545;201306;1270;4283;1183;4144;268;1025;643;2263;911;3288
314550;201306;499;1622;426;1520;161;663;112;377;273;1040
314560;201306;5140;18837;4495;17102;1385;5733;964;3624;2349;9357
314570;201306;369;1189;333;1116;101;363;156;504;257;867
314580;201306;454;1612;395;1494;166;691;98;358;264;1049
314585;201306;644;2365;545;2158;176;762;140;542;316;1304
314587;201306;1673;5624;1557;5379;274;1031;908;3128;1182;4159
314590;201306;4031;14397;3080;11785;841;3451;404;1425;1245;4876
314600;201306;2011;7127;1696;6565;666;2870;296;1065;962;3935
314610;201306;7937;29438;7509;28415;2693;10978;2285;8444;4978;19422
314620;201306;1611;5111;1512;4989;228;735;1124;3825;1352;4560
314625;201306;1368;4620;1328;4555;245;927;834;2925;1079;3852
314630;201306;4908;15129;4326;14156;624;2307;2968;9873;3592;12180
314640;201306;795;2402;710;2252;261;899;214;641;475;1540
314650;201306;1226;3900;1018;3488;291;1165;432;1335;723;2500
314655;201306;1660;5177;1350;4615;255;983;739;2503;994;3486
314660;201306;154;459;141;432;28;94;87;261;115;355
314670;201306;1370;4009;1154;3629;231;805;631;1966;862;2771
314675;201306;1874;5897;1683;5564;236;858;1108;3731;1344;4589
314690;201306;2707;8840;2320;8138;751;2985;703;2307;1454;5292
314700;201306;9698;37969;8846;36184;4253;18133;1993;8599;6246;26732
314710;201306;7678;25845;5705;21317;1578;6603;736;2547;2314;9150
314720;201306;2589;8942;2205;8185;755;3105;899;3267;1654;6372
314730;201306;2365;7735;2063;7292;708;2781;662;2237;1370;5018
314740;201306;2903;10174;2703;9789;945;3685;1000;3512;1945;7197
314750;201306;315;1078;293;1026;65;281;157;521;222;802
314760;201306;1805;6644;1423;5586;354;1590;266;879;620;2469
314770;201306;1154;3791;799;2812;147;606;107;303;254;909
314780;201306;284;826;217;741;81;304;87;296;168;600
314790;201306;13145;41511;10206;36240;4220;16898;2402;7992;6622;24890
314795;201306;1497;4694;1346;4451;158;686;1010;3200;1168;3886
314800;201306;16623;52360;14161;47478;6038;21303;2925;10066;8963;31369
314810;201306;12500;39254;9981;34570;3418;13324;2493;8513;5911;21837
314820;201306;1054;3056;756;2642;319;1219;237;759;556;1978
314830;201306;1603;5689;1411;5306;562;2305;465;1750;1027;4055
314840;201306;1132;4049;909;3713;185;866;535;2201;720;3067
314850;201306;2171;6572;1905;6160;409;1519;1047;3362;1456;4881
314860;201306;3240;11583;3024;11243;606;2466;1882;7066;2488;9532
314870;201306;5562;18719;5034;17971;890;3564;3336;12132;4226;15696
314875;201306;1646;5837;1616;5794;287;960;1258;4642;1545;5602
314880;201306;751;2351;691;2228;108;372;444;1424;552;1796
314890;201306;576;1830;426;1521;138;546;102;308;240;854
314900;201306;358;1168;298;1070;88;342;148;516;236;858
314910;201306;1649;5929;1484;5664;694;2873;362;1298;1056;4171
314915;201306;2398;7732;2154;7394;218;906;1757;5994;1975;6900
314920;201306;650;1945;509;1748;101;406;262;851;363;1257
314930;201306;4952;17433;4393;16191;1620;6563;929;3386;2549;9949
314940;201306;406;1234;382;1191;85;263;213;664;298;927
314950;201306;360;1313;320;1221;104;453;57;188;161;641
314960;201306;761;2582;657;2380;214;854;177;598;391;1452
314970;201306;793;2962;714;2762;314;1312;221;813;535;2125
314980;201306;2206;6921;2024;6623;875;3071;307;964;1182;4035
314990;201306;3043;10097;2498;8836;992;3813;399;1271;1391;5084
314995;201306;1473;4885;1363;4725;298;1232;843;2787;1141;4019
315000;201306;953;3040;842;2893;170;691;530;1769;700;2460
315010;201306;462;1553;395;1404;140;577;134;415;274;992
315015;201306;1756;5654;1665;5547;347;1221;1149;3930;1496;5151
315020;201306;727;2486;662;2362;204;834;257;820;461;1654
315030;201306;1000;3145;870;2903;354;1291;177;581;531;1872
315040;201306;914;2892;847;2783;109;410;603;1959;712;2369
315050;201306;1493;4703;1301;4366;506;1864;369;1185;875;3049
315053;201306;1085;3312;952;3103;272;1069;357;1078;629;2147
315057;201306;1857;6633;1543;6165;247;1019;1021;4220;1268;5239
315060;201306;932;3232;781;2832;247;973;200;748;447;1721
315070;201306;617;1906;577;1848;145;500;349;1100;494;1600
315080;201306;3322;11936;3088;11474;929;3693;1389;5189;2318;8882
315090;201306;744;2750;666;2589;195;828;227;919;422;1747
315100;201306;1144;4085;937;3613;281;1230;282;1051;563;2281
315110;201306;1581;4964;1408;4678;417;1485;590;1946;1007;3431
315120;201306;12269;31785;9602;28354;1956;6327;5324;16496;7280;22823
315130;201306;1728;5897;1582;5615;622;2436;432;1494;1054;3930
315140;201306;2275;7905;1905;7053;583;2485;515;1656;1098;4141
315150;201306;4443;12773;3520;11126;957;3472;1342;4041;2299;7513
315160;201306;1315;3815;1196;3660;240;835;739;2213;979;3048
315170;201306;1305;4043;1152;3836;299;1113;633;2130;932;3243
315180;201306;12509;40783;10257;35961;3249;12981;2600;8698;5849;21679
315190;201306;2324;6439;1903;5827;590;1950;869;2668;1459;4618
315200;201306;4066;14303;3581;13278;1210;4918;996;3558;2206;8476
315210;201306;8088;26110;7184;24486;2896;10604;2131;7130;5027;17734
315213;201306;1057;3569;1020;3510;118;392;813;2884;931;3276
315217;201306;2587;9178;2257;8582;393;1675;1337;5087;1730;6762
315220;201306;9783;30066;8835;28834;1232;4468;6384;21020;7616;25488
315230;201306;2287;6459;2149;6296;156;478;1830;5414;1986;5892
315240;201306;3016;10434;2876;10196;656;2512;1661;5894;2317;8406
315250;201306;7885;27053;6439;24420;2380;10073;2054;7694;4434;17767
315260;201306;1040;3570;913;3290;381;1496;152;497;533;1993
315270;201306;859;3126;751;2888;263;1087;160;573;423;1660
315280;201306;3747;11979;3172;10669;1185;4237;808;2576;1993;6813
315290;201306;1303;3825;1028;3389;420;1537;166;532;586;2069
315300;201306;468;1416;384;1310;202;743;102;312;304;1055
315310;201306;1165;4044;1091;3927;149;613;741;2640;890;3253
315320;201306;780;2805;688;2666;251;1027;284;1147;535;2174
315330;201306;824;3052;684;2750;301;1365;116;444;417;1809
315340;201306;4077;12167;3556;11361;689;2353;2116;6880;2805;9233
315350;201306;1788;5289;1536;4944;173;524;1226;4083;1399;4607
315360;201306;1659;5775;1427;5149;380;1456;487;1695;867;3151
315370;201306;609;1878;542;1779;137;511;294;936;431;1447
315380;201306;271;993;254;943;96;372;48;176;144;548
315390;201306;1907;6913;1654;6287;614;2482;344;1302;958;3784
315400;201306;4277;13975;3981;13396;1180;4221;1906;6583;3086;10804
315410;201306;1619;4725;1381;4314;291;1114;753;2223;1044;3337
315415;201306;1024;3623;966;3515;427;1592;374;1397;801;2989
315420;201306;1491;4793;1156;4205;373;1486;270;937;643;2423
315430;201306;3875;10972;3066;9636;824;2881;1177;3651;2001;6532
315440;201306;949;2990;877;2893;144;549;574;1910;718;2459
315445;201306;2036;6215;1783;5878;294;1068;1240;4132;1534;5200
315450;201306;2430;8063;2324;7911;425;1498;1638;5702;2063;7200
315460;201306;37199;128486;33539;120560;11540;45071;9704;33678;21244;78749
315470;201306;467;1550;437;1502;102;381;251;842;353;1223
315480;201306;1373;4724;1082;4056;291;1180;263;962;554;2142
315490;201306;3186;9343;2820;8854;552;2121;1748;5257;2300;7378
315500;201306;463;1539;319;1165;79;339;128;404;207;743
315510;201306;1450;4377;1262;4061;187;750;793;2481;980;3231
315520;201306;1118;3677;961;3473;192;786;628;2208;820;2994
315530;201306;473;1715;449;1676;219;869;133;469;352;1338
315540;201306;1247;3886;1013;3506;228;964;394;1321;622;2285
315550;201306;1590;4866;1408;4626;471;1696;626;2038;1097;3734
315560;201306;6624;23255;6276;22756;1018;4066;4294;15600;5312;19666
315570;201306;2339;7552;2219;7387;377;1394;1521;5093;1898;6487
315580;201306;2582;8303;2134;7443;651;2651;762;2483;1413;5134
315590;201306;850;2567;798;2488;118;446;579;1776;697;2222
315600;201306;2505;9438;2139;8877;336;1530;1408;6080;1744;7610
315610;201306;947;2947;834;2706;237;900;277;761;514;1661
315620;201306;330;1196;325;1185;109;412;148;547;257;959
315630;201306;973;3188;839;2956;241;895;225;774;466;1669
315640;201306;736;2412;647;2222;242;952;196;618;438;1570
315645;201306;773;2621;690;2405;269;1039;147;489;416;1528
315650;201306;1796;5592;1693;5458;167;699;1308;4100;1475;4799
315660;201306;2572;7319;2367;7039;388;1292;1607;4736;1995;6028
315670;201306;11180;41073;10352;39404;4002;16366;3281;12204;7283;28570
315680;201306;2788;10071;2338;9195;922;3800;598;2467;1520;6267
315690;201306;2943;9898;2544;9161;971;3831;674;2407;1645;6238
315700;201306;6853;22965;6175;21560;1504;5952;2993;10012;4497;15964
315710;201306;1797;5527;1489;5038;244;996;856;2843;1100;3839
315720;201306;2799;9797;2602;9383;827;3366;925;3125;1752;6491
315725;201306;1577;5050;1309;4712;305;1080;871;3212;1176;4292
315727;201306;635;2102;586;1992;146;529;308;1045;454;1574
315730;201306;968;3145;878;2960;263;927;405;1412;668;2339
315733;201306;1089;3604;1009;3426;468;1686;307;1020;775;2706
315737;201306;1337;4276;1159;3975;170;650;744;2570;914;3220
315740;201306;1001;3349;874;3100;284;1144;343;1131;627;2275
315750;201306;1069;3438;959;3289;136;566;676;2256;812;2822
315760;201306;851;2625;839;2606;38;115;773;2422;811;2537
315765;201306;1415;4629;1332;4486;188;660;983;3376;1171;4036
315770;201306;1610;5280;1485;5016;455;1675;578;1895;1033;3570
315780;201306;26220;88988;24823;86084;9357;34280;8490;30055;17847;64335
315790;201306;3011;10763;2821;10359;354;1245;1907;7265;2261;8510
315800;201306;1499;6026;1267;5333;430;1976;214;859;644;2835
315810;201306;1446;4317;1260;4009;248;862;759;2335;1007;3197
315820;201306;3040;10288;2633;9694;654;2569;1440;5381;2094;7950
315830;201306;1463;5047;1344;4784;353;1435;456;1558;809;2993
315840;201306;659;1895;530;1626;108;367;151;444;259;811
315850;201306;1339;4865;1295;4763;406;1558;503;1822;909;3380
315860;201306;402;1516;351;1409;111;492;105;437;216;929
315870;201306;458;1427;403;1339;113;426;155;478;268;904
315880;201306;1060;2967;892;2760;286;998;381;1154;667;2152
315890;201306;1587;5634;1452;5432;407;1545;811;3191;1218;4736
315895;201306;4838;15654;4536;15072;1557;5653;1813;5883;3370;11536
315900;201306;734;2467;683;2381;223;890;310;999;533;1889
315910;201306;598;2183;552;2087;242;945;193;718;435;1663
315920;201306;1125;3710;1006;3471;371;1400;397;1293;768;2693
315930;201306;1047;3074;909;2827;309;1039;294;900;603;1939
315935;201306;1120;3903;1049;3747;362;1417;326;1142;688;2559
315940;201306;607;2015;574;1965;160;601;310;1033;470;1634
315950;201306;1183;3790;1114;3657;336;1129;608;2044;944;3173
315960;201306;2653;9643;2261;8773;1054;4636;226;806;1280;5442
315970;201306;772;2281;647;2085;85;280;479;1579;564;1859
315980;201306;3883;10216;2880;8491;831;2838;936;2428;1767;5266
315990;201306;4213;13067;3749;12306;875;3348;2049;6589;2924;9937
316000;201306;550;1891;486;1766;246;954;113;396;359;1350
316010;201306;427;1605;385;1506;125;561;72;227;197;788
316020;201306;1164;3872;938;3484;182;744;535;2032;717;2776
316030;201306;3563;10431;2628;8933;400;1519;1446;5051;1846;6570
316040;201306;3268;10456;2454;8590;480;1922;411;1148;891;3070
316045;201306;2020;6788;1900;6614;303;951;1346;5009;1649;5960
316050;201306;317;1123;302;1093;63;256;178;638;241;894
316060;201306;751;2380;638;2227;129;553;387;1278;516;1831
316070;201306;5837;20138;5476;19399;1870;7260;2354;8000;4224;15260
316080;201306;714;2727;647;2543;176;774;157;612;333;1386
316090;201306;585;1786;455;1525;128;498;117;347;245;845
316095;201306;1131;3966;1072;3832;228;849;674;2488;902;3337
316100;201306;2817;9880;2359;8704;802;3285;486;1692;1288;4977
316105;201306;848;2478;675;2222;174;632;324;1061;498;1693
316110;201306;11977;44007;10940;42015;1534;6666;7839;30509;9373;37175
316120;201306;1247;4488;1221;4451;437;1624;591;2236;1028;3860
316130;201306;907;2371;710;2059;221;761;258;683;479;1444
316140;201306;1005;3142;803;2807;169;644;440;1567;609;2211
316150;201306;1236;3989;1179;3898;330;1263;610;1937;940;3200
316160;201306;1199;3746;1009;3361;139;513;612;2058;751;2571
316165;201306;869;2564;762;2387;160;575;417;1273;577;1848
316170;201306;1314;4046;1055;3547;251;987;437;1331;688;2318
316180;201306;1160;3850;1006;3589;318;1354;364;1184;682;2538
316190;201306;2548;7953;1629;5729;387;1496;332;1027;719;2523
316200;201306;4039;13461;3281;11976;961;4107;942;3234;1903;7341
316210;201306;4825;16128;4542;15561;2213;8086;947;3239;3160;11325
316220;201306;622;1986;472;1724;153;628;78;305;231;933
316225;201306;998;3133;912;3006;165;615;581;1893;746;2508
316230;201306;420;1340;359;1225;69;256;198;682;267;938
316240;201306;5978;20123;5298;19302;647;2264;4193;15673;4840;17937
316245;201306;2790;10520;2669;10347;251;1097;2157;8430;2408;9527
316250;201306;8440;27703;7632;26007;3444;12539;2008;6468;5452;19007
316255;201306;2262;7449;2038;7185;322;1068;1505;5467;1827;6535
316257;201306;1237;3667;993;3233;309;1150;324;971;633;2121
316260;201306;1741;5095;1357;4549;461;1704;674;2222;1135;3926
316265;201306;1143;3428;1030;3198;89;327;738;2262;827;2589
316270;201306;5138;16990;4825;16361;1514;5598;2025;6943;3539;12541
316280;201306;3200;11026;2898;10421;672;2704;1438;5162;2110;7866
316290;201306;2970;10232;2814;9931;816;3241;1238;4131;2054;7372
316292;201306;3647;12524;3388;12012;1038;4120;1424;4770;2462;8890
316294;201306;863;2980;587;2286;160;720;83;317;243;1037
316295;201306;1872;6846;1750;6584;500;2165;822;2876;1322;5041
316300;201306;892;3094;821;2959;101;380;567;2114;668;2494
316310;201306;663;2180;527;1893;142;568;193;681;335;1249
316320;201306;536;1860;486;1787;185;767;166;560;351;1327
316330;201306;908;2870;804;2689;168;564;452;1578;620;2142
316340;201306;1087;3710;1007;3562;389;1529;250;801;639;2330
316350;201306;1452;4927;1330;4720;274;997;751;2839;1025;3836
316360;201306;732;2009;595;1830;72;231;458;1415;530;1646
316370;201306;4860;16621;4442;15744;1545;5806;1106;4040;2651;9846
316380;201306;1354;4001;1136;3649;153;549;760;2454;913;3003
316390;201306;861;2728;742;2528;273;998;294;1024;567;2022
316400;201306;1445;4993;1302;4751;395;1518;581;2202;976;3720
316410;201306;1188;4147;1116;4033;223;898;702;2529;925;3427
316420;201306;1940;6848;1826;6683;317;1265;1184;4447;1501;5712
316430;201306;839;2685;740;2526;246;907;278;919;524;1826
316440;201306;563;1959;504;1882;204;882;220;742;424;1624
316443;201306;655;2099;574;1924;156;586;201;642;357;1228
316447;201306;1289;4444;1237;4346;212;823;918;3200;1130;4023
316450;201306;2118;7765;1915;7360;494;1890;1030;4159;1524;6049
316460;201306;772;2517;726;2445;198;763;425;1357;623;2120
316470;201306;6562;23627;5951;22271;2264;9532;1785;6210;4049;15742
316480;201306;253;912;227;859;75;299;72;266;147;565
316490;201306;348;1157;335;1131;132;471;140;463;272;934
316500;201306;1057;3934;760;3017;216;928;62;229;278;1157
316510;201306;925;3459;844;3304;384;1573;278;1081;662;2654
316520;201306;1098;3610;941;3371;306;1263;344;1129;650;2392
316530;201306;1180;3928;1002;3537;288;1222;402;1228;690;2450
316540;201306;982;3311;887;3151;297;1249;304;970;601;2219
316550;201306;1235;4342;1141;4189;243;990;731;2682;974;3672
316553;201306;2157;8150;1843;7342;692;2954;384;1495;1076;4449
316555;201306;2552;9571;2377;9364;202;761;1964;7976;2166;8737
316556;201306;575;1705;481;1518;59;230;313;943;372;1173
316557;201306;863;3218;840;3175;307;1205;412;1550;719;2755
316560;201306;343;1186;302;1105;74;328;86;276;160;604
316570;201306;1328;4423;1238;4225;249;937;702;2391;951;3328
316580;201306;230;771;213;732;80;286;73;235;153;521
316590;201306;1269;3993;1099;3690;208;829;642;2102;850;2931
316600;201306;1109;3882;1009;3658;258;1013;503;1768;761;2781
316610;201306;591;2285;557;2225;158;710;307;1194;465;1904
316620;201306;2027;6893;1892;6607;571;2141;828;2915;1399;5056
316630;201306;1422;4985;1299;4700;555;2135;387;1374;942;3509
316640;201306;252;859;228;811;70;291;87;285;157;576
316650;201306;908;3665;816;3501;200;856;442;2016;642;2872
316660;201306;134;422;116;391;31;131;43;127;74;258
316670;201306;1548;4887;1318;4426;521;1979;358;1067;879;3046
316680;201306;1849;5786;1672;5503;235;804;1279;4260;1514;5064
316690;201306;1073;3756;992;3633;397;1613;322;1128;719;2741
316695;201306;1238;3934;1114;3712;126;403;776;2711;902;3114
316700;201306;348;1218;327;1173;95;407;155;513;250;920
316710;201306;3336;13232;2946;12334;1022;4426;934;4118;1956;8544
316720;201306;19754;68616;17207;62891;6470;24921;4576;16684;11046;41605
316730;201306;418;1375;367;1263;98;375;185;586;283;961
316740;201306;724;2597;666;2487;277;1113;172;606;449;1719
316750;201306;395;1452;370;1399;127;537;131;466;258;1003
316760;201306;3486;12109;3004;11570;1796;6896;892;3685;2688;10581
316770;201306;1430;4438;1270;4212;247;917;812;2748;1059;3665
316780;201306;675;2398;640;2329;288;1109;153;542;441;1651
316790;201306;823;2472;621;2117;182;725;231;764;413;1489
316800;201306;5926;20256;5441;19328;1211;5022;2917;9955;4128;14977
316805;201306;880;2390;836;2334;154;418;600;1733;754;2151
316810;201306;503;1619;473;1563;138;503;232;751;370;1254
316820;201306;323;1013;256;893;112;425;45;147;157;572
316830;201306;572;2139;551;2092;209;839;207;777;416;1616
316840;201306;3301;10015;2887;9351;889;3269;1199;3721;2088;6990
316850;201306;2037;6717;1901;6473;478;1828;985;3296;1463;5124
316860;201306;22750;73581;21349;71060;6299;23278;9745;32372;16044;55650
316870;201306;6821;23561;6152;21955;2457;9437;1397;4838;3854;14275
316880;201306;852;3003;826;2963;374;1440;227;788;601;2228
316890;201306;1356;3672;1091;3307;506;1696;338;966;844;2662
316900;201306;2491;8282;2318;7917;768;2914;717;2213;1485;5127
316905;201306;402;1468;378;1414;156;613;113;417;269;1030
316910;201306;663;2346;567;2148;157;633;250;963;407;1596
316920;201306;1453;4623;1178;4146;198;781;572;1995;770;2776
316930;201306;9303;32879;8405;31123;2743;11556;2696;9614;5439;21170
316935;201306;4695;14407;3520;12325;1287;5012;920;3028;2207;8040
316940;201306;6481;22876;5714;21251;1620;6823;1717;6069;3337;12892
316950;201306;1415;4385;1265;4183;232;890;818;2658;1050;3548
316960;201306;5099;13855;4412;13008;970;3136;2705;7994;3675;11130
316970;201306;3377;11595;3204;11270;1424;5605;807;2578;2231;8183
316980;201306;909;2972;758;2730;368;1410;216;780;584;2190
316990;201306;9442;32661;8759;31141;3783;14579;1472;5043;5255;19622
317000;201306;2410;9158;2347;9075;292;903;1948;7888;2240;8791
317005;201306;2251;7681;2178;7577;451;1642;1503;5256;1954;6898
317010;201306;26450;77232;19043;63962;5859;21831;4835;16821;10694;38652
317020;201306;39517;124866;29022;102019;8638;33490;6250;20626;14888;54116
317030;201306;854;2471;720;2267;129;492;412;1294;541;1786
317040;201306;12246;38759;11124;36718;4329;14896;4043;13689;8372;28585
317043;201306;767;2264;647;2099;216;744;292;945;508;1689
317047;201306;1127;3156;920;2833;175;605;449;1385;624;1990
317050;201306;1738;6489;1555;6039;497;2113;478;1767;975;3880
317052;201306;2284;7775;2054;7441;399;1506;1412;5245;1811;6751
317057;201306;1669;5052;1333;4482;230;919;710;2375;940;3294
317060;201306;379;1162;290;960;87;325;107;332;194;657
317065;201306;1205;4166;1108;4014;149;591;842;3070;991;3661
317070;201306;8774;30251;7169;26665;2403;9878;1703;6337;4106;16215
317075;201306;1186;3903;1086;3735;421;1581;399;1311;820;2892
317080;201306;6677;20290;6262;19623;2120;7182;2584;8189;4704;15371
317090;201306;4647;16590;4392;16098;751;2900;2946;10997;3697;13897
317100;201306;3109;9503;2768;8965;942;3420;1190;3648;2132;7068
317103;201306;1971;7115;1692;6498;407;1862;791;2985;1198;4847
317107;201306;1238;4099;1120;3858;288;1172;540;1749;828;2921
317110;201306;672;1870;504;1568;147;543;194;533;341;1076
317115;201306;1012;3358;917;3148;133;480;621;2148;754;2628
317120;201306;12639;44125;11184;40750;4072;15750;4123;14879;8195;30629
317130;201306;8671;28717;7975;27430;2311;8946;3507;11706;5818;20652
317140;201306;627;2270;588;2180;89;366;368;1356;457;1722
317150;201306;1014;2844;866;2670;125;459;601;1819;726;2278
317160;201306;3680;10355;2891;9343;445;1675;1926;6145;2371;7820
317170;201306;1903;5883;1805;5690;279;1034;1080;3272;1359;4306
317180;201306;1755;6204;1433;5444;442;1816;399;1502;841;3318
317190;201306;1311;4092;1226;3976;126;468;998;3240;1124;3708
317200;201306;4128;14492;3948;14095;1532;5923;975;3337;2507;9260
317210;201306;1043;3382;892;3137;304;1187;352;1218;656;2405
317220;201306;341;1269;336;1263;139;531;157;604;296;1135
320010;201306;5897;18939;5294;17524;864;3131;2976;9870;3840;13001
320013;201306;1790;5545;1435;4984;213;796;901;3188;1114;3984
320016;201306;3394;9697;2950;9067;525;1647;1996;6245;2521;7892
320020;201306;4105;13726;3812;13098;1370;5011;1408;4839;2778;9850
320030;201306;1706;5722;1564;5414;444;1669;723;2440;1167;4109
320035;201306;1589;5254;1453;4998;530;1958;441;1522;971;3480
320040;201306;3090;10746;2673;9762;806;3142;854;3072;1660;6214
320050;201306;1850;5423;1591;4890;348;1200;800;2409;1148;3609
320060;201306;10836;35664;9055;31556;2768;10511;3100;10303;5868;20814
320070;201306;1754;6105;1601;5740;565;2173;423;1422;988;3595
320080;201306;5047;15739;4349;14345;1411;5067;1573;5028;2984;10095
320090;201306;8043;24005;6873;21930;2001;6907;3389;10515;5390;17422
320100;201306;3198;9843;2676;8813;653;2358;1272;4100;1925;6458
320110;201306;1523;4763;1399;4512;379;1339;467;1477;846;2816
320115;201306;1913;7165;1865;7047;624;2411;1009;3879;1633;6290
320120;201306;16369;57751;14850;54675;5732;22416;4255;15739;9987;38155
320130;201306;37521;129593;35569;125389;11549;43791;15967;55323;27516;99114
320140;201306;3934;13265;2922;10646;821;3273;371;1301;1192;4574
320150;201306;17314;50870;13180;42810;4574;15916;2108;6767;6682;22683
320160;201306;5251;16533;4648;15576;1267;4733;2193;7035;3460;11768
320170;201306;1941;6537;1799;6220;708;2534;546;1938;1254;4472
320180;201306;901;3054;823;2927;271;1020;373;1321;644;2341
320190;201306;4048;15128;3778;14429;1482;5883;1118;4264;2600;10147
320200;201306;1078;3641;979;3437;308;1165;417;1474;725;2639
320210;201306;6028;17106;5279;15841;1413;4719;2601;7650;4014;12369
320220;201306;2662;8507;2113;7484;681;2614;714;2578;1395;5192
320225;201306;1395;5078;1230;4612;463;1863;239;900;702;2763
320230;201306;4125;14182;3885;13720;1332;5037;1450;5256;2782;10293
320240;201306;11240;37404;9633;34192;3641;13596;2438;9042;6079;22638
320245;201306;4085;14313;3889;13860;1267;4684;1789;6416;3056;11100
320250;201306;1666;5361;1290;4462;369;1432;286;914;655;2346
320255;201306;1946;6669;1705;6256;708;2765;594;2245;1302;5010
320260;201306;1362;4476;1162;3944;352;1320;410;1241;762;2561
320265;201306;2384;7552;2047;7137;275;1012;1526;5449;1801;6461
320270;201306;2150;7311;2000;6943;508;1850;1029;3592;1537;5442
320280;201306;7083;21851;6635;21209;1235;4184;4354;14253;5589;18437
320290;201306;1503;5274;1400;4977;545;2007;416;1427;961;3434
320300;201306;4375;15199;4117;14685;1161;4365;2117;7632;3278;11997
320305;201306;4433;15132;4085;14289;1213;4665;1775;6037;2988;10702
320310;201306;1896;5935;1764;5740;406;1443;1038;3319;1444;4762
320313;201306;2160;6847;1665;5698;494;1966;273;837;767;2803
320316;201306;2177;7056;2079;6828;584;2027;975;3193;1559;5220
320320;201306;17536;59131;15778;55690;4987;19655;6698;22918;11685;42573
320330;201306;2709;8793;2460;8308;625;2121;1311;4577;1936;6698
320332;201306;5018;17540;4678;16923;1573;5872;2040;7677;3613;13549
320334;201306;1524;5514;1283;4902;491;2069;215;732;706;2801
320335;201306;1834;5894;1565;5312;607;2236;297;951;904;3187
320340;201306;5433;16096;4507;14488;1122;4005;2129;6807;3251;10812
320350;201306;5311;14020;4051;11952;874;2938;1916;5466;2790;8404
320360;201306;1702;4727;1367;4130;303;1033;663;1907;966;2940
320370;201306;3412;11677;2997;10838;905;3421;1271;4637;2176;8058
320380;201306;2578;8371;2321;7829;715;2544;957;3214;1672;5758
320390;201306;8008;25019;6889;22833;1887;7015;3023;9748;4910;16763
320400;201306;4096;12057;3539;11285;654;2325;2289;7222;2943;9547
320405;201306;4087;12463;3798;12077;1118;3972;2106;6561;3224;10533
320410;201306;5883;15344;4518;13794;604;1785;3414;10719;4018;12504
320420;201306;2383;7747;1923;7028;875;3415;347;1237;1222;4652
320425;201306;2440;6406;2042;5859;314;1084;1322;3771;1636;4855
320430;201306;2189;6728;2026;6441;321;1179;1225;3801;1546;4980
320435;201306;1927;7067;1771;6682;498;1915;864;3396;1362;5311
320440;201306;1461;5064;1365;4793;449;1707;464;1549;913;3256
320450;201306;2266;7756;2080;7345;628;2401;920;3180;1548;5581
320455;201306;4337;15940;3611;14108;1196;4854;723;2790;1919;7644
320460;201306;2782;9531;2350;8585;826;3254;684;2371;1510;5625
320465;201306;1493;4999;1322;4572;297;1075;572;1957;869;3032
320470;201306;4015;13003;3083;10903;1101;4223;485;1639;1586;5862
320480;201306;1975;6128;1671;5545;421;1640;757;2354;1178;3994
320490;201306;16917;55557;14643;51050;5169;19241;5229;18775;10398;38016
320495;201306;1268;4253;1149;3986;508;1905;346;1161;854;3066
320500;201306;40557;133127;36737;125802;13089;48351;15439;51621;28528;99972
320501;201306;4010;13512;3774;13073;1425;5405;1551;5283;2976;10688
320503;201306;2186;8193;1934;7479;685;2805;503;1814;1188;4619
320506;201306;3025;9853;2211;7737;673;2491;401;1402;1074;3893
320510;201306;7795;25689;7155;24450;2640;9628;2555;8661;5195;18289
320515;201306;2035;5914;1842;5544;516;1638;770;2352;1286;3990
320517;201306;1997;7046;1802;6594;643;2501;562;2048;1205;4549
320520;201306;29494;99272;26110;92650;9114;35349;11033;38963;20147;74312
320530;201306;26015;84443;22785;77828;6781;26101;9672;31656;16453;57757
330010;201306;14336;47467;13486;45644;3387;13009;7350;23767;10737;36776
330015;201306;1910;5501;1688;5068;556;1868;543;1545;1099;3413
330020;201306;15485;48171;14332;46292;3937;13676;7531;24150;11468;37826
330022;201306;1442;4779;1332;4583;315;1293;725;2349;1040;3642
330023;201306;3161;10553;3018;10264;893;3333;1270;4219;2163;7552
330025;201306;3123;9910;2924;9605;703;2512;1854;6055;2557;8567
330030;201306;7100;25114;6560;23979;2190;8754;2652;9220;4842;17974
330040;201306;13887;40501;11935;37452;3228;10997;6341;19554;9569;30551
330045;201306;58628;176540;55028;171304;9207;30486;38067;119182;47274;149668
330050;201306;2828;9313;2548;8740;979;3772;714;2279;1693;6051
330060;201306;5198;16652;4759;16013;1171;4406;2833;9566;4004;13972
330070;201306;24191;77421;22360;74113;6849;24460;9666;32019;16515;56479
330080;201306;8633;26050;8310;25603;2191;6800;4986;15865;7177;22665
330090;201306;2985;8787;2860;8548;967;3082;1274;3744;2241;6826
330093;201306;1866;5596;1678;5303;410;1411;817;2567;1227;3978
330095;201306;1166;4133;1088;3932;426;1706;210;668;636;2374
330100;201306;50587;176491;48175;172086;12734;50027;24455;87628;37189;137655
330110;201306;2587;8357;2378;7966;878;3158;696;2315;1574;5473
330115;201306;2406;7544;2256;7268;794;2803;901;2807;1695;5610
330120;201306;2296;7102;2134;6871;513;1797;1237;3938;1750;5735
330130;201306;3756;12723;3445;12099;1228;4621;1210;4225;2438;8846
330140;201306;3267;10167;2981;9769;773;2821;1461;4782;2234;7603
330150;201306;2872;8927;2328;7766;840;3036;523;1684;1363;4720
330160;201306;1324;4712;1249;4539;505;1994;366;1269;871;3263
330170;201306;95473;299416;90233;291287;13510;47509;65738;211995;79248;259504
330180;201306;1586;4998;1458;4758;277;1147;935;2817;1212;3964
330185;201306;7403;24152;7010;23494;1987;7011;3719;12812;5706;19823
330187;201306;3947;11598;3616;11057;854;3016;2029;6055;2883;9071
330190;201306;26939;83860;25890;82054;7060;23838;14771;46012;21831;69850
330200;201306;12485;40636;11663;38985;2684;9258;6597;22495;9281;31753
330205;201306;2491;6959;2276;6603;538;1808;1182;3292;1720;5100
330210;201306;4563;12331;3489;10351;1108;3609;1012;2972;2120;6581
330220;201306;10732;35055;10199;34020;3788;13658;3468;11159;7256;24817
330225;201306;3876;12582;3669;12255;671;2585;2496;8301;3167;10886
330227;201306;16979;48843;15604;47069;3319;10839;10072;29817;13391;40656
330230;201306;1478;4460;1371;4285;429;1505;545;1575;974;3080
330240;201306;19401;61433;17466;58139;7184;26007;3328;10929;10512;36936
330245;201306;1173;3838;986;3451;310;1176;229;810;539;1986
330250;201306;35699;106824;34115;104344;9010;27693;20194;63212;29204;90905
330260;201306;3282;10682;3129;10378;889;3256;1476;4714;2365;7970
330270;201306;12918;40072;11619;37933;3643;12585;4894;16135;8537;28720
330280;201306;1863;6152;1629;5668;401;1612;801;2630;1202;4242
330285;201306;17104;52552;15857;50805;3663;12437;9861;31739;13524;44176
330290;201306;3346;9498;3020;9106;551;1927;1948;5629;2499;7556
330300;201306;4075;13736;3912;13461;1052;3834;2044;7216;3096;11050
330310;201306;2663;8083;2468;7741;647;2145;1205;3734;1852;5879
330320;201306;15016;45249;14313;44158;3758;11807;8475;26797;12233;38604
330330;201306;29646;87581;27819;84731;7451;24337;16209;48788;23660;73125
330340;201306;13469;43086;11426;38879;3682;13617;3649;12212;7331;25829
330350;201306;88394;293258;86444;290538;16948;56925;60897;209124;77845;266049
330360;201306;5201;16909;5086;16722;886;3202;3555;11575;4441;14777
330370;201306;3646;13900;3475;13445;1430;5754;1195;4656;2625;10410
330380;201306;3852;13016;3470;12386;1144;4300;1519;5557;2663;9857
330385;201306;3894;13861;3609;13261;1147;4531;1384;5051;2531;9582
330390;201306;22401;77502;20931;74628;5299;21099;10997;38424;16296;59523
330395;201306;3172;9883;2988;9567;524;1792;1899;6163;2423;7955
330400;201306;2430;8362;2221;7962;561;2275;1055;3500;1616;5775
330410;201306;2953;9662;2595;8900;643;2326;1238;4249;1881;6575
330411;201306;2424;7826;2204;7379;501;1951;1147;3602;1648;5553
330412;201306;1322;4675;1078;4201;251;1133;463;1728;714;2861
330414;201306;24973;72436;21473;67697;4529;15300;13156;41590;17685;56890
330415;201306;3591;11520;3201;10810;849;3223;1398;4680;2247;7903
330420;201306;6341;22004;5521;20294;1891;7618;1010;3786;2901;11404
330430;201306;7937;24079;7183;22723;1858;6537;3432;10513;5290;17050
330440;201306;2054;7057;1744;6412;591;2417;433;1526;1024;3943
330450;201306;1551;5553;1469;5371;500;2056;514;1807;1014;3863
330452;201306;10362;32532;8694;29176;2538;9455;3590;11483;6128;20938
330455;201306;436091;1324226;382054;1234992;106787;368676;195065;629727;301852;998403
330460;201306;1361;4723;1281;4567;383;1547;604;2108;987;3655
330470;201306;4067;13921;3881;13526;1542;5736;1075;3668;2617;9404
330475;201306;7764;25818;7198;24941;1840;6939;4069;14198;5909;21137
330480;201306;6389;19667;5994;18925;1783;6085;2338;7298;4121;13383
330490;201306;93392;270182;87901;262234;13533;42559;65367;195675;78900;238234
330500;201306;6535;20353;6135;19551;1505;5141;3054;10039;4559;15180
330510;201306;39534;132090;37672;128927;13867;48226;17388;61292;31255;109518
330513;201306;1561;4790;1446;4561;476;1562;673;2164;1149;3726
330515;201306;2786;9198;2633;8929;876;3178;1120;3758;1996;6936
330520;201306;12481;38554;11812;37613;2578;8709;7656;24631;10234;33340
330530;201306;1538;4678;1428;4488;389;1359;756;2280;1145;3639
330540;201306;3095;9750;2740;9202;924;3326;1026;3381;1950;6707
330550;201306;8681;29226;7808;27652;3116;11615;2193;7954;5309;19569
330555;201306;9973;31142;9090;29758;1917;6583;5741;19013;7658;25596
330560;201306;4014;12628;3771;12221;825;3125;2213;6979;3038;10104
330570;201306;3543;10495;3161;9885;813;2669;1721;5480;2534;8149
330575;201306;5185;16248;4860;15649;1122;3886;2940;9221;4062;13107
330580;201306;15517;51772;14033;48895;5177;18901;4776;17140;9953;36041
330590;201306;1902;5963;1798;5786;545;1833;888;2898;1433;4731
330600;201306;8859;27466;7730;25708;1268;5307;4976;15663;6244;20970
330610;201306;8535;28418;7901;27212;2351;8911;3631;12333;5982;21244
330615;201306;1674;6038;1554;5706;602;2274;648;2487;1250;4761
330620;201306;3854;13850;3583;13325;1292;4998;1259;4951;2551;9949
330630;201306;19444;66512;17978;63305;5465;21340;8232;27741;13697;49081
350010;201306;2834;9243;2324;8057;758;2830;449;1503;1207;4333
350020;201306;559;1675;458;1462;127;464;163;477;290;941
350030;201306;4092;13709;3802;13202;1491;5600;1340;4680;2831;10280
350040;201306;562;2099;499;1963;183;785;98;348;281;1133
350050;201306;1355;4555;1134;4135;326;1339;371;1248;697;2587
350055;201306;559;1975;540;1942;176;675;240;864;416;1539
350060;201306;78;269;71;256;23;104;22;64;45;168
350070;201306;2648;8984;2241;8075;596;2382;540;1769;1136;4151
350075;201306;469;1754;429;1662;169;708;122;425;291;1133
350080;201306;579;1759;486;1577;133;495;190;608;323;1103
350090;201306;570;1697;453;1498;136;476;144;463;280;939
350100;201306;1750;6315;1630;6063;635;2548;540;1952;1175;4500
350110;201306;445;1385;355;1179;110;407;112;332;222;739
350115;201306;1250;4245;1116;3890;282;1112;470;1504;752;2616
350120;201306;722;2085;562;1790;164;581;137;441;301;1022
350130;201306;3584;11298;3286;10722;922;3371;1362;4112;2284;7483
350140;201306;679;2161;615;2030;152;583;245;762;397;1345
350150;201306;388;1367;367;1316;163;612;80;283;243;895
350160;201306;6385;21184;5116;18360;1718;6777;1682;5538;3400;12315
350170;201306;2173;7897;1961;7355;770;3004;462;1649;1232;4653
350180;201306;1437;3818;1195;3400;296;885;532;1502;828;2387
350190;201306;2943;10422;2530;9571;907;3819;908;3132;1815;6951
350200;201306;392;1395;365;1361;147;608;139;496;286;1104
350210;201306;7259;21117;5967;18815;2430;8219;1914;5753;4344;13972
350220;201306;3063;10083;2773;9545;1047;4019;769;2380;1816;6399
350230;201306;722;2527;665;2432;243;964;205;753;448;1717
350240;201306;580;1806;509;1693;126;485;269;864;395;1349
350250;201306;2696;10164;2587;9940;1150;4678;809;3080;1959;7758
350260;201306;955;2667;866;2532;218;660;396;1211;614;1871
350270;201306;5084;16348;4644;15456;1278;4655;2115;6993;3393;11648
350275;201306;1927;6477;1733;6203;546;2150;717;2413;1263;4563
350280;201306;21373;58692;14182;44815;3940;13374;2955;9437;6895;22811
350290;201306;1451;5170;1349;4930;490;1885;456;1708;946;3593
350300;201306;475;1541;441;1463;159;572;128;423;287;995
350310;201306;990;3381;933;3259;251;1032;397;1319;648;2351
350315;201306;550;1788;454;1581;84;370;153;479;237;849
350320;201306;11647;39076;10670;36754;3580;13142;1933;6458;5513;19600
350330;201306;9205;28000;8333;26159;1812;6451;4762;14040;6574;20491
350335;201306;532;1587;492;1505;135;435;193;644;328;1079
350340;201306;995;3255;796;2879;264;1033;181;633;445;1666
350350;201306;741;2462;655;2327;200;808;247;867;447;1675
350360;201306;713;2582;635;2412;210;852;233;893;443;1745
350370;201306;685;2156;513;1737;112;420;119;359;231;779
350380;201306;3532;11702;2999;10887;1372;5322;612;2145;1984;7467
350390;201306;8241;27617;7503;26270;1846;7158;4039;13614;5885;20772
350395;201306;293;967;237;841;73;275;42;142;115;417
350400;201306;7714;23654;6529;21465;2118;7550;2321;7360;4439;14910
350410;201306;7028;26724;6377;25237;2429;10305;1717;6627;4146;16932
350420;201306;1004;3276;831;2926;407;1512;75;264;482;1776
350430;201306;883;2835;776;2647;225;902;384;1252;609;2154
350440;201306;1343;4463;1277;4346;473;1700;573;1918;1046;3618
350450;201306;7871;24780;6798;22704;2438;8815;1945;6309;4383;15124
350460;201306;1417;4293;1062;3530;345;1277;292;836;637;2113
350470;201306;205;648;186;619;56;211;76;232;132;443
350480;201306;761;2407;518;1799;104;418;92;265;196;683
350490;201306;2065;6073;1815;5771;451;1644;1144;3524;1595;5168
350500;201306;603;1834;534;1728;151;556;242;725;393;1281
350510;201306;1095;3589;966;3320;319;1247;353;1073;672;2320
350520;201306;1247;4920;1155;4726;466;1998;293;1175;759;3173
350530;201306;2424;7480;2026;6588;808;2840;525;1551;1333;4391
350535;201306;1451;4336;1418;4291;80;256;1255;3831;1335;4087
350540;201306;1996;5924;1747;5500;513;1797;730;2268;1243;4065
350550;201306;10612;32097;8660;28661;2737;10129;3104;9585;5841;19714
350560;201306;3320;11299;3083;10896;619;2348;1785;6497;2404;8845
350570;201306;19914;70767;18368;67140;6234;24323;6567;23081;12801;47404
350580;201306;1922;6511;1671;5977;540;2124;264;820;804;2944
350590;201306;3895;13212;3173;11579;1046;4217;1124;3758;2170;7975
350600;201306;31667;87292;23851;74577;5540;19166;11557;35179;17097;54345
350610;201306;8884;26653;7345;24177;2063;7665;3511;11121;5574;18786
350620;201306;422;1397;379;1316;94;370;162;537;256;907
350630;201306;1584;5139;1278;4534;419;1704;134;430;553;2134
350635;201306;4382;15014;3728;13709;1228;4713;1461;5494;2689;10207
350640;201306;668;2157;605;2012;198;716;247;794;445;1510
350650;201306;3750;12787;2946;10873;1215;4865;303;1093;1518;5958
350660;201306;3613;11980;3221;11277;917;3453;1501;5205;2418;8658
350670;201306;1809;5799;1705;5613;352;1347;1079;3383;1431;4730
350680;201306;1148;3654;943;3247;291;1185;378;1225;669;2410
350690;201306;1036;3574;890;3248;285;1159;212;709;497;1868
350700;201306;2760;9804;2457;9105;973;3967;888;2904;1861;6871
350710;201306;2040;6611;1862;6330;383;1494;1163;3868;1546;5362
350715;201306;1119;3489;995;3248;250;925;411;1270;661;2195
350720;201306;121;397;116;382;48;166;42;127;90;293
350730;201306;396;1573;384;1539;131;569;97;365;228;934
350740;201306;2273;7024;2059;6534;601;2081;816;2585;1417;4666
350745;201306;343;1112;291;993;69;278;134;411;203;689
350750;201306;9171;29266;7210;25222;2241;8621;1772;5834;4013;14455
350760;201306;11217;37172;10309;35552;3730;14247;4167;13602;7897;27849
350770;201306;851;2618;640;2181;154;601;222;738;376;1339
350775;201306;615;1856;556;1740;146;523;237;736;383;1259
350780;201306;1998;6258;1547;5296;364;1363;331;1108;695;2471
350790;201306;2029;6795;1696;6118;603;2298;374;1217;977;3515
350800;201306;2907;10159;2781;9933;727;2937;1552;5391;2279;8328
350810;201306;2566;7637;2256;7058;781;2660;776;2482;1557;5142
350820;201306;501;1442;394;1226;87;324;146;397;233;721
350830;201306;856;2805;633;2228;130;499;132;416;262;915
350840;201306;3010;11467;2621;10402;1026;4389;545;1984;1571;6373
350850;201306;6583;22694;5562;20155;1851;7142;1496;5164;3347;12306
350860;201306;3161;10722;3060;10572;556;2143;2203;7546;2759;9689
350870;201306;2315;8231;2115;7922;787;3108;1004;3787;1791;6895
350880;201306;1638;5658;1399;5104;460;1796;258;951;718;2747
350890;201306;615;1889;497;1633;105;369;156;433;261;802
350900;201306;4529;15440;3897;14127;1141;4498;1344;4583;2485;9081
350910;201306;860;2744;825;2669;370;1238;272;873;642;2111
350920;201306;9096;28366;8533;27448;1556;5652;5582;17322;7138;22974
350925;201306;5228;16685;4761;15779;1472;5374;2086;6716;3558;12090
350930;201306;1487;4284;1259;3900;176;659;856;2546;1032;3205
350940;201306;2274;7719;2087;7407;420;1778;1325;4490;1745;6268
350945;201306;919;3136;823;2932;248;973;320;1094;568;2067
350950;201306;67630;223653;58907;205686;18316;69662;23685;80333;42001;149995
350960;201306;4445;16083;3979;15062;880;3797;2070;7527;2950;11324
350970;201306;4043;15219;3744;14472;1545;6437;1163;4372;2708;10809
350980;201306;646;2138;607;2070;280;1027;119;414;399;1441
350990;201306;1713;6211;1547;5885;562;2312;555;2084;1117;4396
350995;201306;802;2973;763;2898;237;1011;351;1260;588;2271
351000;201306;3441;10892;3059;10122;568;2210;1753;5531;2321;7741
351010;201306;409;1285;310;1080;127;479;59;211;186;690
351015;201306;936;3184;824;2968;321;1311;230;746;551;2057
351020;201306;7480;25249;6699;24026;1882;7297;3565;12913;5447;20210
351030;201306;1281;4959;1200;4777;398;1720;414;1633;812;3353
351040;201306;3528;11705;3278;11268;848;3426;1897;6099;2745;9525
351050;201306;7799;26852;6828;24896;2630;10313;2269;8191;4899;18504
351060;201306;30610;98983;26140;90721;9335;34211;8707;30726;18042;64937
351070;201306;1717;5106;1310;4360;495;1799;249;742;744;2541
351080;201306;2712;8335;2142;7634;705;2722;835;2900;1540;5622
351090;201306;380;1358;310;1210;113;511;52;191;165;702
351100;201306;1762;5901;1674;5761;651;2291;684;2422;1335;4713
351110;201306;7056;21801;5700;19204;2065;7601;1735;5554;3800;13155
351120;201306;570;1811;491;1633;76;311;244;721;320;1032
351130;201306;847;2389;467;1604;118;468;110;326;228;794
351140;201306;1959;6965;1807;6648;716;2871;578;2077;1294;4948
351150;201306;2082;7346;1742;6460;527;2153;437;1478;964;3631
351160;201306;1469;5304;1336;4981;466;1936;444;1585;910;3521
351170;201306;1421;4916;1240;4476;382;1487;485;1628;867;3115
351190;201306;1071;3524;989;3311;282;1036;246;769;528;1805
351200;201306;2205;6740;1905;6170;363;1392;979;2912;1342;4304
351210;201306;948;3215;854;3013;306;1161;261;879;567;2040
351220;201306;3437;11831;3009;10901;940;3734;1117;3937;2057;7671
351230;201306;1824;6306;1654;5959;577;2280;717;2526;1294;4806
351240;201306;988;3336;732;2688;229;960;193;615;422;1575
351250;201306;812;2407;620;2013;140;503;288;900;428;1403
351260;201306;1192;3633;1061;3352;300;1037;402;1213;702;2250
351270;201306;379;1387;344;1313;129;557;110;379;239;936
351280;201306;4210;13696;3644;12300;1153;4142;1090;3349;2243;7491
351290;201306;961;3023;849;2790;294;1002;228;710;522;1712
351300;201306;9637;36434;8541;33817;2562;10962;3312;13056;5874;24018
351310;201306;3292;10595;2787;9649;763;3017;1293;4162;2056;7179
351320;201306;958;3533;873;3314;350;1446;192;640;542;2086
351330;201306;280;849;254;796;104;331;71;215;175;546
351340;201306;6360;22805;5837;21766;1721;6799;3035;11348;4756;18147
351350;201306;8880;30364;8107;28661;2683;9884;3076;10623;5759;20507
351360;201306;4806;15019;4551;14600;1239;4374;2372;7582;3611;11956
351370;201306;1876;6280;1532;5518;535;2155;364;1148;899;3303
351380;201306;35848;116025;33654;111479;9433;34223;15856;50337;25289;84560
351385;201306;244;792;239;783;97;323;80;267;177;590
351390;201306;1193;4155;1074;3898;440;1688;337;1172;777;2860
351400;201306;1195;3964;1128;3818;366;1329;444;1548;810;2877
351410;201306;2799;8916;2544;8442;638;2271;1230;4039;1868;6310
351420;201306;451;1343;314;1032;73;259;49;145;122;404
351430;201306;847;2771;767;2622;209;788;416;1379;625;2167
351440;201306;4597;14444;4095;13402;1658;5690;1093;3396;2751;9086
351450;201306;1792;5241;1587;4975;493;1575;847;2749;1340;4324
351460;201306;800;2585;668;2318;330;1232;185;586;515;1818
351470;201306;1059;3397;953;3196;410;1492;283;929;693;2421
351480;201306;2880;9707;2644;9311;711;3010;1269;4299;1980;7309
351490;201306;1913;6685;1737;6314;412;1756;925;3194;1337;4950
351492;201306;293;1024;222;826;54;236;59;173;113;409
351495;201306;147;529;130;481;44;169;46;168;90;337
351500;201306;18838;62831;17071;59399;5455;20308;7209;24703;12664;45011
351510;201306;7002;23518;6185;22183;1569;6157;3340;11871;4909;18028
351512;201306;324;1042;297;985;88;313;104;324;192;637
351515;201306;1800;6320;1595;5839;561;2200;456;1614;1017;3814
351518;201306;2046;7399;1647;6667;529;2309;290;1154;819;3463
351519;201306;735;2467;654;2288;195;780;284;958;479;1738
351520;201306;730;2158;381;1382;67;279;48;155;115;434
351530;201306;448;1459;405;1350;95;345;119;344;214;689
351535;201306;2498;6682;2095;6129;201;639;1621;4769;1822;5408
351540;201306;2047;6735;1868;6419;974;3507;369;1274;1343;4781
351550;201306;5577;17582;4477;15238;1708;6122;1095;3645;2803;9767
351560;201306;421;1419;370;1292;146;556;61;200;207;756
351565;201306;227;790;208;737;69;290;77;241;146;531
351570;201306;12587;42614;11161;39602;3816;13949;4609;16506;8425;30455
351580;201306;385;1133;302;936;55;187;114;319;169;506
351590;201306;444;1258;384;1117;142;446;87;241;229;687
351600;201306;1819;5476;1673;5196;448;1633;783;2185;1231;3818
351610;201306;628;1787;537;1622;120;411;271;779;391;1190
351620;201306;22672;77897;19086;69859;6672;26437;4796;16316;11468;42753
351630;201306;14185;49098;13072;47245;3569;13347;7379;27098;10948;40445
351640;201306;7984;27366;6953;25528;1965;7778;3513;12860;5478;20638
351650;201306;332;1035;239;804;62;237;55;169;117;406
351660;201306;882;2906;723;2525;177;694;198;616;375;1310
351670;201306;4045;13121;3500;12010;875;3406;1630;5272;2505;8678
351680;201306;704;2265;549;1877;160;585;122;384;282;969
351685;201306;431;1332;343;1177;105;379;118;415;223;794
351690;201306;1271;3802;1025;3277;480;1555;259;780;739;2335
351700;201306;1373;4284;1259;4071;433;1488;403;1253;836;2741
351710;201306;766;2464;650;2205;171;596;185;585;356;1181
351720;201306;1559;5105;1230;4225;294;1121;421;1394;715;2515
351730;201306;979;3244;944;3172;348;1271;360;1192;708;2463
351740;201306;4434;13103;3877;11940;1133;3715;1317;3813;2450;7528
351750;201306;1481;5013;1295;4601;413;1591;330;1091;743;2682
351760;201306;3734;12407;3333;11498;873;3285;1553;5196;2426;8481
351770;201306;2179;7289;1894;6761;745;2752;797;2859;1542;5611
351780;201306;1571;4611;1143;3717;347;1243;264;841;611;2084
351790;201306;1114;3444;961;3232;296;1084;478;1574;774;2658
351800;201306;297;754;261;685;41;143;161;371;202;514
351810;201306;1179;3690;1119;3617;293;1107;690;2098;983;3205
351820;201306;2451;7359;1741;6036;719;2667;215;698;934;3365
351830;201306;3827;12988;3523;12320;987;3823;1545;5198;2532;9021
351840;201306;8692;30810;7843;28997;2713;10681;2716;9877;5429;20558
351850;201306;1143;4081;1010;3784;321;1351;182;616;503;1967
351860;201306;3492;11426;3260;10981;775;2990;1877;6003;2652;8993
351870;201306;34349;109647;31908;105409;7283;26133;19644;64442;26927;90575
351880;201306;112430;376925;100182;351717;33915;125294;31583;110523;65498;235817
351885;201306;593;2267;553;2174;168;705;248;946;416;1651
351890;201306;827;2517;669;2160;242;825;150;466;392;1291
351900;201306;1434;4518;1283;4277;486;1721;493;1649;979;3370
351905;201306;345;1292;300;1204;115;510;87;315;202;825
351907;201306;13941;45817;12239;42364;3117;12077;5644;18698;8761;30775
351910;201306;1102;3644;1009;3462;265;1028;292;922;557;1950
351920;201306;1175;3478;1116;3391;277;961;672;1966;949;2927
351925;201306;971;2841;919;2751;111;435;687;1953;798;2388
351930;201306;3085;10876;2847;10349;905;3688;1129;3727;2034;7415
351940;201306;984;3066;932;2961;287;1014;544;1640;831;2654
351950;201306;978;3125;880;2933;235;859;367;1147;602;2006
351960;201306;3651;12139;3177;11173;1266;4702;1083;3726;2349;8428
351970;201306;6824;26443;6317;25351;2462;10420;2069;8212;4531;18632
351980;201306;883;2833;757;2598;181;721;321;1041;502;1762
351990;201306;1537;4567;1269;4027;383;1401;374;1045;757;2446
352000;201306;2376;7845;2189;7455;545;2034;1068;3507;1613;5541
352010;201306;2261;7859;2080;7413;795;2973;496;1801;1291;4774
352020;201306;1457;4830;1331;4577;433;1572;433;1515;866;3087
352030;201306;4267;13815;3919;13368;881;3245;2346;8148;3227;11393
352040;201306;1645;5957;1435;5410;461;1844;338;1198;799;3042
352042;201306;1877;5652;1540;4970;395;1422;807;2568;1202;3990
352044;201306;1294;4543;1092;4003;317;1259;260;886;577;2145
352050;201306;7097;24694;5331;20609;1714;7397;1097;3734;2811;11131
352060;201306;786;2415;709;2297;223;830;280;822;503;1652
352070;201306;705;1978;651;1888;305;959;173;533;478;1492
352080;201306;530;1688;457;1556;129;498;163;499;292;997
352090;201306;1658;5488;1387;4927;373;1519;479;1541;852;3060
352100;201306;1720;6070;1547;5718;550;2267;545;1787;1095;4054
352110;201306;406;1541;375;1477;119;529;113;406;232;935
352115;201306;333;1127;282;1014;89;363;129;426;218;789
352120;201306;969;2912;846;2743;192;647;508;1698;700;2345
352130;201306;1682;4828;1314;4227;345;1233;606;1805;951;3038
352140;201306;1127;3873;985;3550;335;1280;378;1341;713;2621
352150;201306;634;1922;530;1737;210;739;184;585;394;1324
352160;201306;1186;3508;1093;3367;288;976;581;1789;869;2765
352170;201306;3032;9607;2792;9200;812;2887;1303;4135;2115;7022
352180;201306;3377;9924;2983;9210;881;2973;1335;3939;2216;6912
352190;201306;1017;3239;928;3072;229;911;435;1292;664;2203
352200;201306;366;1288;316;1185;77;322;129;482;206;804
352210;201306;15364;42855;12416;38486;2580;8607;7439;23514;10019;32121
352215;201306;547;1803;492;1718;92;348;294;1050;386;1398
352220;201306;14658;50113;13777;48330;4736;17598;5724;20073;10460;37671
352230;201306;13307;46844;11891;44195;3931;15939;4612;16801;8543;32740
352240;201306;13255;42792;12375;41217;4299;15875;4942;15906;9241;31781
352250;201306;25006;83041;22392;78073;6194;23437;9939;34601;16133;58038
352260;201306;4701;15180;3639;13133;1094;4418;1056;3447;2150;7865
352265;201306;920;3023;814;2860;149;599;508;1755;657;2354
352270;201306;2491;8681;2193;7938;892;3401;496;1699;1388;5100
352280;201306;2414;7685;2092;7133;613;2311;723;2401;1336;4712
352290;201306;1282;4301;1130;3973;307;1219;324;1017;631;2236
352300;201306;890;2734;766;2517;252;884;326;1057;578;1941
352310;201306;30129;106206;27752;101991;8048;31812;15606;56136;23654;87948
352320;201306;6524;21128;5834;19881;2157;8031;1883;5911;4040;13942
352330;201306;2147;7294;1890;6986;735;2920;680;2531;1415;5451
352340;201306;5599;19611;4691;17376;1702;6773;961;3300;2663;10073
352350;201306;1657;6273;1510;5929;441;1878;499;1900;940;3778
352360;201306;1152;3948;1024;3677;301;1270;522;1721;823;2991
352370;201306;881;3033;811;2881;203;820;386;1335;589;2155
352380;201306;996;3264;874;3048;360;1388;253;845;613;2233
352390;201306;11775;37108;9570;32913;2544;10042;4163;13251;6707;23293
352400;201306;2862;8848;1983;7111;610;2414;824;2860;1434;5274
352410;201306;4191;12829;3339;11367;1321;4825;1001;3290;2322;8115
352420;201306;1272;3781;1186;3650;474;1608;425;1285;899;2893
352430;201306;6097;19703;5399;18496;2209;8165;1680;5603;3889;13768
352440;201306;14844;48294;12511;43633;3459;13097;5063;17116;8522;30213
352450;201306;593;1836;416;1499;114;434;86;297;200;731
352460;201306;2586;8973;2362;8576;900;3637;915;3096;1815;6733
352470;201306;4857;13929;3026;10107;644;2341;1364;4444;2008;6785
352480;201306;5342;15547;4492;13952;1282;4556;1901;5445;3183;10001
352490;201306;711;2610;603;2342;158;677;117;444;275;1121
352500;201306;9572;32479;9131;31711;3843;14440;3484;11295;7327;25735
352510;201306;3259;11645;2710;10433;1012;4171;672;2521;1684;6692
352520;201306;2378;8611;2185;8188;562;2290;1316;4855;1878;7145
352530;201306;7133;24108;5653;20814;1775;7067;1254;4372;3029;11439
352540;201306;498;1675;419;1504;109;434;159;574;268;1008
352550;201306;1020;3529;838;3135;318;1285;200;724;518;2009
352560;201306;538;1693;469;1567;95;378;227;688;322;1066
352570;201306;1679;5439;1215;4342;299;1201;330;1030;629;2231
352580;201306;914;2816;800;2615;288;1065;329;995;617;2060
352585;201306;195;649;163;585;40;167;57;174;97;341
352590;201306;13217;43933;11920;41458;2847;11147;6543;22122;9390;33269
352600;201306;1824;6043;1696;5758;616;2191;569;1869;1185;4060
352610;201306;3494;11601;3139;10999;1269;4798;1038;3601;2307;8399
352620;201306;5381;17709;5120;17344;1259;4550;3228;10921;4487;15471
352630;201306;823;2825;780;2723;245;939;358;1227;603;2166
352640;201306;2962;9748;2407;8448;597;2331;916;3101;1513;5432
352650;201306;819;2485;619;2076;163;597;168;511;331;1108
352660;201306;1069;3834;886;3402;303;1250;279;1048;582;2298
352670;201306;7647;26484;6744;24743;2560;9744;2088;7782;4648;17526
352680;201306;3107;11571;2671;10365;736;3146;808;2811;1544;5957
352690;201306;22840;70581;18747;62959;5311;19599;7928;25914;13239;45513
352700;201306;761;2330;610;2096;180;705;271;897;451;1602
352710;201306;4967;15212;3742;12712;1086;4108;1346;4300;2432;8408
352720;201306;8420;29308;7957;28374;2686;10225;3205;11338;5891;21563
352725;201306;398;1218;271;919;53;216;61;194;114;410
352730;201306;2463;8703;2158;7859;617;2454;653;2112;1270;4566
352740;201306;2174;6661;1901;6136;531;2056;850;2444;1381;4500
352750;201306;341;1132;306;1071;119;447;55;165;174;612
352760;201306;877;3153;820;3047;280;1128;412;1484;692;2612
352770;201306;908;2875;859;2778;250;876;316;1036;566;1912
352780;201306;590;2084;522;1925;170;698;159;518;329;1216
352790;201306;635;1895;522;1716;173;644;126;411;299;1055
352800;201306;1058;4132;887;3622;307;1293;152;579;459;1872
352810;201306;992;2701;759;2269;143;500;331;961;474;1461
352820;201306;514;1618;439;1473;204;737;72;240;276;977
352830;201306;400;1215;312;1016;96;322;48;151;144;473
352840;201306;3289;11801;2912;10963;921;3742;1050;3933;1971;7675
352850;201306;9477;31728;8400;29780;2654;9958;3006;10887;5660;20845
352860;201306;1020;3452;933;3249;403;1501;235;738;638;2239
352870;201306;966;2621;802;2310;149;549;420;1084;569;1633
352880;201306;2147;6667;1754;5777;442;1606;442;1287;884;2893
352885;201306;297;1041;282;1007;98;375;98;332;196;707
352890;201306;699;2068;613;1892;150;518;205;580;355;1098
352900;201306;17812;56243;14180;48656;4103;15239;5687;18822;9790;34061
352910;201306;284;935;249;855;81;291;35;100;116;391
352920;201306;3371;10577;2915;9669;979;3590;1007;3096;1986;6686
352930;201306;6840;22386;5475;19293;1759;6637;1018;3446;2777;10083
352940;201306;27107;94798;23962;87125;8871;33866;5030;17999;13901;51865
352950;201306;319;1028;232;838;68;294;63;207;131;501
352960;201306;481;1585;389;1364;88;342;96;317;184;659
352965;201306;351;1006;284;878;78;257;45;136;123;393
352970;201306;3302;8857;2938;8384;367;1115;2179;6347;2546;7462
352980;201306;1403;4295;1236;4017;424;1448;494;1635;918;3083
352990;201306;3540;12176;3322;11775;1176;4477;1263;4394;2439;8871
353000;201306;513;1471;398;1231;95;339;111;293;206;632
353010;201306;2817;8408;2265;7279;770;2734;786;2324;1556;5058
353020;201306;4236;12260;3234;10087;616;2140;1346;3881;1962;6021
353030;201306;4908;15123;4349;14008;1604;5558;1126;3450;2730;9008
353040;201306;667;1960;573;1807;206;703;197;610;403;1313
353050;201306;5197;18907;4695;17857;1940;7891;1473;5345;3413;13236
353060;201306;32169;107704;30067;104281;5836;23674;19603;65071;25439;88745
353070;201306;8330;29327;6654;25344;2468;9896;1563;6035;4031;15931
353080;201306;4566;16145;3874;14496;1365;5483;1066;3774;2431;9257
353090;201306;566;1959;504;1837;99;440;238;798;337;1238
353100;201306;260;792;215;688;98;312;40;128;138;440
353110;201306;7621;24463;6842;22996;1523;5442;3917;13409;5440;18851
353120;201306;469;1650;407;1499;154;638;95;312;249;950
353130;201306;2932;9306;2601;8723;1002;3675;956;3013;1958;6688
353140;201306;2449;7108;1979;6135;684;2301;554;1526;1238;3827
353150;201306;1872;6081;1586;5525;670;2467;352;1232;1022;3699
353160;201306;564;1783;483;1599;152;527;108;331;260;858
353170;201306;510;1865;466;1782;199;847;154;555;353;1402
353180;201306;4617;15331;4098;14338;832;3412;2373;7912;3205;11324
353190;201306;3482;11470;3061;10470;831;3153;1344;4190;2175;7343
353200;201306;815;2923;741;2757;233;984;274;961;507;1945
353205;201306;532;1743;428;1502;109;389;138;496;247;885
353210;201306;967;2698;812;2415;140;498;474;1356;614;1854
353215;201306;544;1768;476;1619;104;412;181;616;285;1028
353220;201306;886;2784;815;2643;227;815;311;979;538;1794
353230;201306;1165;3715;1091;3583;328;1191;407;1268;735;2459
353240;201306;2047;7112;1889;6782;650;2591;754;2495;1404;5086
353250;201306;1149;3343;989;3051;297;994;336;958;633;1952
353260;201306;1144;3448;1017;3237;343;1153;375;1151;718;2304
353270;201306;605;1886;527;1739;175;629;154;467;329;1096
353280;201306;528;1783;465;1675;164;628;127;455;291;1083
353282;201306;1695;5818;1650;5742;319;1228;1149;3937;1468;5165
353284;201306;332;983;268;868;90;312;84;263;174;575
353286;201306;142;435;96;324;27;88;19;66;46;154
353290;201306;426;1567;390;1489;166;667;140;524;306;1191
353300;201306;1861;6033;1681;5630;606;2196;557;1708;1163;3904
353310;201306;345;1102;327;1062;143;489;90;272;233;761
353320;201306;480;1382;422;1286;114;419;192;529;306;948
353325;201306;461;1680;393;1545;135;582;48;194;183;776
353330;201306;488;1529;410;1359;98;371;170;511;268;882
353340;201306;3043;10085;2619;9186;950;3585;846;2860;1796;6445
353350;201306;3259;10138;2895;9465;1023;3609;1290;4063;2313;7672
353360;201306;412;1475;362;1356;104;448;180;617;284;1065
353370;201306;691;2285;628;2144;197;716;286;972;483;1688
353380;201306;394;1339;355;1269;109;434;153;530;262;964
353390;201306;4839;13774;3864;11913;1063;3609;1484;4155;2547;7764
353400;201306;595;1877;505;1683;119;444;175;512;294;956
353410;201306;665;2108;571;1959;191;719;278;930;469;1649
353420;201306;601;1864;521;1641;173;578;158;458;331;1036
353430;201306;2426;8486;1876;6908;644;2428;134;413;778;2841
353440;201306;58085;194330;53377;183097;17342;62866;17996;60167;35338;123033
353450;201306;450;1418;405;1337;108;424;145;448;253;872
353460;201306;3849;11313;3397;10467;996;3312;1539;4677;2535;7989
353470;201306;10877;35386;8639;30571;2861;11079;2013;6915;4874;17994
353475;201306;1600;4799;1226;3959;352;1249;322;928;674;2177
353480;201306;1503;4632;1377;4398;326;1199;735;2215;1061;3414
353490;201306;1652;4835;1409;4356;399;1371;395;1112;794;2483
353500;201306;1157;3448;1078;3307;480;1559;358;1047;838;2606
353510;201306;1354;4493;1184;4037;337;1269;397;1208;734;2477
353520;201306;1116;3530;951;3215;402;1460;237;792;639;2252
353530;201306;2654;8250;2378;7736;703;2558;1011;3133;1714;5691
353540;201306;1865;5897;1719;5640;715;2442;594;1997;1309;4439
353550;201306;6506;19386;5833;18269;1289;4753;3141;9090;4430;13843
353560;201306;2310;7811;1988;7213;531;2218;784;2699;1315;4917
353570;201306;474;1545;395;1375;100;401;196;609;296;1010
353580;201306;2299;7763;2171;7525;817;3171;1064;3458;1881;6629
353590;201306;778;2284;667;2089;269;922;178;572;447;1494
353600;201306;1807;5395;1662;5141;401;1392;840;2596;1241;3988
353610;201306;564;2074;511;1978;178;775;193;735;371;1510
353620;201306;2283;8181;2113;7868;733;2991;776;2729;1509;5720
353625;201306;350;990;258;828;108;394;62;175;170;569
353630;201306;1797;6250;1497;5566;445;1847;350;1209;795;3056
353640;201306;1498;4366;1414;4222;421;1356;703;2153;1124;3509
353650;201306;4754;15475;3975;13737;1038;3884;1835;5969;2873;9853
353657;201306;283;974;260;920;68;282;91;300;159;582
353660;201306;1326;3464;1010;3023;468;1523;143;302;611;1825
353670;201306;4718;15921;4165;14701;1309;4992;1438;4867;2747;9859
353680;201306;613;2277;583;2218;335;1304;124;491;459;1795
353690;201306;489;1387;340;1127;119;447;106;315;225;762
353700;201306;2251;7503;2009;6958;518;2072;647;2061;1165;4133
353710;201306;1843;6724;1613;6191;628;2643;523;1954;1151;4597
353715;201306;469;1425;415;1337;67;251;238;772;305;1023
353720;201306;2047;6588;1815;6236;389;1323;1109;4017;1498;5340
353730;201306;4348;13945;3532;12023;952;3477;927;2966;1879;6443
353740;201306;2254;7049;1821;6129;668;2348;483;1567;1151;3915
353750;201306;590;2171;522;2016;187;777;129;504;316;1281
353760;201306;6381;21625;5356;19544;1739;6662;1995;7394;3734;14056
353770;201306;804;2553;559;1946;138;526;84;230;222;756
353780;201306;5584;20539;5120;19598;2568;10009;1192;4854;3760;14863
353790;201306;3066;11205;2760;10563;1041;4369;511;1998;1552;6367
353800;201306;13507;44954;11176;40298;3133;12451;4899;17243;8032;29694
353810;201306;1163;3932;1039;3649;331;1216;409;1450;740;2666
353820;201306;1164;4261;1116;4164;434;1787;391;1382;825;3169
353830;201306;769;2175;604;1851;133;446;256;780;389;1226
353850;201306;1768;6021;1652;5805;476;1804;748;2547;1224;4351
353860;201306;2333;8140;2020;7429;747;2981;716;2573;1463;5554
353870;201306;22829;74088;17814;63647;4458;17909;6322;20598;10780;38507
353880;201306;2569;8741;2364;8421;532;2178;1354;4675;1886;6853
353890;201306;2250;6088;1706;5219;546;1851;709;2036;1255;3887
353900;201306;1123;3603;852;2980;235;911;193;595;428;1506
353910;201306;2062;7420;1962;7141;654;2552;833;3040;1487;5592
353920;201306;2576;7868;2014;6691;503;1733;398;1240;901;2973
353930;201306;3591;13164;3176;12277;1234;5080;758;2802;1992;7882
353940;201306;1486;4859;1323;4534;353;1407;525;1638;878;3045
353950;201306;3587;12040;3310;11524;617;2473;2100;7102;2717;9575
353960;201306;568;1861;468;1622;123;476;132;389;255;865
353970;201306;518;1559;456;1477;52;206;337;1063;389;1269
353980;201306;13719;41349;11662;38117;3019;10646;6069;19580;9088;30226
353990;201306;511;1638;466;1523;148;539;167;484;315;1023
354000;201306;1821;5545;1273;4441;317;1236;126;383;443;1619
354010;201306;373;1209;335;1141;175;614;81;274;256;888
354020;201306;4569;14341;4177;13517;1416;4948;1717;5252;3133;10200
354025;201306;1039;3058;830;2672;230;823;212;657;442;1480
354030;201306;588;1594;434;1379;151;538;139;404;290;942
354040;201306;768;2142;623;1886;101;381;376;1059;477;1440
354050;201306;877;3048;816;2906;346;1314;223;786;569;2100
354060;201306;4076;13819;3425;12439;1045;4127;1358;4694;2403;8821
354070;201306;3477;11792;3064;10868;1196;4534;748;2625;1944;7159
354075;201306;2242;8626;2146;8453;772;3279;912;3525;1684;6804
354080;201306;1841;5762;1511;4963;427;1473;520;1612;947;3085
354085;201306;292;847;262;792;35;141;178;487;213;628
354090;201306;1068;3313;1027;3250;165;594;747;2299;912;2893
354100;201306;16405;57549;14297;53663;3800;15235;6914;25972;10714;41207
354105;201306;817;2682;686;2426;198;829;223;688;421;1517
354110;201306;747;2312;639;2133;179;655;203;637;382;1292
354120;201306;2144;6306;1892;5875;589;2039;647;1869;1236;3908
354130;201306;6085;19271;5468;18024;1965;6896;1862;5963;3827;12859
354140;201306;17082;47710;12020;37450;2539;8998;5225;15111;7764;24109
354150;201306;4285;12565;3565;11306;1154;4037;1379;4223;2533;8260
354160;201306;3862;13108;3459;12254;1053;4021;1399;4765;2452;8786
354165;201306;382;1452;351;1373;126;511;88;365;214;876
354170;201306;1591;5342;1315;4658;315;1260;468;1497;783;2757
354180;201306;499;1550;476;1502;47;173;351;1061;398;1234
354190;201306;1606;5526;1398;5036;487;1862;410;1414;897;3276
354200;201306;1126;3358;935;3005;231;898;361;1008;592;1906
354210;201306;845;3014;766;2828;201;870;308;1039;509;1909
354220;201306;2990;9730;2732;9226;1028;3674;1019;3351;2047;7025
354230;201306;767;2606;731;2549;246;915;335;1162;581;2077
354240;201306;1233;4323;1040;3908;330;1372;274;983;604;2355
354250;201306;481;1624;425;1555;196;784;116;398;312;1182
354260;201306;9240;28741;8417;27400;2675;9510;3481;11304;6156;20814
354270;201306;1100;3997;1025;3824;335;1381;402;1495;737;2876
354280;201306;871;2640;817;2547;177;618;432;1354;609;1972
354290;201306;1296;4722;1197;4504;417;1690;300;1108;717;2798
354300;201306;3818;13655;3733;13487;1051;4028;2000;7191;3051;11219
354310;201306;766;2606;607;2200;181;719;140;489;321;1208
354320;201306;807;2517;711;2324;219;800;236;718;455;1518
354323;201306;323;994;269;904;96;357;102;307;198;664
354325;201306;1283;4504;1174;4258;358;1463;421;1401;779;2864
354330;201306;7764;24872;7145;23681;1986;7043;3845;12544;5831;19587
354340;201306;28902;96823;25017;89591;9737;37424;8798;30595;18535;68019
354350;201306;1120;3488;1051;3359;319;1074;535;1644;854;2718
354360;201306;431;1443;361;1316;95;373;58;218;153;591
354370;201306;1141;3902;1029;3682;183;781;715;2481;898;3262
354380;201306;1291;3959;1085;3588;429;1581;191;553;620;2134
354390;201306;10893;36554;8482;30969;2363;9503;2683;9320;5046;18823
354400;201306;2065;7463;1825;6869;480;2000;587;2086;1067;4086
354410;201306;6158;19410;5269;18072;1317;4917;2887;9892;4204;14809
354420;201306;1638;4920;1403;4409;466;1571;456;1371;922;2942
354425;201306;3434;10206;3012;9446;1096;3651;951;3059;2047;6710
354430;201306;1282;4331;1189;4192;305;1204;597;2049;902;3253
354440;201306;487;1541;414;1396;113;418;145;465;258;883
354450;201306;437;1292;325;1037;56;229;98;270;154;499
354460;201306;712;2275;675;2208;268;910;334;1088;602;1998
354470;201306;428;1308;369;1191;72;294;164;482;236;776
354480;201306;728;2261;652;2126;152;584;291;829;443;1413
354490;201306;713;2491;550;2070;155;642;168;551;323;1193
354500;201306;2509;8676;2305;8293;873;3449;726;2632;1599;6081
354510;201306;648;2262;579;2101;208;807;197;703;405;1510
354515;201306;329;1174;274;1052;76;327;85;298;161;625
354520;201306;5016;18330;4332;16715;1475;6290;1459;5400;2934;11690
354530;201306;2583;9628;2424;9308;721;2953;1289;4955;2010;7908
354540;201306;1338;4285;1182;4010;409;1458;422;1491;831;2949
354550;201306;517;1798;457;1635;103;392;162;544;265;936
354560;201306;1329;4143;1072;3552;344;1169;306;983;650;2152
354570;201306;590;1893;494;1656;193;702;118;377;311;1079
354580;201306;8612;26308;7395;23893;1721;6349;3635;11068;5356;17417
354600;201306;1669;5940;1492;5587;514;2191;594;2094;1108;4285
354610;201306;471;1334;337;1074;77;257;96;268;173;525
354620;201306;409;1461;339;1330;103;467;109;397;212;864
354625;201306;271;923;233;846;57;234;61;213;118;447
354630;201306;1774;6372;1599;5936;660;2467;500;1771;1160;4238
354640;201306;4067;13931;3520;12727;1108;4505;828;2772;1936;7277
354650;201306;972;3031;879;2831;191;713;474;1463;665;2176
354660;201306;1902;5913;1502;5123;544;2069;480;1542;1024;3611
354670;201306;1730;5841;1400;4986;429;1673;372;1154;801;2827
354680;201306;5066;17628;4714;16860;1441;5477;1807;6336;3248;11813
354690;201306;622;2358;516;2052;129;549;174;623;303;1172
354700;201306;1154;3372;820;2643;144;576;346;971;490;1547
354710;201306;613;1882;536;1739;150;574;183;533;333;1107
354720;201306;183;540;146;461;57;178;40;132;97;310
354730;201306;7151;26100;6446;24601;2140;8654;2470;9203;4610;17857
354740;201306;228;768;194;692;49;185;44;155;93;340
354750;201306;2256;7425;1924;6952;693;2701;666;2369;1359;5070
354760;201306;2124;7249;1848;6629;664;2542;493;1700;1157;4242
354765;201306;246;695;184;589;38;149;43;118;81;267
354770;201306;2716;8220;2200;7350;1016;3645;370;1161;1386;4806
354780;201306;31674;105938;29930;101843;8166;30568;14801;48021;22967;78589
354790;201306;871;2878;790;2762;237;922;409;1345;646;2267
354800;201306;1938;6255;1784;6036;618;2212;920;3142;1538;5354
354805;201306;838;2685;659;2292;132;523;129;413;261;936
354810;201306;646;2195;525;1960;212;857;85;306;297;1163
354820;201306;1014;3736;923;3541;307;1333;224;781;531;2114
354830;201306;422;1350;380;1270;105;400;145;464;250;864
354840;201306;782;2419;731;2314;242;830;243;739;485;1569
354850;201306;14461;48503;11452;42046;3452;14074;3961;13594;7413;27668
354860;201306;1227;4117;1120;3928;345;1442;480;1553;825;2995
354870;201306;41503;137467;39310;132932;12043;43883;19833;65119;31876;109002
354880;201306;3926;12739;2944;10507;947;3694;712;2303;1659;5997
354890;201306;14415;45659;12544;41873;3708;13708;4588;14612;8296;28320
354900;201306;596;1705;483;1544;173;607;169;540;342;1147
354910;201306;4846;16248;3769;13854;1097;4421;559;1965;1656;6386
354920;201306;486;1457;377;1251;114;405;90;287;204;692
354925;201306;362;1070;215;752;41;158;41;128;82;286
354930;201306;248;770;228;721;74;269;60;181;134;450
354940;201306;2483;8887;1962;7477;854;3422;347;1272;1201;4694
354950;201306;1434;4902;1315;4731;257;1086;811;2834;1068;3920
354960;201306;778;2490;689;2349;189;728;362;1195;551;1923
354970;201306;3890;13447;3453;12526;919;3765;1634;5630;2553;9395
354980;201306;32329;81990;18165;57069;4240;14793;6079;17754;10319;32547
354990;201306;33253;116346;31296;112213;7667;30632;16904;58801;24571;89433
354995;201306;1912;6145;1807;5985;500;1754;900;2994;1400;4748
355000;201306;1616;5592;1432;5265;564;2205;397;1445;961;3650
355010;201306;3420;11096;3044;10381;774;2943;1517;5043;2291;7986
355020;201306;3132;11643;2753;10890;1393;5800;754;3028;2147;8828
355030;201306;746342;2295156;693347;2190849;209166;714143;278773;862644;487939;1576787
355040;201306;2753;9410;2467;8861;943;3715;1056;3619;1999;7334
355050;201306;1202;3957;1013;3561;310;1193;279;949;589;2142
355060;201306;4697;16605;3824;14525;1172;4936;794;2718;1966;7654
355070;201306;6049;19825;5462;18829;1381;5462;2877;9381;4258;14843
355080;201306;1254;4773;1080;4298;427;1885;160;544;587;2429
355090;201306;1048;3884;899;3521;209;894;396;1491;605;2385
355100;201306;29000;96565;26149;91409;9610;35130;8796;31708;18406;66838
355110;201306;1272;4539;1168;4312;421;1690;395;1411;816;3101
355120;201306;636;2087;561;1933;177;666;236;788;413;1454
355130;201306;429;1253;337;1064;102;349;98;258;200;607
355140;201306;991;3665;954;3578;294;1214;443;1610;737;2824
355150;201306;3137;11146;2840;10524;1002;3873;1057;3774;2059;7647
355160;201306;1456;5221;1285;4928;565;2396;347;1184;912;3580
355170;201306;8446;25984;6576;22472;2354;8702;1898;6277;4252;14979
355180;201306;2796;8988;2474;8395;775;2992;917;2970;1692;5962
355190;201306;1237;4460;1148;4259;488;1868;329;1175;817;3043
355200;201306;883;3375;846;3294;422;1726;205;779;627;2505
355210;201306;2658;9466;2416;8928;788;3261;902;3073;1690;6334
355220;201306;27841;98135;25908;94343;11972;45047;7403;27782;19375;72829
355230;201306;969;3041;657;2309;132;539;163;496;295;1035
355240;201306;20995;66593;16415;56156;4116;15824;6583;20782;10699;36606
355250;201306;23257;81028;21327;77355;6422;24911;10228;36696;16650;61607
355255;201306;865;2472;636;1977;125;447;188;535;313;982
355260;201306;1556;4609;1408;4338;398;1379;595;1718;993;3097
355270;201306;1618;5103;1535;4968;246;999;1071;3271;1317;4270
355280;201306;21284;66989;19266;63160;5272;19401;8805;27749;14077;47150
355290;201306;850;2798;786;2680;174;665;377;1213;551;1878
355300;201306;837;2847;671;2467;169;681;157;533;326;1214
355310;201306;1009;3223;911;3039;264;907;393;1363;657;2270
355320;201306;713;2362;633;2171;195;740;217;643;412;1383
355330;201306;1460;5496;1266;5110;516;2299;311;1143;827;3442
355340;201306;2877;8114;2721;7849;730;2375;1455;3954;2185;6329
355350;201306;1308;4868;1200;4616;451;1862;296;1180;747;3042
355360;201306;1085;3927;1026;3808;287;1188;631;2285;918;3473
355365;201306;311;1001;264;904;79;307;69;226;148;533
355370;201306;6630;17917;4986;16045;2017;7081;1838;5915;3855;12996
355380;201306;3645;11378;2868;9561;862;3105;623;1852;1485;4957
355385;201306;945;3232;913;3180;387;1479;255;848;642;2327
355390;201306;1397;4013;1208;3622;335;1079;411;1214;746;2293
355395;201306;1468;4754;1227;4152;236;931;563;1747;799;2678
355400;201306;8477;30158;7861;28896;2430;9865;3968;14117;6398;23982
355410;201306;12103;45929;11498;44674;4795;19675;3395;13333;8190;33008
355420;201306;802;3002;770;2934;332;1313;252;986;584;2299
355430;201306;3521;10794;3095;10011;940;3344;1247;3880;2187;7224
355440;201306;850;2917;713;2557;226;855;204;652;430;1507
355450;201306;2426;8303;2060;7545;674;2684;612;2117;1286;4801
355460;201306;552;1641;430;1406;126;484;121;347;247;831
355465;201306;422;1290;360;1171;108;381;97;302;205;683
355470;201306;909;2910;744;2618;292;1137;222;726;514;1863
355475;201306;140;542;120;477;31;129;37;161;68;290
355480;201306;3161;11804;2978;11383;996;4119;1255;4649;2251;8768
355490;201306;774;2347;626;2046;190;680;140;459;330;1139
355495;201306;688;2359;663;2317;211;811;270;902;481;1713
355500;201306;8027;25084;5733;19878;1485;5700;1169;3710;2654;9410
355510;201306;1635;5079;1404;4562;344;1280;385;1183;729;2463
355520;201306;368;1014;266;808;69;246;75;194;144;440
355530;201306;151;443;105;348;27;100;22;74;49;174
355535;201306;733;2292;610;2055;180;719;194;560;374;1279
355540;201306;9849;32896;9370;32073;2717;10043;4782;16086;7499;26129
355550;201306;697;2267;657;2187;201;747;302;969;503;1716
355560;201306;1421;4283;1112;3682;280;1045;286;833;566;1878
355570;201306;183;636;161;575;50;192;36;113;86;305
355580;201306;1194;3717;1047;3410;440;1570;322;1001;762;2571
355590;201306;240;691;217;650;49;176;110;322;159;498
355600;201306;982;3335;848;3028;395;1486;203;688;598;2174
355610;201306;1410;4221;1208;3905;383;1350;492;1527;875;2877
355620;201306;3713;12374;3050;10865;784;3218;1266;4098;2050;7316
355630;201306;3168;9425;2047;7035;443;1733;764;2442;1207;4175
355635;201306;952;3252;845;3058;221;885;437;1533;658;2418
355640;201306;3708;12684;3188;11462;1216;4563;628;2259;1844;6822
355645;201306;3322;12293;3174;11998;707;2963;1931;7202;2638;10165
355650;201306;6276;20487;5545;19040;1410;5744;3067;9734;4477;15478
355660;201306;1260;4205;1054;3789;369;1497;337;1114;706;2611
355670;201306;1997;6678;1420;5267;407;1718;438;1416;845;3134
355680;201306;1689;5983;1430;5341;598;2340;287;1027;885;3367
355690;201306;346;1218;314;1159;201;771;24;70;225;841
355695;201306;326;1001;241;794;43;158;32;84;75;242
355700;201306;6139;22601;5714;21536;1799;7428;2524;9066;4323;16494
355710;201306;11603;31226;7882;24396;2823;9289;1948;5874;4771;15163
355715;201306;185;606;147;531;46;175;28;99;74;274
355720;201306;1520;5182;1295;4702;483;1934;378;1230;861;3164
355730;201306;762;2710;695;2579;291;1146;167;633;458;1779
410010;201306;1576;5184;1472;4987;424;1520;635;2191;1059;3711
410020;201306;1174;4168;1113;4065;380;1459;388;1387;768;2846
410030;201306;1130;4053;1002;3745;368;1460;209;798;577;2258
410040;201306;11888;41214;11080;39601;4296;16434;3138;11106;7434;27540
410045;201306;1064;3177;820;2726;261;918;332;1071;593;1989
410050;201306;2847;8581;2085;7133;753;2820;623;2058;1376;4878
410060;201306;1812;6021;1656;5686;510;1968;593;1959;1103;3927
410070;201306;2061;6073;1754;5449;695;2372;340;923;1035;3295
410080;201306;1372;4296;1201;4007;305;1083;684;2250;989;3333
410090;201306;1102;3618;1004;3407;387;1418;300;967;687;2385
410100;201306;2752;8608;2288;7644;724;2769;537;1710;1261;4479
410105;201306;488;1627;402;1414;112;455;76;237;188;692
410110;201306;2235;7249;2055;6882;567;2145;819;2691;1386;4836
410115;201306;522;1502;455;1363;116;421;144;364;260;785
410120;201306;2813;9944;2679;9733;1092;4214;1040;3841;2132;8055
410130;201306;1332;4626;1229;4383;329;1130;660;2413;989;3543
410140;201306;13486;39834;10201;33554;3522;12812;3580;11611;7102;24423
410150;201306;16766;44408;8773;27550;1984;7128;1748;4938;3732;12066
410160;201306;3226;10696;2960;10232;1009;3821;1092;3812;2101;7633
410165;201306;734;2327;653;2142;139;500;327;1039;466;1539
410170;201306;1566;5009;1368;4581;555;2016;387;1245;942;3261
410180;201306;8317;27600;7338;25467;2021;8022;3396;10946;5417;18968
410185;201306;649;1844;598;1761;136;424;373;1116;509;1540
410190;201306;2115;6532;1948;6185;663;2283;588;1770;1251;4053
410200;201306;4921;14562;4166;13110;1542;5346;761;2314;2303;7660
410210;201306;2549;7942;2067;6902;557;2117;437;1278;994;3395
410220;201306;591;1779;488;1572;105;368;183;570;288;938
410230;201306;1759;5865;1649;5690;677;2537;556;1857;1233;4394
410240;201306;4918;15862;4614;15244;1588;5648;1705;5594;3293;11242
410250;201306;2357;6923;1804;5823;623;2243;374;1069;997;3312
410260;201306;1607;5134;1440;4841;460;1654;503;1665;963;3319
410270;201306;514;1567;452;1452;160;559;175;570;335;1129
410275;201306;859;2627;671;2287;117;446;386;1324;503;1770
410280;201306;2693;8275;1926;6573;488;1892;306;1002;794;2894
410290;201306;3042;9857;2771;9358;820;3000;1154;3915;1974;6915
410300;201306;592;1758;541;1654;92;346;307;867;399;1213
410302;201306;532;1638;475;1556;57;186;318;1067;375;1253
410304;201306;1387;4742;1289;4550;393;1428;573;2092;966;3520
410305;201306;2080;5783;1795;5365;564;1779;931;2843;1495;4622
410310;201306;2214;7703;2059;7400;706;2735;695;2588;1401;5323
410315;201306;592;1935;507;1768;137;524;228;764;365;1288
410320;201306;1171;3530;847;2890;213;857;97;269;310;1126
410322;201306;531;1639;414;1369;120;425;119;382;239;807
410330;201306;1389;4105;1215;3755;387;1309;358;1062;745;2371
410335;201306;1021;3116;880;2853;263;979;304;914;567;1893
410337;201306;744;2087;657;1937;145;507;280;771;425;1278
410340;201306;566;1770;435;1427;91;343;104;285;195;628
410345;201306;1644;5098;1433;4701;509;1831;322;977;831;2808
410347;201306;798;2332;596;1947;200;726;116;332;316;1058
410350;201306;924;3039;741;2681;244;972;109;364;353;1336
410360;201306;3205;10230;2940;9784;1043;3759;832;2815;1875;6574
410370;201306;12107;36732;9539;31388;2762;10251;2764;8488;5526;18739
410380;201306;1293;4214;1207;4044;326;1172;614;2051;940;3223
410390;201306;2734;8240;2254;7402;863;3028;650;1983;1513;5011
410395;201306;849;3024;790;2897;210;846;415;1522;625;2368
410400;201306;4938;16448;4407;15374;1485;5767;1273;4305;2758;10072
410405;201306;918;2805;759;2480;198;758;328;994;526;1752
410410;201306;1314;4617;1259;4515;483;1900;320;1106;803;3006
410420;201306;9458;31707;8530;29624;3054;11583;2442;8029;5496;19612
410425;201306;3596;11871;2800;10060;830;3315;470;1655;1300;4970
410430;201306;14259;41199;11215;35589;3565;12381;3355;10605;6920;22986
410440;201306;3437;11320;3207;10913;844;3019;1616;5601;2460;8620
410442;201306;2862;10249;2666;9784;968;3762;904;3320;1872;7082
410445;201306;2267;7966;2000;7476;649;2581;825;3214;1474;5795
410450;201306;2462;7343;2088;6637;696;2407;567;1669;1263;4076
410460;201306;2260;7014;1921;6297;525;1855;751;2388;1276;4243
410465;201306;1631;6360;1512;6062;625;2591;434;1653;1059;4244
410470;201306;1823;5965;1661;5614;492;1749;638;2160;1130;3909
410480;201306;27302;83686;23344;76043;9324;33205;6400;19962;15724;53167
410490;201306;10478;35960;9253;33228;3188;12393;3141;11250;6329;23643
410500;201306;1349;4511;1217;4238;456;1733;331;1172;787;2905
410510;201306;2188;6103;1717;5200;493;1628;692;1971;1185;3599
410520;201306;3138;11262;3002;10985;1198;4609;1022;3771;2220;8380
410530;201306;1572;4666;1354;4226;375;1351;521;1508;896;2859
410540;201306;3727;11145;2778;9399;761;2769;1040;3543;1801;6312
410550;201306;6095;19578;4915;16895;1686;6393;707;2202;2393;8595
410560;201306;1165;3941;954;3374;253;951;233;693;486;1644
410570;201306;2645;9096;2445;8746;744;2742;1087;4111;1831;6853
410580;201306;24026;78918;21715;74284;7805;29175;6651;21818;14456;50993
410590;201306;1189;3936;856;2993;177;708;219;683;396;1391
410600;201306;1747;5536;1555;5152;472;1631;711;2403;1183;4034
410610;201306;803;2584;724;2432;222;804;304;980;526;1784
410620;201306;1660;6152;1522;5796;534;2159;408;1532;942;3691
410630;201306;2412;7354;2133;6839;605;2203;913;2862;1518;5065
410640;201306;4470;13844;3830;12689;1382;5157;941;2957;2323;8114
410645;201306;1251;4563;1208;4470;492;1963;398;1493;890;3456
410650;201306;2371;7517;2033;6852;760;2687;607;2001;1367;4688
410655;201306;858;2752;757;2540;247;901;217;710;464;1611
410657;201306;533;1730;497;1659;157;611;198;600;355;1211
410660;201306;3682;10992;2975;9468;1131;3847;626;1863;1757;5710
410670;201306;970;2873;755;2433;217;782;213;649;430;1431
410680;201306;2200;8034;1913;7245;562;2180;721;2869;1283;5049
410685;201306;638;1990;602;1926;127;409;386;1250;513;1659
410690;201306;112529;335979;82781;275009;22705;84146;23010;69119;45715;153265
410700;201306;2159;7362;2050;7143;745;2821;768;2556;1513;5377
410710;201306;1037;3381;869;2975;224;873;249;809;473;1682
410712;201306;714;2293;644;2149;311;1127;167;581;478;1708
410715;201306;1043;3377;929;3131;265;967;325;1076;590;2043
410720;201306;3714;12180;3256;11181;995;3625;998;3309;1993;6934
410725;201306;1040;3039;819;2636;225;783;277;804;502;1587
410730;201306;681;2122;630;2017;285;973;166;510;451;1483
410740;201306;881;2753;651;2277;168;670;272;934;440;1604
410750;201306;1727;5409;1567;5025;560;2011;449;1307;1009;3318
410752;201306;231;734;217;714;54;211;110;334;164;545
410753;201306;485;1547;412;1395;110;432;149;462;259;894
410754;201306;986;3174;877;2988;145;547;570;2005;715;2552
410755;201306;611;1848;537;1717;138;511;243;713;381;1224
410760;201306;2354;7922;2257;7732;915;3288;801;2723;1716;6011
410765;201306;14686;45426;11636;39280;3149;11814;2403;8039;5552;19853
410770;201306;815;2404;710;2211;226;781;275;826;501;1607
410773;201306;1183;3880;1074;3667;303;1151;469;1490;772;2641
410775;201306;1761;5383;1731;5340;424;1235;1167;3763;1591;4998
410780;201306;598;1913;528;1772;153;539;150;539;303;1078
410785;201306;884;2972;732;2511;266;939;269;934;535;1873
410790;201306;716;2279;622;2060;223;826;137;399;360;1225
410800;201306;2071;6234;1828;5842;834;2861;525;1612;1359;4473
410810;201306;297;927;240;795;32;131;101;321;133;452
410820;201306;1016;3193;916;2973;288;1032;273;862;561;1894
410830;201306;28990;91476;24866;83902;7837;28802;8709;29182;16546;57984
410832;201306;1124;3474;1039;3313;244;919;514;1516;758;2435
410840;201306;7465;24532;6703;22868;2429;9084;1645;5182;4074;14266
410845;201306;1538;4780;1360;4412;296;1044;737;2397;1033;3441
410850;201306;2596;7927;2388;7644;516;1944;1336;4217;1852;6161
410855;201306;686;2033;618;1902;179;595;218;677;397;1272
410860;201306;3098;9591;2804;9072;775;2619;1313;4380;2088;6999
410865;201306;1593;5699;1447;5400;273;1097;863;3300;1136;4397
410870;201306;1353;4361;1293;4259;611;2192;374;1167;985;3359
410880;201306;4969;14999;4135;13472;1348;4933;1202;3671;2550;8604
410890;201306;1074;3412;841;2972;304;1183;113;336;417;1519
410895;201306;1200;4357;1106;4130;413;1616;341;1238;754;2854
410900;201306;825;2421;654;2144;144;533;194;610;338;1143
410910;201306;301;967;266;902;64;234;120;389;184;623
410920;201306;783;2506;645;2247;203;759;172;553;375;1312
410930;201306;1987;6495;1781;6157;554;2190;684;2287;1238;4477
410940;201306;19541;68994;18021;66218;6075;24217;7971;29441;14046;53658
410950;201306;1863;6358;1713;6077;377;1386;1031;3736;1408;5122
410960;201306;5806;17176;4336;14618;1590;5715;1406;4896;2996;10611
410965;201306;1024;3479;945;3321;236;891;507;1828;743;2719
410970;201306;4859;15363;4171;13946;1498;5597;968;3269;2466;8866
410975;201306;1310;4034;1133;3712;210;808;594;1947;804;2755
410980;201306;4805;14810;3431;11809;999;3821;865;2778;1864;6599
410990;201306;1005;3192;788;2703;271;1046;184;538;455;1584
411000;201306;375;1212;299;1039;79;301;51;162;130;463
411005;201306;448;1384;370;1191;98;312;73;213;171;525
411007;201306;2094;6973;2000;6818;629;2267;1022;3597;1651;5864
411010;201306;3588;12642;3396;12235;1470;5754;925;3178;2395;8932
411020;201306;2514;8389;2332;8068;800;3048;886;3084;1686;6132
411030;201306;797;2284;702;2115;236;786;195;540;431;1326
411040;201306;333;1110;286;998;107;388;62;212;169;600
411050;201306;2085;7773;1905;7342;777;3195;422;1618;1199;4813
411060;201306;2036;6649;1803;6167;623;2387;330;1028;953;3415
411065;201306;370;1156;299;1008;50;186;109;331;159;517
411070;201306;3681;12565;2927;10948;1014;4190;363;1247;1377;5437
411080;201306;1899;6209;1790;5975;477;1764;822;2698;1299;4462
411090;201306;1027;2943;893;2758;260;924;263;751;523;1675
411095;201306;1528;4559;1229;3995;344;1238;317;994;661;2232
411100;201306;1476;4348;1136;3686;287;1049;275;877;562;1926
411110;201306;896;2762;713;2380;218;783;133;373;351;1156
411120;201306;1603;5235;1445;4889;488;1781;461;1534;949;3315
411125;201306;4551;15123;4439;14900;1602;5655;2135;7108;3737;12763
411130;201306;727;2289;628;2083;207;717;227;768;434;1485
411140;201306;2193;8105;1971;7538;774;3065;495;2072;1269;5137
411150;201306;5592;16525;5028;15492;1606;5378;1477;4225;3083;9603
411155;201306;1099;3411;1007;3201;379;1311;302;881;681;2192
411160;201306;297;912;270;861;117;391;80;245;197;636
411170;201306;758;2666;697;2513;223;850;218;773;441;1623
411180;201306;5847;18596;5241;17506;1734;6342;1636;5455;3370;11797
411190;201306;1738;5293;1477;4805;469;1689;435;1341;904;3030
411200;201306;3612;12013;3247;11409;1297;4928;1117;3885;2414;8813
411210;201306;2731;8068;2265;7228;911;3173;310;918;1221;4091
411220;201306;1132;3401;931;3026;266;985;377;1111;643;2096
411230;201306;947;3005;802;2699;289;1065;223;702;512;1767
411240;201306;802;2595;729;2437;327;1181;172;506;499;1687
411250;201306;3055;8739;2544;7782;784;2482;827;2540;1611;5022
411260;201306;256;749;205;662;66;247;90;268;156;515
411270;201306;1970;6445;1830;6202;626;2368;773;2532;1399;4900
411275;201306;1500;4636;1375;4385;437;1465;490;1545;927;3010
411280;201306;1676;5307;1361;4631;430;1654;212;660;642;2314
411290;201306;1005;2923;851;2626;235;777;311;990;546;1767
411295;201306;1065;3292;995;3183;216;772;451;1411;667;2183
411300;201306;1344;3568;944;2793;88;308;389;1061;477;1369
411310;201306;816;2441;661;2177;167;646;301;951;468;1597
411320;201306;5533;17580;4624;15743;1344;4804;1330;4403;2674;9207
411325;201306;1475;5014;1348;4764;170;710;934;3327;1104;4037
411330;201306;3364;11445;3111;11016;1203;4596;1007;3538;2210;8134
411340;201306;935;2804;650;2132;133;488;262;866;395;1354
411342;201306;874;2575;730;2243;205;707;224;613;429;1320
411345;201306;996;3361;937;3248;278;1039;477;1651;755;2690
411350;201306;2420;7930;1956;6995;684;2621;285;938;969;3559
411360;201306;496;1287;327;968;39;159;162;410;201;569
411370;201306;40630;121859;31184;103650;7649;29921;10490;31843;18139;61764
411373;201306;1343;4442;1164;4049;351;1392;264;861;615;2253
411375;201306;1285;3684;1039;3193;309;993;288;847;597;1840
411380;201306;1216;3288;778;2390;164;575;232;689;396;1264
411390;201306;1706;5485;1579;5306;250;990;1151;3737;1401;4727
411400;201306;1513;4737;1305;4292;332;1208;482;1577;814;2785
411410;201306;2316;7447;2085;6937;743;2845;596;1688;1339;4533
411420;201306;4305;12803;3530;11220;1113;3968;827;2386;1940;6354
411430;201306;2609;8835;2314;8281;700;2718;1033;3574;1733;6292
411435;201306;520;1762;460;1608;138;523;146;490;284;1013
411440;201306;2480;8422;2291;8064;869;3306;694;2452;1563;5758
411450;201306;1776;5704;1629;5454;438;1526;841;2891;1279;4417
411460;201306;3790;12709;3306;11577;1444;5339;608;2049;2052;7388
411470;201306;881;2787;700;2362;218;777;145;464;363;1241
411480;201306;4294;13764;3673;12573;1705;6282;798;2614;2503;8896
411490;201306;1594;5234;1440;4946;649;2475;321;1008;970;3483
411500;201306;1315;4206;1068;3623;377;1388;249;812;626;2200
411510;201306;2374;7138;1947;6330;650;2337;400;1149;1050;3486
411520;201306;26381;77595;18603;61300;6429;23511;3912;12096;10341;35607
411530;201306;841;2497;603;2048;272;1025;114;343;386;1368
411535;201306;467;1458;281;1010;66;256;24;72;90;328
411540;201306;2605;7469;2143;6643;481;1636;1078;3410;1559;5046
411545;201306;935;3474;913;3426;212;873;596;2220;808;3093
411550;201306;659;1916;552;1745;256;865;114;347;370;1212
411560;201306;2466;7666;2134;6903;619;2206;545;1636;1164;3842
411570;201306;4648;14067;3973;12982;1406;5029;1088;3728;2494;8757
411573;201306;942;3059;904;2998;243;860;470;1593;713;2453
411575;201306;1334;4480;1215;4188;352;1302;470;1614;822;2916
411580;201306;3222;10107;2600;8864;662;2625;505;1543;1167;4168
411585;201306;408;1479;334;1255;96;385;40;131;136;516
411590;201306;548;1692;497;1584;144;531;131;388;275;919
411600;201306;333;1044;283;939;68;279;62;201;130;480
411605;201306;2152;6326;1706;5487;489;1751;679;2108;1168;3859
411610;201306;2128;6427;2038;6279;497;1632;1317;4017;1814;5649
411620;201306;2614;8934;2483;8703;878;3340;978;3491;1856;6831
411630;201306;663;1854;419;1451;142;569;76;237;218;806
411640;201306;550;1745;460;1554;142;532;163;511;305;1043
411650;201306;255;850;214;754;65;259;68;213;133;472
411660;201306;707;2175;638;2052;168;561;259;869;427;1430
411670;201306;1588;4855;1463;4637;523;1869;488;1423;1011;3292
411680;201306;1630;5231;1455;4932;402;1344;779;2828;1181;4172
411690;201306;3333;10420;2962;9734;1101;3911;852;2801;1953;6712
411695;201306;784;2580;681;2376;146;530;355;1241;501;1771
411700;201306;1745;5371;1384;4686;429;1617;392;1272;821;2889
411705;201306;2168;7662;1927;7214;479;1844;1129;4323;1608;6167
411710;201306;2114;6667;1692;5671;540;1990;334;972;874;2962
411720;201306;824;2573;668;2203;170;622;185;563;355;1185
411721;201306;654;2058;587;1943;159;587;244;778;403;1365
411722;201306;647;2019;537;1799;144;561;179;556;323;1117
411725;201306;1207;4066;917;3387;270;1104;284;1057;554;2161
411727;201306;2301;6791;1939;6066;493;1721;864;2599;1357;4320
411729;201306;489;1433;405;1285;79;285;170;505;249;790
411730;201306;5193;16211;4523;14891;1375;4906;1776;5823;3151;10729
411740;201306;503;1531;422;1367;127;485;168;489;295;974
411745;201306;814;2651;700;2390;214;807;180;566;394;1373
411750;201306;3666;11750;3141;10617;1043;3897;535;1625;1578;5522
411760;201306;8121;25453;7495;24397;2984;10252;2353;8077;5337;18329
411770;201306;3619;13353;3362;12727;1419;5619;779;2989;2198;8608
411780;201306;2858;9896;2783;9795;433;1474;2004;7427;2437;8901
411790;201306;2443;7695;2093;7070;734;2809;601;1960;1335;4769
411800;201306;1173;3643;776;2643;152;578;112;288;264;866
411810;201306;1405;4545;1248;4192;349;1358;314;879;663;2237
411820;201306;15659;50476;13308;46195;4790;17107;4304;15831;9094;32938
411830;201306;434;1238;365;1146;115;377;154;508;269;885
411840;201306;7982;24761;6716;22330;2184;8034;2098;6799;4282;14833
411845;201306;466;1561;384;1388;116;457;84;289;200;746
411850;201306;5717;18332;5030;17004;1521;5651;1731;5833;3252;11484
411860;201306;797;2696;708;2483;235;882;189;613;424;1495
411870;201306;918;3451;811;3154;145;609;215;780;360;1389
411880;201306;2421;7120;2074;6554;491;1731;1085;3459;1576;5190
411885;201306;1312;3775;1114;3499;393;1376;324;912;717;2288
411890;201306;1181;3762;920;3182;291;1134;218;659;509;1793
411900;201306;832;2776;690;2425;224;834;159;549;383;1383
411910;201306;1130;4043;1040;3816;318;1273;366;1279;684;2552
411915;201306;10896;33031;7953;26676;2250;8433;1967;5962;4217;14395
411920;201306;952;3505;879;3314;314;1273;208;777;522;2050
411925;201306;554;1675;459;1505;137;467;196;654;333;1121
411930;201306;5873;20183;5253;18865;1759;6700;2017;7421;3776;14121
411940;201306;3440;12005;3157;11391;1079;4105;936;3373;2015;7478
411950;201306;10303;34281;9151;32318;3068;11779;4005;13983;7073;25762
411960;201306;5523;17425;5219;16856;1555;5585;2403;7532;3958;13117
411965;201306;395;1404;352;1305;109;436;97;364;206;800
411970;201306;707;2155;580;1940;191;670;188;619;379;1289
411980;201306;2024;5684;1456;4787;188;688;845;2779;1033;3467
411990;201306;26200;94027;23360;87932;9273;37082;6240;24032;15513;61114
411995;201306;2840;9268;2648;8907;1115;3987;750;2552;1865;6539
412000;201306;1787;5335;1487;4778;336;1240;617;1751;953;2991
412010;201306;705;2432;635;2276;212;811;212;744;424;1555
412015;201306;573;1917;512;1786;100;395;285;964;385;1359
412020;201306;404;1256;327;1098;122;446;128;406;250;852
412030;201306;513;1652;375;1339;82;350;119;396;201;746
412033;201306;660;2134;528;1816;144;541;89;287;233;828
412035;201306;874;2684;765;2477;202;755;329;1000;531;1755
412040;201306;676;2283;624;2153;257;942;188;636;445;1578
412050;201306;1547;4789;1260;4170;337;1252;296;925;633;2177
412060;201306;7137;25917;6645;24752;2131;8391;2893;10919;5024;19310
412065;201306;908;2894;824;2720;271;1016;237;718;508;1734
412070;201306;1024;3013;927;2808;209;694;381;1132;590;1826
412080;201306;1866;6063;1423;5102;446;1774;169;536;615;2310
412085;201306;231;702;158;545;49;186;40;129;89;315
412090;201306;4667;15990;4492;15667;1020;3809;2863;10131;3883;13940
412100;201306;2149;7013;1914;6594;663;2418;668;2287;1331;4705
412110;201306;777;2592;728;2496;292;1041;264;881;556;1922
412120;201306;2284;8003;2133;7643;546;2149;1082;3748;1628;5897
412125;201306;942;3006;849;2858;271;983;333;1148;604;2131
412130;201306;751;2187;560;1826;134;495;165;528;299;1023
412135;201306;542;1599;420;1338;84;305;196;569;280;874
412140;201306;1758;5510;1510;5022;471;1669;443;1482;914;3151
412150;201306;2628;8215;2367;7688;413;1507;1375;4320;1788;5827
412160;201306;1025;3362;895;3102;288;1107;342;1146;630;2253
412170;201306;4045;14276;3650;13486;1471;5741;1206;4401;2677;10142
412175;201306;1446;5274;1358;5078;408;1654;558;2113;966;3767
412180;201306;1637;5424;1302;4810;550;2216;318;1132;868;3348
412190;201306;2817;8930;2435;8303;987;3530;700;2528;1687;6058
412200;201306;2088;7391;1624;6047;406;1614;517;1873;923;3487
412210;201306;649;1969;468;1562;143;541;94;288;237;829
412215;201306;2993;10310;2748;9834;548;2040;1698;6263;2246;8303
412217;201306;1085;3421;1043;3343;246;892;608;1846;854;2738
412220;201306;6591;21886;6326;21373;2385;8451;2863;9776;5248;18227
412230;201306;2716;9738;2469;9182;880;3556;684;2467;1564;6023
412240;201306;7682;22235;4739;15905;1131;4220;663;1990;1794;6210
412250;201306;2040;6543;1877;6208;706;2519;549;1745;1255;4264
412260;201306;1222;3773;843;2916;214;839;237;717;451;1556
412265;201306;1096;3612;1031;3496;298;1199;478;1544;776;2743
412270;201306;713;2474;570;2100;144;614;95;323;239;937
412280;201306;832;2698;755;2574;183;661;367;1246;550;1907
412290;201306;1166;3391;1004;3092;234;830;421;1245;655;2075
412300;201306;1650;5054;1377;4501;432;1627;423;1272;855;2899
412310;201306;1181;3441;1043;3264;225;598;673;2351;898;2949
412320;201306;722;2031;538;1716;122;457;243;764;365;1221
412330;201306;1920;5431;1501;4723;406;1386;664;2060;1070;3446
412340;201306;838;2781;647;2304;154;612;118;392;272;1004
412350;201306;2296;7653;1968;6891;669;2516;357;1148;1026;3664
412360;201306;320;1080;291;1001;76;277;71;216;147;493
412370;201306;1090;3476;874;3050;322;1179;252;874;574;2053
412380;201306;1911;5994;1741;5664;383;1289;870;2980;1253;4269
412382;201306;693;2011;553;1733;155;559;170;480;325;1039
412385;201306;2390;7897;2250;7614;595;2019;1078;3929;1673;5948
412390;201306;2325;7198;2158;6919;814;2835;786;2494;1600;5329
412395;201306;942;2687;768;2410;100;318;518;1672;618;1990
412400;201306;1177;3709;1064;3508;339;1206;445;1492;784;2698
412402;201306;1880;6098;1636;5588;522;1899;415;1354;937;3253
412405;201306;3736;11296;2549;8655;695;2706;254;751;949;3457
412410;201306;5961;20162;5500;19237;2535;9622;1059;3672;3594;13294
412420;201306;501;1548;430;1442;148;557;132;397;280;954
412430;201306;441;1365;371;1210;133;486;148;442;281;928
412440;201306;3911;12012;3486;11274;679;2429;1570;5313;2249;7742
412450;201306;529;1717;469;1565;133;489;138;404;271;893
412460;201306;961;2737;665;2183;164;631;177;546;341;1177
412470;201306;1924;6794;1814;6546;578;2254;788;2805;1366;5059
412480;201306;1266;3836;945;3146;234;846;196;572;430;1418
412490;201306;1242;3778;1125;3517;332;1091;332;1040;664;2131
412500;201306;1917;5907;1649;5388;551;1994;413;1240;964;3234
412510;201306;3078;10471;2780;9682;968;3676;770;2690;1738;6366
412520;201306;1707;5007;1365;4468;377;1304;618;2051;995;3355
412530;201306;752;2279;653;2084;226;780;175;534;401;1314
412535;201306;348;1069;274;893;82;288;103;299;185;587
412540;201306;1160;3579;986;3205;212;810;385;1227;597;2037
412545;201306;857;2540;745;2308;145;503;286;807;431;1310
412550;201306;22564;70859;16647;57652;5099;19113;3392;10931;8491;30044
412555;201306;304;975;224;769;64;232;41;120;105;352
412560;201306;4270;15144;3826;14161;1277;5111;889;3051;2166;8162
412570;201306;3868;12381;3190;10899;1114;4107;741;2540;1855;6647
412575;201306;1002;3270;853;2904;216;828;278;881;494;1709
412580;201306;1425;4020;1076;3437;279;960;360;1100;639;2060
412590;201306;456;1455;387;1328;162;587;88;300;250;887
412600;201306;1417;4656;1262;4350;445;1684;394;1307;839;2991
412610;201306;713;2386;599;2111;211;817;148;459;359;1276
412620;201306;1308;4432;1189;4191;486;1828;327;1142;813;2970
412625;201306;13174;38240;11234;34627;4344;14452;2564;7866;6908;22318
412627;201306;901;2897;683;2426;235;898;98;333;333;1231
412630;201306;3361;11106;3011;10317;884;3260;899;2981;1783;6241
412635;201306;465;1481;383;1301;110;376;59;183;169;559
412640;201306;891;2801;705;2398;207;808;187;592;394;1400
412650;201306;2220;6423;1824;5729;507;1716;738;2162;1245;3878
412660;201306;2945;9112;2480;8142;672;2518;655;2030;1327;4548
412665;201306;686;1875;451;1494;136;503;128;399;264;902
412667;201306;1520;4737;1252;4199;359;1395;387;1179;746;2574
412670;201306;623;2020;426;1523;104;419;62;190;166;609
412680;201306;1304;4482;1153;4110;367;1386;321;1045;688;2431
412690;201306;598;1935;478;1661;177;672;62;206;239;878
412700;201306;1770;6067;1575;5707;603;2397;559;1989;1162;4386
412710;201306;8660;27816;7246;24871;2194;8218;1846;6162;4040;14380
412720;201306;1520;4903;1142;3964;301;1128;122;342;423;1470
412730;201306;2713;8410;1950;6788;643;2398;248;792;891;3190
412740;201306;2013;6776;1854;6414;799;2942;238;858;1037;3800
412750;201306;3148;11182;3034;10981;634;2550;2094;7441;2728;9991
412760;201306;2092;7230;2011;7088;706;2749;730;2439;1436;5188
412770;201306;10825;33011;7623;25888;1966;7484;1571;4837;3537;12321
412780;201306;1444;4911;1297;4552;410;1528;409;1367;819;2895
412785;201306;2289;7032;1805;6057;589;2117;740;2457;1329;4574
412788;201306;1305;4481;1233;4341;338;1409;558;1839;896;3248
412790;201306;1075;3503;929;3178;220;840;304;938;524;1778
412795;201306;967;2967;850;2752;306;1077;286;886;592;1963
412796;201306;3097;9868;2938;9581;845;3033;1378;4420;2223;7453
412800;201306;3311;10269;2726;9166;813;2989;801;2537;1614;5526
412810;201306;8212;24036;5928;19234;1870;6662;1471;4430;3341;11092
412820;201306;5589;17934;4384;15529;1434;5517;1033;3736;2467;9253
412830;201306;363;1266;332;1201;103;428;72;226;175;654
412840;201306;2283;6741;1921;6036;611;2129;516;1612;1127;3741
412850;201306;2713;8511;2434;8131;509;1925;1312;4335;1821;6260
412853;201306;1723;5380;1550;5088;366;1452;779;2357;1145;3809
412855;201306;1614;4815;1330;4268;464;1708;386;1118;850;2826
412860;201306;1190;3788;1075;3584;311;1156;475;1511;786;2667
412862;201306;688;2026;606;1866;190;637;200;595;390;1232
412863;201306;1190;4221;1152;4147;176;668;810;2918;986;3586
412865;201306;610;1996;460;1601;101;389;172;587;273;976
412870;201306;994;2981;860;2779;323;1123;290;954;613;2077
412880;201306;1553;4324;1318;3964;398;1334;391;1131;789;2465
420005;201306;471;1535;366;1300;92;361;156;519;248;880
420010;201306;3086;10059;2696;9367;439;1646;1863;6529;2302;8175
420020;201306;706;2490;517;1958;110;470;86;290;196;760
420030;201306;403;1300;274;1011;82;348;53;166;135;514
420040;201306;958;3069;675;2542;238;983;178;610;416;1593
420050;201306;681;2310;622;2180;205;765;223;761;428;1526
420055;201306;244;873;203;755;57;220;43;140;100;360
420060;201306;372;1334;286;1107;74;311;44;157;118;468
420070;201306;1884;6261;1698;5808;273;1053;815;2906;1088;3959
420075;201306;146;486;111;392;32;124;32;103;64;227
420080;201306;545;1954;503;1848;198;793;98;356;296;1149
420090;201306;643;2397;511;2045;147;607;100;412;247;1019
420100;201306;1434;4866;1342;4740;305;1093;878;3171;1183;4264
420110;201306;418;1472;386;1395;129;462;162;608;291;1070
420120;201306;300;1073;251;961;113;467;36;118;149;585
420125;201306;346;1473;333;1442;133;608;90;366;223;974
420127;201306;526;1698;277;1050;98;393;32;128;130;521
420130;201306;2651;9334;2408;8849;757;3128;925;3114;1682;6242
420140;201306;6201;19058;4807;16559;1696;6483;1258;4172;2954;10655
420150;201306;671;2158;518;1764;185;682;131;394;316;1076
420160;201306;262;838;178;629;53;228;39;109;92;337
420165;201306;153;542;131;486;29;113;30;117;59;230
420170;201306;226;759;162;626;62;282;19;50;81;332
420180;201306;384;1328;265;990;84;326;64;223;148;549
420190;201306;458;1570;340;1329;142;606;63;244;205;850
420195;201306;1337;3896;1067;3531;290;1068;501;1680;791;2748
420200;201306;2759;9226;1844;7099;654;2807;319;1078;973;3885
420205;201306;988;3413;896;3233;302;1184;382;1389;684;2573
420207;201306;1118;3455;863;2940;283;1087;239;763;522;1850
420208;201306;470;1591;406;1439;168;622;118;418;286;1040
420209;201306;287;1016;209;789;47;189;47;180;94;369
420210;201306;1674;5669;1144;4495;327;1473;156;547;483;2020
420213;201306;827;3188;791;3105;181;737;492;1952;673;2689
420215;201306;464;1629;375;1354;112;432;64;211;176;643
420220;201306;406;1635;386;1582;172;754;74;258;246;1012
420230;201306;4166;13462;3418;12081;881;3489;1808;6259;2689;9748
420240;201306;11878;37815;8297;30222;2049;8770;3182;10413;5231;19183
420243;201306;465;1628;421;1516;141;560;136;482;277;1042
420245;201306;935;3103;735;2706;216;925;148;476;364;1401
420250;201306;841;2768;793;2689;304;1111;321;1111;625;2222
420253;201306;639;1714;536;1575;120;378;262;837;382;1215
420257;201306;408;1327;344;1205;101;355;158;558;259;913
420260;201306;1276;4478;1186;4305;383;1501;546;1999;929;3500
420270;201306;378;1340;262;988;37;141;21;70;58;211
420280;201306;2515;7638;1843;6459;576;2292;570;1771;1146;4063
420285;201306;139;421;59;214;11;47;3;6;14;53
420287;201306;612;1962;543;1821;145;526;223;740;368;1266
420290;201306;5465;16757;3812;13124;1010;3860;1335;4353;2345;8213
420300;201306;5446;17831;3837;14284;1181;4974;759;2784;1940;7758
420310;201306;741;2392;708;2329;190;671;392;1254;582;1925
420315;201306;785;2928;697;2721;195;857;310;1196;505;2053
420320;201306;4538;15240;3945;14144;1285;5236;1541;5249;2826;10485
420325;201306;476;1580;458;1531;160;600;141;451;301;1051
420330;201306;1208;4369;1012;3821;372;1526;180;577;552;2103
420340;201306;1411;4517;1227;4123;302;1125;468;1494;770;2619
420350;201306;1522;5123;1386;4856;393;1457;645;2285;1038;3742
420360;201306;3324;11274;2786;10053;1126;4446;503;1701;1629;6147
420370;201306;1836;5321;1671;5121;210;681;1357;4117;1567;4798
420380;201306;5153;18062;4461;16373;1509;6067;1156;4176;2665;10243
420390;201306;1942;6017;1246;4507;446;1748;267;869;713;2617
420395;201306;2206;6985;1757;5976;529;2043;413;1284;942;3327
420400;201306;1433;4458;1131;3868;356;1402;363;1157;719;2559
420410;201306;719;2134;569;1892;143;537;278;907;421;1444
420415;201306;442;1485;396;1365;117;429;153;523;270;952
420417;201306;768;2607;699;2458;155;560;351;1244;506;1804
420419;201306;398;1343;317;1201;157;627;87;337;244;964
420420;201306;14105;45239;11324;39188;3943;14756;3409;11657;7352;26413
420425;201306;1165;3437;789;2618;121;496;312;942;433;1438
420430;201306;4009;12921;2761;9918;881;3429;740;2610;1621;6039
420435;201306;188;660;142;533;69;289;20;69;89;358
420440;201306;1431;4317;910;3227;324;1237;162;521;486;1758
420445;201306;428;1293;335;1129;106;375;144;494;250;869
420450;201306;1195;3600;717;2620;179;753;141;409;320;1162
420455;201306;2165;6991;1974;6644;632;2411;830;2716;1462;5127
420460;201306;9392;30809;7966;28039;2434;9623;3097;10405;5531;20028
420470;201306;1046;3062;785;2606;257;927;233;765;490;1692
420475;201306;145;526;120;448;45;176;32;128;77;304
420480;201306;5819;17972;4942;16553;2110;7804;848;2802;2958;10606
420490;201306;659;2388;576;2164;177;690;148;535;325;1225
420500;201306;2050;6586;1782;6107;536;1938;947;3305;1483;5243
420510;201306;181;798;177;779;78;345;37;156;115;501
420515;201306;153;584;129;517;42;177;21;82;63;259
420517;201306;912;2912;833;2736;119;402;568;1902;687;2304
420519;201306;378;1129;294;948;60;193;131;445;191;638
420520;201306;644;2086;567;1942;137;523;256;850;393;1373
420530;201306;1339;4778;1120;4199;407;1673;269;907;676;2580
420535;201306;246;828;216;757;71;280;62;204;133;484
420540;201306;18888;60152;14872;51483;5388;20354;4484;15047;9872;35401
420543;201306;424;1270;330;1116;53;193;226;762;279;955
420545;201306;1364;4511;1164;4084;375;1493;371;1207;746;2700
420550;201306;4467;15343;3936;14091;1346;5400;1224;4300;2570;9700
420555;201306;417;1429;369;1320;155;593;99;354;254;947
420560;201306;564;1713;486;1567;73;263;264;868;337;1131
420570;201306;1791;6132;1478;5363;474;1903;420;1419;894;3322
420580;201306;902;3239;799;3044;257;1092;341;1289;598;2381
420590;201306;3042;9965;2310;8237;592;2318;501;1690;1093;4008
420600;201306;659;2460;618;2365;202;850;255;954;457;1804
420610;201306;553;1893;424;1588;154;630;70;235;224;865
420620;201306;1171;3810;1048;3572;409;1517;240;797;649;2314
420630;201306;958;3242;795;2825;259;1007;222;680;481;1687
420640;201306;553;1964;358;1418;94;416;41;169;135;585
420650;201306;2137;7011;1363;5045;370;1558;279;854;649;2412
420660;201306;662;2034;558;1843;114;423;302;978;416;1401
420665;201306;726;2235;515;1775;98;377;188;578;286;955
420670;201306;1621;5427;1283;4622;367;1480;218;718;585;2198
420675;201306;219;726;163;590;38;153;76;254;114;407
420680;201306;501;1415;380;1229;95;350;152;473;247;823
420690;201306;807;2931;629;2419;179;771;196;707;375;1478
420700;201306;6253;19711;5278;17655;1941;7158;1283;4092;3224;11250
420710;201306;693;2608;614;2435;243;1024;150;566;393;1590
420720;201306;1856;6032;1672;5777;488;1760;928;3199;1416;4959
420730;201306;4419;14201;3923;13327;1550;5584;1341;4532;2891;10116
420740;201306;635;2307;620;2280;177;671;367;1360;544;2031
420750;201306;2347;7877;1746;6401;447;1885;558;1811;1005;3696
420757;201306;102;369;91;350;26;110;20;67;46;177
420760;201306;411;1397;334;1185;81;320;112;392;193;712
420765;201306;516;1887;394;1529;126;512;83;310;209;822
420768;201306;1182;4398;1069;4127;354;1417;432;1732;786;3149
420770;201306;830;2746;586;2153;196;790;168;574;364;1364
420775;201306;570;1906;518;1795;126;448;280;976;406;1424
420780;201306;1660;5238;1209;4131;370;1360;367;1186;737;2546
420785;201306;389;1293;319;1110;80;305;123;408;203;713
420790;201306;1281;4826;1091;4279;321;1341;452;1723;773;3064
420800;201306;845;2574;551;1908;157;592;125;404;282;996
420810;201306;2396;8788;2018;7837;733;3143;544;2036;1277;5179
420820;201306;7329;26408;6368;24620;2342;10075;2313;8817;4655;18892
420830;201306;2570;8927;2242;8291;886;3529;737;2639;1623;6168
420840;201306;958;3355;761;2919;273;1156;217;758;490;1914
420845;201306;1007;3634;866;3336;335;1397;147;545;482;1942
420850;201306;1686;5889;1271;5009;463;1973;277;1102;740;3075
420860;201306;626;1955;452;1588;192;747;153;518;345;1265
420870;201306;1314;4006;1080;3667;444;1634;322;1083;766;2717
420880;201306;1416;4889;1199;4322;364;1380;265;928;629;2308
420890;201306;11853;28786;5736;18393;1209;4642;2290;6660;3499;11302
420895;201306;170;490;96;316;29;101;38;123;67;224
420900;201306;2176;6548;1520;5258;484;1840;379;1238;863;3078
420910;201306;21182;68012;14703;53777;4207;17430;3662;12666;7869;30096
420915;201306;647;2602;605;2475;166;684;282;1225;448;1909
420917;201306;388;1220;232;771;55;210;81;219;136;429
420920;201306;164;497;108;377;40;151;17;58;57;209
420930;201306;19138;61004;16858;56721;5900;21655;5744;19273;11644;40928
420940;201306;4408;14142;3909;13028;1239;4579;1310;4084;2549;8663
420945;201306;211;694;149;536;49;199;40;133;89;332
420950;201306;486;1583;288;1115;84;363;47;176;131;539
420960;201306;1376;4485;1177;4104;433;1649;339;1083;772;2732
420970;201306;2543;8458;2282;8053;682;2500;1170;4284;1852;6784
420980;201306;350;1308;326;1244;101;381;179;710;280;1091
420985;201306;448;1476;333;1219;110;429;77;272;187;701
420990;201306;856;2637;593;2158;149;597;176;572;325;1169
421000;201306;660;2412;482;1934;162;722;55;165;217;887
421003;201306;582;1768;267;977;67;269;37;124;104;393
421005;201306;226;794;214;771;66;262;105;373;171;635
421010;201306;6395;20884;5261;18492;1842;6943;1621;5493;3463;12436
421020;201306;491;1739;430;1598;96;357;226;904;322;1261
421030;201306;1044;3877;953;3632;348;1391;294;1149;642;2540
421040;201306;816;2666;741;2533;239;890;284;926;523;1816
421050;201306;1808;5143;1196;4139;328;1297;465;1509;793;2806
421055;201306;236;854;191;724;50;218;53;175;103;393
421060;201306;521;1996;428;1720;135;583;86;320;221;903
421070;201306;752;2477;536;1956;151;625;171;629;322;1254
421080;201306;607;2069;581;2003;204;746;233;786;437;1532
421085;201306;495;1418;280;1011;78;308;56;215;134;523
421090;201306;405;1240;316;1035;88;304;138;457;226;761
421100;201306;918;3024;736;2599;226;836;185;591;411;1427
421105;201306;1327;4510;1201;4274;331;1267;537;1996;868;3263
421110;201306;1612;5414;1405;5071;529;2088;453;1572;982;3660
421120;201306;1500;5132;1220;4439;320;1367;387;1301;707;2668
421125;201306;334;1191;316;1138;123;469;107;358;230;827
421130;201306;4717;16204;4147;15159;1752;6833;1212;4586;2964;11419
421140;201306;406;1351;342;1198;110;418;118;400;228;818
421145;201306;468;1626;412;1476;77;316;195;665;272;981
421150;201306;450;1616;366;1449;109;457;150;587;259;1044
421160;201306;741;2427;535;1989;128;524;157;565;285;1089
421165;201306;310;1147;254;955;64;254;106;408;170;662
421170;201306;1809;6030;1554;5330;504;1822;712;2391;1216;4213
421175;201306;1222;3889;1018;3557;374;1472;318;1027;692;2499
421180;201306;439;1386;306;1103;106;437;114;361;220;798
421185;201306;402;1261;345;1149;63;204;176;610;239;814
421187;201306;301;988;256;895;76;279;94;317;170;596
421189;201306;521;1639;469;1530;131;465;183;589;314;1054
421190;201306;9028;30524;7390;26969;2537;9867;2306;8400;4843;18267
421200;201306;1024;3610;923;3385;289;1176;417;1497;706;2673
421205;201306;198;671;154;567;36;155;36;109;72;264
421210;201306;1946;6298;1778;5855;610;2132;600;1961;1210;4093
421220;201306;2363;8414;2144;7981;735;2904;733;2794;1468;5698
421223;201306;782;2362;540;1939;173;652;270;962;443;1614
421225;201306;1114;3559;972;3278;287;1032;383;1272;670;2304
421227;201306;915;3249;867;3170;256;931;497;1900;753;2831
421230;201306;741;2576;675;2405;197;755;255;873;452;1628
421240;201306;510;1771;379;1388;113;451;53;171;166;622
421250;201306;1821;5825;1326;4913;493;1997;374;1332;867;3329
421260;201306;228;763;160;625;39;156;35;132;74;288
421270;201306;603;1774;387;1390;141;533;87;334;228;867
421280;201306;1526;4978;1269;4571;485;2010;314;1113;799;3123
421290;201306;1904;5605;1310;4428;455;1647;293;896;748;2543
421300;201306;276;955;253;903;125;493;74;234;199;727
421310;201306;505;1778;436;1584;154;562;106;377;260;939
421315;201306;336;1062;229;827;44;166;67;226;111;392
421320;201306;508;1779;351;1325;79;340;65;183;144;523
421330;201306;605;2201;538;2058;235;1017;65;234;300;1251
421335;201306;545;1888;445;1685;138;571;101;385;239;956
421340;201306;1593;5511;1499;5350;528;2005;587;2098;1115;4103
421350;201306;970;3442;823;3123;317;1336;227;820;544;2156
421360;201306;3099;9944;2245;8157;563;2343;766;2656;1329;4999
421370;201306;1066;3917;932;3609;336;1425;257;978;593;2403
421380;201306;999;3004;838;2691;182;624;410;1315;592;1939
421390;201306;185;620;150;534;24;92;45;165;69;257
421400;201306;361;1467;305;1321;135;595;73;304;208;899
421410;201306;361;1175;295;1037;73;264;136;502;209;766
421415;201306;312;1050;208;825;73;302;59;227;132;529
421420;201306;1381;4493;1101;3772;276;1013;243;781;519;1794
421430;201306;250;870;195;750;74;317;34;134;108;451
421440;201306;772;2434;565;2047;196;752;215;776;411;1528
421450;201306;611;2221;527;2009;229;929;136;518;365;1447
421460;201306;567;2004;450;1745;131;554;103;373;234;927
421470;201306;471;1881;442;1796;146;626;180;704;326;1330
421480;201306;2360;8073;1802;6818;606;2557;553;1913;1159;4470
421490;201306;218;845;196;791;97;406;37;147;134;553
421500;201306;2622;9682;2367;9147;1050;4400;557;2106;1607;6506
421505;201306;391;1380;355;1286;139;505;112;411;251;916
421507;201306;554;2017;509;1893;124;473;203;755;327;1228
421510;201306;272;1074;253;1030;84;382;97;349;181;731
421520;201306;695;2051;544;1738;74;290;327;1000;401;1290
421530;201306;436;1536;321;1280;101;454;111;426;212;880
421535;201306;601;2002;445;1683;103;424;214;806;317;1230
421540;201306;369;1193;325;1103;79;302;119;384;198;686
421545;201306;1171;4223;997;3852;340;1449;207;759;547;2208
421550;201306;1997;7176;1863;6892;751;2996;605;2199;1356;5195
421555;201306;218;745;131;486;34;141;35;119;69;260
421560;201306;187;653;118;462;41;167;18;65;59;232
421565;201306;1037;3402;958;3255;451;1628;283;930;734;2558
421567;201306;940;3651;822;3324;413;1699;154;634;567;2333
421568;201306;378;1444;360;1398;126;514;120;461;246;975
421569;201306;145;537;128;484;32;137;40;132;72;269
421570;201306;897;3200;744;2842;284;1193;191;678;475;1871
421575;201306;605;2095;542;1961;117;439;282;1041;399;1480
421580;201306;4100;14108;3354;12434;1370;5628;744;2534;2114;8162
421590;201306;244;817;209;724;49;177;92;304;141;481
421600;201306;733;2396;615;2147;203;746;173;591;376;1337
421605;201306;631;2038;459;1690;146;604;105;378;251;982
421610;201306;1811;4824;1428;4257;222;734;884;2635;1106;3369
421620;201306;4539;14461;3440;12194;1267;4833;1120;4005;2387;8838
421625;201306;324;1185;265;1004;88;364;88;308;176;672
421630;201306;2311;7404;1624;5770;458;1769;416;1458;874;3227
421635;201306;274;1004;239;944;67;288;98;358;165;646
421640;201306;1072;3575;965;3390;216;772;591;2119;807;2891
421650;201306;2330;8172;2100;7659;907;3611;348;1208;1255;4819
421660;201306;8555;30139;7124;27254;2616;10960;2107;7693;4723;18653
421670;201306;1064;3757;881;3279;256;1041;266;984;522;2025
421680;201306;1374;4726;1261;4440;527;2000;221;701;748;2701
421690;201306;1983;6836;1590;5841;506;2002;314;1128;820;3130
421700;201306;731;2381;513;1930;180;736;135;446;315;1182
421710;201306;323;1188;277;1063;114;446;65;242;179;688
421715;201306;227;763;185;655;52;189;55;201;107;390
421720;201306;1455;4968;1284;4664;537;2159;413;1406;950;3565
421725;201306;118;445;113;431;39;155;47;173;86;328
421730;201306;511;1735;322;1227;94;409;89;283;183;692
421740;201306;663;2196;527;1866;161;662;133;383;294;1045
421750;201306;1299;4212;1092;3758;355;1315;347;1097;702;2412
421755;201306;400;1406;335;1216;98;371;88;311;186;682
421760;201306;346;1193;278;1053;91;386;122;428;213;814
421770;201306;3522;11139;2985;10100;1411;4969;726;2548;2137;7517
421775;201306;520;1695;395;1438;97;371;129;469;226;840
421780;201306;1688;6036;1387;5360;593;2463;366;1333;959;3796
421790;201306;866;2705;598;2198;205;857;133;446;338;1303
421795;201306;337;1090;281;925;50;175;88;283;138;458
421800;201306;2254;7899;1875;7092;571;2425;604;2056;1175;4481
421810;201306;693;2407;594;2149;200;779;126;433;326;1212
421820;201306;996;3402;870;3121;210;888;316;1036;526;1924
421825;201306;1248;4436;1176;4247;212;860;643;2268;855;3128
421830;201306;2957;10598;2805;10300;676;2506;1605;6244;2281;8750
421835;201306;161;559;136;509;55;228;46;157;101;385
421840;201306;504;1842;457;1723;186;778;157;545;343;1323
421850;201306;544;1645;440;1478;150;531;149;533;299;1064
421860;201306;425;1476;331;1259;79;330;90;331;169;661
421870;201306;5022;15350;3690;12539;1210;4410;691;2290;1901;6700
421875;201306;248;861;184;685;49;207;47;148;96;355
421880;201306;916;3236;790;2924;285;1189;168;545;453;1734
421885;201306;349;1263;321;1183;92;355;145;533;237;888
421890;201306;1048;3716;912;3420;327;1314;284;1032;611;2346
421895;201306;408;1455;397;1436;119;432;210;786;329;1218
421900;201306;830;2810;695;2465;189;716;253;833;442;1549
421910;201306;478;1657;376;1407;112;489;98;304;210;793
421915;201306;588;1893;524;1770;87;329;315;1060;402;1389
421917;201306;492;1680;422;1546;155;652;116;370;271;1022
421920;201306;718;2347;610;2192;294;1125;177;588;471;1713
421930;201306;3584;11060;2722;9318;867;3312;443;1477;1310;4789
421935;201306;824;3083;700;2770;205;882;256;1006;461;1888
421940;201306;289;1170;251;1042;92;418;70;262;162;680
421950;201306;4064;11943;2537;8887;835;3103;532;1904;1367;5007
421960;201306;232;782;196;696;58;221;55;186;113;407
421970;201306;1874;6102;1556;5366;570;2128;350;1080;920;3208
421985;201306;404;1206;269;919;47;193;95;334;142;527
430003;201306;902;2673;730;2381;221;807;277;902;498;1709
430005;201306;267;952;246;902;61;247;129;440;190;687
430010;201306;1915;6003;1548;5195;518;1798;560;1920;1078;3718
430020;201306;1070;3014;949;2829;246;826;504;1425;750;2251
430030;201306;1449;4237;1305;3928;410;1284;500;1453;910;2737
430040;201306;12607;33084;11272;31331;3503;9968;5623;16220;9126;26188
430045;201306;686;1986;577;1787;98;339;361;1093;459;1432
430047;201306;192;570;170;526;40;130;92;290;132;420
430050;201306;883;2617;603;2047;109;447;290;920;399;1367
430055;201306;235;737;199;642;48;171;107;335;155;506
430057;201306;68;184;29;99;7;30;12;29;19;59
430060;201306;13363;45767;12371;44069;4323;15963;5679;20699;10002;36662
430063;201306;977;3066;852;2755;266;890;377;1261;643;2151
430064;201306;1635;5020;1408;4627;350;1148;791;2721;1141;3869
430066;201306;147;400;120;360;37;121;56;162;93;283
430070;201306;476;1650;421;1526;109;421;148;510;257;931
430080;201306;538;1872;456;1664;126;513;112;377;238;890
430085;201306;500;1651;441;1542;141;542;204;682;345;1224
430087;201306;934;2887;917;2854;94;314;766;2372;860;2686
430090;201306;693;1900;273;908;39;150;96;312;135;462
430100;201306;897;3093;813;2892;313;1222;207;630;520;1852
430105;201306;614;2139;549;2007;216;829;133;471;349;1300
430107;201306;252;855;207;724;46;175;101;339;147;514
430110;201306;2122;6473;1992;6269;659;2254;957;2982;1616;5236
430120;201306;1625;5227;1407;4753;240;844;936;3147;1176;3991
430130;201306;4383;11463;4088;11092;703;2026;2763;7638;3466;9664
430140;201306;1124;3777;910;3253;313;1115;316;1154;629;2269
430150;201306;831;2379;632;2001;162;540;213;675;375;1215
430155;201306;484;1576;373;1323;97;333;157;566;254;899
430160;201306;17716;53718;16670;52012;3813;13068;9385;29894;13198;42962
430163;201306;1763;5527;1536;5090;370;1387;704;2347;1074;3734
430165;201306;257;967;232;916;108;429;41;165;149;594
430170;201306;707;2170;411;1474;113;458;101;318;214;776
430175;201306;936;3211;824;2950;212;728;449;1697;661;2425
430180;201306;1141;3244;1013;3063;200;643;601;1873;801;2516
430185;201306;720;1843;405;1227;63;229;141;355;204;584
430187;201306;741;2352;683;2265;185;727;316;1014;501;1741
430190;201306;2221;6782;1973;6342;516;1899;958;3095;1474;4994
430192;201306;186;600;120;402;24;86;45;145;69;231
430195;201306;189;615;87;333;14;58;14;42;28;100
430200;201306;1731;5787;1529;5409;587;2184;290;1053;877;3237
430205;201306;466;1457;390;1321;46;192;264;882;310;1074
430210;201306;5728;17202;3553;12355;1045;3876;668;2159;1713;6035
430215;201306;303;963;257;872;72;268;126;411;198;679
430220;201306;581;1574;318;1087;74;288;57;176;131;464
430222;201306;303;963;237;822;74;289;95;304;169;593
430223;201306;264;896;259;883;71;249;158;535;229;784
430225;201306;39;134;35;118;4;9;7;20;11;29
430230;201306;2141;6871;2018;6740;379;1177;1499;5198;1878;6375
430235;201306;225;783;189;698;72;295;40;122;112;417
430237;201306;360;1082;326;1018;42;172;234;688;276;860
430240;201306;991;3136;822;2785;319;1215;228;670;547;1885
430245;201306;778;2799;691;2575;192;734;297;1135;489;1869
430250;201306;1586;4518;1455;4276;496;1543;609;1848;1105;3391
430258;201306;170;534;135;452;25;83;67;217;92;300
430260;201306;778;2280;545;1791;77;301;308;1005;385;1306
430265;201306;319;1056;273;940;121;440;39;103;160;543
430270;201306;3353;9858;3081;9412;886;3064;1494;4484;2380;7548
430280;201306;4987;14963;4529;14081;1471;4922;1964;5994;3435;10916
430290;201306;2340;6779;2225;6654;332;1007;1771;5399;2103;6406
430300;201306;9370;29921;8275;27862;3490;12289;3019;10545;6509;22834
430310;201306;8017;26207;7388;25016;2592;9410;3049;10131;5641;19541
430320;201306;770;2448;594;2089;99;341;302;1111;401;1452
430330;201306;915;2613;831;2463;217;708;386;1072;603;1780
430340;201306;649;1819;452;1542;118;455;214;718;332;1173
430350;201306;5958;19720;5258;18145;1922;7079;1960;6643;3882;13722
430355;201306;204;588;140;469;30;129;33;100;63;229
430360;201306;1020;2804;932;2661;161;503;582;1659;743;2162
430367;201306;331;958;236;775;37;136;90;279;127;415
430370;201306;547;1699;489;1572;174;602;136;403;310;1005
430380;201306;847;2232;468;1535;145;493;155;533;300;1026
430390;201306;3873;12143;3168;10596;833;3075;1017;3200;1850;6275
430400;201306;1234;3044;894;2562;196;679;491;1314;687;1993
430410;201306;667;1892;539;1681;114;394;291;916;405;1310
430420;201306;4241;12847;3634;11472;1149;3710;1476;4709;2625;8419
430430;201306;645;1936;498;1650;173;609;132;407;305;1016
430435;201306;1746;5035;1633;4840;351;1041;1056;3186;1407;4227
430440;201306;4156;13353;3606;12468;931;3556;1496;5266;2427;8822
430450;201306;8854;26645;7588;23937;2607;8566;2911;9227;5518;17793
430460;201306;22904;72404;19495;66354;7059;25691;7112;24474;14171;50165
430461;201306;463;1323;154;513;36;119;36;127;72;246
430462;201306;320;987;277;911;115;400;88;283;203;683
430463;201306;3608;12257;3236;11476;887;3457;1548;5472;2435;8929
430465;201306;586;1705;495;1538;134;460;284;876;418;1336
430466;201306;4074;12513;3875;12158;1295;4360;1730;5456;3025;9816
430467;201306;545;1749;482;1631;137;505;220;735;357;1240
430468;201306;1369;4155;1231;3928;532;1855;255;781;787;2636
430469;201306;118;336;40;163;12;51;10;42;22;93
430470;201306;6600;18337;5308;16289;1878;6239;1963;6039;3841;12278
430471;201306;919;3165;835;2975;315;1184;192;680;507;1864
430480;201306;791;2308;515;1713;104;376;128;383;232;759
430485;201306;214;684;130;485;26;91;50;207;76;298
430490;201306;502;1527;362;1252;115;419;115;405;230;824
430495;201306;394;1235;290;1003;78;301;77;258;155;559
430500;201306;1582;4598;1411;4301;406;1384;698;2077;1104;3461
430510;201306;25485;82004;20043;68228;7066;26239;5630;18379;12696;44618
430511;201306;456;1446;292;1025;84;289;57;199;141;488
430512;201306;1275;3454;1145;3238;339;986;489;1456;828;2442
430513;201306;605;1804;458;1492;89;302;215;693;304;995
430515;201306;570;1785;498;1611;103;353;218;723;321;1076
430517;201306;1281;4470;1218;4321;244;931;753;2632;997;3563
430520;201306;1679;5180;1447;4694;498;1734;611;1950;1109;3684
430530;201306;898;2630;602;1985;151;567;180;540;331;1107
430535;201306;2211;7488;1952;6866;564;2162;665;2339;1229;4501
430537;201306;569;1680;419;1440;60;200;323;1143;383;1343
430540;201306;707;1821;566;1628;131;427;328;894;459;1321
430543;201306;575;1570;526;1520;133;407;322;950;455;1357
430544;201306;668;2346;593;2127;143;539;301;1051;444;1590
430545;201306;1251;4224;1115;4055;374;1215;617;2548;991;3763
430550;201306;573;1894;468;1635;130;501;188;645;318;1146
430558;201306;113;337;86;284;34;124;15;39;49;163
430560;201306;329;923;257;784;54;207;114;329;168;536
430570;201306;1084;3014;849;2599;217;735;440;1283;657;2018
430580;201306;963;2896;705;2370;261;897;202;717;463;1614
430583;201306;117;335;56;188;6;26;12;38;18;64
430585;201306;312;921;246;766;82;294;113;319;195;613
430587;201306;301;969;268;899;129;450;76;247;205;697
430590;201306;1535;4404;1460;4283;318;1064;871;2466;1189;3530
430593;201306;36;143;34;136;14;58;10;37;24;95
430595;201306;153;481;102;377;40;156;14;45;54;201
430597;201306;364;1175;312;1054;56;206;144;462;200;668
430600;201306;1796;5361;1384;4417;340;1147;519;1637;859;2784
430605;201306;1257;4136;1072;3726;280;1068;436;1556;716;2624
430607;201306;660;1865;585;1725;117;394;358;1006;475;1400
430610;201306;7824;22200;6496;20057;1493;5158;3315;10153;4808;15311
430613;201306;192;528;138;419;37;126;61;167;98;293
430620;201306;931;2987;793;2672;251;952;302;928;553;1880
430630;201306;418;1330;274;949;84;296;61;197;145;493
430632;201306;692;1998;480;1559;76;294;286;889;362;1183
430635;201306;621;1838;472;1543;90;321;267;875;357;1196
430637;201306;480;1413;449;1358;63;222;326;947;389;1169
430640;201306;1685;5038;1068;3580;267;962;226;635;493;1597
430642;201306;452;1267;350;1110;68;225;200;655;268;880
430645;201306;163;516;105;373;30;116;22;72;52;188
430650;201306;1935;6762;1720;6222;418;1564;926;3449;1344;5013
430655;201306;293;927;273;875;61;222;103;276;164;498
430660;201306;5607;17597;4680;15800;1640;6001;1780;5968;3420;11969
430670;201306;494;1475;450;1391;47;139;341;1091;388;1230
430673;201306;683;1768;456;1411;134;425;211;660;345;1085
430675;201306;167;513;127;427;22;87;61;201;83;288
430676;201306;4399;13809;4122;13359;1270;4437;1987;6607;3257;11044
430680;201306;1188;3610;931;3047;219;834;383;1148;602;1982
430690;201306;4262;12799;3678;11702;1219;3982;1584;5267;2803;9249
430692;201306;274;967;211;821;39;157;124;497;163;654
430693;201306;1732;5055;1407;4313;322;1071;486;1455;808;2526
430695;201306;497;1474;416;1310;94;335;195;571;289;906
430697;201306;397;1163;329;1060;111;362;137;468;248;830
430700;201306;10033;27691;5751;18981;1295;4797;928;2869;2223;7666
430705;201306;409;1305;382;1257;129;456;171;565;300;1021
430710;201306;1782;4822;1480;4332;315;991;847;2600;1162;3591
430720;201306;747;2076;545;1775;164;562;239;798;403;1360
430730;201306;1650;4835;1478;4559;351;1074;859;2762;1210;3836
430740;201306;542;1678;410;1383;144;503;87;280;231;783
430745;201306;506;1513;405;1310;64;224;241;754;305;978
430750;201306;1707;5091;1536;4783;465;1628;775;2276;1240;3904
430755;201306;621;1836;463;1488;126;465;190;550;316;1015
430760;201306;3344;9096;2809;8429;596;1928;1636;5044;2232;6972
430770;201306;6366;20066;5500;18475;1443;5289;2530;8372;3973;13661
430780;201306;1768;5532;1553;5134;539;1947;595;1795;1134;3742
430781;201306;617;1957;482;1683;149;543;188;653;337;1196
430783;201306;525;1452;443;1312;94;309;206;560;300;869
430786;201306;116;407;104;373;40;156;13;43;53;199
430790;201306;2966;8665;2178;7106;524;1975;972;3037;1496;5012
430800;201306;709;2322;629;2131;186;672;235;777;421;1449
430805;201306;428;1312;356;1172;28;111;250;826;278;937
430807;201306;255;833;237;793;53;195;122;399;175;594
430810;201306;493;1533;310;1101;63;266;56;176;119;442
430820;201306;1114;3832;971;3480;324;1258;318;1089;642;2347
430825;201306;445;1308;257;846;51;189;78;229;129;418
430830;201306;2696;8143;2509;7815;428;1379;1588;5230;2016;6609
430840;201306;904;2915;867;2846;234;719;463;1627;697;2346
430843;201306;98;329;77;258;17;55;30;98;47;153
430845;201306;464;1410;395;1283;140;481;85;263;225;744
430850;201306;3190;10122;2908;9590;949;3303;1143;3798;2092;7101
430860;201306;594;2073;533;1927;188;793;122;380;310;1173
430865;201306;701;2010;656;1922;197;590;346;1024;543;1614
430870;201306;434;1412;351;1236;129;467;124;422;253;889
430880;201306;1321;4008;1117;3586;470;1625;278;908;748;2533
430885;201306;163;565;141;519;52;198;35;131;87;329
430890;201306;1831;5167;1603;4783;202;681;1134;3431;1336;4112
430900;201306;3200;8921;3043;8719;588;1740;2071;6092;2659;7832
430905;201306;940;2986;746;2547;264;964;204;674;468;1638
430910;201306;1647;5514;1468;5195;600;2309;519;1784;1119;4093
430912;201306;563;1680;455;1493;91;357;233;727;324;1084
430915;201306;386;1416;310;1239;91;399;92;354;183;753
430920;201306;16162;53418;15437;52240;5626;19664;8348;28259;13974;47923
430925;201306;92;264;75;230;21;71;39;117;60;188
430930;201306;8607;28206;7531;26000;2314;8473;3201;11351;5515;19824
430940;201306;1022;3302;880;3048;222;880;300;987;522;1867
430950;201306;1564;4580;1242;3871;391;1281;394;1214;785;2495
430955;201306;90;309;72;261;28;110;15;51;43;161
430957;201306;306;1076;264;980;69;261;128;477;197;738
430960;201306;1630;4915;1405;4514;560;1877;490;1585;1050;3462
430965;201306;1159;3870;1008;3542;235;940;564;1904;799;2844
430970;201306;492;1462;340;1134;98;357;97;315;195;672
430975;201306;591;2011;528;1858;105;389;340;1195;445;1584
430980;201306;540;1388;347;1099;99;357;127;353;226;710
430990;201306;621;2080;483;1708;166;613;106;373;272;986
430995;201306;681;2119;632;2026;211;686;274;913;485;1599
431000;201306;1566;4426;1023;3310;286;1054;155;437;441;1491
431010;201306;2442;7718;1850;6467;566;2184;599;1988;1165;4172
431020;201306;13550;35120;9817;28313;2969;9026;3131;9330;6100;18356
431030;201306;394;1248;264;928;54;202;69;257;123;459
431033;201306;2757;8262;2549;7958;623;2008;1487;4896;2110;6904
431036;201306;158;486;92;320;24;90;21;60;45;150
431040;201306;951;2904;837;2707;256;906;418;1323;674;2229
431041;201306;569;1617;512;1529;188;595;168;526;356;1121
431043;201306;364;1238;298;1079;141;563;101;318;242;881
431046;201306;108;332;85;282;23;82;36;117;59;199
431050;201306;1746;4542;1566;4317;307;835;1066;3053;1373;3888
431053;201306;576;1968;513;1842;173;683;195;676;368;1359
431055;201306;608;1829;590;1800;77;237;450;1403;527;1640
431057;201306;275;832;180;640;53;207;76;260;129;467
431060;201306;6065;18250;5799;17940;1097;3031;4215;13723;5312;16754
431065;201306;427;1345;411;1316;46;156;292;932;338;1088
431070;201306;741;2216;560;1815;132;424;232;745;364;1169
431075;201306;259;803;180;621;35;139;57;197;92;336
431080;201306;608;2037;512;1829;148;557;93;325;241;882
431085;201306;892;2480;730;2206;142;459;398;1203;540;1662
431087;201306;584;1748;542;1670;34;86;457;1437;491;1523
431090;201306;459;1264;297;952;101;345;82;244;183;589
431100;201306;4596;13144;3982;12083;1136;3681;1806;5587;2942;9268
431110;201306;1470;4240;1273;3850;349;1107;701;2074;1050;3181
431112;201306;725;2338;695;2287;248;829;332;1128;580;1957
431113;201306;620;1928;476;1587;164;537;131;458;295;995
431115;201306;1424;4437;1342;4288;326;1098;798;2518;1124;3616
431120;201306;2565;8597;2358;8198;761;2938;1005;3351;1766;6289
431123;201306;510;1680;444;1545;119;428;221;790;340;1218
431125;201306;1286;4235;1111;3866;354;1268;489;1791;843;3059
431127;201306;112;328;69;220;11;36;19;58;30;94
431130;201306;3750;11130;3232;10269;985;3432;1446;4652;2431;8084
431140;201306;3308;9472;2230;7478;507;1993;756;2324;1263;4317
431142;201306;535;1644;499;1590;70;240;345;1123;415;1363
431150;201306;1297;4053;1081;3650;315;1090;393;1360;708;2450
431160;201306;846;2653;723;2375;160;524;399;1336;559;1860
431162;201306;412;1199;268;909;53;202;60;189;113;391
431164;201306;77;226;33;123;9;31;1;4;10;35
431170;201306;877;2710;750;2452;242;841;233;749;475;1590
431171;201306;846;2655;773;2510;267;943;203;608;470;1551
431173;201306;459;1443;436;1397;98;325;273;875;371;1200
431175;201306;1302;3724;1148;3485;385;1233;498;1505;883;2738
431177;201306;962;3266;881;3099;299;1118;388;1389;687;2507
431179;201306;113;316;90;273;19;67;38;99;57;166
431180;201306;3094;9728;2633;8619;769;2795;857;2632;1626;5427
431190;201306;735;2102;494;1640;151;549;179;587;330;1136
431198;201306;341;1146;310;1083;143;566;61;190;204;756
431200;201306;228;704;116;404;25;96;18;56;43;152
431205;201306;284;959;230;802;62;222;77;258;139;480
431210;201306;739;2197;651;2008;165;530;349;1062;514;1592
431213;201306;315;1003;267;914;81;308;107;350;188;658
431215;201306;325;978;181;625;52;200;31;93;83;293
431217;201306;214;705;193;655;69;255;50;173;119;428
431220;201306;1198;3155;975;2772;148;477;563;1563;711;2040
431225;201306;1309;4067;1183;3851;294;1021;692;2289;986;3310
431230;201306;918;2857;754;2507;129;479;413;1375;542;1854
431235;201306;41;124;37;114;14;46;14;42;28;88
431237;201306;407;1399;367;1334;152;631;130;439;282;1070
431238;201306;51;171;43;154;10;41;15;50;25;91
431240;201306;2824;9264;2491;8631;919;3383;820;2822;1739;6205
431242;201306;426;1418;407;1384;184;693;28;86;212;779
431244;201306;426;1082;336;941;65;224;168;438;233;662
431245;201306;911;2671;793;2466;181;592;480;1511;661;2103
431247;201306;190;621;169;583;64;233;64;214;128;447
431250;201306;1876;6114;1691;5836;582;2148;683;2447;1265;4595
431260;201306;307;982;268;904;70;266;58;184;128;450
431261;201306;220;811;199;766;52;225;72;261;124;486
431262;201306;306;929;172;629;28;129;71;257;99;386
431265;201306;1169;3326;826;2560;218;775;288;760;506;1535
431267;201306;185;587;157;536;45;166;64;199;109;365
431270;201306;2263;6700;2056;6388;691;2295;982;3076;1673;5371
431275;201306;211;710;156;559;52;186;35;116;87;302
431280;201306;143;475;104;379;32;135;23;65;55;200
431290;201306;308;1022;247;856;69;274;62;196;131;470
431295;201306;203;673;124;429;26;103;24;67;50;170
431300;201306;125;462;97;374;35;138;10;39;45;177
431301;201306;228;808;179;664;60;222;32;109;92;331
431303;201306;597;1721;519;1596;148;514;228;676;376;1190
431306;201306;2012;5768;1560;4936;347;1306;588;1659;935;2965
431308;201306;54;192;52;187;40;147;9;29;49;176
431310;201306;736;2453;573;2062;106;420;240;875;346;1295
431320;201306;788;2390;515;1827;161;637;117;374;278;1011
431330;201306;1792;4818;1015;3332;301;1099;235;754;536;1853
431333;201306;301;857;227;706;64;208;77;227;141;435
431335;201306;100;315;86;286;19;61;30;94;49;155
431337;201306;2373;7708;2124;7188;710;2548;723;2457;1433;5005
431339;201306;638;1920;513;1627;116;380;263;853;379;1233
431340;201306;26112;72667;20167;62540;5287;18307;8699;26289;13986;44596
431342;201306;573;1598;529;1516;119;357;337;951;456;1308
431344;201306;359;1046;291;928;23;77;188;611;211;688
431346;201306;266;763;187;570;55;182;60;177;115;359
431349;201306;499;1558;435;1396;87;276;215;702;302;978
431350;201306;3625;11316;3362;10883;534;1987;2280;7197;2814;9184
431360;201306;707;2054;582;1838;187;622;210;650;397;1272
431365;201306;1230;3975;1091;3737;453;1688;386;1291;839;2979
431370;201306;5308;16082;4697;15117;1199;4109;2522;8337;3721;12446
431380;201306;1129;3454;1066;3289;166;572;768;2328;934;2900
431390;201306;3291;10175;2636;8839;930;3389;780;2499;1710;5888
431395;201306;1567;4869;1426;4644;361;1253;633;2124;994;3377
431400;201306;143;519;109;432;41;182;12;35;53;217
431402;201306;1141;3003;768;2327;151;504;374;1098;525;1602
431403;201306;312;937;238;802;85;323;49;150;134;473
431405;201306;4289;12611;3496;11389;840;3227;1696;5285;2536;8512
431406;201306;753;2482;594;2074;204;741;215;737;419;1478
431407;201306;635;2022;496;1681;166;572;139;453;305;1025
431410;201306;15977;51489;13515;46608;5711;20899;3337;12091;9048;32990
431413;201306;161;454;108;343;12;46;56;177;68;223
431415;201306;837;2512;756;2364;196;673;416;1282;612;1955
431417;201306;652;1739;526;1537;98;310;286;864;384;1174
431420;201306;1574;4474;1422;4234;353;1128;793;2384;1146;3512
431430;201306;527;1564;441;1422;130;468;182;558;312;1026
431440;201306;31446;95359;29040;91260;9890;32468;13242;43143;23132;75611
431442;201306;198;656;154;539;49;192;18;47;67;239
431445;201306;436;1275;358;1093;65;218;168;502;233;720
431446;201306;482;1448;374;1235;92;313;199;654;291;967
431447;201306;827;2441;627;1983;114;383;301;974;415;1357
431449;201306;843;2550;738;2369;131;456;410;1339;541;1795
431450;201306;2167;5911;2023;5697;559;1592;1179;3342;1738;4934
431455;201306;577;1540;442;1288;93;313;232;645;325;958
431460;201306;3646;10580;3234;9787;901;2881;1427;4392;2328;7273
431470;201306;2113;6424;1918;5992;564;1748;885;2912;1449;4660
431475;201306;92;315;58;232;12;48;5;22;17;70
431477;201306;591;1766;498;1584;130;427;256;807;386;1234
431478;201306;168;451;92;282;23;75;37;110;60;185
431480;201306;2375;7375;1932;6517;662;2400;485;1636;1147;4036
431490;201306;100418;297624;90199;282489;18014;64039;57818;177891;75832;241930
431500;201306;1177;3127;951;2709;294;858;322;913;616;1771
431505;201306;345;1034;334;1019;38;112;267;824;305;936
431507;201306;427;1111;391;1053;110;308;225;612;335;920
431510;201306;2175;6164;1893;5713;323;1058;1203;3590;1526;4648
431513;201306;208;653;182;589;44;151;77;256;121;407
431514;201306;107;270;64;201;12;41;34;110;46;151
431515;201306;740;2316;594;1965;142;514;296;918;438;1432
431517;201306;84;292;81;283;36;128;19;56;55;184
431520;201306;439;1422;348;1204;108;385;89;321;197;706
431530;201306;4393;11219;3642;10399;866;2423;2272;6999;3138;9422
431531;201306;264;769;198;640;55;205;79;263;134;468
431532;201306;511;1533;485;1478;101;337;283;848;384;1185
431535;201306;374;1120;257;812;63;229;61;169;124;398
431540;201306;2048;6910;1884;6689;206;600;1399;5366;1605;5966
431545;201306;131;406;64;236;5;21;11;44;16;65
431550;201306;2403;7476;2259;7198;563;2034;1079;3391;1642;5425
431555;201306;741;2054;678;1953;149;436;364;1045;513;1481
431560;201306;22590;73216;20757;69689;9091;30952;6790;24120;15881;55072
431570;201306;5392;16030;5127;15611;857;2580;3735;11594;4592;14174
431575;201306;382;1156;335;1083;59;217;193;603;252;820
431580;201306;688;2260;599;2054;160;617;227;718;387;1335
431590;201306;891;2711;724;2331;87;302;400;1298;487;1600
431595;201306;601;1779;539;1644;131;426;221;688;352;1114
431600;201306;2116;6653;1727;5794;508;1934;376;1077;884;3011
431610;201306;1553;4568;1213;3962;313;1109;610;1985;923;3094
431620;201306;283;917;231;760;84;293;93;288;177;581
431630;201306;1327;3758;1107;3286;254;784;598;1792;852;2576
431640;201306;5540;17594;5195;17013;1643;5883;2565;8192;4208;14075
431642;201306;486;1516;449;1425;63;239;266;810;329;1049
431643;201306;173;535;163;516;48;164;84;246;132;410
431645;201306;1777;5591;1654;5381;412;1369;966;3234;1378;4603
431647;201306;166;477;136;414;45;142;38;96;83;238
431650;201306;185;614;133;506;33;150;31;101;64;251
431660;201306;1423;4388;1156;3822;400;1390;426;1339;826;2729
431670;201306;1306;3803;1103;3435;336;1188;447;1315;783;2503
431673;201306;164;559;138;494;43;167;37;136;80;303
431675;201306;277;939;221;761;59;213;61;182;120;395
431680;201306;9480;28388;7781;25277;2577;8965;2907;9520;5484;18485
431690;201306;24373;72415;20557;66661;6807;23572;8366;27568;15173;51140
431695;201306;135;490;111;413;27;100;26;74;53;174
431697;201306;467;1385;446;1347;136;435;203;613;339;1048
431700;201306;1625;4709;1433;4336;301;1014;782;2292;1083;3306
431710;201306;12537;37990;10787;34950;3151;10699;5014;16890;8165;27589
431720;201306;6931;20402;6057;18876;1511;5341;3246;9833;4757;15174
431725;201306;41;150;40;147;22;82;6;22;28;104
431730;201306;3549;11400;3033;10423;908;3484;1238;4226;2146;7710
431740;201306;5918;18000;5387;16989;1853;6269;1982;6148;3835;12417
431750;201306;10105;29826;8803;27661;1824;6192;4793;15337;6617;21529
431755;201306;225;630;82;288;25;102;20;56;45;158
431760;201306;3668;11695;3192;10744;992;3592;932;3095;1924;6687
431770;201306;2264;6489;1982;6024;508;1696;1056;3132;1564;4828
431775;201306;238;699;194;611;76;254;61;177;137;431
431780;201306;2474;6950;2049;6138;656;2120;593;1698;1249;3818
431790;201306;1087;3595;1008;3450;292;1074;529;1792;821;2866
431795;201306;418;1370;364;1200;51;179;229;751;280;930
431800;201306;9285;28357;8070;26168;2644;9379;2860;9108;5504;18487
431805;201306;239;593;69;249;18;76;13;46;31;122
431810;201306;3683;10744;3230;9789;870;2832;1510;4539;2380;7371
431820;201306;2678;8757;2443;8293;804;2953;774;2579;1578;5532
431830;201306;10067;28229;8847;26235;3344;10755;3176;9425;6520;20180
431840;201306;3481;10839;3104;10075;1011;3379;1334;4417;2345;7796
431842;201306;702;1887;434;1357;92;312;151;456;243;768
431843;201306;307;976;285;935;78;277;149;481;227;758
431844;201306;164;506;128;434;37;141;38;131;75;272
431845;201306;536;1691;508;1636;51;165;371;1223;422;1388
431846;201306;496;1569;446;1460;82;306;256;832;338;1138
431848;201306;193;527;95;326;19;79;22;67;41;146
431849;201306;301;798;135;423;25;87;37;103;62;190
431850;201306;4924;14732;4437;13826;1125;3900;2309;6984;3434;10884
431860;201306;955;2833;835;2630;234;804;399;1201;633;2005
431861;201306;80;266;57;197;17;64;11;36;28;100
431862;201306;472;1672;419;1554;162;653;124;444;286;1097
431870;201306;26162;75539;22279;68558;6349;21443;9739;29307;16088;50750
431880;201306;4569;15053;3922;13512;1261;4782;1555;5184;2816;9966
431890;201306;5761;17258;5196;16184;2114;6898;1614;5164;3728;12062
431900;201306;908;3004;800;2794;253;989;313;1001;566;1990
431910;201306;790;2002;467;1391;106;354;194;529;300;883
431912;201306;596;1761;479;1515;147;459;167;545;314;1004
431915;201306;1281;3661;1023;3170;305;982;352;1097;657;2079
431920;201306;1467;4379;1416;4304;203;603;1098;3414;1301;4017
431930;201306;1225;3566;1013;3198;146;449;613;2057;759;2506
431935;201306;94;370;89;357;41;172;18;56;59;228
431936;201306;488;1418;446;1342;72;212;294;959;366;1171
431937;201306;288;813;204;641;50;171;64;191;114;362
431940;201306;2662;7589;1952;6253;576;1969;557;1749;1133;3718
431950;201306;1847;6075;1656;5704;518;1957;629;2059;1147;4016
431960;201306;3690;11300;3406;10731;1109;3716;1230;3917;2339;7633
431970;201306;503;1424;289;977;54;192;95;305;149;497
431971;201306;125;392;111;371;22;80;66;214;88;294
431973;201306;464;1698;415;1595;68;262;241;1009;309;1271
431975;201306;12;50;9;42;2;12;4;16;6;28
431980;201306;1492;4432;1408;4300;357;1274;750;2231;1107;3505
431990;201306;8640;24973;7374;23071;1439;5162;3962;12297;5401;17459
432000;201306;10218;31163;8673;28440;2970;10089;3675;12225;6645;22314
432010;201306;2445;7476;2170;6949;546;2006;1050;3217;1596;5223
432020;201306;1958;5590;1800;5378;355;1135;1120;3346;1475;4481
432023;201306;507;1518;402;1281;115;410;158;469;273;879
432026;201306;1206;3824;1085;3579;235;787;618;2095;853;2882
432030;201306;406;1260;350;1134;102;358;145;443;247;801
432032;201306;455;1257;343;1070;58;195;217;663;275;858
432035;201306;830;2758;767;2621;207;771;429;1427;636;2198
432040;201306;664;2069;511;1713;122;457;125;328;247;785
432045;201306;191;653;169;605;49;192;73;253;122;445
432050;201306;752;2252;683;2119;144;467;398;1266;542;1733
432055;201306;753;2455;688;2316;155;571;426;1407;581;1978
432057;201306;470;1305;415;1194;61;195;247;669;308;864
432060;201306;402;1199;197;716;68;264;48;163;116;427
432065;201306;200;638;176;590;43;169;79;236;122;405
432067;201306;923;3145;703;2616;219;835;282;1022;501;1857
432070;201306;2180;6502;1975;6080;691;2327;747;2303;1438;4630
432080;201306;4039;12203;3688;11595;1156;3848;1670;5210;2826;9058
432085;201306;251;836;222;783;85;355;64;203;149;558
432090;201306;1617;5261;1434;4846;575;2081;378;1100;953;3181
432100;201306;1075;3330;675;2383;198;740;139;428;337;1168
432110;201306;2976;9209;2499;8253;933;3342;536;1747;1469;5089
432120;201306;4897;15568;4281;14354;1539;5653;1192;3854;2731;9507
432130;201306;1902;6170;1797;5990;526;1886;1013;3395;1539;5281
432132;201306;403;1285;268;952;47;171;100;328;147;499
432135;201306;786;2390;745;2316;148;489;477;1480;625;1969
432140;201306;2875;8715;2449;7939;701;2323;996;3623;1697;5946
432143;201306;1312;4182;1179;3970;260;905;772;2668;1032;3573
432145;201306;835;2721;631;2288;236;936;127;424;363;1360
432146;201306;237;789;196;687;69;254;59;206;128;460
432147;201306;822;2686;689;2402;203;741;313;1121;516;1862
432149;201306;387;1218;294;975;86;300;110;355;196;655
432150;201306;2947;9302;2500;8601;1041;3771;751;2680;1792;6451
432160;201306;4348;14666;3946;13970;1476;5527;1461;5445;2937;10972
432162;201306;310;780;96;321;25;95;24;64;49;159
432163;201306;323;842;105;333;20;62;23;72;43;134
432166;201306;753;2343;640;2114;154;572;278;847;432;1419
432170;201306;753;2593;558;2141;141;599;114;381;255;980
432180;201306;2687;7351;2027;6301;637;2177;652;1937;1289;4114
432183;201306;396;1354;374;1313;165;597;104;377;269;974
432185;201306;795;2378;549;1831;133;487;196;635;329;1122
432190;201306;3329;9567;2629;8007;743;2439;835;2401;1578;4840
432195;201306;1258;3664;1143;3492;201;669;733;2227;934;2896
432200;201306;3029;9730;2515;8825;872;3256;1001;3612;1873;6868
432210;201306;424;1301;383;1248;111;417;186;569;297;986
432215;201306;843;2759;781;2660;150;483;511;1831;661;2314
432218;201306;291;862;242;754;51;167;105;308;156;475
432220;201306;3692;10317;3153;9427;585;2028;1877;5449;2462;7477
432225;201306;57;205;51;197;30;119;6;29;36;148
432230;201306;992;2909;881;2741;291;1009;413;1213;704;2222
432232;201306;543;1653;440;1449;103;384;238;774;341;1158
432234;201306;567;1617;444;1306;111;338;189;532;300;870
432235;201306;68;226;43;163;20;86;10;38;30;124
432237;201306;486;1392;453;1338;39;145;378;1100;417;1245
432240;201306;14774;51370;13167;49201;3402;13661;7728;29549;11130;43210
432250;201306;5384;19515;5139;18998;2512;9897;1226;4651;3738;14548
432252;201306;400;1275;379;1234;125;418;191;647;316;1065
432253;201306;1208;4183;1007;3660;344;1300;337;1223;681;2523
432254;201306;334;918;162;541;49;174;20;65;69;239
432255;201306;164;433;95;324;25;95;40;138;65;233
432260;201306;6090;17038;4961;15205;1175;3849;2589;8004;3764;11853
432270;201306;2509;8257;2322;7920;644;2279;1257;4353;1901;6632
432280;201306;1034;3185;736;2540;195;775;202;583;397;1358
432285;201306;106;340;70;240;23;87;15;42;38;129
432290;201306;558;1783;419;1439;87;337;171;554;258;891
432300;201306;22123;70219;20679;67747;5835;20250;10830;35589;16665;55839
432310;201306;977;3181;862;2957;220;820;434;1437;654;2257
432320;201306;255;755;189;622;56;187;67;231;123;418
432330;201306;201;626;106;382;26;102;10;34;36;136
432335;201306;199;594;103;356;35;124;14;40;49;164
432340;201306;277;741;151;469;46;146;38;109;84;255
432345;201306;719;2134;674;2072;175;641;365;1045;540;1686
432350;201306;407;1247;323;1085;88;315;88;281;176;596
432360;201306;43;148;38;136;16;58;11;33;27;91
432370;201306;444;1306;396;1219;34;100;270;843;304;943
432375;201306;784;2128;703;1999;124;365;441;1268;565;1633
432377;201306;70;251;35;126;6;24;8;20;14;44
432380;201306;816;2984;754;2830;351;1440;233;818;584;2258
500020;201306;1724;5965;1458;5392;524;2132;367;1249;891;3381
500025;201306;892;2416;621;1940;134;442;265;797;399;1239
500060;201306;5415;16317;4747;15532;420;1341;3976;13418;4396;14759
500070;201306;3403;10882;2984;10186;805;3088;1353;4504;2158;7592
500080;201306;1580;4997;1298;4506;453;1703;416;1484;869;3187
500085;201306;2168;6074;1652;5253;260;910;967;2992;1227;3902
500090;201306;2065;6483;1754;5909;412;1432;921;3200;1333;4632
500100;201306;2271;7158;2166;7031;839;3046;932;2900;1771;5946
500110;201306;7492;22751;6330;20997;1076;3999;3793;12995;4869;16994
500124;201306;1490;5331;1351;5088;264;951;812;3311;1076;4262
500150;201306;1259;3536;1071;3270;311;1018;512;1542;823;2560
500190;201306;4466;12433;3589;11368;863;2964;1996;6519;2859;9483
500200;201306;2399;6520;1806;5674;451;1604;901;2723;1352;4327
500210;201306;4650;14619;4127;13852;1022;3668;2110;7337;3132;11005
500215;201306;1659;5400;1432;4915;375;1467;618;2001;993;3468
500220;201306;2453;8142;2083;7445;547;2121;847;3078;1394;5199
500230;201306;1553;4991;1401;4773;694;2516;421;1446;1115;3962
500240;201306;4047;13651;3321;12101;808;3279;1441;5390;2249;8669
500260;201306;2343;6752;1998;6211;500;1707;938;2753;1438;4460
500270;201306;93152;256226;67684;212527;22144;75651;18063;57621;40207;133272
500280;201306;1218;3762;1079;3562;257;916;585;1963;842;2879
500290;201306;3311;9237;2476;7742;763;2742;880;2538;1643;5280
500295;201306;2147;7047;1718;5965;462;1822;491;1518;953;3340
500310;201306;796;2219;722;2120;170;557;414;1158;584;1715
500315;201306;2669;8634;2347;8200;539;1828;1409;5260;1948;7088
500320;201306;12138;42657;10981;40589;3899;15103;4153;16391;8052;31494
500325;201306;3640;10386;2934;9232;927;3220;1086;3217;2013;6437
500330;201306;4839;14190;4323;13346;1375;4662;1984;5981;3359;10643
500345;201306;2137;6996;2000;6720;548;2029;972;3181;1520;5210
500348;201306;2279;7144;2156;6938;291;1015;1624;5239;1915;6254
500350;201306;1103;3516;752;2715;136;505;219;853;355;1358
500370;201306;20900;68428;17532;61858;4802;18819;7309;25704;12111;44523
500375;201306;2340;6901;1931;6150;491;1652;950;3129;1441;4781
500380;201306;2816;8466;2457;7732;744;2485;980;3090;1724;5575
500390;201306;524;1190;356;945;55;187;249;608;304;795
500400;201306;1160;3884;1030;3577;346;1310;298;957;644;2267
500410;201306;1980;5714;1703;5332;479;1643;770;2415;1249;4058
500430;201306;2339;7554;2025;7079;604;2212;911;3308;1515;5520
500440;201306;1273;3865;1112;3603;316;1173;591;1819;907;2992
500450;201306;2084;6664;1673;5802;475;1864;340;1054;815;2918
500460;201306;3390;10819;2857;10015;768;2901;1323;4651;2091;7552
500470;201306;3240;10524;2828;9506;992;3593;652;2041;1644;5634
500480;201306;1941;6526;1809;6315;192;737;1408;4989;1600;5726
500490;201306;963;2950;859;2780;299;1048;330;1083;629;2131
500500;201306;2877;9372;2457;8817;966;3887;911;3134;1877;7021
500510;201306;750;2136;573;1866;168;657;235;668;403;1325
500515;201306;1675;4891;1404;4500;279;874;875;2979;1154;3853
500520;201306;2503;9136;2262;8828;594;2410;1362;5533;1956;7943
500525;201306;1060;3687;955;3498;251;976;467;1811;718;2787
500540;201306;3691;12044;2934;10607;981;3887;937;3365;1918;7252
500560;201306;4267;15170;3923;14674;904;3578;2455;9335;3359;12913
500568;201306;3466;9579;2693;8456;654;2237;1299;4161;1953;6398
500570;201306;7123;20255;5327;17157;1623;5581;2116;6871;3739;12452
500580;201306;2931;9290;2443;8377;560;2027;1309;4501;1869;6528
500600;201306;2224;6976;1905;6445;660;2369;732;2427;1392;4796
500620;201306;7318;21353;5533;18487;1466;5492;2666;8776;4132;14268
500625;201306;822;2543;595;2066;163;623;202;650;365;1273
500630;201306;5842;16944;4806;15464;1790;6389;1346;4308;3136;10697
500635;201306;2153;8961;1969;8667;331;1376;1255;6010;1586;7386
500640;201306;1200;3341;1012;3059;166;562;664;1961;830;2523
500660;201306;13062;41995;11486;39226;2512;9313;6662;22815;9174;32128
500690;201306;2891;8644;2423;8060;614;2136;1362;4746;1976;6882
500710;201306;3027;10012;2889;9799;887;3154;1488;5096;2375;8250
500720;201306;3853;12219;3214;10969;1114;4165;1115;3762;2229;7927
500730;201306;865;2584;720;2301;200;719;294;902;494;1621
500740;201306;3405;9872;2615;8512;629;2362;1174;3600;1803;5962
500750;201306;731;2321;689;2258;177;639;399;1288;576;1927
500755;201306;1183;3685;944;3229;239;877;386;1288;625;2165
500769;201306;4186;11878;3037;9596;759;2682;1050;3057;1809;5739
500770;201306;1506;4758;1287;4355;376;1362;499;1727;875;3089
500780;201306;899;3069;858;2981;313;1170;358;1199;671;2369
500790;201306;7650;23098;6585;21203;1511;5659;3449;10584;4960;16243
500793;201306;2309;6913;1894;6196;370;1385;838;2574;1208;3959
500795;201306;2094;6517;1899;6229;213;640;1458;4999;1671;5639
500797;201306;835;2432;688;2201;168;592;319;1037;487;1629
500800;201306;2008;6361;1764;6016;567;2116;830;2825;1397;4941
500830;201306;13354;42204;10681;36409;3558;13056;2936;9867;6494;22923
500840;201306;1203;3795;1015;3426;209;769;518;1732;727;2501
510010;201306;1204;3932;1141;3831;387;1382;505;1721;892;3103
510020;201306;2383;7244;1888;6402;589;2145;518;1670;1107;3815
510025;201306;8596;26887;7694;25384;2546;9245;3105;10008;5651;19253
510030;201306;2050;5694;1765;5287;544;1690;868;2663;1412;4353
510035;201306;896;2745;773;2558;189;641;419;1462;608;2103
510040;201306;1530;4353;1224;3905;298;1090;604;1872;902;2962
510050;201306;1599;4960;1285;4404;383;1452;507;1751;890;3203
510060;201306;1128;3440;899;3010;286;1058;273;875;559;1933
510080;201306;1273;4036;1083;3720;322;1306;422;1312;744;2618
510100;201306;573;1575;393;1228;100;348;146;440;246;788
510120;201306;280;597;203;511;15;31;180;462;195;493
510125;201306;2786;7644;2330;6910;482;1749;1181;3330;1663;5079
510130;201306;1907;5559;1717;5301;531;1721;756;2362;1287;4083
510140;201306;2857;9685;2425;9018;887;3428;962;3673;1849;7101
510160;201306;1265;4364;1213;4304;89;353;1071;3797;1160;4150
510170;201306;5292;17196;4699;16101;1302;5007;2144;7129;3446;12136
510180;201306;9373;27485;7383;24096;2437;8458;2748;9626;5185;18084
510185;201306;1027;3346;964;3255;254;831;575;2068;829;2899
510190;201306;1480;5245;1272;4914;340;1470;570;2257;910;3727
510250;201306;13113;43225;11562;41127;3656;13733;5739;20886;9395;34619
510260;201306;2470;9251;2346;9008;662;2529;1266;5133;1928;7662
510263;201306;3844;11039;3077;9801;912;3171;1125;3509;2037;6680
510267;201306;4067;12591;3480;11405;886;3240;1548;4903;2434;8143
510268;201306;816;2425;717;2291;218;767;356;1126;574;1893
510269;201306;806;2695;731;2568;242;881;293;1076;535;1957
510270;201306;2235;7236;2028;6936;481;1676;1095;3979;1576;5655
510279;201306;2001;6661;1854;6413;714;2734;665;2149;1379;4883
510285;201306;1396;4492;1216;4141;380;1399;410;1325;790;2724
510300;201306;2892;9361;2667;9061;405;1536;1957;6612;2362;8148
510305;201306;1593;5248;1340;4769;376;1472;466;1720;842;3192
510310;201306;1059;3129;855;2805;310;1125;262;845;572;1970
510320;201306;3724;11494;3114;10272;1009;3861;601;1683;1610;5544
510325;201306;5319;17482;4696;16561;610;2108;3571;13063;4181;15171
510330;201306;2595;8762;2292;8205;640;2522;903;3300;1543;5822
510335;201306;4232;13888;3803;13307;672;2350;2715;9851;3387;12201
510336;201306;471;1537;433;1464;102;372;222;750;324;1122
510337;201306;2207;7635;2021;7295;840;3099;734;2850;1574;5949
510340;201306;54928;170547;45953;157037;18999;70383;11166;40239;30165;110622
510343;201306;1045;3252;985;3180;131;402;781;2606;912;3008
510345;201306;1561;4719;1392;4463;405;1358;584;1903;989;3261
510350;201306;3012;9416;2623;8894;810;2917;1333;4602;2143;7519
510360;201306;1662;4732;1340;4326;288;987;876;2819;1164;3806
510370;201306;789;2893;706;2751;227;938;317;1264;544;2202
510380;201306;468;1571;389;1401;144;586;74;241;218;827
510385;201306;837;3280;759;3094;140;589;387;1713;527;2302
510390;201306;1022;3375;945;3281;266;909;513;1910;779;2819
510395;201306;811;2186;640;1966;130;426;387;1240;517;1666
510410;201306;3657;12524;3495;12252;1113;4221;1737;6034;2850;10255
510420;201306;2131;5798;1668;5020;288;1038;921;2731;1209;3769
510450;201306;554;1597;433;1422;142;514;140;459;282;973
510452;201306;589;1890;447;1566;122;489;159;506;281;995
510454;201306;683;2279;611;2172;168;628;328;1204;496;1832
510455;201306;926;2958;754;2660;200;829;309;1070;509;1899
510460;201306;1653;5153;1547;5012;370;1376;952;2968;1322;4344
510480;201306;3813;10857;3080;9472;805;2693;1327;4035;2132;6728
510490;201306;1400;4820;1292;4662;391;1486;705;2549;1096;4035
510500;201306;1222;3989;1019;3659;289;1172;526;1845;815;3017
510510;201306;2845;10275;2573;9826;1006;4017;1044;4024;2050;8041
510515;201306;5073;16242;4305;14699;1238;4724;1339;4360;2577;9084
510517;201306;1567;5036;1426;4831;430;1433;846;2986;1276;4419
510520;201306;2100;5648;1698;5077;146;517;1299;3846;1445;4363
510523;201306;993;3134;843;2880;266;991;366;1225;632;2216
510525;201306;7416;19096;4700;14758;1215;4156;1644;5065;2859;9221
510530;201306;543;1618;485;1536;91;336;283;893;374;1229
510550;201306;2465;8464;2243;8135;639;2348;1169;4441;1808;6789
510558;201306;1934;5780;1533;5182;519;1902;526;1743;1045;3645
510560;201306;1417;4896;1133;4386;444;1782;262;1076;706;2858
510562;201306;4705;14821;4284;13997;1552;5544;1478;4859;3030;10403
510590;201306;2461;7528;1995;6929;610;2346;868;3022;1478;5368
510600;201306;1346;3574;998;3063;176;605;576;1718;752;2323
510610;201306;2421;7749;2309;7622;300;1147;1874;6107;2174;7254
510615;201306;2027;6964;1829;6608;599;2348;799;2831;1398;5179
510617;201306;480;1602;448;1558;81;314;332;1143;413;1457
510618;201306;1196;3674;917;3128;246;923;405;1386;651;2309
510619;201306;750;2148;504;1694;110;412;166;563;276;975
510620;201306;1151;3194;814;2718;298;1100;169;535;467;1635
510621;201306;1086;3878;952;3565;303;1234;345;1254;648;2488
510622;201306;3096;10095;2323;8219;656;2600;447;1388;1103;3988
510623;201306;3238;9809;2895;9317;1175;3927;938;3082;2113;7009
510624;201306;987;3365;881;3143;215;865;396;1333;611;2198
510625;201306;1897;6051;1641;5535;544;2001;543;1718;1087;3719
510626;201306;1134;3801;975;3541;319;1251;470;1728;789;2979
510627;201306;616;2043;521;1853;205;782;179;634;384;1416
510628;201306;1396;3831;1173;3556;183;640;815;2433;998;3073
510629;201306;1677;5735;1485;5330;586;2259;338;1182;924;3441
510630;201306;2554;8724;2190;8112;767;3103;672;2569;1439;5672
510631;201306;392;1200;356;1141;77;247;235;760;312;1007
510637;201306;2375;7532;2228;7256;713;2591;1060;3326;1773;5917
510642;201306;4309;14569;3737;13822;1304;4974;1777;6907;3081;11881
510645;201306;646;1676;528;1533;185;568;189;600;374;1168
510650;201306;5575;19694;5303;19339;1327;5149;3202;12036;4529;17185
510665;201306;1123;3034;858;2713;217;788;464;1464;681;2252
510670;201306;347;878;211;679;54;197;85;253;139;450
510675;201306;5832;19846;5134;18545;1894;7447;1546;5522;3440;12969
510677;201306;2347;6202;1787;5499;254;815;1312;4114;1566;4929
510680;201306;758;2442;661;2294;178;691;260;826;438;1517
510682;201306;2149;7196;1847;6637;511;1918;844;3194;1355;5112
510685;201306;718;2313;688;2270;158;567;421;1405;579;1972
510700;201306;2844;8810;2465;8272;568;2114;1494;4931;2062;7045
510704;201306;7170;21445;6204;19693;1830;6530;2890;8805;4720;15335
510706;201306;1321;4531;1228;4357;414;1551;586;2024;1000;3575
510710;201306;3399;10023;2863;8978;856;3089;1055;2979;1911;6068
510715;201306;674;1821;459;1464;131;455;160;463;291;918
510718;201306;1567;5036;1468;4877;338;1184;939;3142;1277;4326
510719;201306;430;1013;261;779;35;145;123;330;158;475
510720;201306;1223;2980;920;2621;96;311;698;1998;794;2309
510724;201306;805;2551;707;2367;150;535;436;1457;586;1992
510726;201306;641;1793;574;1688;165;523;263;747;428;1270
510729;201306;566;1709;499;1602;156;534;220;697;376;1231
510730;201306;2057;6706;1913;6447;464;1832;1132;3629;1596;5461
510735;201306;1054;3782;919;3559;350;1424;375;1465;725;2889
510740;201306;955;2531;799;2320;170;490;491;1473;661;1963
510757;201306;621;2278;597;2218;167;664;309;1125;476;1789
510760;201306;23480;72077;20382;66581;7829;27304;6833;22244;14662;49548
510770;201306;3413;10785;3283;10605;603;1961;2225;7540;2828;9501
510774;201306;363;1041;304;959;56;203;178;553;234;756
510775;201306;820;2365;688;2180;271;959;278;904;549;1863
510776;201306;346;1097;306;1027;80;301;152;474;232;775
510777;201306;1298;4264;1050;3952;237;1050;641;2355;878;3405
510779;201306;605;1836;477;1602;93;335;198;695;291;1030
510780;201306;3446;10789;3152;10379;750;2621;1869;6251;2619;8872
510785;201306;1800;5488;1514;5016;512;1781;583;1974;1095;3755
510787;201306;1831;5995;1659;5677;513;1919;615;2042;1128;3961
510788;201306;337;1073;309;1035;132;418;106;381;238;799
510790;201306;13210;40755;9609;33750;3041;12205;1479;5030;4520;17235
510792;201306;5095;17507;4009;15116;1157;4981;737;2570;1894;7551
510794;201306;1284;4135;1042;3760;534;2032;198;665;732;2697
510795;201306;7310;25803;6434;23905;2376;9381;1783;6751;4159;16132
510800;201306;1637;4929;1439;4662;407;1484;716;2206;1123;3690
510805;201306;1580;4735;1310;4347;302;1161;813;2605;1115;3766
510810;201306;631;1623;513;1460;159;486;257;716;416;1202
510820;201306;820;2103;640;1830;168;563;254;661;422;1224
510830;201306;528;1911;484;1842;174;718;215;853;389;1571
510835;201306;653;2125;531;1896;203;794;212;702;415;1496
510840;201306;44001;117077;36841;108267;9812;30510;19684;59755;29496;90265
510850;201306;1594;4876;1333;4464;598;2229;203;549;801;2778
510860;201306;2290;7953;1987;7309;763;2985;437;1621;1200;4606
510880;201306;789;2745;705;2588;274;1051;253;928;527;1979
510885;201306;506;1505;389;1321;95;366;173;581;268;947
510890;201306;870;3026;759;2804;258;1059;189;648;447;1707
510895;201306;983;3296;914;3184;292;1139;401;1323;693;2462
520005;201306;1034;3509;974;3413;323;1195;408;1433;731;2628
520010;201306;1744;6252;1567;5855;714;2952;233;729;947;3681
520013;201306;3775;10793;3025;9520;787;2649;1449;4618;2236;7267
520015;201306;573;1605;463;1442;124;396;224;730;348;1126
520017;201306;1161;3810;1030;3584;302;1156;444;1513;746;2669
520020;201306;368;1036;306;943;92;295;156;494;248;789
520025;201306;19042;65268;18693;64813;3428;12574;13980;48449;17408;61023
520030;201306;4174;14130;3792;13477;1388;5284;1330;4919;2718;10203
520050;201306;321;984;304;948;66;233;199;597;265;830
520055;201306;652;1986;565;1846;152;500;278;946;430;1446
520060;201306;1579;5143;1408;4806;357;1364;558;1958;915;3322
520080;201306;1460;5048;1385;4880;341;1246;778;2789;1119;4035
520082;201306;597;2109;570;2050;163;582;332;1240;495;1822
520085;201306;980;3173;861;2884;221;807;353;1192;574;1999
520090;201306;760;2125;700;2023;114;322;464;1367;578;1689
520110;201306;34611;109529;28014;99572;11738;45373;7511;27027;19249;72400
520120;201306;256;674;149;485;41;151;42;150;83;301
520130;201306;3335;10345;3190;10123;834;2886;1783;5651;2617;8537
520140;201306;40870;141257;37581;134583;14142;54507;11936;42609;26078;97116
520145;201306;532;1411;396;1229;93;313;168;505;261;818
520150;201306;640;1733;545;1612;170;550;253;738;423;1288
520160;201306;775;2406;704;2305;253;881;294;976;547;1857
520170;201306;3551;9112;2893;8411;667;2029;1846;5537;2513;7566
520180;201306;1392;4683;1301;4521;423;1580;559;1917;982;3497
520215;201306;1387;3897;1230;3665;255;870;745;2222;1000;3092
520235;201306;752;2131;617;1940;198;681;269;826;467;1507
520250;201306;1097;3759;1022;3627;359;1346;483;1751;842;3097
520260;201306;696;1907;554;1654;98;338;285;819;383;1157
520280;201306;543;1634;494;1555;235;773;138;473;373;1246
520310;201306;881;2377;728;2194;201;618;449;1407;650;2025
520320;201306;1330;4451;1161;4137;296;1114;562;2032;858;3146
520330;201306;2583;8383;2123;7615;717;2804;692;2455;1409;5259
520340;201306;1805;4757;1495;4391;241;693;1135;3422;1376;4115
520350;201306;2735;8715;2447;8132;953;3376;1016;3292;1969;6668
520355;201306;1070;3826;1049;3777;430;1627;440;1578;870;3205
520357;201306;878;2475;764;2313;80;278;534;1599;614;1877
520360;201306;557;1545;493;1442;138;412;234;687;372;1099
520380;201306;977;2731;780;2443;163;550;437;1396;600;1946
520390;201306;1156;3165;816;2699;283;1069;294;895;577;1964
520393;201306;548;1505;505;1439;96;282;343;992;439;1274
520396;201306;661;2197;639;2160;77;301;481;1639;558;1940
520400;201306;1724;5040;1479;4698;270;924;1009;3230;1279;4154
520410;201306;1330;3923;1101;3582;367;1312;492;1546;859;2858
520420;201306;315;898;254;798;60;223;122;363;182;586
520425;201306;1392;3960;1322;3830;441;1378;633;1796;1074;3174
520430;201306;1791;4968;1395;4331;330;1183;639;1935;969;3118
520440;201306;2567;7490;2123;6801;816;2853;636;2013;1452;4866
520450;201306;8739;26270;7187;23449;2299;8371;1865;5696;4164;14067
520455;201306;652;2009;551;1843;229;816;146;499;375;1315
520460;201306;728;2232;625;2056;208;756;223;730;431;1486
520465;201306;793;2216;698;2088;179;643;313;862;492;1505
520470;201306;1616;5421;1490;5232;371;1326;916;3338;1287;4664
520480;201306;834;2584;772;2502;181;601;508;1668;689;2269
520485;201306;1096;3798;1027;3685;396;1517;444;1576;840;3093
520490;201306;4249;13511;3485;12311;1447;5526;1175;4155;2622;9681
520495;201306;1370;3773;1153;3513;57;134;1056;3303;1113;3437
520500;201306;1976;5357;1793;5114;593;1769;797;2504;1390;4273
520505;201306;830;2468;724;2306;112;331;532;1751;644;2082
520510;201306;10481;30359;7078;24405;2253;8549;1781;6091;4034;14640
520520;201306;954;2889;844;2738;343;1187;320;1051;663;2238
520530;201306;2316;7324;2039;6871;478;1646;1013;3756;1491;5402
520540;201306;2789;8874;2509;8371;870;3058;1040;3430;1910;6488
520545;201306;1266;4034;1100;3683;351;1278;330;1041;681;2319
520547;201306;797;2552;636;2257;215;841;188;626;403;1467
520549;201306;7567;24078;6791;23177;1606;5960;4466;15108;6072;21068
520551;201306;3464;10842;3336;10679;1006;3347;1852;6198;2858;9545
520552;201306;670;2297;655;2276;138;535;432;1476;570;2011
520570;201306;559;1698;424;1469;185;676;80;284;265;960
520580;201306;1864;5640;1530;5115;490;1841;387;1207;877;3048
520590;201306;1426;4181;1272;3942;357;1197;580;1681;937;2878
520620;201306;6591;22076;6088;21293;1461;5520;3527;12485;4988;18005
520630;201306;594;1666;511;1566;151;440;312;1003;463;1443
520640;201306;2231;6965;2102;6773;785;2599;923;3137;1708;5736
520650;201306;767;2310;689;2167;298;994;252;781;550;1775
520660;201306;351;1145;314;1068;111;412;95;318;206;730
520670;201306;701;2215;691;2202;75;187;593;1956;668;2143
520680;201306;483;1615;457;1578;179;670;164;553;343;1223
520690;201306;304;808;217;690;28;94;123;409;151;503
520710;201306;300;853;276;820;7;24;214;626;221;650
520725;201306;1620;4468;1322;4069;333;1125;710;2175;1043;3300
520735;201306;574;1822;499;1692;187;661;155;507;342;1168
520740;201306;1592;4828;1371;4517;393;1365;660;2192;1053;3557
520750;201306;664;1820;512;1625;147;526;300;941;447;1467
520753;201306;1068;3225;1053;3200;170;471;817;2571;987;3042
520760;201306;1115;3194;994;3043;329;1088;534;1603;863;2691
520780;201306;1809;4809;1614;4557;185;524;1288;3700;1473;4224
520790;201306;2379;7195;2165;6884;347;1217;1520;4879;1867;6096
520800;201306;16259;50052;14616;48071;3434;11391;8785;30825;12219;42216
520810;201306;799;2454;784;2425;112;366;609;1915;721;2281
520815;201306;352;1278;295;1157;166;705;43;171;209;876
520830;201306;1653;4365;1301;3998;68;185;1168;3681;1236;3866
520840;201306;1597;5514;1453;5221;484;1844;558;2055;1042;3899
520850;201306;775;2301;618;2082;193;693;282;932;475;1625
520860;201306;6751;20154;5269;18198;1582;5929;2561;8967;4143;14896
520870;201306;116266;335626;84021;276137;27962;99599;25109;82244;53071;181843
520880;201306;5687;17453;4382;15280;1385;5363;603;1869;1988;7232
520890;201306;3317;10374;3073;9988;777;2691;1644;5315;2421;8006
520910;201306;3661;12070;3256;11228;1162;4322;976;3226;2138;7548
520915;201306;868;2501;642;2051;152;514;236;720;388;1234
520920;201306;2508;7482;2081;6825;568;2007;824;2743;1392;4750
520929;201306;419;1290;390;1254;114;379;199;638;313;1017
520940;201306;896;2869;851;2804;117;441;649;2108;766;2549
520945;201306;631;1615;566;1511;204;568;205;496;409;1064
520960;201306;855;2569;720;2369;118;413;460;1521;578;1934
520970;201306;3246;9637;2654;8569;583;2136;1159;3678;1742;5814
520980;201306;997;2754;937;2671;140;419;747;2133;887;2552
520990;201306;3602;11457;3202;10757;718;2584;1702;6208;2420;8792
520993;201306;967;2893;793;2537;171;602;406;1256;577;1858
520995;201306;2446;6876;2217;6567;367;1129;1615;4814;1982;5943
521000;201306;7288;22515;6357;21036;1600;5763;3443;11478;5043;17241
521010;201306;3335;10927;3005;10281;844;3110;1372;4704;2216;7814
521015;201306;678;1993;588;1853;160;524;297;940;457;1464
521020;201306;4142;12654;3448;11227;1347;4754;762;2226;2109;6980
521030;201306;786;2152;703;2037;142;430;480;1413;622;1843
521040;201306;4960;15075;4542;14402;1460;4662;2419;7972;3879;12634
521056;201306;958;3013;824;2791;281;1001;353;1217;634;2218
521060;201306;1101;3171;952;2913;234;776;382;1126;616;1902
521080;201306;1088;2863;750;2283;179;655;275;726;454;1381
521090;201306;2997;9204;2628;8681;917;3249;1079;3574;1996;6823
521100;201306;1369;3649;1275;3545;225;624;925;2631;1150;3255
521120;201306;4564;13616;4194;12979;1013;3065;2395;7721;3408;10786
521130;201306;984;2945;862;2752;183;655;457;1490;640;2145
521140;201306;861;2981;784;2797;329;1240;163;556;492;1796
521150;201306;10436;29085;8553;25987;2697;8966;4181;12668;6878;21634
521160;201306;666;1761;498;1428;99;312;297;819;396;1131
521170;201306;1292;3198;1127;2997;316;817;660;1770;976;2587
521180;201306;5924;20961;5495;20031;2170;8398;1536;5597;3706;13995
521190;201306;7911;24564;6193;21584;2293;8383;2053;7217;4346;15600
521200;201306;775;2137;736;2088;112;325;540;1550;652;1875
521205;201306;449;1498;422;1442;67;252;269;931;336;1183
521210;201306;755;2338;581;2004;223;858;217;672;440;1530
521220;201306;3456;10306;3047;9725;1126;3862;1128;3549;2254;7411
521225;201306;361;970;292;879;51;179;187;567;238;746
521230;201306;1240;4030;1188;3911;437;1530;546;1745;983;3275
521250;201306;24166;83558;23280;82071;9711;36295;8972;32159;18683;68454
521260;201306;562;1482;448;1246;93;324;218;572;311;896
521270;201306;1660;5534;1569;5378;144;429;1266;4518;1410;4947
521280;201306;1603;5165;1410;4846;479;1731;616;2122;1095;3853
521290;201306;485;1452;371;1258;101;412;153;495;254;907
521295;201306;1046;3044;979;2948;205;679;658;1952;863;2631
521300;201306;1625;4923;1486;4685;477;1592;598;1953;1075;3545
521305;201306;801;2163;686;2006;155;454;428;1299;583;1753
521308;201306;4621;14339;3847;13088;762;2860;2350;7897;3112;10757
521310;201306;6286;20097;5501;18831;2288;8293;1611;5461;3899;13754
521340;201306;237;779;217;743;73;276;87;280;160;556
521350;201306;2013;5428;1669;4980;236;796;1087;3410;1323;4206
521370;201306;979;3220;913;3090;341;1235;337;1105;678;2340
521375;201306;1263;3694;1112;3454;291;960;597;1844;888;2804
521377;201306;939;2964;915;2930;94;288;772;2520;866;2808
521380;201306;3442;10431;2886;9575;696;2563;1337;4349;2033;6912
521385;201306;574;1677;520;1603;162;528;263;814;425;1342
521390;201306;1075;2927;835;2592;331;1152;255;782;586;1934
521400;201306;2324;6385;2022;6047;284;902;1590;4742;1874;5644
521405;201306;1003;3191;982;3158;160;505;714;2353;874;2858
521410;201306;723;2386;671;2297;330;1109;220;802;550;1911
521440;201306;1408;3981;1383;3954;140;361;1195;3490;1335;3851
521450;201306;4756;14645;4012;13242;1335;4741;991;3078;2326;7819
521460;201306;6492;21271;6018;20514;1921;6979;2937;10135;4858;17114
521470;201306;712;2070;546;1758;131;471;129;434;260;905
521480;201306;509;1505;382;1285;133;468;99;335;232;803
521483;201306;2711;7676;2460;7266;603;1882;1354;3945;1957;5827
521486;201306;1485;4351;1355;4092;391;1330;770;2192;1161;3522
521487;201306;535;1483;411;1299;101;326;215;689;316;1015
521490;201306;768;2305;645;2142;136;498;387;1299;523;1797
521500;201306;1097;3723;1042;3637;109;392;850;2959;959;3351
521520;201306;862;2083;774;1984;186;388;445;1292;631;1680
521523;201306;10721;40627;10072;39483;2906;12313;4939;19484;7845;31797
521525;201306;954;2548;859;2422;125;394;575;1572;700;1966
521530;201306;1871;5724;1348;4683;563;2064;230;759;793;2823
521540;201306;862;2587;667;2185;219;823;163;459;382;1282
521550;201306;771;2104;717;2029;218;691;387;1035;605;1726
521560;201306;4958;15364;3962;14030;1708;6587;986;3327;2694;9914
521565;201306;593;1755;545;1694;95;319;389;1218;484;1537
521570;201306;3739;11139;3170;10168;1218;4180;1067;3452;2285;7632
521580;201306;565;1520;454;1365;174;554;159;492;333;1046
521590;201306;706;2060;616;1909;253;848;125;411;378;1259
521600;201306;612;1646;444;1346;116;388;155;422;271;810
521630;201306;1720;4823;1471;4419;612;2134;267;650;879;2784
521640;201306;1637;4933;1464;4662;529;1941;390;1262;919;3203
521645;201306;604;1957;543;1822;157;585;230;711;387;1296
521680;201306;1305;4413;1234;4252;759;2723;249;830;1008;3553
521690;201306;551;1678;498;1574;113;405;259;777;372;1182
521710;201306;2050;6580;1845;6187;394;1414;1118;3719;1512;5133
521720;201306;1970;6032;1817;5821;446;1467;1096;3602;1542;5069
521730;201306;3549;12280;3393;11971;1514;5815;1055;3495;2569;9310
521740;201306;3209;9147;2624;8389;1274;4204;876;2891;2150;7095
521760;201306;11625;40969;11105;40180;1952;7879;7746;28105;9698;35984
521770;201306;2680;8277;2316;7566;1019;3553;527;1623;1546;5176
521800;201306;8228;25295;7253;23884;2771;9549;3317;11264;6088;20813
521805;201306;691;1763;667;1731;242;560;345;1049;587;1609
521810;201306;805;2447;713;2290;188;664;369;1175;557;1839
521830;201306;5332;18387;5076;17979;1064;4099;3451;12164;4515;16263
521839;201306;630;1989;540;1791;150;536;228;721;378;1257
521850;201306;6145;18031;5718;17469;1296;3869;3717;11754;5013;15623
521860;201306;1647;5167;1452;4754;426;1535;539;1668;965;3203
521870;201306;541;1912;507;1823;166;647;138;454;304;1101
521878;201306;408;1410;381;1362;150;602;110;360;260;962
521880;201306;22092;60924;15714;50377;5964;20487;4568;14793;10532;35280
521890;201306;3463;11085;2992;10140;1198;4329;702;2367;1900;6696
521900;201306;1626;4363;1346;3965;370;1232;534;1457;904;2689
521910;201306;1140;3344;1008;3187;266;919;578;1855;844;2774
521920;201306;398;1296;390;1279;162;569;185;597;347;1166
521925;201306;571;1806;531;1706;118;417;295;907;413;1324
521930;201306;4043;13423;3732;12788;1495;5452;1150;3891;2645;9343
521935;201306;667;2029;635;1968;178;594;364;1090;542;1684
521940;201306;1139;3113;952;2824;365;1143;327;978;692;2121
521945;201306;645;2287;602;2235;127;423;439;1719;566;2142
521950;201306;464;1563;419;1473;160;606;151;521;311;1127
521960;201306;907;2700;784;2476;205;697;387;1213;592;1910
521970;201306;2317;6827;2180;6635;382;1209;1531;4776;1913;5985
521971;201306;890;2549;745;2309;201;685;337;1003;538;1688
521973;201306;787;2738;727;2615;219;818;235;847;454;1665
521975;201306;12072;36647;11456;35849;2369;8134;7424;23279;9793;31413
521980;201306;1666;5516;1632;5475;291;938;1261;4367;1552;5305
521990;201306;983;3211;934;3116;202;744;552;1792;754;2536
522000;201306;2041;6204;1834;5936;397;1349;1116;3776;1513;5125
522005;201306;305;889;246;792;65;228;127;393;192;621
522010;201306;2740;8485;2434;7991;910;3275;754;2395;1664;5670
522015;201306;963;2934;819;2716;243;891;429;1418;672;2309
522020;201306;3946;11677;3545;11160;1022;3374;1915;6036;2937;9410
522026;201306;488;1611;419;1539;218;837;138;507;356;1344
522028;201306;512;1565;466;1487;120;419;269;836;389;1255
522040;201306;2818;7404;2039;6381;754;2558;777;2406;1531;4964
522045;201306;11894;40535;10501;37505;3659;14254;2278;7895;5937;22149
522050;201306;1008;3040;853;2776;294;1057;342;1061;636;2118
522060;201306;2601;8754;2443;8539;799;2949;1389;4859;2188;7808
522068;201306;1371;4674;1290;4581;121;383;1093;4010;1214;4393
522070;201306;812;2516;746;2407;134;515;468;1483;602;1998
522100;201306;797;2224;708;2085;267;901;325;879;592;1780
522108;201306;868;2600;788;2485;80;265;594;1918;674;2183
522119;201306;1417;4389;1245;4175;139;463;1013;3470;1152;3933
522130;201306;498;1445;429;1367;127;453;221;702;348;1155
522140;201306;15741;46244;14155;44230;4199;14023;7647;23939;11846;37962
522145;201306;898;2627;849;2542;458;1450;203;591;661;2041
522150;201306;1229;3260;1012;2978;345;1076;418;1283;763;2359
522155;201306;704;2147;647;2066;157;534;380;1239;537;1773
522157;201306;652;1978;600;1893;80;276;453;1434;533;1710
522160;201306;5443;16177;4265;14311;1975;7261;854;2708;2829;9969
522170;201306;3147;8814;2710;8227;735;2267;1331;4259;2066;6526
522180;201306;431;1302;344;1192;170;644;117;393;287;1037
522185;201306;13507;44627;12869;43744;2754;10151;8189;28060;10943;38211
522190;201306;670;2002;606;1858;124;398;361;1117;485;1515
522200;201306;1512;5166;1415;4963;540;2025;447;1531;987;3556
522205;201306;1483;4357;1257;3987;383;1245;567;1824;950;3069
522220;201306;967;3122;891;3016;228;817;489;1745;717;2562
522230;201306;872;2910;826;2827;209;762;477;1677;686;2439
530010;201306;242381;806908;219237;758881;69466;264453;70816;245210;140282;509663
110001;201305;4102;13895;3575;13060;1085;4125;1943;7203;3028;11328
110002;201305;11630;39142;10589;37276;3762;14089;4543;16124;8305;30213
110003;201305;983;3229;919;3126;273;977;399;1327;672;2304
110004;201305;8879;30207;7989;28354;2618;10137;3085;10931;5703;21068
110005;201305;2260;7870;2174;7706;810;2940;979;3516;1789;6456
110006;201305;3398;9201;2158;7495;726;2666;677;2255;1403;4921
110007;201305;1399;4685;1295;4535;366;1303;758;2722;1124;4025
110008;201305;2368;8483;2231;8282;548;1949;1482;5762;2030;7711
110009;201305;4801;14396;3964;13255;889;3063;2575;8740;3464;11803
110010;201305;8161;23784;7305;22766;1274;3410;5265;17794;6539;21204
110011;201305;10413;33103;8783;30342;3519;12827;3018;10504;6537;23331
110012;201305;15166;48987;13764;46359;5187;18457;5635;19003;10822;37460
110013;201305;5041;16458;4254;15350;1284;4840;2160;7930;3444;12770
110014;201305;4087;12625;3499;11805;785;2737;2255;7707;3040;10444
110015;201305;4777;15940;4061;14716;1619;6219;1467;5314;3086;11533
110018;201305;4873;14796;4037;13733;1322;4956;1801;5899;3123;10855
110020;201305;48873;152743;43558;146077;10170;35152;26640;91829;36810;126981
110025;201305;4113;12617;3531;11534;604;2168;2539;8227;3143;10395
110026;201305;767;2334;656;2208;158;539;433;1494;591;2033
110028;201305;7197;21813;5562;19240;1716;6451;2006;6938;3722;13389
110029;201305;1593;4865;1285;4336;423;1478;582;2009;1005;3487
110030;201305;10862;32006;8982;29606;2705;9501;4550;15563;7255;25064
110032;201305;3959;13313;3630;12603;992;3628;1817;6316;2809;9944
110033;201305;4979;16269;4714;15888;1373;4589;2749;9789;4122;14378
110034;201305;3671;9732;3152;9143;442;1202;2516;7451;2958;8653
110037;201305;1997;6976;1797;6610;410;1506;1159;4350;1569;5856
110040;201305;3397;11549;3256;11276;1100;4039;1551;5389;2651;9428
110045;201305;4937;17956;4710;17662;1280;5014;2942;11133;4222;16147
110050;201305;1745;5801;1482;5470;554;2058;755;2871;1309;4929
110060;201305;978;3488;876;3294;220;836;519;1990;739;2826
110070;201305;1840;6499;1808;6416;312;1152;1339;4755;1651;5907
110080;201305;2985;10100;2923;10016;479;1562;2307;8093;2786;9655
110090;201305;927;2841;757;2569;233;879;315;1005;548;1884
110092;201305;1620;5408;1479;5214;372;1322;853;3155;1225;4477
110094;201305;2650;9183;2494;8971;689;2590;1490;5415;2179;8005
110100;201305;2611;8635;2300;8147;601;2160;1406;5097;2007;7257
110110;201305;1675;5744;1579;5631;655;2404;725;2664;1380;5068
110120;201305;1574;5451;1415;5078;398;1499;565;2026;963;3525
110130;201305;2701;7975;2142;7195;573;2068;1098;3698;1671;5766
110140;201305;2282;8140;2212;8038;543;2024;1394;5122;1937;7146
110143;201305;1474;5090;1236;4684;312;1248;725;2739;1037;3987
110145;201305;915;2921;838;2791;174;611;522;1747;696;2358
110146;201305;440;1450;397;1381;111;401;214;750;325;1151
110147;201305;854;2649;716;2455;208;779;344;1141;552;1920
110148;201305;1337;4065;1156;3739;372;1319;421;1300;793;2619
110149;201305;3325;10300;2800;9579;589;2098;1930;6726;2519;8824
110150;201305;2578;8087;2182;7510;450;1604;1440;4995;1890;6599
110155;201305;862;2972;837;2915;303;1111;383;1305;686;2416
110160;201305;2067;6839;1799;6455;408;1492;1160;4265;1568;5757
110170;201305;2934;8916;2424;8097;549;1934;1557;5236;2106;7170
110175;201305;1543;5197;1235;4814;113;469;958;3751;1071;4220
110180;201305;1647;5360;1451;5017;343;1222;888;3085;1231;4307
120001;201305;2696;10080;2629;9942;716;2844;1503;5800;2219;8644
120005;201305;1479;6274;1437;6194;188;750;1096;4944;1284;5694
120010;201305;3904;14514;3750;14230;760;2820;2434;9629;3194;12449
120013;201305;1667;6606;1641;6560;307;1190;1165;4851;1472;6041
120017;201305;1978;7246;1899;7107;513;1991;963;3890;1476;5881
120020;201305;13483;59845;13315;59455;2590;10910;9568;44708;12158;55618
120025;201305;2469;8920;2414;8833;646;2438;1433;5385;2079;7823
120030;201305;5043;21933;5019;21871;701;2803;3987;17967;4688;20770
120032;201305;1293;6275;1257;6188;174;971;939;4687;1113;5658
120033;201305;3463;13460;3437;13412;175;708;3106;12255;3281;12963
120034;201305;1818;7253;1816;7251;72;287;1698;6823;1770;7110
120035;201305;2307;11746;2290;11698;294;1382;1790;9627;2084;11009
120038;201305;3094;11539;3003;11354;824;3178;1683;6557;2507;9735
120039;201305;1331;7600;1309;7545;182;1078;1023;6016;1205;7094
120040;201305;41317;154372;38928;149081;12264;48732;19158;75625;31422;124357
120042;201305;2521;11409;2458;11255;279;1329;1964;9161;2243;10490
120043;201305;759;3717;751;3695;71;352;631;3160;702;3512
120045;201305;4141;15082;4116;15035;939;3385;2940;10999;3879;14384
120050;201305;7846;33183;7661;32770;1803;7430;4753;21756;6556;29186
120060;201305;5027;25667;4981;25574;792;3875;3777;20273;4569;24148
120070;201305;2562;9943;2526;9859;597;2181;1590;6588;2187;8769
120080;201305;3362;12928;3242;12741;574;2314;2318;9365;2892;11679
130002;201305;2626;11480;2482;11231;339;1598;1869;8586;2208;10184
130006;201305;1672;7332;1526;7054;183;918;1140;5333;1323;6251
130008;201305;1840;7773;1780;7655;203;921;1368;6039;1571;6960
130010;201305;2724;9304;2370;8885;258;888;1947;7519;2205;8407
130014;201305;3125;10491;2729;9920;415;1660;1872;6845;2287;8505
130020;201305;2299;8321;2282;8302;71;272;2185;7953;2256;8225
130030;201305;6106;25119;5927;24874;565;1977;5025;21861;5590;23838
130040;201305;3394;10893;3244;10663;183;634;2869;9483;3052;10117
130050;201305;5534;23281;4954;22299;803;3521;3441;16419;4244;19940
130060;201305;5516;23801;5212;23386;572;2469;4282;19711;4854;22180
130063;201305;2744;12671;2724;12630;367;1651;2224;10535;2591;12186
130068;201305;2784;12131;2644;11841;360;1744;1948;8807;2308;10551
130070;201305;6011;21264;5705;20851;462;1706;4807;17913;5269;19619
130080;201305;4690;21230;4573;21049;801;3794;3292;15579;4093;19373
130083;201305;1639;7000;1580;6898;290;1281;1138;5048;1428;6329
130090;201305;2235;8430;2138;8292;187;832;1818;7039;2005;7871
130100;201305;5036;20139;4852;19881;505;2202;3960;16455;4465;18657
130110;201305;6101;20083;5735;19628;1045;3420;4169;14906;5214;18326
130115;201305;3468;13349;3309;13130;204;653;3001;12125;3205;12778
130120;201305;12202;48108;11968;47778;1166;4272;10174;41867;11340;46139
130130;201305;3299;14571;3181;14291;484;2154;2433;11200;2917;13354
130140;201305;5700;23115;5657;23059;148;448;5459;22506;5607;22954
130150;201305;3213;12494;3151;12411;320;1544;2594;10128;2914;11672
130160;201305;3780;15785;3727;15699;210;757;3425;14630;3635;15387
130165;201305;2717;11210;2679;11146;544;2299;2001;8428;2545;10727
130170;201305;7376;29435;6627;28498;1333;5542;4548;20653;5881;26195
130180;201305;3217;10300;3157;10211;149;435;2893;9445;3042;9880
130185;201305;7607;29054;7407;28759;1687;6279;4986;20315;6673;26594
130190;201305;16031;57711;14392;55591;3099;11564;9289;38140;12388;49704
130195;201305;1713;7121;1657;7036;99;444;1476;6315;1575;6759
130200;201305;1869;6910;1757;6717;304;1213;1208;4677;1512;5890
130210;201305;1076;4268;1022;4168;180;713;745;3165;925;3878
130220;201305;1959;8157;1846;7989;269;1255;1358;6015;1627;7270
130230;201305;3263;14971;3123;14707;210;952;2719;13119;2929;14071
130240;201305;7842;31210;7297;30395;567;2614;6115;25906;6682;28520
130250;201305;16534;62899;16340;62604;2327;8239;12972;51562;15299;59801
130255;201305;3693;13917;3508;13594;231;880;3055;12080;3286;12960
130260;201305;222222;734479;204667;708436;56884;197982;114971;415201;171855;613183
130270;201305;7239;30539;6569;29479;1101;4830;4675;21998;5776;26828
130280;201305;2835;11307;2775;11215;176;622;2467;10227;2643;10849
130290;201305;10129;37682;10071;37601;232;715;9556;36266;9788;36981
130300;201305;4159;16589;3961;16307;356;1521;3257;13641;3613;15162
130310;201305;4299;17495;3996;17107;607;2541;2980;13232;3587;15773
130320;201305;2512;8912;2307;8627;327;1275;1677;6416;2004;7691
130330;201305;3224;12317;2901;11865;285;1253;2379;9877;2664;11130
130340;201305;16613;65681;16231;65073;2629;9966;11825;49962;14454;59928
130350;201305;3149;12772;3021;12629;141;340;2826;12179;2967;12519
130353;201305;4637;16006;4241;15457;1214;4361;2361;9144;3575;13505
130356;201305;3454;13086;3345;12903;579;2237;2449;9786;3028;12023
130360;201305;2623;8209;2356;7892;71;227;2169;7420;2240;7647
130370;201305;4481;17948;3837;17093;325;1759;3093;13819;3418;15578
130380;201305;6085;26442;5899;26102;496;2387;4882;21836;5378;24223
130390;201305;4373;19425;4133;19032;468;2040;3373;16023;3841;18063
130395;201305;1913;7427;1775;7150;308;1382;1134;4542;1442;5924
130400;201305;2080;7624;2014;7522;105;414;1796;6793;1901;7207
130406;201305;8140;32760;7358;31427;1878;7812;4189;19178;6067;26990
130410;201305;3974;15315;3686;14778;905;3775;2058;8557;2963;12332
130420;201305;9120;40021;8855;39402;1812;7977;5904;27219;7716;35196
130423;201305;2722;11214;2620;11062;214;1069;2232;9430;2446;10499
130426;201305;1824;8142;1761;8034;301;1318;1256;6050;1557;7368
130430;201305;3210;12028;3048;11797;374;1510;2269;9050;2643;10560
130440;201305;3468;13034;3194;12733;238;777;2784;11538;3022;12315
140002;201305;1265;4652;1228;4585;277;938;806;3245;1083;4183
140005;201305;2284;7484;2154;7340;134;438;1916;6630;2050;7068
140010;201305;41010;137124;37717;131523;8423;31209;22952;81653;31375;112862
140015;201305;2499;8843;2421;8741;181;538;2118;7872;2299;8410
140017;201305;2757;9241;2680;9141;186;634;2355;8140;2541;8774
140020;201305;3934;13760;3700;13433;492;1787;2793;10430;3285;12217
140023;201305;1812;6791;1753;6707;187;708;1449;5667;1636;6375
140028;201305;2023;5869;1959;5794;107;269;1765;5341;1872;5610
140030;201305;3294;11108;3191;10972;317;730;2756;9987;3073;10717
140040;201305;1442;7098;1390;6932;133;744;1019;5193;1152;5937
140045;201305;2111;8225;2069;8165;196;620;1765;7278;1961;7898
140047;201305;4786;14947;4701;14839;724;1803;3699;12455;4423;14258
140050;201305;1421;4570;1356;4476;143;439;1118;3777;1261;4216
140060;201305;1222;4065;1153;3980;206;688;850;3026;1056;3714
140070;201305;1430;7063;1427;7057;58;235;1355;6778;1413;7013
150010;201305;29698;103648;28603;102156;2177;7986;24487;88913;26664;96899
150013;201305;1453;4727;1411;4678;128;444;1182;3947;1310;4391
150020;201305;9750;35816;9600;35571;1038;3899;7932;29814;8970;33713
150030;201305;5761;25880;5620;25633;625;2451;4626;22049;5251;24500
150034;201305;4381;12096;4169;11844;147;342;3964;11398;4111;11740
150040;201305;11486;41791;10194;40136;2037;7342;6975;29383;9012;36725
150050;201305;5774;22455;5657;22236;707;2982;4472;17730;5179;20712
150060;201305;13228;45296;12662;44454;3469;11905;7447;27484;10916;39389
150070;201305;4919;21501;4544;21041;586;2577;3626;17312;4212;19889
150080;201305;55978;156654;50025;149155;5902;15940;38740;119099;44642;135039
150085;201305;4476;16700;4331;16491;758;2447;3274;13221;4032;15668
150090;201305;9173;36898;8726;36275;1113;4450;6935;29567;8048;34017
150095;201305;4742;17100;4473;16676;508;1889;3608;13747;4116;15636
150100;201305;3276;12683;3102;12431;312;1441;2526;10059;2838;11500
150110;201305;3119;15177;3111;15158;128;531;2930;14438;3058;14969
150120;201305;5569;22676;5471;22474;678;2682;4428;18506;5106;21188
150125;201305;762;2436;701;2334;153;538;423;1410;576;1948
150130;201305;16751;57619;16300;56910;1906;6692;13111;46437;15017;53129
150140;201305;130917;407227;126827;402050;19694;62807;97797;314233;117491;377040
150145;201305;4559;15014;4245;14600;620;2215;3154;11060;3774;13275
150150;201305;8196;28462;7805;27812;1759;6535;5024;18152;6783;24687
150157;201305;2421;8405;2274;8195;346;1343;1762;6363;2108;7706
150160;201305;2450;8860;2376;8753;620;2206;1493;5727;2113;7933
150170;201305;21182;79565;20235;78437;2965;11227;15993;63016;18958;74243
150172;201305;2797;9968;2549;9609;295;1133;2102;8047;2397;9180
150175;201305;1898;6224;1836;6148;163;500;1592;5457;1755;5957
150178;201305;10239;33003;9004;31553;564;1722;8116;29088;8680;30810
150180;201305;15715;66514;15321;65975;1480;6820;12939;56229;14419;63049
150190;201305;6783;22279;6428;21770;430;1105;5613;19761;6043;20866
150195;201305;4002;15184;3766;14741;462;1806;2948;11723;3410;13529
150200;201305;4153;14740;4117;14692;110;364;3915;14069;4025;14433
150210;201305;21350;82447;21125;82122;1719;6412;18628;73316;20347;79728
150215;201305;4972;16792;4623;16267;1208;4324;2744;9891;3952;14215
150220;201305;11509;39317;11025;38498;2529;9030;6811;24224;9340;33254
150230;201305;10228;37057;9582;36126;798;3664;8129;30303;8927;33967
150240;201305;29871;95994;28044;92802;7796;27039;15080;50627;22876;77666
150250;201305;3265;13170;3184;13038;587;2171;2312;10028;2899;12199
150260;201305;1775;7756;1752;7711;264;1274;1266;5586;1530;6860
150270;201305;8967;28271;7152;26003;1605;6189;4529;16730;6134;22919
150275;201305;5267;20361;5078;20039;820;3272;3734;15052;4554;18324
150276;201305;1957;6097;1878;5997;259;873;1512;4843;1771;5716
150277;201305;4817;15362;4278;14739;523;1881;3445;12064;3968;13945
150280;201305;5582;24603;5489;24396;572;2474;4507;20423;5079;22897
150285;201305;2530;10323;2509;10280;175;725;2265;9340;2440;10065
150290;201305;7322;25096;7194;24912;879;2950;5779;20510;6658;23460
150293;201305;8260;27407;7475;26209;2541;9040;3615;13320;6156;22360
150295;201305;5712;20381;5197;19683;1275;4913;3223;12564;4498;17477
150300;201305;1676;6033;1643;5985;111;383;1430;5263;1541;5646
150304;201305;3776;12381;3356;11834;531;1877;2502;8999;3033;10876
150307;201305;6329;22404;5945;21833;480;1719;4947;18689;5427;20408
150309;201305;5967;22554;5678;22114;1561;6017;3549;14397;5110;20414
150310;201305;4809;22741;4739;22617;539;2399;3912;19239;4451;21638
150320;201305;7371;22509;7247;22357;481;1546;6468;20026;6949;21572
150330;201305;12061;46482;11640;45765;1384;5445;9329;37416;10713;42861
150340;201305;1952;7175;1869;7056;530;2041;1068;4157;1598;6198
150345;201305;6000;22121;5699;21705;670;2577;4649;18007;5319;20584
150350;201305;6779;23569;6518;23167;902;3260;4895;17662;5797;20922
150360;201305;19241;63389;17072;60721;2496;8994;12918;47340;15414;56334
150370;201305;9228;36175;8965;35796;1158;4311;7254;29946;8412;34257
150375;201305;2594;11110;2546;11047;236;794;2182;9943;2418;10737
150380;201305;9076;29030;8288;27949;940;3433;6888;23198;7828;26631
150390;201305;7552;33361;7271;32764;1718;7349;4510;21461;6228;28810
150400;201305;5045;21757;4907;21424;636;2669;3662;16500;4298;19169
150405;201305;7848;25222;7173;24362;1600;4891;4751;17273;6351;22164
150410;201305;1561;6218;1541;6183;226;942;1097;4502;1323;5444
150420;201305;29237;109495;26909;105715;7278;29685;15089;61679;22367;91364
150430;201305;6013;23354;5909;23154;833;3625;4521;17677;5354;21302
150440;201305;4968;18075;4892;17946;694;2584;3753;13975;4447;16559
150442;201305;20502;59891;18902;57901;3065;9542;13559;42717;16624;52259
150445;201305;4748;17366;4415;16893;641;2332;3414;13452;4055;15784
150450;201305;4007;19580;3886;19410;367;1815;3304;16813;3671;18628
150460;201305;6207;24124;5347;23220;356;1663;4825;21078;5181;22741
150470;201305;14271;48671;13972;48256;1647;4816;11655;41700;13302;46516
150480;201305;13334;46966;13013;46521;837;2707;11547;42125;12384;44832
150490;201305;5927;23269;5831;23144;358;1403;5266;21085;5624;22488
150495;201305;4004;15745;3921;15568;469;1987;3163;12603;3632;14590
150497;201305;3191;11328;2952;10940;774;2860;1782;6903;2556;9763
150500;201305;2783;8775;2684;8602;405;1370;2018;6453;2423;7823
150503;201305;3640;11760;3135;11104;1213;4457;1353;5019;2566;9476
150506;201305;11240;41851;10782;41230;2547;8483;7476;30579;10023;39062
150510;201305;8995;36809;8526;35994;1428;6083;6060;26557;7488;32640
150520;201305;5451;23663;5392;23563;431;1538;4778;21446;5209;22984
150530;201305;10471;39310;9658;38128;1319;4778;7315;29991;8634;34769
150540;201305;4285;14239;4010;13822;347;1264;3359;11573;3706;12837
150543;201305;4356;14485;4055;14056;1229;4320;2349;8384;3578;12704
150548;201305;7289;24463;6906;23962;783;2515;5679;20280;6462;22795
150549;201305;2138;7034;2048;6924;100;280;1869;6449;1969;6729
150550;201305;19838;65379;18283;62900;5176;18411;9914;34886;15090;53297
150553;201305;19886;75678;18301;71427;7502;31043;3803;14810;11305;45853
150555;201305;1580;5196;1406;4936;255;979;954;3374;1209;4353
150560;201305;1922;6364;1873;6250;218;809;1455;4814;1673;5623
150563;201305;2741;9501;2606;9254;621;2362;1628;5789;2249;8151
150565;201305;3188;11875;3038;11651;256;1117;2502;9624;2758;10741
150570;201305;4740;19137;4687;19045;419;1696;3972;16457;4391;18153
150580;201305;8569;35731;8445;35547;806;2942;7224;31533;8030;34475
150590;201305;4907;20461;4804;20335;189;878;4449;18932;4638;19810
150600;201305;6984;28438;6883;28262;691;2547;5817;24639;6508;27186
150610;201305;2400;8437;2250;8129;287;1161;1583;5667;1870;6828
150611;201305;2464;9583;2383;9383;318;1332;1771;7052;2089;8384
150613;201305;10517;34264;9451;32703;3224;11343;4737;17160;7961;28503
150616;201305;2906;8493;2374;7923;570;1843;1589;5520;2159;7363
150618;201305;7182;25781;6936;25347;2262;8609;3469;12959;5731;21568
150619;201305;4793;17325;4541;16945;776;2965;3194;12157;3970;15122
150620;201305;5848;21823;5398;21236;777;3099;4114;16755;4891;19854
150630;201305;4922;16390;4717;16112;443;1530;3939;13636;4382;15166
150635;201305;4112;14192;3930;13830;831;3003;2515;9107;3346;12110
150640;201305;1349;4537;1336;4516;33;94;1271;4338;1304;4432
150650;201305;11244;36303;10415;34795;2829;9854;5646;19132;8475;28986
150655;201305;4934;17474;4598;17003;861;3177;3289;12458;4150;15635
150658;201305;3816;13159;3693;12970;344;1432;2975;10353;3319;11785
150660;201305;5425;17803;4998;17253;1402;4753;2911;10475;4313;15228
150670;201305;5642;17541;4967;16718;1713;5828;2618;9365;4331;15193
150680;201305;46058;189551;44259;186090;15663;65102;21002;94463;36665;159565
150690;201305;1782;6005;1673;5802;279;990;1094;3898;1373;4888
150700;201305;5259;17300;5098;17054;1050;3507;3478;11898;4528;15405
150710;201305;3482;11737;3391;11609;357;932;2907;10324;3264;11256
150715;201305;4517;15765;4254;15430;530;1876;3452;12841;3982;14717
150720;201305;5759;25056;5550;24685;804;3391;4195;19422;4999;22813
150730;201305;8436;30352;7989;29741;1195;4303;6339;24184;7534;28487
150740;201305;3338;11322;3186;11026;491;1805;2244;7868;2735;9673
150745;201305;5811;18754;5448;18270;775;2671;4190;14250;4965;16921
150746;201305;1295;4600;1246;4507;190;797;892;3216;1082;4013
150747;201305;4823;16295;4533;15915;437;1488;3706;13414;4143;14902
150750;201305;2396;8889;2369;8858;125;293;2217;8509;2342;8802
150760;201305;10647;35544;10325;35083;2374;7932;6816;23887;9190;31819
150770;201305;5028;20282;4894;20075;839;3116;3712;15878;4551;18994
150775;201305;1000;3338;924;3197;199;825;550;1824;749;2649
150780;201305;2932;10068;2911;10045;87;223;2755;9651;2842;9874
150790;201305;4705;15356;4461;15077;343;994;3872;13498;4215;14492
150795;201305;13226;43182;12431;42179;1890;6229;9545;33330;11435;39559
150796;201305;2557;8263;2513;8209;397;1198;1954;6607;2351;7805
150797;201305;3587;12338;3453;12124;202;750;3027;10736;3229;11486
150800;201305;12962;45332;12011;44142;2802;9725;7974;30831;10776;40556
150803;201305;6236;23878;6057;23619;860;3571;4615;18258;5475;21829
150805;201305;2573;9282;2412;9054;383;1356;1751;6822;2134;8178
150808;201305;5544;19557;4836;18236;2141;8428;1322;5274;3463;13702
150810;201305;17981;58637;15468;55588;2616;9130;11045;41656;13661;50786
150812;201305;4621;15214;4368;14918;417;1713;3480;11765;3897;13478
150815;201305;8007;26447;7296;25579;730;2265;6162;22323;6892;24588
150820;201305;9880;30082;9058;29186;472;1009;8260;27388;8732;28397
150830;201305;11804;46843;11356;46060;978;3809;9212;38799;10190;42608
150835;201305;1913;7244;1788;6944;510;2090;859;3350;1369;5440
150840;201305;6158;18939;5067;17566;1449;5530;2785;9385;4234;14915
160005;201305;684;2673;649;2597;113;524;397;1571;510;2095
160010;201305;1475;5332;1464;5320;195;548;1203;4601;1398;5149
160015;201305;1498;5762;1466;5704;263;956;1055;4343;1318;5299
160020;201305;2191;7400;2051;7210;288;1018;1535;5546;1823;6564
160021;201305;753;3472;731;3428;126;648;507;2437;633;3085
160023;201305;904;3489;895;3476;111;393;748;2980;859;3373
160025;201305;1167;3222;1136;3189;26;85;1092;3058;1118;3143
160027;201305;7472;25496;7133;25100;1481;5370;4939;17733;6420;23103
160030;201305;35680;137849;35108;136709;8127;30579;24178;97188;32305;127767
160040;201305;3089;13324;3033;13226;207;963;2677;11746;2884;12709
160050;201305;2918;11546;2662;11136;1004;3814;1231;5919;2235;9733
160053;201305;1860;8080;1844;8051;524;2253;1179;5359;1703;7612
160055;201305;753;3026;737;3003;142;616;520;2148;662;2764
160060;201305;17191;57587;16224;56505;3945;12933;10805;39709;14750;52642
160070;201305;1906;8543;1892;8519;177;737;1656;7612;1833;8349
160080;201305;2394;9740;2376;9710;157;550;2167;9021;2324;9571
170025;201305;557;1945;514;1879;191;730;236;892;427;1622
170030;201305;1127;3843;1057;3728;305;1103;575;2061;880;3164
170035;201305;1509;4696;1251;4199;444;1592;399;1379;843;2971
170040;201305;1671;5802;1516;5558;355;1450;881;3243;1236;4693
170070;201305;1976;5564;1642;5145;416;1409;914;2927;1330;4336
170100;201305;2448;6800;2197;6359;270;898;1742;4977;2012;5875
170105;201305;694;2348;600;2158;133;585;332;1151;465;1736
170110;201305;1151;3648;1028;3439;183;589;680;2337;863;2926
170130;201305;1320;4299;1191;4125;175;599;870;3128;1045;3727
170190;201305;1532;4655;1321;4361;473;1567;506;1840;979;3407
170200;201305;1425;4586;1139;4067;306;1223;373;1303;679;2526
170210;201305;24457;81416;21984;76916;9411;35318;6300;22522;15711;57840
170215;201305;1077;3617;989;3468;154;558;717;2571;871;3129
170220;201305;6126;20948;5677;20266;791;2994;4102;15043;4893;18037
170230;201305;1414;4939;1275;4693;355;1469;602;2160;957;3629
170240;201305;2936;8331;2418;7704;321;1140;1724;5543;2045;6683
170255;201305;3385;11221;2910;10412;1065;3744;1164;4521;2229;8265
170270;201305;1027;2713;755;2346;200;643;435;1380;635;2023
170290;201305;2818;8855;2497;8460;252;799;2051;7208;2303;8007
170300;201305;1987;6503;1780;6170;319;1217;1189;4143;1508;5360
170305;201305;662;2207;573;2028;122;476;349;1212;471;1688
170307;201305;1052;3741;925;3517;300;1155;359;1542;659;2697
170310;201305;1565;4401;1279;3941;310;1010;626;2012;936;3022
170320;201305;903;2786;768;2547;166;568;456;1540;622;2108
170330;201305;761;2358;641;2225;114;359;454;1663;568;2022
170360;201305;446;1602;425;1568;98;381;212;780;310;1161
170370;201305;1356;4110;1153;3820;196;773;693;2282;889;3055
170380;201305;2034;6627;1715;6158;428;1737;910;3235;1338;4972
170382;201305;557;1936;507;1869;54;195;417;1559;471;1754
170384;201305;1281;5820;1246;5755;288;1365;842;3985;1130;5350
170386;201305;803;2502;671;2298;208;783;240;855;448;1638
170388;201305;630;1949;554;1827;133;518;228;736;361;1254
170389;201305;939;3330;883;3243;105;484;681;2447;786;2931
170390;201305;1272;3939;1114;3737;188;641;807;2781;995;3422
170410;201305;448;1540;435;1516;68;262;297;1035;365;1297
170460;201305;401;1241;352;1160;100;353;128;432;228;785
170510;201305;754;2613;653;2459;137;578;358;1341;495;1919
170550;201305;5119;16625;4371;15260;1822;6757;1227;4435;3049;11192
170555;201305;1289;3906;1091;3610;285;1054;606;1997;891;3051
170560;201305;1013;3514;872;3353;178;683;620;2473;798;3156
170600;201305;1298;3786;1165;3627;71;244;977;3097;1048;3341
170610;201305;1593;4886;1269;4377;209;805;741;2581;950;3386
170625;201305;387;1288;314;1126;93;356;83;302;176;658
170650;201305;1217;4074;1155;3958;283;1044;633;2200;916;3244
170700;201305;3772;12981;3230;12085;878;3590;1540;6002;2418;9592
170710;201305;1639;5009;1406;4673;178;700;1013;3384;1191;4084
170720;201305;1776;4834;1577;4519;311;897;1091;3175;1402;4072
170730;201305;1135;3323;946;3042;293;1048;429;1377;722;2425
170740;201305;2117;7983;1979;7771;283;1233;1442;5709;1725;6942
170755;201305;873;2818;747;2546;206;751;300;1009;506;1760
170765;201305;1542;4249;1257;3792;335;1079;529;1651;864;2730
170770;201305;1761;6306;1656;6100;392;1510;946;3596;1338;5106
170820;201305;4037;13241;3678;12668;1005;3677;1751;6130;2756;9807
170825;201305;698;2234;551;1957;146;585;246;839;392;1424
170830;201305;1255;3875;1207;3806;46;113;1113;3546;1159;3659
170900;201305;2741;9958;2640;9757;344;1246;2008;7640;2352;8886
170930;201305;4130;12799;3395;11755;1372;4979;1158;4040;2530;9019
170950;201305;9944;31557;8172;28654;3896;14865;1844;6031;5740;20896
170980;201305;419;1368;364;1266;116;409;145;503;261;912
171050;201305;1203;4403;1155;4315;63;284;1033;3822;1096;4106
171070;201305;1641;5458;1534;5307;355;1296;924;3258;1279;4554
171090;201305;826;2609;747;2482;156;521;472;1614;628;2135
171110;201305;630;1916;523;1743;168;614;286;914;454;1528
171150;201305;855;2574;643;2169;133;480;366;1239;499;1719
171180;201305;570;1880;473;1668;121;461;217;794;338;1255
171190;201305;1822;6647;1573;6130;392;1609;752;3069;1144;4678
171195;201305;844;3101;774;2974;109;468;495;1961;604;2429
171200;201305;630;2112;534;1931;153;638;245;832;398;1470
171215;201305;423;1326;351;1206;65;243;177;617;242;860
171240;201305;864;2963;839;2922;73;165;728;2653;801;2818
171245;201305;662;2224;559;1975;116;439;288;1018;404;1457
171250;201305;1092;3211;998;3101;74;245;842;2645;916;2890
171270;201305;386;1611;364;1562;81;320;220;1002;301;1322
171280;201305;820;2662;759;2558;163;540;410;1505;573;2045
171320;201305;3751;11954;3297;11314;1158;4143;1557;5388;2715;9531
171330;201305;2674;8447;2431;8077;618;2156;1383;4672;2001;6828
171360;201305;1467;4934;1261;4635;328;1290;692;2585;1020;3875
171370;201305;688;1984;621;1874;141;516;339;967;480;1483
171380;201305;1217;4365;1129;4204;270;988;661;2571;931;3559
171395;201305;870;2809;750;2585;149;601;422;1437;571;2038
171420;201305;2215;6843;1841;6204;379;1426;1019;3433;1398;4859
171430;201305;995;3237;918;3122;221;750;554;1917;775;2667
171488;201305;2313;7337;2158;7102;564;1862;1184;4043;1748;5905
171500;201305;857;2687;758;2489;131;396;431;1472;562;1868
171510;201305;877;3243;804;3130;157;623;510;2089;667;2712
171515;201305;593;1789;480;1625;116;404;231;801;347;1205
171525;201305;571;2001;496;1855;100;416;268;991;368;1407
171550;201305;314;1133;284;1047;130;529;49;186;179;715
171570;201305;1050;3536;949;3390;165;597;658;2396;823;2993
171575;201305;1864;5521;1532;4934;472;1578;641;2162;1113;3740
171610;201305;5811;20532;5446;19836;1995;7588;1904;7004;3899;14592
171620;201305;2082;6988;1974;6811;201;780;1590;5508;1791;6288
171630;201305;845;2900;708;2658;161;682;326;1217;487;1899
171650;201305;2176;7139;1872;6632;513;1993;885;3065;1398;5058
171660;201305;2497;7190;2098;6504;518;1669;1083;3464;1601;5133
171665;201305;1300;4196;1175;3978;222;840;754;2569;976;3409
171670;201305;2235;6170;1888;5738;456;1495;1179;3554;1635;5049
171700;201305;1058;3627;970;3485;156;643;634;2270;790;2913
171720;201305;621;2029;552;1892;156;610;290;974;446;1584
171750;201305;1179;3995;1064;3760;394;1458;383;1367;777;2825
171780;201305;1095;3274;826;2891;140;540;517;1811;657;2351
171790;201305;1714;5603;1404;5148;294;1092;832;3198;1126;4290
171800;201305;691;2298;641;2228;94;362;443;1546;537;1908
171820;201305;9013;29146;8435;28445;1936;7033;5223;17850;7159;24883
171830;201305;1595;5946;1470;5672;340;1396;746;2901;1086;4297
171840;201305;727;2249;662;2157;80;288;491;1598;571;1886
171845;201305;768;2115;601;1824;88;325;349;1012;437;1337
171850;201305;994;3696;914;3524;111;520;614;2352;725;2872
171855;201305;1200;3974;1100;3807;120;517;834;2830;954;3347
171865;201305;478;1591;410;1489;104;426;202;720;306;1146
171870;201305;629;2118;539;1964;131;521;279;1040;410;1561
171875;201305;1342;4387;1149;4093;182;717;819;2912;1001;3629
171880;201305;990;3633;969;3600;123;483;755;2865;878;3348
171884;201305;813;2457;633;2184;134;510;274;983;408;1493
171886;201305;1425;4970;1314;4729;444;1697;472;1723;916;3420
171888;201305;606;1947;534;1819;108;378;327;1163;435;1541
171889;201305;463;1601;452;1574;83;259;294;1087;377;1346
171890;201305;1059;3680;979;3562;142;639;669;2376;811;3015
171900;201305;412;1634;396;1603;96;410;224;906;320;1316
172000;201305;611;2018;525;1894;87;387;322;1126;409;1513
172010;201305;1102;3836;1051;3748;112;448;820;2953;932;3401
172015;201305;349;1319;307;1255;62;249;179;783;241;1032
172020;201305;2250;7552;2030;7227;298;1179;1460;5246;1758;6425
172025;201305;663;2055;572;1893;100;367;349;1154;449;1521
172030;201305;1052;3678;973;3533;176;718;621;2278;797;2996
172049;201305;1031;3125;987;3068;139;447;747;2348;886;2795
172065;201305;1114;3461;949;3250;160;620;697;2370;857;2990
172080;201305;2653;8228;2289;7626;320;1243;1550;5073;1870;6316
172085;201305;492;1410;399;1254;118;440;116;337;234;777
172090;201305;3285;10116;2606;9254;536;2064;1590;5772;2126;7836
172093;201305;559;1873;454;1689;177;731;187;694;364;1425
172097;201305;659;1992;564;1827;186;651;190;611;376;1262
172100;201305;23098;82458;21288;78774;7706;30828;6763;25169;14469;55997
172110;201305;1607;5933;1510;5792;159;608;1186;4677;1345;5285
172120;201305;5402;16555;4590;15527;481;1696;3607;12480;4088;14176
172125;201305;313;973;254;883;57;219;122;445;179;664
172130;201305;467;1443;430;1387;85;298;278;924;363;1222
172208;201305;2124;6758;2016;6573;447;1546;1145;3820;1592;5366
172210;201305;2242;6834;2152;6727;145;491;1902;5954;2047;6445
210005;201305;20125;68364;18608;65873;5127;19195;10434;37385;15561;56580
210010;201305;1570;5588;1427;5409;156;546;1138;4472;1294;5018
210015;201305;3296;10281;3063;9962;202;464;2650;9020;2852;9484
210020;201305;6706;17944;6316;17468;457;1457;5182;14538;5639;15995
210030;201305;5687;19474;5485;19188;470;2029;4592;15882;5062;17911
210040;201305;1927;5715;1768;5526;179;576;1410;4461;1589;5037
210043;201305;5542;17708;5333;17373;316;1131;4668;15277;4984;16408
210047;201305;6573;26154;6219;25517;941;4164;4232;17522;5173;21686
210050;201305;2393;8309;1986;7858;174;703;1644;6617;1818;7320
210055;201305;1583;5657;1516;5563;194;675;1200;4482;1394;5157
210060;201305;7777;28951;7091;27912;814;3560;5314;21295;6128;24855
210070;201305;6386;20900;6187;20661;296;1095;5656;18972;5952;20067
210080;201305;3509;12285;3441;12180;102;407;3216;11427;3318;11834
210083;201305;3230;12108;3179;12043;252;895;2788;10749;3040;11644
210087;201305;2253;7589;2186;7500;178;649;1920;6582;2098;7231
210090;201305;9144;30954;8905;30561;597;2148;7711;26652;8308;28800
210095;201305;6013;24106;5916;23930;655;2718;4862;19963;5517;22681
210100;201305;7301;22165;7018;21846;219;891;6475;20119;6694;21010
210110;201305;3070;10919;2979;10786;211;825;2514;9261;2725;10086
210120;201305;21860;71359;19699;68465;2099;7750;15326;54122;17425;61872
210125;201305;3134;10772;3029;10642;245;837;2638;9412;2883;10249
210130;201305;3397;10723;3343;10665;218;720;2933;9406;3151;10126
210135;201305;1473;4668;1358;4489;109;367;1145;3854;1254;4221
210140;201305;15791;53299;13809;50738;2969;11173;9089;34433;12058;45606
210150;201305;4215;11756;4025;11536;184;504;3683;10617;3867;11121
210160;201305;17432;59045;16449;57594;1997;6852;13088;46947;15085;53799
210170;201305;13539;51230;13340;50942;1045;3630;11644;45410;12689;49040
210173;201305;1704;7537;1665;7453;172;775;1396;6333;1568;7108
210177;201305;2779;9626;2641;9443;367;1452;2013;7165;2380;8617
210180;201305;1376;4471;1313;4366;129;441;1072;3584;1201;4025
210190;201305;4976;16590;4755;16220;397;1797;3751;12505;4148;14302
210193;201305;1383;4534;1310;4413;92;357;1098;3729;1190;4086
210197;201305;1663;6215;1600;6143;112;490;1415;5419;1527;5909
210200;201305;8586;30234;8057;29479;1170;4093;5959;22717;7129;26810
210203;201305;5933;20681;5596;20247;461;1496;4812;17818;5273;19314
210207;201305;2874;9978;2744;9754;367;1338;2084;7500;2451;8838
210210;201305;8306;29146;8098;28792;357;1383;7086;25510;7443;26893
210215;201305;1746;7064;1710;7009;152;685;1446;5955;1598;6640
210220;201305;6021;23911;5854;23633;483;1996;4837;19975;5320;21971
210230;201305;5164;18191;4842;17650;503;1874;3817;14131;4320;16005
210232;201305;10764;41258;10345;40584;2309;8948;7126;28794;9435;37742
210235;201305;3172;10461;2942;10157;206;742;2567;8927;2773;9669
210237;201305;2450;8973;2428;8940;47;115;2340;8728;2387;8843
210240;201305;2636;8953;2561;8835;211;769;2123;7362;2334;8131
210250;201305;4454;15366;4319;15197;162;618;3986;14130;4148;14748
210255;201305;2496;8431;2303;8107;614;2308;1316;4713;1930;7021
210260;201305;5020;16477;4685;15977;635;2076;3617;12629;4252;14705
210270;201305;5086;15064;4653;14490;189;659;4188;13168;4377;13827
210275;201305;3167;8605;2972;8392;103;272;2811;7988;2914;8260
210280;201305;5716;17172;5085;16381;380;1322;4347;14147;4727;15469
210290;201305;5764;18675;5364;18171;539;1783;4399;15218;4938;17001
210300;201305;33849;109462;30010;104371;3258;12095;24353;85868;27611;97963
210310;201305;2543;7883;2491;7808;157;512;2222;6991;2379;7503
210312;201305;1781;6321;1757;6278;145;574;1502;5385;1647;5959
210315;201305;2052;7747;1985;7648;82;370;1784;6918;1866;7288
210317;201305;4113;12634;4026;12533;161;476;3774;11825;3935;12301
210320;201305;17245;58801;16735;58098;1041;3830;14922;52101;15963;55931
210325;201305;3296;11022;3053;10677;377;1406;2403;8485;2780;9891
210330;201305;29804;85990;25898;81665;3738;10771;19367;65087;23105;75858
210340;201305;11349;36982;10572;36026;1267;3887;8306;29604;9573;33491
210350;201305;9734;32413;9281;31780;843;2935;7627;26658;8470;29593
210355;201305;3881;14108;3582;13737;130;340;3329;13092;3459;13432
210360;201305;16180;51239;15343;49987;1430;4900;12340;40881;13770;45781
210370;201305;7460;21951;6901;21350;276;862;6355;19850;6631;20712
210375;201305;3137;9884;2785;9471;492;1792;2036;7007;2528;8799
210380;201305;5813;17932;5346;17169;403;1348;4488;14528;4891;15876
210390;201305;2528;9631;2434;9477;96;414;2243;8804;2339;9218
210400;201305;4479;15456;4340;15277;375;1242;3736;13392;4111;14634
210405;201305;8211;23695;6901;21917;2043;6535;3346;11554;5389;18089
210407;201305;2022;7180;1837;6893;209;750;1410;5535;1619;6285
210408;201305;1987;8289;1916;8203;83;335;1756;7682;1839;8017
210409;201305;3727;13765;3573;13526;320;1227;2829;11017;3149;12244
210410;201305;3309;11169;3117;10924;277;921;2695;9573;2972;10494
210420;201305;3969;13685;3773;13334;382;1329;3039;10951;3421;12280
210430;201305;1811;5951;1787;5916;131;447;1574;5255;1705;5702
210440;201305;3938;12982;3842;12830;227;799;3361;11349;3588;12148
210450;201305;2611;8823;2464;8576;225;876;2002;6976;2227;7852
210455;201305;3979;12231;3419;11339;615;2101;2294;7809;2909;9910
210460;201305;4041;13272;3864;13052;200;729;3419;11679;3619;12408
210462;201305;1727;6363;1687;6289;184;707;1299;4964;1483;5671
210465;201305;2696;9038;2566;8870;322;943;2072;7463;2394;8406
210467;201305;5637;20068;5307;19586;599;2209;4220;15985;4819;18194
210470;201305;1602;5171;1480;5004;110;413;1203;4110;1313;4523
210480;201305;12551;44921;11496;43466;2905;11204;7073;27718;9978;38922
210490;201305;3143;10053;2964;9778;393;1372;2273;7535;2666;8907
210500;201305;6525;26035;6268;25581;723;2894;4880;20607;5603;23501
210510;201305;6312;22080;6226;21983;158;536;5811;20906;5969;21442
210515;201305;3467;11477;3416;11394;281;862;2962;10083;3243;10945
210520;201305;2538;8367;2420;8201;253;895;1949;6713;2202;7608
210530;201305;38049;131324;34043;125037;11293;44094;17164;64244;28457;108338
210535;201305;2955;10911;2900;10805;145;590;2570;9643;2715;10233
210540;201305;11310;42003;10377;40439;2208;8509;6376;26403;8584;34912
210542;201305;6177;18794;5535;18076;292;884;4952;16524;5244;17408
210545;201305;2130;7443;2047;7310;91;397;1784;6392;1875;6789
210547;201305;3262;12412;3124;12203;206;898;2669;10522;2875;11420
210550;201305;6048;18019;5257;17131;278;812;4737;15776;5015;16588
210560;201305;3520;12188;3340;11905;287;1138;2782;9916;3069;11054
210565;201305;1507;5261;1348;5028;92;413;1070;4015;1162;4428
210570;201305;11706;36238;10774;35134;989;3096;9092;30357;10081;33453
210580;201305;2630;8904;2367;8555;290;1062;1864;6865;2154;7927
210590;201305;4331;13843;4135;13602;261;871;3647;12166;3908;13037
210592;201305;2376;7736;2329;7662;113;439;2076;6797;2189;7236
210594;201305;2575;7762;2236;7350;140;487;1942;6457;2082;6944
210596;201305;2797;10808;2675;10578;341;1369;2009;8076;2350;9445
210598;201305;1986;6227;1900;6129;114;483;1738;5516;1852;5999
210600;201305;3188;9613;3004;9356;276;926;2459;7632;2735;8558
210610;201305;2546;8330;2313;8047;257;897;1899;6680;2156;7577
210620;201305;1716;5462;1608;5320;52;163;1494;4981;1546;5144
210630;201305;3243;12318;2858;11537;549;2230;1673;7046;2222;9276
210632;201305;4635;16399;4295;15922;509;1942;3378;12666;3887;14608
210635;201305;1832;6864;1802;6821;62;202;1682;6468;1744;6670
210637;201305;2608;9142;2516;9009;131;509;2253;8145;2384;8654
210640;201305;4091;13811;4042;13745;31;97;3935;13458;3966;13555
210650;201305;6146;19922;6064;19806;327;1056;5548;18264;5875;19320
210660;201305;7101;23279;6738;22695;277;875;6153;20829;6430;21704
210663;201305;2632;8050;2559;7971;64;195;2431;7666;2495;7861
210667;201305;1567;6033;1524;5972;117;504;1290;5113;1407;5617
210670;201305;4560;17654;4447;17454;430;1760;3594;14410;4024;16170
210675;201305;4675;13563;4538;13391;313;916;3911;11766;4224;12682
210680;201305;4189;12841;3833;12410;207;737;3389;10981;3596;11718
210690;201305;6380;23030;6163;22804;355;1355;5567;20751;5922;22106
210700;201305;2476;7212;2219;6908;169;390;1854;6180;2023;6570
210710;201305;4757;15698;4639;15529;169;516;4306;14548;4475;15064
210720;201305;2297;8884;2228;8789;162;668;1937;7686;2099;8354
210725;201305;1135;4286;991;4034;144;641;612;2521;756;3162
210730;201305;1134;3703;1034;3593;79;253;897;3161;976;3414
210735;201305;3582;13673;3438;13396;640;2540;2415;9642;3055;12182
210740;201305;4458;12601;4192;12331;188;404;3858;11652;4046;12056
210745;201305;3255;10817;3172;10680;263;996;2660;8902;2923;9898
210750;201305;19383;55635;17928;53934;1978;6084;14624;44489;16602;50573
210760;201305;5471;15304;5270;15085;88;269;5119;14666;5207;14935
210770;201305;5977;16546;5207;15680;240;678;4723;14373;4963;15051
210780;201305;8367;29281;7944;28500;1053;4127;5883;21292;6936;25419
210790;201305;4439;13929;3935;13376;187;649;3554;12267;3741;12916
210800;201305;4521;14238;4166;13855;210;784;3608;12367;3818;13151
210805;201305;3587;15767;3534;15659;199;873;3100;14021;3299;14894
210810;201305;5349;17098;4870;16552;520;1420;4106;14496;4626;15916
210820;201305;8632;25582;8261;25089;1331;4019;6059;18889;7390;22908
210825;201305;5262;18088;5176;17983;201;721;4745;16638;4946;17359
210830;201305;7757;25974;7499;25679;305;829;7045;24467;7350;25296
210840;201305;3595;10165;3328;9773;303;764;2649;7871;2952;8635
210845;201305;5270;17433;5126;17253;246;770;4611;15829;4857;16599
210850;201305;5508;21475;5234;20972;992;4416;3515;14098;4507;18514
210860;201305;15982;52799;15539;52127;1462;5181;12896;43417;14358;48598
210870;201305;5915;20279;5447;19634;755;2778;4000;14688;4755;17466
210880;201305;3673;12274;3636;12227;202;618;3304;11286;3506;11904
210890;201305;5184;16103;4897;15724;424;1532;4078;13003;4502;14535
210900;201305;4348;14797;4111;14374;1421;5061;1962;7143;3383;12204
210905;201305;1748;5621;1696;5554;100;259;1545;5174;1645;5433
210910;201305;10185;33151;9696;32386;1964;6953;6402;21652;8366;28605
210920;201305;3372;11522;3298;11421;154;455;2992;10572;3146;11027
210923;201305;1467;5652;1420;5574;207;858;1030;4167;1237;5025
210927;201305;4506;14594;4425;14513;41;102;4350;14331;4391;14433
210930;201305;2403;9279;2352;9200;202;907;1991;7800;2193;8707
210940;201305;2821;11458;2785;11390;318;1193;2263;9522;2581;10715
210945;201305;5664;16938;5489;16759;143;211;5292;16448;5435;16659
210950;201305;5235;17218;4697;16420;700;2484;3284;11836;3984;14320
210955;201305;1762;6164;1635;5934;279;1120;1111;4024;1390;5144
210960;201305;8747;30123;8507;29732;1784;6057;5985;21614;7769;27671
210970;201305;1269;4909;1160;4739;200;869;818;3386;1018;4255
210975;201305;1608;5943;1543;5812;151;637;1239;4673;1390;5310
210980;201305;8066;21816;7910;21634;278;778;7361;20167;7639;20945
210990;201305;14116;41301;11988;38971;1017;3165;10284;33963;11301;37128
211000;201305;15099;51203;13949;49683;1319;4905;11493;41597;12812;46502
211003;201305;5000;17947;4661;17429;884;3437;3106;11879;3990;15316
211010;201305;6477;21845;6330;21647;162;544;5907;20378;6069;20922
211020;201305;7165;22395;7108;22326;251;516;6760;21563;7011;22079
211023;201305;2346;8252;2268;8115;182;686;1904;6904;2086;7590
211027;201305;2943;11711;2819;11504;289;1131;2270;9614;2559;10745
211030;201305;4063;12874;3719;12468;853;2384;2644;9442;3497;11826
211040;201305;3996;15554;3916;15417;120;508;3553;14196;3673;14704
211050;201305;9558;27037;9448;26907;534;1392;8706;25007;9240;26399
211060;201305;5397;20723;5307;20533;488;1718;4487;17809;4975;19527
211065;201305;1597;5725;1482;5565;89;348;1336;5048;1425;5396
211070;201305;8339;28829;8032;28309;818;2966;6419;22999;7237;25965
211080;201305;1300;4219;1091;3938;96;470;901;3177;997;3647
211085;201305;1953;6746;1707;6427;302;1079;1284;5026;1586;6105
211090;201305;3332;11140;3183;10923;235;925;2675;9164;2910;10089
211100;201305;6111;17582;5992;17431;159;554;5558;16183;5717;16737
211102;201305;2966;11406;2885;11282;342;1361;2354;9360;2696;10721
211105;201305;2651;8671;2459;8427;170;626;2151;7396;2321;8022
211107;201305;4198;13443;4012;13205;134;439;3724;12349;3858;12788
211110;201305;6152;19230;5100;17903;855;2918;3547;13098;4402;16016
211120;201305;28721;83777;26093;80139;3167;9535;20180;63494;23347;73029
211125;201305;1980;6941;1912;6821;134;520;1630;5858;1764;6378
211130;201305;138463;424076;132186;416105;24729;77387;95466;307296;120195;384683
211140;201305;5543;18425;5370;18142;317;1175;4685;15848;5002;17023
211150;201305;9244;30749;9064;30506;679;2214;7997;27297;8676;29511
211153;201305;3148;9635;2896;9335;276;725;2424;8153;2700;8878
211157;201305;1152;3993;1003;3765;136;606;724;2750;860;3356
211160;201305;3990;14238;3570;13524;420;1840;2724;10328;3144;12168
211163;201305;1594;5426;1531;5346;68;265;1402;4899;1470;5164
211167;201305;1389;4939;1301;4781;68;295;1121;4129;1189;4424
211170;201305;6363;17957;6204;17760;156;582;5803;16531;5959;17113
211172;201305;2208;6745;1974;6394;151;624;1609;5094;1760;5718
211174;201305;2750;8435;2561;8188;135;551;2238;7099;2373;7650
211176;201305;5439;16284;4681;15397;482;1351;3853;13153;4335;14504
211178;201305;2820;9524;2759;9458;66;196;2635;9124;2701;9320
211180;201305;4124;15349;3892;14970;414;1749;3052;11812;3466;13561
211190;201305;2664;9516;2460;9231;158;689;2151;8109;2309;8798
211195;201305;1367;4537;1220;4373;102;370;1006;3679;1108;4049
211200;201305;2009;7312;1827;7049;292;1052;1295;5312;1587;6364
211210;201305;6695;22824;6537;22556;513;1837;5562;19370;6075;21207
211220;201305;33323;103476;29671;98602;6743;23297;18440;63059;25183;86356
211223;201305;5767;16865;5413;16289;723;2194;3783;11957;4506;14151
211227;201305;1436;5706;1410;5659;173;821;1082;4314;1255;5135
211230;201305;8291;29771;7955;29152;1376;5104;5550;20761;6926;25865
211240;201305;8310;28549;8124;28322;373;1372;7488;26232;7861;27604
211245;201305;4890;15799;4813;15700;233;672;4403;14598;4636;15270
211250;201305;11278;44000;10811;43452;1276;4361;8961;37507;10237;41868
211260;201305;6728;24733;6662;24620;373;1229;6065;22759;6438;23988
211270;201305;9617;35281;9249;34794;655;2741;7776;29608;8431;32349
211280;201305;11347;33959;11153;33721;1224;3013;9449;29643;10673;32656
211285;201305;1959;7110;1719;6667;426;1686;908;3740;1334;5426
211290;201305;7641;25477;7505;25319;541;1485;6661;23046;7202;24531
211300;201305;8049;25687;7288;24517;729;2614;5796;19612;6525;22226
211400;201305;11757;35989;10939;35088;2344;7436;6936;24084;9280;31520
220005;201305;1674;5025;1616;4935;64;287;1439;4266;1503;4553
220010;201305;1706;4596;1304;4096;148;553;1012;3119;1160;3672
220020;201305;3557;11184;3446;10986;619;2114;2328;7404;2947;9518
220025;201305;2053;5333;1972;5226;75;240;1772;4633;1847;4873
220027;201305;1302;3796;1236;3709;97;239;1056;3262;1153;3501
220030;201305;3186;10058;3128;9962;269;946;2652;8456;2921;9402
220040;201305;8152;25837;7843;25331;1447;5003;5129;16605;6576;21608
220045;201305;1408;4607;1297;4432;165;626;965;3276;1130;3902
220050;201305;4669;13649;4229;13077;363;1295;3511;10767;3874;12062
220060;201305;1882;5092;1789;4981;115;345;1578;4393;1693;4738
220070;201305;2527;7741;2276;7392;213;691;1844;6096;2057;6787
220080;201305;801;2540;757;2461;98;392;535;1682;633;2074
220090;201305;1650;4741;1499;4513;152;548;1160;3409;1312;3957
220095;201305;628;1869;611;1829;37;110;552;1644;589;1754
220100;201305;1383;4277;1219;4020;166;512;890;3038;1056;3550
220105;201305;2121;7280;2035;7124;210;790;1511;5296;1721;6086
220110;201305;3472;10316;3090;9771;299;1132;2511;7810;2810;8942
220115;201305;2107;8015;2032;7888;291;1180;1570;6176;1861;7356
220117;201305;1392;3786;1169;3459;96;328;923;2690;1019;3018
220120;201305;11686;35478;11013;34618;443;1685;9941;31273;10384;32958
220130;201305;774;2907;689;2794;70;205;585;2482;655;2687
220140;201305;1493;4155;1445;4098;209;483;1198;3507;1407;3990
220150;201305;6815;22585;6634;22313;503;1984;5648;18935;6151;20919
220155;201305;1023;3297;893;3044;90;381;630;2092;720;2473
220157;201305;1014;2784;942;2679;45;119;821;2360;866;2479
220160;201305;2791;8529;2529;8070;251;943;1914;6052;2165;6995
220170;201305;1208;4054;1164;3968;118;432;910;3132;1028;3564
220173;201305;2074;6400;1761;5802;101;442;1431;4658;1532;5100
220177;201305;1535;4825;1515;4794;110;366;1326;4210;1436;4576
220180;201305;1135;3179;1026;3008;83;289;788;2265;871;2554
220190;201305;4481;14978;3919;14254;485;1858;3003;11018;3488;12876
220191;201305;1393;4803;1341;4715;219;777;993;3517;1212;4294
220192;201305;1728;5202;1457;4752;183;574;1089;3636;1272;4210
220194;201305;1596;4845;1533;4739;156;558;1259;3828;1415;4386
220196;201305;1941;6059;1855;5920;212;782;1437;4549;1649;5331
220198;201305;1316;3625;1134;3378;46;150;1032;3096;1078;3246
220200;201305;4555;16059;4325;15679;761;3017;2954;10654;3715;13671
220202;201305;1953;6456;1820;6213;85;358;1587;5390;1672;5748
220205;201305;2698;7765;2410;7374;125;505;2089;6309;2214;6814
220207;201305;904;2817;803;2644;107;397;598;1964;705;2361
220208;201305;1530;5663;1454;5503;293;1200;931;3552;1224;4752
220209;201305;1531;4956;1421;4762;105;423;1100;3687;1205;4110
220210;201305;1846;4985;1625;4693;102;348;1291;3751;1393;4099
220211;201305;1560;4929;1486;4824;113;506;1216;3926;1329;4432
220213;201305;1757;5270;1653;5081;122;413;1312;3997;1434;4410
220217;201305;1750;5606;1707;5546;90;279;1525;5009;1615;5288
220220;201305;11043;33313;10498;32413;1422;4369;7638;24107;9060;28476
220225;201305;941;3039;925;3012;43;189;830;2670;873;2859
220230;201305;5640;15538;4647;14179;267;821;4080;12546;4347;13367
220240;201305;2604;8546;2514;8381;216;827;1993;6572;2209;7399
220245;201305;1347;3832;1288;3754;62;155;1167;3442;1229;3597
220250;201305;3270;8953;3004;8614;63;154;2833;8223;2896;8377
220253;201305;1824;5574;1602;5167;112;443;1203;3912;1315;4355
220255;201305;1684;5030;1505;4731;124;481;1203;3706;1327;4187
220260;201305;5141;16811;4760;16108;518;2034;3586;12054;4104;14088
220265;201305;1170;4349;1126;4275;103;475;881;3308;984;3783
220270;201305;6056;21958;5936;21740;443;1995;5030;18194;5473;20189
220271;201305;1328;4027;1296;3981;92;298;1114;3453;1206;3751
220272;201305;1743;5478;1635;5315;119;495;1295;4156;1414;4651
220273;201305;1224;3624;1110;3460;96;354;883;2738;979;3092
220275;201305;2001;5537;1741;5194;95;312;1491;4473;1586;4785
220277;201305;2477;6967;2143;6480;180;605;1632;4959;1812;5564
220280;201305;1733;4605;1524;4313;102;380;1241;3443;1343;3823
220285;201305;1594;4369;1486;4223;107;295;1226;3591;1333;3886
220290;201305;6461;21149;5495;19918;468;1744;4516;16638;4984;18382
220300;201305;1870;6188;1673;5922;97;441;1438;5078;1535;5519
220310;201305;2486;8126;2045;7597;109;349;1846;7027;1955;7376
220320;201305;3303;9927;2829;9154;405;1321;2055;6737;2460;8058
220323;201305;1405;5366;1304;5217;226;960;926;3729;1152;4689
220325;201305;1247;3969;1157;3806;162;574;781;2648;943;3222
220327;201305;1304;4308;1192;4110;94;430;970;3311;1064;3741
220330;201305;3546;10469;3419;10290;318;1078;2840;8562;3158;9640
220335;201305;1954;5836;1766;5590;128;467;1501;4734;1629;5201
220340;201305;1717;5033;1555;4817;174;618;1212;3717;1386;4335
220342;201305;1199;3994;1136;3901;116;460;866;3068;982;3528
220345;201305;2777;7999;2400;7378;78;245;2108;6474;2186;6719
220350;201305;4400;12120;3902;11440;316;1028;3113;9108;3429;10136
220360;201305;1404;3999;1127;3554;119;448;822;2565;941;3013
220370;201305;8841;26116;8250;25384;421;1221;7538;23357;7959;24578
220375;201305;1475;4691;1393;4576;91;346;1222;3988;1313;4334
220380;201305;1249;3658;1108;3450;81;277;844;2650;925;2927
220385;201305;640;1853;585;1740;50;174;469;1340;519;1514
220390;201305;9958;32222;9403;31169;2171;7670;5343;17834;7514;25504
220400;201305;1397;3453;1285;3302;63;206;1117;2815;1180;3021
220410;201305;1368;4076;1183;3824;110;475;938;2939;1048;3414
220415;201305;839;2340;764;2231;86;250;570;1682;656;1932
220420;201305;2132;6435;2058;6305;149;472;1748;5371;1897;5843
220430;201305;2882;8705;2746;8520;449;1458;1976;6137;2425;7595
220435;201305;1533;4676;1459;4582;75;240;1265;4005;1340;4245
220440;201305;2750;8330;2282;7797;149;404;2024;7064;2173;7468
220450;201305;2690;8092;2357;7653;547;1821;1488;4924;2035;6745
220455;201305;1376;4340;1232;4133;60;204;1107;3749;1167;3953
220460;201305;991;2851;943;2784;57;184;823;2419;880;2603
220465;201305;2357;7981;2220;7805;315;1189;1716;6087;2031;7276
220470;201305;3943;12221;3609;11616;258;976;2854;9062;3112;10038
220480;201305;2213;6977;2057;6736;177;617;1692;5545;1869;6162
220490;201305;2287;6999;2212;6900;140;516;1938;6015;2078;6531
220500;201305;3369;9347;2955;8679;231;882;2398;6856;2629;7738
220510;201305;2863;8176;2244;7303;121;526;1799;5809;1920;6335
220515;201305;1858;4886;1652;4624;87;253;1406;3958;1493;4211
220520;201305;4724;13881;4488;13536;262;737;3902;11937;4164;12674
220525;201305;1389;4137;1314;4029;102;367;1091;3306;1193;3673
220527;201305;1351;4455;1319;4394;124;407;1114;3745;1238;4152
220530;201305;1014;3161;980;3104;144;515;763;2350;907;2865
220535;201305;845;2762;822;2725;70;294;665;2179;735;2473
220540;201305;3486;11968;3382;11782;299;1183;2742;9580;3041;10763
220545;201305;1359;4858;1314;4776;218;893;894;3207;1112;4100
220550;201305;8657;29530;8277;28806;1626;5981;5472;19088;7098;25069
220551;201305;1344;4830;1292;4733;135;578;1009;3646;1144;4224
220552;201305;1586;5072;1384;4740;143;646;1001;3297;1144;3943
220553;201305;1573;4784;1397;4524;64;207;1216;3966;1280;4173
220554;201305;903;2573;800;2432;124;373;560;1740;684;2113
220555;201305;2327;7110;2214;6947;109;384;1881;6000;1990;6384
220556;201305;1429;4638;1307;4403;105;438;980;3253;1085;3691
220557;201305;1551;5308;1451;5110;181;781;1041;3615;1222;4396
220558;201305;1003;3194;956;3115;87;316;784;2553;871;2869
220559;201305;1513;4390;1411;4240;83;290;1212;3622;1295;3912
220560;201305;1719;4382;1465;4025;82;250;1246;3391;1328;3641
220570;201305;7213;23439;6853;22998;641;1785;5842;20259;6483;22044
220580;201305;6270;21221;6102;21012;431;1455;5380;18782;5811;20237
220585;201305;1690;6795;1655;6727;110;475;1449;5911;1559;6386
220590;201305;1369;4430;1245;4242;219;781;842;2910;1061;3691
220595;201305;2379;7076;2223;6864;97;332;2000;6203;2097;6535
220600;201305;1222;3315;1081;3143;124;349;818;2426;942;2775
220605;201305;1974;6064;1794;5784;132;447;1407;4569;1539;5016
220610;201305;2602;8652;2528;8540;191;745;2131;7172;2322;7917
220620;201305;7594;26450;7399;26145;357;1518;6574;23166;6931;24684
220630;201305;373;1176;330;1102;88;308;167;569;255;877
220635;201305;1826;6691;1699;6393;168;756;1131;4250;1299;5006
220640;201305;2663;8170;2612;8075;276;974;2041;6273;2317;7247
220650;201305;2441;6905;2212;6554;128;436;1854;5483;1982;5919
220660;201305;2474;8638;2051;8121;151;594;1841;7360;1992;7954
220665;201305;1194;4168;1146;4091;58;236;1005;3576;1063;3812
220667;201305;1727;6005;1640;5878;95;395;1411;5038;1506;5433
220669;201305;1820;6162;1704;5927;226;902;1231;4261;1457;5163
220670;201305;2057;6426;1989;6348;159;416;1743;5761;1902;6177
220672;201305;2081;6243;2035;6176;230;692;1691;5180;1921;5872
220675;201305;1261;3841;1195;3727;132;374;898;2842;1030;3216
220680;201305;2209;7466;2136;7362;117;463;1879;6490;1996;6953
220690;201305;1694;4988;1551;4744;134;508;1260;3793;1394;4301
220695;201305;822;2633;794;2582;63;219;619;2026;682;2245
220700;201305;8866;26544;8175;25516;791;2729;6500;20357;7291;23086
220710;201305;733;2245;659;2134;87;276;478;1563;565;1839
220720;201305;2072;5736;1968;5586;109;249;1745;5052;1854;5301
220730;201305;1300;3735;1193;3568;68;216;994;2977;1062;3193
220735;201305;1015;2751;887;2545;95;300;657;1889;752;2189
220740;201305;1295;4421;1131;4204;104;342;945;3616;1049;3958
220750;201305;3744;11611;3611;11405;458;1387;2798;9085;3256;10472
220755;201305;1145;3514;1102;3446;70;213;964;3035;1034;3248
220760;201305;2504;9112;2339;8850;120;501;2033;7752;2153;8253
220770;201305;22354;79121;21186;76982;7261;27310;9557;35770;16818;63080
220775;201305;1085;2809;1076;2800;18;27;1052;2758;1070;2785
220777;201305;1648;4860;1581;4764;142;458;1300;3887;1442;4345
220779;201305;1116;3561;1097;3528;71;285;968;3087;1039;3372
220780;201305;6151;16390;5624;15710;470;1208;4739;13506;5209;14714
220785;201305;1274;3568;1231;3477;66;196;1104;3092;1170;3288
220790;201305;8694;30235;8514;29872;871;3459;6812;23828;7683;27287
220793;201305;819;2558;778;2480;74;263;616;1961;690;2224
220795;201305;1400;4255;1356;4182;96;334;1145;3542;1241;3876
220800;201305;16188;47947;15369;46625;2058;7225;11600;34476;13658;41701
220810;201305;3175;9604;2795;8911;252;1011;2164;6780;2416;7791
220820;201305;5315;15793;4894;15236;374;1219;4108;12936;4482;14155
220830;201305;7577;22082;7304;21636;898;2623;5672;17118;6570;19741
220840;201305;14003;46570;13079;44727;3509;12213;6218;22041;9727;34254
220850;201305;2534;9703;2447;9563;366;1521;1836;7266;2202;8787
220855;201305;586;1933;542;1848;74;301;392;1319;466;1620
220860;201305;912;2641;857;2554;55;221;705;2051;760;2272
220865;201305;2608;7567;2231;6964;128;572;1820;5572;1948;6144
220870;201305;2273;7737;1999;7382;167;672;1668;6172;1835;6844
220880;201305;5237;14149;4821;13633;271;939;4209;11873;4480;12812
220885;201305;1314;4707;1169;4446;119;556;862;3280;981;3836
220887;201305;1182;3387;1081;3244;56;184;942;2843;998;3027
220890;201305;1563;5726;1419;5491;123;460;1178;4686;1301;5146
220900;201305;1788;5622;1621;5227;133;415;1303;4280;1436;4695
220910;201305;1715;5051;1546;4787;89;308;1331;4153;1420;4461
220915;201305;1023;3034;925;2874;58;251;747;2255;805;2506
220920;201305;1284;4908;1229;4828;120;547;955;3748;1075;4295
220930;201305;1415;4731;1259;4526;117;488;1017;3663;1134;4151
220935;201305;1084;3458;1014;3304;92;397;742;2314;834;2711
220937;201305;1473;4234;1295;3918;86;303;1038;3099;1124;3402
220940;201305;1460;4579;1370;4383;102;377;1106;3546;1208;3923
220945;201305;470;1751;445;1667;56;237;330;1234;386;1471
220950;201305;1229;3199;915;2649;50;205;692;1929;742;2134
220955;201305;1516;4389;1294;4043;141;506;1000;3091;1141;3597
220960;201305;766;2258;693;2132;79;306;522;1552;601;1858
220965;201305;1591;5057;1513;4947;80;332;1295;4223;1375;4555
220970;201305;2097;5817;1619;5044;199;617;1142;3632;1341;4249
220975;201305;459;1896;457;1891;51;185;392;1656;443;1841
220980;201305;1452;4475;1306;4207;134;509;896;2944;1030;3453
220985;201305;1332;3927;1281;3856;120;405;1018;3067;1138;3472
220987;201305;1460;4951;1385;4812;138;575;1050;3583;1188;4158
220990;201305;1784;5414;1620;5141;105;443;1300;4069;1405;4512
220995;201305;1134;3590;966;3300;83;352;771;2609;854;2961
220997;201305;2050;6615;1983;6515;162;542;1730;5683;1892;6225
221000;201305;3955;12929;3681;12438;432;1626;2747;9240;3179;10866
221005;201305;1371;4453;1309;4342;364;1151;757;2616;1121;3767
221010;201305;1219;3439;1087;3272;73;240;932;2823;1005;3063
221020;201305;1878;5978;1787;5814;141;616;1385;4401;1526;5017
221030;201305;1810;5057;1592;4743;89;359;1301;3826;1390;4185
221035;201305;1477;4174;1345;4005;103;306;1150;3469;1253;3775
221037;201305;601;1926;578;1886;37;162;468;1464;505;1626
221038;201305;592;1774;499;1620;51;180;357;1165;408;1345
221039;201305;879;2750;847;2699;65;228;738;2341;803;2569
221040;201305;5033;15866;4809;15492;430;1531;3792;12331;4222;13862
221050;201305;3509;11288;3263;10922;234;978;2768;9156;3002;10134
221060;201305;8905;24734;7777;23288;884;2694;6176;18693;7060;21387
221062;201305;1236;4414;1190;4353;36;105;1119;4126;1155;4231
221063;201305;1064;3552;1021;3478;330;1084;581;2091;911;3175
221065;201305;2477;7866;2398;7718;267;909;1866;5984;2133;6893
221070;201305;4359;13693;4020;13179;300;1132;3243;10619;3543;11751
221080;201305;3095;9315;2869;9011;261;862;2312;7353;2573;8215
221090;201305;1316;3709;1189;3523;76;303;1001;2899;1077;3202
221093;201305;1752;5364;1686;5243;253;915;1157;3512;1410;4427
221095;201305;942;2648;819;2476;45;123;721;2213;766;2336
221097;201305;765;2310;696;2195;64;247;535;1676;599;1923
221100;201305;118061;373234;113157;364986;25408;90840;73163;230516;98571;321356
221110;201305;9153;32721;9027;32527;727;2931;7616;27454;8343;30385
221120;201305;3946;13735;3839;13535;1198;4034;2203;8226;3401;12260
221130;201305;4516;13849;4079;12954;989;3290;2317;7275;3306;10565
221135;201305;1369;4519;1297;4400;195;741;907;3065;1102;3806
221140;201305;1367;3566;1268;3435;177;389;975;2746;1152;3135
221150;201305;1207;3208;1056;2947;39;154;859;2374;898;2528
221160;201305;905;2517;867;2457;61;193;680;1938;741;2131
221170;201305;1075;3626;1041;3555;84;340;864;2918;948;3258
230010;201305;3231;9212;2801;8513;184;633;2243;6891;2427;7524
230015;201305;2923;10373;2723;9945;510;2124;1711;6163;2221;8287
230020;201305;13658;47297;13208;46379;1368;5236;10292;36346;11660;41582
230030;201305;11850;36827;11404;36076;1252;4289;8946;28336;10198;32625
230040;201305;4426;13061;3832;12000;366;1294;2985;9311;3351;10605
230050;201305;2520;8820;2222;8083;416;1673;1229;4487;1645;6160
230060;201305;1920;6019;1746;5678;193;726;1297;4192;1490;4918
230070;201305;4549;12866;4084;12215;395;1262;3130;9563;3525;10825
230075;201305;8417;33007;8083;32325;1115;4986;5929;23863;7044;28849
230080;201305;2281;6563;1983;6131;123;449;1621;4989;1744;5438
230090;201305;3138;10249;2885;9773;371;1434;2137;7152;2508;8586
230100;201305;16323;52983;15407;51323;4644;16373;7598;25643;12242;42016
230110;201305;13559;46522;12767;44809;2580;9828;7821;27456;10401;37284
230120;201305;7402;21663;6835;20902;783;2734;5209;15851;5992;18585
230125;201305;2789;8524;2377;7737;195;765;1813;5858;2008;6623
230130;201305;5871;19919;4922;17858;492;2141;3441;12381;3933;14522
230140;201305;3186;11040;2905;10559;480;1829;1920;7133;2400;8962
230150;201305;1665;5547;1494;5200;279;1144;983;3264;1262;4408
230160;201305;6037;19147;5402;18192;592;2224;4088;13809;4680;16033
230170;201305;6291;20851;5558;19493;573;2308;4023;13999;4596;16307
230180;201305;1872;5627;1704;5334;166;656;1215;3782;1381;4438
230185;201305;4045;14047;3782;13522;736;2702;2350;8647;3086;11349
230190;201305;12160;41120;11247;39300;2067;8225;6819;23617;8886;31842
230195;201305;4677;15155;4287;14549;399;1725;3323;10910;3722;12635
230200;201305;5309;16395;4981;15761;761;2554;3461;10949;4222;13503
230205;201305;4292;14311;3883;13606;447;1802;2813;9985;3260;11787
230210;201305;8895;26777;8095;25554;1964;6379;4701;15340;6665;21719
230220;201305;13064;40781;12262;39417;2152;7743;8220;26071;10372;33814
230230;201305;6904;24274;6279;22892;1047;4144;3907;14381;4954;18525
230240;201305;12740;39039;11733;37139;866;3427;9209;28584;10075;32011
230250;201305;10105;31669;9876;31317;584;2135;8464;26838;9048;28973
230260;201305;14475;51322;13573;49386;3294;12765;7085;26422;10379;39187
230270;201305;6927;21792;6247;20629;717;2629;4624;15410;5341;18039
230280;201305;19503;61248;18294;59292;2487;8820;13736;44532;16223;53352
230290;201305;4951;15850;4407;14760;610;2212;3028;10158;3638;12370
230300;201305;4501;14856;4347;14623;590;2202;3231;10912;3821;13114
230310;201305;4750;14695;4257;13875;419;1691;3243;10363;3662;12054
230320;201305;7106;23987;6761;23377;900;3495;4964;17232;5864;20727
230330;201305;4554;14197;4201;13494;448;1720;3135;9866;3583;11586
230340;201305;3224;11810;3083;11489;517;2242;1979;7189;2496;9431
230350;201305;17419;55598;15810;52750;3250;11649;9599;32377;12849;44026
230360;201305;2721;8615;2540;8275;273;1048;2000;6430;2273;7478
230365;201305;2785;8659;2484;8146;229;894;1840;6009;2069;6903
230370;201305;51435;178711;48466;173679;14968;55895;24606;90966;39574;146861
230380;201305;6874;20547;6002;19070;608;2289;4288;13563;4896;15852
230390;201305;3585;11755;3235;11176;459;1848;2202;7583;2661;9431
230393;201305;3261;11283;2901;10517;313;1510;2050;7201;2363;8711
230395;201305;4766;15785;4486;15225;653;2633;3095;10365;3748;12998
230400;201305;4976;16128;4434;15390;430;1906;3586;12204;4016;14110
230410;201305;15808;51522;14401;48977;2387;8896;9251;31504;11638;40400
230420;201305;23164;79868;22072;77668;5820;22380;11455;40102;17275;62482
230423;201305;4682;15901;4358;15330;558;2153;3061;10916;3619;13069
230425;201305;5059;17937;4848;17445;730;2867;3429;12344;4159;15211
230426;201305;2761;7988;2392;7333;154;630;1850;5559;2004;6189
230427;201305;1686;5351;1322;4527;162;620;886;2987;1048;3607
230428;201305;8699;29702;8511;29372;1841;7123;5453;18540;7294;25663
230430;201305;4420;14843;4230;14454;433;1809;3122;10499;3555;12308
230435;201305;4390;15563;4062;14991;1131;4492;1934;7439;3065;11931
230440;201305;346239;1113542;330016;1083965;87467;310373;170235;559671;257702;870044
230445;201305;4549;13055;4020;12321;425;1294;3001;9461;3426;10755
230450;201305;3524;11735;3044;10864;522;2046;1898;6854;2420;8900
230460;201305;1831;6300;1717;6075;202;771;1279;4564;1481;5335
230465;201305;3980;12859;3374;11706;412;1700;2237;7712;2649;9412
230470;201305;10298;39918;10017;39364;1511;6362;7157;28715;8668;35077
230480;201305;1396;4698;1291;4508;201;762;903;3147;1104;3909
230490;201305;2904;8742;2598;8186;455;1634;1477;4645;1932;6279
230495;201305;5588;19283;5099;18473;966;4116;3107;11248;4073;15364
230500;201305;10509;36677;10087;36002;892;3292;8082;29529;8974;32821
230510;201305;1441;5378;1290;5004;383;1567;587;2356;970;3923
230520;201305;4932;15497;4339;14438;498;1942;3036;10039;3534;11981
230523;201305;12693;44040;11902;42258;3860;15166;3675;13230;7535;28396
230526;201305;3881;12836;3476;12077;498;1906;2368;8350;2866;10256
230530;201305;4952;17205;4650;16769;618;2354;3505;12704;4123;15058
230533;201305;3679;11230;3481;10844;314;1145;2704;8346;3018;9491
230535;201305;5136;16093;4589;15066;525;1896;3359;11122;3884;13018
230540;201305;17920;54042;16316;51677;1293;4738;13365;42116;14658;46854
230550;201305;19921;62118;18429;59275;4467;15471;10174;32780;14641;48251
230560;201305;6464;19450;6035;18648;355;1425;4801;14693;5156;16118
230565;201305;3534;10552;3134;9802;297;1119;2268;7010;2565;8129
230570;201305;3810;10815;3470;10379;266;977;2849;8411;3115;9388
230580;201305;9909;31783;9621;31397;569;1991;8454;27792;9023;29783
230590;201305;9290;30876;8757;29919;866;3654;6601;22119;7467;25773
230600;201305;3524;10329;2920;9088;353;1233;1940;5981;2293;7214
230610;201305;5881;20211;5541;19656;822;3224;3999;14240;4821;17464
230620;201305;1919;5724;1674;5247;174;637;1152;3574;1326;4211
230625;201305;7062;24570;6561;23397;1855;7232;2727;9652;4582;16884
230630;201305;10541;36078;9827;34551;1906;6694;5922;21459;7828;28153
230640;201305;24246;87800;23608;86617;4100;15982;16287;60432;20387;76414
230650;201305;4810;15967;4476;15308;432;1872;3417;11469;3849;13341
230655;201305;7865;31574;7656;31227;859;3456;6246;26036;7105;29492
230660;201305;6139;20011;5487;18793;616;2482;3928;13546;4544;16028
230670;201305;5757;16403;4814;14787;338;1249;3795;11514;4133;12763
230680;201305;2860;8794;2500;8150;462;1655;1494;4874;1956;6529
230690;201305;6729;22545;6341;21864;631;2703;4547;15350;5178;18053
230700;201305;8705;26535;7796;24889;936;3660;5264;16374;6200;20034
230710;201305;7018;24245;6619;23433;883;3277;4751;17144;5634;20421
230720;201305;1901;6161;1647;5672;247;905;1097;3818;1344;4723
230725;201305;3741;12806;3597;12493;585;2329;2529;8661;3114;10990
230730;201305;55312;173905;47887;162577;12071;44628;26003;89834;38074;134462
230740;201305;4820;16464;4751;16318;375;1642;3945;13354;4320;14996
230750;201305;8628;26155;7503;24269;788;3062;5585;17931;6373;20993
230760;201305;9399;30284;9189;29793;1363;5520;6663;20507;8026;26027
230763;201305;4054;13313;3880;12980;357;1627;3009;9678;3366;11305
230765;201305;41886;142278;39731;137798;13686;50274;15124;53525;28810;103799
230770;201305;21694;64294;20881;63145;1756;6803;16996;50694;18752;57497
230780;201305;5816;23851;5604;23357;1281;5426;3203;14037;4484;19463
230790;201305;2378;8607;2293;8472;293;1172;1805;6724;2098;7896
230800;201305;7639;28789;7144;27668;1721;7372;3682;14308;5403;21680
230810;201305;12128;40834;11710;40135;1450;5316;8943;31014;10393;36330
230820;201305;3215;11436;2933;10866;650;2624;1682;6356;2332;8980
230830;201305;7553;23768;6932;22658;743;2896;5052;16400;5795;19296
230835;201305;4042;11424;3526;10761;336;1115;2763;8471;3099;9586
230837;201305;3111;10982;2726;10180;417;1758;1780;6668;2197;8426
230840;201305;9040;31194;8370;29981;1633;6147;5152;18954;6785;25101
230850;201305;11029;34756;10504;34093;1357;4913;7948;25749;9305;30662
230860;201305;4973;15394;4578;14582;444;1704;3412;10700;3856;12404
230870;201305;18489;53251;16850;50422;1987;6773;12531;37188;14518;43961
230880;201305;1894;6792;1785;6573;300;1257;1170;4316;1470;5573
230890;201305;4015;15064;3765;14551;511;2340;2695;10285;3206;12625
230900;201305;2975;10258;2652;9579;442;1736;1610;5799;2052;7535
230910;201305;2895;9043;2421;8118;289;1146;1689;5564;1978;6710
230920;201305;4478;13698;4158;13288;356;1216;3366;10915;3722;12131
230930;201305;7479;23748;6933;22737;923;3255;4888;16137;5811;19392
230940;201305;7477;21587;6747;20577;325;980;5938;18352;6263;19332
230945;201305;6000;18997;5440;18231;694;2493;3968;13403;4662;15896
230950;201305;6700;19105;5917;18080;396;1407;4709;14375;5105;15782
230960;201305;11595;38667;10885;37193;2716;10236;5287;17926;8003;28162
230970;201305;12762;42799;11859;40978;2655;10505;6291;21304;8946;31809
230980;201305;2668;9268;2521;8952;686;2528;1332;4854;2018;7382
230990;201305;1533;5053;1319;4588;169;703;837;2836;1006;3539
231000;201305;2772;7796;2296;6885;250;905;1600;4681;1850;5586
231010;201305;2823;8654;2539;8223;358;1386;1792;5697;2150;7083
231020;201305;7837;26694;7443;25882;1398;5199;4765;16835;6163;22034
231025;201305;7401;24407;6797;23402;640;2258;5323;18723;5963;20981
231030;201305;7621;26225;6614;24078;1284;4957;4051;14922;5335;19879
231040;201305;2918;10167;2691;9674;316;1368;1864;6613;2180;7981
231050;201305;11380;34967;10373;33096;1122;4090;7585;24182;8707;28272
231060;201305;2344;7589;2185;7315;218;993;1650;5339;1868;6332
231070;201305;8784;29244;8385;28481;1447;5283;5597;19163;7044;24446
231080;201305;4108;13544;3853;13046;328;1503;2865;9366;3193;10869
231085;201305;4511;15076;4367;14808;712;2683;3175;10762;3887;13445
231090;201305;4137;11892;3556;10730;253;954;2696;8010;2949;8964
231095;201305;2128;7291;1892;6825;222;869;1345;4897;1567;5766
231100;201305;3023;9605;2584;8734;265;1030;1867;6282;2132;7312
231110;201305;3648;12618;3553;12447;411;1571;2630;9268;3041;10839
231120;201305;2389;8057;2231;7774;388;1425;1484;5187;1872;6612
231123;201305;2149;6225;1898;5836;150;509;1519;4693;1669;5202
231126;201305;6556;18770;5508;17322;488;1765;4324;13457;4812;15222
231130;201305;19478;63643;18088;61175;4752;17023;9611;33481;14363;50504
231135;201305;4524;13777;3902;12810;386;1494;2885;9346;3271;10840
231140;201305;15095;50816;14402;49470;1715;7766;10366;34308;12081;42074
231150;201305;5709;17451;4918;15885;1067;3787;2511;7971;3578;11758
231160;201305;5604;19958;5451;19632;1621;6032;2984;10788;4605;16820
231170;201305;4608;15244;4353;14747;554;2273;3052;10218;3606;12491
231180;201305;13561;44232;12936;42970;2694;9944;7890;25726;10584;35670
231190;201305;4805;14054;4132;13069;416;1482;3164;9954;3580;11436
231195;201305;4637;16278;4079;15207;440;1918;3085;11572;3525;13490
231200;201305;7359;26697;6809;25662;840;3784;4984;18688;5824;22472
231210;201305;4713;15603;4118;14737;374;1623;3098;11215;3472;12838
231220;201305;13643;40764;11761;37582;1347;5114;7697;24672;9044;29786
231230;201305;9189;33872;8718;32920;1300;5389;6125;23181;7425;28570
231240;201305;11362;37182;10418;35507;1453;5570;7044;24239;8497;29809
231250;201305;2042;6110;1416;4545;271;922;602;1808;873;2730
231260;201305;3993;11538;3657;11088;492;1598;2575;7971;3067;9569
231270;201305;7350;21865;6824;21070;773;3028;4975;14989;5748;18017
231280;201305;1699;5825;1644;5728;156;563;1315;4656;1471;5219
231290;201305;31692;116844;29540;111390;8199;33823;12667;46945;20866;80768
231300;201305;4308;13245;3680;11929;404;1662;2657;8299;3061;9961
231310;201305;7093;21659;6348;20160;1472;4913;3418;10856;4890;15769
231320;201305;7005;22189;6309;20875;514;2024;4852;15988;5366;18012
231325;201305;2533;8040;2319;7669;205;725;1815;6103;2020;6828
231330;201305;13726;43918;11712;40008;2052;7225;7259;25093;9311;32318
231335;201305;4850;14488;4422;13706;372;1436;3537;10743;3909;12179
231340;201305;17107;57952;16303;56789;1582;5346;13192;47194;14774;52540
231350;201305;11742;41533;11587;41287;1356;4703;9472;34426;10828;39129
231355;201305;4296;14149;4162;13933;254;847;3609;12254;3863;13101
231360;201305;6686;23061;6368;22576;1493;5231;3953;14597;5446;19828
231370;201305;2275;6797;1884;6225;144;589;1429;4625;1573;5214
231375;201305;4032;14303;3847;13947;486;2105;2875;10279;3361;12384
231380;201305;5140;17212;4866;16823;880;3277;3339;11734;4219;15011
231390;201305;3330;10879;3199;10705;212;837;2718;9140;2930;9977
231395;201305;4134;13715;3743;13103;812;2975;2298;8244;3110;11219
231400;201305;10113;31249;9351;29913;1098;4089;6636;21239;7734;25328
231410;201305;14480;49086;13223;47316;1476;5392;9922;36600;11398;41992
240010;201305;2278;7447;2133;7127;618;2297;947;3074;1565;5371
240020;201305;11410;36848;10349;34847;2946;10669;4785;16414;7731;27083
240030;201305;2703;8184;2610;8034;283;1076;1980;5937;2263;7013
240040;201305;752;2343;671;2192;83;355;471;1459;554;1814
240050;201305;3416;9843;3111;9320;269;1009;2356;6880;2625;7889
240060;201305;1355;4247;1308;4172;144;571;985;3042;1129;3613
240070;201305;2640;7824;2530;7607;359;1224;1727;5046;2086;6270
240080;201305;2904;8093;2734;7837;208;659;2266;6505;2474;7164
240090;201305;2125;6087;1861;5555;89;372;1444;4206;1533;4578
240100;201305;9825;29800;9229;28604;1265;4679;5840;18077;7105;22756
240110;201305;4994;15549;4627;14948;983;3575;2859;8958;3842;12533
240120;201305;2901;9837;2827;9700;619;2314;1758;6111;2377;8425
240130;201305;2609;7577;2286;7058;179;691;1819;5492;1998;6183
240140;201305;2191;7043;2035;6762;474;1798;1083;3524;1557;5322
240145;201305;6055;19162;5552;18291;1471;5381;3033;9993;4504;15374
240150;201305;992;3137;847;2855;141;585;483;1564;624;2149
240160;201305;1398;4770;1308;4612;163;657;912;3234;1075;3891
240165;201305;853;2854;778;2713;100;386;528;1862;628;2248
240170;201305;2536;7906;2319;7499;618;2105;1230;4064;1848;6169
240180;201305;2851;9256;2709;9028;674;2343;1524;5282;2198;7625
240185;201305;1464;4968;1421;4903;192;701;1054;3657;1246;4358
240190;201305;865;2735;840;2692;122;482;569;1761;691;2243
240200;201305;13384;36364;11545;34058;2230;6601;7528;23124;9758;29725
240210;201305;2651;7782;2475;7545;246;900;2016;6046;2262;6946
240220;201305;7259;23437;7075;23223;251;964;6585;21615;6836;22579
240230;201305;5218;15567;4920;15025;515;1859;3757;11295;4272;13154
240240;201305;1688;5479;1345;4551;420;1514;331;1036;751;2550
240250;201305;2753;8167;2632;7972;215;809;2153;6385;2368;7194
240260;201305;14315;49398;13741;48433;2439;9846;9064;31822;11503;41668
240270;201305;2282;7799;2181;7631;274;973;1619;5777;1893;6750
240280;201305;1574;4671;1409;4365;145;538;1010;3088;1155;3626
240290;201305;1420;4547;1236;4203;127;612;830;2679;957;3291
240300;201305;1953;5458;1682;5008;351;1169;933;2701;1284;3870
240310;201305;9928;29071;9234;27993;2215;7431;5074;15268;7289;22699
240320;201305;2006;6132;1731;5570;139;626;1198;3698;1337;4324
240325;201305;34676;99847;28387;89085;8475;29382;10417;32885;18892;62267
240330;201305;1494;4633;1293;4232;176;719;795;2485;971;3204
240340;201305;1546;4816;1405;4632;306;1103;873;2861;1179;3964
240350;201305;1990;6402;1904;6248;320;1208;1416;4538;1736;5746
240360;201305;6909;21748;6181;20610;1040;3779;4196;14281;5236;18060
240370;201305;1911;5388;1722;5092;137;496;1313;3874;1450;4370
240375;201305;855;2317;766;2193;155;519;427;1164;582;1683
240380;201305;2543;7772;2218;7101;359;1194;1363;4351;1722;5545
240390;201305;881;2594;737;2305;78;306;481;1481;559;1787
240400;201305;1416;3933;1253;3705;138;521;952;2748;1090;3269
240410;201305;507;1685;454;1570;87;347;264;899;351;1246
240420;201305;4777;18401;4627;18067;1343;5310;2470;10178;3813;15488
240430;201305;3365;9984;3122;9553;389;1359;2214;6692;2603;8051
240440;201305;2535;7281;2389;6994;604;1758;1252;3780;1856;5538
240450;201305;3516;10954;3302;10589;571;2158;2016;6424;2587;8582
240460;201305;2716;9331;2650;9210;317;1275;2006;6975;2323;8250
240470;201305;3762;11634;3236;10599;846;2913;1620;5450;2466;8363
240480;201305;330;900;321;891;37;102;246;700;283;802
240485;201305;2071;6346;1852;5919;281;1014;1187;3802;1468;4816
240490;201305;1628;4284;1454;4044;95;367;1163;3126;1258;3493
240500;201305;1901;6101;1862;6035;183;666;1470;4795;1653;5461
240510;201305;1742;5469;1629;5249;278;936;1100;3592;1378;4528
240520;201305;1419;4263;1258;4032;212;792;864;2707;1076;3499
240530;201305;2018;6885;1853;6603;291;1146;1245;4441;1536;5587
240540;201305;1826;5615;1741;5474;154;566;1337;4145;1491;4711
240550;201305;696;2144;674;2108;55;210;538;1655;593;1865
240560;201305;3134;9389;3012;9205;270;928;2471;7518;2741;8446
240570;201305;3033;8886;2538;7785;554;1917;1159;3287;1713;5204
240580;201305;7887;25041;7532;24483;1367;4658;5336;17361;6703;22019
240590;201305;814;2378;749;2268;57;226;541;1594;598;1820
240600;201305;1429;4398;1202;3908;220;806;659;2038;879;2844
240610;201305;5016;14239;4476;13271;459;1543;3203;9353;3662;10896
240615;201305;987;2929;868;2708;143;457;518;1632;661;2089
240620;201305;1528;5284;1460;5144;314;1179;1000;3536;1314;4715
240630;201305;1980;6263;1899;6125;173;570;1487;4936;1660;5506
240640;201305;820;2594;720;2433;95;418;471;1527;566;1945
240650;201305;3656;11574;3426;11261;318;1213;2769;9054;3087;10267
240660;201305;2355;7971;2276;7846;260;999;1740;6066;2000;7065
240670;201305;2686;8224;2345;7535;392;1484;1392;4339;1784;5823
240680;201305;1442;4333;1188;3860;155;549;740;2406;895;2955
240690;201305;1059;3080;941;2891;108;394;677;2061;785;2455
240700;201305;2560;7904;2173;7148;154;685;1658;5277;1812;5962
240710;201305;17476;45264;15758;43189;2875;8001;10115;28661;12990;36662
240720;201305;5373;15985;5148;15633;1293;4358;2942;8876;4235;13234
240725;201305;1062;3211;836;2707;97;318;466;1490;563;1808
240730;201305;2243;7069;2035;6676;212;796;1439;4651;1651;5447
240740;201305;2222;6819;2011;6435;256;910;1349;4286;1605;5196
240750;201305;2135;8122;1990;7847;442;1856;1189;4763;1631;6619
240760;201305;1172;3599;1120;3519;108;318;903;2917;1011;3235
240770;201305;3424;10306;3168;9919;448;1557;2201;6902;2649;8459
240780;201305;5297;16177;4566;14925;964;3251;2507;8574;3471;11825
240790;201305;822;2708;699;2484;70;294;521;1834;591;2128
240800;201305;38021;113870;35515;109410;10514;34813;15858;49434;26372;84247
240810;201305;91731;282885;87063;274109;29381;96170;39189;125765;68570;221935
240820;201305;6596;20184;5799;18894;931;3420;3503;11708;4434;15128
240830;201305;8981;28250;8590;27666;846;2853;6937;22723;7783;25576
240840;201305;1234;3579;1095;3326;101;378;707;2120;808;2498
240850;201305;1099;3506;861;3005;175;701;442;1457;617;2158
240860;201305;1261;3673;1105;3429;94;356;812;2462;906;2818
240870;201305;1093;3164;975;2945;131;515;674;1909;805;2424
240880;201305;1079;3830;1051;3780;156;683;721;2558;877;3241
240890;201305;5341;15353;4838;14543;795;2740;2923;8678;3718;11418
240895;201305;2709;9437;2511;9084;384;1525;1767;6432;2151;7957
240910;201305;2434;8186;2317;7969;261;1076;1767;6041;2028;7117
240920;201305;835;2763;782;2628;189;722;422;1375;611;2097
240930;201305;3475;9721;3203;9343;318;1012;2527;7412;2845;8424
240933;201305;1315;4249;1212;4072;351;1241;565;2024;916;3265
240940;201305;6375;18571;5533;17146;1151;3823;3089;9546;4240;13369
240950;201305;1106;3588;1049;3489;101;425;771;2572;872;2997
240960;201305;733;2416;674;2293;112;425;470;1582;582;2007
240970;201305;1927;5728;1715;5318;150;616;1218;3727;1368;4343
240980;201305;3311;11063;3104;10661;752;2793;1804;6191;2556;8984
240990;201305;3003;9203;2840;8867;639;2231;1747;5309;2386;7540
241000;201305;1026;3013;916;2821;99;384;666;2000;765;2384
241010;201305;2831;9881;2570;9405;456;1868;1677;6060;2133;7928
241020;201305;2016;5863;1711;5284;180;683;1086;3191;1266;3874
241025;201305;1466;4616;1392;4492;148;631;984;3108;1132;3739
241030;201305;2451;8250;2272;7936;175;657;1847;6506;2022;7163
241040;201305;2001;7166;1866;6907;217;942;1416;5199;1633;6141
241050;201305;1270;3910;1175;3750;122;497;886;2736;1008;3233
241060;201305;985;2886;906;2756;127;411;678;2069;805;2480
241070;201305;911;2701;794;2476;102;400;561;1682;663;2082
241080;201305;1145;3544;1042;3364;87;367;756;2379;843;2746
241090;201305;2017;5956;1807;5613;131;547;1497;4572;1628;5119
241100;201305;1150;3539;1057;3330;107;400;745;2312;852;2712
241105;201305;1061;3316;1008;3216;131;470;705;2282;836;2752
241110;201305;837;2747;721;2497;148;570;382;1309;530;1879
241120;201305;8005;24243;7340;23193;1407;4550;4995;16147;6402;20697
241140;201305;3137;9448;2871;8908;377;1390;1943;5849;2320;7239
241142;201305;688;2141;526;1789;169;656;170;540;339;1196
241150;201305;5442;17104;5144;16608;778;2709;3613;11705;4391;14414
241160;201305;1039;3161;1004;3102;163;557;700;2159;863;2716
241170;201305;1331;3990;1222;3789;164;588;770;2468;934;3056
241180;201305;990;2709;799;2385;95;359;515;1469;610;1828
241190;201305;1012;2880;934;2752;100;384;637;1771;737;2155
241200;201305;19464;60737;18297;58804;4951;17159;9576;31255;14527;48414
241210;201305;1429;4386;1258;4052;251;906;704;2256;955;3162
241220;201305;7813;26977;7494;26361;1827;6900;4190;15065;6017;21965
241230;201305;2900;9321;2684;8997;261;1027;2128;7127;2389;8154
241240;201305;1120;3272;872;2762;104;345;527;1686;631;2031
241250;201305;5399;17731;4909;16768;419;1859;3995;13402;4414;15261
241255;201305;1847;7185;1778;7036;413;1710;964;3969;1377;5679
241260;201305;4196;12456;3580;11359;539;1828;2316;7367;2855;9195
241270;201305;1970;6101;1789;5764;307;1143;1060;3460;1367;4603
241280;201305;2082;6186;1953;5927;386;1234;1203;3706;1589;4940
241290;201305;3181;9014;2611;8116;490;1661;1539;4750;2029;6411
241300;201305;1269;3933;1213;3849;110;406;964;3063;1074;3469
241310;201305;1462;4838;1422;4764;202;677;1056;3630;1258;4307
241320;201305;823;2819;792;2761;163;613;468;1656;631;2269
241330;201305;1465;4759;1389;4656;158;634;1115;3689;1273;4323
241335;201305;2389;7739;2337;7646;207;676;1977;6514;2184;7190
241340;201305;1897;6053;1745;5747;474;1716;875;2826;1349;4542
241350;201305;1872;6140;1778;5951;187;778;1345;4389;1532;5167
241355;201305;1193;3403;1119;3279;30;130;1027;2959;1057;3089
241360;201305;2024;5783;1863;5464;167;644;1391;3906;1558;4550
241370;201305;1316;4184;1099;3732;184;758;688;2254;872;3012
241380;201305;700;2094;612;1914;91;358;334;1014;425;1372
241390;201305;2760;9584;2634;9333;721;2586;1478;5460;2199;8046
241400;201305;3509;10928;3355;10704;499;1814;2420;7730;2919;9544
241410;201305;2580;7857;2397;7589;445;1563;1629;5093;2074;6656
241415;201305;1527;4901;1417;4670;162;622;1001;3257;1163;3879
241420;201305;1924;7090;1772;6851;561;2368;855;3304;1416;5672
241430;201305;411;1276;395;1229;60;216;266;790;326;1006
241440;201305;6395;23262;6060;22656;1100;4301;4187;15855;5287;20156
241445;201305;995;3225;952;3161;173;493;696;2462;869;2955
241450;201305;3073;9068;2949;8851;494;1683;2088;6177;2582;7860
241460;201305;3296;10004;2963;9334;291;1108;2158;6687;2449;7795
241470;201305;1315;3846;1169;3663;119;466;910;2782;1029;3248
241475;201305;1190;3975;1096;3815;94;451;812;2761;906;3212
241480;201305;3146;10408;2906;10042;951;3382;1142;4302;2093;7684
241490;201305;602;1690;505;1528;56;234;350;988;406;1222
241500;201305;738;2408;724;2387;21;78;675;2227;696;2305
250010;201305;2581;8495;2319;8056;273;1160;1637;5550;1910;6710
250020;201305;1638;4870;1294;4228;125;534;910;2895;1035;3429
250030;201305;7480;22285;6775;21280;859;2926;5019;16057;5878;18983
250040;201305;4320;15055;4038;14517;784;2994;2611;9466;3395;12460
250050;201305;3503;11452;3252;11096;539;2051;2210;7573;2749;9624
250053;201305;1229;3868;1185;3809;177;648;840;2691;1017;3339
250057;201305;774;2517;754;2490;75;265;608;2041;683;2306
250060;201305;4564;15184;4440;14974;618;2461;3380;11143;3998;13604
250070;201305;4155;13111;3925;12703;490;2007;3000;9360;3490;11367
250073;201305;766;2351;704;2239;86;317;497;1586;583;1903
250077;201305;2201;6576;1862;6013;278;974;1112;3618;1390;4592
250080;201305;4580;13780;4426;13556;628;1995;3256;10079;3884;12074
250090;201305;2558;7903;2495;7812;155;627;2106;6430;2261;7057
250100;201305;3863;13373;3707;13089;438;1748;2852;10035;3290;11783
250110;201305;5591;17601;5358;17266;904;3212;3895;12501;4799;15713
250115;201305;551;1841;480;1675;60;277;292;954;352;1231
250120;201305;2122;6514;1845;5995;231;893;1285;4101;1516;4994
250130;201305;5434;17384;5148;16974;376;1382;4307;14323;4683;15705
250135;201305;1038;3271;956;3127;109;380;695;2321;804;2701
250140;201305;1955;6638;1808;6445;257;898;1350;4968;1607;5866
250150;201305;4951;17156;4638;16570;551;2233;3505;12510;4056;14743
250153;201305;1567;4144;1421;3934;133;452;1134;3114;1267;3566
250157;201305;1576;5626;1439;5320;360;1342;784;3006;1144;4348
250160;201305;3225;10387;3099;10191;221;827;2657;8729;2878;9556
250170;201305;1575;4690;1483;4536;329;1053;909;2829;1238;3882
250180;201305;15723;51134;15360;50429;3036;11178;10019;32201;13055;43379
250190;201305;4219;12663;3981;12267;708;2435;2526;7715;3234;10150
250200;201305;2144;6017;1757;5534;145;522;1501;4679;1646;5201
250205;201305;1001;3376;879;3161;94;436;615;2194;709;2630
250210;201305;1615;5398;1493;5222;206;902;1063;3611;1269;4513
250215;201305;1370;4817;1334;4750;217;889;847;2995;1064;3884
250220;201305;795;2311;678;2170;50;174;590;1875;640;2049
250230;201305;1661;4358;1367;3879;162;578;1048;2850;1210;3428
250240;201305;2551;8500;2286;8112;274;1031;1714;6185;1988;7216
250250;201305;4170;13267;3880;12856;511;1772;2947;9915;3458;11687
250260;201305;1882;5927;1680;5593;140;528;1283;4278;1423;4806
250270;201305;1212;3983;1141;3895;165;599;846;2910;1011;3509
250280;201305;3651;11240;3404;10851;687;2290;2173;7190;2860;9480
250290;201305;2108;5632;1747;5154;58;214;1530;4503;1588;4717
250300;201305;5317;15993;5028;15616;651;2568;3886;11644;4537;14212
250310;201305;1127;3705;1036;3557;166;668;744;2524;910;3192
250320;201305;7493;24298;7142;23520;1340;4940;4454;14287;5794;19227
250330;201305;2450;7912;2152;7485;280;1118;1614;5544;1894;6662
250340;201305;1104;3311;1066;3256;77;268;862;2656;939;2924
250350;201305;4487;12499;4141;12061;199;698;3604;10588;3803;11286
250355;201305;2073;6509;1901;6234;140;593;1499;4886;1639;5479
250360;201305;2010;6065;1870;5858;122;468;1459;4578;1581;5046
250370;201305;13257;38203;11733;36336;801;2509;10226;31989;11027;34498
250375;201305;1063;3434;1018;3354;78;324;838;2743;916;3067
250380;201305;1596;4614;1528;4531;98;355;1334;3928;1432;4283
250390;201305;1921;5252;1597;4700;216;715;1078;3160;1294;3875
250400;201305;56932;172088;54273;167978;14963;47682;29559;94378;44522;142060
250403;201305;1311;4818;1287;4783;192;832;980;3591;1172;4423
250407;201305;1045;3198;943;3021;107;355;731;2346;838;2701
250410;201305;654;2148;577;2012;72;311;430;1476;502;1787
250415;201305;1768;5767;1662;5553;110;462;1271;4175;1381;4637
250420;201305;1283;4111;1206;3983;102;424;1007;3253;1109;3677
250430;201305;6436;18349;6113;17880;512;1842;5061;14482;5573;16324
250435;201305;1599;4944;1441;4634;196;739;873;2868;1069;3607
250440;201305;4295;13463;4183;13288;317;1141;3518;11204;3835;12345
250450;201305;2038;5856;1829;5576;79;298;1637;4968;1716;5266
250460;201305;5716;18186;5371;17687;906;3156;3768;12575;4674;15731
250470;201305;1559;4366;1426;4174;130;483;1076;3086;1206;3569
250480;201305;3727;11536;3377;11013;189;760;2912;9428;3101;10188
250485;201305;584;1600;490;1429;28;121;384;1063;412;1184
250490;201305;4028;13522;3930;13366;591;2237;2946;9995;3537;12232
250500;201305;1862;5828;1730;5614;371;1256;1018;3347;1389;4603
250510;201305;4889;14051;4330;13275;362;1351;3548;10769;3910;12120
250520;201305;1826;5832;1742;5689;377;1441;1069;3398;1446;4839
250523;201305;1768;5739;1688;5634;210;758;1326;4473;1536;5231
250527;201305;1401;4443;1312;4316;65;302;1160;3752;1225;4054
250530;201305;670;2104;595;2006;55;215;481;1619;536;1834
250535;201305;1218;4084;1186;4017;99;415;951;3164;1050;3579
250540;201305;2422;7275;2280;7113;99;339;2077;6501;2176;6840
250550;201305;898;3050;832;2945;83;369;620;2140;703;2509
250560;201305;1680;5611;1657;5576;153;585;1389;4673;1542;5258
250570;201305;2489;8407;2284;8018;229;945;1734;6006;1963;6951
250580;201305;1046;3126;900;2881;132;527;604;1852;736;2379
250590;201305;1024;3192;924;3056;83;358;733;2371;816;2729
250600;201305;7453;23041;7085;22460;1207;3891;4979;16191;6186;20082
250610;201305;3233;10128;3070;9874;409;1425;2242;7252;2651;8677
250620;201305;864;2553;801;2429;138;460;536;1614;674;2074
250625;201305;2011;6886;1976;6835;90;294;1804;6303;1894;6597
250630;201305;9811;32665;9352;31803;2188;8167;5284;17848;7472;26015
250640;201305;3835;11421;3590;11129;263;1029;3097;9466;3360;10495
250650;201305;886;2697;838;2600;171;625;439;1409;610;2034
250660;201305;2162;5252;1659;4645;26;71;1587;4445;1613;4516
250670;201305;2532;8959;2424;8756;299;1272;1729;6238;2028;7510
250680;201305;4792;14186;4534;13806;316;1178;3805;11494;4121;12672
250690;201305;5965;17001;5782;16743;645;2171;4745;13497;5390;15668
250700;201305;5159;16129;4904;15726;656;2410;3623;11464;4279;13874
250710;201305;4382;14442;4088;14064;615;2255;2924;10254;3539;12509
250720;201305;2516;8219;2405;8018;243;932;1859;6212;2102;7144
250730;201305;3509;11391;3369;11164;471;1764;2509;8290;2980;10054
250740;201305;2007;6126;1776;5704;295;1037;1164;3689;1459;4726
250750;201305;97909;300457;93655;293755;18921;65334;61023;189313;79944;254647
250760;201305;2083;6552;1948;6321;290;1116;1308;4189;1598;5305
250770;201305;3671;12999;3509;12763;787;2985;2145;7954;2932;10939
250780;201305;1877;5748;1664;5346;173;704;1174;3667;1347;4371
250790;201305;2420;8044;2295;7857;607;2085;1412;4941;2019;7026
250800;201305;2651;7931;2356;7427;179;676;1772;5458;1951;6134
250810;201305;1319;4020;1158;3783;114;484;946;3015;1060;3499
250820;201305;1928;6227;1877;6146;113;430;1566;5200;1679;5630
250830;201305;5674;19546;5447;19100;867;3552;3754;12962;4621;16514
250840;201305;1029;3352;929;3147;134;520;584;1977;718;2497
250850;201305;2316;6949;2037;6488;247;965;1321;4354;1568;5319
250855;201305;990;3019;936;2929;60;208;791;2467;851;2675
250860;201305;2819;9797;2646;9460;694;2725;1165;4186;1859;6911
250870;201305;1167;3449;1021;3203;94;370;735;2236;829;2606
250880;201305;1266;3882;1247;3852;118;408;1015;3100;1133;3508
250890;201305;8844;29855;8320;29153;1673;6613;5473;19038;7146;25651
250900;201305;2998;10254;2694;9666;325;1241;1907;6951;2232;8192
250905;201305;2073;6532;1987;6415;320;1115;1474;4755;1794;5870
250910;201305;5099;15524;4782;15029;686;2222;3485;11081;4171;13303
250915;201305;1693;5133;1559;4935;131;423;1314;4200;1445;4623
250920;201305;3414;10030;3223;9763;408;1313;2409;7432;2817;8745
250930;201305;1867;6237;1800;6122;380;1487;1185;3941;1565;5428
250933;201305;1110;3882;1073;3818;196;739;705;2581;901;3320
250937;201305;853;2736;775;2574;127;504;467;1551;594;2055
250939;201305;1676;5433;1538;5206;299;1072;1024;3482;1323;4554
250940;201305;3881;11716;3616;11309;300;1089;2895;9051;3195;10140
250950;201305;1279;4124;1199;4025;88;304;1001;3409;1089;3713
250960;201305;1340;4271;1193;4078;75;300;1017;3495;1092;3795
250970;201305;8413;23873;7718;22984;1001;3022;5848;17688;6849;20710
250980;201305;2603;8118;2425;7824;324;1311;1687;5249;2011;6560
250990;201305;2044;7408;1943;7203;317;1332;1336;4909;1653;6241
251000;201305;2498;7259;2068;6648;139;541;1653;5287;1792;5828
251010;201305;2773;8187;2546;7877;192;697;2075;6441;2267;7138
251020;201305;1643;5285;1544;5168;171;632;1257;4234;1428;4866
251030;201305;1292;3718;1177;3524;136;480;760;2274;896;2754
251040;201305;1920;6274;1742;5999;202;944;1257;4158;1459;5102
251050;201305;1112;3375;977;3128;181;636;545;1817;726;2453
251060;201305;975;2535;807;2325;110;408;587;1604;697;2012
251065;201305;569;1735;500;1627;74;284;306;952;380;1236
251070;201305;562;1683;536;1642;44;184;424;1231;468;1415
251080;201305;20894;59209;19856;57538;5233;16092;11391;33360;16624;49452
251090;201305;2971;9573;2697;9076;328;1273;1922;6387;2250;7660
251100;201305;951;3196;843;2993;125;508;547;1886;672;2394
251110;201305;2069;6107;1914;5887;236;816;1399;4314;1635;5130
251120;201305;5862;20111;5711;19849;823;3391;4433;15072;5256;18463
251130;201305;3816;10100;3471;9702;69;252;3316;9209;3385;9461
251140;201305;4288;13499;4028;13099;289;1172;3174;10269;3463;11441
251150;201305;2828;9307;2617;9021;326;1308;1976;6870;2302;8178
251160;201305;1844;6177;1775;6085;102;398;1550;5329;1652;5727
251170;201305;1410;4530;1380;4498;97;349;1215;3963;1312;4312
251180;201305;2884;8815;2661;8534;609;2047;1631;5367;2240;7414
251190;201305;4124;12395;4010;12248;305;1030;3488;10669;3793;11699
251200;201305;4141;12805;3950;12548;277;1000;3385;10756;3662;11756
251203;201305;1298;4219;1180;3971;127;535;712;2487;839;3022
251207;201305;1213;3899;1055;3584;100;417;747;2495;847;2912
251210;201305;7456;22688;6921;22040;915;2909;5453;17695;6368;20604
251220;201305;1257;3512;1134;3321;186;609;701;2099;887;2708
251230;201305;5048;15746;4479;15065;476;1794;3732;12493;4208;14287
251240;201305;3032;10204;2960;10085;329;1388;2312;7714;2641;9102
251250;201305;9920;30967;9361;30062;1722;6010;6404;20417;8126;26427
251260;201305;528;1670;481;1606;40;150;365;1224;405;1374
251270;201305;4001;12605;3784;12321;185;724;3426;11122;3611;11846
251272;201305;1329;4179;1243;4053;121;421;970;3219;1091;3640
251274;201305;942;3087;900;3001;134;566;498;1693;632;2259
251275;201305;1350;3927;1279;3812;158;589;955;2765;1113;3354
251276;201305;1445;4410;1373;4264;256;847;786;2544;1042;3391
251278;201305;579;1910;510;1746;88;347;280;1005;368;1352
251280;201305;2241;7305;2171;7180;315;1164;1567;5190;1882;6354
251290;201305;5864;17241;5578;16869;859;3111;4007;11732;4866;14843
251300;201305;773;2671;725;2596;71;339;512;1774;583;2113
251310;201305;3132;9458;2889;9096;242;904;2322;7233;2564;8137
251315;201305;1572;5885;1538;5811;328;1321;966;3711;1294;5032
251320;201305;2081;5983;1765;5474;151;570;1292;4030;1443;4600
251330;201305;2012;5325;1682;4895;144;612;1375;3800;1519;4412
251335;201305;942;3322;922;3283;104;431;742;2610;846;3041
251340;201305;3919;11111;3360;10278;393;1505;2373;7091;2766;8596
251350;201305;1615;5075;1465;4854;269;986;942;3143;1211;4129
251360;201305;1814;6013;1755;5935;126;498;1484;5035;1610;5533
251365;201305;903;2692;734;2331;77;313;480;1473;557;1786
251370;201305;20482;72982;20216;72463;4356;17099;13578;48142;17934;65241
251380;201305;1259;4050;1150;3869;139;566;841;2754;980;3320
251385;201305;849;2442;786;2336;90;321;544;1573;634;1894
251390;201305;5602;20317;5347;19941;1051;4283;3612;13367;4663;17650
251392;201305;1003;3055;934;2934;137;474;628;1996;765;2470
251394;201305;613;1925;526;1756;49;208;371;1224;420;1432
251396;201305;865;2526;813;2444;64;213;653;1948;717;2161
251398;201305;1119;3296;938;2958;106;405;640;1991;746;2396
251400;201305;1342;3952;1254;3838;174;681;897;2662;1071;3343
251410;201305;1573;4267;1444;4059;190;586;966;2797;1156;3383
251420;201305;2211;6577;1918;6249;176;694;1565;5040;1741;5734
251430;201305;1661;6081;1517;5855;134;607;1232;4735;1366;5342
251440;201305;1445;4510;1264;4180;180;688;892;2912;1072;3600
251445;201305;1496;4842;1429;4741;143;571;1160;3794;1303;4365
251450;201305;4751;15153;4300;14591;160;627;3924;13364;4084;13991
251455;201305;1191;3749;1034;3495;97;430;774;2569;871;2999
251460;201305;871;2736;850;2694;163;541;621;1989;784;2530
251465;201305;503;1607;461;1524;52;209;305;980;357;1189
251470;201305;1201;3595;1011;3250;154;593;618;1973;772;2566
251480;201305;1099;3080;1002;2917;70;268;796;2269;866;2537
251490;201305;2044;6181;1803;5864;347;1295;1134;3614;1481;4909
251500;201305;1605;5709;1558;5630;230;975;1157;4112;1387;5087
251510;201305;2454;8525;2338;8268;503;1939;1415;5069;1918;7008
251520;201305;1076;3030;994;2901;136;418;624;1849;760;2267
251530;201305;10796;33874;10537;33474;1055;4039;8638;26920;9693;30959
251540;201305;2741;9307;2588;8966;314;1323;1862;6397;2176;7720
251550;201305;3925;10060;3367;9350;217;779;2808;7636;3025;8415
251560;201305;909;2775;832;2659;178;685;463;1391;641;2076
251570;201305;1021;3142;934;2990;133;504;600;1972;733;2476
251580;201305;2170;6073;2024;5877;192;548;1679;4924;1871;5472
251590;201305;1678;5623;1646;5586;113;414;1443;4941;1556;5355
251593;201305;968;3171;924;3096;136;521;620;2027;756;2548
251597;201305;1958;6124;1895;6027;240;904;1466;4570;1706;5474
251600;201305;6962;21615;6668;21130;1114;3607;4637;15181;5751;18788
251610;201305;3522;10813;3245;10442;399;1390;2417;7853;2816;9243
251615;201305;1199;3570;1060;3325;87;257;788;2608;875;2865
251620;201305;16483;48839;14975;46816;2438;8071;10631;33592;13069;41663
251630;201305;5275;13641;4645;12879;406;1237;3714;10370;4120;11607
251640;201305;2638;7843;2165;6986;285;1079;1453;4641;1738;5720
251650;201305;4292;12440;3878;11910;351;1246;3134;9719;3485;10965
251660;201305;3512;11933;3236;11503;276;1302;2609;9052;2885;10354
251670;201305;3703;11163;3350;10622;274;986;2673;8439;2947;9425
251675;201305;737;2549;708;2499;134;556;453;1555;587;2111
251680;201305;2814;7953;2300;7180;150;639;1874;5723;2024;6362
251690;201305;3267;10724;3065;10354;479;1726;2034;6930;2513;8656
251700;201305;2048;7011;1965;6894;249;962;1529;5349;1778;6311
251710;201305;867;2431;684;2084;95;364;395;1121;490;1485
251720;201305;1321;4200;1248;4089;131;524;951;3087;1082;3611
251740;201305;727;2081;590;1832;110;385;330;1033;440;1418
260005;201305;23869;60099;21484;57014;4434;12080;13810;37025;18244;49105
260010;201305;9195;25773;7607;23814;693;2443;6132;19132;6825;21575
260020;201305;5609;17235;5062;16392;672;2035;3681;12558;4353;14593
260030;201305;5412;16641;5053;16154;592;2011;3934;12621;4526;14632
260040;201305;9128;23400;8348;22536;516;1131;7376;20478;7892;21609
260050;201305;10434;34775;9893;34155;678;2536;8660;30121;9338;32657
260060;201305;4006;11342;3762;10982;328;1020;3073;9092;3401;10112
260070;201305;8941;28167;8631;27722;2326;8014;5067;16372;7393;24386
260080;201305;5118;15487;4616;14719;557;2124;3256;10230;3813;12354
260090;201305;5107;14009;4863;13686;761;1968;3744;10914;4505;12882
260100;201305;3410;9289;3147;8940;269;986;2495;7097;2764;8083
260105;201305;4120;13012;4017;12834;763;2629;2743;8742;3506;11371
260110;201305;20689;63927;19398;62354;1651;5271;16442;53549;18093;58820
260120;201305;10932;34785;10667;34309;3070;10120;5594;18677;8664;28797
260130;201305;3011;8850;2886;8639;386;1149;2154;6566;2540;7715
260140;201305;11424;33030;10551;31836;1368;4637;7998;24230;9366;28867
260150;201305;2821;8997;2564;8595;189;743;2034;6917;2223;7660
260160;201305;5870;18038;5383;17474;511;1754;4433;14698;4944;16452
260170;201305;16766;47950;16142;47105;1457;4044;13372;39713;14829;43757
260180;201305;3310;10664;3068;10281;215;873;2570;8565;2785;9438
260190;201305;15268;38038;14599;37175;1243;3401;12192;31040;13435;34441
260200;201305;10564;32519;9403;30757;1271;4347;6656;22415;7927;26762
260210;201305;11142;35437;10404;34375;837;3117;8581;28655;9418;31772
260220;201305;8903;28802;8723;28538;750;3069;7445;23954;8195;27023
260230;201305;9462;28646;9139;28205;720;2349;7605;23808;8325;26157
260240;201305;2780;9112;2523;8714;387;1443;1712;5937;2099;7380
260250;201305;2718;7475;2512;7218;186;505;2118;6192;2304;6697
260260;201305;11114;33452;10939;33229;944;3114;9152;28407;10096;31521
260270;201305;3494;11133;3320;10880;438;1720;2560;8248;2998;9968
260280;201305;12063;41900;11223;40562;874;3582;9243;33707;10117;37289
260290;201305;32806;101531;31907;100100;5909;21144;22005;67516;27914;88660
260300;201305;8198;25695;7413;24592;805;2971;5697;19080;6502;22051
260310;201305;5045;15575;4758;15118;1431;4288;2456;8402;3887;12690
260320;201305;6440;22724;6062;22184;550;2115;4883;18159;5433;20274
260330;201305;3058;9787;2813;9359;322;1247;1876;6507;2198;7754
260340;201305;1818;5592;1743;5494;110;410;1533;4801;1643;5211
260345;201305;24947;84721;24140;83120;7753;28935;11220;37587;18973;66522
260350;201305;4159;12728;4004;12489;625;2134;2762;8673;3387;10807
260360;201305;2259;7364;2200;7267;581;2024;1263;4309;1844;6333
260370;201305;5935;18783;5518;18047;847;2808;3861;12971;4708;15779
260380;201305;4777;16245;4499;15884;412;1299;3796;13731;4208;15030
260390;201305;4715;15128;4139;14234;505;1980;3051;10372;3556;12352
260392;201305;2884;10347;2765;10170;197;768;2390;8871;2587;9639
260400;201305;13001;39888;12626;39299;2400;8406;8772;26776;11172;35182
260410;201305;60103;181780;57674;177792;18105;56044;29416;94263;47521;150307
260415;201305;3923;13256;3544;12554;570;2340;2266;8037;2836;10377
260420;201305;11000;27066;10131;26136;941;2729;8176;21095;9117;23824
260430;201305;2657;9069;2464;8770;275;1186;1913;6685;2188;7871
260440;201305;3348;10579;3154;10207;546;2021;1972;6291;2518;8312
260450;201305;4750;15308;4524;14915;550;1976;3402;11305;3952;13281
260460;201305;5769;18335;5534;17992;862;3197;3940;12611;4802;15808
260470;201305;4823;14578;4567;14223;415;1450;3665;11587;4080;13037
260480;201305;3694;11131;3433;10751;665;2240;2337;7262;3002;9502
260490;201305;6015;16019;5329;14938;761;2507;3508;9843;4269;12350
260500;201305;6585;18600;6197;18053;652;2043;4759;14135;5411;16178
260510;201305;9656;27586;8941;26585;1083;3466;6580;20328;7663;23794
260515;201305;4710;15173;3934;13596;581;2200;2339;8284;2920;10484
260520;201305;14816;41711;14550;41342;2266;6084;11246;32609;13512;38693
260530;201305;10064;30316;8974;28880;538;1647;7828;25675;8366;27322
260540;201305;5588;14918;5370;14670;658;1575;4291;12102;4949;13677
260545;201305;40;156;28;115;4;19;6;23;10;42
260550;201305;2708;9389;2474;8987;724;2901;1183;4254;1907;7155
260560;201305;6528;17277;5961;16488;364;979;5227;14541;5591;15520
260570;201305;5790;21613;5536;21142;1106;4565;3676;14196;4782;18761
260580;201305;3859;10853;3691;10602;328;1082;3071;8659;3399;9741
260590;201305;5878;15764;5719;15561;475;1225;4885;13585;5360;14810
260600;201305;23583;77013;22611;75301;5432;18808;13046;44644;18478;63452
260610;201305;6906;20910;6624;20538;1296;4217;4642;14521;5938;18738
260620;201305;16719;53520;16207;52671;2939;10965;11104;35129;14043;46094
260630;201305;2249;6948;1977;6519;253;1007;1445;4715;1698;5722
260640;201305;16772;47313;16125;46361;1950;5948;12532;36115;14482;42063
260650;201305;5558;18073;5376;17777;860;2859;3533;12518;4393;15377
260660;201305;7664;23207;6975;22285;696;2361;5561;18040;6257;20401
260670;201305;2328;6878;2007;6440;308;1112;1335;4307;1643;5419
260680;201305;22675;62183;21653;60585;4737;14113;13143;36587;17880;50700
260690;201305;3399;9745;2991;9102;318;1160;2272;6822;2590;7982
260700;201305;4921;15623;4871;15570;109;255;4666;15131;4775;15386
260710;201305;1293;4088;1171;3906;155;619;862;2810;1017;3429
260720;201305;17242;57371;16432;55860;4782;16773;8704;30265;13486;47038
260730;201305;7269;24489;6592;23503;902;3353;4923;17831;5825;21184
260740;201305;1328;4123;1171;3838;200;733;707;2338;907;3071
260750;201305;6467;22030;6334;21812;555;1899;5293;18574;5848;20473
260760;201305;4437;12961;4208;12644;579;1864;3083;9285;3662;11149
260765;201305;7444;28334;7229;28000;1737;7113;4401;17468;6138;24581
260770;201305;4191;11199;3853;10745;252;919;3103;8469;3355;9388
260775;201305;5254;15705;5044;15379;567;2049;3828;11454;4395;13503
260780;201305;3836;13188;3717;12985;829;3218;2280;7902;3109;11120
260790;201305;115402;304850;111636;299475;26879;75805;67996;183082;94875;258887
260795;201305;2933;9883;2794;9667;458;1733;1935;6786;2393;8519
260800;201305;4483;12749;4209;12370;274;1087;3573;10238;3847;11325
260805;201305;3965;12043;3642;11533;607;1987;2465;7917;3072;9904
260810;201305;7335;21848;7149;21585;518;1897;6180;18456;6698;20353
260820;201305;4486;13628;4316;13379;1229;3911;2476;7770;3705;11681
260825;201305;2980;9816;2842;9611;275;923;2351;8067;2626;8990
260830;201305;3572;11963;3361;11598;889;2904;1963;7164;2852;10068
260840;201305;4024;12179;3792;11837;241;915;3319;10322;3560;11237
260845;201305;4031;12343;3761;11797;617;2098;2580;8084;3197;10182
260850;201305;4772;17171;4409;16379;1202;4893;2148;7981;3350;12874
260860;201305;2890;9873;2717;9597;350;1248;2014;7284;2364;8532
260870;201305;4103;11742;3786;11351;544;1487;2822;8768;3366;10255
260875;201305;7164;19318;6635;18514;768;2173;4809;13836;5577;16009
260880;201305;8221;27080;7861;26543;1106;3759;5989;20531;7095;24290
260890;201305;14570;42611;14044;41844;1661;5653;10600;31547;12261;37200
260900;201305;5922;18767;5193;17572;1094;3831;3092;10732;4186;14563
260910;201305;2866;9207;2642;8888;303;1152;2064;6901;2367;8053
260915;201305;4356;14832;4256;14690;112;337;3970;13938;4082;14275
260920;201305;3276;10565;3140;10361;600;2167;2100;7041;2700;9208
260930;201305;4009;13174;3634;12633;531;1932;2606;9162;3137;11094
260940;201305;13312;39669;12303;37865;2562;9247;6737;20238;9299;29485
260950;201305;6094;20358;5892;19971;1080;4532;3899;12439;4979;16971
260960;201305;65501;186605;62454;181872;13554;42185;37657;110575;51211;152760
260970;201305;5213;17548;4890;17022;664;2684;3548;12275;4212;14959
260980;201305;3909;12677;3760;12473;266;976;3145;10621;3411;11597
260990;201305;16490;54931;15339;53299;1939;6352;11468;41920;13407;48272
261000;201305;13526;41767;12222;39596;2956;10367;6805;22224;9761;32591
261010;201305;2696;7774;2545;7565;253;600;2109;6581;2362;7181
261020;201305;5981;18681;5675;18199;391;1661;4748;14843;5139;16504
261030;201305;3114;10964;3027;10828;340;1356;2400;8533;2740;9889
261040;201305;5124;17231;4479;16216;662;2680;3123;11297;3785;13977
261050;201305;8430;24200;7989;23551;704;2171;6469;19088;7173;21259
261060;201305;10589;34215;10306;33751;2138;7577;6853;22224;8991;29801
261070;201305;45882;123587;42318;118716;10284;30421;24278;69096;34562;99517
261080;201305;5507;17547;5264;17149;446;1421;4379;14539;4825;15960
261090;201305;15474;45036;14657;43937;1391;4466;12026;36232;13417;40698
261100;201305;7078;23399;6710;22858;535;2224;5541;18769;6076;20993
261110;201305;63573;186448;58871;179887;14047;43580;34583;111643;48630;155223
261120;201305;3221;9410;3078;9216;110;358;2816;8470;2926;8828
261130;201305;6679;17966;6446;17717;279;791;5894;16195;6173;16986
261140;201305;3105;9016;2954;8795;636;2083;1870;5509;2506;7592
261150;201305;5370;16895;4895;16249;501;1893;3856;12874;4357;14767
261153;201305;1924;5647;1658;5283;110;419;1404;4510;1514;4929
261160;201305;220298;586535;212004;575652;42405;117226;138200;385907;180605;503133
261170;201305;5770;16656;5433;16153;699;2191;4246;12664;4945;14855
261180;201305;8880;26956;8743;26782;1176;3497;6944;21762;8120;25259
261190;201305;5288;17173;5082;16891;816;3564;3636;11468;4452;15032
261200;201305;3769;10103;3630;9919;487;1302;2763;7711;3250;9013
261210;201305;1841;5206;1768;5103;149;419;1501;4412;1650;4831
261220;201305;12018;40718;10869;38183;2280;8656;5927;20789;8207;29445
261230;201305;4221;12960;3959;12657;192;620;3562;11506;3754;12126
261240;201305;4765;14388;4540;13967;821;2481;3163;9940;3984;12421
261245;201305;3778;12402;3317;11629;322;1350;2444;8697;2766;10047
261247;201305;3399;10977;3037;10293;484;1703;2020;6963;2504;8666
261250;201305;18564;51112;18128;50521;2083;6097;15063;41931;17146;48028
261255;201305;4233;13459;3841;12821;418;1586;2859;9668;3277;11254
261260;201305;11556;34791;10757;33864;637;1912;9545;30492;10182;32404
261270;201305;3637;10764;3425;10426;504;1646;2397;7327;2901;8973
261280;201305;2671;8514;2438;8159;284;1097;1792;5952;2076;7049
261290;201305;2863;8440;2602;8104;188;644;2189;6902;2377;7546
261300;201305;9818;34613;9077;33290;1503;6004;6326;23401;7829;29405
261310;201305;8183;25464;7878;24946;1739;5756;4956;15804;6695;21560
261320;201305;5699;18212;5439;17722;768;2487;3905;13075;4673;15562
261330;201305;5502;16705;5400;16574;403;1391;4602;14153;5005;15544
261340;201305;4501;14999;4307;14690;754;2937;2817;9626;3571;12563
261350;201305;7738;26984;7382;26348;713;3069;5794;20469;6507;23538
261360;201305;9164;24417;8492;23483;1289;3761;5838;16463;7127;20224
261370;201305;20111;61665;19263;60451;2827;9577;14292;45056;17119;54633
261380;201305;4077;14369;3835;13978;645;2376;2634;9905;3279;12281
261390;201305;16429;52320;15239;50241;2801;10209;9490;31063;12291;41272
261400;201305;4763;17074;4392;16356;675;2796;2979;11181;3654;13977
261410;201305;7884;24610;7624;24196;815;2644;5999;19496;6814;22140
261420;201305;7481;25874;7292;25589;1894;7273;4263;15177;6157;22450
261430;201305;3483;11023;2978;10356;429;1538;2145;7640;2574;9178
261440;201305;1617;5000;1535;4877;128;505;1241;3906;1369;4411
261450;201305;13601;41473;13360;41161;1162;3786;11604;35802;12766;39588
261460;201305;8281;24207;7769;23491;830;2412;5709;18609;6539;21021
261470;201305;3848;10661;3539;10292;279;936;2973;8594;3252;9530
261480;201305;3229;12272;3065;11981;362;1634;2388;9178;2750;10812
261485;201305;4748;15295;4537;14934;1036;3664;2648;8806;3684;12470
261500;201305;5641;16142;5144;15469;789;2190;3856;12118;4645;14308
261510;201305;2020;6842;1950;6747;111;329;1725;6104;1836;6433
261520;201305;2500;8409;2287;8090;233;946;1694;5987;1927;6933
261530;201305;12271;40545;11059;38190;2568;9864;5490;18817;8058;28681
261540;201305;6998;22854;6858;22621;2123;6547;4138;14458;6261;21005
261550;201305;3219;10379;3120;10224;524;2134;2299;7186;2823;9320
261560;201305;6168;20997;5813;20557;1219;3927;4149;15427;5368;19354
261570;201305;3555;11416;3310;11017;484;1670;2356;7998;2840;9668
261580;201305;5605;18637;5074;17755;452;1797;4033;14355;4485;16152
261590;201305;2742;7900;2430;7456;247;829;1794;5586;2041;6415
261600;201305;4941;14347;4273;13359;555;1837;3091;9800;3646;11637
261610;201305;2172;6904;1976;6627;161;669;1630;5344;1791;6013
261618;201305;2464;7282;2351;7121;256;923;1838;5446;2094;6369
261620;201305;4433;13936;4231;13619;494;1729;3072;10074;3566;11803
261630;201305;7938;24001;7221;22771;1524;5516;4127;12736;5651;18252
261640;201305;32294;85532;30370;83349;1839;5253;26436;73698;28275;78951
261650;201305;3533;12143;3439;12000;444;1755;2726;9510;3170;11265
270010;201305;4415;17186;4084;16484;513;2432;2921;11757;3434;14189
270020;201305;3778;11939;3566;11585;551;2096;2568;8159;3119;10255
270030;201305;42288;131870;40827;129717;11267;36661;23678;77260;34945;113921
270040;201305;10317;32335;10031;32021;1119;3013;8405;27738;9524;30751
270050;201305;3723;11257;3525;10996;400;1557;2673;8150;3073;9707
270060;201305;1466;5189;1414;5112;363;1448;838;3024;1201;4472
270070;201305;3978;12654;3769;12355;137;613;3385;11013;3522;11626
270080;201305;1255;4100;1144;3950;280;1078;672;2296;952;3374
270090;201305;1988;6455;1945;6401;60;226;1825;6010;1885;6236
270100;201305;6288;20249;6071;19964;1181;4252;4292;14014;5473;18266
270110;201305;3352;9777;3109;9479;631;2008;1940;6336;2571;8344
270120;201305;2998;8917;2718;8522;172;649;2292;7195;2464;7844
270130;201305;4916;15689;4698;15430;688;2275;3543;11927;4231;14202
270135;201305;1678;5011;1604;4923;77;191;1465;4584;1542;4775
270140;201305;8696;24196;7958;23235;1046;4202;6099;16809;7145;21011
270150;201305;2499;8945;2436;8856;282;1181;1981;7125;2263;8306
270160;201305;4657;16667;4391;16297;328;1137;3782;14270;4110;15407
270170;201305;3946;13416;3650;12956;808;3280;2092;7367;2900;10647
270180;201305;2117;7440;1915;7185;209;906;1506;5665;1715;6571
270190;201305;1818;6227;1739;6092;212;777;1313;4680;1525;5457
270200;201305;2594;8996;2502;8848;241;1110;2029;6990;2270;8100
270210;201305;3895;14026;3806;13902;527;2126;3003;11007;3530;13133
270220;201305;1663;5345;1576;5171;307;1171;868;2907;1175;4078
270230;201305;10814;36522;9699;34815;1484;6079;6913;24713;8397;30792
270235;201305;6376;21453;6100;20994;366;1654;5239;17902;5605;19556
270240;201305;9577;29321;8669;28077;1608;5490;5718;18639;7326;24129
270250;201305;3358;9034;3124;8779;158;467;2840;7982;2998;8449
270255;201305;5039;15868;4256;14506;470;2004;3019;10139;3489;12143
270260;201305;5980;19916;5827;19635;947;3689;4084;13812;5031;17501
270270;201305;1222;3639;1150;3526;192;644;830;2520;1022;3164
270280;201305;3630;11223;3473;10993;570;2074;2500;7854;3070;9928
270290;201305;8223;29744;7903;29185;760;3107;6377;23629;7137;26736
270300;201305;3191;11207;3053;11038;191;870;2713;9748;2904;10618
270310;201305;6913;22341;6362;21400;460;2080;5103;16765;5563;18845
270320;201305;6070;20678;5888;20342;1688;6451;2830;9991;4518;16442
270330;201305;4625;15771;4415;15485;407;1518;3658;12978;4065;14496
270340;201305;1727;5524;1591;5361;233;823;1175;4045;1408;4868
270350;201305;2070;6027;1934;5850;341;1102;1241;3978;1582;5080
270360;201305;1957;6309;1936;6285;161;538;1695;5558;1856;6096
270370;201305;1689;5673;1555;5430;199;801;1081;3856;1280;4657
270375;201305;2885;9246;2759;9049;521;2096;1838;5732;2359;7828
270380;201305;5975;18539;5757;18247;622;2076;4486;14512;5108;16588
270390;201305;1363;3953;1271;3833;186;668;890;2590;1076;3258
270400;201305;5966;18887;5594;18361;522;2024;4393;14325;4915;16349
270410;201305;4730;15161;4559;14833;627;2281;3424;11106;4051;13387
270420;201305;5094;17327;4970;17147;313;1426;4331;14756;4644;16182
270430;201305;137775;406549;133220;400250;35157;108111;78716;242466;113873;350577
270440;201305;4818;15409;4573;15023;398;1493;3706;12225;4104;13718
270450;201305;6171;20189;6046;20027;719;2729;4756;15783;5475;18512
270460;201305;3337;9709;3034;9277;262;1061;2414;7185;2676;8246
270470;201305;10494;34783;10119;34111;1320;4226;7640;26792;8960;31018
270480;201305;3046;10013;2876;9726;370;1535;2031;6672;2401;8207
270490;201305;967;3167;920;3097;117;462;691;2279;808;2741
270500;201305;5409;19306;5252;19080;453;1615;4410;16463;4863;18078
270510;201305;5843;18769;5402;18150;1030;4391;3817;12150;4847;16541
270520;201305;3644;12333;3461;12014;959;3570;1860;6557;2819;10127
270530;201305;1526;4627;1358;4406;242;754;904;3086;1146;3840
270540;201305;1932;6989;1788;6759;214;1005;1387;5147;1601;6152
270550;201305;6839;21805;6147;20849;1113;3938;4062;14216;5175;18154
270560;201305;2857;9491;2782;9389;522;2038;1953;6448;2475;8486
270570;201305;4175;13957;3866;13460;515;2179;2629;9067;3144;11246
270580;201305;1949;6798;1884;6687;326;1206;1364;4914;1690;6120
270590;201305;1265;4600;1195;4471;114;542;963;3566;1077;4108
270600;201305;2790;9591;2572;9277;232;1146;2022;7075;2254;8221
270610;201305;3152;10228;2980;9968;362;1292;2301;7678;2663;8970
270620;201305;1409;4908;1281;4717;165;782;959;3427;1124;4209
270630;201305;17655;50306;17010;49437;2145;6039;13558;40104;15703;46143
270640;201305;5674;18072;5220;17550;422;1792;4383;14503;4805;16295
270642;201305;2437;8492;2300;8280;406;1631;1526;5529;1932;7160
270644;201305;2253;7021;2130;6883;384;1154;1612;5395;1996;6549
270650;201305;3822;12763;3710;12603;952;3674;2167;7299;3119;10973
270660;201305;2487;6705;2029;5991;217;768;1434;4180;1651;4948
270670;201305;13457;40405;12355;38916;1586;5689;9318;29313;10904;35002
270680;201305;4040;12650;3939;12529;254;750;3519;11319;3773;12069
270690;201305;8052;24218;7750;23842;2392;6985;4244;14183;6636;21168
270700;201305;786;2564;752;2507;146;566;470;1549;616;2115
270710;201305;5305;18519;5133;18291;521;1835;4266;15470;4787;17305
270720;201305;3197;11372;3002;11035;296;1352;2388;8686;2684;10038
270730;201305;6287;20398;5986;19998;1254;4517;4028;13385;5282;17902
270740;201305;2347;7124;2220;6927;389;1391;1460;4502;1849;5893
270750;201305;4726;15670;4470;15291;559;2160;3376;11509;3935;13669
270760;201305;3205;10107;3027;9851;384;1340;2303;7517;2687;8857
270770;201305;16817;46808;14705;44242;2824;9229;9616;29252;12440;38481
270780;201305;1893;6123;1775;5937;155;546;1437;4864;1592;5410
270790;201305;1571;5083;1450;4881;384;1384;722;2477;1106;3861
270800;201305;10752;33487;10228;32789;1010;3661;8279;26465;9289;30126
270810;201305;3206;10313;2737;9452;416;1650;1720;5965;2136;7615
270820;201305;1864;6503;1733;6269;248;1085;1237;4399;1485;5484
270830;201305;4940;16669;4620;16228;1473;5843;2444;8453;3917;14296
270840;201305;7027;25457;6507;24780;539;2467;5363;20373;5902;22840
270850;201305;7326;25065;7204;24907;1555;6560;5049;16598;6604;23158
270860;201305;10821;34295;10268;33467;1873;7024;7125;22718;8998;29742
270870;201305;2189;6494;1856;5862;283;997;1153;3640;1436;4637
270880;201305;7909;26378;7564;25873;655;2668;6306;21387;6961;24055
270890;201305;2526;7989;2380;7761;406;1568;1630;5166;2036;6734
270895;201305;2940;11201;2806;11022;276;1054;2346;9422;2622;10476
270900;201305;1865;5279;1570;4861;124;474;1210;3649;1334;4123
270910;201305;3216;11750;3177;11675;350;1551;2632;9477;2982;11028
270915;201305;9623;33824;8926;32539;2164;8796;4696;17132;6860;25928
270920;201305;5724;19575;5383;19070;449;1978;4446;15655;4895;17633
270930;201305;16491;46366;13880;43028;3013;10009;7952;25096;10965;35105
270940;201305;5699;19870;5550;19690;858;3136;4200;15157;5058;18293
280010;201305;704;2109;629;1993;71;285;410;1270;481;1555
280020;201305;4705;14842;4322;14157;859;2995;2718;8937;3577;11932
280030;201305;67176;184781;61495;176466;15743;47645;33087;96524;48830;144169
280040;201305;3025;9910;2779;9587;364;1293;2084;7423;2448;8716
280050;201305;4005;13162;3767;12818;1086;3743;2141;7584;3227;11327
280060;201305;4107;14157;3989;13963;978;3747;2368;8306;3346;12053
280067;201305;7256;21412;6248;20025;642;2377;4805;15331;5447;17708
280070;201305;1765;6417;1703;6323;319;1257;1147;4311;1466;5568
280100;201305;3886;12677;3584;12139;873;3048;1965;6828;2838;9876
280110;201305;1298;4178;1217;4039;121;501;934;3058;1055;3559
280120;201305;7363;24449;6929;23729;1494;4828;4552;16599;6046;21427
280130;201305;7552;22448;7180;21920;1182;4194;4961;14907;6143;19101
280140;201305;5279;15314;4847;14756;404;1241;4065;12547;4469;13788
280150;201305;3212;10352;2969;9868;489;1978;1849;5873;2338;7851
280160;201305;1500;4390;1381;4201;192;659;978;2977;1170;3636
280170;201305;4331;13853;4001;13444;551;1905;3022;10437;3573;12342
280190;201305;1074;3234;984;3087;122;476;683;2069;805;2545
280200;201305;967;3228;937;3189;172;723;662;2172;834;2895
280210;201305;11354;38670;10965;38023;2517;9262;6822;24025;9339;33287
280220;201305;1492;4690;1442;4625;97;366;1271;4058;1368;4424
280230;201305;3766;11224;3425;10663;747;2482;2000;6378;2747;8860
280240;201305;3340;10364;3118;10023;258;831;2508;8189;2766;9020
280250;201305;708;1971;667;1910;54;181;542;1512;596;1693
280260;201305;1883;5322;1734;5131;132;405;1470;4356;1602;4761
280270;201305;2107;6803;1866;6393;139;575;1470;4930;1609;5505
280280;201305;3945;13436;3747;13096;797;2466;2273;8738;3070;11204
280290;201305;15233;51587;14483;50296;2620;9938;10220;35492;12840;45430
280300;201305;9513;29855;8976;29246;640;2289;7866;25656;8506;27945
280310;201305;1383;4027;1250;3824;118;463;918;2726;1036;3189
280320;201305;7057;25229;6761;24674;1210;4985;4407;16088;5617;21073
280330;201305;4239;12783;4037;12527;571;1920;3069;9584;3640;11504
280340;201305;3500;11282;3419;11167;304;1098;2796;9298;3100;10396
280350;201305;20198;62772;19357;61445;3095;10207;13636;44263;16731;54470
280360;201305;5670;18383;5377;17931;1198;4539;3304;10844;4502;15383
280370;201305;1837;5456;1716;5252;220;809;1256;3727;1476;4536
280380;201305;868;2910;816;2828;139;574;589;1963;728;2537
280390;201305;3092;9477;2829;9016;693;2054;1743;5721;2436;7775
280400;201305;4207;12431;3884;12004;791;2379;2553;8224;3344;10603
280410;201305;2255;7640;2095;7373;360;1464;1282;4404;1642;5868
280420;201305;3833;11695;3624;11393;266;875;3112;9885;3378;10760
280430;201305;1894;5662;1802;5543;280;969;1285;3986;1565;4955
280440;201305;4740;14828;4508;14523;403;1476;3808;12215;4211;13691
280445;201305;2407;7083;2266;6848;131;528;1884;5590;2015;6118
280450;201305;8427;24045;7883;23417;796;2062;6612;20279;7408;22341
280460;201305;6418;18635;5874;17895;1325;4171;3763;11761;5088;15932
280470;201305;1681;5328;1558;5141;180;673;1168;3822;1348;4495
280480;201305;29208;91687;28384;90508;4734;17981;19770;61192;24504;79173
280490;201305;3611;11397;3419;11058;385;1479;2657;8515;3042;9994
280500;201305;817;2296;789;2262;45;159;678;1909;723;2068
280510;201305;2614;7923;2267;7444;314;1188;1676;5514;1990;6702
280520;201305;1572;4824;1449;4659;197;697;1020;3355;1217;4052
280530;201305;1921;6325;1842;6214;230;876;1442;4889;1672;5765
280540;201305;8415;24362;8037;23845;376;1347;7185;21179;7561;22526
280550;201305;6715;19239;6250;18507;556;2028;4760;13958;5316;15986
280560;201305;7569;23135;7222;22545;557;1978;5904;18381;6461;20359
280570;201305;6441;18889;6042;18380;845;3065;4485;13443;5330;16508
280580;201305;5528;17183;4878;16123;687;2422;3485;11676;4172;14098
280590;201305;2277;7141;2123;6965;262;1057;1612;5276;1874;6333
280600;201305;3921;12362;3690;11939;411;1639;2654;8384;3065;10023
280610;201305;2231;6768;2137;6626;370;1275;1359;4220;1729;5495
280620;201305;4525;14791;4284;14294;862;3094;2708;9052;3570;12146
280630;201305;3700;12621;3603;12477;417;1394;2864;10227;3281;11621
280640;201305;2032;6137;1924;6003;137;397;1685;5348;1822;5745
280650;201305;1051;3416;981;3283;196;711;600;2045;796;2756
280660;201305;2453;7489;2361;7334;201;754;2000;6099;2201;6853
280670;201305;15018;40779;14407;40040;1413;4220;11755;32720;13168;36940
280680;201305;2608;7254;2334;6914;194;610;1961;5818;2155;6428
280690;201305;934;2797;838;2647;123;461;565;1689;688;2150
280700;201305;1164;3529;1043;3360;86;273;811;2689;897;2962
280710;201305;9539;27893;9129;27381;562;1893;7912;23667;8474;25560
280720;201305;2386;6672;2139;6359;193;634;1694;5063;1887;5697
280730;201305;888;2760;871;2737;91;305;712;2267;803;2572
280740;201305;12115;34472;10828;32585;1706;5035;7636;23713;9342;28748
280750;201305;3442;11249;3249;10896;292;1226;2441;8076;2733;9302
280760;201305;5385;17161;4997;16659;644;2194;3833;13142;4477;15336
290010;201305;2911;6664;2150;5466;91;372;1731;4166;1822;4538
290020;201305;4799;15462;4371;15017;372;1204;3811;13326;4183;14530
290030;201305;2982;10122;2923;10003;353;1337;2264;7690;2617;9027
290035;201305;4349;12519;3983;12036;266;948;3401;10251;3667;11199
290040;201305;3505;10871;3321;10621;282;1102;2748;8661;3030;9763
290050;201305;2679;8942;2522;8700;254;980;1951;6784;2205;7764
290060;201305;1232;3310;1049;3095;83;234;907;2694;990;2928
290070;201305;28285;78729;25525;75210;5449;16810;14858;45638;20307;62448
290080;201305;5503;17672;5010;17042;612;2222;3880;13373;4492;15595
290090;201305;2296;5177;1849;4703;217;556;1513;3904;1730;4460
290100;201305;9860;29102;8643;27005;1898;5980;4755;15561;6653;21541
290110;201305;5094;15949;4948;15698;871;3005;3419;10779;4290;13784
290115;201305;4778;14967;4302;14339;356;1266;3306;11238;3662;12504
290120;201305;6413;18421;6076;18019;400;1241;5335;15924;5735;17165
290130;201305;4469;12055;4011;11512;318;804;3428;10067;3746;10871
290135;201305;4927;13343;4363;12409;476;1633;2982;8463;3458;10096
290140;201305;3559;12234;3218;11785;428;1677;2521;9298;2949;10975
290150;201305;2063;6277;2011;6192;173;578;1723;5290;1896;5868
290160;201305;3394;9715;3337;9649;377;763;2841;8590;3218;9353
290170;201305;2680;9307;2489;8987;270;1135;1947;7031;2217;8166
290180;201305;2840;8411;2608;8106;302;1051;1921;5973;2223;7024
290190;201305;4130;13842;3994;13602;447;1597;3125;10767;3572;12364
290195;201305;2106;6104;1854;5726;132;433;1509;4724;1641;5157
290200;201305;3662;12360;3406;11887;477;1804;2448;8581;2925;10385
290205;201305;2670;8945;2537;8761;433;1765;1789;6033;2222;7798
290210;201305;15099;43091;14511;42386;2498;5873;10469;33546;12967;39419
290220;201305;2227;7170;2159;7071;347;1308;1532;4918;1879;6226
290225;201305;2928;8109;2769;7936;267;598;2350;7009;2617;7607
290230;201305;2268;7743;2235;7695;260;906;1825;6387;2085;7293
290240;201305;3798;10281;3466;9830;418;1307;2565;7228;2983;8535
290250;201305;3688;12124;3155;11264;314;1214;2382;8593;2696;9807
290260;201305;4499;14517;4288;14188;511;1800;3356;11118;3867;12918
290265;201305;3236;10859;3114;10650;332;1325;2389;8144;2721;9469
290270;201305;11322;43409;10755;42602;1265;5551;8451;33747;9716;39298
290280;201305;4852;16722;4647;16308;739;2716;3128;11269;3867;13985
290290;201305;9373;31003;8699;29907;1630;5930;5812;20292;7442;26222
290300;201305;4292;12520;3467;11125;330;1067;2559;8453;2889;9520
290310;201305;1476;4648;1431;4599;215;796;1070;3379;1285;4175
290320;201305;22556;76043;21383;74364;4842;17697;13598;48131;18440;65828
290323;201305;3882;10929;3237;10251;211;777;2773;8767;2984;9544
290327;201305;3843;12787;3638;12356;528;1902;2555;8721;3083;10623
290330;201305;1799;4997;1733;4922;290;921;1325;3694;1615;4615
290340;201305;5423;17674;5119;17223;1253;4296;2956;10307;4209;14603
290350;201305;4801;15066;3979;13935;512;1838;2893;10412;3405;12250
290360;201305;3938;12916;3699;12620;229;829;3267;11260;3496;12089
290370;201305;4402;13788;4102;13345;574;1907;3181;10490;3755;12397
290380;201305;5265;16204;4763;15544;431;1583;3933;12848;4364;14431
290390;201305;14394;48945;13912;48136;2850;9587;9238;33576;12088;43163
290395;201305;2696;9008;2459;8618;264;1124;1838;6440;2102;7564
290400;201305;3355;11416;3079;11022;398;1524;2323;8450;2721;9974
290405;201305;4149;13787;3685;12997;526;1940;2494;9053;3020;10993
290410;201305;5756;17972;4995;16861;578;2490;3712;12181;4290;14671
290420;201305;3035;9603;2645;9043;288;1162;1999;6772;2287;7934
290430;201305;3300;10927;3048;10580;631;2172;1997;7214;2628;9386
290440;201305;2711;7769;2319;7277;223;773;1912;6038;2135;6811
290450;201305;3391;10304;3113;9913;701;2133;1928;6451;2629;8584
290460;201305;12552;40776;11972;39794;3069;10905;6505;21472;9574;32377
290470;201305;4543;13420;3703;12367;870;3285;2032;6859;2902;10144
290475;201305;5008;18214;4595;17475;560;2257;3367;13030;3927;15287
290480;201305;2554;6833;2297;6489;394;1238;1569;4446;1963;5684
290485;201305;4343;14886;4106;14537;484;2148;3139;11030;3623;13178
290490;201305;7227;21007;7045;20770;957;3037;5534;16352;6491;19389
290500;201305;4510;14823;3954;13866;741;2796;2233;7895;2974;10691
290510;201305;3370;10114;2982;9540;261;1005;2356;7513;2617;8518
290515;201305;2598;8554;2517;8393;143;465;2083;7140;2226;7605
290520;201305;11459;36776;9585;33268;1328;5380;6145;21231;7473;26611
290530;201305;5082;15202;4414;14255;377;1354;3584;11585;3961;12939
290540;201305;3916;11436;3753;11217;516;1510;2835;8692;3351;10202
290550;201305;4037;11253;3601;10696;289;811;2981;8988;3270;9799
290560;201305;6690;19879;5881;18795;1405;4664;3445;11282;4850;15946
290570;201305;37196;113600;35099;110364;4812;16381;25999;81594;30811;97975
290580;201305;7203;26196;6958;25821;1196;4479;5087;19392;6283;23871
290590;201305;7153;23750;6200;22264;465;2012;5072;18159;5537;20171
290600;201305;17644;56805;16800;55495;2406;8115;11942;40610;14348;48725
290610;201305;2267;8190;1966;7604;216;1035;1482;5628;1698;6663
290620;201305;7097;21614;6434;20672;536;1860;5389;17350;5925;19210
290630;201305;7974;22448;7160;21584;792;2357;5858;17920;6650;20277
290640;201305;2676;8037;2254;7294;259;902;1597;5187;1856;6089
290650;201305;11408;34908;10749;33885;3328;10533;5676;18737;9004;29270
290660;201305;3615;10501;3052;9687;220;810;2434;7755;2654;8565
290670;201305;6201;20477;5739;19759;816;2607;4435;15934;5251;18541
290680;201305;9905;30232;9383;29623;555;1661;8283;26571;8838;28232
290682;201305;4060;12837;3754;12406;230;937;3142;10343;3372;11280
290685;201305;3111;8393;2450;7467;306;1040;1584;4895;1890;5935
290687;201305;8186;22614;6737;20918;1059;3596;4560;14390;5619;17986
290689;201305;3060;8885;2608;8148;277;932;1998;6284;2275;7216
290690;201305;5089;15588;4730;15084;634;2257;3591;11453;4225;13710
290700;201305;2162;7039;2085;6923;247;878;1589;5335;1836;6213
290710;201305;7332;24641;6895;23959;410;1420;6101;21455;6511;22875
290720;201305;16855;52470;15292;50518;2405;7278;11555;39786;13960;47064
290730;201305;7170;20620;6641;19949;1328;3839;4330;13615;5658;17454
290740;201305;971;3032;846;2825;191;621;468;1657;659;2278
290750;201305;8647;27363;8130;26389;1714;6505;4906;14991;6620;21496
290755;201305;2364;6952;2043;6418;139;555;1676;5202;1815;5757
290760;201305;4366;13317;3695;12401;370;1286;2863;9696;3233;10982
290770;201305;2508;8891;2358;8694;153;622;2005;7440;2158;8062
290780;201305;8353;23199;7660;22273;1020;2794;5746;17180;6766;19974
290790;201305;4248;13581;4031;13304;493;1567;3112;10713;3605;12280
290800;201305;6971;16223;5445;14601;1121;2802;3776;10607;4897;13409
290810;201305;4631;15537;4217;14923;373;1405;3298;11879;3671;13284
290820;201305;5189;15613;4698;14920;644;2297;3408;10845;4052;13142
290830;201305;4068;12748;3937;12505;543;2122;2796;8649;3339;10771
290840;201305;16724;48752;15751;47413;2331;6767;11483;35944;13814;42711
290850;201305;6507;20208;6383;20017;1660;5152;4035;13089;5695;18241
290860;201305;4596;17230;4443;17021;728;2746;3258;12901;3986;15647
290870;201305;4595;14609;3906;13710;431;1779;2993;10482;3424;12261
290880;201305;1353;3893;1116;3515;118;392;753;2422;871;2814
290890;201305;6058;17552;5871;17308;566;1784;4858;14329;5424;16113
290900;201305;2333;7047;1800;6197;310;1216;947;3208;1257;4424
290910;201305;4596;13445;4027;12627;370;1256;3228;10158;3598;11414
290920;201305;4618;14446;4255;13971;293;844;3658;12267;3951;13111
290930;201305;7053;23515;6621;22818;754;2976;4917;16741;5671;19717
290940;201305;3241;10888;3086;10679;268;1026;2625;9165;2893;10191
290950;201305;1558;4581;1484;4482;226;745;1092;3265;1318;4010
290960;201305;5552;16864;5187;16362;410;1345;4202;13437;4612;14782
290970;201305;3682;12283;3465;11904;525;1875;2313;8179;2838;10054
290980;201305;10190;32387;9347;30676;2758;9641;4185;13633;6943;23274
290990;201305;8949;27530;8304;26523;945;3175;6503;20889;7448;24064
291000;201305;2813;9420;2690;9254;443;1475;1984;7092;2427;8567
291005;201305;10426;33202;9911;32389;2042;7147;6557;21531;8599;28678
291010;201305;2834;9990;2460;9116;513;2020;1285;4818;1798;6838
291020;201305;1307;3674;1032;3158;131;507;595;1761;726;2268
291030;201305;1999;5890;1714;5292;187;646;1139;3477;1326;4123
291040;201305;5033;16912;4800;16560;679;2573;3501;12088;4180;14661
291050;201305;7760;26670;7222;25677;1893;7228;3950;14147;5843;21375
291060;201305;6028;22997;5800;22723;795;3519;4481;17533;5276;21052
291070;201305;15292;47006;14304;45540;1983;5911;10739;35338;12722;41249
291072;201305;17630;58640;15921;55345;6278;23065;5166;19164;11444;42229
291075;201305;4995;15156;4583;14585;338;1093;3615;11706;3953;12799
291077;201305;1459;4481;1272;4195;148;600;881;2836;1029;3436
291080;201305;79174;246519;73204;237221;18519;63571;38507;124628;57026;188199
291085;201305;5372;15216;4757;14390;613;2004;3645;11038;4258;13042
291090;201305;1177;3413;1040;3204;174;748;673;1894;847;2642
291100;201305;2619;7267;2222;6846;127;512;1925;5893;2052;6405
291110;201305;4814;17832;4390;17160;568;2543;3226;12552;3794;15095
291120;201305;7240;19982;6877;19464;1022;3057;5107;14493;6129;17550
291125;201305;1639;3780;1356;3482;135;328;1061;2858;1196;3186
291130;201305;2942;9159;2601;8589;274;1053;1859;6108;2133;7161
291140;201305;3914;12193;3747;11900;554;1885;2745;8732;3299;10617
291150;201305;1956;5259;1893;5184;194;572;1509;4095;1703;4667
291160;201305;5379;16791;4806;15955;1122;3911;2934;9744;4056;13655
291165;201305;2216;7067;1940;6525;197;826;1383;4535;1580;5361
291170;201305;19860;52588;17544;49823;1407;4814;14250;40185;15657;44999
291180;201305;6134;16979;5189;15693;545;1887;4064;12192;4609;14079
291185;201305;3473;10274;3336;10098;231;823;2863;8601;3094;9424
291190;201305;7296;21235;6662;20500;915;2681;4987;16048;5902;18729
291200;201305;3012;9434;2660;8876;372;1450;1901;6291;2273;7741
291210;201305;7434;18246;6662;17408;709;1938;5173;13671;5882;15609
291220;201305;3830;12725;3659;12427;583;2264;2577;8649;3160;10913
291230;201305;3680;10091;3322;9651;222;674;2860;8365;3082;9039
291240;201305;4586;13048;3957;11947;341;1100;3048;9114;3389;10214
291250;201305;3644;11238;2935;10075;313;1126;2118;7376;2431;8502
291260;201305;1152;3523;1104;3463;105;371;895;2801;1000;3172
291270;201305;4605;15667;4405;15372;286;1129;3726;13041;4012;14170
291280;201305;2313;5980;1779;5377;534;1558;1031;3249;1565;4807
291290;201305;5735;17111;5327;16617;499;1521;4281;13692;4780;15213
291300;201305;4320;13337;3631;12176;466;1738;2526;8505;2992;10243
291310;201305;5102;15295;4590;14481;452;1542;3526;11135;3978;12677
291320;201305;5308;18357;4864;17478;1387;5388;2365;8395;3752;13783
291330;201305;1544;4919;1455;4757;223;856;913;2855;1136;3711
291340;201305;3697;11431;3016;10458;406;1617;2244;7704;2650;9321
291345;201305;3232;11270;3113;11140;238;897;2721;9838;2959;10735
291350;201305;5940;18067;5355;17179;729;2443;3544;11696;4273;14139
291360;201305;35364;105779;33369;102827;7840;24060;21568;68657;29408;92717
291370;201305;8775;27304;8464;26906;1393;4107;6140;20495;7533;24602
291380;201305;3623;11604;3293;11064;315;1096;2423;8365;2738;9461
291390;201305;9902;28984;9117;28084;1193;3713;7150;22302;8343;26015
291400;201305;16255;44188;13419;40418;1967;6179;9040;28192;11007;34371
291410;201305;3163;8423;2360;7239;212;877;1745;5140;1957;6017
291420;201305;2179;5895;1997;5675;142;359;1784;5158;1926;5517
291430;201305;3271;9967;2921;9507;273;1060;2286;7385;2559;8445
291440;201305;5552;18570;4782;17097;596;2278;3536;12833;4132;15111
291450;201305;7020;22583;6717;22054;504;1628;5446;18277;5950;19905
291460;201305;11988;38445;10880;36830;2702;9470;6462;22355;9164;31825
291465;201305;7217;22520;6778;22022;1000;3464;5176;17007;6176;20471
291470;201305;15011;43570;13577;41805;1170;3668;10962;34672;12132;38340
291480;201305;33043;93149;29756;88511;5641;18333;18978;56353;24619;74686
291490;201305;3985;14224;3925;14129;537;1967;3140;11428;3677;13395
291500;201305;4041;12129;3581;11495;305;1067;2896;9338;3201;10405
291510;201305;3293;10640;3134;10413;176;637;2801;9354;2977;9991
291520;201305;3921;11364;3550;10854;639;1848;2361;7731;3000;9579
291530;201305;2013;6238;1753;5839;510;1805;862;2977;1372;4782
291535;201305;4226;12754;3867;12234;419;1392;2890;9535;3309;10927
291540;201305;2171;5561;1903;5280;156;402;1617;4589;1773;4991
291550;201305;5427;15450;4945;14766;1225;3944;2787;8377;4012;12321
291560;201305;15935;43601;12929;40127;1813;5779;9407;29968;11220;35747
291570;201305;2230;6283;2190;6230;78;189;2057;5915;2135;6104
291580;201305;5679;18000;5089;17046;860;3486;3204;10527;4064;14013
291590;201305;1900;6172;1707;5845;361;1422;1026;3553;1387;4975
291600;201305;5342;15376;4007;13511;1020;3710;2027;6811;3047;10521
291610;201305;5108;14849;4957;14625;559;1976;3942;11326;4501;13302
291620;201305;2954;7196;2500;6706;217;576;1988;5505;2205;6081
291630;201305;3156;8185;2843;7832;248;648;2455;6910;2703;7558
291640;201305;16472;47309;14166;44386;4051;13929;6474;20406;10525;34335
291650;201305;7843;23954;7302;23323;631;1631;6185;20537;6816;22168
291660;201305;2373;6501;2137;6188;272;901;1543;4414;1815;5315
291670;201305;2472;7130;2288;6825;380;1183;1292;4184;1672;5367
291680;201305;4894;14375;4488;13749;1197;4116;2138;6841;3335;10957
291685;201305;4039;11195;3682;10761;227;695;3148;9406;3375;10101
291690;201305;3889;11032;3243;10001;339;1103;2237;6951;2576;8054
291700;201305;8971;29688;8478;28858;937;3364;6548;22625;7485;25989
291710;201305;5628;15697;4968;14793;1388;4522;2291;7120;3679;11642
291720;201305;3531;12936;3372;12598;405;1707;2532;9344;2937;11051
291730;201305;5587;18815;5269;18397;1392;4900;3156;11481;4548;16381
291733;201305;2407;7670;2141;7305;255;961;1520;5241;1775;6202
291735;201305;2023;6265;1807;5932;102;418;1550;5014;1652;5432
291740;201305;3885;11579;3110;10389;329;1293;2205;7328;2534;8621
291750;201305;20946;57700;17275;52402;3875;12193;9825;30364;13700;42557
291760;201305;11804;38835;11207;37778;3761;13600;5438;18727;9199;32327
291770;201305;7713;23029;7219;22210;1113;3742;5015;15305;6128;19047
291780;201305;4187;13420;4058;13189;601;1886;3079;10180;3680;12066
291790;201305;2325;7767;2223;7632;211;810;1819;6268;2030;7078
291800;201305;29672;90818;27420;87586;6484;21478;16589;54453;23073;75931
291810;201305;10021;30485;8918;29208;698;2461;7324;24348;8022;26809
291820;201305;3467;10870;3238;10555;383;1252;2503;8291;2886;9543
291830;201305;4194;11794;3945;11416;555;1790;2967;8517;3522;10307
291835;201305;5959;19071;5121;17764;1055;3969;3390;11752;4445;15721
291840;201305;44947;129379;39462;123612;4928;15454;31601;101021;36529;116475
291845;201305;2985;8941;2709;8643;205;607;2404;7787;2609;8394
291850;201305;4767;13795;4101;12892;425;1312;3259;10511;3684;11823
291855;201305;1853;5084;1638;4823;290;1005;1142;3291;1432;4296
291860;201305;1848;5789;1709;5561;204;771;1153;3732;1357;4503
291870;201305;1313;3728;1073;3299;113;430;732;2223;845;2653
291875;201305;2710;9171;2542;8900;272;1112;1906;6590;2178;7702
291880;201305;4308;14106;4203;13967;285;969;3695;12386;3980;13355
291890;201305;1398;3621;1201;3378;160;480;886;2508;1046;2988
291900;201305;1244;3742;1127;3564;114;410;853;2669;967;3079
291905;201305;2810;7819;2416;7196;259;863;1666;5062;1925;5925
291910;201305;2393;6919;2186;6657;183;684;1785;5336;1968;6020
291915;201305;6403;20716;5882;19640;514;1802;4922;16618;5436;18420
291920;201305;32070;94982;29913;91866;5856;18192;19309;61296;25165;79488
291930;201305;2427;7553;2249;7308;239;788;1781;5915;2020;6703
291940;201305;3494;10265;2717;8914;405;1563;1710;5467;2115;7030
291950;201305;8931;31437;8206;30259;2123;8008;4488;16970;6611;24978
291955;201305;7226;24507;7120;24359;1411;4895;4989;17396;6400;22291
291960;201305;3282;10083;2877;9542;367;1170;2050;7176;2417;8346
291970;201305;4292;13192;3850;12667;633;2128;2696;9117;3329;11245
291980;201305;11108;33083;8798;29821;1033;3694;6356;21988;7389;25682
291990;201305;2065;7029;1928;6820;218;794;1408;5143;1626;5937
291992;201305;2712;8551;2659;8439;499;1646;1888;5984;2387;7630
291995;201305;2040;6257;1868;6028;222;749;1453;4760;1675;5509
292000;201305;2201;6805;2027;6536;562;1971;1115;3533;1677;5504
292010;201305;5953;16000;4665;14036;396;1337;3630;10903;4026;12240
292020;201305;4385;15433;4058;14895;556;2233;3004;11185;3560;13418
292030;201305;2102;6924;1926;6679;264;1002;1332;4703;1596;5705
292040;201305;4395;12812;4024;12411;337;1019;3400;10803;3737;11822
292045;201305;2252;8432;2226;8387;123;414;2036;7748;2159;8162
292050;201305;5879;19354;5454;18517;640;2644;3887;12981;4527;15625
292060;201305;10527;30549;10178;30076;933;2920;8509;25089;9442;28009
292070;201305;4167;13796;4069;13670;413;1232;3499;12007;3912;13239
292080;201305;3565;9812;3142;9237;313;953;2527;7506;2840;8459
292090;201305;4184;11575;3644;10958;385;1326;2913;8746;3298;10072
292100;201305;10377;30280;9245;28869;2379;7755;5616;17904;7995;25659
292105;201305;3094;9683;2725;9166;224;908;2169;7249;2393;8157
292110;201305;6886;18646;5340;16468;1082;3585;3242;10175;4324;13760
292120;201305;8199;24297;7370;23002;1511;4941;4440;14180;5951;19121
292130;201305;3183;8679;2951;8379;390;910;2294;6826;2684;7736
292140;201305;5254;14268;4707;13531;524;1578;3413;10061;3937;11639
292145;201305;2634;8325;2428;8001;220;715;1829;6296;2049;7011
292150;201305;13143;41100;12313;39761;902;3454;9744;31604;10646;35058
292160;201305;2523;7582;2193;7130;211;653;1759;5909;1970;6562
292170;201305;8363;26101;7343;24350;1102;4085;4775;16043;5877;20128
292180;201305;3435;10536;2904;9738;338;1228;2096;7136;2434;8364
292190;201305;3005;8791;2679;8334;550;1900;1742;5396;2292;7296
292200;201305;4855;17570;4474;16678;1596;6283;1589;6046;3185;12329
292205;201305;3931;12521;3652;12148;313;1187;2882;9592;3195;10779
292210;201305;6345;19228;5656;18271;592;2003;4409;14609;5001;16612
292220;201305;1887;5613;1800;5488;335;1043;1216;3693;1551;4736
292225;201305;2800;9262;2591;8935;227;820;2059;7221;2286;8041
292230;201305;5916;18355;5690;17997;694;2649;4357;13446;5051;16095
292240;201305;4152;13807;3908;13244;619;2215;2442;8311;3061;10526
292250;201305;5239;16388;4944;15796;1031;3445;2831;9137;3862;12582
292260;201305;2849;9540;2751;9381;347;1266;2082;7102;2429;8368
292265;201305;2968;10211;2786;9857;250;1038;2103;7414;2353;8452
292270;201305;3670;10579;3016;9808;279;1123;2441;7901;2720;9024
292273;201305;2705;6712;2096;5929;326;897;1452;4296;1778;5193
292275;201305;1882;4991;1772;4834;226;708;1338;3613;1564;4321
292280;201305;1998;6223;1870;6088;197;561;1480;5109;1677;5670
292285;201305;2401;7103;2158;6748;335;1120;1458;4720;1793;5840
292290;201305;7338;22744;6286;21405;261;984;5450;18975;5711;19959
292300;201305;8061;25724;7169;24764;2389;8308;3973;14302;6362;22610
292303;201305;2687;8849;2541;8631;95;372;2230;7604;2325;7976
292305;201305;3048;8654;2897;8449;116;360;2598;7611;2714;7971
292310;201305;5777;18511;5335;17918;379;1270;4560;15544;4939;16814
292320;201305;5511;17805;5176;17212;600;2343;3934;12959;4534;15302
292330;201305;1833;5639;1731;5518;296;1041;1217;3842;1513;4883
292335;201305;5032;13807;4662;13308;401;1165;3924;11284;4325;12449
292340;201305;6238;18791;5549;17752;514;1797;4208;13499;4722;15296
292350;201305;2018;6529;1910;6399;206;788;1522;5098;1728;5886
292360;201305;4703;14376;4566;13888;206;642;3977;12368;4183;13010
292370;201305;8035;26414;7385;25440;932;3098;5326;19393;6258;22491
292380;201305;7096;21198;6760;20709;549;1602;5702;17678;6251;19280
292390;201305;3483;8216;3110;7812;112;235;2906;7370;3018;7605
292400;201305;21563;65026;20698;63628;3092;10078;14735;46235;17827;56313
292405;201305;4290;11918;3788;11310;292;884;3190;9665;3482;10549
292410;201305;1616;4888;1579;4845;107;432;1393;4193;1500;4625
292420;201305;3525;11713;3411;11582;237;635;3029;10611;3266;11246
292430;201305;5064;16783;4413;15955;338;1377;3507;12742;3845;14119
292440;201305;8344;27822;7877;27167;311;1204;7023;24557;7334;25761
292450;201305;4068;12726;3403;11657;373;1428;2380;8269;2753;9697
292460;201305;5540;17124;4989;16118;839;2865;3281;10677;4120;13542
292465;201305;2246;7136;1971;6694;247;980;1436;4886;1683;5866
292467;201305;2155;7183;2052;7006;459;1710;1276;4371;1735;6081
292470;201305;3118;8612;2643;7859;234;843;2010;5877;2244;6720
292480;201305;5437;16031;4725;14992;409;1468;3808;12151;4217;13619
292490;201305;2149;6421;1898;6042;229;870;1393;4379;1622;5249
292500;201305;6336;19795;5601;18505;617;2368;4095;13602;4712;15970
292510;201305;12681;37754;11431;35973;1151;4045;8982;28578;10133;32623
292520;201305;5508;17629;5165;17011;1562;5281;2568;8552;4130;13833
292525;201305;5336;14469;4733;13764;475;1511;3756;11017;4231;12528
292530;201305;23898;73717;22173;71738;4044;13428;15660;52209;19704;65637
292540;201305;2605;8226;2409;7928;505;1874;1535;5035;2040;6909
292550;201305;5884;20369;5412;19605;1026;3949;3539;13068;4565;17017
292560;201305;4139;11749;3575;11011;320;1186;2890;8762;3210;9948
292570;201305;3785;11640;3723;11574;145;462;3244;10419;3389;10881
292575;201305;5737;20201;5605;19927;1260;4588;3621;12928;4881;17516
292580;201305;6758;20984;6338;20446;561;1872;5251;17112;5812;18984
292590;201305;6926;22964;6703;22560;1091;3618;4680;16125;5771;19743
292593;201305;3164;8604;2730;7973;257;785;2108;6149;2365;6934
292595;201305;5401;16374;4928;15740;484;1688;3796;12147;4280;13835
292600;201305;9974;29277;9570;28775;1396;3272;7616;24147;9012;27419
292610;201305;4253;12639;3605;11554;635;2150;2202;7180;2837;9330
292620;201305;5694;18117;5108;17438;272;1014;4629;15901;4901;16915
292630;201305;9703;25071;8596;23455;674;2025;6770;18610;7444;20635
292640;201305;8186;26961;7281;25776;683;2495;5728;20780;6411;23275
292650;201305;4548;13173;4407;13005;505;1152;3539;11143;4044;12295
292660;201305;10710;33794;10354;33253;1535;4907;7633;25159;9168;30066
292665;201305;2831;8627;2764;8523;100;278;2589;8055;2689;8333
292670;201305;3734;10952;3009;9731;381;1416;1995;6477;2376;7893
292680;201305;3453;10783;3322;10610;240;866;2846;9013;3086;9879
292690;201305;3295;9240;2455;7960;326;1172;1673;5505;1999;6677
292700;201305;8549;27408;7733;26284;970;3162;5916;20888;6886;24050
292710;201305;1856;6230;1793;6134;113;414;1571;5407;1684;5821
292720;201305;9253;24873;8285;23765;835;2484;6807;19752;7642;22236
292730;201305;3207;10095;3119;9947;630;1925;2039;6767;2669;8692
292740;201305;338452;989814;324249;968647;80056;252212;194177;582996;274233;835208
292750;201305;5610;16019;5175;15450;413;1208;4215;12890;4628;14098
292760;201305;4180;13725;3874;13165;575;2159;2611;8962;3186;11121
292770;201305;5705;18206;5450;17810;1407;4611;3160;10765;4567;15376
292780;201305;1738;4629;1415;4242;227;811;997;2924;1224;3735
292790;201305;3002;8679;2921;8586;255;665;2419;7442;2674;8107
292800;201305;9141;28406;8641;27592;959;3308;6685;21404;7644;24712
292805;201305;2953;9237;2766;8957;522;1847;1894;6215;2416;8062
292810;201305;9349;30033;8218;28539;1267;4511;6095;21666;7362;26177
292820;201305;7080;21063;5334;18606;446;1755;4369;15302;4815;17057
292830;201305;1811;5548;1664;5349;133;536;1350;4297;1483;4833
292840;201305;6217;22364;5781;21749;553;2068;4745;18192;5298;20260
292850;201305;2947;8220;2622;7740;404;1251;1800;5281;2204;6532
292860;201305;14716;41349;14277;40813;2029;5770;11112;32331;13141;38101
292870;201305;17625;51402;16003;48752;3073;10522;9581;28628;12654;39150
292880;201305;11382;35202;10426;33648;2036;6792;6610;21628;8646;28420
292890;201305;5236;18761;4795;17895;1062;4075;2700;10432;3762;14507
292895;201305;2633;6991;2255;6433;320;981;1685;4772;2005;5753
292900;201305;3014;9593;2850;9324;480;1834;1867;5895;2347;7729
292905;201305;3841;12126;3255;11356;397;1253;2562;9317;2959;10570
292910;201305;4869;15649;4582;15120;823;2889;2988;9838;3811;12727
292920;201305;7438;22890;7125;22417;703;2521;5705;17751;6408;20272
292925;201305;4872;15983;4397;15341;380;1428;3542;12453;3922;13881
292930;201305;6217;20577;5984;20143;896;3641;4279;14062;5175;17703
292935;201305;2044;5977;1754;5651;202;605;1364;4598;1566;5203
292937;201305;3209;8509;2778;7958;345;1113;2085;5899;2430;7012
292940;201305;2990;8551;2421;7767;294;958;1647;5503;1941;6461
292950;201305;7922;24953;7640;24471;1122;4196;5429;16958;6551;21154
292960;201305;4402;12851;4166;12497;504;1660;3006;8940;3510;10600
292970;201305;4032;13114;3761;12768;214;881;3187;10837;3401;11718
292975;201305;2985;8787;2902;8650;348;1102;2304;6876;2652;7978
292980;201305;3462;10137;2881;9441;409;1617;2007;6514;2416;8131
292990;201305;11562;34266;10956;33392;791;2527;9454;28980;10245;31507
293000;201305;2827;7804;2387;7232;144;520;2056;6195;2200;6715
293010;201305;16770;50987;15578;48960;3256;11093;9552;29968;12808;41061
293015;201305;7609;25890;6234;23892;1088;4500;4152;15887;5240;20387
293020;201305;9211;31066;8656;30255;651;2559;7172;25359;7823;27918
293030;201305;5333;16209;4417;14855;515;1850;3102;10782;3617;12632
293040;201305;3580;11782;3464;11654;257;920;2995;10108;3252;11028
293050;201305;18325;54378;16545;52017;2431;7816;11636;37573;14067;45389
293060;201305;4223;11054;3644;10137;427;1286;2532;7010;2959;8296
293070;201305;18370;58590;17558;57185;4821;16472;9861;32464;14682;48936
293075;201305;3537;11267;3237;10921;201;710;2856;9719;3057;10429
293076;201305;3631;10586;3426;10277;319;883;2842;8735;3161;9618
293077;201305;5136;16134;4500;15336;706;2561;3196;10965;3902;13526
293080;201305;4687;15211;4338;14617;372;1604;3393;11184;3765;12788
293090;201305;3529;11277;2944;10473;289;1094;2332;8403;2621;9497
293100;201305;5469;17373;4785;16186;496;1844;3615;12409;4111;14253
293105;201305;3700;12817;3322;12078;487;1932;2307;8477;2794;10409
293110;201305;1898;5849;1814;5712;110;408;1544;4861;1654;5269
293120;201305;3892;13463;3655;13131;358;1321;2925;10658;3283;11979
293130;201305;3851;11514;3166;10743;201;790;2758;9478;2959;10268
293135;201305;23378;67783;20018;63245;3958;14961;11318;34911;15276;49872
293140;201305;1991;6228;1939;6147;204;855;1509;4623;1713;5478
293150;201305;5745;19169;5285;18293;1040;3664;3253;11641;4293;15305
293160;201305;2920;8955;2779;8781;444;1128;2095;6997;2539;8125
293170;201305;3326;10467;3147;10192;472;1625;2306;7616;2778;9241
293180;201305;5246;15088;4487;13947;439;1621;3511;10753;3950;12374
293190;201305;13068;41113;12637;40395;669;2916;10936;34281;11605;37197
293200;201305;5860;18163;5320;17298;362;1381;4566;14716;4928;16097
293210;201305;4529;14241;4304;13862;551;1901;3106;10134;3657;12035
293220;201305;4809;15287;4496;14831;1196;4112;2488;8422;3684;12534
293230;201305;3903;12584;3647;12233;383;1489;2943;9821;3326;11310
293240;201305;4381;11660;3531;10530;201;620;2794;8360;2995;8980
293245;201305;4255;12814;3931;12278;519;1671;2794;8998;3313;10669
293250;201305;5817;17137;5460;16641;923;2935;3806;11732;4729;14667
293260;201305;4563;14180;3868;13170;373;1421;2914;10055;3287;11476
293270;201305;5620;15934;5386;15680;549;1546;4568;13499;5117;15045
293280;201305;5490;16241;4885;15441;437;1310;3838;12585;4275;13895
293290;201305;15678;54951;15212;53982;3119;11213;9805;35673;12924;46886
293300;201305;5982;15874;5242;15057;533;1475;4146;12165;4679;13640
293305;201305;4430;11778;4118;11362;436;1312;3221;8948;3657;10260
293310;201305;2624;7010;2206;6331;337;1070;1454;4139;1791;5209
293315;201305;4700;12413;4271;11728;793;2148;2614;7588;3407;9736
293317;201305;2440;7545;2253;7193;334;1111;1468;4734;1802;5845
293320;201305;8015;26488;7826;26227;982;3606;6225;20765;7207;24371
293325;201305;1864;5594;1563;5115;282;1009;1012;3351;1294;4360
293330;201305;51958;169877;47407;162203;11003;40801;26722;92751;37725;133552
293340;201305;2622;7716;2125;6870;294;1096;1472;4660;1766;5756
293345;201305;3248;10209;2750;9473;374;1310;1892;6748;2266;8058
293350;201305;6508;18605;6279;18321;341;939;5664;16783;6005;17722
293360;201305;13343;41493;12358;40186;809;2666;10499;34898;11308;37564
310010;201305;1223;3404;894;2872;258;983;393;1162;651;2145
310020;201305;3688;11995;3184;10868;1181;4345;642;1994;1823;6339
310030;201305;2366;8145;2150;7741;757;2858;877;3204;1634;6062
310040;201305;922;2665;787;2477;124;464;519;1582;643;2046
310050;201305;1882;6853;1667;6311;357;1560;824;3099;1181;4659
310060;201305;2935;10673;2847;10542;309;1209;2307;8634;2616;9843
310070;201305;306;935;232;794;44;186;100;306;144;492
310080;201305;718;2282;597;2046;173;684;197;627;370;1311
310090;201305;4345;13881;3908;13118;740;2749;2419;8160;3159;10909
310100;201305;3109;10237;2780;9755;442;1681;1926;6805;2368;8486
310110;201305;5715;16625;4862;15354;1177;4254;2622;8162;3799;12416
310120;201305;552;1871;529;1834;235;925;195;588;430;1513
310130;201305;450;1486;413;1427;117;460;210;693;327;1153
310140;201305;250;887;217;822;77;326;44;150;121;476
310150;201305;4502;14728;4143;14060;969;3769;2191;7385;3160;11154
310160;201305;6478;21602;5812;20501;1676;6615;2788;9660;4464;16275
310163;201305;634;2251;604;2195;162;679;281;996;443;1675
310170;201305;9367;27887;8700;26854;1904;6324;5142;16414;7046;22738
310180;201305;1739;5277;1421;4864;364;1452;759;2507;1123;3959
310190;201305;2421;8356;2234;8063;709;2884;398;1471;1107;4355
310200;201305;1769;6166;1519;5640;514;2068;483;1771;997;3839
310205;201305;908;2975;836;2821;170;598;504;1735;674;2333
310210;201305;2295;7669;2148;7425;419;1568;1430;4942;1849;6510
310220;201305;1247;3624;1013;3331;181;658;662;2167;843;2825
310230;201305;2722;9355;2448;8733;837;3415;835;2696;1672;6111
310240;201305;980;3581;832;3277;142;619;482;1993;624;2612
310250;201305;929;3340;907;3304;188;780;550;1921;738;2701
310260;201305;3196;10784;2835;10038;957;3726;1036;3556;1993;7282
310270;201305;2231;7019;2051;6763;343;1257;1413;4715;1756;5972
310280;201305;2014;6139;1839;5851;655;2471;668;1921;1323;4392
310285;201305;2260;8065;2167;7944;268;933;1677;6359;1945;7292
310290;201305;1295;4221;1208;4086;403;1591;542;1626;945;3217
310300;201305;1809;6438;1723;6248;504;2010;941;3362;1445;5372
310310;201305;373;1084;288;900;59;213;144;431;203;644
310320;201305;329;1214;303;1143;84;342;143;543;227;885
310330;201305;467;1260;357;1064;54;195;207;575;261;770
310340;201305;8052;26638;7269;25374;1377;5081;4582;16495;5959;21576
310350;201305;13286;40909;11221;37119;4217;15125;2910;9685;7127;24810
310360;201305;425;1436;414;1416;108;428;247;800;355;1228
310370;201305;1344;5070;1301;4980;507;1993;499;1947;1006;3940
310375;201305;1234;3419;954;2963;139;526;562;1720;701;2246
310380;201305;366;1099;312;1030;144;524;117;354;261;878
310390;201305;434;1616;377;1489;117;503;67;250;184;753
310400;201305;9496;29716;7815;26649;2824;10548;2025;6735;4849;17283
310410;201305;1024;3336;679;2813;300;1337;130;516;430;1853
310420;201305;5358;15981;3123;10584;888;3385;460;1396;1348;4781
310430;201305;1499;5320;1304;4884;471;1885;373;1385;844;3270
310440;201305;617;1848;541;1728;165;606;202;599;367;1205
310445;201305;1169;4091;1012;3819;161;695;643;2459;804;3154
310450;201305;4257;13177;3611;12175;832;3001;2124;7336;2956;10337
310460;201305;1422;4799;1257;4499;493;1883;303;1151;796;3034
310470;201305;3675;9857;3135;9190;337;1168;2470;7202;2807;8370
310480;201305;967;3160;878;3015;239;945;399;1294;638;2239
310490;201305;3172;11031;2765;10226;961;3789;958;3656;1919;7445
310500;201305;1413;5113;1328;4944;457;1840;483;1790;940;3630
310510;201305;2447;8239;2160;7585;863;3308;500;1653;1363;4961
310520;201305;1219;3615;1102;3417;98;340;722;2235;820;2575
310530;201305;772;2590;534;1958;128;525;93;326;221;851
310540;201305;3561;12051;3324;11713;1201;4501;1233;4401;2434;8902
310550;201305;1037;3417;893;3169;337;1345;265;894;602;2239
310560;201305;15135;49250;13353;45783;4657;17666;4567;14939;9224;32605
310570;201305;1237;3973;1169;3880;178;677;853;2788;1031;3465
310590;201305;3888;11915;3173;10482;748;2848;1135;3538;1883;6386
310600;201305;1590;5487;1524;5332;534;2086;524;1726;1058;3812
310610;201305;535;1875;490;1775;173;730;154;499;327;1229
310620;201305;185909;611591;154827;546792;49094;190779;56990;193643;106084;384422
310630;201305;3929;13449;3745;13097;992;3885;2149;7269;3141;11154
310640;201305;1412;4486;1159;4027;372;1415;385;1268;757;2683
310650;201305;2727;9360;2316;8685;478;1951;1339;5158;1817;7109
310660;201305;1249;4042;1127;3867;212;839;795;2659;1007;3498
310665;201305;1083;3570;1012;3475;209;767;649;2264;858;3031
310670;201305;53355;173631;50239;166509;16210;57101;22681;73585;38891;130686
310680;201305;792;2442;729;2344;165;592;411;1281;576;1873
310690;201305;1152;4053;977;3658;284;1255;255;889;539;2144
310700;201305;476;1372;414;1276;96;343;217;629;313;972
310710;201305;6990;23914;5914;22455;1411;5583;3274;13140;4685;18723
310720;201305;791;2529;735;2442;218;809;379;1191;597;2000
310730;201305;9072;29913;8496;29032;1932;7161;5252;18034;7184;25195
310740;201305;4744;16733;4165;15506;1716;6922;987;3470;2703;10392
310750;201305;1497;4075;1268;3764;272;862;780;2318;1052;3180
310760;201305;598;1949;526;1828;153;569;212;726;365;1295
310770;201305;676;2592;669;2581;228;924;342;1331;570;2255
310780;201305;3475;10497;3230;10113;361;1054;2563;8202;2924;9256
310790;201305;1633;5494;1539;5352;491;1764;792;2838;1283;4602
310800;201305;3066;10326;2562;9294;1123;4430;443;1608;1566;6038
310810;201305;1497;4280;1405;4133;359;1191;716;2013;1075;3204
310820;201305;1427;4216;1088;3639;338;1241;368;1177;706;2418
310825;201305;2197;7947;1889;7399;183;899;1398;5444;1581;6343
310830;201305;1471;5126;1253;4679;489;1957;436;1604;925;3561
310840;201305;2151;7448;1988;7119;753;2956;615;2075;1368;5031
310850;201305;1401;4541;1231;4307;272;1064;756;2615;1028;3679
310855;201305;2967;10019;2724;9618;799;2953;1376;5052;2175;8005
310860;201305;7536;24526;6842;23356;1196;4371;4102;14379;5298;18750
310870;201305;935;2956;842;2784;186;711;432;1427;618;2138
310880;201305;1219;3892;936;3349;204;832;460;1649;664;2481
310890;201305;2582;8510;2067;7501;692;2818;414;1420;1106;4238
310900;201305;3931;13863;3551;13039;1155;4646;1407;5010;2562;9656
310910;201305;1754;5430;1422;4849;459;1741;425;1417;884;3158
310920;201305;1734;5697;1460;5288;418;1707;701;2515;1119;4222
310925;201305;884;3022;799;2867;322;1257;215;775;537;2032
310930;201305;4840;15737;4338;14931;1103;3894;2483;8762;3586;12656
310940;201305;6046;18691;5329;17589;997;3772;3107;10104;4104;13876
310945;201305;1233;3628;1004;3311;231;876;555;1780;786;2656
310950;201305;1757;6293;1550;5866;655;2690;430;1556;1085;4246
310960;201305;441;1542;395;1455;144;583;138;506;282;1089
310970;201305;1447;5192;1126;4301;466;1919;144;507;610;2426
310980;201305;439;1193;319;974;60;214;143;397;203;611
310990;201305;1099;3908;966;3645;231;1002;378;1328;609;2330
311000;201305;4546;16293;4092;15330;1358;5640;1480;5345;2838;10985
311010;201305;919;3049;813;2853;263;982;369;1265;632;2247
311020;201305;861;2780;747;2584;80;322;529;1824;609;2146
311030;201305;1645;5344;1406;4815;481;1814;522;1615;1003;3429
311040;201305;460;1629;408;1484;128;487;114;399;242;886
311050;201305;2448;8161;2063;7351;693;2706;756;2676;1449;5382
311060;201305;2117;6923;1796;6219;553;2055;418;1427;971;3482
311070;201305;1688;6155;1492;5737;474;2039;463;1759;937;3798
311080;201305;1177;3254;1062;3086;179;604;697;2029;876;2633
311090;201305;1573;6216;1390;5829;510;2401;322;1304;832;3705
311100;201305;2218;8004;2027;7610;955;3722;524;1996;1479;5718
311110;201305;3623;9201;2800;8108;657;2169;1503;4204;2160;6373
311115;201305;1057;3417;924;3212;126;531;631;2218;757;2749
311120;201305;8126;24828;7009;22803;2528;9232;2099;6382;4627;15614
311130;201305;2352;7339;1935;6812;705;2804;772;2613;1477;5417
311140;201305;1185;3590;1037;3416;192;740;704;2264;896;3004
311150;201305;2379;8020;2200;7733;495;1737;1297;4751;1792;6488
311160;201305;4708;16382;4067;15355;1574;6349;1382;5167;2956;11516
311170;201305;692;2301;590;2090;82;320;361;1330;443;1650
311180;201305;1525;4354;1104;3505;341;1188;212;585;553;1773
311190;201305;1079;3363;930;3053;227;842;441;1404;668;2246
311200;201305;2443;7726;2183;7221;986;3548;505;1511;1491;5059
311205;201305;1109;3804;1009;3619;262;1071;394;1479;656;2550
311210;201305;894;2988;835;2891;132;459;618;2185;750;2644
311220;201305;877;2927;740;2625;202;745;256;890;458;1635
311230;201305;8586;27011;7518;25206;1650;6094;4067;13889;5717;19983
311240;201305;1301;4155;1123;3849;392;1502;326;1069;718;2571
311250;201305;1287;4433;1167;4217;382;1500;378;1266;760;2766
311260;201305;2835;7940;2177;6766;712;2428;665;1946;1377;4374
311265;201305;1260;3543;1014;3223;150;594;725;2276;875;2870
311270;201305;3240;11216;2973;10861;629;2645;1936;7006;2565;9651
311280;201305;1325;3798;1040;3310;294;1049;329;1019;623;2068
311290;201305;2273;7618;2115;7278;405;1372;1249;4512;1654;5884
311300;201305;4901;16998;4524;16433;709;2923;3071;11221;3780;14144
311310;201305;480;1757;461;1723;106;493;201;692;307;1185
311320;201305;3900;13575;3414;12473;1082;4448;1115;3886;2197;8334
311330;201305;5291;16801;4650;15810;1694;6223;1793;6059;3487;12282
311340;201305;11915;39839;11130;38326;4407;16304;3164;10839;7571;27143
311350;201305;2104;6677;1865;6264;482;1900;834;2678;1316;4578
311360;201305;1276;3716;1017;3362;476;1662;285;973;761;2635
311370;201305;4328;13551;3942;12890;1083;4220;1723;5448;2806;9668
311380;201305;458;1570;393;1441;133;545;120;407;253;952
311390;201305;1892;7209;1813;7035;776;3311;556;2077;1332;5388
311400;201305;1652;5681;1542;5486;488;1971;658;2158;1146;4129
311410;201305;1944;7224;1832;7063;699;2889;813;3143;1512;6032
311420;201305;2173;7861;1993;7420;787;3100;425;1421;1212;4521
311430;201305;3541;11649;2835;10055;704;2758;595;2064;1299;4822
311440;201305;2064;7515;1789;7087;853;3702;444;1735;1297;5437
311450;201305;2394;8765;2159;8248;906;3704;642;2351;1548;6055
311455;201305;1484;4158;1321;3915;287;973;735;2124;1022;3097
311460;201305;581;1993;471;1748;129;591;118;419;247;1010
311470;201305;554;1850;472;1673;143;586;161;547;304;1133
311480;201305;760;2285;737;2247;239;773;347;1012;586;1785
311490;201305;308;1260;298;1222;108;464;101;418;209;882
311500;201305;488;1527;399;1347;183;674;106;340;289;1014
311510;201305;2974;9628;2534;8801;1018;3930;663;2180;1681;6110
311520;201305;666;2345;635;2281;255;979;258;899;513;1878
311530;201305;9596;27240;6928;22307;2281;8613;1834;5590;4115;14203
311535;201305;651;2108;502;1792;144;581;122;426;266;1007
311540;201305;664;2521;637;2481;232;938;301;1161;533;2099
311545;201305;1937;6616;1888;6536;396;1486;1234;4289;1630;5775
311547;201305;1618;4687;1408;4357;156;521;966;3032;1122;3553
311550;201305;3123;10746;2847;10202;1057;4255;911;3157;1968;7412
311560;201305;244;695;228;677;59;191;129;370;188;561
311570;201305;1820;4896;1606;4666;142;456;1374;4002;1516;4458
311580;201305;1978;4899;1845;4742;518;1301;1105;2905;1623;4206
311590;201305;342;1145;306;1091;90;378;89;306;179;684
311600;201305;1262;3927;1097;3717;232;791;647;2334;879;3125
311610;201305;3658;12825;3404;12427;939;3422;1763;6957;2702;10379
311615;201305;2386;8402;2176;8055;276;1076;1594;6038;1870;7114
311620;201305;426;1436;384;1375;101;431;197;670;298;1101
311630;201305;1444;4423;1252;4049;230;800;741;2376;971;3176
311640;201305;855;2695;731;2494;103;389;547;1865;650;2254
311650;201305;2394;7053;2013;6426;331;1210;1179;3802;1510;5012
311660;201305;2413;8863;2234;8450;735;3117;586;1961;1321;5078
311670;201305;1267;4169;1136;3918;448;1712;418;1365;866;3077
311680;201305;2176;7086;1867;6675;359;1351;1213;4454;1572;5805
311690;201305;472;1397;410;1332;94;339;254;803;348;1142
311700;201305;2087;6339;1893;6061;214;850;1445;4547;1659;5397
311710;201305;1564;5109;1287;4597;570;2182;373;1350;943;3532
311720;201305;378;1334;364;1313;55;213;265;944;320;1157
311730;201305;3452;10984;2811;9712;905;3385;1137;3737;2042;7122
311740;201305;984;2904;862;2760;380;1200;382;1299;762;2499
311750;201305;3690;12939;3491;12670;624;2532;2372;8628;2996;11160
311760;201305;772;2781;723;2662;271;1139;202;617;473;1756
311770;201305;2563;8347;2164;7668;662;2653;737;2516;1399;5169
311780;201305;907;3523;791;3217;292;1326;95;358;387;1684
311783;201305;2006;6809;1814;6445;215;941;1191;4331;1406;5272
311787;201305;664;2335;518;1912;125;504;118;384;243;888
311790;201305;1090;3739;932;3393;297;1169;182;625;479;1794
311800;201305;4682;16730;3913;14416;1268;4951;704;2225;1972;7176
311810;201305;1008;3459;986;3421;34;163;904;3106;938;3269
311820;201305;782;2636;685;2437;253;1026;294;948;547;1974
311830;201305;9987;37004;9374;35478;4044;16087;2296;8632;6340;24719
311840;201305;3257;10085;2783;9356;1003;3685;975;3226;1978;6911
311850;201305;305;949;264;883;73;269;123;401;196;670
311860;201305;53563;178394;48280;168007;15494;58737;19874;67370;35368;126107
311870;201305;2217;6882;1865;6213;515;1968;688;2191;1203;4159
311880;201305;6464;21209;6065;20698;897;3191;4462;15641;5359;18832
311890;201305;1552;5072;1340;4632;444;1695;531;1767;975;3462
311900;201305;782;2506;706;2394;166;580;417;1478;583;2058
311910;201305;4563;14017;3764;12887;1235;4607;1491;5153;2726;9760
311920;201305;1928;6636;1700;6323;263;1118;1194;4387;1457;5505
311930;201305;4611;14415;4210;13757;1614;5737;1388;4495;3002;10232
311940;201305;13951;44668;12563;41833;4681;16866;3716;12277;8397;29143
311950;201305;2120;6707;1894;6414;167;601;1559;5311;1726;5912
311960;201305;355;1296;331;1249;99;383;172;659;271;1042
311970;201305;449;1672;400;1570;157;671;64;230;221;901
311980;201305;705;2046;561;1846;143;507;253;853;396;1360
311990;201305;448;1447;419;1395;183;619;146;481;329;1100
311995;201305;981;3102;782;2676;260;1005;243;730;503;1735
312000;201305;653;2130;628;2091;118;457;381;1258;499;1715
312010;201305;999;3322;932;3201;212;798;436;1485;648;2283
312015;201305;1526;4899;1340;4579;201;809;826;2843;1027;3652
312020;201305;873;2952;785;2825;239;958;388;1354;627;2312
312030;201305;1650;5365;1510;5182;288;1139;1023;3432;1311;4571
312040;201305;675;2665;628;2536;252;1100;174;686;426;1786
312050;201305;1473;5209;1287;4817;484;1993;349;1258;833;3251
312060;201305;776;2436;704;2350;237;870;381;1226;618;2096
312070;201305;817;2667;578;2150;174;716;205;737;379;1453
312080;201305;2518;7323;2025;6535;555;2198;902;2630;1457;4828
312083;201305;856;2662;744;2504;79;317;509;1707;588;2024
312087;201305;2206;7136;1993;6856;410;1480;1341;4710;1751;6190
312090;201305;9430;31648;8747;30457;2629;10263;3926;13151;6555;23414
312100;201305;1330;4651;1197;4449;266;1115;667;2526;933;3641
312110;201305;1165;4296;1065;4087;423;1785;221;783;644;2568
312120;201305;878;3126;800;2951;262;1106;218;695;480;1801
312125;201305;1041;3507;936;3262;248;957;375;1254;623;2211
312130;201305;709;2282;595;2043;187;713;218;721;405;1434
312140;201305;1411;4550;1210;4074;321;1134;439;1416;760;2550
312150;201305;585;1721;519;1610;104;385;305;901;409;1286
312160;201305;7643;27476;7153;26470;2398;9593;2826;10721;5224;20314
312170;201305;995;3110;921;2963;165;573;574;1882;739;2455
312180;201305;1524;4996;1462;4899;501;1739;593;2023;1094;3762
312190;201305;592;2056;490;1860;213;870;114;420;327;1290
312200;201305;4269;13891;3787;12990;584;2150;2514;8684;3098;10834
312210;201305;1095;3185;914;2933;239;871;454;1398;693;2269
312220;201305;1779;6062;1631;5884;336;1215;1112;4221;1448;5436
312230;201305;16841;58406;14698;53934;7247;28157;2639;10002;9886;38159
312235;201305;1723;5068;1432;4602;192;756;971;3126;1163;3882
312240;201305;1087;3815;945;3509;293;1155;323;1208;616;2363
312245;201305;2286;6955;2024;6593;179;522;1674;5614;1853;6136
312247;201305;860;2663;694;2414;211;786;347;1255;558;2041
312250;201305;1051;3312;982;3202;196;746;573;1831;769;2577
312260;201305;873;2990;770;2854;116;530;540;1969;656;2499
312270;201305;768;2523;671;2327;186;776;212;620;398;1396
312280;201305;463;1623;425;1526;184;713;50;170;234;883
312290;201305;696;2512;652;2452;310;1290;125;464;435;1754
312300;201305;1042;3569;905;3255;312;1191;131;414;443;1605
312310;201305;900;3581;819;3367;280;1240;325;1315;605;2555
312320;201305;2374;6812;2025;6193;589;2076;655;1720;1244;3796
312330;201305;1051;3389;979;3276;373;1388;386;1265;759;2653
312340;201305;290;796;276;777;40;147;214;571;254;718
312350;201305;351;941;337;921;51;164;267;698;318;862
312352;201305;1575;5388;1484;5253;512;1853;776;2816;1288;4669
312360;201305;3492;12244;3096;11388;1088;4258;687;2536;1775;6794
312370;201305;1590;5400;1478;5199;505;1980;550;1867;1055;3847
312380;201305;1862;5707;1769;5576;281;967;1193;3848;1474;4815
312385;201305;1122;3749;1092;3703;154;630;802;2641;956;3271
312390;201305;1913;6772;1748;6405;628;2478;440;1565;1068;4043
312400;201305;3226;11154;3030;10781;1019;3762;1429;5215;2448;8977
312410;201305;9860;34463;9020;32733;3018;11927;2982;10560;6000;22487
312420;201305;3844;12888;3679;12693;693;2470;2583;9140;3276;11610
312430;201305;8203;25434;7280;24055;1512;5236;4485;15373;5997;20609
312440;201305;506;1760;450;1651;161;633;153;553;314;1186
312450;201305;1071;4143;1023;4019;491;1911;331;1330;822;3241
312460;201305;377;1211;338;1163;92;371;156;495;248;866
312470;201305;713;2093;497;1653;147;570;96;298;243;868
312480;201305;1229;3999;1080;3819;430;1586;431;1513;861;3099
312490;201305;2262;6087;1843;5558;306;1108;1109;3227;1415;4335
312500;201305;564;2096;535;2043;157;673;266;1004;423;1677
312510;201305;1730;6294;1553;5876;482;2060;468;1590;950;3650
312520;201305;358;1287;331;1228;123;483;109;407;232;890
312530;201305;546;1861;520;1804;113;459;279;917;392;1376
312540;201305;1430;4806;1208;4350;251;1001;693;2467;944;3468
312550;201305;568;1983;538;1915;78;324;350;1222;428;1546
312560;201305;1911;5505;1761;5305;259;814;1264;3890;1523;4704
312570;201305;2597;8288;2317;7764;792;2880;674;2176;1466;5056
312580;201305;510;1774;418;1586;112;487;179;648;291;1135
312590;201305;1773;6273;1569;5818;574;2372;515;1769;1089;4141
312595;201305;1988;7005;1810;6580;371;1461;1050;3781;1421;5242
312600;201305;739;2798;699;2702;234;996;245;888;479;1884
312610;201305;8182;26564;7151;24511;2790;10279;2040;6804;4830;17083
312620;201305;1906;5808;1527;5341;114;356;1261;4612;1375;4968
312630;201305;480;1669;450;1615;127;529;192;648;319;1177
312640;201305;559;1886;481;1728;123;516;221;752;344;1268
312650;201305;2259;6953;1646;5773;184;772;869;3000;1053;3772
312660;201305;1174;3437;1025;3232;215;787;603;1846;818;2633
312670;201305;5770;18886;5493;18456;875;3406;3885;12978;4760;16384
312675;201305;1429;4717;1303;4469;274;1029;742;2595;1016;3624
312680;201305;1662;5205;1492;4903;297;1105;864;2876;1161;3981
312690;201305;2300;6598;1972;6156;427;1585;1120;3339;1547;4924
312695;201305;838;3113;792;3038;139;555;532;2089;671;2644
312700;201305;2072;6255;1607;5353;355;1352;816;2663;1171;4015
312705;201305;1352;4163;1206;3965;224;752;795;2654;1019;3406
312707;201305;1784;5692;1525;5249;359;1405;737;2531;1096;3936
312710;201305;7613;22491;5897;19437;2421;8858;1412;4332;3833;13190
312720;201305;727;2511;663;2394;200;801;263;894;463;1695
312730;201305;1801;4792;1422;4368;240;875;888;2715;1128;3590
312733;201305;1697;4750;1390;4190;142;537;969;2824;1111;3361
312735;201305;815;2645;734;2500;261;950;319;1064;580;2014
312737;201305;938;2403;706;2099;167;538;379;1164;546;1702
312738;201305;488;1616;402;1454;144;606;149;484;293;1090
312740;201305;483;1419;340;1239;134;532;101;366;235;898
312750;201305;1263;4770;1213;4666;344;1458;569;2177;913;3635
312760;201305;2289;7756;1888;6984;663;2695;454;1702;1117;4397
312770;201305;41380;118221;32937;105792;10375;36172;10862;35079;21237;71251
312780;201305;2335;9002;2134;8662;449;1972;1284;5386;1733;7358
312790;201305;295;883;244;801;81;281;67;214;148;495
312800;201305;4761;17059;4302;16071;1500;5993;1354;5206;2854;11199
312810;201305;2128;6745;1668;6006;707;2769;458;1602;1165;4371
312820;201305;2021;6324;1935;6170;278;1046;1266;3912;1544;4958
312825;201305;1472;4165;1316;3969;140;465;1056;3160;1196;3625
312830;201305;2549;8427;1928;7180;642;2717;250;847;892;3564
312840;201305;1036;3664;913;3433;277;1177;300;1067;577;2244
312850;201305;665;2278;591;2116;180;723;202;713;382;1436
312860;201305;1289;3835;1023;3461;380;1523;393;1173;773;2696
312870;201305;5415;17626;4324;15643;1449;5983;1293;4460;2742;10443
312880;201305;1075;3362;914;3086;300;1149;372;1148;672;2297
312890;201305;1489;4780;1203;4263;474;1862;363;1232;837;3094
312900;201305;1267;4479;1233;4429;466;1712;568;2083;1034;3795
312910;201305;1431;3493;1192;3175;338;1092;571;1399;909;2491
312920;201305;909;3108;808;2952;291;1155;325;1167;616;2322
312930;201305;2092;6523;1904;6239;452;1588;1007;3365;1459;4953
312940;201305;896;3125;805;2943;267;1127;236;800;503;1927
312950;201305;3285;9673;2740;8872;920;3232;1201;3901;2121;7133
312960;201305;1828;5817;1647;5572;221;751;1221;4249;1442;5000
312965;201305;1686;5715;1494;5367;367;1410;827;3055;1194;4465
312970;201305;1116;3925;1006;3775;465;1950;165;612;630;2562
312980;201305;19565;71323;18991;69942;7813;30707;6952;24978;14765;55685
312990;201305;343;1114;278;1007;119;483;78;266;197;749
313000;201305;482;1722;450;1664;156;669;126;424;282;1093
313005;201305;2437;8308;2189;7891;313;1332;1535;5485;1848;6817
313010;201305;3707;12930;3347;12311;1089;4412;1319;4572;2408;8984
313020;201305;1002;3442;925;3285;315;1273;346;1097;661;2370
313030;201305;1521;4447;1248;4059;357;1310;644;1986;1001;3296
313040;201305;931;3349;797;2957;211;858;206;726;417;1584
313050;201305;1759;5994;1503;5580;532;2158;483;1730;1015;3888
313055;201305;1385;4862;1307;4746;133;478;1005;3774;1138;4252
313060;201305;907;3261;862;3162;419;1579;155;576;574;2155
313065;201305;1838;6359;1726;6192;247;1046;1285;4541;1532;5587
313070;201305;1115;3509;963;3235;254;1024;511;1596;765;2620
313080;201305;435;1447;364;1306;122;495;99;298;221;793
313090;201305;4619;15201;4454;14922;1019;3572;2818;9677;3837;13249
313100;201305;974;3304;918;3225;178;731;613;2065;791;2796
313110;201305;1613;5027;1308;4446;350;1420;531;1667;881;3087
313115;201305;2828;10343;2713;10117;976;4026;1162;4103;2138;8129
313120;201305;3701;11009;3194;10250;1192;4030;1301;4264;2493;8294
313130;201305;25096;82818;23070;78548;7203;27251;8567;27734;15770;54985
313140;201305;738;1977;548;1672;60;230;336;1000;396;1230
313150;201305;1596;5160;1459;4915;672;2334;392;1369;1064;3703
313160;201305;1155;3586;1045;3418;259;981;583;1828;842;2809
313170;201305;9215;35206;8773;34046;3724;14975;1939;7654;5663;22629
313180;201305;2603;7121;2065;6432;688;2432;709;2148;1397;4580
313190;201305;3171;12213;3092;12030;955;3900;1330;5206;2285;9106
313200;201305;1411;4653;1278;4434;211;900;792;2732;1003;3632
313210;201305;4475;14709;3860;13870;928;3700;2128;7639;3056;11339
313220;201305;1065;3496;935;3225;292;1156;231;694;523;1850
313230;201305;2342;8689;2254;8543;435;1737;1393;5501;1828;7238
313240;201305;7203;26170;6413;24601;2037;8486;2479;9543;4516;18029
313250;201305;7453;24502;7013;23949;823;2698;5401;19268;6224;21966
313260;201305;553;1832;481;1684;161;638;130;433;291;1071
313270;201305;5107;16005;4689;15372;1102;3832;2804;9354;3906;13186
313280;201305;508;1775;442;1617;114;479;164;581;278;1060
313290;201305;1029;3824;886;3522;301;1288;220;810;521;2098
313300;201305;1883;6676;1702;6245;568;2264;484;1686;1052;3950
313310;201305;1022;3698;942;3520;295;1241;223;788;518;2029
313320;201305;2296;7321;1987;6775;394;1409;973;3388;1367;4797
313330;201305;3706;12909;3434;12396;774;3112;1790;6502;2564;9614
313340;201305;2110;5240;1657;4598;357;1083;952;2566;1309;3649
313350;201305;3236;10423;2588;8997;857;3265;568;1810;1425;5075
313360;201305;1142;3657;903;3172;329;1332;354;1111;683;2443
313370;201305;1396;5021;1336;4856;302;1263;604;2045;906;3308
313375;201305;1827;5064;1289;4323;295;1214;632;2065;927;3279
313380;201305;6347;22597;5631;21011;2412;9582;1415;5014;3827;14596
313390;201305;871;3306;836;3244;147;678;522;1983;669;2661
313400;201305;3566;11098;3308;10785;448;1539;2505;8278;2953;9817
313410;201305;1336;3970;1155;3732;248;891;709;2281;957;3172
313420;201305;17794;46267;11992;35653;3151;10670;3204;9131;6355;19801
313430;201305;1270;4297;1152;4088;384;1512;413;1430;797;2942
313440;201305;6134;15356;4779;13803;823;2580;3344;9691;4167;12271
313450;201305;677;2088;579;1901;169;677;200;578;369;1255
313460;201305;2603;9509;2380;9132;932;3875;734;2687;1666;6562
313470;201305;3348;9663;3209;9502;372;1031;2642;8007;3014;9038
313480;201305;1083;3359;842;2918;198;778;345;1155;543;1933
313490;201305;1180;4536;1061;4232;470;1834;196;817;666;2651
313500;201305;424;1388;403;1351;106;406;232;757;338;1163
313505;201305;7821;24742;7432;24246;527;1442;6509;21955;7036;23397
313507;201305;1258;3947;1145;3773;264;989;657;2176;921;3165
313510;201305;15279;47253;13862;45446;2588;9032;9347;31127;11935;40159
313520;201305;15429;48581;13524;45571;2014;7935;9156;30730;11170;38665
313530;201305;508;1821;452;1677;70;302;200;695;270;997
313535;201305;2392;7505;2173;7145;395;1411;1361;4537;1756;5948
313540;201305;1117;3605;940;3186;290;1055;263;842;553;1897
313545;201305;1352;5136;1213;4896;234;1111;767;3030;1001;4141
313550;201305;1859;6620;1810;6507;515;2012;972;3371;1487;5383
313560;201305;2181;5699;1971;5453;190;518;1613;4573;1803;5091
313570;201305;740;2875;670;2733;253;1106;281;1130;534;2236
313580;201305;5860;17460;5281;16703;668;2252;4045;12908;4713;15160
313590;201305;1043;3240;866;3030;335;1183;462;1678;797;2861
313600;201305;3788;11877;3400;11251;706;2608;2027;6748;2733;9356
313610;201305;1104;3600;970;3326;284;1047;386;1305;670;2352
313620;201305;7346;25191;6946;24325;2450;9146;2330;8005;4780;17151
313630;201305;8070;26399;7212;25145;2423;9251;2456;8903;4879;18154
313640;201305;828;2723;738;2604;269;1026;301;1057;570;2083
313650;201305;2256;7594;2020;7204;307;1152;1460;5324;1767;6476
313652;201305;971;3637;907;3495;187;767;541;2087;728;2854
313655;201305;909;3200;796;3022;187;828;504;1858;691;2686
313657;201305;1039;3730;1004;3667;190;896;656;2202;846;3098
313660;201305;851;3083;789;2974;229;997;394;1408;623;2405
313665;201305;3491;12038;3290;11625;941;3743;1479;5024;2420;8767
313670;201305;50178;151441;37038;129617;12983;49495;11544;39452;24527;88947
313680;201305;1067;3290;954;3127;127;434;679;2264;806;2698
313690;201305;861;3189;813;3110;247;948;330;1328;577;2276
313695;201305;1454;4962;1269;4671;205;890;884;3209;1089;4099
313700;201305;3715;13026;3239;12345;475;1923;2344;9020;2819;10943
313710;201305;1338;3945;1155;3685;329;1169;633;1948;962;3117
313720;201305;4971;17418;4456;16266;1309;5349;1419;4684;2728;10033
313730;201305;1217;3539;1012;3278;157;551;677;2232;834;2783
313740;201305;1988;7414;1664;6547;683;2994;234;871;917;3865
313750;201305;2847;8985;2538;8397;857;3106;692;2126;1549;5232
313753;201305;1752;5511;1539;5135;501;1811;634;2125;1135;3936
313760;201305;4344;15001;3806;13841;1381;5621;1167;3990;2548;9611
313770;201305;3571;12396;3421;12048;1268;4709;1046;3706;2314;8415
313780;201305;3708;11121;3054;10135;950;3523;1219;3985;2169;7508
313790;201305;548;1956;531;1928;108;422;313;1148;421;1570
313800;201305;1221;3593;1106;3402;188;668;710;2163;898;2831
313810;201305;1385;4525;1336;4449;324;1108;770;2631;1094;3739
313820;201305;12486;37933;10377;34069;3403;12412;3365;10993;6768;23405
313830;201305;459;1645;396;1508;157;674;106;379;263;1053
313835;201305;1048;3629;1011;3567;236;910;558;1968;794;2878
313840;201305;6934;22015;6084;20616;1922;7324;2185;7151;4107;14475
313850;201305;1229;3550;1129;3376;244;853;673;1917;917;2770
313860;201305;2496;8101;2221;7530;743;2787;544;1682;1287;4469
313862;201305;885;2672;660;2299;239;895;173;570;412;1465
313865;201305;2144;7105;2018;6880;329;1289;1407;4719;1736;6008
313867;201305;956;3444;830;3181;259;1037;330;1292;589;2329
313868;201305;1440;5348;1332;5123;222;939;851;3309;1073;4248
313870;201305;912;2890;810;2720;214;837;371;1168;585;2005
313880;201305;2221;7294;2041;7029;509;2072;1038;3294;1547;5366
313890;201305;1944;5598;1688;5288;211;675;1226;3929;1437;4604
313900;201305;4424;16753;4202;16291;1754;7438;1115;4329;2869;11767
313910;201305;740;2600;641;2384;293;1196;130;448;423;1644
313920;201305;3471;11661;3255;11277;514;1755;2176;7915;2690;9670
313925;201305;2087;5724;1591;4820;142;504;1073;3226;1215;3730
313930;201305;5088;17447;4422;16283;872;3543;2583;9711;3455;13254
313940;201305;7558;27409;6692;25988;2753;11379;2349;9398;5102;20777
313950;201305;4502;13775;3907;12796;1211;4432;1485;4788;2696;9220
313960;201305;5584;16158;4859;15115;1711;5963;1375;4317;3086;10280
313970;201305;1414;4325;1216;4099;262;967;762;2579;1024;3546
313980;201305;1148;3964;993;3667;324;1328;249;887;573;2215
313990;201305;1995;7727;1809;7315;712;3111;525;2013;1237;5124
314000;201305;7517;27196;7063;26311;2237;9053;3440;12757;5677;21810
314010;201305;1019;3130;864;2937;188;719;456;1518;644;2237
314015;201305;1568;6034;1457;5775;582;2424;421;1703;1003;4127
314020;201305;474;1590;410;1447;161;626;131;442;292;1068
314030;201305;807;2674;647;2300;159;671;193;612;352;1283
314040;201305;672;2105;606;1990;105;393;415;1325;520;1718
314050;201305;1838;6188;1560;5601;512;2036;418;1383;930;3419
314053;201305;1317;4689;1264;4619;230;814;911;3422;1141;4236
314055;201305;2171;6722;1983;6464;222;744;1490;4975;1712;5719
314060;201305;1065;3540;934;3299;157;648;558;1936;715;2584
314070;201305;3518;11678;2956;10517;950;3735;893;3072;1843;6807
314080;201305;1756;5724;1355;4852;354;1456;343;1119;697;2575
314085;201305;1735;6474;1542;6209;545;2410;636;2577;1181;4987
314090;201305;3413;12058;3147;11538;1059;4149;1220;4599;2279;8748
314100;201305;3307;9435;2935;8898;427;1344;2160;6654;2587;7998
314110;201305;4303;14661;3817;13626;1044;4306;1470;4855;2514;9161
314120;201305;919;2302;545;1736;213;779;131;381;344;1160
314130;201305;612;1912;412;1449;130;514;77;249;207;763
314140;201305;4888;15898;4488;15164;1149;4201;2357;8038;3506;12239
314150;201305;1649;4589;1345;4131;233;798;825;2511;1058;3309
314160;201305;2153;6275;1887;5931;205;719;1513;4767;1718;5486
314170;201305;1028;3343;899;3058;180;719;483;1572;663;2291
314180;201305;6248;21123;5786;20439;1706;6562;2704;9715;4410;16277
314190;201305;802;2620;716;2478;230;906;281;932;511;1838
314200;201305;2968;10039;2735;9625;467;1873;1825;6342;2292;8215
314210;201305;1887;6258;1723;5937;462;1731;825;2751;1287;4482
314220;201305;1603;5511;1426;5133;488;1943;477;1549;965;3492
314225;201305;1134;3632;1025;3477;63;181;924;3201;987;3382
314230;201305;692;2487;647;2396;215;862;230;822;445;1684
314240;201305;1082;3578;998;3437;301;1024;546;1942;847;2966
314250;201305;484;1581;420;1455;157;599;136;426;293;1025
314260;201305;1276;4719;1232;4634;449;1789;513;1963;962;3752
314270;201305;2645;9525;2503;9258;389;1563;1623;6070;2012;7633
314280;201305;3108;9277;2341;7818;778;2981;647;1902;1425;4883
314290;201305;5213;15301;4545;14253;608;2107;3251;10221;3859;12328
314300;201305;1886;6611;1790;6387;634;2412;724;2544;1358;4956
314310;201305;6149;20639;5538;19276;2401;8902;1168;3929;3569;12831
314315;201305;953;3714;893;3592;169;756;511;2101;680;2857
314320;201305;3204;10160;2697;9448;1052;4013;862;2937;1914;6950
314330;201305;49785;168989;47840;165453;15754;58937;22016;75376;37770;134313
314340;201305;2040;6062;1273;4432;345;1361;155;369;500;1730
314345;201305;1272;4494;1138;4279;393;1520;531;2098;924;3618
314350;201305;1237;4030;1093;3776;488;1818;280;952;768;2770
314360;201305;681;2250;543;1999;184;788;135;445;319;1233
314370;201305;536;1968;505;1929;169;707;256;957;425;1664
314380;201305;980;3184;798;2876;334;1262;232;843;566;2105
314390;201305;14552;46047;12503;42100;4309;15698;3807;12632;8116;28330
314400;201305;5181;15249;4317;14038;1069;3407;2749;9317;3818;12724
314410;201305;2419;8195;2194;7748;729;2894;863;2868;1592;5762
314420;201305;753;2291;636;2130;102;420;466;1525;568;1945
314430;201305;8062;24795;7278;23339;2575;8990;2285;7533;4860;16523
314435;201305;1115;3898;1014;3685;232;1044;526;1796;758;2840
314437;201305;1126;2983;1024;2844;101;286;814;2281;915;2567
314440;201305;731;2058;513;1772;200;771;112;366;312;1137
314450;201305;1695;5228;1465;4894;480;1906;678;2104;1158;4010
314460;201305;4508;16155;4072;15199;1501;6074;804;3043;2305;9117
314465;201305;2333;7706;2149;7362;235;960;1627;5498;1862;6458
314467;201305;1059;3202;963;3042;436;1409;349;1145;785;2554
314470;201305;2299;7794;1819;6627;587;2449;384;1177;971;3626
314480;201305;7004;24943;5478;20756;1485;6089;598;2084;2083;8173
314490;201305;920;2936;800;2696;257;1007;318;996;575;2003
314500;201305;2736;8006;2237;7028;725;2546;753;2332;1478;4878
314505;201305;1698;5598;1617;5445;424;1573;867;2901;1291;4474
314510;201305;1427;4708;1245;4374;546;2023;350;1223;896;3246
314520;201305;3466;14036;3051;12808;1229;5564;589;2319;1818;7883
314530;201305;7054;25910;6503;24995;1289;5186;3890;15486;5179;20672
314535;201305;2598;7828;2341;7490;370;1365;1562;5004;1932;6369
314537;201305;1425;4499;1220;4138;283;1067;613;2166;896;3233
314540;201305;458;1445;403;1318;131;494;125;379;256;873
314545;201305;1257;4263;1172;4126;257;983;651;2318;908;3301
314550;201305;497;1626;428;1531;165;684;116;389;281;1073
314560;201305;5112;18783;4475;17071;1408;5826;936;3543;2344;9369
314570;201305;369;1189;334;1119;100;360;158;510;258;870
314580;201305;452;1606;391;1482;167;693;91;333;258;1026
314585;201305;634;2344;542;2154;179;781;137;534;316;1315
314587;201305;1667;5613;1560;5391;279;1050;926;3194;1205;4244
314590;201305;3956;14162;3069;11748;843;3462;415;1468;1258;4930
314600;201305;1996;7085;1682;6523;660;2850;296;1065;956;3915
314610;201305;7900;29372;7479;28372;2696;11012;2267;8410;4963;19422
314620;201305;1606;5104;1507;4982;226;723;1121;3826;1347;4549
314625;201305;1324;4510;1278;4429;253;972;770;2726;1023;3698
314630;201305;4896;15114;4316;14144;595;2193;3004;10029;3599;12222
314640;201305;794;2398;710;2250;260;896;213;636;473;1532
314650;201305;1220;3909;1015;3502;292;1168;425;1335;717;2503
314655;201305;1666;5209;1361;4659;263;1010;751;2549;1014;3559
314660;201305;149;450;138;429;35;119;78;233;113;352
314670;201305;1355;3972;1144;3601;239;829;619;1934;858;2763
314675;201305;1859;5865;1669;5532;230;841;1106;3736;1336;4577
314690;201305;2703;8845;2321;8158;757;3016;708;2335;1465;5351
314700;201305;9684;37947;8835;36164;4273;18202;2012;8700;6285;26902
314710;201305;7580;25622;5677;21261;1585;6648;734;2554;2319;9202
314720;201305;2584;8927;2205;8187;757;3104;901;3277;1658;6381
314730;201305;2352;7718;2053;7278;706;2788;654;2214;1360;5002
314740;201305;2888;10137;2689;9753;958;3744;990;3475;1948;7219
314750;201305;311;1065;291;1017;63;271;158;526;221;797
314760;201305;1796;6625;1415;5570;357;1608;258;852;615;2460
314770;201305;1167;3829;814;2853;150;617;105;293;255;910
314780;201305;284;826;217;741;81;304;87;296;168;600
314790;201305;13102;41390;10188;36158;4215;16867;2412;8034;6627;24901
314795;201305;1481;4661;1330;4417;155;681;997;3170;1152;3851
314800;201305;16544;52168;14119;47369;6042;21341;2929;10096;8971;31437
314810;201305;12488;39380;10001;34748;3460;13522;2508;8589;5968;22111
314820;201305;1039;3023;755;2637;319;1222;241;770;560;1992
314830;201305;1606;5703;1414;5320;563;2310;466;1755;1029;4065
314840;201305;1125;4034;905;3704;184;854;535;2209;719;3063
314850;201305;2166;6567;1902;6162;404;1508;1054;3391;1458;4899
314860;201305;3193;11515;3009;11229;608;2473;1894;7140;2502;9613
314870;201305;5533;18640;5009;17898;893;3575;3297;12021;4190;15596
314875;201305;1650;5857;1622;5816;293;972;1260;4655;1553;5627
314880;201305;745;2341;686;2218;111;382;436;1402;547;1784
314890;201305;571;1818;423;1511;139;553;99;297;238;850
314900;201305;335;1120;285;1037;87;340;137;483;224;823
314910;201305;1650;5936;1485;5671;697;2885;359;1290;1056;4175
314915;201305;2383;7698;2146;7376;218;905;1749;5975;1967;6880
314920;201305;640;1933;513;1758;101;402;264;857;365;1259
314930;201305;4932;17369;4375;16135;1623;6564;922;3370;2545;9934
314940;201305;403;1233;380;1191;86;265;210;661;296;926
314950;201305;359;1305;317;1207;102;443;54;181;156;624
314960;201305;760;2580;657;2381;214;851;178;608;392;1459
314970;201305;778;2912;726;2808;322;1348;234;874;556;2222
314980;201305;2196;6899;2019;6618;872;3071;317;994;1189;4065
314990;201305;2997;9971;2479;8782;995;3830;392;1251;1387;5081
314995;201305;1464;4871;1355;4712;296;1229;838;2778;1134;4007
315000;201305;949;3034;841;2891;170;690;530;1771;700;2461
315010;201305;459;1547;393;1400;141;579;133;418;274;997
315015;201305;1747;5639;1658;5537;346;1218;1147;3933;1493;5151
315020;201305;723;2482;659;2360;205;839;252;808;457;1647
315030;201305;996;3137;867;2897;354;1290;174;570;528;1860
315040;201305;913;2889;846;2780;112;417;599;1949;711;2366
315050;201305;1490;4695;1300;4361;509;1878;367;1177;876;3055
315053;201305;1081;3313;948;3102;274;1082;355;1071;629;2153
315057;201305;1860;6650;1547;6183;249;1024;1022;4230;1271;5254
315060;201305;931;3229;780;2829;246;968;201;754;447;1722
315070;201305;610;1879;570;1821;144;496;345;1086;489;1582
315080;201305;3304;11898;3080;11455;936;3718;1379;5160;2315;8878
315090;201305;745;2746;668;2586;195;823;232;934;427;1757
315100;201305;1144;4091;937;3619;279;1233;282;1051;561;2284
315110;201305;1561;4916;1395;4645;418;1491;589;1944;1007;3435
315120;201305;12180;31652;9551;28277;1930;6265;5346;16599;7276;22864
315130;201305;1729;5913;1583;5631;624;2449;431;1495;1055;3944
315140;201305;2245;7805;1887;6989;577;2445;510;1649;1087;4094
315150;201305;4347;12573;3487;11045;945;3444;1338;4033;2283;7477
315160;201305;1310;3802;1197;3659;239;822;757;2266;996;3088
315170;201305;1296;4006;1147;3804;295;1100;641;2142;936;3242
315180;201305;12321;40335;10162;35705;3245;12990;2616;8774;5861;21764
315190;201305;2292;6394;1876;5786;587;1956;855;2642;1442;4598
315200;201305;4009;14184;3543;13201;1196;4890;988;3540;2184;8430
315210;201305;8071;26115;7180;24517;2904;10650;2132;7158;5036;17808
315213;201305;1038;3529;1001;3470;129;436;769;2749;898;3185
315217;201305;2588;9185;2259;8591;396;1695;1340;5092;1736;6787
315220;201305;9763;30017;8816;28787;1221;4442;6387;21033;7608;25475
315230;201305;2265;6419;2129;6259;153;471;1810;5376;1963;5847
315240;201305;3005;10421;2867;10185;661;2533;1645;5856;2306;8389
315250;201305;7789;26869;6394;24332;2372;10075;2042;7692;4414;17767
315260;201305;1033;3555;910;3288;386;1518;150;492;536;2010
315270;201305;857;3122;749;2884;264;1094;158;567;422;1661
315280;201305;3727;11940;3166;10669;1186;4259;810;2578;1996;6837
315290;201305;1290;3814;1019;3382;418;1537;169;546;587;2083
315300;201305;468;1422;385;1318;201;743;103;317;304;1060
315310;201305;1158;4036;1086;3923;147;607;744;2652;891;3259
315320;201305;772;2810;686;2678;253;1031;285;1159;538;2190
315330;201305;818;3041;686;2760;300;1363;125;482;425;1845
315340;201305;4045;12111;3531;11316;661;2265;2135;6962;2796;9227
315350;201305;1769;5259;1532;4940;174;531;1224;4080;1398;4611
315360;201305;1622;5698;1407;5124;388;1503;475;1662;863;3165
315370;201305;606;1863;539;1764;138;513;291;923;429;1436
315380;201305;271;993;254;943;96;372;48;176;144;548
315390;201305;1896;6889;1649;6273;612;2474;343;1298;955;3772
315400;201305;4262;14002;3974;13443;1169;4202;1939;6746;3108;10948
315410;201305;1601;4688;1361;4269;285;1094;737;2185;1022;3279
315415;201305;1025;3629;966;3518;461;1720;333;1253;794;2973
315420;201305;1492;4804;1159;4227;386;1544;276;965;662;2509
315430;201305;3845;10944;3051;9630;812;2849;1182;3695;1994;6544
315440;201305;948;2989;876;2892;143;545;575;1917;718;2462
315445;201305;2024;6214;1776;5883;294;1069;1231;4129;1525;5198
315450;201305;2421;8069;2319;7921;411;1446;1652;5779;2063;7225
315460;201305;37112;128338;33507;120560;11518;45082;9802;34038;21320;79120
315470;201305;466;1547;436;1499;102;381;250;839;352;1220
315480;201305;1371;4725;1082;4062;294;1205;260;945;554;2150
315490;201305;3180;9317;2823;8841;544;2094;1777;5338;2321;7432
315500;201305;462;1538;319;1166;78;334;130;412;208;746
315510;201305;1449;4377;1261;4061;187;751;792;2479;979;3230
315520;201305;1112;3661;956;3458;192;786;622;2190;814;2976
315530;201305;472;1712;448;1673;218;867;133;469;351;1336
315540;201305;1250;3921;1026;3572;227;971;422;1424;649;2395
315550;201305;1566;4821;1396;4595;462;1667;625;2039;1087;3706
315560;201305;6550;23209;6240;22763;1005;4038;4310;15770;5315;19808
315570;201305;2336;7547;2216;7382;368;1363;1528;5121;1896;6484
315580;201305;2571;8296;2126;7442;644;2621;771;2538;1415;5159
315590;201305;852;2575;800;2496;118;446;581;1784;699;2230
315600;201305;2506;9453;2140;8892;332;1514;1415;6121;1747;7635
315610;201305;944;2946;831;2705;238;904;273;756;511;1660
315620;201305;324;1180;319;1169;101;384;151;561;252;945
315630;201305;978;3206;844;2974;245;908;228;785;473;1693
315640;201305;731;2402;644;2218;242;951;196;620;438;1571
315645;201305;764;2601;685;2394;265;1028;148;494;413;1522
315650;201305;1790;5583;1687;5449;166;700;1307;4105;1473;4805
315660;201305;2556;7302;2355;7032;366;1224;1634;4843;2000;6067
315670;201305;11132;40946;10313;39291;3971;16256;3315;12365;7286;28621
315680;201305;2776;10043;2341;9210;931;3836;600;2480;1531;6316
315690;201305;2937;9890;2543;9163;967;3818;682;2451;1649;6269
315700;201305;6820;22881;6152;21492;1502;5956;2994;10015;4496;15971
315710;201305;1793;5519;1487;5031;258;1061;850;2807;1108;3868
315720;201305;2758;9740;2566;9330;817;3349;908;3098;1725;6447
315725;201305;1580;5064;1314;4733;297;1054;893;3290;1190;4344
315727;201305;628;2100;585;2000;148;537;311;1059;459;1596
315730;201305;965;3146;876;2964;260;918;405;1420;665;2338
315733;201305;1078;3579;1000;3407;470;1699;305;1013;775;2712
315737;201305;1337;4280;1161;3986;165;636;753;2607;918;3243
315740;201305;999;3346;872;3097;287;1163;343;1135;630;2298
315750;201305;1066;3453;956;3304;140;582;670;2253;810;2835
315760;201305;830;2630;821;2614;45;150;748;2395;793;2545
315765;201305;1415;4633;1334;4494;188;661;985;3383;1173;4044
315770;201305;1594;5219;1484;4995;450;1644;622;2051;1072;3695
315780;201305;26067;88612;24707;85794;9365;34354;8492;30132;17857;64486
315790;201305;2984;10684;2797;10287;357;1265;1897;7220;2254;8485
315800;201305;1496;6032;1267;5348;436;2005;213;858;649;2863
315810;201305;1442;4325;1258;4021;244;868;764;2350;1008;3218
315820;201305;3036;10298;2632;9708;650;2570;1447;5416;2097;7986
315830;201305;1460;5043;1343;4786;357;1447;461;1582;818;3029
315840;201305;657;1897;529;1630;107;362;149;443;256;805
315850;201305;1343;4882;1299;4780;408;1568;504;1826;912;3394
315860;201305;397;1483;345;1375;109;480;106;446;215;926
315870;201305;453;1414;400;1330;109;415;155;477;264;892
315880;201305;1016;2908;876;2731;281;980;379;1166;660;2146
315890;201305;1584;5628;1450;5429;405;1538;812;3197;1217;4735
315895;201305;4803;15589;4508;15023;1562;5689;1783;5801;3345;11490
315900;201305;731;2457;680;2371;222;887;307;989;529;1876
315910;201305;599;2186;553;2090;243;953;194;716;437;1669
315920;201305;1111;3680;1000;3465;380;1433;398;1311;778;2744
315930;201305;1040;3066;908;2830;313;1051;298;919;611;1970
315935;201305;1111;3878;1040;3722;360;1413;321;1125;681;2538
315940;201305;603;2001;570;1951;157;585;317;1062;474;1647
315950;201305;1184;3802;1118;3673;341;1143;608;2041;949;3184
315960;201305;2620;9546;2238;8699;1039;4574;224;810;1263;5384
315970;201305;770;2280;647;2088;85;280;478;1580;563;1860
315980;201305;3876;10197;2876;8479;828;2830;934;2427;1762;5257
315990;201305;4203;13050;3744;12296;874;3352;2046;6578;2920;9930
316000;201305;548;1888;484;1763;250;971;106;371;356;1342
316010;201305;419;1580;377;1481;126;565;63;200;189;765
316020;201305;1162;3871;936;3480;185;756;532;2023;717;2779
316030;201305;3544;10420;2618;8943;395;1506;1443;5072;1838;6578
316040;201305;3263;10463;2458;8620;506;2027;513;1545;1019;3572
316045;201305;2012;6780;1895;6610;307;958;1339;5010;1646;5968
316050;201305;316;1120;301;1090;63;255;177;636;240;891
316060;201305;754;2391;641;2238;131;561;394;1306;525;1867
316070;201305;5800;20067;5445;19340;1874;7292;2344;7990;4218;15282
316080;201305;713;2727;646;2543;176;775;157;615;333;1390
316090;201305;584;1787;454;1526;130;504;118;350;248;854
316095;201305;1125;3949;1067;3813;235;868;663;2456;898;3324
316100;201305;2805;9839;2357;8695;806;3309;490;1718;1296;5027
316105;201305;845;2467;670;2209;173;636;323;1056;496;1692
316110;201305;11878;43799;10869;41855;1511;6552;7853;30641;9364;37193
316120;201305;1247;4490;1221;4453;436;1622;593;2241;1029;3863
316130;201305;907;2376;711;2064;223;768;259;685;482;1453
316140;201305;1000;3135;801;2804;169;645;437;1559;606;2204
316150;201305;1216;3951;1160;3863;326;1251;609;1942;935;3193
316160;201305;1193;3731;1005;3356;138;515;610;2055;748;2570
316165;201305;862;2557;756;2379;159;575;414;1271;573;1846
316170;201305;1309;4028;1051;3527;246;970;442;1351;688;2321
316180;201305;1158;3851;1006;3593;315;1346;370;1204;685;2550
316190;201305;2535;7932;1636;5760;401;1557;331;1017;732;2574
316200;201305;4016;13425;3275;11967;965;4120;941;3240;1906;7360
316210;201305;4803;16088;4529;15544;2240;8195;976;3366;3216;11561
316220;201305;619;1978;470;1719;150;620;77;302;227;922
316225;201305;982;3119;903;3002;165;620;571;1878;736;2498
316230;201305;414;1326;354;1213;66;249;198;686;264;935
316240;201305;5963;20183;5293;19374;629;2177;4230;15912;4859;18089
316245;201305;2720;10402;2607;10237;246;1067;2114;8393;2360;9460
316250;201305;8379;27577;7603;25953;3456;12615;2032;6556;5488;19171
316255;201305;2269;7478;2048;7220;326;1082;1515;5499;1841;6581
316257;201305;1232;3655;990;3224;313;1161;317;952;630;2113
316260;201305;1727;5059;1342;4511;467;1727;653;2158;1120;3885
316265;201305;1137;3422;1025;3189;89;327;734;2257;823;2584
316270;201305;5142;17011;4829;16382;1521;5614;2025;6961;3546;12575
316280;201305;3191;11024;2892;10428;681;2742;1426;5128;2107;7870
316290;201305;2941;10200;2793;9911;832;3316;1212;4073;2044;7389
316292;201305;3631;12489;3375;11982;1036;4123;1428;4788;2464;8911
316294;201305;859;2978;587;2298;159;717;81;310;240;1027
316295;201305;1855;6797;1734;6539;494;2138;813;2855;1307;4993
316300;201305;888;3107;818;2974;99;374;570;2146;669;2520
316310;201305;628;2117;522;1887;145;586;195;691;340;1277
316320;201305;531;1846;482;1777;181;753;168;571;349;1324
316330;201305;903;2852;801;2677;174;583;446;1559;620;2142
316340;201305;1083;3705;1007;3563;387;1525;250;800;637;2325
316350;201305;1443;4914;1321;4707;270;985;751;2851;1021;3836
316360;201305;726;1992;592;1818;71;230;456;1406;527;1636
316370;201305;4842;16589;4427;15722;1540;5797;1117;4080;2657;9877
316380;201305;1332;3977;1135;3651;153;546;761;2459;914;3005
316390;201305;859;2730;743;2538;272;993;295;1032;567;2025
316400;201305;1432;4951;1297;4726;386;1483;598;2266;984;3749
316410;201305;1190;4154;1118;4040;225;908;703;2527;928;3435
316420;201305;1945;6863;1837;6707;314;1250;1201;4501;1515;5751
316430;201305;827;2661;729;2503;248;916;277;922;525;1838
316440;201305;562;1958;503;1881;201;878;222;747;423;1625
316443;201305;654;2102;574;1928;157;586;204;661;361;1247
316447;201305;1287;4442;1235;4344;214;830;913;3187;1127;4017
316450;201305;2105;7774;1904;7374;468;1788;1044;4263;1512;6051
316460;201305;770;2517;724;2445;196;756;427;1371;623;2127
316470;201305;6470;23456;5913;22214;2284;9621;1775;6216;4059;15837
316480;201305;251;907;226;855;73;290;73;271;146;561
316490;201305;348;1152;335;1126;129;451;142;475;271;926
316500;201305;1052;3928;757;3020;219;936;60;227;279;1163
316510;201305;921;3448;841;3295;385;1583;278;1080;663;2663
316520;201305;1094;3600;938;3363;312;1285;341;1124;653;2409
316530;201305;1180;3927;1002;3536;288;1223;401;1221;689;2444
316540;201305;985;3322;890;3162;299;1258;305;972;604;2230
316550;201305;1230;4322;1137;4173;245;997;726;2662;971;3659
316553;201305;2146;8105;1828;7280;689;2942;379;1473;1068;4415
316555;201305;2554;9586;2380;9380;197;734;1979;8053;2176;8787
316556;201305;564;1697;475;1515;57;230;312;942;369;1172
316557;201305;863;3212;840;3169;311;1219;412;1543;723;2762
316560;201305;341;1184;301;1106;78;345;99;329;177;674
316570;201305;1326;4426;1241;4241;249;943;715;2435;964;3378
316580;201305;230;778;213;739;82;297;77;252;159;549
316590;201305;1264;3998;1098;3707;206;829;657;2171;863;3000
316600;201305;1103;3873;1004;3651;264;1036;489;1728;753;2764
316610;201305;585;2275;553;2221;164;730;296;1164;460;1894
316620;201305;2010;6891;1884;6628;574;2167;821;2926;1395;5093
316630;201305;1358;4883;1273;4680;550;2146;370;1320;920;3466
316640;201305;251;853;228;807;70;291;87;285;157;576
316650;201305;907;3670;815;3505;200;855;441;2014;641;2869
316660;201305;132;416;114;385;31;138;50;148;81;286
316670;201305;1546;4891;1320;4435;519;1966;367;1105;886;3071
316680;201305;1839;5757;1660;5474;238;823;1264;4210;1502;5033
316690;201305;1049;3685;971;3569;392;1608;317;1108;709;2716
316695;201305;1234;3940;1114;3731;127;408;780;2741;907;3149
316700;201305;346;1216;325;1168;96;413;152;505;248;918
316710;201305;3320;13226;2939;12355;1015;4407;936;4134;1951;8541
316720;201305;19638;68316;17137;62709;6446;24850;4598;16806;11044;41656
316730;201305;414;1375;364;1264;99;376;185;595;284;971
316740;201305;715;2572;659;2468;273;1102;172;605;445;1707
316750;201305;387;1441;362;1388;126;532;124;452;250;984
316760;201305;3475;12086;2996;11551;1782;6842;910;3752;2692;10594
316770;201305;1421;4423;1263;4199;246;914;802;2727;1048;3641
316780;201305;676;2402;641;2333;288;1106;155;550;443;1656
316790;201305;820;2464;617;2106;181;721;236;781;417;1502
316800;201305;5922;20283;5439;19353;1209;5023;2921;9998;4130;15021
316805;201305;880;2385;836;2329;157;422;598;1728;755;2150
316810;201305;498;1607;469;1553;134;489;236;763;370;1252
316820;201305;301;976;250;883;113;434;46;151;159;585
316830;201305;570;2135;550;2089;214;858;206;772;420;1630
316840;201305;3300;10020;2890;9376;891;3281;1204;3753;2095;7034
316850;201305;2033;6719;1898;6476;484;1846;976;3276;1460;5122
316860;201305;22733;73565;21336;71056;6299;23272;9755;32455;16054;55727
316870;201305;6757;23388;6109;21845;2445;9404;1396;4843;3841;14247
316880;201305;848;2994;824;2958;374;1442;224;777;598;2219
316890;201305;1330;3634;1076;3283;510;1704;317;925;827;2629
316900;201305;2470;8238;2305;7892;761;2896;710;2196;1471;5092
316905;201305;386;1422;367;1377;156;618;107;396;263;1014
316910;201305;657;2332;564;2140;151;611;257;991;408;1602
316920;201305;1433;4588;1156;4106;186;745;555;1965;741;2710
316930;201305;9237;32690;8381;31030;2782;11740;2745;9766;5527;21506
316935;201305;4689;14403;3517;12328;1283;5002;930;3078;2213;8080
316940;201305;6445;22777;5685;21166;1613;6801;1707;6033;3320;12834
316950;201305;1409;4396;1262;4198;236;907;810;2651;1046;3558
316960;201305;5040;13765;4374;12943;945;3079;2692;7990;3637;11069
316970;201305;3351;11557;3181;11234;1399;5533;836;2683;2235;8216
316980;201305;907;2964;756;2722;365;1401;216;779;581;2180
316990;201305;9400;32561;8727;31061;3767;14553;1478;5053;5245;19606
317000;201305;2402;9131;2338;9047;295;910;1937;7854;2232;8764
317005;201305;2226;7618;2153;7514;451;1653;1492;5217;1943;6870
317010;201305;26034;76493;18874;63603;5827;21767;4804;16758;10631;38525
317020;201305;38805;122884;28612;100779;8599;33404;6096;20177;14695;53581
317030;201305;854;2472;721;2270;131;502;410;1283;541;1785
317040;201305;12166;38599;11065;36600;4327;14903;4022;13664;8349;28567
317043;201305;762;2241;642;2076;220;758;281;902;501;1660
317047;201305;1121;3158;915;2837;176;604;444;1388;620;1992
317050;201305;1727;6468;1550;6034;503;2138;478;1771;981;3909
317052;201305;2180;7564;1962;7246;413;1572;1310;4986;1723;6558
317057;201305;1667;5056;1333;4488;230;923;711;2381;941;3304
317060;201305;376;1154;288;954;87;326;107;332;194;658
317065;201305;1201;4163;1104;4011;144;577;849;3103;993;3680
317070;201305;8662;29973;7118;26536;2399;9883;1705;6357;4104;16240
317075;201305;1179;3892;1081;3729;424;1593;402;1327;826;2920
317080;201305;6674;20333;6266;19679;2123;7203;2616;8314;4739;15517
317090;201305;4623;16589;4378;16111;754;2921;2945;11023;3699;13944
317100;201305;3083;9469;2751;8944;923;3394;1214;3726;2137;7120
317103;201305;1971;7145;1695;6532;404;1861;808;3057;1212;4918
317107;201305;1225;4074;1111;3842;286;1169;542;1760;828;2929
317110;201305;639;1791;500;1556;149;552;193;542;342;1094
317115;201305;999;3321;908;3122;134;475;615;2129;749;2604
317120;201305;12580;43993;11172;40729;4089;15832;4133;14918;8222;30750
317130;201305;8636;28637;7949;27369;2312;8941;3505;11713;5817;20654
317140;201305;628;2280;589;2190;88;361;370;1371;458;1732
317150;201305;1011;2842;862;2667;126;468;599;1813;725;2281
317160;201305;3662;10335;2897;9358;445;1677;1932;6157;2377;7834
317170;201305;1903;5898;1806;5707;279;1034;1082;3291;1361;4325
317180;201305;1728;6144;1424;5427;443;1824;393;1480;836;3304
317190;201305;1306;4086;1222;3971;124;463;997;3241;1121;3704
317200;201305;4069;14359;3926;14050;1542;5960;980;3367;2522;9327
317210;201305;1045;3383;893;3135;306;1199;350;1202;656;2401
317220;201305;340;1266;335;1260;147;567;149;569;296;1136
320010;201305;5892;18937;5311;17586;862;3117;3011;9990;3873;13107
320013;201305;1785;5526;1433;4977;213;799;905;3201;1118;4000
320016;201305;3389;9702;2949;9078;515;1629;2008;6285;2523;7914
320020;201305;4070;13685;3788;13080;1370;5037;1402;4841;2772;9878
320030;201305;1690;5691;1561;5409;445;1685;735;2493;1180;4178
320035;201305;1565;5201;1437;4963;523;1936;448;1543;971;3479
320040;201305;3013;10537;2617;9601;794;3108;847;3061;1641;6169
320050;201305;1846;5431;1591;4903;348;1208;800;2417;1148;3625
320060;201305;10710;35353;8997;31377;2750;10445;3106;10356;5856;20801
320070;201305;1745;6087;1592;5723;576;2223;420;1412;996;3635
320080;201305;5003;15630;4321;14279;1400;5038;1601;5133;3001;10171
320090;201305;7995;24013;6877;22037;1928;6710;3548;11082;5476;17792
320100;201305;3178;9820;2680;8846;666;2416;1275;4109;1941;6525
320110;201305;1514;4759;1397;4521;377;1338;482;1531;859;2869
320115;201305;1925;7215;1880;7105;611;2366;1041;3995;1652;6361
320120;201305;16222;57370;14738;54365;5723;22403;4256;15761;9979;38164
320130;201305;37274;128886;35390;124847;11556;43852;15921;55261;27477;99113
320140;201305;3929;13274;2927;10686;835;3329;378;1335;1213;4664
320150;201305;17197;50686;13163;42793;4595;15977;2100;6765;6695;22742
320160;201305;5259;16603;4660;15654;1266;4722;2227;7200;3493;11922
320170;201305;1927;6500;1786;6184;710;2545;537;1906;1247;4451
320180;201305;901;3066;827;2948;278;1056;388;1381;666;2437
320190;201305;4014;15033;3759;14381;1484;5894;1120;4279;2604;10173
320200;201305;1071;3636;976;3440;310;1183;415;1470;725;2653
320210;201305;6011;17077;5266;15810;1407;4673;2604;7693;4011;12366
320220;201305;2658;8522;2114;7507;706;2718;694;2500;1400;5218
320225;201305;1397;5095;1235;4636;467;1878;241;911;708;2789
320230;201305;4079;14059;3847;13616;1312;4967;1442;5247;2754;10214
320240;201305;10915;36634;9409;33644;3605;13484;2379;8945;5984;22429
320245;201305;4068;14284;3880;13857;1260;4661;1812;6524;3072;11185
320250;201305;1647;5319;1277;4435;372;1450;288;924;660;2374
320255;201305;1940;6673;1706;6273;707;2760;601;2282;1308;5042
320260;201305;1363;4492;1167;3968;360;1355;413;1250;773;2605
320265;201305;2339;7457;2002;7042;272;1006;1481;5339;1753;6345
320270;201305;2118;7244;1991;6933;496;1803;1053;3706;1549;5509
320280;201305;7100;21889;6668;21299;1215;4088;4452;14612;5667;18700
320290;201305;1499;5272;1415;5035;548;2021;452;1567;1000;3588
320300;201305;4578;15790;4277;15229;1233;4595;2189;7898;3422;12493
320305;201305;4403;15072;4064;14248;1223;4699;1757;6002;2980;10701
320310;201305;1884;5919;1756;5730;405;1438;1044;3348;1449;4786
320313;201305;2140;6811;1669;5726;497;1972;270;834;767;2806
320316;201305;2179;7078;2084;6859;581;2016;991;3259;1572;5275
320320;201305;17347;58763;15706;55572;4981;19678;6738;23137;11719;42815
320330;201305;2674;8721;2441;8260;642;2176;1277;4479;1919;6655
320332;201305;4966;17387;4650;16818;1545;5772;2044;7701;3589;13473
320334;201305;1527;5536;1290;4934;499;2093;208;704;707;2797
320335;201305;1793;5821;1555;5301;627;2306;294;946;921;3252
320340;201305;5371;15919;4489;14413;1093;3912;2190;6972;3283;10884
320350;201305;5290;13978;4042;11944;870;2930;1920;5495;2790;8425
320360;201305;1696;4721;1365;4132;305;1039;665;1921;970;2960
320370;201305;3412;11673;2996;10835;904;3414;1284;4681;2188;8095
320380;201305;2553;8323;2299;7787;736;2624;924;3112;1660;5736
320390;201305;7962;24946;6856;22801;1839;6851;3117;10121;4956;16972
320400;201305;4245;12531;3693;11778;705;2462;2414;7646;3119;10108
320405;201305;4100;12533;3819;12161;1078;3847;2199;6873;3277;10720
320410;201305;5830;15291;4500;13800;543;1562;3542;11205;4085;12767
320420;201305;2371;7704;1919;7004;878;3425;352;1266;1230;4691
320425;201305;2437;6400;2049;5871;315;1085;1338;3808;1653;4893
320430;201305;2145;6663;1998;6397;313;1168;1223;3807;1536;4975
320435;201305;1906;7025;1751;6638;496;1918;859;3379;1355;5297
320440;201305;1434;4994;1355;4779;438;1667;496;1688;934;3355
320450;201305;2260;7749;2079;7351;630;2412;917;3179;1547;5591
320455;201305;4262;15756;3582;14042;1196;4844;728;2838;1924;7682
320460;201305;2778;9551;2346;8605;836;3287;668;2338;1504;5625
320465;201305;1482;4965;1324;4569;291;1057;592;2026;883;3083
320470;201305;4008;13005;3083;10916;1104;4241;485;1648;1589;5889
320480;201305;1973;6146;1676;5581;422;1648;768;2404;1190;4052
320490;201305;16679;55070;14536;50852;5158;19237;5238;18889;10396;38126
320495;201305;1266;4263;1149;3999;512;1914;349;1182;861;3096
320500;201305;40189;132451;36486;125340;13011;48171;15390;51687;28401;99858
320501;201305;4138;13999;3906;13569;1492;5648;1588;5445;3080;11093
320503;201305;2183;8204;1934;7500;700;2866;502;1819;1202;4685
320506;201305;3009;9825;2211;7751;677;2508;401;1416;1078;3924
320510;201305;7682;25401;7088;24269;2634;9601;2538;8659;5172;18260
320515;201305;2030;5910;1839;5541;504;1600;796;2435;1300;4035
320517;201305;1998;7070;1803;6610;622;2415;597;2204;1219;4619
320520;201305;29176;98557;25935;92221;9124;35402;10969;38855;20093;74257
320530;201305;25790;83858;22639;77425;6785;26138;9619;31565;16404;57703
330010;201305;14225;47289;13387;45480;3413;13117;7219;23477;10632;36594
330015;201305;1886;5451;1667;5025;564;1894;533;1527;1097;3421
330020;201305;15242;47736;14119;45911;3968;13837;7355;23784;11323;37621
330022;201305;1401;4700;1301;4526;317;1311;706;2320;1023;3631
330023;201305;3141;10519;3005;10242;882;3288;1280;4264;2162;7552
330025;201305;3083;9812;2889;9516;680;2439;1852;6066;2532;8505
330030;201305;7051;25007;6520;23881;2195;8791;2627;9164;4822;17955
330040;201305;13860;40426;11917;37399;3201;10930;6379;19665;9580;30595
330045;201305;57762;175170;54374;170282;9154;30416;37727;118937;46881;149353
330050;201305;2823;9331;2544;8758;981;3781;724;2340;1705;6121
330060;201305;5139;16546;4719;15939;1192;4489;2782;9430;3974;13919
330070;201305;24098;77268;22294;74018;6851;24508;9625;31941;16476;56449
330080;201305;8623;26045;8309;25616;2195;6808;5001;15926;7196;22734
330090;201305;2985;8802;2860;8563;970;3087;1266;3725;2236;6812
330093;201305;1860;5588;1675;5304;410;1404;828;2618;1238;4022
330095;201305;1160;4120;1084;3925;420;1684;217;705;637;2389
330100;201305;50210;175584;47843;171276;12824;50403;24245;87157;37069;137560
330110;201305;2578;8329;2369;7938;876;3149;690;2296;1566;5445
330115;201305;2392;7522;2244;7249;791;2799;890;2785;1681;5584
330120;201305;2287;7113;2128;6886;483;1715;1287;4115;1770;5830
330130;201305;3701;12613;3395;11990;1245;4687;1154;4077;2399;8764
330140;201305;3263;10169;2978;9772;770;2817;1458;4769;2228;7586
330150;201305;2846;8892;2328;7790;846;3057;529;1723;1375;4780
330160;201305;1311;4688;1241;4529;512;2030;356;1244;868;3274
330170;201305;94711;297957;89613;290067;13545;47734;65296;211181;78841;258915
330180;201305;1577;4994;1452;4759;280;1166;927;2802;1207;3968
330185;201305;7286;23953;6924;23344;1998;7063;3627;12612;5625;19675
330187;201305;3871;11452;3554;10930;855;3021;1966;5914;2821;8935
330190;201305;26887;83802;25850;82024;7070;23898;14748;45992;21818;69890
330200;201305;12276;40118;11535;38637;2659;9166;6570;22472;9229;31638
330205;201305;2477;6930;2266;6582;537;1803;1178;3289;1715;5092
330210;201305;4559;12331;3486;10349;1103;3607;1038;3046;2141;6653
330220;201305;10676;34933;10152;33915;3775;13629;3461;11171;7236;24800
330225;201305;3862;12563;3657;12240;677;2600;2477;8261;3154;10861
330227;201305;16983;48878;15621;47129;3286;10745;10156;30090;13442;40835
330230;201305;1471;4426;1364;4254;424;1484;574;1667;998;3151
330240;201305;19298;61228;17390;57999;7309;26422;3315;11022;10624;37444
330245;201305;1159;3797;981;3428;303;1145;236;838;539;1983
330250;201305;35432;106427;33931;104099;8745;26916;20471;64287;29216;91203
330260;201305;3242;10552;3102;10275;876;3203;1496;4790;2372;7993
330270;201305;12844;39882;11590;37824;3643;12559;4923;16240;8566;28799
330280;201305;1844;6125;1616;5653;398;1606;798;2636;1196;4242
330285;201305;17085;52571;15844;50840;3667;12483;9863;31790;13530;44273
330290;201305;3335;9434;3015;9068;508;1780;2060;5972;2568;7752
330300;201305;4073;13751;3911;13478;1054;3844;2043;7225;3097;11069
330310;201305;2643;8074;2460;7752;653;2174;1202;3739;1855;5913
330320;201305;14940;45051;14253;43985;3767;11852;8437;26676;12204;38528
330330;201305;29274;86976;27524;84247;7412;24304;16041;48573;23453;72877
330340;201305;13236;42485;11257;38433;3624;13470;3639;12232;7263;25702
330350;201305;87870;292108;85951;289435;17034;57331;60374;207770;77408;265101
330360;201305;5189;16909;5075;16722;903;3260;3525;11514;4428;14774
330370;201305;3624;13854;3453;13397;1439;5810;1175;4585;2614;10395
330380;201305;3765;12704;3408;12134;1141;4275;1476;5402;2617;9677
330385;201305;3879;13835;3599;13247;1103;4343;1442;5299;2545;9642
330390;201305;22111;76997;20730;74314;5245;21008;10938;38447;16183;59455
330395;201305;3177;9911;3001;9614;531;1828;1917;6218;2448;8046
330400;201305;2391;8280;2181;7874;557;2266;1019;3413;1576;5679
330410;201305;2919;9603;2566;8847;629;2296;1228;4235;1857;6531
330411;201305;2400;7764;2189;7345;499;1950;1139;3585;1638;5535
330412;201305;1308;4639;1070;4179;247;1116;465;1743;712;2859
330414;201305;24893;72453;21401;67721;4475;15226;13174;41802;17649;57028
330415;201305;3582;11493;3194;10786;848;3222;1394;4664;2242;7886
330420;201305;6251;21803;5474;20193;1890;7630;1004;3799;2894;11429
330430;201305;7877;23995;7139;22673;1856;6547;3424;10533;5280;17080
330440;201305;2050;7046;1744;6412;588;2403;442;1563;1030;3966
330450;201305;1532;5527;1454;5352;503;2075;498;1774;1001;3849
330452;201305;10286;32293;8641;28992;2495;9301;3605;11554;6100;20855
330455;201305;430532;1312410;378241;1226285;105752;366015;194208;629212;299960;995227
330460;201305;1352;4708;1273;4553;383;1553;597;2093;980;3646
330470;201305;3976;13736;3818;13407;1545;5778;1038;3577;2583;9355
330475;201305;7665;25602;7107;24740;1805;6832;4028;14141;5833;20973
330480;201305;6364;19582;5968;18843;1767;6043;2289;7131;4056;13174
330490;201305;92893;269657;87459;261798;13542;42777;64998;195200;78540;237977
330500;201305;6483;20225;6084;19427;1516;5178;2996;9883;4512;15061
330510;201305;39436;131946;37604;128848;13881;48349;17367;61303;31248;109652
330513;201305;1550;4785;1438;4564;442;1465;708;2287;1150;3752
330515;201305;2725;9100;2597;8875;837;3070;1166;3939;2003;7009
330520;201305;12456;38547;11795;37621;2556;8672;7687;24752;10243;33424
330530;201305;1530;4670;1422;4482;384;1342;763;2325;1147;3667
330540;201305;3068;9685;2719;9147;923;3341;1009;3328;1932;6669
330550;201305;8649;29119;7790;27576;3098;11546;2231;8089;5329;19635
330555;201305;9882;31019;9028;29677;1940;6678;5656;18817;7596;25495
330560;201305;3979;12563;3743;12168;815;3119;2204;6962;3019;10081
330570;201305;3528;10479;3156;9895;804;2637;1732;5539;2536;8176
330575;201305;5137;16158;4830;15590;1111;3857;2928;9221;4039;13078
330580;201305;15425;51642;13953;48793;5174;18931;4743;17146;9917;36077
330590;201305;1896;5956;1796;5785;521;1755;921;3017;1442;4772
330600;201305;8837;27465;7716;25716;1262;5296;4996;15754;6258;21050
330610;201305;8435;28284;7826;27129;2397;9128;3575;12230;5972;21358
330615;201305;1659;6007;1547;5693;602;2287;640;2453;1242;4740
330620;201305;3833;13852;3580;13379;1295;5018;1358;5386;2653;10404
330630;201305;19375;66378;17941;63235;5466;21325;8248;27828;13714;49153
350010;201305;2829;9227;2324;8056;765;2866;454;1526;1219;4392
350020;201305;548;1645;448;1433;126;461;160;469;286;930
350030;201305;4081;13679;3794;13179;1492;5596;1380;4829;2872;10425
350040;201305;562;2099;499;1963;186;791;97;349;283;1140
350050;201305;1346;4534;1130;4127;327;1342;375;1272;702;2614
350055;201305;551;1944;532;1912;178;678;226;819;404;1497
350060;201305;78;269;71;256;23;104;22;64;45;168
350070;201305;2640;8964;2242;8077;604;2411;570;1864;1174;4275
350075;201305;463;1740;428;1659;174;728;116;399;290;1127
350080;201305;577;1761;489;1588;135;504;190;609;325;1113
350090;201305;568;1685;451;1487;131;457;151;489;282;946
350100;201305;1741;6289;1625;6047;628;2513;553;2006;1181;4519
350110;201305;433;1354;348;1161;109;410;109;319;218;729
350115;201305;1244;4231;1109;3871;273;1079;474;1522;747;2601
350120;201305;717;2074;561;1785;161;574;142;452;303;1026
350130;201305;3579;11302;3285;10731;924;3373;1358;4118;2282;7491
350140;201305;675;2153;613;2024;151;585;242;754;393;1339
350150;201305;385;1348;364;1300;166;618;78;279;244;897
350160;201305;6355;21204;5112;18437;1735;6876;1671;5526;3406;12402
350170;201305;2163;7879;1954;7350;761;2968;463;1677;1224;4645
350180;201305;1427;3793;1189;3382;295;879;537;1520;832;2399
350190;201305;2884;10293;2479;9461;875;3727;911;3172;1786;6899
350200;201305;390;1388;366;1359;145;598;142;504;287;1102
350210;201305;7258;21127;5969;18829;2430;8217;1931;5816;4361;14033
350220;201305;3043;10059;2756;9523;1056;4060;749;2335;1805;6395
350230;201305;719;2514;663;2419;246;977;202;735;448;1712
350240;201305;580;1801;509;1688;126;485;269;859;395;1344
350250;201305;2688;10149;2580;9928;1151;4690;805;3075;1956;7765
350260;201305;947;2659;870;2542;222;670;399;1225;621;1895
350270;201305;5056;16318;4623;15445;1309;4774;2090;6946;3399;11720
350275;201305;1904;6401;1715;6139;543;2138;719;2424;1262;4562
350280;201305;21301;58548;14187;44830;3956;13431;2958;9445;6914;22876
350290;201305;1452;5170;1350;4930;491;1886;455;1704;946;3590
350300;201305;472;1534;437;1453;161;587;124;407;285;994
350310;201305;990;3389;934;3268;255;1050;395;1313;650;2363
350315;201305;545;1772;449;1564;86;377;152;480;238;857
350320;201305;11510;38697;10558;36438;3579;13152;1924;6455;5503;19607
350330;201305;9159;27957;8312;26169;1795;6451;4786;14136;6581;20587
350335;201305;530;1583;492;1506;138;445;193;644;331;1089
350340;201305;984;3220;789;2852;277;1077;177;613;454;1690
350350;201305;736;2458;652;2327;204;831;247;872;451;1703
350360;201305;713;2587;636;2420;209;849;236;907;445;1756
350370;201305;677;2148;509;1737;110;418;126;393;236;811
350380;201305;3494;11625;2981;10851;1383;5365;605;2133;1988;7498
350390;201305;8187;27503;7472;26209;1815;7060;4063;13712;5878;20772
350395;201305;293;967;237;841;73;276;42;142;115;418
350400;201305;7651;23515;6490;21374;2125;7586;2302;7318;4427;14904
350410;201305;7000;26682;6357;25217;2433;10347;1721;6655;4154;17002
350420;201305;1005;3279;833;2930;408;1513;76;267;484;1780
350430;201305;884;2843;777;2658;228;919;386;1263;614;2182
350440;201305;1341;4465;1276;4349;477;1710;570;1916;1047;3626
350450;201305;7834;24682;6782;22649;2449;8880;1942;6271;4391;15151
350460;201305;1394;4229;1042;3471;340;1255;286;818;626;2073
350470;201305;204;645;185;616;56;211;76;232;132;443
350480;201305;750;2371;515;1782;103;416;90;252;193;668
350490;201305;2058;6073;1823;5807;435;1574;1212;3778;1647;5352
350500;201305;605;1848;536;1742;156;577;244;736;400;1313
350510;201305;1095;3600;973;3354;321;1261;356;1091;677;2352
350520;201305;1239;4904;1150;4718;467;2003;292;1185;759;3188
350530;201305;2415;7465;2024;6589;804;2831;533;1579;1337;4410
350535;201305;1447;4329;1415;4285;80;248;1251;3830;1331;4078
350540;201305;1976;5895;1735;5488;504;1768;730;2280;1234;4048
350550;201305;10581;32054;8640;28653;2744;10169;3076;9537;5820;19706
350560;201305;3323;11325;3087;10925;620;2350;1794;6541;2414;8891
350570;201305;19790;70474;18281;66938;6280;24519;6498;22898;12778;47417
350580;201305;1912;6486;1668;5970;545;2137;267;840;812;2977
350590;201305;3843;13081;3130;11463;1033;4172;1110;3740;2143;7912
350600;201305;28629;82729;22770;72630;5364;18989;11113;34430;16477;53419
350610;201305;8826;26563;7313;24148;2063;7679;3503;11165;5566;18844
350620;201305;419;1387;377;1308;93;367;160;529;253;896
350630;201305;1581;5139;1284;4551;423;1721;135;423;558;2144
350635;201305;3897;13970;3549;13258;1230;4774;1453;5522;2683;10296
350640;201305;658;2143;603;2022;205;743;249;807;454;1550
350650;201305;3695;12609;2911;10753;1226;4915;310;1120;1536;6035
350660;201305;3598;11940;3210;11247;916;3446;1494;5188;2410;8634
350670;201305;1808;5805;1704;5620;351;1354;1080;3386;1431;4740
350680;201305;1140;3629;936;3224;291;1184;376;1221;667;2405
350690;201305;1032;3567;889;3246;289;1172;211;707;500;1879
350700;201305;2739;9761;2441;9076;964;3934;881;2898;1845;6832
350710;201305;1995;6474;1820;6199;387;1510;1124;3745;1511;5255
350715;201305;1121;3502;999;3268;245;918;421;1302;666;2220
350720;201305;120;390;115;375;47;159;42;127;89;286
350730;201305;391;1560;381;1530;131;568;97;365;228;933
350740;201305;2255;6979;2044;6499;608;2102;801;2549;1409;4651
350745;201305;342;1112;291;993;71;282;131;405;202;687
350750;201305;9079;29067;7212;25217;2259;8680;1778;5859;4037;14539
350760;201305;11067;36718;10171;35120;3725;14211;4083;13383;7808;27594
350770;201305;831;2579;635;2172;153;599;218;734;371;1333
350775;201305;613;1857;554;1741;147;528;234;728;381;1256
350780;201305;1981;6224;1545;5306;360;1361;346;1169;706;2530
350790;201305;2025;6809;1696;6143;613;2350;378;1235;991;3585
350800;201305;2893;10145;2767;9919;747;3019;1515;5277;2262;8296
350810;201305;2552;7619;2245;7044;780;2658;776;2495;1556;5153
350820;201305;501;1441;394;1225;86;319;146;397;232;716
350830;201305;856;2803;638;2239;132;504;135;427;267;931
350840;201305;2995;11418;2613;10370;1031;4405;552;2011;1583;6416
350850;201305;6523;22552;5551;20151;1866;7192;1514;5261;3380;12453
350860;201305;3141;10706;3041;10557;556;2159;2188;7522;2744;9681
350870;201305;2296;8184;2104;7886;795;3147;985;3717;1780;6864
350880;201305;1631;5642;1397;5103;463;1814;258;949;721;2763
350890;201305;615;1886;497;1631;106;375;158;436;264;811
350900;201305;4515;15416;3897;14143;1147;4524;1345;4595;2492;9119
350910;201305;856;2735;822;2662;359;1197;278;898;637;2095
350920;201305;9022;28185;8474;27312;1556;5653;5536;17229;7092;22882
350925;201305;5220;16682;4761;15792;1482;5413;2084;6727;3566;12140
350930;201305;1465;4236;1241;3859;178;666;836;2494;1014;3160
350940;201305;2274;7738;2090;7432;418;1763;1333;4537;1751;6300
350945;201305;916;3150;823;2951;250;978;317;1106;567;2084
350950;201305;67029;222244;58618;205044;18300;69704;23674;80535;41974;150239
350960;201305;4435;16089;3975;15085;883;3828;2087;7622;2970;11450
350970;201305;4025;15185;3732;14452;1544;6446;1167;4399;2711;10845
350980;201305;635;2117;605;2067;278;1029;117;401;395;1430
350990;201305;1707;6221;1545;5899;554;2290;565;2130;1119;4420
350995;201305;803;2985;765;2911;241;1027;350;1262;591;2289
351000;201305;3421;10870;3044;10110;571;2229;1735;5493;2306;7722
351010;201305;407;1281;310;1081;127;479;58;208;185;687
351015;201305;933;3182;821;2966;320;1309;231;751;551;2060
351020;201305;7444;25199;6670;23983;1862;7246;3582;13005;5444;20251
351030;201305;1284;4975;1203;4793;401;1736;415;1640;816;3376
351040;201305;3499;11618;3256;11196;851;3440;1873;6014;2724;9454
351050;201305;7696;26578;6765;24709;2608;10239;2245;8109;4853;18348
351060;201305;30267;98010;25885;89972;9281;34082;8678;30739;17959;64821
351070;201305;1716;5114;1311;4368;498;1815;254;754;752;2569
351080;201305;2703;8351;2136;7655;706;2738;839;2933;1545;5671
351090;201305;379;1352;309;1204;113;511;51;187;164;698
351100;201305;1750;5920;1662;5779;642;2276;692;2481;1334;4757
351110;201305;7054;21796;5707;19218;2070;7616;1740;5579;3810;13195
351120;201305;622;1990;542;1809;87;355;250;730;337;1085
351130;201305;838;2362;463;1595;118;480;108;318;226;798
351140;201305;1959;6971;1808;6655;722;2893;578;2081;1300;4974
351150;201305;2043;7205;1720;6371;518;2105;439;1500;957;3605
351160;201305;1468;5308;1335;4985;469;1952;443;1583;912;3535
351170;201305;1421;4917;1240;4477;386;1500;483;1621;869;3121
351190;201305;1063;3500;983;3293;281;1028;250;795;531;1823
351200;201305;2200;6737;1910;6183;368;1408;986;2938;1354;4346
351210;201305;903;3133;830;2972;299;1151;257;877;556;2028
351220;201305;3421;11794;2992;10859;949;3758;1079;3824;2028;7582
351230;201305;1819;6314;1650;5968;578;2284;715;2541;1293;4825
351240;201305;984;3326;731;2684;228;953;193;614;421;1567
351250;201305;809;2408;619;2020;141;507;287;901;428;1408
351260;201305;1181;3612;1055;3341;297;1035;398;1198;695;2233
351270;201305;375;1379;341;1307;131;568;107;372;238;940
351280;201305;4187;13652;3631;12296;1152;4156;1104;3399;2256;7555
351290;201305;960;3017;850;2786;293;1000;231;712;524;1712
351300;201305;9603;36346;8524;33777;2571;11028;3307;13046;5878;24074
351310;201305;3274;10560;2769;9616;766;3030;1277;4124;2043;7154
351320;201305;949;3497;869;3295;344;1416;197;652;541;2068
351330;201305;275;838;250;786;102;328;70;212;172;540
351340;201305;6275;22625;5815;21720;1706;6747;3053;11437;4759;18184
351350;201305;8853;30311;8095;28638;2671;9843;3099;10714;5770;20557
351360;201305;4782;14976;4529;14566;1230;4343;2395;7690;3625;12033
351370;201305;1858;6239;1518;5482;530;2134;368;1173;898;3307
351380;201305;35707;115820;33558;111383;9446;34361;15832;50401;25278;84762
351385;201305;240;783;235;774;98;323;74;254;172;577
351390;201305;1190;4157;1073;3905;440;1687;340;1192;780;2879
351400;201305;1188;3952;1120;3804;356;1302;446;1562;802;2864
351410;201305;2772;8876;2526;8419;640;2289;1216;4016;1856;6305
351420;201305;447;1339;311;1031;75;269;47;143;122;412
351430;201305;845;2766;765;2617;211;799;410;1359;621;2158
351440;201305;4578;14399;4084;13372;1656;5691;1101;3420;2757;9111
351450;201305;1786;5225;1582;4960;489;1558;850;2759;1339;4317
351460;201305;796;2573;666;2311;330;1231;184;582;514;1813
351470;201305;1040;3346;937;3152;415;1506;285;936;700;2442
351480;201305;2863;9652;2632;9261;712;3012;1267;4285;1979;7297
351490;201305;1909;6693;1733;6322;413;1763;925;3209;1338;4972
351492;201305;293;1024;222;826;54;236;59;173;113;409
351495;201305;145;524;127;474;45;177;46;166;91;343
351500;201305;17692;60128;15959;56766;5295;19819;6727;23714;12022;43533
351510;201305;6990;23473;6186;22171;1554;6108;3365;11944;4919;18052
351512;201305;313;1000;286;943;87;309;96;292;183;601
351515;201305;1792;6305;1589;5830;562;2214;458;1625;1020;3839
351518;201305;2067;7472;1668;6743;540;2363;296;1168;836;3531
351519;201305;731;2475;653;2302;201;814;281;954;482;1768
351520;201305;730;2175;380;1392;68;284;46;150;114;434
351530;201305;447;1458;404;1349;96;349;117;339;213;688
351535;201305;2487;6666;2093;6133;200;639;1630;4804;1830;5443
351540;201305;2039;6730;1860;6414;971;3512;367;1272;1338;4784
351550;201305;5555;17510;4463;15181;1708;6119;1089;3632;2797;9751
351560;201305;421;1420;369;1292;146;558;62;205;208;763
351565;201305;227;795;209;746;69;290;80;254;149;544
351570;201305;12519;42445;11112;39477;3819;13989;4589;16436;8408;30425
351580;201305;385;1133;302;936;56;190;115;321;171;511
351590;201305;443;1256;384;1119;145;455;91;256;236;711
351600;201305;1798;5419;1651;5135;447;1624;763;2136;1210;3760
351610;201305;626;1789;536;1625;120;412;271;784;391;1196
351620;201305;22554;77559;19012;69629;6696;26564;4791;16337;11487;42901
351630;201305;14093;48778;12983;46931;3547;13271;7321;26876;10868;40147
351640;201305;7903;27128;6886;25319;1963;7768;3470;12745;5433;20513
351650;201305;331;1032;246;831;60;221;60;196;120;417
351660;201305;881;2899;724;2525;183;714;205;642;388;1356
351670;201305;4024;13120;3482;12015;891;3487;1595;5187;2486;8674
351680;201305;680;2210;543;1852;159;582;127;401;286;983
351685;201305;425;1313;338;1160;104;375;112;394;216;769
351690;201305;1269;3800;1028;3290;485;1577;262;794;747;2371
351700;201305;1374;4289;1261;4078;429;1471;409;1272;838;2743
351710;201305;763;2453;648;2197;172;606;183;571;355;1177
351720;201305;1554;5093;1230;4224;290;1107;426;1407;716;2514
351730;201305;978;3248;949;3193;341;1253;413;1391;754;2644
351740;201305;4415;13071;3869;11925;1147;3772;1317;3815;2464;7587
351750;201305;1478;5003;1292;4591;414;1595;324;1067;738;2662
351760;201305;3701;12360;3304;11461;880;3313;1521;5133;2401;8446
351770;201305;2144;7205;1866;6695;758;2816;776;2797;1534;5613
351780;201305;1550;4591;1150;3766;353;1258;276;891;629;2149
351790;201305;1101;3405;949;3195;294;1083;466;1530;760;2613
351800;201305;299;762;263;693;41;143;162;376;203;519
351810;201305;1174;3694;1116;3621;292;1108;689;2104;981;3212
351820;201305;2418;7253;1714;5950;730;2714;219;716;949;3430
351830;201305;3816;12967;3514;12305;992;3845;1533;5165;2525;9010
351840;201305;8675;30796;7830;28986;2720;10742;2708;9850;5428;20592
351850;201305;1119;4031;991;3743;317;1346;172;588;489;1934
351860;201305;3457;11374;3225;10926;776;3000;1857;5979;2633;8979
351870;201305;34264;109439;31834;105221;7268;26087;19617;64385;26885;90472
351880;201305;111989;375844;99925;351076;33980;125492;31477;110384;65457;235876
351885;201305;592;2264;553;2176;165;694;250;954;415;1648
351890;201305;824;2505;672;2165;244;832;149;458;393;1290
351900;201305;1430;4523;1284;4293;479;1702;505;1702;984;3404
351905;201305;345;1293;299;1203;115;510;87;315;202;825
351907;201305;13808;45458;12123;42046;3111;12068;5536;18399;8647;30467
351910;201305;1099;3634;1006;3452;265;1026;289;913;554;1939
351920;201305;1169;3471;1112;3387;279;967;665;1954;944;2921
351925;201305;971;2830;920;2744;109;423;699;1995;808;2418
351930;201305;3030;10726;2794;10203;897;3647;1086;3628;1983;7275
351940;201305;977;3057;925;2952;287;1015;538;1633;825;2648
351950;201305;965;3075;873;2899;241;883;356;1094;597;1977
351960;201305;3614;12039;3145;11082;1263;4698;1058;3647;2321;8345
351970;201305;6803;26395;6302;25317;2468;10457;2076;8250;4544;18707
351980;201305;884;2841;759;2607;179;712;321;1047;500;1759
351990;201305;1532;4567;1266;4028;384;1401;371;1046;755;2447
352000;201305;2366;7815;2180;7423;547;2022;1066;3513;1613;5535
352010;201305;2251;7840;2075;7403;802;2997;485;1768;1287;4765
352020;201305;1453;4822;1331;4584;433;1569;434;1530;867;3099
352030;201305;4257;13840;3911;13397;876;3239;2354;8219;3230;11458
352040;201305;1626;5903;1424;5381;461;1833;337;1200;798;3033
352042;201305;1863;5608;1529;4931;396;1427;804;2568;1200;3995
352044;201305;1266;4473;1073;3953;319;1264;251;868;570;2132
352050;201305;7048;24491;5302;20469;1708;7393;1112;3773;2820;11166
352060;201305;783;2405;705;2285;225;831;270;801;495;1632
352070;201305;699;1960;644;1870;303;952;173;534;476;1486
352080;201305;529;1690;456;1558;131;509;163;499;294;1008
352090;201305;1651;5474;1381;4915;370;1518;479;1542;849;3060
352100;201305;1699;6018;1531;5676;545;2247;541;1806;1086;4053
352110;201305;398;1529;369;1469;118;530;111;406;229;936
352115;201305;323;1096;274;992;90;368;123;406;213;774
352120;201305;966;2899;844;2731;187;624;507;1699;694;2323
352130;201305;1667;4789;1308;4207;346;1241;607;1805;953;3046
352140;201305;1123;3867;984;3549;338;1292;375;1334;713;2626
352150;201305;629;1904;526;1721;212;747;181;569;393;1316
352160;201305;1176;3503;1087;3366;295;1006;569;1758;864;2764
352170;201305;3011;9557;2770;9155;801;2851;1297;4145;2098;6996
352180;201305;3346;9893;2956;9186;885;3008;1314;3895;2199;6903
352190;201305;1009;3222;922;3064;228;907;442;1333;670;2240
352200;201305;359;1268;309;1165;77;323;122;461;199;784
352210;201305;15239;42604;12328;38299;2534;8513;7443;23546;9977;32059
352215;201305;545;1803;490;1718;92;353;295;1056;387;1409
352220;201305;14563;49895;13707;48172;4733;17605;5750;20217;10483;37822
352230;201305;13247;46699;11851;44102;3933;15930;4598;16795;8531;32725
352240;201305;13554;43683;12629;42059;4373;16149;5078;16359;9451;32508
352250;201305;24782;82481;22210;77618;6075;23068;10007;34930;16082;57998
352260;201305;4657;15069;3631;13118;1102;4440;1036;3389;2138;7829
352265;201305;919;3025;817;2870;147;593;522;1814;669;2407
352270;201305;2489;8667;2194;7930;895;3403;501;1721;1396;5124
352280;201305;2405;7678;2089;7137;619;2342;722;2403;1341;4745
352290;201305;1344;4508;1194;4184;328;1298;336;1060;664;2358
352300;201305;881;2724;761;2514;250;881;324;1057;574;1938
352310;201305;29562;104987;27336;100993;8018;31770;15311;55402;23329;87172
352320;201305;6616;21448;5933;20237;2265;8419;1910;6025;4175;14444
352330;201305;2144;7291;1887;6981;736;2931;680;2536;1416;5467
352340;201305;5569;19519;4679;17333;1702;6772;973;3351;2675;10123
352350;201305;1649;6261;1502;5918;446;1894;491;1888;937;3782
352360;201305;1148;3939;1019;3664;298;1255;518;1718;816;2973
352370;201305;876;3015;808;2869;208;839;382;1318;590;2157
352380;201305;990;3248;869;3034;357;1378;251;841;608;2219
352390;201305;11732;36976;9549;32846;2545;10067;4163;13230;6708;23297
352400;201305;2810;8675;1941;6972;586;2313;813;2838;1399;5151
352410;201305;4341;13388;3494;11940;1419;5186;1034;3422;2453;8608
352420;201305;1275;3792;1190;3662;475;1612;427;1291;902;2903
352430;201305;6055;19611;5363;18415;2198;8148;1669;5578;3867;13726
352440;201305;14826;48280;12505;43646;3462;13139;5075;17179;8537;30318
352450;201305;598;1856;421;1519;114;435;88;306;202;741
352460;201305;2575;8958;2356;8575;895;3631;921;3132;1816;6763
352470;201305;4792;13765;2981;9985;646;2358;1348;4400;1994;6758
352480;201305;5310;15462;4473;13902;1292;4584;1880;5398;3172;9982
352490;201305;709;2605;601;2339;158;678;117;442;275;1120
352500;201305;9527;32429;9094;31678;3804;14357;3507;11379;7311;25736
352510;201305;3235;11580;2693;10386;1007;4160;673;2527;1680;6687
352520;201305;2358;8536;2168;8123;557;2283;1311;4843;1868;7126
352530;201305;7054;23853;5616;20662;1760;7017;1279;4451;3039;11468
352540;201305;498;1672;419;1502;109;436;169;608;278;1044
352550;201305;1016;3521;838;3139;318;1280;200;735;518;2015
352560;201305;523;1660;455;1536;96;386;234;732;330;1118
352570;201305;1685;5459;1225;4372;308;1238;332;1035;640;2273
352580;201305;909;2816;795;2615;283;1057;329;1001;612;2058
352585;201305;185;626;157;569;40;168;53;162;93;330
352590;201305;13138;43774;11851;41315;2843;11149;6492;22033;9335;33182
352600;201305;1806;5992;1681;5714;622;2222;568;1864;1190;4086
352610;201305;3486;11628;3139;11038;1280;4841;1032;3612;2312;8453
352620;201305;5342;17654;5091;17297;1263;4572;3200;10856;4463;15428
352630;201305;823;2829;781;2729;245;939;360;1234;605;2173
352640;201305;2947;9708;2395;8415;599;2344;905;3065;1504;5409
352650;201305;815;2470;617;2066;162;592;164;499;326;1091
352660;201305;1065;3838;886;3414;307;1273;276;1041;583;2314
352670;201305;7630;26428;6729;24695;2551;9703;2117;7904;4668;17607
352680;201305;3105;11579;2673;10381;742;3170;800;2800;1542;5970
352690;201305;22734;70380;18651;62776;5323;19653;7820;25662;13143;45315
352700;201305;751;2308;600;2072;176;688;268;893;444;1581
352710;201305;4985;15264;3766;12774;1092;4120;1357;4334;2449;8454
352720;201305;8236;28932;7811;28077;2675;10254;3146;11262;5821;21516
352725;201305;397;1213;270;914;53;216;63;200;116;416
352730;201305;2444;8671;2142;7839;618;2482;642;2077;1260;4559
352740;201305;2156;6635;1889;6117;522;2034;851;2458;1373;4492
352750;201305;341;1134;308;1075;121;455;56;164;177;619
352760;201305;861;3096;803;2986;269;1087;402;1449;671;2536
352770;201305;901;2858;852;2761;246;866;312;1022;558;1888
352780;201305;590;2086;523;1930;173;712;157;511;330;1223
352790;201305;629;1891;519;1715;176;653;119;395;295;1048
352800;201305;1048;4103;881;3605;304;1276;149;573;453;1849
352810;201305;986;2680;754;2249;143;500;328;949;471;1449
352820;201305;489;1581;434;1463;205;740;69;232;274;972
352830;201305;397;1209;313;1018;96;327;47;146;143;473
352840;201305;3267;11767;2896;10940;918;3739;1050;3955;1968;7694
352850;201305;9407;31583;8344;29660;2681;10080;2913;10604;5594;20684
352860;201305;1014;3444;928;3246;399;1482;235;746;634;2228
352870;201305;964;2632;801;2323;150;554;420;1096;570;1650
352880;201305;2115;6591;1738;5737;441;1593;444;1320;885;2913
352885;201305;293;1032;278;998;96;368;96;329;192;697
352890;201305;694;2052;608;1876;150;517;204;583;354;1100
352900;201305;17593;55735;14100;48440;4106;15278;5668;18792;9774;34070
352910;201305;283;932;248;852;80;288;36;103;116;391
352920;201305;3369;10580;2918;9682;983;3610;1008;3099;1991;6709
352930;201305;6779;22260;5453;19263;1766;6687;1008;3420;2774;10107
352940;201305;26959;94422;23874;86911;8846;33867;5048;18120;13894;51987
352950;201305;315;1018;229;831;68;295;63;205;131;500
352960;201305;474;1564;389;1368;90;354;97;321;187;675
352965;201305;351;1013;287;889;78;250;49;156;127;406
352970;201305;3290;8839;2927;8367;368;1116;2170;6338;2538;7454
352980;201305;1386;4249;1221;3974;418;1433;486;1606;904;3039
352990;201305;3502;12113;3296;11735;1156;4394;1348;4743;2504;9137
353000;201305;514;1482;400;1242;97;348;112;297;209;645
353010;201305;2790;8355;2249;7249;772;2745;784;2328;1556;5073
353020;201305;4205;12212;3258;10187;643;2237;1332;3852;1975;6089
353030;201305;4890;15092;4337;13992;1599;5546;1128;3465;2727;9011
353040;201305;662;1950;570;1800;210;714;192;596;402;1310
353050;201305;5180;18861;4688;17833;1944;7919;1476;5347;3420;13266
353060;201305;32028;107474;29944;104077;5848;23781;19462;64689;25310;88470
353070;201305;8148;28848;6573;25099;2450;9878;1573;6078;4023;15956
353080;201305;4554;16115;3864;14475;1364;5487;1070;3791;2434;9278
353090;201305;565;1957;503;1835;100;442;237;798;337;1240
353100;201305;259;791;215;691;99;317;39;126;138;443
353110;201305;7557;24320;6785;22866;1503;5394;3885;13343;5388;18737
353120;201305;463;1635;404;1492;155;642;94;313;249;955
353130;201305;2918;9276;2588;8695;997;3661;958;3030;1955;6691
353140;201305;2437;7086;1973;6122;695;2347;541;1482;1236;3829
353150;201305;1781;5889;1515;5367;664;2470;319;1160;983;3630
353160;201305;564;1783;483;1599;152;527;108;331;260;858
353170;201305;512;1872;468;1789;200;849;155;560;355;1409
353180;201305;4571;15212;4057;14230;830;3403;2334;7799;3164;11202
353190;201305;3431;11317;3017;10342;821;3133;1314;4104;2135;7237
353200;201305;808;2899;734;2733;228;970;277;967;505;1937
353205;201305;532;1750;427;1507;109;394;139;502;248;896
353210;201305;937;2634;784;2352;141;486;460;1331;601;1817
353215;201305;539;1745;473;1604;102;405;181;611;283;1016
353220;201305;885;2784;817;2656;226;817;314;990;540;1807
353230;201305;1163;3704;1093;3584;330;1194;411;1281;741;2475
353240;201305;2041;7105;1885;6779;647;2581;755;2502;1402;5083
353250;201305;1125;3290;969;3006;294;987;326;939;620;1926
353260;201305;1142;3449;1016;3240;344;1157;372;1146;716;2303
353270;201305;596;1869;519;1723;173;631;152;462;325;1093
353280;201305;522;1760;458;1649;162;626;115;402;277;1028
353282;201305;1696;5831;1651;5755;319;1229;1150;3950;1469;5179
353284;201305;333;988;271;880;89;310;86;269;175;579
353286;201305;142;435;97;326;27;88;19;66;46;154
353290;201305;428;1582;392;1504;165;665;141;531;306;1196
353300;201305;1854;6020;1678;5631;607;2205;555;1703;1162;3908
353310;201305;345;1108;327;1068;143;488;90;279;233;767
353320;201305;476;1376;419;1282;115;426;190;523;305;949
353325;201305;461;1677;393;1541;137;588;49;195;186;783
353330;201305;478;1508;403;1343;98;372;173;523;271;895
353340;201305;3030;10070;2614;9189;951;3593;843;2859;1794;6452
353350;201305;3240;10095;2878;9426;1032;3626;1268;4014;2300;7640
353360;201305;409;1467;359;1348;103;445;179;616;282;1061
353370;201305;692;2291;630;2153;199;726;284;963;483;1689
353380;201305;393;1337;354;1267;109;436;153;531;262;967
353390;201305;4781;13636;3825;11825;1068;3620;1467;4144;2535;7764
353400;201305;584;1848;494;1654;121;454;171;500;292;954
353410;201305;651;2076;558;1928;189;717;271;909;460;1626
353420;201305;595;1849;520;1636;173;578;159;456;332;1034
353430;201305;2398;8393;1876;6914;669;2528;138;429;807;2957
353440;201305;57782;193439;53237;182687;17340;62868;18064;60496;35404;123364
353450;201305;448;1414;403;1333;107;421;146;450;253;871
353460;201305;3814;11246;3380;10428;994;3306;1531;4666;2525;7972
353470;201305;10771;35183;8612;30533;2875;11136;2018;6960;4893;18096
353475;201305;1595;4794;1228;3973;356;1266;321;932;677;2198
353480;201305;1506;4641;1380;4407;323;1186;742;2240;1065;3426
353490;201305;1653;4843;1414;4371;406;1401;394;1108;800;2509
353500;201305;1154;3443;1077;3306;480;1557;355;1043;835;2600
353510;201305;1351;4485;1183;4033;338;1275;409;1249;747;2524
353520;201305;1105;3507;943;3198;409;1487;228;763;637;2250
353530;201305;2631;8200;2357;7690;712;2586;992;3083;1704;5669
353540;201305;1840;5829;1702;5585;716;2439;579;1950;1295;4389
353550;201305;6492;19368;5827;18265;1299;4788;3126;9055;4425;13843
353560;201305;2321;7838;1995;7233;535;2227;787;2713;1322;4940
353570;201305;475;1548;396;1378;97;389;199;618;296;1007
353580;201305;2287;7761;2159;7523;823;3200;1051;3434;1874;6634
353590;201305;778;2283;668;2091;271;930;177;567;448;1497
353600;201305;1804;5401;1661;5151;403;1399;844;2616;1247;4015
353610;201305;558;2059;505;1963;178;773;187;719;365;1492
353620;201305;2276;8156;2110;7851;733;3004;779;2730;1512;5734
353625;201305;350;990;258;828;108;394;62;175;170;569
353630;201305;1802;6273;1513;5623;456;1893;360;1239;816;3132
353640;201305;1494;4354;1414;4222;425;1367;706;2163;1131;3530
353650;201305;4501;14858;3862;13426;1025;3861;1882;6241;2907;10102
353657;201305;279;967;260;926;68;275;94;323;162;598
353660;201305;1323;3461;1007;3017;470;1535;141;297;611;1832
353670;201305;4696;15856;4149;14653;1303;4976;1436;4872;2739;9848
353680;201305;613;2277;583;2218;336;1311;124;490;460;1801
353690;201305;484;1373;340;1127;122;456;103;305;225;761
353700;201305;2248;7499;2013;6972;518;2074;658;2094;1176;4168
353710;201305;1821;6670;1607;6179;632;2663;534;1997;1166;4660
353715;201305;469;1428;416;1341;64;237;243;794;307;1031
353720;201305;2035;6567;1805;6217;376;1255;1120;4100;1496;5355
353730;201305;4339;13914;3527;12004;957;3505;926;2959;1883;6464
353740;201305;2231;6983;1815;6097;668;2345;485;1569;1153;3914
353750;201305;590;2183;523;2029;189;784;128;506;317;1290
353760;201305;6230;21288;5235;19246;1718;6651;1929;7173;3647;13824
353770;201305;796;2545;553;1940;134;514;83;228;217;742
353780;201305;5526;20394;5070;19471;2549;9956;1175;4818;3724;14774
353790;201305;3062;11195;2763;10569;1057;4427;509;1998;1566;6425
353800;201305;13144;44216;10974;39849;3088;12385;4859;17219;7947;29604
353810;201305;1142;3858;1023;3592;330;1206;409;1458;739;2664
353820;201305;1161;4262;1114;4166;437;1811;389;1371;826;3182
353830;201305;764;2153;599;1829;135;452;254;768;389;1220
353850;201305;1755;6018;1640;5803;479;1821;745;2562;1224;4383
353860;201305;2323;8109;2028;7449;757;3022;738;2639;1495;5661
353870;201305;22699;73737;17736;63439;4458;17949;6306;20579;10764;38528
353880;201305;2604;8859;2398;8535;542;2217;1370;4727;1912;6944
353890;201305;2248;6094;1704;5226;551;1870;703;2027;1254;3897
353900;201305;1122;3612;853;2994;231;901;195;607;426;1508
353910;201305;2061;7438;1961;7159;653;2546;838;3075;1491;5621
353920;201305;2594;7930;2032;6751;516;1769;403;1260;919;3029
353930;201305;3555;13058;3145;12192;1228;5059;749;2780;1977;7839
353940;201305;1480;4852;1320;4531;355;1418;519;1617;874;3035
353950;201305;3565;11985;3294;11483;614;2465;2093;7092;2707;9557
353960;201305;570;1879;468;1635;123;482;131;388;254;870
353970;201305;520;1569;458;1487;53;214;337;1063;390;1277
353980;201305;13647;41177;11607;37990;3010;10657;6042;19515;9052;30172
353990;201305;515;1656;470;1541;148;539;171;502;319;1041
354000;201305;1783;5462;1256;4402;313;1233;122;372;435;1605
354010;201305;374;1213;336;1145;175;614;82;277;257;891
354020;201305;4571;14358;4183;13539;1418;4975;1725;5257;3143;10232
354025;201305;1032;3035;834;2682;236;838;212;666;448;1504
354030;201305;584;1574;430;1359;147;524;139;397;286;921
354040;201305;760;2129;616;1874;100;385;373;1055;473;1440
354050;201305;868;3038;811;2904;347;1312;219;787;566;2099
354060;201305;4037;13710;3402;12370;1039;4116;1355;4690;2394;8806
354070;201305;3480;11806;3067;10882;1204;4565;745;2615;1949;7180
354075;201305;2237;8651;2142;8481;787;3343;898;3496;1685;6839
354080;201305;1833;5745;1506;4952;429;1480;522;1624;951;3104
354085;201305;291;846;261;791;35;141;177;486;212;627
354090;201305;1051;3276;1013;3217;170;608;734;2268;904;2876
354100;201305;16342;57393;14254;53559;3769;15115;6952;26159;10721;41274
354105;201305;808;2672;677;2414;200;840;212;662;412;1502
354110;201305;722;2268;630;2108;177;640;200;628;377;1268
354120;201305;2128;6289;1890;5880;590;2043;645;1874;1235;3917
354130;201305;6049;19167;5441;17944;1946;6829;1875;6017;3821;12846
354140;201305;16647;46732;11873;37044;2495;8872;5296;15386;7791;24258
354150;201305;4216;12398;3528;11216;1164;4077;1367;4209;2531;8286
354160;201305;3831;13008;3428;12151;1047;4005;1386;4718;2433;8723
354165;201305;378;1436;347;1357;126;512;86;358;212;870
354170;201305;1589;5341;1315;4666;316;1262;468;1496;784;2758
354180;201305;497;1545;474;1497;47;173;350;1062;397;1235
354190;201305;1602;5533;1396;5047;487;1865;407;1414;894;3279
354200;201305;1113;3321;922;2966;232;903;351;976;583;1879
354210;201305;845;3029;766;2843;204;882;307;1053;511;1935
354220;201305;2959;9676;2714;9188;1027;3672;1009;3328;2036;7000
354230;201305;764;2609;726;2545;248;932;334;1162;582;2094
354240;201305;1229;4307;1034;3889;328;1356;278;1000;606;2356
354250;201305;467;1585;416;1523;194;779;113;389;307;1168
354260;201305;9234;28773;8418;27443;2684;9548;3490;11373;6174;20921
354270;201305;1094;3989;1019;3817;334;1381;404;1510;738;2891
354280;201305;860;2622;808;2530;175;621;430;1350;605;1971
354290;201305;1292;4706;1194;4491;413;1669;301;1123;714;2792
354300;201305;3796;13658;3714;13495;1046;4038;2007;7253;3053;11291
354310;201305;762;2602;603;2197;188;751;135;475;323;1226
354320;201305;807;2519;711;2326;218;797;236;718;454;1515
354323;201305;324;1001;271;912;98;363;101;306;199;669
354325;201305;1281;4503;1173;4261;359;1461;419;1402;778;2863
354330;201305;7763;24891;7146;23709;1981;7029;3864;12636;5845;19665
354340;201305;28734;96412;24890;89280;9709;37373;8741;30468;18450;67841
354350;201305;1123;3499;1054;3370;321;1080;537;1652;858;2732
354360;201305;425;1432;357;1309;98;391;62;232;160;623
354370;201305;1133;3878;1023;3662;186;782;712;2481;898;3263
354380;201305;1293;3960;1086;3588;429;1579;192;556;621;2135
354390;201305;10697;36116;8439;30848;2383;9593;2689;9334;5072;18927
354400;201305;2066;7462;1826;6870;482;2003;588;2084;1070;4087
354410;201305;6110;19309;5238;18003;1310;4893;2891;9931;4201;14824
354420;201305;1630;4900;1398;4396;464;1566;461;1396;925;2962
354425;201305;3406;10164;2990;9419;1089;3629;965;3135;2054;6764
354430;201305;1283;4335;1191;4200;305;1206;597;2047;902;3253
354440;201305;492;1560;419;1415;113;418;150;484;263;902
354450;201305;429;1276;326;1043;57;232;98;267;155;499
354460;201305;704;2254;670;2192;265;891;334;1096;599;1987
354470;201305;424;1295;366;1180;70;282;167;492;237;774
354480;201305;723;2264;654;2139;154;596;286;813;440;1409
354490;201305;712;2496;549;2075;159;661;162;531;321;1192
354500;201305;2508;8685;2305;8304;873;3450;734;2673;1607;6123
354510;201305;648;2264;579;2102;209;810;196;702;405;1512
354515;201305;331;1178;276;1056;75;323;87;303;162;626
354520;201305;4986;18238;4309;16640;1468;6266;1449;5389;2917;11655
354530;201305;2562;9573;2404;9255;724;2964;1273;4905;1997;7869
354540;201305;1326;4261;1174;3994;412;1478;412;1459;824;2937
354550;201305;515;1793;455;1630;104;397;161;542;265;939
354560;201305;1321;4128;1064;3536;340;1159;298;958;638;2117
354570;201305;584;1880;488;1643;190;695;120;382;310;1077
354580;201305;8475;26027;7298;23698;1731;6406;3562;10909;5293;17315
354600;201305;1659;5925;1484;5577;518;2210;583;2065;1101;4275
354610;201305;468;1326;335;1070;81;274;95;265;176;539
354620;201305;406;1446;339;1317;107;487;104;360;211;847
354625;201305;271;927;234;851;57;234;63;223;120;457
354630;201305;1751;6325;1576;5889;641;2427;496;1765;1137;4192
354640;201305;4057;13907;3511;12706;1122;4550;828;2780;1950;7330
354650;201305;968;3015;875;2815;189;707;474;1460;663;2167
354660;201305;1900;5907;1503;5120;547;2082;481;1537;1028;3619
354670;201305;1724;5825;1399;4985;429;1676;375;1164;804;2840
354680;201305;5039;17582;4696;16837;1446;5490;1804;6352;3250;11842
354690;201305;621;2357;516;2055;131;557;174;624;305;1181
354700;201305;1134;3344;812;2646;146;600;331;931;477;1531
354710;201305;612;1882;536;1740;155;599;183;532;338;1131
354720;201305;183;540;146;461;57;178;40;132;97;310
354730;201305;7126;26014;6430;24534;2152;8697;2449;9124;4601;17821
354740;201305;227;767;194;693;45;168;46;164;91;332
354750;201305;2246;7400;1912;6920;685;2656;670;2419;1355;5075
354760;201305;2107;7211;1838;6604;660;2529;496;1714;1156;4243
354765;201305;245;693;184;592;37;145;43;123;80;268
354770;201305;2704;8204;2192;7344;1018;3669;364;1140;1382;4809
354780;201305;31472;105471;29764;101476;8165;30576;14669;47789;22834;78365
354790;201305;868;2871;787;2755;237;925;405;1330;642;2255
354800;201305;1919;6210;1766;5992;620;2229;900;3078;1520;5307
354805;201305;836;2676;657;2283;130;513;129;413;259;926
354810;201305;639;2162;521;1937;213;860;90;319;303;1179
354820;201305;1009;3722;919;3528;305;1321;223;776;528;2097
354830;201305;421;1351;380;1272;106;403;145;465;251;868
354840;201305;772;2399;727;2303;245;845;240;733;485;1578
354850;201305;14414;48405;11447;42057;3473;14162;3935;13521;7408;27683
354860;201305;1220;4093;1117;3912;347;1450;484;1560;831;3010
354870;201305;41371;137156;39220;132713;11981;43734;19932;65483;31913;109217
354880;201305;3892;12648;2914;10424;952;3718;699;2282;1651;6000
354890;201305;14303;45382;12471;41678;3689;13651;4611;14713;8300;28364
354900;201305;596;1707;483;1546;174;611;169;540;343;1151
354910;201305;4685;15852;3764;13825;1119;4504;568;2000;1687;6504
354920;201305;483;1451;374;1245;112;401;87;280;199;681
354925;201305;366;1091;219;773;39;148;47;156;86;304
354930;201305;242;761;223;715;72;267;59;180;131;447
354940;201305;2491;8918;1966;7501;852;3425;354;1296;1206;4721
354950;201305;1427;4892;1309;4722;256;1084;812;2844;1068;3928
354960;201305;771;2478;690;2350;189;728;364;1203;553;1931
354970;201305;3749;13112;3371;12330;948;3899;1575;5473;2523;9372
354980;201305;32187;81674;18055;56810;4212;14707;5997;17576;10209;32283
354990;201305;33032;115759;31134;111747;7675;30712;16836;58600;24511;89312
354995;201305;1909;6138;1803;5974;501;1756;899;2997;1400;4753
355000;201305;1617;5601;1433;5274;566;2216;397;1445;963;3661
355010;201305;3415;11105;3041;10395;765;2919;1533;5111;2298;8030
355020;201305;3114;11609;2742;10870;1390;5794;759;3055;2149;8849
355030;201305;729987;2253612;679197;2153875;206813;708539;271178;843031;477991;1551570
355040;201305;2750;9420;2467;8876;946;3737;1055;3619;2001;7356
355050;201305;1190;3934;1005;3549;307;1186;290;996;597;2182
355060;201305;4673;16542;3814;14496;1168;4943;792;2714;1960;7657
355070;201305;5970;19613;5394;18644;1370;5418;2854;9332;4224;14750
355080;201305;1241;4733;1069;4264;429;1898;158;537;587;2435
355090;201305;1042;3880;896;3522;207;887;395;1497;602;2384
355100;201305;28944;96451;26115;91326;9596;35074;8801;31762;18397;66836
355110;201305;1259;4519;1162;4313;410;1653;408;1479;818;3132
355120;201305;636;2086;561;1932;176;661;237;792;413;1453
355130;201305;426;1239;334;1050;102;350;95;242;197;592
355140;201305;984;3643;947;3556;295;1220;440;1599;735;2819
355150;201305;3116;11112;2834;10511;1001;3874;1057;3772;2058;7646
355160;201305;1450;5215;1279;4923;565;2409;349;1201;914;3610
355170;201305;8429;25968;6562;22460;2354;8727;1895;6268;4249;14995
355180;201305;2771;8911;2452;8324;774;2987;913;2962;1687;5949
355190;201305;1224;4436;1137;4241;486;1869;325;1169;811;3038
355200;201305;881;3376;845;3301;425;1750;205;781;630;2531
355210;201305;2642;9423;2403;8891;786;3245;893;3055;1679;6300
355220;201305;27589;97437;25699;93718;11944;44972;7384;27757;19328;72729
355230;201305;944;2992;638;2270;133;548;150;468;283;1016
355240;201305;20909;66397;16352;56015;4122;15880;6519;20591;10641;36471
355250;201305;23161;80836;21249;77206;6387;24811;10206;36714;16593;61525
355255;201305;863;2477;637;1987;123;441;190;545;313;986
355260;201305;1554;4584;1408;4318;401;1395;628;1812;1029;3207
355270;201305;1608;5090;1525;4956;248;1001;1057;3246;1305;4247
355280;201305;21162;66730;19189;62997;5270;19382;8783;27785;14053;47167
355290;201305;851;2807;788;2691;178;681;374;1205;552;1886
355300;201305;827;2815;664;2441;169;690;154;516;323;1206
355310;201305;1005;3214;907;3030;263;904;389;1347;652;2251
355320;201305;708;2347;632;2165;196;742;218;649;414;1391
355330;201305;1461;5499;1267;5113;516;2299;311;1144;827;3443
355340;201305;2852;8089;2698;7827;710;2322;1473;4030;2183;6352
355350;201305;1302;4854;1197;4610;450;1863;294;1176;744;3039
355360;201305;1054;3882;996;3764;291;1230;596;2189;887;3419
355365;201305;311;1005;265;909;81;317;68;222;149;539
355370;201305;6556;17764;4943;15947;2014;7080;1833;5933;3847;13013
355380;201305;3637;11372;2871;9584;866;3137;635;1881;1501;5018
355385;201305;946;3237;914;3185;387;1483;257;853;644;2336
355390;201305;1394;4002;1209;3624;328;1059;415;1219;743;2278
355395;201305;1448;4699;1211;4107;232;919;557;1731;789;2650
355400;201305;8428;30025;7827;28805;2342;9571;4133;14709;6475;24280
355410;201305;12037;45795;11438;44550;4786;19664;3382;13343;8168;33007
355420;201305;797;2969;765;2901;331;1307;248;962;579;2269
355430;201305;3513;10807;3092;10035;956;3407;1228;3834;2184;7241
355440;201305;838;2881;714;2561;222;837;217;706;439;1543
355450;201305;2425;8316;2061;7560;682;2720;611;2114;1293;4834
355460;201305;548;1625;430;1402;126;481;120;344;246;825
355465;201305;420;1284;358;1165;106;374;97;302;203;676
355470;201305;903;2889;738;2597;295;1150;214;692;509;1842
355475;201305;140;542;120;477;31;129;37;161;68;290
355480;201305;3154;11796;2974;11379;992;4094;1256;4668;2248;8762
355490;201305;776;2354;628;2053;191;684;141;462;332;1146
355495;201305;681;2343;656;2301;211;814;266;887;477;1701
355500;201305;7928;24909;5715;19870;1488;5738;1158;3674;2646;9412
355510;201305;1624;5053;1395;4545;352;1308;381;1184;733;2492
355520;201305;368;1016;266;810;69;246;74;193;143;439
355530;201305;148;429;102;334;26;94;20;66;46;160
355535;201305;735;2305;615;2073;181;723;197;567;378;1290
355540;201305;9823;32861;9349;32046;2710;10020;4790;16152;7500;26172
355550;201305;691;2248;653;2173;196;729;303;977;499;1706
355560;201305;1420;4274;1109;3673;283;1067;280;807;563;1874
355570;201305;182;627;161;570;49;187;36;113;85;300
355580;201305;1187;3713;1044;3413;440;1572;325;1018;765;2590
355590;201305;239;690;217;652;49;177;111;325;160;502
355600;201305;970;3324;845;3046;401;1518;204;707;605;2225
355610;201305;1406;4214;1204;3898;384;1350;492;1530;876;2880
355620;201305;3700;12347;3045;10863;785;3220;1272;4132;2057;7352
355630;201305;3169;9427;2052;7052;442;1731;771;2465;1213;4196
355635;201305;942;3226;841;3042;227;894;425;1501;652;2395
355640;201305;3693;12644;3183;11448;1230;4620;633;2284;1863;6904
355645;201305;3317;12294;3169;11997;707;2973;1930;7203;2637;10176
355650;201305;6224;20344;5497;18908;1423;5792;3016;9578;4439;15370
355660;201305;1251;4175;1047;3763;368;1488;334;1106;702;2594
355670;201305;1987;6651;1407;5228;401;1695;430;1393;831;3088
355680;201305;1663;5907;1404;5265;589;2302;278;1003;867;3305
355690;201305;342;1205;311;1149;197;759;26;77;223;836
355695;201305;322;985;242;797;45;167;32;82;77;249
355700;201305;6103;22515;5683;21462;1802;7441;2523;9093;4325;16534
355710;201305;11511;31057;7855;24366;2832;9331;1942;5873;4774;15204
355715;201305;184;603;146;528;46;175;27;97;73;272
355720;201305;1512;5160;1290;4684;484;1936;373;1213;857;3149
355730;201305;757;2707;693;2582;292;1158;168;636;460;1794
410010;201305;1579;5201;1476;5006;421;1509;642;2223;1063;3732
410020;201305;1165;4149;1106;4049;381;1462;391;1406;772;2868
410030;201305;1147;4114;1021;3806;383;1500;218;839;601;2339
410040;201305;11807;40985;11015;39407;4303;16465;3091;10953;7394;27418
410045;201305;1066;3186;822;2735;261;918;334;1080;595;1998
410050;201305;2802;8477;2058;7068;771;2894;595;1976;1366;4870
410060;201305;1780;5934;1632;5617;510;1954;576;1922;1086;3876
410070;201305;2045;6047;1759;5483;713;2459;346;931;1059;3390
410080;201305;1352;4259;1192;4002;304;1087;690;2292;994;3379
410090;201305;1101;3609;1003;3398;388;1423;297;947;685;2370
410100;201305;2711;8513;2269;7596;712;2733;537;1731;1249;4464
410105;201305;483;1604;399;1402;111;452;76;237;187;689
410110;201305;2123;6993;1978;6692;566;2155;796;2660;1362;4815
410115;201305;514;1487;449;1352;115;417;139;355;254;772
410120;201305;2799;9922;2665;9711;1095;4237;1023;3793;2118;8030
410130;201305;1318;4590;1222;4369;318;1103;672;2454;990;3557
410140;201305;13096;39074;10083;33308;3533;12904;3557;11567;7090;24471
410150;201305;16748;44470;8801;27705;1996;7205;1732;4917;3728;12122
410160;201305;3212;10664;2948;10203;1006;3822;1101;3848;2107;7670
410165;201305;724;2305;654;2152;139;498;329;1057;468;1555
410170;201305;1549;4978;1357;4568;558;2038;384;1243;942;3281
410180;201305;8094;26975;7175;24989;1960;7858;3390;10975;5350;18833
410185;201305;651;1858;600;1775;135;420;377;1135;512;1555
410190;201305;2110;6534;1950;6205;670;2315;597;1804;1267;4119
410200;201305;4914;14553;4161;13103;1536;5321;769;2345;2305;7666
410210;201305;2521;7871;2055;6867;567;2148;432;1266;999;3414
410220;201305;585;1762;485;1560;102;360;183;569;285;929
410230;201305;1753;5844;1645;5672;675;2525;555;1854;1230;4379
410240;201305;4890;15825;4613;15259;1596;5667;1706;5618;3302;11285
410250;201305;2348;6868;1803;5799;625;2251;382;1096;1007;3347
410260;201305;1593;5092;1431;4809;464;1675;495;1635;959;3310
410270;201305;513;1567;451;1450;160;562;174;565;334;1127
410275;201305;853;2608;667;2277;119;459;391;1341;510;1800
410280;201305;2684;8272;1926;6590;492;1921;308;1017;800;2938
410290;201305;3031;9864;2771;9384;805;2955;1209;4102;2014;7057
410300;201305;593;1762;544;1664;95;362;310;874;405;1236
410302;201305;533;1628;476;1546;57;184;319;1059;376;1243
410304;201305;1380;4723;1284;4531;394;1429;571;2082;965;3511
410305;201305;2029;5683;1755;5280;568;1800;899;2763;1467;4563
410310;201305;2204;7697;2057;7407;710;2756;695;2591;1405;5347
410315;201305;584;1922;506;1769;138;527;230;774;368;1301
410320;201305;1163;3511;843;2880;209;841;95;267;304;1108
410322;201305;479;1539;408;1376;119;429;120;397;239;826
410330;201305;1388;4113;1215;3766;403;1363;351;1047;754;2410
410335;201305;1011;3105;878;2859;260;966;300;913;560;1879
410337;201305;734;2068;647;1919;144;500;276;777;420;1277
410340;201305;566;1770;435;1427;91;343;104;285;195;628
410345;201305;1609;5018;1418;4666;512;1850;310;939;822;2789
410347;201305;810;2384;612;2009;213;771;115;335;328;1106
410350;201305;897;2972;733;2655;245;987;100;329;345;1316
410360;201305;3181;10166;2918;9726;1053;3795;806;2724;1859;6519
410370;201305;11992;36491;9518;31367;2772;10312;2767;8520;5539;18832
410380;201305;1285;4192;1199;4022;327;1173;607;2037;934;3210
410390;201305;2718;8212;2247;7395;866;3045;640;1959;1506;5004
410395;201305;840;3005;783;2884;215;871;411;1512;626;2383
410400;201305;4913;16378;4392;15336;1473;5723;1282;4345;2755;10068
410405;201305;898;2767;750;2459;188;719;339;1036;527;1755
410410;201305;1306;4598;1253;4499;468;1844;327;1143;795;2987
410420;201305;9444;31705;8533;29660;3048;11565;2482;8181;5530;19746
410425;201305;3576;11811;2787;10022;828;3313;473;1670;1301;4983
410430;201305;14125;40914;11140;35436;3569;12403;3357;10688;6926;23091
410440;201305;3437;11349;3207;10943;820;2944;1640;5704;2460;8648
410442;201305;2844;10209;2654;9765;964;3756;909;3343;1873;7099
410445;201305;2246;7916;1986;7437;646;2575;833;3257;1479;5832
410450;201305;2437;7282;2077;6612;696;2406;565;1663;1261;4069
410460;201305;2260;7028;1920;6307;523;1845;753;2410;1276;4255
410465;201305;1608;6308;1494;6022;616;2559;428;1650;1044;4209
410470;201305;1799;5896;1644;5566;487;1734;632;2146;1119;3880
410480;201305;26909;82853;23155;75660;9316;33288;6379;19940;15695;53228
410490;201305;10307;35589;9213;33146;3203;12455;3145;11313;6348;23768
410500;201305;1339;4491;1212;4229;451;1710;337;1204;788;2914
410510;201305;2119;5957;1686;5151;495;1642;661;1918;1156;3560
410520;201305;3130;11235;2995;10959;1201;4616;1020;3772;2221;8388
410530;201305;1541;4618;1337;4199;374;1354;516;1507;890;2861
410540;201305;3710;11108;2776;9398;766;2791;1042;3557;1808;6348
410550;201305;6003;19343;4865;16756;1694;6458;679;2115;2373;8573
410560;201305;1149;3906;948;3363;257;964;226;676;483;1640
410570;201305;2604;9048;2417;8720;743;2733;1060;4067;1803;6800
410580;201305;23749;78179;21580;73942;7821;29266;6682;22003;14503;51269
410590;201305;1190;3963;865;3041;179;717;224;704;403;1421
410600;201305;1732;5526;1550;5161;474;1652;725;2454;1199;4106
410610;201305;801;2581;722;2429;221;796;305;991;526;1787
410620;201305;1651;6135;1520;5797;522;2135;427;1598;949;3733
410630;201305;2369;7219;2105;6753;604;2199;914;2871;1518;5070
410640;201305;4422;13746;3814;12668;1383;5170;937;2950;2320;8120
410645;201305;1234;4511;1193;4422;484;1938;398;1495;882;3433
410650;201305;2351;7495;2028;6864;766;2725;627;2079;1393;4804
410655;201305;850;2735;756;2541;247;905;215;702;462;1607
410657;201305;524;1709;491;1643;159;624;198;601;357;1225
410660;201305;3680;11007;2977;9491;1137;3871;621;1855;1758;5726
410670;201305;969;2865;757;2435;221;804;220;665;441;1469
410680;201305;2142;7904;1868;7156;550;2169;714;2851;1264;5020
410685;201305;634;1978;598;1914;127;409;382;1237;509;1646
410690;201305;112298;335659;82792;275353;22838;84699;23067;69591;45905;154290
410700;201305;2146;7365;2039;7148;738;2809;763;2565;1501;5374
410710;201305;1020;3347;855;2948;225;886;239;786;464;1672
410712;201305;696;2248;634;2127;306;1107;169;600;475;1707
410715;201305;1073;3470;960;3230;268;981;350;1150;618;2131
410720;201305;3675;12110;3243;11185;999;3651;1001;3347;2000;6998
410725;201305;1029;3024;817;2639;222;776;278;808;500;1584
410730;201305;682;2128;631;2023;289;986;166;509;455;1495
410740;201305;875;2736;648;2270;168;670;272;936;440;1606
410750;201305;1712;5370;1552;4988;559;2006;445;1305;1004;3311
410752;201305;229;731;215;711;56;222;111;339;167;561
410753;201305;450;1455;404;1366;111;433;150;468;261;901
410754;201305;982;3184;875;3000;149;565;569;2010;718;2575
410755;201305;604;1831;532;1705;139;515;240;704;379;1219
410760;201305;2331;7882;2237;7693;901;3244;814;2787;1715;6031
410765;201305;14504;45034;11580;39152;3158;11867;2423;8148;5581;20015
410770;201305;816;2408;712;2222;221;757;291;885;512;1642
410773;201305;1170;3844;1061;3630;298;1139;462;1466;760;2605
410775;201305;1764;5401;1736;5360;419;1216;1179;3809;1598;5025
410780;201305;585;1879;520;1750;154;542;144;521;298;1063
410785;201305;874;2962;723;2503;258;916;264;931;522;1847
410790;201305;711;2272;620;2065;221;824;140;413;361;1237
410800;201305;2056;6211;1821;5830;832;2852;527;1629;1359;4481
410810;201305;296;927;238;792;31;127;101;323;132;450
410820;201305;1014;3192;916;2979;293;1053;272;861;565;1914
410830;201305;28759;90989;24737;83623;7792;28691;8737;29347;16529;58038
410832;201305;1109;3446;1033;3306;245;922;517;1535;762;2457
410840;201305;7456;24519;6720;22935;2432;9084;1675;5295;4107;14379
410845;201305;1511;4709;1347;4387;306;1089;719;2345;1025;3434
410850;201305;2575;7874;2367;7594;503;1908;1340;4242;1843;6150
410855;201305;683;2024;617;1896;181;601;217;675;398;1276
410860;201305;3052;9486;2768;8992;767;2597;1298;4366;2065;6963
410865;201305;1582;5700;1442;5418;257;1023;885;3419;1142;4442
410870;201305;1348;4368;1289;4269;596;2150;389;1232;985;3382
410880;201305;4950;14980;4130;13488;1353;4956;1222;3757;2575;8713
410890;201305;1063;3395;837;2962;309;1197;122;373;431;1570
410895;201305;1198;4375;1113;4166;408;1605;367;1339;775;2944
410900;201305;810;2392;647;2134;144;536;188;599;332;1135
410910;201305;301;966;266;901;64;234;120;388;184;622
410920;201305;777;2499;641;2243;204;762;169;549;373;1311
410930;201305;1978;6472;1776;6144;549;2166;686;2302;1235;4468
410940;201305;19201;68122;17815;65670;6027;24043;8035;29828;14062;53871
410950;201305;1862;6368;1712;6089;380;1401;1029;3735;1409;5136
410960;201305;5739;17040;4302;14539;1591;5731;1414;4947;3005;10678
410965;201305;1023;3487;944;3331;221;826;529;1929;750;2755
410970;201305;4817;15255;4148;13878;1504;5613;967;3281;2471;8894
410975;201305;1255;3928;1114;3666;206;795;594;1953;800;2748
410980;201305;4724;14607;3398;11718;994;3815;860;2774;1854;6589
410990;201305;987;3147;783;2690;276;1061;178;518;454;1579
411000;201305;373;1206;297;1033;78;299;51;164;129;463
411005;201305;431;1325;366;1171;99;314;80;238;179;552
411007;201305;2088;6978;2000;6835;633;2288;1026;3614;1659;5902
411010;201305;3586;12702;3401;12313;1490;5844;948;3281;2438;9125
411020;201305;2505;8378;2324;8060;801;3060;886;3083;1687;6143
411030;201305;797;2299;702;2130;240;814;197;549;437;1363
411040;201305;333;1110;286;998;107;388;63;216;170;604
411050;201305;2073;7753;1902;7348;781;3212;424;1638;1205;4850
411060;201305;2031;6629;1808;6180;638;2437;328;1009;966;3446
411065;201305;370;1158;299;1010;50;188;108;330;158;518
411070;201305;3590;12299;2879;10808;1014;4198;356;1246;1370;5444
411080;201305;1889;6185;1778;5943;467;1733;821;2694;1288;4427
411090;201305;1021;2940;893;2764;261;935;264;758;525;1693
411095;201305;1515;4526;1219;3967;343;1229;309;972;652;2201
411100;201305;1466;4341;1125;3675;300;1098;269;876;569;1974
411110;201305;884;2738;711;2379;223;806;131;364;354;1170
411120;201305;1587;5187;1434;4852;481;1751;467;1552;948;3303
411125;201305;4540;15088;4433;14880;1606;5675;2131;7091;3737;12766
411130;201305;713;2249;617;2051;206;722;227;763;433;1485
411140;201305;2180;8082;1962;7523;785;3112;491;2057;1276;5169
411150;201305;5594;16553;5035;15527;1611;5398;1482;4244;3093;9642
411155;201305;1090;3396;1002;3190;383;1324;304;890;687;2214
411160;201305;291;905;267;857;116;392;79;241;195;633
411170;201305;760;2675;699;2522;226;863;216;763;442;1626
411180;201305;5804;18505;5223;17466;1748;6381;1633;5460;3381;11841
411190;201305;1727;5267;1469;4786;468;1685;435;1349;903;3034
411200;201305;3581;11954;3223;11366;1298;4936;1094;3836;2392;8772
411210;201305;2725;8063;2267;7240;912;3177;307;910;1219;4087
411220;201305;1124;3394;924;3024;268;992;364;1085;632;2077
411230;201305;946;3009;804;2708;289;1065;226;711;515;1776
411240;201305;792;2557;720;2402;326;1172;168;495;494;1667
411250;201305;3048;8732;2543;7788;792;2515;829;2550;1621;5065
411260;201305;254;747;203;660;68;257;86;256;154;513
411270;201305;1950;6403;1815;6170;630;2387;763;2526;1393;4913
411275;201305;1483;4590;1364;4352;440;1492;502;1581;942;3073
411280;201305;1665;5275;1359;4625;433;1668;211;659;644;2327
411290;201305;998;2910;850;2624;234;776;310;987;544;1763
411295;201305;1059;3277;990;3170;218;781;451;1410;669;2191
411300;201305;1336;3560;942;2794;90;315;394;1084;484;1399
411310;201305;811;2428;658;2167;168;647;300;948;468;1595
411320;201305;5511;17544;4613;15729;1329;4767;1350;4471;2679;9238
411325;201305;1466;5005;1345;4777;167;703;931;3332;1098;4035
411330;201305;3348;11454;3110;11051;1203;4601;1015;3577;2218;8178
411340;201305;916;2752;645;2120;133;490;263;872;396;1362
411342;201305;869;2569;727;2240;204;703;229;628;433;1331
411345;201305;994;3368;936;3257;280;1054;476;1648;756;2702
411350;201305;2419;7921;1953;6980;680;2601;293;965;973;3566
411360;201305;492;1290;327;979;42;167;161;418;203;585
411370;201305;40292;121166;31000;103306;7680;30083;10375;31618;18055;61701
411373;201305;1308;4335;1143;3985;348;1385;258;838;606;2223
411375;201305;1276;3666;1031;3173;308;990;289;855;597;1845
411380;201305;1219;3310;787;2424;174;607;231;690;405;1297
411390;201305;1692;5484;1571;5311;250;990;1147;3742;1397;4732
411400;201305;1506;4707;1298;4260;337;1230;486;1596;823;2826
411410;201305;2298;7395;2073;6905;734;2813;603;1718;1337;4531
411420;201305;4276;12711;3514;11162;1114;3968;819;2359;1933;6327
411430;201305;2498;8652;2277;8217;686;2688;1036;3611;1722;6299
411435;201305;511;1738;455;1594;141;536;144;484;285;1020
411440;201305;2458;8372;2274;8025;868;3318;698;2467;1566;5785
411450;201305;1747;5627;1607;5387;442;1543;826;2834;1268;4377
411460;201305;3729;12588;3314;11644;1458;5414;606;2056;2064;7470
411470;201305;884;2803;705;2383;217;779;154;494;371;1273
411480;201305;4268;13719;3661;12563;1697;6261;812;2675;2509;8936
411490;201305;1583;5208;1431;4924;648;2475;324;1018;972;3493
411500;201305;1260;4091;1054;3594;377;1402;257;840;634;2242
411510;201305;2364;7114;1945;6326;650;2328;412;1192;1062;3520
411520;201305;26121;77091;18519;61145;6445;23608;3880;12025;10325;35633
411530;201305;828;2482;600;2054;271;1036;118;358;389;1394
411535;201305;463;1451;282;1022;66;254;21;68;87;322
411540;201305;2574;7394;2129;6621;484;1645;1062;3375;1546;5020
411545;201305;930;3473;909;3429;210;866;593;2221;803;3087
411550;201305;644;1891;540;1724;249;847;120;369;369;1216
411560;201305;2441;7609;2129;6891;614;2200;548;1638;1162;3838
411570;201305;4607;13984;3950;12933;1408;5045;1092;3742;2500;8787
411573;201305;935;3044;897;2983;242;867;466;1577;708;2444
411575;201305;1328;4470;1209;4178;348;1292;471;1622;819;2914
411580;201305;3177;9986;2580;8793;663;2621;509;1554;1172;4175
411585;201305;412;1500;337;1272;103;413;39;128;142;541
411590;201305;548;1692;498;1585;143;527;131;388;274;915
411600;201305;325;1037;281;938;70;291;57;185;127;476
411605;201305;2130;6295;1698;5482;490;1753;672;2109;1162;3862
411610;201305;2086;6330;2000;6191;492;1619;1299;3986;1791;5605
411620;201305;2595;8898;2466;8673;872;3317;991;3555;1863;6872
411630;201305;663;1855;419;1452;142;569;76;238;218;807
411640;201305;545;1736;456;1546;141;532;159;498;300;1030
411650;201305;252;846;212;751;66;267;66;207;132;474
411660;201305;683;2140;626;2034;162;540;256;863;418;1403
411670;201305;1584;4850;1460;4633;527;1882;485;1415;1012;3297
411680;201305;1617;5196;1447;4910;405;1354;770;2797;1175;4151
411690;201305;3310;10377;2953;9720;1096;3905;867;2860;1963;6765
411695;201305;781;2566;678;2362;146;530;353;1232;499;1762
411700;201305;1736;5350;1381;4680;432;1623;388;1259;820;2882
411705;201305;2164;7668;1926;7228;483;1876;1126;4315;1609;6191
411710;201305;2119;6698;1700;5707;543;2009;334;975;877;2984
411720;201305;822;2567;669;2205;169;624;192;585;361;1209
411721;201305;651;2052;589;1946;155;570;251;806;406;1376
411722;201305;650;2025;541;1807;146;569;182;560;328;1129
411725;201305;1184;4008;922;3400;275;1128;285;1050;560;2178
411727;201305;2297;6794;1952;6125;488;1716;906;2737;1394;4453
411729;201305;485;1431;404;1290;74;267;174;524;248;791
411730;201305;5151;16172;4507;14903;1351;4831;1801;5950;3152;10781
411740;201305;503;1533;422;1369;127;485;168;491;295;976
411745;201305;806;2635;697;2385;211;798;180;567;391;1365
411750;201305;3626;11642;3114;10549;1048;3923;529;1611;1577;5534
411760;201305;8029;25388;7444;24386;2988;10334;2338;8081;5326;18415
411770;201305;3581;13280;3351;12724;1433;5694;784;3025;2217;8719
411780;201305;2794;9764;2721;9665;427;1464;1953;7319;2380;8783
411790;201305;2444;7710;2107;7117;744;2842;602;1969;1346;4811
411800;201305;1172;3647;781;2664;157;600;111;284;268;884
411810;201305;1406;4557;1250;4205;352;1373;318;898;670;2271
411820;201305;15544;50172;13239;45997;4757;16969;4340;16013;9097;32982
411830;201305;431;1228;363;1138;115;375;154;507;269;882
411840;201305;7932;24641;6692;22283;2180;8020;2111;6851;4291;14871
411845;201305;464;1563;382;1390;116;461;81;281;197;742
411850;201305;5652;18151;4978;16845;1507;5623;1738;5857;3245;11480
411860;201305;792;2704;708;2501;239;904;185;612;424;1516
411870;201305;866;3302;799;3132;143;603;214;785;357;1388
411880;201305;2407;7099;2064;6539;498;1748;1072;3436;1570;5184
411885;201305;1309;3778;1116;3512;405;1435;337;956;742;2391
411890;201305;1180;3751;919;3173;293;1142;217;651;510;1793
411900;201305;820;2756;696;2471;237;897;169;592;406;1489
411910;201305;1129;4048;1041;3824;320;1278;373;1308;693;2586
411915;201305;10600;32334;7823;26342;2249;8493;1960;5983;4209;14476
411920;201305;952;3510;880;3322;315;1278;208;779;523;2057
411925;201305;551;1675;461;1516;139;476;197;657;336;1133
411930;201305;5847;20164;5231;18858;1721;6581;2063;7622;3784;14203
411940;201305;3395;11918;3136;11355;1072;4094;959;3484;2031;7578
411950;201305;10153;33876;9024;31957;3043;11746;3956;13850;6999;25596
411960;201305;5479;17338;5188;16808;1551;5591;2403;7549;3954;13140
411965;201305;393;1393;350;1294;107;426;96;361;203;787
411970;201305;710;2155;583;1940;188;660;190;618;378;1278
411980;201305;1996;5633;1436;4753;179;660;852;2811;1031;3471
411990;201305;26054;93727;23277;87753;9283;37155;6238;24112;15521;61267
411995;201305;2810;9189;2618;8827;1099;3924;765;2625;1864;6549
412000;201305;1776;5303;1475;4742;336;1242;611;1733;947;2975
412010;201305;700;2419;631;2266;219;847;208;723;427;1570
412015;201305;562;1896;512;1793;102;402;282;965;384;1367
412020;201305;397;1249;323;1098;122;454;130;416;252;870
412030;201305;488;1583;364;1305;80;346;121;406;201;752
412033;201305;653;2114;527;1813;146;547;88;283;234;830
412035;201305;860;2675;765;2494;204;766;327;1006;531;1772
412040;201305;670;2274;622;2155;259;951;186;636;445;1587
412050;201305;1543;4802;1260;4190;342;1273;288;913;630;2186
412060;201305;7113;25911;6638;24784;2143;8473;2907;10999;5050;19472
412065;201305;898;2885;824;2734;287;1084;244;742;531;1826
412070;201305;1022;3013;925;2807;210;696;382;1135;592;1831
412080;201305;1837;5991;1421;5093;451;1792;166;528;617;2320
412085;201305;219;671;156;542;49;191;42;134;91;325
412090;201305;4657;16012;4489;15703;1036;3877;2859;10161;3895;14038
412100;201305;2139;6996;1909;6586;662;2423;669;2290;1331;4713
412110;201305;772;2584;725;2494;289;1034;267;895;556;1929
412120;201305;2268;7963;2129;7632;536;2106;1094;3792;1630;5898
412125;201305;940;3003;849;2857;273;988;333;1146;606;2134
412130;201305;752;2198;561;1837;137;507;167;539;304;1046
412135;201305;540;1604;419;1346;87;318;196;579;283;897
412140;201305;1740;5472;1497;4994;471;1678;436;1461;907;3139
412150;201305;2614;8178;2356;7658;413;1509;1368;4296;1781;5805
412160;201305;1017;3345;899;3113;290;1123;353;1180;643;2303
412170;201305;3994;14172;3616;13417;1487;5823;1189;4361;2676;10184
412175;201305;1435;5256;1358;5092;406;1658;561;2131;967;3789
412180;201305;1630;5410;1297;4796;552;2224;311;1109;863;3333
412190;201305;2793;8869;2421;8269;981;3508;719;2610;1700;6118
412200;201305;2079;7370;1627;6059;405;1605;518;1882;923;3487
412210;201305;646;1963;467;1562;144;548;98;303;242;851
412215;201305;2978;10301;2739;9834;560;2075;1683;6241;2243;8316
412217;201305;1079;3410;1039;3335;249;895;600;1834;849;2729
412220;201305;6563;21847;6301;21336;2385;8475;2845;9731;5230;18206
412230;201305;2705;9738;2465;9195;887;3573;697;2551;1584;6124
412240;201305;7580;22093;4723;15888;1140;4251;664;2019;1804;6270
412250;201305;2024;6508;1865;6182;687;2470;571;1827;1258;4297
412260;201305;1208;3729;838;2890;209;822;235;704;444;1526
412265;201305;1086;3594;1023;3485;299;1205;477;1548;776;2753
412270;201305;707;2457;568;2092;141;605;95;322;236;927
412280;201305;829;2700;755;2580;167;604;386;1314;553;1918
412290;201305;1162;3382;1000;3083;234;832;423;1250;657;2082
412300;201305;1569;4834;1326;4345;413;1575;424;1284;837;2859
412310;201305;1175;3425;1038;3251;228;604;665;2331;893;2935
412320;201305;716;2020;537;1719;123;459;247;780;370;1239
412330;201305;1915;5422;1496;4713;403;1379;664;2064;1067;3443
412340;201305;830;2745;650;2306;155;614;115;376;270;990
412350;201305;2286;7654;1962;6903;665;2516;351;1131;1016;3647
412360;201305;315;1052;288;986;77;281;69;208;146;489
412370;201305;1085;3471;871;3048;321;1181;252;877;573;2058
412380;201305;1893;5939;1732;5636;378;1271;869;2980;1247;4251
412382;201305;678;1973;549;1717;154;554;170;484;324;1038
412385;201305;2359;7860;2255;7656;557;1864;1150;4243;1707;6107
412390;201305;2313;7189;2147;6913;825;2878;780;2496;1605;5374
412395;201305;933;2665;764;2397;101;318;515;1663;616;1981
412400;201305;1177;3710;1066;3513;341;1217;446;1493;787;2710
412402;201305;1870;6056;1638;5576;525;1914;426;1389;951;3303
412405;201305;3617;11065;2568;8748;721;2815;247;736;968;3551
412410;201305;5946;20142;5497;19249;2536;9633;1062;3692;3598;13325
412420;201305;501;1549;431;1447;148;558;134;404;282;962
412430;201305;438;1359;372;1219;133;489;149;448;282;937
412440;201305;3905;12023;3485;11289;678;2424;1575;5344;2253;7768
412450;201305;524;1704;467;1556;134;487;145;426;279;913
412460;201305;959;2736;664;2185;164;634;177;549;341;1183
412470;201305;1903;6750;1799;6512;568;2204;806;2894;1374;5098
412480;201305;1262;3835;955;3185;244;902;225;662;469;1564
412490;201305;1237;3765;1121;3505;333;1090;328;1033;661;2123
412500;201305;1907;5880;1642;5367;554;1997;417;1258;971;3255
412510;201305;3074;10483;2780;9705;966;3666;775;2729;1741;6395
412520;201305;1710;5016;1369;4480;377;1303;623;2069;1000;3372
412530;201305;745;2257;651;2079;230;795;172;525;402;1320
412535;201305;354;1086;294;954;92;331;116;327;208;658
412540;201305;1156;3574;989;3224;216;822;386;1232;602;2054
412545;201305;860;2562;748;2330;149;521;284;808;433;1329
412550;201305;22159;69831;16484;57182;5086;19106;3382;10963;8468;30069
412555;201305;298;961;226;778;66;241;41;123;107;364
412560;201305;4256;15115;3818;14141;1280;5109;890;3078;2170;8187
412570;201305;3843;12328;3189;10903;1126;4148;732;2516;1858;6664
412575;201305;988;3251;848;2905;224;864;281;896;505;1760
412580;201305;1406;3992;1068;3427;282;972;354;1096;636;2068
412590;201305;438;1410;374;1290;166;610;80;269;246;879
412600;201305;1403;4623;1255;4329;448;1695;390;1293;838;2988
412610;201305;710;2378;596;2103;209;812;147;454;356;1266
412620;201305;1298;4398;1186;4176;486;1821;340;1196;826;3017
412625;201305;13174;38280;11256;34717;4357;14488;2578;7924;6935;22412
412627;201305;894;2876;682;2414;241;907;112;392;353;1299
412630;201305;3328;11064;3008;10337;909;3362;896;2979;1805;6341
412635;201305;468;1493;389;1322;113;389;63;197;176;586
412640;201305;887;2798;704;2402;209;816;193;616;402;1432
412650;201305;2220;6420;1825;5725;507;1716;746;2186;1253;3902
412660;201305;2934;9099;2480;8150;671;2517;667;2073;1338;4590
412665;201305;684;1875;448;1493;138;515;124;387;262;902
412667;201305;1497;4688;1238;4168;360;1403;377;1155;737;2558
412670;201305;625;2033;428;1536;107;433;62;190;169;623
412680;201305;1289;4434;1140;4065;366;1384;314;1016;680;2400
412690;201305;598;1940;478;1666;179;683;62;210;241;893
412700;201305;1720;5962;1560;5663;594;2364;570;2020;1164;4384
412710;201305;8642;27775;7235;24839;2189;8207;1853;6199;4042;14406
412720;201305;1508;4882;1148;3985;302;1137;126;353;428;1490
412730;201305;2699;8371;1948;6782;642;2395;245;788;887;3183
412740;201305;2002;6758;1858;6444;811;2989;235;853;1046;3842
412750;201305;3116;11074;3010;10893;624;2519;2092;7438;2716;9957
412760;201305;2061;7189;1988;7060;721;2821;702;2368;1423;5189
412770;201305;10797;32964;7627;25925;1979;7530;1570;4832;3549;12362
412780;201305;1438;4907;1293;4548;406;1515;411;1377;817;2892
412785;201305;2226;6859;1788;6018;601;2175;741;2449;1342;4624
412788;201305;1287;4433;1221;4305;329;1378;564;1863;893;3241
412790;201305;1061;3468;922;3157;229;880;310;955;539;1835
412795;201305;953;2941;846;2751;307;1082;283;884;590;1966
412796;201305;3090;9886;2934;9607;842;3015;1385;4483;2227;7498
412800;201305;3289;10235;2711;9161;813;2995;817;2626;1630;5621
412810;201305;8022;23534;5872;19065;1875;6697;1478;4440;3353;11137
412820;201305;5464;17646;4313;15348;1420;5504;1026;3706;2446;9210
412830;201305;359;1256;328;1191;105;433;69;220;174;653
412840;201305;2231;6637;1911;6024;630;2210;513;1611;1143;3821
412850;201305;2707;8510;2429;8131;516;1955;1305;4312;1821;6267
412853;201305;1749;5479;1575;5185;384;1518;780;2371;1164;3889
412855;201305;1603;4804;1330;4283;462;1699;399;1165;861;2864
412860;201305;1172;3766;1071;3582;319;1187;464;1475;783;2662
412862;201305;688;2029;606;1869;193;647;197;586;390;1233
412863;201305;1191;4223;1154;4151;176;665;815;2935;991;3600
412865;201305;602;1975;451;1575;98;377;171;586;269;963
412870;201305;968;2940;856;2774;322;1123;311;1027;633;2150
412880;201305;1553;4333;1318;3972;398;1332;399;1160;797;2492
420005;201305;469;1532;367;1303;90;354;157;520;247;874
420010;201305;3067;10031;2683;9351;438;1649;1849;6504;2287;8153
420020;201305;700;2480;521;1975;122;514;88;295;210;809
420030;201305;397;1301;275;1026;82;358;58;191;140;549
420040;201305;957;3076;679;2559;238;991;184;636;422;1627
420050;201305;673;2274;616;2147;206;766;217;733;423;1499
420055;201305;240;861;202;753;56;213;44;146;100;359
420060;201305;370;1329;285;1107;74;311;42;153;116;464
420070;201305;1875;6248;1700;5819;276;1068;819;2926;1095;3994
420075;201305;141;476;107;383;31;120;32;109;63;229
420080;201305;532;1916;491;1812;196;788;93;338;289;1126
420090;201305;642;2400;511;2048;149;615;101;418;250;1033
420100;201305;1430;4870;1342;4750;293;1043;895;3248;1188;4291
420110;201305;420;1478;388;1401;129;461;163;613;292;1074
420120;201305;296;1060;249;954;112;463;35;115;147;578
420125;201305;345;1468;332;1437;132;603;90;366;222;969
420127;201305;506;1654;273;1037;97;391;30;119;127;510
420130;201305;2649;9326;2420;8882;746;3077;944;3182;1690;6259
420140;201305;6226;19169;4846;16720;1750;6681;1286;4284;3036;10965
420150;201305;654;2091;519;1760;189;696;134;403;323;1099
420160;201305;244;803;167;600;51;224;34;97;85;321
420165;201305;150;535;131;488;31;119;31;121;62;240
420170;201305;223;753;164;633;64;293;20;52;84;345
420180;201305;371;1282;261;972;85;331;61;207;146;538
420190;201305;453;1558;335;1318;143;624;69;272;212;896
420195;201305;1319;3838;1056;3489;289;1067;499;1666;788;2733
420200;201305;2751;9204;1846;7109;670;2864;318;1082;988;3946
420205;201305;992;3433;901;3254;302;1184;387;1407;689;2591
420207;201305;1096;3406;855;2918;282;1082;241;778;523;1860
420208;201305;463;1573;404;1433;165;613;118;418;283;1031
420209;201305;282;1004;210;791;48;192;48;181;96;373
420210;201305;1665;5638;1140;4473;333;1491;150;526;483;2017
420213;201305;828;3202;792;3119;185;756;485;1933;670;2689
420215;201305;451;1605;370;1344;113;430;65;214;178;644
420220;201305;406;1639;386;1586;172;754;75;265;247;1019
420230;201305;4098;13289;3392;12004;876;3473;1808;6264;2684;9737
420240;201305;11798;37676;8245;30150;2069;8868;3124;10271;5193;19139
420243;201305;465;1627;423;1519;138;549;140;496;278;1045
420245;201305;897;3003;716;2654;216;927;142;472;358;1399
420250;201305;842;2770;794;2691;305;1113;321;1111;626;2224
420253;201305;629;1696;529;1561;115;360;264;851;379;1211
420257;201305;400;1304;338;1185;97;338;157;555;254;893
420260;201305;1262;4442;1172;4270;379;1488;539;1989;918;3477
420270;201305;344;1250;263;997;35;133;19;65;54;198
420280;201305;2503;7630;1833;6456;579;2310;560;1746;1139;4056
420285;201305;135;408;58;211;10;42;3;6;13;48
420287;201305;605;1950;540;1821;141;513;225;751;366;1264
420290;201305;5261;16235;3747;12940;1003;3849;1317;4318;2320;8167
420300;201305;5393;17672;3820;14211;1198;5059;756;2764;1954;7823
420310;201305;731;2372;700;2313;187;664;387;1244;574;1908
420315;201305;791;2953;703;2746;198;872;312;1204;510;2076
420320;201305;4456;15042;3887;13988;1270;5190;1520;5211;2790;10401
420325;201305;477;1584;459;1535;161;604;141;451;302;1055
420330;201305;1195;4342;1009;3819;373;1531;178;577;551;2108
420340;201305;1401;4495;1223;4110;314;1168;467;1493;781;2661
420350;201305;1519;5137;1391;4892;393;1470;674;2409;1067;3879
420360;201305;3288;11213;2785;10066;1145;4515;508;1725;1653;6240
420370;201305;1821;5266;1657;5067;212;686;1348;4081;1560;4767
420380;201305;5108;17978;4433;16326;1519;6098;1143;4165;2662;10263
420390;201305;1925;5969;1241;4485;447;1754;265;859;712;2613
420395;201305;2199;6986;1759;5998;540;2085;416;1305;956;3390
420400;201305;1428;4458;1131;3877;362;1443;369;1168;731;2611
420410;201305;717;2142;572;1909;141;525;285;939;426;1464
420415;201305;434;1469;393;1361;113;418;158;543;271;961
420417;201305;767;2612;701;2470;152;542;358;1280;510;1822
420419;201305;398;1345;317;1202;157;626;88;342;245;968
420420;201305;14014;45033;11270;39057;3930;14703;3362;11560;7292;26263
420425;201305;1160;3425;791;2627;125;510;311;944;436;1454
420430;201305;4007;12928;2762;9929;890;3472;740;2622;1630;6094
420435;201305;188;661;142;534;68;281;22;80;90;361
420440;201305;1393;4185;914;3242;319;1222;166;528;485;1750
420445;201305;428;1303;340;1151;106;377;146;503;252;880
420450;201305;1180;3566;712;2607;177;752;141;413;318;1165
420455;201305;2138;6942;1949;6597;627;2393;816;2693;1443;5086
420460;201305;9361;30745;7948;28004;2445;9671;3081;10372;5526;20043
420470;201305;1039;3046;785;2606;258;928;236;773;494;1701
420475;201305;144;524;120;448;45;176;32;128;77;304
420480;201305;5778;17889;4928;16528;2110;7814;865;2863;2975;10677
420490;201305;657;2388;575;2165;182;713;147;530;329;1243
420500;201305;2053;6602;1785;6123;536;1939;948;3312;1484;5251
420510;201305;181;799;177;780;79;351;36;151;115;502
420515;201305;154;589;130;522;42;177;22;87;64;264
420517;201305;908;2924;831;2755;120;407;561;1902;681;2309
420519;201305;341;1070;279;923;59;194;128;441;187;635
420520;201305;631;2061;559;1922;133;506;252;841;385;1347
420530;201305;1339;4799;1125;4239;413;1708;269;915;682;2623
420535;201305;239;812;224;777;71;277;69;223;140;500
420540;201305;18869;60131;14857;51461;5387;20337;4477;15043;9864;35380
420543;201305;424;1270;330;1116;54;196;225;759;279;955
420545;201305;1304;4357;1132;3987;377;1505;369;1203;746;2708
420550;201305;4433;15296;3921;14090;1352;5434;1224;4330;2576;9764
420555;201305;418;1438;370;1329;155;593;99;358;254;951
420560;201305;564;1713;487;1569;71;253;264;868;335;1121
420570;201305;1766;6060;1464;5324;468;1865;405;1389;873;3254
420580;201305;897;3237;797;3045;261;1107;336;1278;597;2385
420590;201305;3011;9882;2288;8174;591;2314;482;1631;1073;3945
420600;201305;654;2433;614;2339;208;877;246;908;454;1785
420610;201305;553;1893;423;1584;155;637;69;228;224;865
420620;201305;1169;3806;1045;3565;410;1524;238;793;648;2317
420630;201305;942;3213;790;2820;256;1002;221;685;477;1687
420640;201305;540;1917;350;1387;93;411;41;169;134;580
420650;201305;2076;6839;1344;4989;369;1569;282;862;651;2431
420660;201305;659;2024;556;1836;113;422;302;975;415;1397
420665;201305;718;2229;517;1784;97;374;194;600;291;974
420670;201305;1605;5401;1276;4613;370;1492;212;710;582;2202
420675;201305;215;710;159;574;36;144;74;248;110;392
420680;201305;491;1395;377;1222;98;362;154;483;252;845
420690;201305;797;2898;627;2423;181;783;194;701;375;1484
420700;201305;6196;19584;5243;17580;1936;7142;1257;4028;3193;11170
420710;201305;690;2601;614;2434;246;1036;150;566;396;1602
420720;201305;1834;6000;1657;5746;492;1786;906;3136;1398;4922
420730;201305;4391;14119;3903;13261;1559;5623;1332;4504;2891;10127
420740;201305;602;2225;589;2200;172;649;345;1313;517;1962
420750;201305;2340;7870;1748;6430;459;1944;556;1813;1015;3757
420757;201305;101;365;90;346;26;110;20;67;46;177
420760;201305;409;1398;336;1197;81;323;114;398;195;721
420765;201305;515;1886;394;1530;126;512;83;311;209;823
420768;201305;1175;4385;1067;4124;347;1383;438;1774;785;3157
420770;201305;816;2729;579;2144;198;802;166;573;364;1375
420775;201305;561;1880;518;1797;122;433;294;1027;416;1460
420780;201305;1629;5176;1203;4125;377;1389;367;1198;744;2587
420785;201305;385;1288;319;1114;82;315;126;419;208;734
420790;201305;1267;4779;1084;4253;321;1343;455;1730;776;3073
420800;201305;831;2537;545;1889;156;588;124;399;280;987
420810;201305;2378;8777;2014;7852;734;3151;542;2043;1276;5194
420820;201305;7363;26698;6414;24916;2355;10159;2312;8850;4667;19009
420830;201305;2550;8876;2231;8257;884;3527;736;2631;1620;6158
420840;201305;943;3320;763;2936;272;1155;222;779;494;1934
420845;201305;1000;3615;860;3320;331;1395;146;533;477;1928
420850;201305;1668;5869;1270;5017;465;1986;274;1098;739;3084
420860;201305;623;1948;452;1588;192;747;151;511;343;1258
420870;201305;1296;3986;1072;3664;446;1648;321;1092;767;2740
420880;201305;1412;4884;1203;4343;362;1368;273;967;635;2335
420890;201305;11756;28527;5688;18261;1198;4608;2266;6599;3464;11207
420895;201305;170;491;96;317;28;97;38;123;66;220
420900;201305;2127;6423;1505;5214;489;1861;375;1230;864;3091
420910;201305;20970;67492;14595;53489;4215;17508;3618;12582;7833;30090
420915;201305;643;2590;603;2467;160;658;287;1245;447;1903
420917;201305;349;1087;226;754;54;206;82;228;136;434
420920;201305;162;485;107;374;40;151;17;59;57;210
420930;201305;19021;60783;16768;56548;5910;21704;5722;19292;11632;40996
420940;201305;4410;14161;3911;13047;1242;4589;1311;4096;2553;8685
420945;201305;183;625;148;531;50;201;40;133;90;334
420950;201305;470;1554;282;1106;85;379;44;164;129;543
420960;201305;1359;4464;1163;4087;439;1677;325;1038;764;2715
420970;201305;2536;8427;2277;8024;689;2519;1172;4282;1861;6801
420980;201305;351;1313;327;1249;101;381;180;716;281;1097
420985;201305;443;1471;330;1216;109;428;77;267;186;695
420990;201305;852;2627;590;2150;148;590;180;588;328;1178
421000;201305;650;2375;475;1896;159;705;54;159;213;864
421003;201305;571;1743;269;985;71;281;37;124;108;405
421005;201305;223;782;211;759;66;262;102;361;168;623
421010;201305;6265;20604;5217;18397;1844;6960;1626;5536;3470;12496
421020;201305;500;1776;443;1643;101;379;227;906;328;1285
421030;201305;1045;3881;954;3636;348;1390;294;1153;642;2543
421040;201305;793;2634;737;2525;234;877;291;950;525;1827
421050;201305;1794;5118;1192;4138;328;1301;471;1541;799;2842
421055;201305;236;858;191;728;53;229;52;172;105;401
421060;201305;517;1987;426;1717;137;590;84;314;221;904
421070;201305;746;2475;544;1984;146;611;187;686;333;1297
421080;201305;602;2053;576;1987;203;743;231;778;434;1521
421085;201305;492;1412;281;1015;77;304;54;210;131;514
421090;201305;402;1227;316;1032;88;306;139;454;227;760
421100;201305;901;2991;736;2601;230;845;185;593;415;1438
421105;201305;1306;4464;1184;4236;337;1296;532;1981;869;3277
421110;201305;1607;5407;1397;5058;531;2106;456;1587;987;3693
421120;201305;1470;5044;1221;4448;326;1389;391;1324;717;2713
421125;201305;330;1177;313;1125;124;471;104;347;228;818
421130;201305;4687;16115;4122;15083;1755;6847;1200;4552;2955;11399
421140;201305;394;1321;339;1189;111;420;116;393;227;813
421145;201305;441;1566;402;1455;76;312;195;675;271;987
421150;201305;427;1556;352;1403;107;441;148;594;255;1035
421160;201305;722;2365;525;1956;133;547;148;530;281;1077
421165;201305;307;1139;252;949;64;254;104;398;168;652
421170;201305;1801;6015;1546;5314;505;1826;706;2377;1211;4203
421175;201305;1210;3883;1013;3562;378;1486;318;1034;696;2520
421180;201305;431;1371;304;1102;104;431;112;359;216;790
421185;201305;393;1233;336;1121;65;212;170;591;235;803
421187;201305;295;969;255;888;73;269;96;319;169;588
421189;201305;522;1636;470;1527;131;462;188;604;319;1066
421190;201305;8780;29905;7302;26718;2536;9872;2328;8495;4864;18367
421200;201305;1018;3592;918;3371;289;1179;417;1495;706;2674
421205;201305;197;667;153;563;35;150;36;110;71;260
421210;201305;1916;6237;1776;5864;608;2134;612;2004;1220;4138
421220;201305;2349;8390;2132;7960;729;2895;738;2818;1467;5713
421223;201305;777;2356;538;1940;175;660;271;966;446;1626
421225;201305;1096;3524;962;3258;282;1015;380;1266;662;2281
421227;201305;902;3220;855;3143;249;908;492;1894;741;2802
421230;201305;743;2589;680;2429;197;755;260;898;457;1653
421240;201305;512;1783;388;1419;120;480;57;187;177;667
421250;201305;1799;5787;1311;4885;489;1993;375;1342;864;3335
421260;201305;228;763;160;625;39;156;35;132;74;288
421270;201305;599;1767;384;1382;143;539;88;339;231;878
421280;201305;1509;4956;1254;4557;480;2007;310;1116;790;3123
421290;201305;1899;5623;1322;4484;461;1674;297;914;758;2588
421300;201305;275;956;253;907;127;505;72;226;199;731
421310;201305;505;1781;436;1586;155;568;106;378;261;946
421315;201305;326;1019;227;808;59;226;77;262;136;488
421320;201305;501;1752;345;1306;77;336;61;165;138;501
421330;201305;602;2203;538;2069;233;1007;67;252;300;1259
421335;201305;544;1887;446;1688;145;602;106;398;251;1000
421340;201305;1576;5486;1491;5339;529;2014;594;2127;1123;4141
421350;201305;944;3354;799;3040;309;1306;221;809;530;2115
421360;201305;3031;9835;2228;8134;570;2371;759;2657;1329;5028
421370;201305;1059;3921;926;3615;337;1439;255;989;592;2428
421380;201305;985;2967;830;2665;182;620;407;1302;589;1922
421390;201305;184;614;149;528;24;92;44;159;68;251
421400;201305;359;1465;304;1320;137;609;70;291;207;900
421410;201305;314;1088;273;999;72;266;131;499;203;765
421415;201305;311;1047;207;822;72;297;59;229;131;526
421420;201305;1373;4472;1098;3763;274;1003;250;814;524;1817
421430;201305;250;871;194;748;74;318;34;134;108;452
421440;201305;747;2390;560;2039;198;763;213;772;411;1535
421450;201305;608;2213;526;2007;228;926;138;524;366;1450
421460;201305;562;1992;450;1742;136;574;104;374;240;948
421470;201305;466;1860;437;1775;144;621;177;688;321;1309
421480;201305;2295;7899;1775;6736;603;2547;542;1893;1145;4440
421490;201305;216;839;195;787;96;402;37;147;133;549
421500;201305;2600;9626;2353;9106;1049;4396;558;2129;1607;6525
421505;201305;391;1384;356;1292;140;510;114;422;254;932
421507;201305;555;2025;512;1905;127;483;204;758;331;1241
421510;201305;268;1061;250;1018;85;384;93;335;178;719
421520;201305;676;2022;542;1755;75;294;334;1041;409;1335
421530;201305;395;1431;302;1222;97;441;112;431;209;872
421535;201305;564;1920;440;1677;103;427;213;809;316;1236
421540;201305;366;1179;322;1089;77;294;119;382;196;676
421545;201305;1153;4189;995;3854;342;1460;208;767;550;2227
421550;201305;1929;6963;1807;6710;728;2909;591;2163;1319;5072
421555;201305;216;746;132;493;35;144;32;112;67;256
421560;201305;185;647;117;459;41;167;16;58;57;225
421565;201305;1030;3403;952;3257;447;1615;284;950;731;2565
421567;201305;934;3639;818;3317;415;1718;153;628;568;2346
421568;201305;378;1445;360;1399;126;514;120;462;246;976
421569;201305;145;537;128;484;32;137;40;132;72;269
421570;201305;887;3174;743;2836;284;1192;191;674;475;1866
421575;201305;606;2100;543;1966;118;442;282;1043;400;1485
421580;201305;4005;13877;3307;12316;1354;5575;749;2584;2103;8159
421590;201305;248;833;213;740;50;180;97;323;147;503
421600;201305;727;2383;618;2160;205;752;179;621;384;1373
421605;201305;619;2021;452;1682;146;617;105;388;251;1005
421610;201305;1805;4814;1424;4253;226;752;884;2638;1110;3390
421620;201305;4499;14324;3416;12102;1254;4774;1121;4017;2375;8791
421625;201305;320;1178;262;999;86;357;87;309;173;666
421630;201305;2274;7327;1610;5737;462;1797;416;1457;878;3254
421635;201305;270;1000;238;944;67;288;98;361;165;649
421640;201305;1063;3557;958;3375;214;769;585;2101;799;2870
421650;201305;2275;8048;2077;7603;901;3590;337;1187;1238;4777
421660;201305;8451;29878;7055;27068;2612;10976;2095;7667;4707;18643
421670;201305;1056;3743;875;3273;253;1032;271;1004;524;2036
421680;201305;1359;4698;1252;4422;529;2018;218;693;747;2711
421690;201305;1954;6748;1573;5786;503;1982;321;1169;824;3151
421700;201305;727;2368;513;1933;177;722;142;476;319;1198
421710;201305;323;1187;277;1062;113;443;67;249;180;692
421715;201305;223;750;182;645;51;187;55;201;106;388
421720;201305;2105;6337;1502;5425;633;2535;451;1558;1084;4093
421725;201305;118;445;113;431;39;155;47;173;86;328
421730;201305;484;1679;323;1242;99;431;87;280;186;711
421740;201305;650;2170;521;1861;163;673;133;396;296;1069
421750;201305;1281;4176;1079;3731;353;1312;344;1097;697;2409
421755;201305;399;1407;337;1223;98;372;89;314;187;686
421760;201305;337;1170;272;1035;94;402;116;412;210;814
421770;201305;3485;11039;2972;10061;1418;4978;721;2557;2139;7535
421775;201305;514;1680;393;1432;96;366;129;468;225;834
421780;201305;1675;6014;1391;5378;593;2458;375;1368;968;3826
421790;201305;852;2675;591;2180;202;850;127;426;329;1276
421795;201305;325;1066;281;939;52;182;88;294;140;476
421800;201305;2189;7732;1844;6999;572;2434;591;2013;1163;4447
421810;201305;699;2432;601;2174;200;778;131;453;331;1231
421820;201305;975;3359;854;3089;208;886;321;1080;529;1966
421825;201305;1222;4379;1162;4221;211;857;641;2280;852;3137
421830;201305;2943;10553;2797;10271;665;2451;1642;6385;2307;8836
421835;201305;161;559;136;509;55;228;46;157;101;385
421840;201305;502;1842;455;1716;183;764;160;561;343;1325
421850;201305;531;1625;431;1465;153;538;151;554;304;1092
421860;201305;419;1443;325;1226;79;329;87;311;166;640
421870;201305;4982;15255;3670;12505;1211;4426;686;2282;1897;6708
421875;201305;238;835;174;657;44;187;45;145;89;332
421880;201305;876;3128;772;2877;291;1216;160;522;451;1738
421885;201305;344;1250;317;1171;89;340;149;557;238;897
421890;201305;1039;3686;905;3392;328;1326;281;1009;609;2335
421895;201305;405;1446;394;1427;119;433;207;774;326;1207
421900;201305;827;2802;693;2459;186;709;256;842;442;1551
421910;201305;466;1637;370;1398;108;475;91;292;199;767
421915;201305;585;1894;521;1769;88;336;328;1107;416;1443
421917;201305;480;1660;417;1536;153;644;114;368;267;1012
421920;201305;714;2350;616;2205;293;1127;186;607;479;1734
421930;201305;3556;11008;2714;9297;865;3298;444;1488;1309;4786
421935;201305;807;3044;693;2757;204;881;258;1026;462;1907
421940;201305;289;1170;251;1042;91;414;71;267;162;681
421950;201305;3949;11647;2520;8848;842;3119;535;1927;1377;5046
421960;201305;231;784;195;698;58;221;57;194;115;415
421970;201305;1857;6068;1546;5338;564;2114;347;1070;911;3184
421985;201305;390;1171;268;914;47;193;95;332;142;525
430003;201305;900;2659;730;2373;224;819;275;889;499;1708
430005;201305;267;952;246;902;59;237;131;447;190;684
430010;201305;1899;5978;1540;5185;520;1810;560;1928;1080;3738
430020;201305;1055;2993;944;2822;248;831;499;1417;747;2248
430030;201305;1449;4251;1310;3953;415;1297;505;1478;920;2775
430040;201305;12546;33011;11246;31311;3486;9878;5689;16521;9175;26399
430045;201305;646;1930;575;1787;90;317;377;1142;467;1459
430047;201305;188;553;166;509;39;125;89;277;128;402
430050;201305;880;2629;608;2078;102;421;308;1010;410;1431
430055;201305;235;738;199;643;49;176;107;335;156;511
430057;201305;68;184;29;99;7;30;12;29;19;59
430060;201305;13167;45348;12208;43699;4323;16021;5550;20350;9873;36371
430063;201305;935;2982;839;2734;263;878;373;1267;636;2145
430064;201305;1628;5013;1405;4625;350;1148;796;2740;1146;3888
430066;201305;145;399;118;359;38;124;54;161;92;285
430070;201305;476;1659;419;1526;111;432;149;515;260;947
430080;201305;530;1852;449;1648;127;519;103;352;230;871
430085;201305;487;1636;433;1535;141;544;203;688;344;1232
430087;201305;927;2861;910;2828;94;312;764;2366;858;2678
430090;201305;682;1871;272;905;39;148;98;318;137;466
430100;201305;891;3077;814;2898;318;1249;210;640;528;1889
430105;201305;615;2141;550;2009;218;837;134;471;352;1308
430107;201305;252;854;207;723;46;175;106;357;152;532
430110;201305;2114;6460;1986;6260;659;2256;953;2974;1612;5230
430120;201305;1594;5155;1398;4727;224;785;982;3311;1206;4096
430130;201305;4375;11436;4084;11070;694;1983;2781;7703;3475;9686
430140;201305;1107;3734;911;3250;313;1114;323;1179;636;2293
430150;201305;816;2360;629;2002;160;540;217;687;377;1227
430155;201305;481;1569;373;1324;96;328;156;564;252;892
430160;201305;17548;53386;16513;51703;3860;13241;9160;29341;13020;42582
430163;201305;1758;5530;1534;5099;374;1401;702;2350;1076;3751
430165;201305;255;964;232;916;108;429;43;170;151;599
430170;201305;693;2135;415;1487;123;500;108;344;231;844
430175;201305;913;3183;820;2972;209;730;452;1729;661;2459
430180;201305;1135;3229;1008;3050;199;639;598;1866;797;2505
430185;201305;706;1828;410;1249;65;243;145;366;210;609
430187;201305;735;2353;678;2268;187;737;320;1039;507;1776
430190;201305;2206;6762;1959;6323;518;1917;944;3064;1462;4981
430192;201305;185;604;142;477;33;119;60;194;93;313
430195;201305;188;611;87;333;14;58;14;42;28;100
430200;201305;1725;5787;1525;5416;603;2250;300;1099;903;3349
430205;201305;460;1447;385;1312;43;184;261;878;304;1062
430210;201305;5691;17144;3566;12405;1059;3917;671;2178;1730;6095
430215;201305;297;950;253;861;67;256;125;408;192;664
430220;201305;574;1553;315;1077;73;284;55;170;128;454
430222;201305;301;952;235;810;76;296;95;301;171;597
430223;201305;260;890;255;877;71;249;152;523;223;772
430225;201305;39;134;35;118;4;9;7;20;11;29
430230;201305;2136;6866;2013;6735;383;1190;1488;5175;1871;6365
430235;201305;216;750;179;663;67;277;36;112;103;389
430237;201305;354;1066;319;999;41;171;227;668;268;839
430240;201305;985;3126;819;2782;315;1200;227;673;542;1873
430245;201305;775;2803;690;2584;195;745;296;1143;491;1888
430250;201305;1588;4535;1459;4296;496;1540;613;1873;1109;3413
430258;201305;170;535;135;453;25;83;67;218;92;301
430260;201305;775;2279;545;1797;76;300;310;1008;386;1308
430265;201305;320;1060;278;960;133;488;42;110;175;598
430270;201305;3333;9844;3071;9417;883;3072;1501;4511;2384;7583
430280;201305;4945;14911;4517;14088;1477;4962;1961;6010;3438;10972
430290;201305;2340;6798;2225;6673;334;1019;1771;5411;2105;6430
430300;201305;9315;29850;8246;27843;3479;12270;3017;10584;6496;22854
430310;201305;7983;26102;7362;24933;2584;9372;3055;10184;5639;19556
430320;201305;764;2436;591;2084;101;348;293;1084;394;1432
430330;201305;917;2624;836;2479;218;712;393;1092;611;1804
430340;201305;642;1803;452;1537;119;459;213;711;332;1170
430350;201305;5897;19609;5228;18102;1885;6974;2002;6835;3887;13809
430355;201305;204;590;141;472;31;134;32;99;63;233
430360;201305;1017;2806;932;2670;159;491;584;1682;743;2173
430367;201305;330;955;236;776;35;134;93;286;128;420
430370;201305;543;1689;489;1570;175;604;134;396;309;1000
430380;201305;845;2231;468;1538;155;523;147;512;302;1035
430390;201305;3749;11919;3151;10581;836;3088;1026;3249;1862;6337
430400;201305;1234;3054;898;2577;199;692;494;1321;693;2013
430410;201305;660;1879;535;1674;112;388;293;925;405;1313
430420;201305;4200;12775;3631;11491;1161;3772;1475;4703;2636;8475
430430;201305;643;1926;496;1642;164;578;133;409;297;987
430435;201305;1732;5004;1626;4826;345;1032;1064;3210;1409;4242
430440;201305;4112;13258;3577;12401;905;3498;1500;5275;2405;8773
430450;201305;8814;26623;7571;23950;2565;8449;2940;9364;5505;17813
430460;201305;22692;71867;19353;65948;7056;25696;7058;24343;14114;50039
430461;201305;463;1323;154;513;36;119;36;127;72;246
430462;201305;320;993;278;918;113;389;89;293;202;682
430463;201305;3587;12231;3221;11464;887;3460;1541;5473;2428;8933
430465;201305;586;1703;494;1533;132;453;282;867;414;1320
430466;201305;4043;12437;3848;12089;1299;4381;1716;5433;3015;9814
430467;201305;542;1740;479;1622;140;514;220;743;360;1257
430468;201305;1365;4147;1230;3930;529;1844;255;784;784;2628
430469;201305;117;335;40;163;12;51;10;42;22;93
430470;201305;6484;18149;5266;16214;1859;6210;1986;6140;3845;12350
430471;201305;913;3161;833;2980;322;1213;187;667;509;1880
430480;201305;780;2307;516;1732;106;392;127;383;233;775
430485;201305;214;682;130;483;26;90;50;206;76;296
430490;201305;492;1502;358;1237;117;435;117;404;234;839
430495;201305;388;1220;284;988;79;303;75;258;154;561
430500;201305;1577;4597;1411;4307;404;1379;701;2096;1105;3475
430510;201305;25348;81723;19954;68046;7011;26054;5628;18451;12639;44505
430511;201305;456;1442;296;1036;88;301;58;201;146;502
430512;201305;1273;3460;1142;3242;336;982;490;1469;826;2451
430513;201305;581;1764;449;1473;87;300;211;684;298;984
430515;201305;569;1787;499;1617;103;354;218;725;321;1079
430517;201305;1269;4455;1210;4314;242;920;745;2622;987;3542
430520;201305;1654;5111;1442;4670;498;1728;611;1953;1109;3681
430530;201305;878;2613;607;2016;151;573;185;563;336;1136
430535;201305;2178;7402;1931;6807;559;2158;667;2346;1226;4504
430537;201305;561;1663;411;1423;58;195;317;1131;375;1326
430540;201305;695;1820;563;1637;130;430;327;903;457;1333
430543;201305;571;1572;523;1523;130;402;320;952;450;1354
430544;201305;663;2328;588;2109;138;524;302;1054;440;1578
430545;201305;1225;4159;1090;3992;357;1162;621;2566;978;3728
430550;201305;567;1887;467;1640;129;503;182;629;311;1132
430558;201305;113;337;86;284;34;124;15;39;49;163
430560;201305;313;886;253;775;56;217;110;317;166;534
430570;201305;1084;3020;854;2616;215;728;450;1320;665;2048
430580;201305;941;2847;690;2331;246;857;193;682;439;1539
430583;201305;117;335;56;188;6;26;12;38;18;64
430585;201305;307;904;246;767;82;292;114;324;196;616
430587;201305;302;969;268;898;132;461;77;247;209;708
430590;201305;1540;4421;1465;4300;319;1069;875;2478;1194;3547
430593;201305;36;143;34;136;14;58;10;37;24;95
430595;201305;147;463;100;372;40;156;14;45;54;201
430597;201305;365;1178;313;1057;55;201;145;465;200;666
430600;201305;1784;5334;1386;4423;341;1144;530;1675;871;2819
430605;201305;1234;4088;1060;3697;280;1072;433;1547;713;2619
430607;201305;659;1865;584;1724;113;381;361;1015;474;1396
430610;201305;7757;22088;6465;20011;1478;5129;3334;10244;4812;15373
430613;201305;188;523;138;420;37;128;62;169;99;297
430620;201305;927;2984;789;2669;249;945;301;933;550;1878
430630;201305;411;1316;270;941;85;300;59;191;144;491
430632;201305;693;2006;483;1573;74;289;289;902;363;1191
430635;201305;607;1817;471;1541;90;319;271;889;361;1208
430637;201305;478;1409;449;1358;63;222;326;947;389;1169
430640;201305;1622;4914;1089;3648;274;998;235;664;509;1662
430642;201305;444;1268;349;1122;70;235;201;664;271;899
430645;201305;163;516;105;373;30;116;22;72;52;188
430650;201305;1894;6693;1695;6184;425;1600;900;3384;1325;4984
430655;201305;294;932;274;880;61;223;104;280;165;503
430660;201305;5552;17529;4652;15777;1652;6076;1762;5927;3414;12003
430670;201305;486;1448;445;1375;48;142;337;1077;385;1219
430673;201305;675;1758;456;1417;132;422;212;665;344;1087
430675;201305;166;509;127;427;21;82;65;217;86;299
430676;201305;4356;13720;4098;13304;1256;4394;2006;6683;3262;11077
430680;201305;1153;3550;924;3044;221;850;379;1138;600;1988
430690;201305;4217;12709;3640;11626;1209;3953;1575;5268;2784;9221
430692;201305;272;971;212;834;40;164;124;502;164;666
430693;201305;1716;5004;1403;4297;319;1070;484;1440;803;2510
430695;201305;493;1469;412;1304;92;329;194;570;286;899
430697;201305;390;1146;324;1048;107;352;137;469;244;821
430700;201305;9928;27508;5762;19054;1323;4916;948;2943;2271;7859
430705;201305;406;1293;379;1245;116;411;185;610;301;1021
430710;201305;1765;4807;1472;4336;324;1014;838;2599;1162;3613
430720;201305;729;2040;529;1742;158;554;237;789;395;1343
430730;201305;1635;4818;1474;4559;349;1053;871;2819;1220;3872
430740;201305;541;1684;413;1396;151;527;91;307;242;834
430745;201305;507;1516;406;1313;64;224;242;757;306;981
430750;201305;1703;5085;1534;4783;467;1635;774;2279;1241;3914
430755;201305;618;1830;464;1489;125;462;191;553;316;1015
430760;201305;3253;8998;2805;8424;596;1919;1632;5049;2228;6968
430770;201305;6345;20019;5482;18434;1438;5276;2524;8374;3962;13650
430780;201305;1727;5458;1539;5114;547;1983;588;1780;1135;3763
430781;201305;611;1950;480;1686;150;546;199;703;349;1249
430783;201305;523;1453;441;1313;93;303;207;570;300;873
430786;201305;115;406;104;373;40;156;13;43;53;199
430790;201305;2897;8507;2145;7013;520;1963;953;2981;1473;4944
430800;201305;705;2315;634;2148;194;707;238;780;432;1487
430805;201305;424;1303;355;1169;28;111;250;825;278;936
430807;201305;252;830;237;798;53;194;124;409;177;603
430810;201305;482;1503;305;1084;59;252;56;174;115;426
430820;201305;1100;3803;970;3481;326;1270;318;1090;644;2360
430825;201305;446;1311;258;849;51;189;78;229;129;418
430830;201305;2691;8170;2507;7845;434;1406;1582;5234;2016;6640
430840;201305;889;2907;854;2841;230;693;492;1754;722;2447
430843;201305;98;331;77;260;17;56;31;102;48;158
430845;201305;464;1421;398;1297;138;473;89;284;227;757
430850;201305;3182;10121;2909;9608;947;3305;1145;3809;2092;7114
430860;201305;581;2034;520;1883;184;782;119;370;303;1152
430865;201305;699;2007;653;1916;195;589;347;1024;542;1613
430870;201305;432;1417;353;1248;124;452;129;440;253;892
430880;201305;1316;4008;1116;3592;469;1632;275;900;744;2532
430885;201305;159;560;138;516;52;198;35;133;87;331
430890;201305;1813;5124;1608;4793;202;678;1139;3449;1341;4127
430900;201305;3181;8907;3023;8698;584;1736;2055;6074;2639;7810
430905;201305;872;2856;739;2547;271;1010;206;677;477;1687
430910;201305;1651;5521;1477;5217;604;2322;525;1802;1129;4124
430912;201305;560;1682;453;1497;90;353;232;731;322;1084
430915;201305;369;1347;298;1178;93;406;96;358;189;764
430920;201305;15996;53032;15296;51904;5573;19495;8353;28349;13926;47844
430925;201305;92;267;75;233;21;71;39;120;60;191
430930;201305;8515;27995;7509;25954;2299;8427;3254;11542;5553;19969
430940;201305;1022;3303;879;3047;224;894;304;1001;528;1895
430950;201305;1561;4570;1243;3871;394;1293;395;1210;789;2503
430955;201305;90;309;72;261;28;110;15;51;43;161
430957;201305;297;1061;261;976;69;263;126;475;195;738
430960;201305;1621;4907;1398;4508;556;1876;490;1591;1046;3467
430965;201305;1143;3848;996;3527;238;947;547;1861;785;2808
430970;201305;480;1439;341;1137;100;363;97;314;197;677
430975;201305;592;2017;529;1864;107;389;343;1209;450;1598
430980;201305;537;1378;345;1090;100;359;125;347;225;706
430990;201305;618;2075;481;1705;168;622;106;374;274;996
430995;201305;672;2098;623;2004;210;680;269;901;479;1581
431000;201305;1559;4414;1025;3320;289;1065;153;426;442;1491
431010;201305;2363;7554;1819;6406;568;2195;588;1969;1156;4164
431020;201305;13516;35084;9809;28326;2978;9078;3124;9312;6102;18390
431030;201305;389;1235;262;920;51;192;71;264;122;456
431033;201305;2690;8166;2507;7900;621;2014;1469;4887;2090;6901
431036;201305;152;472;92;317;25;92;21;60;46;152
431040;201305;952;2912;839;2716;259;918;416;1316;675;2234
431041;201305;569;1618;512;1530;188;594;165;520;353;1114
431043;201305;361;1233;295;1074;142;565;94;299;236;864
431046;201305;109;336;86;286;25;88;36;117;61;205
431050;201305;1738;4532;1562;4313;305;831;1063;3050;1368;3881
431053;201305;573;1968;514;1850;175;693;195;677;370;1370
431055;201305;613;1849;595;1820;77;238;454;1418;531;1656
431057;201305;274;830;180;641;51;202;79;269;130;471
431060;201305;6019;18173;5762;17878;1068;2961;4229;13791;5297;16752
431065;201305;430;1356;415;1331;43;142;312;1006;355;1148
431070;201305;736;2213;577;1873;142;453;240;773;382;1226
431075;201305;249;783;178;616;35;140;56;192;91;332
431080;201305;592;1994;498;1790;147;558;89;313;236;871
431085;201305;891;2470;728;2194;144;466;395;1189;539;1655
431087;201305;587;1763;544;1683;32;82;463;1461;495;1543
431090;201305;439;1232;295;954;99;340;83;251;182;591
431100;201305;4582;13148;3976;12098;1140;3707;1813;5622;2953;9329
431110;201305;1463;4223;1269;3839;349;1098;698;2074;1047;3172
431112;201305;720;2329;692;2281;237;803;339;1145;576;1948
431113;201305;617;1921;476;1586;164;537;131;458;295;995
431115;201305;1417;4432;1336;4285;324;1096;793;2512;1117;3608
431120;201305;2555;8589;2353;8203;759;2939;1007;3368;1766;6307
431123;201305;507;1681;444;1552;113;407;225;808;338;1215
431125;201305;1275;4211;1120;3889;356;1274;505;1839;861;3113
431127;201305;112;327;72;230;13;44;20;61;33;105
431130;201305;3712;11057;3209;10224;984;3439;1444;4644;2428;8083
431140;201305;3267;9486;2255;7592;522;2067;775;2389;1297;4456
431142;201305;534;1645;498;1591;70;242;344;1122;414;1364
431150;201305;1294;4052;1082;3654;318;1101;392;1361;710;2462
431160;201305;840;2645;719;2370;161;528;396;1331;557;1859
431162;201305;404;1179;266;899;51;198;64;196;115;394
431164;201305;77;226;33;123;9;34;1;4;10;38
431170;201305;875;2709;748;2451;242;849;237;762;479;1611
431171;201305;844;2654;771;2511;265;940;205;620;470;1560
431173;201305;459;1446;435;1399;97;327;273;875;370;1202
431175;201305;1300;3717;1148;3482;385;1234;502;1514;887;2748
431177;201305;963;3268;882;3101;300;1118;388;1391;688;2509
431179;201305;114;319;93;280;19;67;41;106;60;173
431180;201305;3059;9649;2612;8568;767;2790;845;2589;1612;5379
431190;201305;734;2105;496;1649;150;548;183;600;333;1148
431198;201305;333;1126;303;1064;142;566;59;187;201;753
431200;201305;228;706;118;414;28;109;19;62;47;171
431205;201305;284;959;230;802;62;222;77;258;139;480
431210;201305;740;2203;652;2014;165;534;350;1064;515;1598
431213;201305;315;1018;271;936;83;320;109;359;192;679
431215;201305;315;951;178;621;52;204;31;93;83;297
431217;201305;213;704;194;662;72;270;49;169;121;439
431220;201305;1201;3162;997;2823;153;491;575;1591;728;2082
431225;201305;1298;4038;1180;3843;293;1012;697;2318;990;3330
431230;201305;912;2849;752;2507;131;487;412;1377;543;1864
431235;201305;38;113;34;103;14;46;13;38;27;84
431237;201305;403;1390;363;1325;151;634;132;445;283;1079
431238;201305;49;167;43;155;11;46;15;50;26;96
431240;201305;2767;9150;2445;8540;900;3331;825;2859;1725;6190
431242;201305;426;1418;407;1384;185;698;29;89;214;787
431244;201305;421;1074;335;940;65;224;169;443;234;667
431245;201305;870;2568;765;2388;177;583;458;1448;635;2031
431247;201305;189;614;168;576;64;233;63;207;127;440
431250;201305;1864;6077;1680;5801;577;2134;686;2460;1263;4594
431260;201305;306;981;268;905;70;266;58;184;128;450
431261;201305;220;816;202;778;53;231;76;276;129;507
431262;201305;298;913;170;626;29;134;70;256;99;390
431265;201305;1155;3294;829;2569;222;787;296;784;518;1571
431267;201305;174;569;158;539;46;169;63;198;109;367
431270;201305;2255;6681;2052;6376;690;2287;983;3083;1673;5370
431275;201305;209;703;155;556;52;188;34;110;86;298
431280;201305;140;467;101;371;32;135;21;61;53;196
431290;201305;305;1011;246;849;67;266;64;205;131;471
431295;201305;203;673;124;429;26;103;24;67;50;170
431300;201305;123;455;95;367;33;128;9;37;42;165
431301;201305;227;809;179;666;63;230;30;104;93;334
431303;201305;594;1717;518;1595;147;511;229;681;376;1192
431306;201305;1976;5695;1540;4888;340;1279;584;1656;924;2935
431308;201305;52;184;50;179;38;139;9;29;47;168
431310;201305;732;2439;571;2053;104;414;241;880;345;1294
431320;201305;766;2347;504;1804;161;637;110;362;271;999
431330;201305;1728;4671;993;3282;293;1075;231;746;524;1821
431333;201305;292;846;229;713;64;208;79;233;143;441
431335;201305;100;316;87;290;19;61;30;94;49;155
431337;201305;2326;7628;2109;7174;707;2549;742;2552;1449;5101
431339;201305;655;1979;532;1687;118;388;282;911;400;1299
431340;201305;25790;72123;20041;62355;5235;18246;8762;26566;13997;44812
431342;201305;563;1584;530;1524;119;355;337;956;456;1311
431344;201305;358;1045;291;928;24;83;187;605;211;688
431346;201305;246;721;184;564;55;185;57;167;112;352
431349;201305;499;1553;436;1393;86;271;216;702;302;973
431350;201305;3582;11205;3332;10800;540;2001;2257;7138;2797;9139
431360;201305;708;2052;582;1835;188;627;209;642;397;1269
431365;201305;1233;3992;1094;3754;456;1698;387;1300;843;2998
431370;201305;5267;16016;4676;15092;1176;4046;2548;8441;3724;12487
431380;201305;1127;3449;1056;3261;162;564;769;2330;931;2894
431390;201305;3419;10592;2770;9269;1017;3673;791;2529;1808;6202
431395;201305;1561;4869;1421;4645;358;1259;635;2139;993;3398
431400;201305;137;505;106;426;40;182;12;35;52;217
431402;201305;1127;2982;773;2348;152;507;375;1103;527;1610
431403;201305;310;925;235;787;82;311;49;148;131;459
431405;201305;4203;12390;3422;11185;803;3133;1674;5213;2477;8346
431406;201305;737;2446;587;2059;206;750;212;729;418;1479
431407;201305;636;2027;498;1689;168;579;142;466;310;1045
431410;201305;15877;51275;13484;46552;5708;20895;3358;12203;9066;33098
431413;201305;159;441;106;330;14;52;55;165;69;217
431415;201305;834;2508;757;2367;195;673;419;1292;614;1965
431417;201305;652;1741;526;1539;100;314;286;868;386;1182
431420;201305;1575;4479;1424;4239;354;1138;793;2375;1147;3513
431430;201305;525;1563;440;1421;130;468;183;561;313;1029
431440;201305;31385;95283;29028;91260;9873;32426;13281;43290;23154;75716
431442;201305;198;656;154;539;49;192;18;47;67;239
431445;201305;433;1269;355;1090;63;209;163;493;226;702
431446;201305;479;1440;377;1246;83;280;214;709;297;989
431447;201305;825;2440;624;1977;112;375;299;970;411;1345
431449;201305;836;2535;734;2360;131;457;409;1335;540;1792
431450;201305;2159;5888;2019;5682;553;1572;1182;3355;1735;4927
431455;201305;578;1542;444;1291;77;271;258;717;335;988
431460;201305;3640;10586;3233;9806;896;2884;1449;4455;2345;7339
431470;201305;2101;6413;1912;5992;570;1786;892;2931;1462;4717
431475;201305;91;312;59;237;16;62;4;16;20;78
431477;201305;585;1758;498;1589;127;413;259;825;386;1238
431478;201305;167;448;91;279;22;72;37;110;59;182
431480;201305;2309;7214;1909;6448;668;2410;483;1639;1151;4049
431490;201305;99227;295219;89355;280623;17949;63840;57279;176896;75228;240736
431500;201305;1175;3134;947;2711;295;868;319;906;614;1774
431505;201305;342;1024;331;1009;39;115;264;814;303;929
431507;201305;426;1112;391;1055;113;315;222;605;335;920
431510;201305;2175;6167;1894;5718;321;1046;1208;3612;1529;4658
431513;201305;208;660;184;600;46;160;77;256;123;416
431514;201305;107;270;64;201;12;41;34;110;46;151
431515;201305;741;2320;595;1969;140;509;298;923;438;1432
431517;201305;83;290;80;281;36;128;18;53;54;181
431520;201305;434;1412;348;1205;112;398;92;332;204;730
431530;201305;4374;11201;3630;10394;847;2352;2294;7103;3141;9455
431531;201305;262;765;195;635;56;209;77;258;133;467
431532;201305;512;1536;486;1481;101;337;283;850;384;1187
431535;201305;374;1120;257;812;63;229;61;169;124;398
431540;201305;2049;6926;1890;6713;205;595;1424;5455;1629;6050
431545;201305;131;407;65;239;6;26;9;35;15;61
431550;201305;2392;7455;2250;7184;571;2068;1063;3346;1634;5414
431555;201305;741;2053;679;1955;151;441;366;1050;517;1491
431560;201305;22429;72855;20690;69519;9080;30882;6823;24327;15903;55209
431570;201305;5376;16001;5113;15583;837;2540;3758;11644;4595;14184
431575;201305;391;1190;344;1117;64;233;190;594;254;827
431580;201305;688;2261;599;2055;160;617;227;719;387;1336
431590;201305;890;2728;729;2356;87;302;406;1323;493;1625
431595;201305;602;1792;542;1664;131;430;227;716;358;1146
431600;201305;2111;6654;1732;5816;520;1977;383;1108;903;3085
431610;201305;1548;4564;1210;3964;314;1122;613;1995;927;3117
431620;201305;283;920;231;763;83;291;94;292;177;583
431630;201305;1315;3731;1102;3276;254;783;593;1782;847;2565
431640;201305;5477;17502;5156;16953;1658;5947;2510;8061;4168;14008
431642;201305;483;1518;449;1433;63;238;266;819;329;1057
431643;201305;173;535;163;516;48;164;84;246;132;410
431645;201305;1763;5574;1643;5368;413;1373;955;3219;1368;4592
431647;201305;166;477;136;414;45;142;38;96;83;238
431650;201305;186;619;135;512;34;152;32;107;66;259
431660;201305;1425;4393;1157;3826;401;1401;423;1324;824;2725
431670;201305;1296;3787;1098;3428;340;1203;443;1305;783;2508
431673;201305;150;525;131;477;41;161;36;137;77;298
431675;201305;278;943;223;768;57;206;65;196;122;402
431680;201305;9421;28250;7765;25231;2579;8986;2911;9531;5490;18517
431690;201305;24201;72051;20456;66435;6787;23509;8407;27792;15194;51301
431695;201305;135;490;111;413;27;100;26;74;53;174
431697;201305;467;1391;446;1353;136;435;203;619;339;1054
431700;201305;1619;4715;1432;4352;297;1007;781;2302;1078;3309
431710;201305;12456;37848;10744;34872;3122;10627;5052;17038;8174;27665
431720;201305;6848;20231;6006;18766;1496;5293;3263;9926;4759;15219
431725;201305;41;150;40;147;22;82;6;22;28;104
431730;201305;3527;11368;3025;10421;906;3488;1245;4256;2151;7744
431740;201305;5901;17963;5381;16982;1851;6270;1990;6188;3841;12458
431750;201305;10067;29836;8777;27685;1798;6130;4823;15500;6621;21630
431755;201305;215;602;82;289;25;102;20;57;45;159
431760;201305;3617;11585;3165;10691;992;3611;932;3100;1924;6711
431770;201305;2258;6491;1978;6029;506;1695;1057;3149;1563;4844
431775;201305;230;680;190;602;75;258;61;175;136;433
431780;201305;2445;6886;2045;6130;660;2129;591;1703;1251;3832
431790;201305;1070;3568;998;3436;290;1068;523;1786;813;2854
431795;201305;415;1365;360;1192;53;185;225;742;278;927
431800;201305;9244;28258;8047;26102;2610;9257;2905;9275;5515;18532
431805;201305;233;581;67;243;19;81;12;42;31;123
431810;201305;3654;10715;3217;9795;878;2874;1491;4504;2369;7378
431820;201305;2662;8726;2435;8280;817;3000;738;2466;1555;5466
431830;201305;9999;28144;8810;26194;3342;10762;3158;9401;6500;20163
431840;201305;3459;10791;3094;10045;1010;3382;1327;4395;2337;7777
431842;201305;700;1886;437;1366;93;321;151;450;244;771
431843;201305;307;977;285;936;80;284;147;475;227;759
431844;201305;164;506;128;434;37;141;38;131;75;272
431845;201305;534;1692;506;1637;51;167;370;1224;421;1391
431846;201305;498;1581;448;1472;82;306;258;843;340;1149
431848;201305;194;532;96;331;19;79;23;72;42;151
431849;201305;299;793;141;439;27;91;39;110;66;201
431850;201305;4912;14708;4432;13812;1126;3904;2304;6971;3430;10875
431860;201305;948;2823;834;2628;236;807;396;1198;632;2005
431861;201305;79;262;57;197;16;61;12;39;28;100
431862;201305;472;1668;419;1552;160;636;129;471;289;1107
431870;201305;26091;75401;22263;68530;6360;21538;9766;29391;16126;50929
431880;201305;4539;15002;3901;13482;1261;4814;1562;5202;2823;10016
431890;201305;5743;17246;5184;16179;2122;6945;1610;5160;3732;12105
431900;201305;928;3082;822;2874;268;1040;316;1015;584;2055
431910;201305;767;1958;462;1380;102;349;195;530;297;879
431912;201305;596;1762;479;1515;145;455;168;547;313;1002
431915;201305;1239;3588;1014;3155;304;979;351;1103;655;2082
431920;201305;1463;4385;1414;4315;207;624;1093;3407;1300;4031
431930;201305;1208;3536;1011;3193;149;458;602;2029;751;2487
431935;201305;92;365;87;352;39;163;18;60;57;223
431936;201305;485;1415;443;1339;71;209;292;958;363;1167
431937;201305;288;819;206;652;50;171;66;200;116;371
431940;201305;2655;7561;1953;6244;578;1980;559;1744;1137;3724
431950;201305;1838;6059;1651;5696;518;1961;628;2063;1146;4024
431960;201305;3683;11292;3399;10722;1104;3711;1240;3953;2344;7664
431970;201305;501;1419;292;989;56;201;96;307;152;508
431971;201305;126;395;112;374;22;80;67;217;89;297
431973;201305;458;1691;410;1590;68;263;235;995;303;1258
431975;201305;12;51;9;43;2;12;4;17;6;29
431980;201305;1488;4414;1405;4285;356;1272;761;2261;1117;3533
431990;201305;8589;24862;7331;22965;1435;5153;3948;12267;5383;17420
432000;201305;10121;30920;8605;28247;2955;10050;3647;12141;6602;22191
432010;201305;2436;7458;2166;6939;543;1993;1046;3209;1589;5202
432020;201305;1942;5576;1791;5372;355;1137;1114;3337;1469;4474
432023;201305;508;1519;403;1282;115;408;161;479;276;887
432026;201305;1217;3875;1097;3635;234;785;636;2166;870;2951
432030;201305;396;1231;344;1114;99;347;145;443;244;790
432032;201305;444;1240;337;1056;53;187;221;673;274;860
432035;201305;832;2767;769;2630;208;773;429;1434;637;2207
432040;201305;657;2052;505;1699;124;468;119;314;243;782
432045;201305;188;648;168;603;48;187;76;268;124;455
432050;201305;754;2258;688;2133;146;475;401;1271;547;1746
432055;201305;746;2440;682;2304;156;569;422;1410;578;1979
432057;201305;470;1310;415;1199;64;205;245;666;309;871
432060;201305;380;1139;194;702;64;244;49;170;113;414
432065;201305;198;634;174;586;45;178;76;227;121;405
432067;201305;899;3095;695;2606;218;835;280;1024;498;1859
432070;201305;2146;6464;1950;6064;709;2408;730;2267;1439;4675
432080;201305;4017;12165;3674;11572;1153;3853;1668;5208;2821;9061
432085;201305;252;843;223;790;85;355;65;210;150;565
432090;201305;1597;5216;1419;4814;565;2053;373;1092;938;3145
432100;201305;1063;3306;671;2383;202;761;146;456;348;1217
432110;201305;2964;9192;2503;8277;942;3371;539;1753;1481;5124
432120;201305;4867;15534;4258;14330;1552;5715;1156;3765;2708;9480
432130;201305;1882;6127;1786;5958;535;1927;991;3313;1526;5240
432132;201305;396;1273;266;951;49;175;98;328;147;503
432135;201305;786;2392;744;2316;147;488;478;1483;625;1971
432140;201305;2868;8697;2450;7942;703;2324;1001;3646;1704;5970
432143;201305;1298;4153;1174;3954;261;911;771;2664;1032;3575
432145;201305;793;2577;604;2180;230;915;124;411;354;1326
432146;201305;235;781;195;680;68;250;58;200;126;450
432147;201305;814;2678;696;2428;217;792;326;1171;543;1963
432149;201305;388;1225;295;982;82;286;115;376;197;662
432150;201305;2904;9210;2479;8550;1051;3818;741;2662;1792;6480
432160;201305;4339;14657;3937;13965;1489;5567;1444;5404;2933;10971
432162;201305;310;781;96;322;25;95;24;65;49;160
432163;201305;323;844;108;339;21;63;24;75;45;138
432166;201305;733;2297;628;2088;157;585;265;810;422;1395
432170;201305;741;2556;548;2109;142;604;112;377;254;981
432180;201305;2645;7243;2011;6253;635;2160;654;1947;1289;4107
432183;201305;396;1355;374;1314;165;597;104;378;269;975
432185;201305;790;2370;544;1823;133;494;189;616;322;1110
432190;201305;3338;9594;2640;8040;750;2462;839;2411;1589;4873
432195;201305;1243;3632;1128;3460;199;667;719;2194;918;2861
432200;201305;3029;9735;2517;8833;872;3244;1003;3628;1875;6872
432210;201305;424;1298;383;1245;113;424;185;561;298;985
432215;201305;820;2731;772;2646;150;489;503;1812;653;2301
432218;201305;288;856;238;740;42;142;109;313;151;455
432220;201305;3673;10293;3144;9426;589;2036;1870;5454;2459;7490
432225;201305;57;205;51;197;30;119;6;29;36;148
432230;201305;976;2874;872;2720;283;980;418;1243;701;2223
432232;201305;541;1651;439;1449;103;382;238;778;341;1160
432234;201305;570;1633;465;1381;121;373;209;600;330;973
432235;201305;67;223;42;160;21;93;9;31;30;124
432237;201305;485;1391;452;1337;41;155;375;1089;416;1244
432240;201305;14645;51096;13045;48935;3368;13561;7656;29409;11024;42970
432250;201305;5365;19460;5127;18964;2514;9914;1237;4691;3751;14605
432252;201305;394;1274;379;1240;126;414;192;663;318;1077
432253;201305;1177;4138;1011;3703;350;1330;341;1255;691;2585
432254;201305;299;833;159;528;49;174;20;65;69;239
432255;201305;165;436;96;327;26;97;40;139;66;236
432260;201305;5953;16846;4923;15168;1174;3865;2598;8065;3772;11930
432270;201305;2483;8205;2304;7884;644;2278;1251;4348;1895;6626
432280;201305;1012;3154;731;2532;196;785;202;583;398;1368
432285;201305;106;340;70;240;23;87;15;42;38;129
432290;201305;555;1777;416;1432;86;335;171;556;257;891
432300;201305;21951;69824;20565;67469;5789;20129;10805;35558;16594;55687
432310;201305;967;3164;855;2943;218;819;431;1428;649;2247
432320;201305;256;763;195;644;58;195;68;236;126;431
432330;201305;198;619;106;383;27;108;11;36;38;144
432335;201305;199;593;105;362;37;131;15;41;52;172
432340;201305;275;742;152;476;47;150;40;118;87;268
432345;201305;717;2134;674;2075;175;641;368;1055;543;1696
432350;201305;403;1242;322;1090;88;319;88;284;176;603
432360;201305;43;148;38;136;17;64;11;33;28;97
432370;201305;444;1297;396;1210;35;102;270;833;305;935
432375;201305;780;2132;701;2005;123;364;444;1286;567;1650
432377;201305;62;220;33;122;5;21;8;20;13;41
432380;201305;813;2978;751;2824;349;1432;233;820;582;2252
500020;201305;1666;5819;1419;5285;521;2142;364;1260;885;3402
500025;201305;853;2343;611;1917;141;466;265;799;406;1265
500060;201305;5300;16105;4679;15386;397;1280;3963;13418;4360;14698
500070;201305;3326;10735;2932;10083;806;3094;1318;4458;2124;7552
500080;201305;1562;4957;1288;4480;447;1674;433;1554;880;3228
500085;201305;2136;6035;1636;5238;258;914;964;3001;1222;3915
500090;201305;2041;6425;1743;5886;406;1412;920;3202;1326;4614
500100;201305;2259;7153;2161;7038;840;3037;936;2951;1776;5988
500110;201305;7337;22407;6232;20745;1052;3942;3781;12955;4833;16897
500124;201305;1460;5257;1327;5022;259;948;797;3261;1056;4209
500150;201305;1251;3525;1071;3274;314;1023;512;1550;826;2573
500190;201305;4377;12252;3523;11228;869;3015;1924;6336;2793;9351
500200;201305;2398;6551;1804;5702;469;1682;875;2652;1344;4334
500210;201305;4603;14512;4092;13765;993;3560;2129;7418;3122;10978
500215;201305;1652;5374;1433;4905;369;1443;628;2030;997;3473
500220;201305;2446;8152;2101;7509;562;2179;851;3097;1413;5276
500230;201305;1524;4951;1389;4757;699;2544;412;1415;1111;3959
500240;201305;3978;13484;3284;12016;807;3266;1427;5393;2234;8659
500260;201305;2331;6728;1988;6190;498;1696;933;2742;1431;4438
500270;201305;91751;253309;67178;211226;22182;75876;18096;57877;40278;133753
500280;201305;1219;3769;1080;3569;257;916;586;1970;843;2886
500290;201305;3300;9229;2475;7753;768;2763;880;2541;1648;5304
500295;201305;2136;7007;1713;5946;466;1834;495;1532;961;3366
500310;201305;785;2195;715;2100;170;558;408;1139;578;1697
500315;201305;2661;8635;2345;8211;553;1882;1405;5247;1958;7129
500320;201305;11944;42144;10828;40170;3833;14857;4159;16513;7992;31370
500325;201305;3575;10258;2893;9139;911;3196;1051;3113;1962;6309
500330;201305;4740;13982;4254;13196;1349;4599;1977;5990;3326;10589
500345;201305;2100;6961;1992;6731;558;2063;957;3151;1515;5214
500348;201305;2275;7152;2156;6952;293;1030;1626;5248;1919;6278
500350;201305;1091;3486;745;2694;135;507;212;828;347;1335
500370;201305;20543;67633;17358;61415;4754;18694;7351;25938;12105;44632
500375;201305;2253;6693;1884;6034;487;1646;929;3073;1416;4719
500380;201305;2790;8413;2449;7718;746;2496;977;3084;1723;5580
500390;201305;518;1189;358;955;56;190;249;613;305;803
500400;201305;1142;3827;1026;3554;345;1303;301;968;646;2271
500410;201305;1951;5636;1683;5279;470;1594;769;2439;1239;4033
500430;201305;2309;7518;2006;7063;604;2228;909;3319;1513;5547
500440;201305;1257;3828;1103;3579;314;1167;588;1809;902;2976
500450;201305;2070;6647;1670;5810;476;1870;338;1054;814;2924
500460;201305;3357;10817;2843;10050;758;2869;1354;4801;2112;7670
500470;201305;3164;10376;2816;9502;996;3610;685;2181;1681;5791
500480;201305;1934;6539;1803;6327;191;727;1399;4997;1590;5724
500490;201305;921;2867;838;2732;296;1041;331;1090;627;2131
500500;201305;2845;9336;2454;8823;959;3854;927;3207;1886;7061
500510;201305;745;2127;572;1869;172;674;238;676;410;1350
500515;201305;1654;4866;1398;4493;282;881;873;2976;1155;3857
500520;201305;2473;9062;2243;8772;601;2432;1345;5483;1946;7915
500525;201305;1016;3584;932;3442;261;1020;453;1758;714;2778
500540;201305;3464;11531;2858;10407;963;3832;976;3520;1939;7352
500560;201305;4269;15180;3921;14679;904;3583;2451;9330;3355;12913
500568;201305;3402;9483;2663;8423;665;2293;1304;4249;1969;6542
500570;201305;7029;20046;5286;17060;1615;5575;2137;6942;3752;12517
500580;201305;2864;9197;2407;8336;565;2056;1275;4436;1840;6492
500600;201305;2161;6852;1866;6367;649;2358;723;2404;1372;4762
500620;201305;7287;21259;5515;18428;1454;5459;2667;8769;4121;14228
500625;201305;790;2484;595;2077;168;646;202;656;370;1302
500630;201305;5814;16888;4784;15415;1781;6357;1343;4308;3124;10665
500635;201305;2128;8868;1945;8576;334;1395;1230;5909;1564;7304
500640;201305;1189;3323;1005;3046;168;575;654;1933;822;2508
500660;201305;12950;41695;11425;39019;2450;9056;6777;23228;9227;32284
500690;201305;2894;8656;2430;8079;606;2104;1379;4806;1985;6910
500710;201305;2969;9904;2854;9724;885;3140;1503;5190;2388;8330
500720;201305;3667;11780;3160;10821;1125;4228;1111;3757;2236;7985
500730;201305;840;2541;703;2275;205;742;285;888;490;1630
500740;201305;3359;9733;2578;8388;634;2368;1140;3490;1774;5858
500750;201305;706;2282;668;2225;170;632;393;1279;563;1911
500755;201305;1121;3543;902;3127;227;842;365;1244;592;2086
500769;201305;4104;11704;3019;9546;765;2699;1051;3078;1816;5777
500770;201305;1495;4728;1279;4327;384;1385;493;1708;877;3093
500780;201305;888;3054;851;2972;313;1179;353;1184;666;2363
500790;201305;7441;22671;6457;20917;1503;5650;3369;10396;4872;16046
500793;201305;2299;6922;1896;6235;369;1402;842;2597;1211;3999
500795;201305;2062;6435;1872;6155;208;630;1438;4943;1646;5573
500797;201305;827;2410;682;2181;173;612;310;1006;483;1618
500800;201305;1970;6269;1734;5935;548;2049;836;2857;1384;4906
500830;201305;12994;41420;10535;36076;3581;13168;2894;9795;6475;22963
500840;201305;1191;3771;1013;3427;207;765;519;1738;726;2503
510010;201305;1195;3911;1134;3813;381;1352;503;1728;884;3080
510020;201305;2364;7201;1875;6365;599;2183;514;1648;1113;3831
510025;201305;8579;26889;7690;25415;2548;9264;3114;10071;5662;19335
510030;201305;2054;5709;1768;5301;540;1683;878;2691;1418;4374
510035;201305;889;2733;769;2550;188;640;414;1449;602;2089
510040;201305;1502;4308;1203;3868;305;1129;589;1827;894;2956
510050;201305;1563;4853;1271;4358;377;1426;510;1774;887;3200
510060;201305;1102;3357;883;2956;275;1013;267;859;542;1872
510080;201305;1268;4035;1080;3722;312;1264;427;1343;739;2607
510100;201305;554;1531;385;1205;102;358;149;445;251;803
510120;201305;282;598;204;511;16;37;179;452;195;489
510125;201305;2705;7484;2304;6861;475;1725;1207;3440;1682;5165
510130;201305;1882;5519;1701;5279;527;1725;759;2378;1286;4103
510140;201305;2806;9552;2395;8924;858;3323;969;3714;1827;7037
510160;201305;1261;4370;1210;4311;89;355;1067;3800;1156;4155
510170;201305;5184;16906;4634;15903;1305;5014;2111;7024;3416;12038
510180;201305;9208;27169;7296;23907;2407;8398;2735;9612;5142;18010
510185;201305;1024;3335;962;3248;255;832;573;2058;828;2890
510190;201305;1452;5186;1257;4879;347;1494;561;2234;908;3728
510250;201305;13108;43340;11575;41273;3651;13715;5800;21200;9451;34915
510260;201305;2469;9189;2354;8974;631;2311;1359;5534;1990;7845
510263;201305;3773;10927;3041;9741;902;3143;1126;3531;2028;6674
510267;201305;3987;12346;3420;11214;880;3218;1516;4794;2396;8012
510268;201305;808;2395;710;2263;220;774;352;1107;572;1881
510269;201305;803;2687;728;2560;241;880;289;1063;530;1943
510270;201305;2159;7078;1967;6804;484;1721;1039;3815;1523;5536
510279;201305;2002;6668;1856;6421;715;2739;674;2183;1389;4922
510285;201305;1385;4467;1205;4116;383;1408;392;1268;775;2676
510300;201305;2883;9336;2667;9057;397;1506;1975;6676;2372;8182
510305;201305;1580;5227;1340;4780;370;1446;475;1765;845;3211
510310;201305;1052;3121;848;2797;312;1141;262;847;574;1988
510320;201305;3686;11439;3098;10262;1014;3897;610;1707;1624;5604
510325;201305;5291;17431;4677;16513;601;2084;3559;13020;4160;15104
510330;201305;2574;8726;2281;8181;638;2530;899;3290;1537;5820
510335;201305;4186;13819;3769;13248;668;2362;2699;9820;3367;12182
510336;201305;459;1501;426;1445;102;374;215;728;317;1102
510337;201305;2219;7694;2034;7355;844;3121;740;2875;1584;5996
510340;201305;53993;168870;45523;156130;18893;70132;11134;40234;30027;110366
510343;201305;1032;3238;975;3169;135;420;768;2578;903;2998
510345;201305;1542;4721;1383;4483;414;1398;583;1922;997;3320
510350;201305;2985;9395;2611;8899;813;2941;1329;4619;2142;7560
510360;201305;1627;4683;1333;4313;290;994;873;2808;1163;3802
510370;201305;771;2872;687;2727;227;954;302;1228;529;2182
510380;201305;464;1558;387;1390;144;582;75;244;219;826
510385;201305;825;3251;752;3073;138;578;391;1736;529;2314
510390;201305;987;3346;913;3255;253;918;497;1882;750;2800
510395;201305;807;2176;638;1958;131;432;386;1235;517;1667
510410;201305;3643;12529;3481;12256;1123;4262;1707;5974;2830;10236
510420;201305;2088;5711;1651;4987;282;1029;920;2735;1202;3764
510450;201305;544;1582;428;1413;144;523;137;447;281;970
510452;201305;570;1828;438;1532;123;496;151;473;274;969
510454;201305;676;2255;604;2148;172;644;319;1172;491;1816
510455;201305;917;2937;748;2644;200;833;305;1054;505;1887
510460;201305;1654;5158;1550;5019;376;1397;949;2949;1325;4346
510480;201305;3798;10827;3077;9466;804;2689;1332;4059;2136;6748
510490;201305;1387;4803;1281;4647;398;1510;694;2533;1092;4043
510500;201305;1219;3979;1020;3661;288;1172;533;1866;821;3038
510510;201305;2824;10219;2555;9783;995;3962;1043;4054;2038;8016
510515;201305;5088;16303;4318;14757;1245;4756;1340;4371;2585;9127
510517;201305;1565;5040;1426;4837;428;1432;849;2992;1277;4424
510520;201305;2086;5636;1697;5088;147;523;1299;3854;1446;4377
510523;201305;981;3116;833;2866;269;1009;360;1210;629;2219
510525;201305;7339;18935;4645;14625;1211;4146;1596;4940;2807;9086
510530;201305;547;1632;489;1550;92;339;286;906;378;1245
510550;201305;2451;8428;2231;8101;642;2359;1161;4427;1803;6786
510558;201305;1919;5761;1519;5164;522;1911;509;1711;1031;3622
510560;201305;1393;4832;1119;4345;447;1793;255;1052;702;2845
510562;201305;4565;14498;4203;13814;1560;5581;1465;4829;3025;10410
510590;201305;2434;7492;1982;6911;609;2335;870;3036;1479;5371
510600;201305;1341;3557;999;3054;181;620;578;1719;759;2339
510610;201305;2388;7700;2288;7588;298;1154;1857;6070;2155;7224
510615;201305;2014;6963;1820;6612;607;2391;791;2815;1398;5206
510617;201305;481;1610;449;1566;81;319;333;1146;414;1465
510618;201305;1175;3644;905;3105;241;912;394;1356;635;2268
510619;201305;745;2135;498;1678;112;421;166;564;278;985
510620;201305;1108;3134;813;2717;292;1081;173;546;465;1627
510621;201305;1115;3992;983;3687;311;1277;366;1331;677;2608
510622;201305;3002;9880;2315;8205;671;2678;485;1511;1156;4189
510623;201305;3215;9793;2877;9314;1194;3984;912;3045;2106;7029
510624;201305;975;3346;869;3121;218;857;388;1335;606;2192
510625;201305;1887;6044;1634;5534;540;1999;540;1713;1080;3712
510626;201305;1129;3808;972;3550;311;1206;484;1806;795;3012
510627;201305;606;2025;514;1841;200;765;180;643;380;1408
510628;201305;1389;3830;1167;3556;185;645;809;2432;994;3077
510629;201305;1644;5647;1467;5278;581;2217;332;1188;913;3405
510630;201305;2548;8696;2186;8087;769;3107;680;2586;1449;5693
510631;201305;388;1193;352;1134;79;254;229;746;308;1000
510637;201305;2364;7507;2223;7244;708;2575;1069;3360;1777;5935
510642;201305;4273;14417;3698;13663;1266;4817;1793;6961;3059;11778
510645;201305;621;1637;520;1512;188;583;185;584;373;1167
510650;201305;5555;19698;5301;19362;1303;5054;3233;12171;4536;17225
510665;201305;1115;3011;851;2698;220;799;465;1469;685;2268
510670;201305;343;868;208;672;52;187;82;248;134;435
510675;201305;5805;19802;5113;18518;1904;7501;1559;5591;3463;13092
510677;201305;2339;6185;1782;5490;256;822;1311;4113;1567;4935
510680;201305;762;2462;666;2316;179;696;264;846;443;1542
510682;201305;2121;7159;1835;6625;510;1922;837;3183;1347;5105
510685;201305;691;2273;667;2237;168;598;391;1339;559;1937
510700;201305;2825;8773;2454;8244;565;2105;1484;4910;2049;7015
510704;201305;7021;21151;6136;19568;1843;6605;2858;8749;4701;15354
510706;201305;1317;4505;1225;4332;409;1531;588;2023;997;3554
510710;201305;3379;9979;2856;8968;843;3057;1094;3094;1937;6151
510715;201305;675;1825;460;1468;133;461;156;454;289;915
510718;201305;1572;5066;1473;4907;334;1174;950;3183;1284;4357
510719;201305;430;1015;262;780;36;154;125;331;161;485
510720;201305;1215;2983;914;2626;95;311;691;1996;786;2307
510724;201305;795;2537;698;2356;148;529;435;1470;583;1999
510726;201305;631;1765;565;1662;165;522;256;725;421;1247
510729;201305;558;1696;490;1586;146;503;221;711;367;1214
510730;201305;2056;6733;1916;6480;467;1848;1135;3654;1602;5502
510735;201305;1048;3770;922;3568;328;1301;413;1647;741;2948
510740;201305;966;2559;817;2362;149;438;537;1589;686;2027
510757;201305;607;2253;590;2207;167;670;310;1131;477;1801
510760;201305;22993;71190;20128;66096;7783;27299;6794;22235;14577;49534
510770;201305;3392;10743;3264;10567;610;1999;2196;7449;2806;9448
510774;201305;363;1037;304;955;51;179;184;576;235;755
510775;201305;818;2366;688;2184;275;973;276;899;551;1872
510776;201305;346;1101;307;1034;81;306;150;469;231;775
510777;201305;1301;4284;1053;3972;241;1070;640;2355;881;3425
510779;201305;604;1841;478;1610;98;353;198;695;296;1048
510780;201305;3450;10824;3158;10416;750;2622;1879;6300;2629;8922
510785;201305;1770;5430;1494;4977;514;1779;579;1984;1093;3763
510787;201305;1815;5948;1647;5643;507;1907;609;2024;1116;3931
510788;201305;335;1068;308;1032;130;416;110;390;240;806
510790;201305;12988;40228;9503;33467;3028;12172;1471;5029;4499;17201
510792;201305;4993;17195;3953;14908;1144;4932;723;2524;1867;7456
510794;201305;1265;4100;1039;3767;539;2062;200;678;739;2740
510795;201305;7297;25750;6421;23844;2369;9332;1774;6732;4143;16064
510800;201305;1623;4915;1427;4650;411;1505;716;2229;1127;3734
510805;201305;1526;4612;1270;4241;303;1156;782;2531;1085;3687
510810;201305;629;1619;511;1456;157;482;260;721;417;1203
510820;201305;818;2097;638;1823;169;567;253;656;422;1223
510830;201305;529;1915;485;1846;175;720;217;858;392;1578
510835;201305;637;2082;515;1851;203;794;205;690;408;1484
510840;201305;43326;115844;36361;107273;9692;30240;19507;59469;29199;89709
510850;201305;1583;4831;1322;4417;584;2163;202;550;786;2713
510860;201305;2270;7938;1983;7334;765;3000;452;1691;1217;4691
510880;201305;787;2735;703;2578;273;1047;254;932;527;1979
510885;201305;494;1474;379;1296;94;364;167;565;261;929
510890;201305;864;3022;755;2805;255;1054;184;638;439;1692
510895;201305;984;3310;915;3196;293;1144;399;1325;692;2469
520005;201305;994;3410;940;3323;313;1176;393;1380;706;2556
520010;201305;1733;6238;1562;5859;712;2954;229;718;941;3672
520013;201305;3679;10569;2986;9428;787;2663;1450;4627;2237;7290
520015;201305;568;1588;461;1435;123;391;227;741;350;1132
520017;201305;1147;3776;1023;3568;303;1151;438;1502;741;2653
520020;201305;362;1023;305;943;93;299;154;490;247;789
520025;201305;18772;64594;18437;64153;3464;12780;13679;47526;17143;60306
520030;201305;4123;14002;3750;13374;1396;5322;1324;4925;2720;10247
520050;201305;320;984;303;948;67;234;197;596;264;830
520055;201305;642;1959;557;1822;147;493;277;940;424;1433
520060;201305;1575;5135;1410;4813;355;1356;563;1979;918;3335
520080;201305;1424;4944;1363;4823;329;1209;804;2881;1133;4090
520082;201305;592;2093;564;2033;167;603;325;1215;492;1818
520085;201305;978;3166;860;2882;223;819;355;1198;578;2017
520090;201305;757;2119;697;2017;117;334;457;1349;574;1683
520110;201305;33672;107627;27427;98233;11589;45050;7381;26802;18970;71852
520120;201305;255;664;147;474;43;155;43;154;86;309
520130;201305;3263;10232;3141;10054;857;2976;1715;5492;2572;8468
520140;201305;40604;140602;37412;134123;14086;54329;11976;42833;26062;97162
520145;201305;532;1415;396;1233;93;313;169;511;262;824
520150;201305;619;1685;533;1574;167;536;251;729;418;1265
520160;201305;770;2401;701;2303;253;884;295;980;548;1864
520170;201305;3496;9028;2849;8339;681;2076;1782;5406;2463;7482
520180;201305;1376;4660;1289;4500;428;1600;552;1903;980;3503
520215;201305;1343;3808;1200;3604;244;848;741;2223;985;3071
520235;201305;746;2113;613;1923;191;660;273;834;464;1494
520250;201305;1091;3746;1016;3614;356;1341;480;1744;836;3085
520260;201305;689;1895;549;1646;96;331;285;823;381;1154
520280;201305;544;1638;495;1559;235;773;138;476;373;1249
520310;201305;844;2303;700;2132;184;565;452;1428;636;1993
520320;201305;1304;4383;1143;4090;299;1127;538;1953;837;3080
520330;201305;2575;8362;2118;7600;712;2782;698;2494;1410;5276
520340;201305;1801;4760;1492;4396;249;713;1126;3414;1375;4127
520350;201305;2716;8697;2440;8145;953;3388;1017;3310;1970;6698
520355;201305;1069;3829;1050;3785;427;1609;447;1611;874;3220
520357;201305;880;2488;768;2328;80;279;536;1609;616;1888
520360;201305;499;1402;452;1335;119;352;242;724;361;1076
520380;201305;974;2734;778;2448;163;558;439;1410;602;1968
520390;201305;1156;3168;817;2703;282;1071;296;903;578;1974
520393;201305;545;1509;503;1445;96;280;342;1002;438;1282
520396;201305;651;2169;629;2132;77;300;480;1631;557;1931
520400;201305;1733;5073;1491;4738;272;935;1017;3256;1289;4191
520410;201305;1329;3931;1100;3590;368;1320;493;1555;861;2875
520420;201305;314;895;254;796;61;224;123;366;184;590
520425;201305;1392;3969;1323;3841;435;1360;642;1830;1077;3190
520430;201305;1778;4938;1383;4303;330;1175;637;1946;967;3121
520440;201305;2449;7225;2053;6625;791;2785;633;2003;1424;4788
520450;201305;8615;25943;7156;23332;2313;8432;1913;5845;4226;14277
520455;201305;647;2003;547;1838;224;798;150;519;374;1317
520460;201305;703;2181;610;2028;213;776;214;714;427;1490
520465;201305;795;2228;701;2101;181;652;317;874;498;1526
520470;201305;1613;5421;1489;5234;373;1335;916;3341;1289;4676
520480;201305;822;2552;760;2469;185;613;499;1642;684;2255
520485;201305;1096;3803;1027;3690;393;1506;447;1593;840;3099
520490;201305;4236;13521;3489;12356;1295;4995;1351;4801;2646;9796
520495;201305;1374;3792;1157;3532;60;140;1056;3314;1116;3454
520500;201305;1953;5318;1778;5091;585;1749;796;2514;1381;4263
520505;201305;823;2448;716;2285;109;323;531;1745;640;2068
520510;201305;10448;30223;7054;24298;2242;8488;1781;6087;4023;14575
520520;201305;944;2878;839;2734;340;1182;321;1058;661;2240
520530;201305;2298;7318;2036;6889;478;1632;1031;3857;1509;5489
520540;201305;2763;8821;2494;8336;871;3064;1046;3439;1917;6503
520545;201305;1267;4042;1101;3691;352;1279;330;1048;682;2327
520547;201305;790;2523;629;2229;213;839;185;617;398;1456
520549;201305;7444;23729;6682;22861;1502;5623;4533;15371;6035;20994
520551;201305;3443;10792;3318;10634;996;3302;1850;6221;2846;9523
520552;201305;668;2292;653;2267;137;530;433;1477;570;2007
520570;201305;559;1698;425;1470;185;676;81;285;266;961
520580;201305;1849;5606;1510;5064;493;1860;353;1102;846;2962
520590;201305;1423;4185;1270;3946;351;1190;591;1713;942;2903
520620;201305;6531;21921;6036;21149;1478;5572;3466;12313;4944;17885
520630;201305;581;1627;501;1533;146;409;314;1023;460;1432
520640;201305;2171;6849;2064;6691;768;2542;928;3169;1696;5711
520650;201305;764;2299;690;2164;298;989;256;792;554;1781
520660;201305;352;1146;315;1069;111;410;95;318;206;728
520670;201305;701;2217;692;2205;75;187;594;1959;669;2146
520680;201305;476;1605;454;1572;180;671;160;543;340;1214
520690;201305;302;801;214;680;27;91;121;403;148;494
520710;201305;292;839;269;808;7;24;210;619;217;643
520725;201305;1621;4476;1323;4080;332;1122;709;2180;1041;3302
520735;201305;572;1824;498;1699;191;676;151;504;342;1180
520740;201305;1579;4791;1364;4494;390;1358;662;2207;1052;3565
520750;201305;657;1798;507;1607;148;521;296;933;444;1454
520753;201305;1042;3173;1027;3150;159;446;818;2573;977;3019
520760;201305;1093;3156;981;3017;333;1105;533;1597;866;2702
520780;201305;1806;4808;1611;4557;187;528;1282;3694;1469;4222
520790;201305;2377;7205;2173;6905;318;1095;1560;5030;1878;6125
520800;201305;16168;49910;14531;47934;3372;11270;8814;30948;12186;42218
520810;201305;799;2456;784;2427;113;366;607;1914;720;2280
520815;201305;337;1225;287;1118;164;692;42;167;206;859
520830;201305;1649;4379;1299;4014;68;185;1166;3697;1234;3882
520840;201305;1590;5506;1452;5222;484;1842;559;2060;1043;3902
520850;201305;769;2283;612;2064;190;686;280;924;470;1610
520860;201305;6702;20076;5258;18175;1591;5982;2576;9017;4167;14999
520870;201305;115703;334726;83724;275714;27919;99604;25021;82147;52940;181751
520880;201305;5580;17235;4315;15116;1360;5294;591;1838;1951;7132
520890;201305;3301;10343;3059;9961;777;2695;1643;5324;2420;8019
520910;201305;3642;12062;3252;11253;1146;4282;1023;3405;2169;7687
520915;201305;865;2500;639;2047;145;492;238;728;383;1220
520920;201305;2423;7268;2037;6695;557;1973;859;2886;1416;4859
520929;201305;419;1301;392;1267;113;380;201;648;314;1028
520940;201305;898;2882;854;2819;117;440;653;2123;770;2563
520945;201305;620;1593;557;1492;183;521;248;614;431;1135
520960;201305;849;2559;721;2375;120;419;462;1529;582;1948
520970;201305;3235;9623;2649;8569;583;2133;1157;3689;1740;5822
520980;201305;989;2750;928;2666;133;403;746;2143;879;2546
520990;201305;3595;11460;3195;10761;705;2513;1722;6319;2427;8832
520993;201305;951;2884;782;2537;177;626;384;1205;561;1831
520995;201305;2429;6843;2204;6541;364;1120;1611;4817;1975;5937
521000;201305;7259;22452;6338;20989;1613;5812;3460;11536;5073;17348
521010;201305;3267;10774;2957;10179;825;3053;1398;4844;2223;7897
521015;201305;670;1976;583;1840;140;462;315;990;455;1452
521020;201305;4125;12613;3454;11254;1357;4785;765;2235;2122;7020
521030;201305;787;2165;704;2050;141;430;482;1426;623;1856
521040;201305;4887;14943;4475;14278;1347;4312;2480;8220;3827;12532
521056;201305;959;3023;826;2802;280;997;357;1236;637;2233
521060;201305;1097;3174;953;2921;237;790;376;1110;613;1900
521080;201305;1074;2866;754;2317;194;721;275;740;469;1461
521090;201305;2982;9199;2619;8682;917;3255;1075;3578;1992;6833
521100;201305;1375;3663;1281;3559;226;625;928;2640;1154;3265
521120;201305;4536;13559;4170;12930;1041;3164;2333;7525;3374;10689
521130;201305;978;2938;858;2749;184;659;454;1489;638;2148
521140;201305;862;2991;785;2807;332;1251;164;562;496;1813
521150;201305;10229;28598;8524;25910;2707;9010;4200;12724;6907;21734
521160;201305;612;1695;501;1461;98;311;296;841;394;1152
521170;201305;1284;3182;1118;2980;311;807;656;1763;967;2570
521180;201305;5906;20958;5481;20031;2162;8375;1532;5622;3694;13997
521190;201305;7812;24326;6150;21480;2276;8322;2091;7384;4367;15706
521200;201305;776;2140;737;2091;111;321;539;1549;650;1870
521205;201305;450;1503;424;1450;63;233;276;960;339;1193
521210;201305;727;2267;576;1995;225;872;217;670;442;1542
521220;201305;3421;10220;3026;9658;1115;3830;1123;3538;2238;7368
521225;201305;343;942;275;852;49;176;173;545;222;721
521230;201305;1225;4002;1179;3895;423;1486;556;1786;979;3272
521250;201305;24000;83099;23132;81651;9591;35910;9029;32370;18620;68280
521260;201305;563;1490;449;1254;97;343;211;550;308;893
521270;201305;1651;5514;1564;5364;152;451;1249;4473;1401;4924
521280;201305;1582;5112;1398;4813;476;1729;628;2165;1104;3894
521290;201305;475;1434;367;1249;99;407;154;499;253;906
521295;201305;1030;3031;965;2937;212;705;639;1918;851;2623
521300;201305;1612;4881;1469;4632;479;1618;557;1806;1036;3424
521305;201305;789;2127;675;1974;141;408;438;1334;579;1742
521308;201305;4615;14344;3846;13101;758;2857;2356;7919;3114;10776
521310;201305;6238;19982;5465;18740;2283;8283;1617;5503;3900;13786
521340;201305;237;779;217;743;73;276;87;280;160;556
521350;201305;1995;5406;1659;4974;238;806;1075;3393;1313;4199
521370;201305;975;3211;911;3083;341;1228;343;1125;684;2353
521375;201305;1251;3676;1107;3445;291;967;603;1871;894;2838
521377;201305;940;2982;915;2947;98;299;768;2526;866;2825
521380;201305;3445;10478;2894;9632;673;2462;1415;4667;2088;7129
521385;201305;573;1680;520;1608;162;528;264;823;426;1351
521390;201305;1076;2934;837;2600;334;1160;257;790;591;1950
521400;201305;2329;6414;2028;6077;284;906;1596;4767;1880;5673
521405;201305;990;3161;974;3139;155;487;729;2411;884;2898
521410;201305;721;2390;669;2301;323;1089;229;837;552;1926
521440;201305;1405;3989;1382;3965;144;376;1189;3484;1333;3860
521450;201305;4731;14571;3997;13195;1351;4779;992;3101;2343;7880
521460;201305;6422;21179;5963;20442;1906;6961;2903;10100;4809;17061
521470;201305;702;2054;540;1751;134;487;127;427;261;914
521480;201305;509;1503;382;1283;133;468;99;333;232;801
521483;201305;2689;7625;2449;7241;583;1821;1391;4076;1974;5897
521486;201305;1480;4354;1353;4098;396;1350;763;2179;1159;3529
521487;201305;534;1484;414;1313;96;325;238;760;334;1085
521490;201305;760;2291;637;2128;132;484;383;1298;515;1782
521500;201305;1100;3750;1048;3673;100;355;896;3140;996;3495
521520;201305;853;2067;765;1968;180;375;443;1288;623;1663
521523;201305;10703;40599;10065;39478;2833;11981;5149;20361;7982;32342
521525;201305;908;2454;817;2336;111;343;548;1532;659;1875
521530;201305;1860;5711;1340;4670;568;2094;230;759;798;2853
521540;201305;858;2590;665;2192;217;820;164;467;381;1287
521550;201305;753;2075;701;2001;215;683;372;1011;587;1694
521560;201305;4943;15350;3952;14018;1708;6594;978;3303;2686;9897
521565;201305;589;1768;542;1708;92;316;393;1246;485;1562
521570;201305;3527;10747;3092;10048;1240;4250;1066;3539;2306;7789
521580;201305;565;1522;456;1370;173;545;163;510;336;1055
521590;201305;703;2054;614;1905;257;860;134;448;391;1308
521600;201305;605;1615;438;1319;113;376;155;418;268;794
521630;201305;1717;4817;1471;4420;613;2139;268;650;881;2789
521640;201305;1577;4814;1420;4569;529;1943;386;1259;915;3202
521645;201305;596;1934;535;1797;154;576;226;700;380;1276
521680;201305;1304;4414;1236;4259;763;2735;255;854;1018;3589
521690;201305;543;1657;493;1557;109;392;262;786;371;1178
521710;201305;2022;6490;1820;6103;389;1391;1103;3672;1492;5063
521720;201305;1947;5986;1796;5777;440;1450;1088;3586;1528;5036
521730;201305;3539;12269;3386;11964;1502;5776;1072;3561;2574;9337
521740;201305;3206;9172;2631;8429;1276;4220;884;2919;2160;7139
521760;201305;11553;40814;11035;40028;1893;7680;7758;28222;9651;35902
521770;201305;2666;8253;2303;7545;1008;3534;529;1632;1537;5166
521800;201305;8138;25116;7179;23729;2720;9399;3321;11319;6041;20718
521805;201305;664;1718;653;1705;241;565;345;1049;586;1614
521810;201305;795;2432;712;2296;191;676;368;1181;559;1857
521830;201305;5300;18336;5044;17926;1071;4125;3427;12131;4498;16256
521839;201305;630;1989;542;1798;149;531;230;728;379;1259
521850;201305;6110;17932;5720;17462;1287;3811;3883;12322;5170;16133
521860;201305;1644;5170;1452;4765;428;1541;539;1677;967;3218
521870;201305;538;1911;505;1823;165;647;138;457;303;1104
521878;201305;392;1365;369;1325;148;598;98;321;246;919
521880;201305;21932;60587;15641;50188;5989;20552;4529;14702;10518;35254
521890;201305;3445;11050;2978;10110;1187;4292;707;2397;1894;6689
521900;201305;1612;4350;1341;3971;369;1216;541;1507;910;2723
521910;201305;1130;3323;1003;3172;266;918;575;1842;841;2760
521920;201305;396;1285;388;1268;160;558;185;597;345;1155
521925;201305;537;1727;505;1637;108;380;302;945;410;1325
521930;201305;4042;13414;3730;12772;1500;5461;1137;3849;2637;9310
521935;201305;668;2036;636;1975;178;596;366;1098;544;1694
521940;201305;1141;3124;953;2834;370;1159;324;972;694;2131
521945;201305;639;2267;596;2215;126;424;435;1699;561;2123
521950;201305;456;1549;415;1466;158;599;150;519;308;1118
521960;201305;905;2695;784;2481;205;699;395;1244;600;1943
521970;201305;2287;6758;2165;6585;383;1217;1531;4757;1914;5974
521971;201305;885;2533;742;2300;199;681;339;1003;538;1684
521973;201305;777;2717;721;2601;222;832;231;834;453;1666
521975;201305;11996;36529;11392;35747;2372;8151;7370;23191;9742;31342
521980;201305;1660;5513;1626;5472;288;927;1258;4375;1546;5302
521990;201305;978;3214;930;3120;204;752;546;1788;750;2540
522000;201305;2030;6189;1825;5925;398;1360;1109;3762;1507;5122
522005;201305;305;891;246;794;65;228;127;395;192;623
522010;201305;2734;8467;2428;7973;906;3262;746;2372;1652;5634
522015;201305;957;2925;816;2711;240;890;426;1406;666;2296
522020;201305;3933;11672;3544;11172;1023;3376;1910;6033;2933;9409
522026;201305;486;1601;418;1530;232;889;143;517;375;1406
522028;201305;508;1557;463;1483;125;437;261;815;386;1252
522040;201305;2804;7392;2030;6380;748;2547;778;2423;1526;4970
522045;201305;11800;40337;10437;37370;3598;14068;2297;7988;5895;22056
522050;201305;1003;3030;849;2767;283;1018;348;1081;631;2099
522060;201305;2589;8726;2434;8515;792;2938;1388;4848;2180;7786
522068;201305;1361;4661;1287;4575;123;384;1086;4002;1209;4386
522070;201305;805;2504;744;2408;136;526;466;1486;602;2012
522100;201305;797;2224;708;2085;267;900;325;880;592;1780
522108;201305;860;2575;786;2471;86;293;594;1908;680;2201
522119;201305;1399;4347;1232;4140;135;454;1011;3464;1146;3918
522130;201305;494;1442;426;1366;127;453;220;705;347;1158
522140;201305;15690;46155;14123;44180;4161;13889;7703;24184;11864;38073
522145;201305;899;2632;849;2546;461;1464;201;584;662;2048
522150;201305;1219;3243;1007;2973;342;1072;429;1326;771;2398
522155;201305;703;2154;646;2073;156;531;380;1249;536;1780
522157;201305;646;1971;593;1882;79;271;449;1435;528;1706
522160;201305;5369;15960;4228;14177;1968;7243;864;2731;2832;9974
522170;201305;3124;8756;2692;8180;711;2185;1376;4405;2087;6590
522180;201305;430;1301;343;1191;174;660;115;386;289;1046
522185;201305;13422;44476;12819;43652;2745;10147;8193;28100;10938;38247
522190;201305;664;1993;601;1849;119;386;363;1124;482;1510
522200;201305;1518;5193;1423;4995;540;2025;451;1548;991;3573
522205;201305;1474;4329;1254;3967;382;1241;564;1807;946;3048
522220;201305;973;3147;897;3041;228;819;494;1767;722;2586
522230;201305;854;2891;816;2826;207;762;474;1692;681;2454
530010;201305;241652;805458;218684;757781;69338;264086;70513;244647;139851;508733
110001;201304;4100;13903;3572;13066;1086;4124;1937;7199;3023;11323
110002;201304;11459;38865;10469;37095;3778;14199;4444;15909;8222;30108
110003;201304;981;3227;919;3129;274;981;403;1343;677;2324
110004;201304;8811;30005;7968;28273;2610;10077;3104;11015;5714;21092
110005;201304;2262;7886;2176;7722;808;2935;992;3563;1800;6498
110006;201304;3381;9160;2157;7505;747;2740;698;2354;1445;5094
110007;201304;1400;4693;1296;4543;370;1320;756;2717;1126;4037
110008;201304;2364;8482;2228;8283;550;1961;1480;5762;2030;7723
110009;201304;4782;14354;3956;13237;877;3028;2593;8804;3470;11832
110010;201304;8125;23650;7288;22680;1262;3339;5283;17847;6545;21186
110011;201304;10374;33030;8750;30280;3527;12875;3006;10473;6533;23348
110012;201304;15145;48954;13761;46368;5192;18476;5650;19064;10842;37540
110013;201304;5028;16466;4251;15375;1272;4826;2177;8002;3449;12828
110014;201304;4078;12643;3490;11825;759;2652;2288;7861;3047;10513
110015;201304;4759;15898;4053;14698;1616;6215;1465;5311;3081;11526
110018;201304;4869;14798;4034;13737;1316;4939;1799;5896;3115;10835
110020;201304;48469;152097;43365;145677;10115;35017;26582;91773;36697;126790
110025;201304;4089;12579;3509;11499;603;2169;2520;8192;3123;10361
110026;201304;743;2283;634;2159;151;521;425;1474;576;1995
110028;201304;7205;21872;5578;19319;1711;6434;2025;7015;3736;13449
110029;201304;1598;4883;1290;4354;424;1481;585;2021;1009;3502
110030;201304;10847;31983;8971;29589;2716;9537;4538;15536;7254;25073
110032;201304;3948;13309;3629;12628;974;3576;1856;6465;2830;10041
110033;201304;4979;16281;4715;15904;1375;4606;2752;9798;4127;14404
110034;201304;3678;9741;3169;9167;426;1140;2555;7561;2981;8701
110037;201304;1989;6961;1794;6612;373;1376;1208;4531;1581;5907
110040;201304;3375;11509;3239;11252;1091;4016;1550;5412;2641;9428
110045;201304;4922;17931;4700;17646;1273;4984;2952;11179;4225;16163
110050;201304;1737;5803;1476;5474;542;2015;761;2911;1303;4926
110060;201304;977;3493;875;3299;219;833;520;2000;739;2833
110070;201304;1831;6497;1804;6434;299;1122;1355;4829;1654;5951
110080;201304;2928;9977;2869;9899;461;1525;2278;8029;2739;9554
110090;201304;927;2848;759;2578;233;877;316;1011;549;1888
110092;201304;1607;5370;1466;5173;372;1326;842;3116;1214;4442
110094;201304;2624;9121;2472;8913;681;2569;1482;5389;2163;7958
110100;201304;2615;8656;2305;8170;605;2175;1407;5104;2012;7279
110110;201304;1665;5742;1572;5633;645;2389;723;2666;1368;5055
110120;201304;1577;5476;1425;5124;401;1508;577;2080;978;3588
110130;201304;2696;7986;2144;7215;577;2087;1100;3705;1677;5792
110140;201304;2257;8071;2186;7965;546;2040;1369;5045;1915;7085
110143;201304;1471;5092;1236;4693;310;1243;730;2766;1040;4009
110145;201304;912;2923;835;2793;173;611;520;1745;693;2356
110146;201304;434;1433;391;1364;111;407;210;738;321;1145
110147;201304;850;2634;713;2441;209;782;342;1130;551;1912
110148;201304;1329;4044;1154;3736;364;1301;428;1319;792;2620
110149;201304;3323;10291;2798;9570;567;2023;1952;6794;2519;8817
110150;201304;2559;8046;2166;7476;457;1630;1413;4921;1870;6551
110155;201304;863;2978;839;2923;302;1107;386;1317;688;2424
110160;201304;2072;6881;1809;6504;392;1439;1206;4434;1598;5873
110170;201304;2850;8744;2384;8000;542;1932;1551;5226;2093;7158
110175;201304;1551;5233;1243;4850;115;478;967;3789;1082;4267
110180;201304;1646;5373;1455;5041;343;1227;894;3113;1237;4340
120001;201304;2668;10018;2605;9885;714;2844;1486;5763;2200;8607
120005;201304;1478;6281;1437;6203;184;735;1100;4968;1284;5703
120010;201304;3829;14312;3679;14034;731;2745;2406;9536;3137;12281
120013;201304;1660;6585;1634;6539;306;1186;1159;4833;1465;6019
120017;201304;1962;7207;1886;7073;508;1980;963;3884;1471;5864
120020;201304;13453;59696;13286;59311;2586;10899;9555;44618;12141;55517
120025;201304;2464;8912;2410;8826;644;2427;1432;5391;2076;7818
120030;201304;4997;21862;4973;21800;709;2842;3934;17859;4643;20701
120032;201304;1290;6280;1258;6211;175;985;937;4688;1112;5673
120033;201304;3464;13476;3438;13428;177;718;3104;12260;3281;12978
120034;201304;1810;7231;1808;7229;69;272;1691;6810;1760;7082
120035;201304;2267;11707;2249;11658;316;1515;1733;9467;2049;10982
120038;201304;3074;11505;2988;11330;820;3191;1687;6573;2507;9764
120039;201304;1331;7588;1310;7537;183;1081;1025;6014;1208;7095
120040;201304;40894;153149;38579;148021;12166;48371;19142;75696;31308;124067
120042;201304;2520;11406;2458;11256;275;1308;1970;9191;2245;10499
120043;201304;757;3710;749;3688;70;347;630;3158;700;3505
120045;201304;4130;15065;4106;15021;927;3349;2945;11033;3872;14382
120050;201304;7834;33156;7652;32749;1804;7452;4743;21702;6547;29154
120060;201304;4911;25365;4867;25275;783;3816;3670;20023;4453;23839
120070;201304;2539;9891;2504;9810;595;2189;1571;6531;2166;8720
120080;201304;3349;12891;3233;12712;580;2333;2306;9324;2886;11657
130002;201304;2603;11426;2458;11173;337;1586;1853;8559;2190;10145
130006;201304;1675;7346;1529;7068;177;888;1158;5421;1335;6309
130008;201304;1830;7755;1771;7640;206;932;1357;6018;1563;6950
130010;201304;2713;9276;2360;8858;257;883;1939;7500;2196;8383
130014;201304;3119;10479;2724;9911;412;1647;1875;6865;2287;8512
130020;201304;2292;8321;2275;8302;73;278;2176;7947;2249;8225
130030;201304;6024;24868;5846;24622;545;1921;4961;21660;5506;23581
130040;201304;3380;10860;3231;10631;184;640;2856;9449;3040;10089
130050;201304;5516;23254;4937;22273;806;3547;3422;16371;4228;19918
130060;201304;5501;23742;5197;23327;568;2448;4268;19664;4836;22112
130063;201304;2737;12627;2715;12578;349;1577;2232;10552;2581;12129
130068;201304;2754;12049;2615;11758;351;1726;1939;8789;2290;10515
130070;201304;5974;21209;5675;20806;442;1648;4805;17947;5247;19595
130080;201304;4642;21036;4525;20850;795;3774;3254;15416;4049;19190
130083;201304;1640;7003;1581;6901;290;1281;1139;5051;1429;6332
130090;201304;2233;8427;2137;8292;185;824;1816;7037;2001;7861
130100;201304;5026;20125;4841;19864;509;2229;3946;16414;4455;18643
130110;201304;6073;20045;5708;19593;1078;3537;4095;14707;5173;18244
130115;201304;3460;13341;3302;13123;202;646;2996;12128;3198;12774
130120;201304;12198;48064;11965;47735;1158;4246;10176;41855;11334;46101
130130;201304;3279;14495;3187;14333;488;2165;2439;11246;2927;13411
130140;201304;5710;23114;5667;23058;149;450;5468;22503;5617;22953
130150;201304;3192;12495;3131;12415;326;1578;2566;10091;2892;11669
130160;201304;3774;15770;3721;15684;209;753;3420;14619;3629;15372
130165;201304;2722;11245;2683;11178;551;2332;1999;8430;2550;10762
130170;201304;7361;29389;6614;28458;1338;5551;4526;20594;5864;26145
130180;201304;3205;10270;3143;10177;151;441;2877;9406;3028;9847
130185;201304;7538;28872;7349;28592;1697;6333;4928;20116;6625;26449
130190;201304;16011;57682;14376;55565;3091;11527;9296;38196;12387;49723
130195;201304;1706;7119;1651;7035;104;467;1465;6289;1569;6756
130200;201304;1863;6907;1753;6717;300;1199;1206;4683;1506;5882
130210;201304;1066;4245;1012;4145;179;706;737;3154;916;3860
130220;201304;1954;8142;1844;7984;260;1203;1376;6100;1636;7303
130230;201304;3260;14971;3128;14747;208;942;2736;13216;2944;14158
130240;201304;7833;31213;7290;30400;574;2648;6102;25880;6676;28528
130250;201304;16485;62842;16309;62569;2328;8250;12956;51548;15284;59798
130255;201304;3657;13824;3477;13511;219;854;3040;12031;3259;12885
130260;201304;220488;729701;203178;704133;56250;195880;114857;415285;171107;611165
130270;201304;7247;30610;6579;29552;1099;4825;4701;22129;5800;26954
130280;201304;2836;11333;2777;11246;173;607;2471;10268;2644;10875
130290;201304;10068;37578;10011;37498;235;733;9490;36138;9725;36871
130300;201304;4155;16612;3959;16334;356;1540;3259;13668;3615;15208
130310;201304;4305;17524;4002;17136;607;2541;2983;13252;3590;15793
130320;201304;2493;8846;2291;8567;322;1244;1674;6407;1996;7651
130330;201304;3202;12299;2882;11846;279;1247;2370;9875;2649;11122
130340;201304;16618;65723;16240;65125;2612;9906;11852;50089;14464;59995
130350;201304;3150;12779;3022;12636;141;340;2827;12186;2968;12526
130353;201304;4602;15904;4212;15367;1214;4357;2331;9052;3545;13409
130356;201304;3313;12653;3225;12497;587;2286;2332;9342;2919;11628
130360;201304;2615;8204;2349;7888;70;221;2163;7421;2233;7642
130370;201304;4479;17882;3838;17039;319;1719;3108;13837;3427;15556
130380;201304;6069;26412;5884;26073;498;2399;4862;21783;5360;24182
130390;201304;4373;19415;4135;19026;468;2032;3382;16066;3850;18098
130395;201304;1876;7343;1753;7108;299;1361;1121;4510;1420;5871
130400;201304;2080;7624;2014;7522;103;401;1794;6794;1897;7195
130406;201304;8105;32667;7326;31328;1880;7785;4170;19160;6050;26945
130410;201304;3967;15295;3680;14763;909;3788;2049;8534;2958;12322
130420;201304;9103;40046;8847;39450;1690;7386;6090;28135;7780;35521
130423;201304;2697;11133;2609;11016;176;850;2297;9746;2473;10596
130426;201304;1815;8132;1752;8024;299;1297;1251;6064;1550;7361
130430;201304;3205;12028;3044;11799;377;1528;2267;9054;2644;10582
130440;201304;3454;13013;3183;12716;236;778;2779;11537;3015;12315
140002;201304;1265;4652;1228;4585;277;938;806;3245;1083;4183
140005;201304;2288;7505;2158;7361;134;438;1920;6651;2054;7089
140010;201304;40780;136589;37525;131058;8317;30904;22969;81784;31286;112688
140015;201304;2505;8862;2427;8760;182;540;2123;7889;2305;8429
140017;201304;2757;9254;2682;9156;187;637;2356;8152;2543;8789
140020;201304;3921;13754;3697;13444;489;1783;2798;10459;3287;12242
140023;201304;1814;6798;1755;6714;187;708;1451;5674;1638;6382
140028;201304;2029;5895;1965;5820;107;269;1771;5367;1878;5636
140030;201304;3290;11109;3189;10977;311;710;2758;10011;3069;10721
140040;201304;1432;7064;1380;6898;132;734;1014;5185;1146;5919
140045;201304;2113;8236;2073;8180;197;623;1768;7290;1965;7913
140047;201304;4775;14899;4693;14796;718;1780;3699;12440;4417;14220
140050;201304;1426;4584;1361;4490;143;439;1123;3791;1266;4230
140060;201304;1214;4049;1145;3964;199;663;853;3044;1052;3707
140070;201304;1431;7066;1428;7060;58;235;1356;6781;1414;7016
150010;201304;29376;103355;28289;101864;2179;8025;24174;88578;26353;96603
150013;201304;1457;4754;1417;4707;131;455;1185;3965;1316;4420
150020;201304;9683;35615;9548;35394;960;3624;7995;30030;8955;33654
150030;201304;5728;25827;5589;25584;623;2433;4596;22015;5219;24448
150034;201304;4398;12152;4186;11900;146;341;3982;11455;4128;11796
150040;201304;11471;41817;10187;40170;2038;7351;6974;29411;9012;36762
150050;201304;5758;22431;5648;22231;711;3003;4463;17720;5174;20723
150060;201304;13182;45261;12624;44430;3456;11890;7430;27475;10886;39365
150070;201304;4919;21501;4544;21041;586;2577;3626;17312;4212;19889
150080;201304;55908;156531;49981;149060;5773;15552;38846;119442;44619;134994
150085;201304;4460;16674;4317;16467;757;2450;3263;13190;4020;15640
150090;201304;9112;36711;8669;36091;1111;4433;6885;29416;7996;33849
150095;201304;4708;17047;4448;16639;524;1941;3574;13679;4098;15620
150100;201304;3258;12681;3088;12438;313;1448;2515;10068;2828;11516
150110;201304;3122;15195;3114;15176;128;531;2933;14456;3061;14987
150120;201304;5496;22512;5407;22334;631;2518;4438;18634;5069;21152
150125;201304;761;2436;699;2334;154;540;422;1414;576;1954
150130;201304;16671;57477;16228;56777;1909;6711;13050;46316;14959;53027
150140;201304;130135;405596;126054;400428;19783;63189;96917;312140;116700;375329
150145;201304;4557;15062;4247;14660;613;2181;3163;11149;3776;13330
150150;201304;8096;28247;7712;27607;1725;6446;4988;18088;6713;24534
150157;201304;2426;8434;2279;8224;346;1343;1767;6392;2113;7735
150160;201304;2447;8860;2373;8754;619;2207;1491;5726;2110;7933
150170;201304;21125;79403;20187;78288;2933;11084;15996;63063;18929;74147
150172;201304;2790;9952;2544;9596;298;1143;2095;8027;2393;9170
150175;201304;1897;6236;1836;6161;166;512;1589;5458;1755;5970
150178;201304;10235;33086;8999;31635;569;1735;8107;29158;8676;30893
150180;201304;15667;66355;15277;65823;1480;6807;12914;56156;14394;62963
150190;201304;6755;22234;6401;21726;430;1115;5591;19714;6021;20829
150195;201304;4006;15202;3774;14770;463;1808;2955;11750;3418;13558
150200;201304;4094;14588;4061;14543;113;377;3858;13914;3971;14291
150210;201304;21308;82262;21088;81952;1652;6149;18682;73465;20334;79614
150215;201304;4912;16584;4570;16074;1194;4280;2705;9740;3899;14020
150220;201304;11479;39259;11001;38451;2502;8940;6831;24324;9333;33264
150230;201304;10232;37097;9587;36166;796;3660;8145;30376;8941;34036
150240;201304;29762;95731;27960;92590;7712;26760;15148;50888;22860;77648
150250;201304;3207;12975;3128;12844;578;2128;2273;9904;2851;12032
150260;201304;1776;7772;1755;7730;263;1278;1276;5620;1539;6898
150270;201304;8946;28254;7139;25999;1583;6099;4553;16858;6136;22957
150275;201304;5219;20282;5051;19991;800;3172;3750;15165;4550;18337
150276;201304;1928;6063;1853;5966;257;878;1489;4812;1746;5690
150277;201304;4805;15380;4272;14763;516;1845;3452;12139;3968;13984
150280;201304;5559;24552;5468;24347;548;2389;4518;20496;5066;22885
150285;201304;2522;10312;2501;10269;173;718;2257;9328;2430;10046
150290;201304;7308;25099;7182;24918;900;3029;5742;20423;6642;23452
150293;201304;8262;27449;7488;26268;2563;9123;3615;13346;6178;22469
150295;201304;5679;20377;5169;19684;1268;4930;3212;12572;4480;17502
150300;201304;1666;6017;1636;5972;104;365;1430;5265;1534;5630
150304;201304;3745;12336;3340;11813;529;1886;2493;8981;3022;10867
150307;201304;6314;22427;5936;21867;472;1667;4953;18788;5425;20455
150309;201304;5934;22498;5657;22072;1554;5974;3539;14395;5093;20369
150310;201304;4810;22748;4744;22635;539;2396;3916;19259;4455;21655
150320;201304;7310;22501;7188;22351;484;1556;6407;20004;6891;21560
150330;201304;12048;46494;11634;45787;1385;5451;9330;37458;10715;42909
150340;201304;1928;7137;1849;7022;531;2060;1045;4098;1576;6158
150345;201304;5913;21966;5632;21575;662;2578;4610;17914;5272;20492
150350;201304;6750;23560;6504;23176;893;3254;4890;17665;5783;20919
150360;201304;19069;63020;16921;60379;2514;9076;12747;46904;15261;55980
150370;201304;9156;35995;8900;35624;1157;4322;7192;29769;8349;34091
150375;201304;2548;11045;2506;10989;235;776;2144;9900;2379;10676
150380;201304;9004;28868;8227;27799;936;3431;6835;23061;7771;26492
150390;201304;7453;33093;7207;32547;1697;7286;4481;21375;6178;28661
150400;201304;5021;21703;4889;21379;637;2668;3647;16464;4284;19132
150405;201304;7832;25215;7160;24360;1620;4987;4722;17194;6342;22181
150410;201304;1559;6224;1539;6189;223;943;1104;4527;1327;5470
150420;201304;29018;108887;26725;105179;7250;29561;14968;61382;22218;90943
150430;201304;5990;23309;5887;23112;833;3636;4504;17635;5337;21271
150440;201304;4956;18091;4882;17968;682;2539;3767;14089;4449;16628
150442;201304;20425;59766;18830;57781;3066;9556;13500;42615;16566;52171
150445;201304;4731;17357;4405;16891;649;2348;3404;13457;4053;15805
150450;201304;4006;19530;3884;19357;367;1801;3305;16790;3672;18591
150460;201304;6193;24108;5337;23210;352;1645;4817;21079;5169;22724
150470;201304;14119;48375;13822;47961;1676;4949;11473;41252;13149;46201
150480;201304;13322;47024;13013;46605;844;2751;11550;42194;12394;44945
150490;201304;5827;23018;5734;22897;361;1428;5165;20810;5526;22238
150495;201304;3999;15734;3916;15556;478;2025;3144;12534;3622;14559
150497;201304;3190;11355;2951;10967;777;2874;1782;6924;2559;9798
150500;201304;2777;8799;2680;8627;408;1382;2006;6448;2414;7830
150503;201304;3647;11785;3142;11129;1216;4468;1357;5033;2573;9501
150506;201304;11237;41905;10783;41288;2536;8447;7490;30677;10026;39124
150510;201304;8975;36790;8507;35976;1437;6133;6038;26506;7475;32639
150520;201304;5447;23642;5388;23542;435;1550;4772;21420;5207;22970
150530;201304;10446;39232;9647;38083;1314;4742;7320;30031;8634;34773
150540;201304;4272;14236;4000;13823;347;1274;3350;11557;3697;12831
150543;201304;4251;14206;3951;13778;1164;4126;2340;8387;3504;12513
150548;201304;7266;24424;6888;23930;813;2618;5623;20125;6436;22743
150549;201304;2137;7023;2048;6914;99;279;1870;6440;1969;6719
150550;201304;19767;65295;18259;62903;5126;18275;9992;35176;15118;53451
150553;201304;19813;75461;18252;71264;7482;30949;3818;14890;11300;45839
150555;201304;1576;5187;1402;4927;255;983;947;3350;1202;4333
150560;201304;1919;6356;1872;6244;215;800;1459;4826;1674;5626
150563;201304;2719;9451;2589;9215;611;2318;1637;5835;2248;8153
150565;201304;3170;11852;3025;11633;256;1118;2487;9599;2743;10717
150570;201304;4722;19059;4669;18967;426;1735;3953;16370;4379;18105
150580;201304;8318;34996;8195;34808;785;2915;7008;30842;7793;33757
150590;201304;4885;20394;4782;20268;190;887;4426;18853;4616;19740
150600;201304;6958;28446;6856;28268;696;2565;5789;24638;6485;27203
150610;201304;2396;8413;2248;8108;285;1144;1586;5671;1871;6815
150611;201304;2454;9589;2380;9409;313;1303;1774;7095;2087;8398
150613;201304;10501;34271;9442;32723;3220;11348;4743;17220;7963;28568
150616;201304;2908;8506;2377;7939;573;1854;1591;5530;2164;7384
150618;201304;7157;25714;6920;25300;2274;8664;3472;12957;5746;21621
150619;201304;4786;17319;4535;16942;801;3059;3159;12041;3960;15100
150620;201304;5838;21791;5388;21204;776;3100;4106;16725;4882;19825
150630;201304;4893;16388;4689;16112;439;1543;3906;13581;4345;15124
150635;201304;4102;14180;3919;13817;833;3017;2503;9079;3336;12096
150640;201304;1348;4538;1335;4517;34;100;1269;4333;1303;4433
150650;201304;11226;36265;10394;34749;2824;9844;5639;19129;8463;28973
150655;201304;4926;17498;4595;17041;864;3218;3297;12513;4161;15731
150658;201304;3811;13156;3688;12967;334;1390;2988;10424;3322;11814
150660;201304;5417;17780;4995;17242;1399;4741;2912;10477;4311;15218
150670;201304;5605;17489;4945;16685;1716;5867;2608;9326;4324;15193
150680;201304;45746;189050;44001;185694;15535;64730;21047;94927;36582;159657
150690;201304;1774;5994;1674;5808;276;971;1094;3908;1370;4879
150700;201304;5232;17238;5092;17034;1036;3454;3498;11977;4534;15431
150710;201304;3476;11703;3386;11579;355;918;2903;10305;3258;11223
150715;201304;4460;15705;4214;15394;524;1864;3423;12820;3947;14684
150720;201304;5719;24984;5515;24623;788;3325;4189;19478;4977;22803
150730;201304;8374;30210;7928;29601;1189;4308;6296;24070;7485;28378
150740;201304;3319;11275;3169;10985;491;1804;2232;7842;2723;9646
150745;201304;5800;18737;5443;18261;750;2552;4228;14412;4978;16964
150746;201304;1296;4601;1247;4508;191;802;891;3209;1082;4011
150747;201304;4822;16298;4534;15927;436;1483;3715;13440;4151;14923
150750;201304;2354;8806;2336;8785;126;296;2185;8437;2311;8733
150760;201304;10650;35522;10336;35079;2353;7850;6860;24013;9213;31863
150770;201304;5001;20199;4868;19994;819;3044;3706;15872;4525;18916
150775;201304;994;3308;918;3169;207;863;541;1778;748;2641
150780;201304;2932;10074;2911;10051;92;239;2751;9642;2843;9881
150790;201304;4631;15180;4403;14918;342;999;3818;13342;4160;14341
150795;201304;13246;43247;12450;42244;1883;6212;9582;33446;11465;39658
150796;201304;2537;8226;2498;8178;399;1207;1937;6564;2336;7771
150797;201304;3561;12261;3427;12047;205;755;2997;10655;3202;11410
150800;201304;12933;45322;11996;44146;2799;9714;7952;30830;10751;40544
150803;201304;6217;23857;6037;23597;851;3556;4629;18336;5480;21892
150805;201304;2572;9281;2412;9056;386;1371;1746;6802;2132;8173
150808;201304;5552;19585;4846;18270;2124;8353;1362;5447;3486;13800
150810;201304;17901;58550;15408;55520;2612;9165;10997;41571;13609;50736
150812;201304;4597;15202;4350;14921;402;1650;3496;11901;3898;13551
150815;201304;7815;26037;7122;25199;623;1938;6133;22378;6756;24316
150820;201304;9865;30053;9046;29162;407;845;8325;27554;8732;28399
150830;201304;11808;46828;11358;46044;979;3818;9215;38774;10194;42592
150835;201304;1919;7270;1794;6970;511;2093;864;3372;1375;5465
150840;201304;6137;18928;5048;17558;1453;5546;2775;9396;4228;14942
160005;201304;684;2678;650;2603;113;524;399;1583;512;2107
160010;201304;1477;5339;1466;5327;196;552;1204;4604;1400;5156
160015;201304;1494;5751;1462;5693;265;966;1049;4320;1314;5286
160020;201304;2191;7393;2051;7202;289;1016;1534;5543;1823;6559
160021;201304;754;3480;732;3436;125;643;511;2455;636;3098
160023;201304;906;3497;897;3484;111;393;750;2988;861;3381
160025;201304;1160;3192;1129;3159;26;83;1085;3030;1111;3113
160027;201304;7415;25428;7083;25040;1451;5314;4930;17755;6381;23069
160030;201304;35643;137746;35076;136615;8073;30315;24224;97442;32297;127757
160040;201304;3058;13223;3002;13125;206;954;2652;11675;2858;12629
160050;201304;2889;11469;2635;11060;996;3798;1204;5836;2200;9634
160053;201304;1813;7894;1799;7862;519;2206;1148;5253;1667;7459
160055;201304;754;3032;738;3009;142;616;521;2154;663;2770
160060;201304;17190;57552;16224;56471;3876;12695;10879;39946;14755;52641
160070;201304;1911;8563;1897;8539;177;737;1661;7632;1838;8369
160080;201304;2400;9768;2382;9738;158;553;2172;9046;2330;9599
170025;201304;554;1934;512;1869;188;715;238;898;426;1613
170030;201304;1120;3825;1052;3713;307;1113;569;2036;876;3149
170035;201304;1504;4683;1247;4189;446;1599;396;1368;842;2967
170040;201304;1667;5802;1514;5561;357;1450;879;3245;1236;4695
170070;201304;1967;5546;1636;5132;417;1419;911;2913;1328;4332
170100;201304;2446;6772;2196;6334;262;865;1750;4985;2012;5850
170105;201304;693;2350;602;2165;131;578;340;1180;471;1758
170110;201304;1118;3554;1003;3357;169;532;688;2374;857;2906
170130;201304;1324;4310;1195;4136;175;599;873;3137;1048;3736
170190;201304;1531;4666;1324;4378;474;1572;510;1856;984;3428
170200;201304;1425;4589;1140;4072;306;1223;373;1305;679;2528
170210;201304;24229;80991;21812;76589;9400;35347;6265;22493;15665;57840
170215;201304;1077;3625;991;3480;153;557;719;2580;872;3137
170220;201304;6085;20861;5641;20188;785;2972;4084;15028;4869;18000
170230;201304;1410;4936;1272;4692;356;1477;602;2160;958;3637
170240;201304;2927;8295;2407;7672;313;1116;1722;5536;2035;6652
170255;201304;3383;11223;2914;10425;1065;3754;1169;4524;2234;8278
170270;201304;1022;2706;754;2343;200;643;435;1380;635;2023
170290;201304;2771;8827;2448;8430;251;812;2013;7164;2264;7976
170300;201304;1983;6501;1777;6169;316;1204;1188;4148;1504;5352
170305;201304;661;2207;574;2035;123;480;350;1221;473;1701
170307;201304;1055;3761;928;3537;299;1159;361;1550;660;2709
170310;201304;1549;4377;1265;3919;287;937;657;2126;944;3063
170320;201304;901;2780;768;2545;170;583;455;1529;625;2112
170330;201304;752;2330;635;2207;111;343;456;1691;567;2034
170360;201304;448;1614;427;1580;99;385;213;788;312;1173
170370;201304;1347;4096;1145;3807;195;770;689;2271;884;3041
170380;201304;2027;6602;1711;6137;416;1692;922;3281;1338;4973
170382;201304;558;1957;511;1892;55;200;420;1577;475;1777
170384;201304;1273;5805;1239;5741;290;1370;837;3982;1127;5352
170386;201304;800;2502;665;2292;209;788;235;851;444;1639
170388;201304;628;1945;553;1826;134;523;227;732;361;1255
170389;201304;942;3340;886;3253;106;487;683;2454;789;2941
170390;201304;1260;3925;1108;3730;190;655;797;2756;987;3411
170410;201304;447;1540;433;1513;65;257;297;1034;362;1291
170460;201304;400;1238;352;1161;101;358;129;434;230;792
170510;201304;757;2630;660;2482;134;570;378;1404;512;1974
170550;201304;5085;16545;4344;15191;1807;6732;1230;4442;3037;11174
170555;201304;1284;3894;1091;3609;287;1062;603;1986;890;3048
170560;201304;1013;3523;873;3363;176;678;623;2490;799;3168
170600;201304;1292;3759;1160;3602;68;237;975;3078;1043;3315
170610;201304;1583;4865;1263;4362;206;794;737;2571;943;3365
170625;201304;387;1289;314;1127;93;356;83;303;176;659
170650;201304;1214;4071;1153;3959;276;1006;634;2225;910;3231
170700;201304;3756;12950;3220;12062;874;3596;1544;6013;2418;9609
170710;201304;1636;5010;1406;4678;186;735;1006;3360;1192;4095
170720;201304;1773;4840;1578;4532;307;888;1095;3196;1402;4084
170730;201304;1136;3331;946;3048;296;1059;428;1376;724;2435
170740;201304;2120;7999;1984;7791;282;1229;1450;5744;1732;6973
170755;201304;875;2821;750;2553;208;758;300;1006;508;1764
170765;201304;1534;4227;1251;3773;337;1087;525;1633;862;2720
170770;201304;1752;6292;1649;6091;395;1530;939;3578;1334;5108
170820;201304;4013;13198;3661;12638;1005;3686;1739;6102;2744;9788
170825;201304;697;2241;558;1988;159;637;261;904;420;1541
170830;201304;1236;3850;1192;3785;47;116;1096;3517;1143;3633
170900;201304;2741;9972;2642;9773;335;1202;2025;7720;2360;8922
170930;201304;4123;12788;3392;11764;1369;4975;1160;4065;2529;9040
170950;201304;9803;31253;8079;28427;3906;14923;1810;5944;5716;20867
170980;201304;420;1373;365;1271;114;402;147;509;261;911
171050;201304;1188;4367;1145;4290;66;298;1022;3788;1088;4086
171070;201304;1622;5431;1520;5288;354;1293;920;3265;1274;4558
171090;201304;816;2599;742;2480;162;539;462;1595;624;2134
171110;201304;624;1902;520;1737;165;602;287;922;452;1524
171150;201304;857;2587;646;2182;134;484;366;1245;500;1729
171180;201304;569;1873;472;1662;120;457;218;795;338;1252
171190;201304;1812;6617;1566;6115;392;1607;751;3070;1143;4677
171195;201304;827;3058;762;2943;99;431;499;1982;598;2413
171200;201304;628;2108;534;1930;155;643;245;834;400;1477
171215;201304;423;1323;351;1203;67;252;182;627;249;879
171240;201304;866;2967;842;2928;74;167;730;2657;804;2824
171245;201304;661;2214;558;1966;113;428;290;1021;403;1449
171250;201304;1087;3207;992;3097;78;260;835;2631;913;2891
171270;201304;387;1614;365;1565;81;320;221;1005;302;1325
171280;201304;824;2668;763;2564;164;539;412;1512;576;2051
171320;201304;3713;11864;3267;11237;1152;4130;1549;5366;2701;9496
171330;201304;2669;8446;2434;8093;617;2151;1387;4691;2004;6842
171360;201304;1470;4947;1264;4648;330;1296;693;2592;1023;3888
171370;201304;683;1974;617;1867;139;509;342;981;481;1490
171380;201304;1215;4374;1128;4215;265;971;670;2615;935;3586
171395;201304;865;2799;747;2579;145;597;428;1454;573;2051
171420;201304;2215;6831;1846;6202;367;1381;1048;3516;1415;4897
171430;201304;986;3232;913;3125;217;743;557;1937;774;2680
171488;201304;2294;7283;2141;7051;558;1844;1178;4024;1736;5868
171500;201304;850;2676;754;2483;126;387;431;1473;557;1860
171510;201304;878;3254;806;3143;158;623;511;2096;669;2719
171515;201304;590;1782;479;1623;120;419;230;797;350;1216
171525;201304;571;2007;496;1861;98;406;269;1002;367;1408
171550;201304;313;1129;283;1043;129;526;47;181;176;707
171570;201304;1053;3549;952;3403;166;603;660;2403;826;3006
171575;201304;1859;5502;1528;4918;483;1617;630;2119;1113;3736
171610;201304;5806;20524;5442;19832;1998;7605;1902;6995;3900;14600
171620;201304;2068;6984;1966;6814;201;784;1577;5489;1778;6273
171630;201304;842;2900;706;2660;166;708;320;1194;486;1902
171650;201304;2179;7162;1875;6654;512;1993;887;3073;1399;5066
171660;201304;2489;7176;2093;6496;517;1665;1079;3456;1596;5121
171665;201304;1289;4177;1172;3971;224;844;749;2554;973;3398
171670;201304;2236;6174;1889;5742;453;1487;1184;3571;1637;5058
171700;201304;1052;3641;965;3500;156;632;638;2322;794;2954
171720;201304;621;2029;552;1892;156;610;290;974;446;1584
171750;201304;1178;3993;1064;3762;391;1444;388;1392;779;2836
171780;201304;1088;3260;823;2883;143;546;513;1800;656;2346
171790;201304;1715;5611;1404;5155;299;1120;828;3180;1127;4300
171800;201304;690;2295;640;2225;92;355;444;1550;536;1905
171820;201304;8995;29117;8428;28439;1896;6893;5318;18163;7214;25056
171830;201304;1596;5951;1474;5681;346;1417;742;2888;1088;4305
171840;201304;723;2248;661;2161;79;289;491;1601;570;1890
171845;201304;761;2100;597;1817;87;321;345;1006;432;1327
171850;201304;995;3708;917;3542;111;521;616;2366;727;2887
171855;201304;1203;3995;1103;3828;119;515;838;2854;957;3369
171865;201304;475;1585;407;1483;104;427;201;717;305;1144
171870;201304;630;2121;539;1966;130;515;280;1045;410;1560
171875;201304;1341;4391;1149;4100;183;722;819;2913;1002;3635
171880;201304;991;3633;970;3600;123;477;757;2872;880;3349
171884;201304;812;2455;632;2182;133;509;276;995;409;1504
171886;201304;1423;4969;1313;4735;447;1726;491;1786;938;3512
171888;201304;588;1904;518;1780;105;371;318;1140;423;1511
171889;201304;463;1605;454;1584;83;260;297;1102;380;1362
171890;201304;1058;3694;981;3579;143;641;671;2392;814;3033
171900;201304;413;1636;397;1605;97;412;224;906;321;1318
172000;201304;603;2000;518;1877;92;402;309;1090;401;1492
172010;201304;1097;3836;1046;3748;108;428;820;2980;928;3408
172015;201304;348;1315;306;1251;61;247;178;780;239;1027
172020;201304;2246;7538;2030;7217;294;1165;1466;5254;1760;6419
172025;201304;663;2055;573;1897;96;353;355;1176;451;1529
172030;201304;1051;3675;972;3530;176;718;620;2275;796;2993
172049;201304;1019;3137;976;3081;139;453;731;2342;870;2795
172065;201304;1066;3371;914;3175;162;627;658;2284;820;2911
172080;201304;2651;8236;2290;7637;323;1257;1550;5078;1873;6335
172085;201304;491;1411;399;1258;119;451;113;327;232;778
172090;201304;3278;10088;2602;9231;537;2063;1589;5769;2126;7832
172093;201304;561;1878;456;1694;178;729;187;697;365;1426
172097;201304;653;1981;565;1832;188;665;189;604;377;1269
172100;201304;23048;82377;21268;78760;7705;30856;6782;25270;14487;56126
172110;201304;1585;5909;1489;5769;166;654;1151;4578;1317;5232
172120;201304;5382;16521;4575;15505;469;1661;3606;12488;4075;14149
172125;201304;311;971;253;884;56;211;123;455;179;666
172130;201304;467;1442;431;1390;85;301;278;922;363;1223
172208;201304;2123;6760;2018;6581;449;1550;1152;3851;1601;5401
172210;201304;2244;6843;2156;6738;144;488;1907;5968;2051;6456
210005;201304;20018;68169;18540;65768;4902;18515;10636;38088;15538;56603
210010;201304;1554;5577;1411;5398;154;547;1131;4475;1285;5022
210015;201304;3269;10217;3041;9904;193;446;2642;8994;2835;9440
210020;201304;6697;17956;6309;17482;458;1460;5173;14546;5631;16006
210030;201304;5662;19406;5466;19130;474;2045;4569;15806;5043;17851
210040;201304;1924;5719;1765;5530;177;568;1410;4476;1587;5044
210043;201304;5480;17643;5275;17315;329;1178;4604;15189;4933;16367
210047;201304;6574;26141;6223;25506;952;4199;4228;17492;5180;21691
210050;201304;2366;8241;1975;7825;163;651;1665;6696;1828;7347
210055;201304;1574;5642;1507;5548;194;675;1190;4465;1384;5140
210060;201304;7774;28948;7093;27920;820;3584;5320;21314;6140;24898
210070;201304;6346;20874;6161;20657;294;1091;5641;19005;5935;20096
210080;201304;3486;12203;3419;12101;103;416;3192;11331;3295;11747
210083;201304;3227;12089;3177;12027;238;853;2808;10800;3046;11653
210087;201304;2246;7582;2181;7498;168;616;1932;6633;2100;7249
210090;201304;9132;30952;8893;30559;610;2187;7689;26625;8299;28812
210095;201304;5995;24059;5904;23889;653;2720;4857;19930;5510;22650
210100;201304;7280;22146;7004;21833;221;893;6460;20100;6681;20993
210110;201304;3058;10896;2970;10768;212;827;2502;9237;2714;10064
210120;201304;21785;71317;19686;68493;2113;7806;15319;54152;17432;61958
210125;201304;3110;10690;3006;10561;247;846;2612;9312;2859;10158
210130;201304;3396;10718;3346;10664;217;715;2941;9421;3158;10136
210135;201304;1447;4639;1344;4482;102;360;1143;3861;1245;4221
210140;201304;15781;53325;13804;50773;2947;11077;9126;34602;12073;45679
210150;201304;4180;11686;3998;11478;181;491;3662;10582;3843;11073
210160;201304;17391;58982;16409;57536;1952;6737;13109;47039;15061;53776
210170;201304;13535;51238;13338;50954;1047;3634;11642;45420;12689;49054
210173;201304;1699;7520;1662;7440;171;763;1393;6326;1564;7089
210177;201304;2744;9538;2616;9368;344;1370;2037;7256;2381;8626
210180;201304;1372;4472;1310;4368;131;448;1066;3580;1197;4028
210190;201304;4965;16608;4748;16248;403;1813;3750;12560;4153;14373
210193;201304;1380;4532;1307;4411;92;358;1096;3726;1188;4084
210197;201304;1655;6206;1595;6137;112;490;1411;5416;1523;5906
210200;201304;8547;30208;8032;29480;1163;4085;5945;22722;7108;26807
210203;201304;5904;20586;5569;20156;452;1457;4800;17798;5252;19255
210207;201304;2873;9987;2745;9768;368;1338;2085;7516;2453;8854
210210;201304;8261;29034;8055;28687;359;1390;7041;25397;7400;26787
210215;201304;1744;7065;1710;7017;152;685;1446;5963;1598;6648
210220;201304;6011;23933;5848;23662;472;1954;4852;20078;5324;22032
210230;201304;5141;18186;4820;17647;506;1888;3793;14113;4299;16001
210232;201304;10743;41195;10325;40521;2228;8640;7206;29120;9434;37760
210235;201304;3132;10387;2918;10104;207;747;2550;8889;2757;9636
210237;201304;2447;8954;2425;8921;47;115;2336;8706;2383;8821
210240;201304;2609;8906;2537;8793;209;767;2104;7334;2313;8101
210250;201304;4458;15377;4323;15208;162;618;3990;14141;4152;14759
210255;201304;2492;8429;2300;8106;613;2313;1313;4705;1926;7018
210260;201304;4965;16335;4639;15846;620;2043;3589;12531;4209;14574
210270;201304;5053;15018;4633;14461;189;656;4168;13142;4357;13798
210275;201304;3169;8616;2974;8403;103;272;2813;7999;2916;8271
210280;201304;5691;17131;5066;16348;375;1329;4335;14111;4710;15440
210290;201304;5757;18624;5361;18121;543;1793;4384;15137;4927;16930
210300;201304;33573;109217;29860;104286;3258;12143;24293;85921;27551;98064
210310;201304;2518;7820;2468;7751;163;527;2206;6963;2369;7490
210312;201304;1766;6296;1746;6260;141;557;1493;5374;1634;5931
210315;201304;2037;7711;1979;7630;80;360;1781;6917;1861;7277
210317;201304;4076;12548;3993;12451;164;490;3739;11731;3903;12221
210320;201304;17158;58745;16669;58065;1008;3765;14909;52194;15917;55959
210325;201304;3224;10871;3000;10561;366;1376;2377;8446;2743;9822
210330;201304;29701;85968;25829;81679;3674;10640;19358;65202;23032;75842
210340;201304;11344;37004;10576;36060;1270;3896;8313;29642;9583;33538
210350;201304;9717;32406;9270;31781;850;2962;7617;26653;8467;29615
210355;201304;3857;14015;3560;13649;127;335;3311;13010;3438;13345
210360;201304;16179;51266;15344;50021;1443;4959;12326;40853;13769;45812
210370;201304;7456;21962;6905;21370;277;867;6361;19871;6638;20738
210375;201304;3135;9900;2785;9489;503;1842;2026;6978;2529;8820
210380;201304;5794;17898;5335;17145;400;1347;4480;14492;4880;15839
210390;201304;2506;9581;2420;9445;94;405;2237;8804;2331;9209
210400;201304;4450;15458;4312;15280;379;1257;3704;13378;4083;14635
210405;201304;8182;23667;6887;21914;2027;6498;3352;11588;5379;18086
210407;201304;2015;7146;1834;6867;208;739;1410;5537;1618;6276
210408;201304;1963;8225;1898;8145;82;326;1747;7641;1829;7967
210409;201304;3714;13785;3562;13547;317;1235;2821;11035;3138;12270
210410;201304;3257;11100;3064;10854;255;849;2669;9588;2924;10437
210420;201304;3966;13679;3774;13343;379;1319;3047;10983;3426;12302
210430;201304;1813;5959;1790;5925;130;443;1579;5270;1709;5713
210440;201304;3907;12913;3813;12763;228;811;3327;11262;3555;12073
210450;201304;2601;8798;2458;8559;224;876;1995;6952;2219;7828
210455;201304;3981;12238;3421;11346;611;2080;2302;7845;2913;9925
210460;201304;4037;13276;3862;13060;203;734;3414;11683;3617;12417
210462;201304;1722;6356;1682;6282;180;698;1301;4975;1481;5673
210465;201304;2701;9051;2571;8883;323;945;2076;7474;2399;8419
210467;201304;5647;20115;5316;19631;606;2238;4222;16001;4828;18239
210470;201304;1597;5176;1478;5014;111;419;1204;4129;1315;4548
210480;201304;12525;44901;11483;43466;2838;10997;7170;28040;10008;39037
210490;201304;3130;10022;2953;9750;390;1363;2265;7516;2655;8879
210500;201304;6525;26019;6269;25568;723;2886;4879;20597;5602;23483
210510;201304;6300;22063;6214;21966;158;532;5800;20898;5958;21430
210515;201304;3446;11423;3398;11344;287;882;2938;10011;3225;10893
210520;201304;2527;8351;2409;8185;257;911;1935;6683;2192;7594
210530;201304;37896;131110;33959;124937;11278;44060;17150;64294;28428;108354
210535;201304;2950;10913;2897;10816;145;590;2568;9657;2713;10247
210540;201304;11290;41981;10362;40427;2179;8407;6399;26531;8578;34938
210542;201304;6188;18884;5545;18164;280;836;4975;16659;5255;17495
210545;201304;2117;7422;2036;7294;90;396;1775;6378;1865;6774
210547;201304;3254;12383;3119;12180;207;899;2677;10548;2884;11447
210550;201304;6036;17995;5244;17106;279;821;4724;15742;5003;16563
210560;201304;3432;11998;3259;11731;280;1115;2712;9774;2992;10889
210565;201304;1480;5209;1334;4992;89;399;1067;4023;1156;4422
210570;201304;11619;36115;10699;35023;1000;3145;9010;30201;10010;33346
210580;201304;2597;8853;2339;8511;282;1055;1844;6823;2126;7878
210590;201304;4324;13864;4133;13628;263;889;3643;12173;3906;13062
210592;201304;2379;7749;2332;7675;113;439;2079;6810;2192;7249
210594;201304;2565;7751;2236;7358;141;486;1943;6471;2084;6957
210596;201304;2789;10795;2669;10572;341;1374;2004;8067;2345;9441
210598;201304;1978;6216;1895;6121;114;483;1735;5508;1849;5991
210600;201304;3185;9590;3007;9350;274;925;2468;7640;2742;8565
210610;201304;2547;8338;2314;8055;258;903;1903;6689;2161;7592
210620;201304;1707;5450;1603;5316;50;161;1490;4976;1540;5137
210630;201304;3226;12268;2845;11497;550;2231;1661;7009;2211;9240
210632;201304;4609;16370;4274;15898;503;1932;3362;12641;3865;14573
210635;201304;1825;6855;1795;6812;60;197;1678;6465;1738;6662
210637;201304;2612;9162;2522;9035;130;506;2259;8170;2389;8676
210640;201304;4091;13837;4043;13772;31;97;3935;13483;3966;13580
210650;201304;6095;19874;6015;19760;347;1143;5472;18108;5819;19251
210660;201304;7084;23270;6738;22722;281;884;6152;20857;6433;21741
210663;201304;2609;8020;2536;7941;69;215;2406;7624;2475;7839
210667;201304;1566;6039;1523;5978;115;488;1290;5133;1405;5621
210670;201304;4555;17636;4443;17438;431;1760;3589;14394;4020;16154
210675;201304;4668;13589;4543;13433;312;948;3923;11800;4235;12748
210680;201304;4180;12862;3829;12436;208;744;3385;11001;3593;11745
210690;201304;6317;22879;6112;22665;348;1356;5531;20615;5879;21971
210700;201304;2422;7146;2166;6843;149;370;1837;6149;1986;6519
210710;201304;4737;15643;4621;15475;171;516;4298;14531;4469;15047
210720;201304;2290;8889;2222;8798;163;673;1931;7692;2094;8365
210725;201304;1132;4275;988;4023;144;640;611;2517;755;3157
210730;201304;1125;3691;1030;3588;71;232;908;3203;979;3435
210735;201304;3583;13683;3435;13389;646;2564;2409;9621;3055;12185
210740;201304;4393;12467;4132;12202;194;416;3792;11511;3986;11927
210745;201304;3244;10788;3163;10656;265;1015;2649;8859;2914;9874
210750;201304;19371;55667;17924;53979;1897;5823;14715;44828;16612;50651
210760;201304;5443;15268;5244;15051;87;269;5093;14628;5180;14897
210770;201304;5941;16514;5188;15672;219;617;4738;14458;4957;15075
210780;201304;8316;29212;7912;28468;1040;4096;5868;21290;6908;25386
210790;201304;4437;13903;3933;13350;185;643;3557;12253;3742;12896
210800;201304;4490;14240;4138;13862;215;795;3579;12375;3794;13170
210805;201304;3574;15747;3523;15641;201;881;3090;14010;3291;14891
210810;201304;5330;17050;4853;16506;515;1412;4091;14447;4606;15859
210820;201304;8601;25558;8251;25093;1314;3986;6083;18967;7397;22953
210825;201304;5234;18019;5151;17917;198;714;4724;16582;4922;17296
210830;201304;7730;25956;7481;25684;302;820;7037;24499;7339;25319
210840;201304;3584;10150;3321;9763;304;766;2641;7856;2945;8622
210845;201304;5232;17361;5097;17192;237;758;4596;15782;4833;16540
210850;201304;5450;21366;5192;20887;994;4428;3471;14002;4465;18430
210860;201304;15955;52762;15525;52110;1474;5204;12887;43424;14361;48628
210870;201304;5909;20300;5448;19663;754;2773;4004;14722;4758;17495
210880;201304;3653;12233;3619;12191;202;618;3290;11260;3492;11878
210890;201304;5178;16101;4891;15719;408;1481;4094;13063;4502;14544
210900;201304;4314;14709;4083;14296;1408;5022;1954;7119;3362;12141
210905;201304;1744;5613;1692;5546;96;254;1545;5171;1641;5425
210910;201304;10138;33096;9663;32360;1974;6982;6389;21681;8363;28663
210920;201304;3351;11489;3277;11388;163;484;2962;10508;3125;10992
210923;201304;1437;5625;1398;5555;208;870;1031;4174;1239;5044
210927;201304;4507;14601;4426;14520;41;102;4351;14338;4392;14440
210930;201304;2372;9234;2324;9158;200;905;1965;7760;2165;8665
210940;201304;2814;11464;2778;11396;319;1200;2257;9520;2576;10720
210945;201304;5638;16915;5467;16740;145;214;5268;16425;5413;16639
210950;201304;5188;17147;4658;16356;696;2479;3246;11763;3942;14242
210955;201304;1762;6162;1635;5932;279;1126;1112;4020;1391;5146
210960;201304;8685;29998;8449;29614;1761;6010;5962;21559;7723;27569
210970;201304;1264;4900;1158;4736;199;871;821;3394;1020;4265
210975;201304;1601;5923;1538;5795;150;636;1238;4672;1388;5308
210980;201304;8066;21849;7910;21667;283;798;7356;20179;7639;20977
210990;201304;14031;41033;11952;38788;962;2933;10347;34140;11309;37073
211000;201304;15042;51069;13920;49577;1343;5000;11446;41405;12789;46405
211003;201304;4987;17929;4651;17417;877;3415;3112;11920;3989;15335
211010;201304;6459;21787;6312;21589;161;543;5888;20316;6049;20859
211020;201304;7157;22378;7100;22309;256;523;6747;21541;7003;22064
211023;201304;2349;8271;2272;8136;183;691;1906;6916;2089;7607
211027;201304;2939;11696;2816;11492;291;1143;2270;9608;2561;10751
211030;201304;4045;12877;3711;12484;843;2374;2644;9462;3487;11836
211040;201304;3997;15536;3921;15408;122;519;3559;14179;3681;14698
211050;201304;9550;27036;9443;26912;530;1382;8705;25021;9235;26403
211060;201304;5357;20671;5270;20487;485;1709;4466;17811;4951;19520
211065;201304;1596;5740;1480;5579;92;363;1331;5046;1423;5409
211070;201304;8324;28802;8029;28304;822;2991;6412;22972;7234;25963
211080;201304;1300;4217;1091;3936;95;462;902;3183;997;3645
211085;201304;1943;6716;1703;6408;304;1086;1281;5012;1585;6098
211090;201304;3324;11130;3177;10917;237;931;2663;9133;2900;10064
211100;201304;6092;17562;5975;17413;161;562;5539;16156;5700;16718
211102;201304;2949;11352;2872;11240;320;1294;2367;9387;2687;10681
211105;201304;2652;8677;2461;8434;171;628;2153;7404;2324;8032
211107;201304;4194;13430;4009;13193;132;434;3723;12341;3855;12775
211110;201304;6118;19176;5078;17872;842;2899;3546;13117;4388;16016
211120;201304;28555;83419;25983;79883;3104;9341;20227;63687;23331;73028
211125;201304;1958;6910;1894;6796;134;515;1618;5857;1752;6372
211130;201304;138324;424102;132163;416297;24516;76722;95830;308636;120346;385358
211140;201304;5524;18411;5361;18150;319;1176;4670;15842;4989;17018
211150;201304;9242;30783;9065;30545;670;2173;8014;27396;8684;29569
211153;201304;3143;9628;2892;9329;275;723;2422;8150;2697;8873
211157;201304;1140;3969;1000;3761;135;610;723;2747;858;3357
211160;201304;3969;14224;3559;13528;430;1886;2704;10293;3134;12179
211163;201304;1569;5387;1509;5311;68;266;1380;4862;1448;5128
211167;201304;1385;4947;1298;4790;68;292;1118;4141;1186;4433
211170;201304;6301;17903;6146;17708;162;600;5740;16468;5902;17068
211172;201304;2195;6726;1969;6394;151;621;1607;5119;1758;5740
211174;201304;2741;8421;2557;8180;137;554;2232;7085;2369;7639
211176;201304;5438;16288;4686;15407;485;1367;3857;13154;4342;14521
211178;201304;2820;9540;2759;9474;66;196;2635;9140;2701;9336
211180;201304;4108;15311;3877;14934;414;1750;3037;11768;3451;13518
211190;201304;2650;9520;2448;9239;160;697;2138;8110;2298;8807
211195;201304;1369;4541;1222;4377;102;370;1008;3683;1110;4053
211200;201304;2003;7290;1820;7026;298;1091;1286;5264;1584;6355
211210;201304;6704;22860;6546;22592;514;1840;5571;19405;6085;21245
211220;201304;33180;103205;29546;98345;6705;23206;18384;62953;25089;86159
211223;201304;5747;16808;5396;16237;729;2225;3760;11887;4489;14112
211227;201304;1435;5700;1410;5656;170;806;1082;4316;1252;5122
211230;201304;8268;29722;7935;29108;1384;5133;5527;20700;6911;25833
211240;201304;8280;28471;8097;28247;380;1408;7457;26130;7837;27538
211245;201304;4868;15791;4791;15692;233;677;4381;14585;4614;15262
211250;201304;11247;43960;10783;43413;1274;4365;8943;37480;10217;41845
211260;201304;6680;24680;6615;24569;371;1229;6020;22707;6391;23936
211270;201304;9574;35178;9219;34710;658;2759;7747;29511;8405;32270
211280;201304;11122;33706;10980;33529;1171;2928;9359;29597;10530;32525
211285;201304;1954;7114;1722;6687;427;1681;915;3779;1342;5460
211290;201304;7591;25409;7464;25260;540;1488;6631;23000;7171;24488
211300;201304;8043;25701;7284;24535;736;2655;5788;19599;6524;22254
211400;201304;11720;35873;10945;35031;2293;7210;7033;24395;9326;31605
220005;201304;1763;5244;1686;5116;70;307;1468;4343;1538;4650
220010;201304;1706;4596;1304;4096;148;553;1012;3119;1160;3672
220020;201304;3544;11166;3441;10977;617;2111;2324;7392;2941;9503
220025;201304;2031;5317;1953;5215;76;246;1752;4611;1828;4857
220027;201304;1294;3792;1229;3706;94;244;1050;3248;1144;3492
220030;201304;3178;10028;3120;9932;267;934;2651;8452;2918;9386
220040;201304;8149;25834;7844;25340;1444;4997;5146;16668;6590;21665
220045;201304;1400;4593;1291;4424;162;617;967;3293;1129;3910
220050;201304;4622;13567;4194;13012;360;1284;3494;10754;3854;12038
220060;201304;1873;5093;1780;4982;116;348;1569;4393;1685;4741
220070;201304;2526;7749;2278;7404;210;680;1850;6124;2060;6804
220080;201304;802;2548;758;2469;100;399;534;1684;634;2083
220090;201304;1644;4737;1494;4510;152;551;1155;3403;1307;3954
220095;201304;629;1871;612;1831;37;110;552;1643;589;1753
220100;201304;1371;4256;1212;4008;165;507;882;3026;1047;3533
220105;201304;2117;7282;2031;7125;209;784;1508;5304;1717;6088
220110;201304;3454;10279;3073;9733;296;1115;2501;7799;2797;8914
220115;201304;2101;7995;2027;7869;295;1199;1560;6135;1855;7334
220117;201304;1392;3785;1169;3458;96;327;921;2680;1017;3007
220120;201304;11628;35365;10959;34510;449;1708;9881;31158;10330;32866
220130;201304;775;2916;690;2803;72;215;584;2481;656;2696
220140;201304;1484;4158;1443;4110;187;438;1220;3571;1407;4009
220150;201304;6772;22544;6598;22287;512;2003;5606;18899;6118;20902
220155;201304;1022;3296;892;3043;89;377;630;2095;719;2472
220157;201304;1014;2784;942;2679;45;119;823;2366;868;2485
220160;201304;2776;8525;2514;8065;256;962;1907;6058;2163;7020
220170;201304;1201;4041;1160;3959;114;418;910;3138;1024;3556
220173;201304;2076;6412;1766;5819;103;451;1439;4684;1542;5135
220177;201304;1491;4779;1471;4747;115;388;1275;4136;1390;4524
220180;201304;1131;3174;1024;3010;89;312;787;2267;876;2579
220190;201304;4479;14992;3917;14266;482;1848;3003;11032;3485;12880
220191;201304;1393;4808;1341;4720;216;773;995;3523;1211;4296
220192;201304;1730;5217;1458;4762;184;576;1088;3640;1272;4216
220194;201304;1592;4869;1534;4770;150;549;1271;3879;1421;4428
220196;201304;1936;6053;1855;5925;197;732;1456;4622;1653;5354
220198;201304;1313;3617;1132;3370;50;163;1024;3067;1074;3230
220200;201304;4546;16069;4316;15688;762;3030;2950;10672;3712;13702
220202;201304;1947;6453;1815;6210;87;366;1579;5375;1666;5741
220205;201304;2672;7762;2388;7377;125;508;2068;6309;2193;6817
220207;201304;905;2822;810;2664;108;401;600;1968;708;2369
220208;201304;1507;5612;1432;5454;296;1209;907;3497;1203;4706
220209;201304;1532;4952;1423;4759;107;426;1099;3679;1206;4105
220210;201304;1837;4973;1620;4685;102;348;1293;3762;1395;4110
220211;201304;1544;4915;1471;4811;116;526;1201;3898;1317;4424
220213;201304;1753;5273;1648;5082;120;409;1308;3999;1428;4408
220217;201304;1751;5600;1709;5541;91;281;1526;5002;1617;5283
220220;201304;10987;33238;10460;32370;1407;4329;7636;24151;9043;28480
220225;201304;934;3031;918;3003;44;196;823;2658;867;2854
220230;201304;5626;15520;4634;14164;269;834;4067;12526;4336;13360
220240;201304;2590;8517;2504;8362;212;809;1986;6560;2198;7369
220245;201304;1332;3809;1274;3732;58;148;1159;3433;1217;3581
220250;201304;3251;8925;2992;8600;64;159;2820;8207;2884;8366
220253;201304;1816;5566;1594;5159;113;448;1197;3908;1310;4356
220255;201304;1678;5018;1499;4724;123;473;1197;3699;1320;4172
220260;201304;5135;16827;4758;16136;517;2044;3589;12082;4106;14126
220265;201304;1165;4342;1127;4279;102;465;894;3356;996;3821
220270;201304;6027;21948;5913;21745;446;2004;5013;18221;5459;20225
220271;201304;1317;3998;1285;3953;93;302;1102;3419;1195;3721
220272;201304;1740;5471;1633;5309;119;495;1294;4154;1413;4649
220273;201304;1208;3595;1100;3442;95;346;875;2728;970;3074
220275;201304;1991;5526;1735;5188;94;307;1488;4476;1582;4783
220277;201304;2471;6958;2136;6469;181;604;1623;4942;1804;5546
220280;201304;1730;4607;1523;4319;103;384;1240;3450;1343;3834
220285;201304;1591;4378;1484;4232;107;296;1231;3622;1338;3918
220290;201304;6449;21102;5484;19874;461;1711;4532;16700;4993;18411
220300;201304;1867;6186;1672;5921;93;421;1445;5108;1538;5529
220310;201304;2483;8109;2042;7580;109;351;1843;7008;1952;7359
220320;201304;3274;9887;2806;9126;403;1313;2044;6747;2447;8060
220323;201304;1402;5353;1303;5211;228;966;924;3720;1152;4686
220325;201304;1245;3956;1156;3795;155;543;787;2667;942;3210
220327;201304;1303;4305;1191;4107;95;435;970;3308;1065;3743
220330;201304;3540;10481;3416;10306;317;1076;2841;8592;3158;9668
220335;201304;1954;5835;1766;5589;128;467;1502;4737;1630;5204
220340;201304;1700;5003;1547;4800;175;624;1203;3694;1378;4318
220342;201304;1196;3992;1136;3907;117;458;864;3070;981;3528
220345;201304;2762;7998;2394;7394;73;231;2102;6481;2175;6712
220350;201304;4397;12110;3904;11444;316;1025;3115;9113;3431;10138
220360;201304;1376;3972;1104;3540;118;448;802;2541;920;2989
220370;201304;8805;26062;8227;25346;413;1210;7526;23340;7939;24550
220375;201304;1451;4657;1374;4548;93;355;1200;3946;1293;4301
220380;201304;1246;3653;1108;3455;85;296;837;2632;922;2928
220385;201304;633;1842;578;1729;50;174;464;1336;514;1510
220390;201304;9966;32242;9419;31216;2146;7598;5452;18191;7598;25789
220400;201304;1395;3447;1283;3296;62;204;1117;2813;1179;3017
220410;201304;1367;4080;1185;3838;109;471;942;2960;1051;3431
220415;201304;818;2298;746;2196;86;253;556;1655;642;1908
220420;201304;2124;6408;2051;6282;148;469;1745;5359;1893;5828
220430;201304;2855;8662;2724;8482;456;1484;1950;6072;2406;7556
220435;201304;1530;4671;1458;4583;75;242;1267;4017;1342;4259
220440;201304;2745;8327;2284;7803;154;423;2030;7079;2184;7502
220450;201304;2687;8094;2358;7662;533;1763;1509;5007;2042;6770
220455;201304;1368;4331;1225;4125;61;208;1099;3737;1160;3945
220460;201304;984;2841;937;2776;58;188;816;2406;874;2594
220465;201304;2356;7977;2219;7801;316;1186;1715;6091;2031;7277
220470;201304;3916;12167;3593;11582;264;996;2837;9024;3101;10020
220480;201304;2195;6952;2052;6736;176;611;1693;5565;1869;6176
220490;201304;2261;6940;2192;6847;139;508;1918;5968;2057;6476
220500;201304;3363;9346;2958;8694;230;878;2397;6863;2627;7741
220510;201304;2852;8155;2238;7292;125;546;1799;5803;1924;6349
220515;201304;1809;4850;1609;4595;88;258;1362;3920;1450;4178
220520;201304;4697;13848;4470;13515;261;736;3892;11939;4153;12675
220525;201304;1388;4131;1316;4026;102;367;1098;3320;1200;3687
220527;201304;1356;4481;1324;4420;122;402;1123;3783;1245;4185
220530;201304;1003;3146;973;3096;145;515;757;2352;902;2867
220535;201304;846;2764;823;2727;72;298;665;2178;737;2476
220540;201304;3469;11947;3365;11761;296;1163;2727;9575;3023;10738
220545;201304;1349;4836;1307;4762;216;884;891;3203;1107;4087
220550;201304;8595;29525;8226;28823;1542;5756;5563;19495;7105;25251
220551;201304;1331;4819;1284;4729;135;580;1003;3650;1138;4230
220552;201304;1578;5067;1379;4736;148;666;995;3285;1143;3951
220553;201304;1573;4790;1397;4530;64;207;1220;3985;1284;4192
220554;201304;898;2562;797;2425;120;363;559;1735;679;2098
220555;201304;2324;7104;2212;6942;111;388;1876;5987;1987;6375
220556;201304;1419;4620;1299;4389;109;466;975;3245;1084;3711
220557;201304;1555;5318;1455;5120;181;781;1045;3625;1226;4406
220558;201304;997;3193;955;3124;89;325;779;2543;868;2868
220559;201304;1507;4383;1405;4233;81;285;1209;3623;1290;3908
220560;201304;1715;4376;1461;4019;80;242;1244;3393;1324;3635
220570;201304;7210;23441;6853;23008;637;1771;5848;20286;6485;22057
220580;201304;6213;21114;6045;20905;429;1455;5318;18659;5747;20114
220585;201304;1680;6749;1647;6687;108;459;1444;5889;1552;6348
220590;201304;1356;4417;1232;4229;218;786;838;2914;1056;3700
220595;201304;2367;7059;2215;6854;98;337;1991;6188;2089;6525
220600;201304;1212;3310;1081;3150;122;348;819;2430;941;2778
220605;201304;1975;6062;1794;5778;132;447;1408;4566;1540;5013
220610;201304;2587;8646;2514;8536;192;750;2115;7156;2307;7906
220620;201304;7557;26397;7362;26092;354;1518;6540;23109;6894;24627
220630;201304;375;1180;332;1106;88;308;169;573;257;881
220635;201304;1822;6695;1698;6402;173;769;1126;4247;1299;5016
220640;201304;2639;8139;2590;8042;265;954;2032;6265;2297;7219
220650;201304;2432;6875;2208;6532;126;422;1852;5472;1978;5894
220660;201304;2479;8655;2056;8138;152;600;1845;7371;1997;7971
220665;201304;1189;4157;1142;4082;60;246;1000;3562;1060;3808
220667;201304;1725;5999;1638;5872;95;396;1409;5031;1504;5427
220669;201304;1814;6154;1700;5919;226;901;1231;4270;1457;5171
220670;201304;2060;6436;1992;6358;159;416;1746;5771;1905;6187
220672;201304;2077;6235;2031;6168;234;702;1683;5161;1917;5863
220675;201304;1249;3829;1184;3717;131;374;888;2834;1019;3208
220680;201304;2205;7466;2132;7362;116;461;1875;6488;1991;6949
220690;201304;1695;5004;1555;4766;135;504;1261;3811;1396;4315
220695;201304;820;2643;793;2594;64;225;617;2031;681;2256
220700;201304;8823;26514;8142;25498;797;2754;6466;20335;7263;23089
220710;201304;735;2251;660;2139;87;276;479;1568;566;1844
220720;201304;2068;5726;1964;5576;108;243;1742;5048;1850;5291
220730;201304;1285;3728;1184;3571;71;230;984;2974;1055;3204
220735;201304;1011;2750;884;2546;98;311;653;1886;751;2197
220740;201304;1289;4410;1127;4197;100;328;947;3629;1047;3957
220750;201304;3711;11562;3600;11390;449;1363;2794;9088;3243;10451
220755;201304;1144;3513;1106;3459;70;208;972;3061;1042;3269
220760;201304;2506;9124;2341;8862;120;501;2035;7764;2155;8265
220770;201304;22339;79140;21173;77006;7259;27297;9560;35850;16819;63147
220775;201304;1058;2759;1049;2750;18;27;1024;2706;1042;2733
220777;201304;1646;4862;1581;4769;137;438;1305;3912;1442;4350
220779;201304;1116;3563;1097;3530;71;285;968;3089;1039;3374
220780;201304;6134;16339;5613;15666;471;1200;4733;13479;5204;14679
220785;201304;1274;3568;1231;3477;66;196;1104;3092;1170;3288
220790;201304;8568;30027;8400;29690;845;3403;6729;23700;7574;27103
220793;201304;817;2555;778;2483;74;269;614;1951;688;2220
220795;201304;1379;4254;1336;4182;97;344;1127;3535;1224;3879
220800;201304;16121;47861;15321;46562;2069;7259;11546;34382;13615;41641
220810;201304;3147;9566;2775;8890;249;1003;2147;6766;2396;7769
220820;201304;5292;15754;4878;15210;381;1259;4088;12885;4469;14144
220830;201304;7551;22042;7285;21606;887;2603;5663;17106;6550;19709
220840;201304;13829;46269;12925;44459;3458;12125;6156;21946;9614;34071
220850;201304;2534;9708;2448;9569;366;1521;1836;7270;2202;8791
220855;201304;583;1922;541;1846;75;305;390;1313;465;1618
220860;201304;911;2649;856;2562;56;225;704;2059;760;2284
220865;201304;2603;7568;2230;6972;129;575;1815;5567;1944;6142
220870;201304;2248;7669;1976;7320;172;694;1644;6096;1816;6790
220880;201304;5209;14092;4794;13577;270;939;4181;11810;4451;12749
220885;201304;1312;4698;1169;4443;121;567;864;3284;985;3851
220887;201304;1180;3389;1080;3246;56;184;942;2846;998;3030
220890;201304;1561;5733;1419;5501;122;458;1180;4699;1302;5157
220900;201304;1787;5628;1621;5235;134;419;1302;4284;1436;4703
220910;201304;1716;5051;1548;4788;89;312;1333;4151;1422;4463
220915;201304;1022;3041;925;2884;60;260;748;2265;808;2525
220920;201304;1284;4913;1229;4833;118;535;957;3764;1075;4299
220930;201304;1398;4703;1247;4505;113;467;1013;3670;1126;4137
220935;201304;1085;3468;1022;3330;95;415;753;2348;848;2763
220937;201304;1469;4225;1291;3910;84;307;1040;3101;1124;3408
220940;201304;1464;4591;1374;4395;102;377;1111;3562;1213;3939
220945;201304;468;1752;443;1668;57;241;326;1228;383;1469
220950;201304;1227;3187;916;2644;50;205;691;1917;741;2122
220955;201304;1504;4380;1287;4041;142;507;991;3080;1133;3587
220960;201304;762;2256;690;2132;81;317;515;1534;596;1851
220965;201304;1582;5045;1504;4935;79;327;1286;4212;1365;4539
220970;201304;2089;5810;1612;5038;199;625;1139;3627;1338;4252
220975;201304;458;1889;456;1884;56;201;385;1632;441;1833
220980;201304;1452;4474;1306;4206;134;509;896;2943;1030;3452
220985;201304;1316;3906;1266;3836;119;405;1008;3055;1127;3460
220987;201304;1438;4919;1365;4782;134;570;1034;3561;1168;4131
220990;201304;1783;5421;1621;5150;105;443;1301;4078;1406;4521
220995;201304;1133;3592;967;3305;83;352;773;2616;856;2968
220997;201304;2045;6604;1981;6510;163;549;1727;5671;1890;6220
221000;201304;3956;12945;3683;12456;426;1604;2759;9292;3185;10896
221005;201304;1371;4452;1309;4341;364;1152;756;2610;1120;3762
221010;201304;1217;3448;1085;3281;76;254;927;2818;1003;3072
221020;201304;1880;5996;1791;5836;141;620;1392;4430;1533;5050
221030;201304;1810;5063;1593;4751;88;356;1303;3837;1391;4193
221035;201304;1463;4149;1337;3989;103;306;1143;3457;1246;3763
221037;201304;602;1925;578;1884;37;162;468;1462;505;1624
221038;201304;589;1765;496;1610;51;179;356;1161;407;1340
221039;201304;879;2754;847;2702;65;228;740;2348;805;2576
221040;201304;5024;15870;4804;15501;434;1546;3786;12332;4220;13878
221050;201304;3498;11276;3251;10909;234;979;2759;9148;2993;10127
221060;201304;8863;24631;7750;23220;891;2706;6158;18656;7049;21362
221062;201304;1231;4415;1185;4354;36;105;1115;4130;1151;4235
221063;201304;1056;3518;1017;3459;317;1039;597;2126;914;3165
221065;201304;2448;7815;2378;7682;271;928;1847;5940;2118;6868
221070;201304;4363;13717;4028;13207;302;1132;3252;10655;3554;11787
221080;201304;3078;9307;2855;9008;262;882;2299;7338;2561;8220
221090;201304;1313;3707;1187;3522;76;304;1002;2907;1078;3211
221093;201304;1745;5354;1680;5235;254;925;1153;3502;1407;4427
221095;201304;937;2642;815;2470;45;123;717;2207;762;2330
221097;201304;762;2304;698;2197;67;257;535;1673;602;1930
221100;201304;117890;373225;113010;365016;25453;91073;73054;230509;98507;321582
221110;201304;9116;32531;8997;32349;728;2924;7596;27323;8324;30247
221120;201304;3935;13707;3828;13505;1188;3999;2202;8228;3390;12227
221130;201304;4508;13834;4078;12952;991;3299;2311;7258;3302;10557
221135;201304;1354;4500;1285;4384;194;743;898;3052;1092;3795
221140;201304;1363;3564;1265;3434;179;390;970;2744;1149;3134
221150;201304;1203;3196;1054;2938;38;150;861;2375;899;2525
221160;201304;900;2513;864;2456;59;192;680;1942;739;2134
221170;201304;1077;3637;1043;3566;85;344;866;2929;951;3273
230010;201304;3222;9196;2797;8507;184;633;2240;6889;2424;7522
230015;201304;2922;10367;2723;9942;509;2116;1712;6161;2221;8277
230020;201304;13613;47252;13166;46338;1389;5342;10224;36188;11613;41530
230030;201304;11812;36805;11381;36075;1260;4334;8917;28289;10177;32623
230040;201304;4395;13035;3815;11999;371;1324;2968;9299;3339;10623
230050;201304;2518;8826;2230;8124;419;1684;1233;4504;1652;6188
230060;201304;1904;5983;1738;5654;192;724;1292;4175;1484;4899
230070;201304;4557;12902;4094;12254;397;1264;3138;9602;3535;10866
230075;201304;8388;32932;8056;32253;1117;5007;5910;23798;7027;28805
230080;201304;2260;6555;1979;6149;122;454;1612;4980;1734;5434
230090;201304;3106;10180;2856;9708;373;1442;2102;7064;2475;8506
230100;201304;16263;52907;15369;51293;4658;16439;7557;25576;12215;42015
230110;201304;13526;46473;12733;44758;2572;9801;7822;27515;10394;37316
230120;201304;7374;21635;6823;20895;793;2763;5195;15838;5988;18601
230125;201304;2782;8524;2377;7754;191;755;1819;5892;2010;6647
230130;201304;5905;20019;4934;17926;499;2185;3449;12429;3948;14614
230140;201304;3177;11033;2898;10556;489;1871;1904;7088;2393;8959
230150;201304;1667;5572;1502;5237;279;1145;994;3309;1273;4454
230160;201304;5993;19085;5367;18144;591;2217;4064;13797;4655;16014
230170;201304;6283;20868;5558;19524;568;2286;4022;14028;4590;16314
230180;201304;1867;5623;1700;5331;167;664;1212;3779;1379;4443
230185;201304;4036;14025;3774;13502;735;2697;2342;8627;3077;11324
230190;201304;12184;41202;11266;39379;2074;8250;6833;23682;8907;31932
230195;201304;4665;15144;4275;14538;399;1721;3315;10918;3714;12639
230200;201304;5309;16439;4982;15806;765;2577;3461;10980;4226;13557
230205;201304;4281;14236;3879;13544;451;1814;2810;9934;3261;11748
230210;201304;8897;26801;8101;25588;1968;6391;4710;15386;6678;21777
230220;201304;13048;40783;12250;39427;2177;7852;8193;26016;10370;33868
230230;201304;6844;24149;6233;22793;1038;4123;3884;14331;4922;18454
230240;201304;12706;38989;11708;37102;873;3473;9178;28500;10051;31973
230250;201304;10088;31652;9859;31301;583;2155;8467;26878;9050;29033
230260;201304;14455;51424;13552;49488;3274;12754;7086;26513;10360;39267
230270;201304;6901;21760;6236;20622;709;2601;4630;15447;5339;18048
230280;201304;19489;61240;18286;59296;2492;8842;13729;44535;16221;53377
230290;201304;4936;15825;4399;14753;611;2222;3026;10159;3637;12381
230300;201304;4510;14893;4357;14661;589;2193;3241;10959;3830;13152
230310;201304;4740;14669;4250;13852;419;1693;3236;10337;3655;12030
230320;201304;7084;23954;6749;23367;906;3522;4957;17218;5863;20740
230330;201304;4549;14181;4199;13484;444;1713;3144;9882;3588;11595
230340;201304;3221;11815;3080;11494;513;2231;1984;7226;2497;9457
230350;201304;17372;55638;15777;52804;3228;11626;9632;32583;12860;44209
230360;201304;2678;8514;2518;8216;271;1048;1989;6391;2260;7439
230365;201304;2755;8593;2457;8083;223;874;1822;5969;2045;6843
230370;201304;51378;178759;48448;173787;14954;55858;24665;91333;39619;147191
230380;201304;6870;20564;5999;19091;625;2353;4270;13521;4895;15874
230390;201304;3572;11742;3224;11166;456;1829;2197;7602;2653;9431
230393;201304;3256;11275;2903;10528;314;1514;2051;7208;2365;8722
230395;201304;4751;15756;4473;15200;655;2642;3079;10321;3734;12963
230400;201304;4979;16134;4440;15398;428;1893;3594;12223;4022;14116
230410;201304;15789;51537;14390;49013;2376;8885;9270;31598;11646;40483
230420;201304;23122;79778;22041;77613;5833;22423;11459;40184;17292;62607
230423;201304;4670;15904;4348;15339;553;2125;3056;10951;3609;13076
230425;201304;5054;17984;4849;17509;727;2878;3438;12414;4165;15292
230426;201304;2751;7969;2386;7322;154;629;1844;5548;1998;6177
230427;201304;1682;5353;1335;4572;173;662;893;3018;1066;3680
230428;201304;8679;29722;8494;29397;1857;7188;5446;18576;7303;25764
230430;201304;4406;14813;4228;14454;428;1788;3134;10548;3562;12336
230435;201304;4350;15508;4037;14974;1141;4535;1908;7409;3049;11944
230440;201304;345764;1113757;329735;1084552;87526;311142;170423;561125;257949;872267
230445;201304;4541;13061;4017;12333;425;1295;2995;9464;3420;10759
230450;201304;3504;11721;3024;10852;514;2028;1892;6874;2406;8902
230460;201304;1827;6315;1718;6096;199;750;1291;4635;1490;5385
230465;201304;3974;12856;3372;11715;408;1695;2244;7746;2652;9441
230470;201304;10306;39970;10025;39416;1512;6358;7163;28767;8675;35125
230480;201304;1385;4652;1282;4466;182;695;919;3200;1101;3895
230490;201304;2899;8742;2598;8196;454;1635;1480;4659;1934;6294
230495;201304;5578;19263;5094;18465;957;4073;3118;11307;4075;15380
230500;201304;10453;36588;10034;35919;889;3276;8036;29473;8925;32749
230510;201304;1441;5370;1294;5009;382;1557;592;2373;974;3930
230520;201304;4916;15502;4326;14446;500;1946;3022;10042;3522;11988
230523;201304;12666;44017;11885;42252;3867;15209;3694;13332;7561;28541
230526;201304;3859;12800;3456;12040;497;1901;2350;8327;2847;10228
230530;201304;4915;17153;4624;16737;573;2217;3549;12882;4122;15099
230533;201304;3678;11240;3482;10856;314;1145;2706;8360;3020;9505
230535;201304;5121;16056;4574;15030;525;1897;3346;11090;3871;12987
230540;201304;17859;54072;16293;51767;1301;4766;13341;42198;14642;46964
230550;201304;19881;62034;18413;59242;4475;15500;10171;32786;14646;48286
230560;201304;6455;19479;6040;18698;361;1457;4808;14744;5169;16201
230565;201304;3535;10562;3136;9814;298;1126;2269;7015;2567;8141
230570;201304;3795;10791;3458;10359;269;990;2835;8379;3104;9369
230580;201304;9885;31760;9605;31385;579;2028;8437;27774;9016;29802
230590;201304;9272;30864;8752;29931;866;3655;6601;22160;7467;25815
230600;201304;3522;10320;2923;9087;353;1232;1951;6011;2304;7243
230610;201304;5844;20158;5516;19627;803;3171;4002;14275;4805;17446
230620;201304;1917;5721;1675;5252;174;636;1153;3581;1327;4217
230625;201304;7054;24566;6560;23410;1862;7250;2737;9706;4599;16956
230630;201304;10524;36139;9820;34630;1830;6473;6052;21950;7882;28423
230640;201304;24102;87722;23541;86636;4105;16073;16236;60383;20341;76456
230650;201304;4796;15939;4465;15285;432;1882;3411;11446;3843;13328
230655;201304;7824;31423;7617;31080;855;3464;6211;25882;7066;29346
230660;201304;6129;20026;5479;18809;614;2480;3933;13599;4547;16079
230670;201304;5739;16376;4806;14777;340;1251;3790;11518;4130;12769
230680;201304;2848;8776;2492;8136;467;1673;1486;4859;1953;6532
230690;201304;6738;22587;6334;21881;631;2709;4534;15345;5165;18054
230700;201304;8667;26509;7767;24878;934;3670;5236;16337;6170;20007
230710;201304;6974;24185;6621;23450;881;3263;4748;17149;5629;20412
230720;201304;1905;6184;1652;5697;249;915;1101;3835;1350;4750
230725;201304;3731;12763;3593;12467;582;2314;2537;8683;3119;10997
230730;201304;55249;173733;47859;162501;12009;44395;26206;90616;38215;135011
230740;201304;4819;16466;4754;16327;380;1665;3944;13343;4324;15008
230750;201304;8589;26123;7478;24267;786;3084;5570;17928;6356;21012
230760;201304;9360;30228;9153;29745;1361;5509;6637;20487;7998;25996
230763;201304;4042;13310;3872;12985;361;1639;3005;9703;3366;11342
230765;201304;41824;142232;39698;137820;13678;50272;15174;53763;28852;104035
230770;201304;21600;64326;20805;63211;1790;6948;16919;50723;18709;57671
230780;201304;5815;23872;5613;23415;1270;5370;3228;14160;4498;19530
230790;201304;2367;8617;2282;8483;294;1174;1797;6747;2091;7921
230800;201304;7635;28804;7143;27687;1725;7394;3684;14330;5409;21724
230810;201304;12116;40841;11705;40152;1458;5342;8938;31026;10396;36368
230820;201304;3201;11409;2926;10850;639;2580;1692;6402;2331;8982
230830;201304;7531;23769;6926;22689;749;2932;5046;16410;5795;19342
230835;201304;4033;11399;3520;10742;338;1117;2753;8448;3091;9565
230837;201304;3108;10977;2724;10177;420;1766;1776;6657;2196;8423
230840;201304;9000;31155;8345;29966;1614;6101;5165;19025;6779;25126
230850;201304;11031;34788;10508;34128;1351;4902;7961;25811;9312;30713
230860;201304;4973;15405;4579;14594;444;1705;3414;10716;3858;12421
230870;201304;18421;53290;16792;50473;1990;6817;12480;37209;14470;44026
230880;201304;1886;6805;1777;6586;301;1269;1163;4322;1464;5591
230890;201304;4001;15026;3753;14517;511;2338;2694;10288;3205;12626
230900;201304;2978;10261;2655;9580;441;1742;1612;5797;2053;7539
230910;201304;2892;9044;2420;8123;291;1153;1689;5568;1980;6721
230920;201304;4461;13680;4148;13277;363;1236;3352;10894;3715;12130
230930;201304;7464;23738;6931;22755;916;3233;4911;16235;5827;19468
230940;201304;7465;21561;6762;20608;320;968;5968;18429;6288;19397
230945;201304;6048;19200;5507;18456;702;2504;4008;13556;4710;16060
230950;201304;6682;19063;5914;18071;400;1422;4704;14359;5104;15781
230960;201304;11463;38403;10765;36951;2717;10284;5191;17722;7908;28006
230970;201304;12695;42726;11808;40937;2660;10552;6281;21352;8941;31904
230980;201304;2649;9225;2508;8924;682;2517;1332;4856;2014;7373
230990;201304;1528;5044;1319;4590;165;689;842;2850;1007;3539
231000;201304;2770;7797;2297;6894;254;923;1597;4671;1851;5594
231010;201304;2813;8643;2533;8218;358;1393;1786;5687;2144;7080
231020;201304;7829;26686;7439;25885;1399;5198;4758;16829;6157;22027
231025;201304;7375;24403;6785;23433;608;2146;5371;18950;5979;21096
231030;201304;7610;26234;6612;24106;1285;4966;4055;14956;5340;19922
231040;201304;2903;10126;2678;9633;317;1375;1853;6573;2170;7948
231050;201304;11356;34960;10358;33107;1119;4088;7577;24206;8696;28294
231060;201304;2348;7598;2189;7324;218;993;1654;5347;1872;6340
231070;201304;8765;29229;8370;28473;1437;5255;5602;19211;7039;24466
231080;201304;4080;13524;3847;13054;332;1525;2859;9360;3191;10885
231085;201304;4497;15066;4353;14798;711;2689;3158;10733;3869;13422
231090;201304;4138;11896;3572;10774;259;974;2708;8038;2967;9012
231095;201304;2123;7291;1890;6830;222;870;1343;4898;1565;5768
231100;201304;3001;9621;2605;8847;266;1038;1908;6461;2174;7499
231110;201304;3641;12615;3550;12454;413;1588;2632;9283;3045;10871
231120;201304;2381;8047;2227;7775;392;1437;1479;5185;1871;6622
231123;201304;2153;6232;1904;5846;156;532;1522;4692;1678;5224
231126;201304;6524;18738;5487;17314;486;1776;4313;13470;4799;15246
231130;201304;19439;63640;18067;61209;4745;17023;9607;33521;14352;50544
231135;201304;4514;13776;3899;12818;388;1506;2881;9338;3269;10844
231140;201304;15080;50738;14418;49463;1723;7786;10395;34364;12118;42150
231150;201304;5703;17449;4914;15888;1058;3769;2512;7976;3570;11745
231160;201304;5598;19971;5446;19646;1621;6041;2981;10799;4602;16840
231170;201304;4576;15190;4331;14716;558;2290;3040;10218;3598;12508
231180;201304;13467;43962;12855;42727;2690;9945;7831;25527;10521;35472
231190;201304;4693;14001;4133;13186;418;1514;3171;10091;3589;11605
231195;201304;4644;16336;4097;15290;440;1916;3111;11689;3551;13605
231200;201304;7341;26669;6798;25652;836;3765;4976;18695;5812;22460
231210;201304;4702;15574;4108;14714;375;1614;3093;11222;3468;12836
231220;201304;13638;40785;11760;37613;1347;5128;7693;24680;9040;29808
231230;201304;9167;33871;8697;32923;1305;5413;6100;23150;7405;28563
231240;201304;11335;37142;10396;35477;1449;5569;7031;24217;8480;29786
231250;201304;2039;6096;1417;4536;265;898;602;1807;867;2705
231260;201304;3979;11522;3644;11074;486;1577;2572;7989;3058;9566
231270;201304;7310;21830;6798;21059;779;3052;4952;14969;5731;18021
231280;201304;1699;5836;1644;5739;158;570;1313;4658;1471;5228
231290;201304;31642;116775;29527;111430;8230;33946;12675;47029;20905;80975
231300;201304;4299;13242;3676;11937;402;1666;2659;8317;3061;9983
231310;201304;7090;21701;6357;20233;1469;4908;3443;10978;4912;15886
231320;201304;6986;22201;6311;20934;522;2059;4858;16051;5380;18110
231325;201304;2527;8047;2317;7684;202;724;1819;6126;2021;6850
231330;201304;13663;43841;11669;39972;2056;7242;7218;25053;9274;32295
231335;201304;4830;14463;4409;13698;375;1437;3534;10781;3909;12218
231340;201304;17046;57853;16257;56713;1587;5356;13153;47136;14740;52492
231350;201304;11714;41476;11561;41235;1360;4725;9444;34355;10804;39080
231355;201304;4297;14161;4163;13945;260;863;3602;12243;3862;13106
231360;201304;6683;23060;6365;22575;1483;5192;3959;14623;5442;19815
231370;201304;2248;6763;1867;6207;146;599;1412;4597;1558;5196
231375;201304;4027;14300;3845;13950;490;2121;2870;10273;3360;12394
231380;201304;5124;17199;4859;16820;876;3270;3346;11766;4222;15036
231390;201304;3297;10824;3168;10653;210;828;2703;9148;2913;9976
231395;201304;4132;13741;3744;13134;818;3008;2300;8264;3118;11272
231400;201304;10096;31227;9341;29904;1109;4137;6626;21216;7735;25353
231410;201304;14451;49048;13206;47310;1490;5450;9901;36552;11391;42002
240010;201304;2274;7441;2130;7123;624;2321;941;3060;1565;5381
240020;201304;11383;36800;10339;34833;2955;10699;4779;16411;7734;27110
240030;201304;2704;8194;2611;8044;283;1074;1983;5957;2266;7031
240040;201304;751;2336;668;2183;83;355;468;1448;551;1803
240050;201304;3404;9819;3103;9309;273;1025;2343;6848;2616;7873
240060;201304;1356;4251;1309;4176;144;571;986;3046;1130;3617
240070;201304;2629;7802;2523;7590;347;1193;1735;5064;2082;6257
240080;201304;2890;8073;2723;7820;203;653;2264;6501;2467;7154
240090;201304;2119;6075;1857;5548;91;379;1439;4194;1530;4573
240100;201304;9822;29815;9228;28623;1272;4706;5836;18081;7108;22787
240110;201304;4988;15527;4626;14947;990;3601;2868;8978;3858;12579
240120;201304;2890;9815;2817;9682;613;2276;1757;6128;2370;8404
240130;201304;2606;7580;2286;7064;180;695;1818;5494;1998;6189
240140;201304;2180;7030;2032;6768;477;1814;1077;3512;1554;5326
240145;201304;6019;19060;5526;18213;1453;5314;3050;10043;4503;15357
240150;201304;990;3140;852;2871;142;591;480;1555;622;2146
240160;201304;1383;4760;1308;4628;162;645;916;3265;1078;3910
240165;201304;851;2858;778;2719;98;378;528;1868;626;2246
240170;201304;2532;7915;2314;7508;611;2086;1246;4143;1857;6229
240180;201304;2844;9253;2705;9030;676;2336;1532;5337;2208;7673
240185;201304;1465;4981;1422;4916;185;672;1066;3707;1251;4379
240190;201304;866;2737;841;2694;124;485;567;1759;691;2244
240200;201304;13283;36248;11503;34017;2213;6549;7554;23258;9767;29807
240210;201304;2645;7774;2472;7542;244;895;2016;6056;2260;6951
240220;201304;7218;23381;7034;23167;250;967;6551;21569;6801;22536
240230;201304;5201;15565;4911;15031;520;1879;3751;11305;4271;13184
240240;201304;1688;5485;1348;4567;423;1532;337;1057;760;2589
240250;201304;2745;8164;2627;7974;216;814;2157;6409;2373;7223
240260;201304;14250;49237;13685;48290;2413;9783;9042;31764;11455;41547
240270;201304;2277;7793;2177;7628;277;985;1613;5766;1890;6751
240280;201304;1571;4667;1409;4369;151;556;1005;3073;1156;3629
240290;201304;1418;4542;1236;4201;129;609;832;2704;961;3313
240300;201304;1936;5417;1670;4980;349;1172;939;2714;1288;3886
240310;201304;9913;29076;9226;28007;2209;7412;5084;15333;7293;22745
240320;201304;1997;6126;1728;5575;140;632;1191;3689;1331;4321
240325;201304;34568;99700;28332;89030;8425;29254;10471;33125;18896;62379
240330;201304;1491;4629;1293;4232;171;701;819;2559;990;3260
240340;201304;1541;4807;1400;4623;303;1095;869;2855;1172;3950
240350;201304;1979;6384;1892;6228;333;1242;1389;4478;1722;5720
240360;201304;6859;21684;6152;20576;1037;3787;4175;14245;5212;18032
240370;201304;1902;5372;1715;5083;137;499;1312;3878;1449;4377
240375;201304;851;2328;765;2207;169;557;414;1145;583;1702
240380;201304;2516;7715;2208;7086;348;1164;1372;4393;1720;5557
240390;201304;883;2603;740;2317;79;314;483;1486;562;1800
240400;201304;1414;3939;1252;3712;136;513;955;2766;1091;3279
240410;201304;507;1685;454;1570;87;347;264;899;351;1246
240420;201304;4743;18338;4599;18016;1329;5269;2466;10199;3795;15468
240430;201304;3357;9977;3115;9549;390;1361;2206;6686;2596;8047
240440;201304;2525;7285;2381;7002;604;1772;1246;3785;1850;5557
240450;201304;3510;10942;3299;10584;578;2186;2009;6403;2587;8589
240460;201304;2709;9337;2644;9219;321;1294;1998;6969;2319;8263
240470;201304;3756;11636;3238;10619;875;2991;1599;5399;2474;8390
240480;201304;329;892;320;883;37;102;246;696;283;798
240485;201304;2066;6337;1847;5910;276;1007;1189;3808;1465;4815
240490;201304;1631;4297;1456;4056;97;376;1166;3138;1263;3514
240500;201304;1898;6123;1859;6057;180;652;1473;4838;1653;5490
240510;201304;1735;5456;1624;5240;280;951;1097;3577;1377;4528
240520;201304;1415;4260;1257;4036;214;802;860;2699;1074;3501
240530;201304;1998;6850;1832;6563;290;1139;1224;4402;1514;5541
240540;201304;1822;5605;1739;5467;152;557;1336;4141;1488;4698
240550;201304;696;2150;675;2115;57;218;543;1673;600;1891
240560;201304;3127;9366;3005;9182;267;918;2468;7506;2735;8424
240570;201304;3023;8878;2532;7788;551;1913;1159;3300;1710;5213
240580;201304;7877;25026;7527;24476;1360;4636;5335;17372;6695;22008
240590;201304;812;2379;748;2271;57;226;539;1595;596;1821
240600;201304;1423;4383;1201;3904;221;811;660;2035;881;2846
240610;201304;5000;14219;4466;13262;463;1552;3196;9356;3659;10908
240615;201304;984;2921;869;2710;146;471;519;1628;665;2099
240620;201304;1525;5282;1459;5148;315;1188;998;3528;1313;4716
240630;201304;1983;6273;1903;6136;175;577;1487;4934;1662;5511
240640;201304;814;2581;714;2419;100;436;463;1509;563;1945
240650;201304;3654;11571;3425;11259;318;1213;2770;9055;3088;10268
240660;201304;2345;7968;2268;7849;254;982;1739;6086;1993;7068
240670;201304;2684;8221;2343;7532;390;1477;1401;4380;1791;5857
240680;201304;1437;4324;1185;3860;153;545;740;2411;893;2956
240690;201304;1056;3075;939;2888;105;386;678;2064;783;2450
240700;201304;2557;7898;2181;7173;154;688;1663;5291;1817;5979
240710;201304;17202;45013;15602;43076;2875;8051;10066;28689;12941;36740
240720;201304;5338;15932;5114;15581;1287;4355;2926;8846;4213;13201
240725;201304;1069;3223;840;2719;98;322;470;1502;568;1824
240730;201304;2238;7059;2030;6663;212;797;1436;4644;1648;5441
240740;201304;2221;6827;2012;6446;258;920;1357;4315;1615;5235
240750;201304;2129;8104;1985;7830;432;1812;1198;4801;1630;6613
240760;201304;1174;3601;1122;3521;108;318;905;2920;1013;3238
240770;201304;3419;10285;3165;9901;448;1557;2199;6882;2647;8439
240780;201304;5277;16149;4551;14902;964;3252;2495;8559;3459;11811
240790;201304;822;2711;700;2489;69;290;522;1838;591;2128
240800;201304;37890;113615;35411;109200;10524;34833;15837;49456;26361;84289
240810;201304;91339;282126;86725;273441;29332;96160;39063;125536;68395;221696
240820;201304;6565;20142;5777;18865;910;3342;3521;11794;4431;15136
240830;201304;8938;28208;8574;27658;852;2877;6917;22699;7769;25576
240840;201304;1231;3576;1091;3321;101;378;704;2116;805;2494
240850;201304;1092;3502;854;3002;177;708;431;1442;608;2150
240860;201304;1264;3679;1108;3435;95;358;816;2473;911;2831
240870;201304;1095;3171;977;2952;131;515;675;1912;806;2427
240880;201304;1067;3816;1039;3766;152;663;715;2571;867;3234
240890;201304;5321;15340;4832;14550;782;2692;2939;8752;3721;11444
240895;201304;2694;9419;2497;9067;385;1535;1755;6412;2140;7947
240910;201304;2428;8174;2310;7954;259;1068;1763;6037;2022;7105
240920;201304;832;2747;780;2618;193;741;425;1384;618;2125
240930;201304;3468;9710;3199;9335;317;1012;2524;7404;2841;8416
240933;201304;1315;4263;1214;4090;353;1239;569;2050;922;3289
240940;201304;6352;18568;5530;17169;1146;3832;3115;9648;4261;13480
240950;201304;1105;3586;1050;3492;101;425;772;2574;873;2999
240960;201304;718;2392;663;2272;111;425;463;1567;574;1992
240970;201304;1922;5732;1713;5326;150;617;1219;3739;1369;4356
240980;201304;3308;11072;3102;10671;752;2793;1803;6200;2555;8993
240990;201304;2995;9203;2836;8872;635;2224;1745;5313;2380;7537
241000;201304;1024;3007;914;2815;101;393;663;1989;764;2382
241010;201304;2827;9887;2568;9413;452;1863;1675;6062;2127;7925
241020;201304;2009;5848;1713;5289;178;685;1089;3195;1267;3880
241025;201304;1462;4609;1389;4488;149;636;984;3111;1133;3747
241030;201304;2438;8212;2259;7900;172;655;1836;6470;2008;7125
241040;201304;1981;7118;1850;6865;215;937;1403;5166;1618;6103
241050;201304;1262;3904;1168;3746;123;505;878;2724;1001;3229
241060;201304;986;2891;907;2761;130;418;676;2069;806;2487
241070;201304;911;2705;795;2481;101;396;562;1687;663;2083
241080;201304;1138;3532;1035;3354;88;373;753;2374;841;2747
241090;201304;2006;5946;1801;5613;130;551;1496;4574;1626;5125
241100;201304;1145;3541;1053;3334;107;399;742;2318;849;2717
241105;201304;1052;3289;999;3189;127;458;701;2268;828;2726
241110;201304;836;2750;724;2511;148;566;384;1324;532;1890
241120;201304;8001;24235;7342;23201;1410;4549;5001;16163;6411;20712
241140;201304;3140;9461;2875;8923;377;1390;1947;5863;2324;7253
241142;201304;679;2127;518;1777;165;641;178;578;343;1219
241150;201304;5419;17080;5134;16612;767;2688;3635;11791;4402;14479
241160;201304;1025;3133;993;3083;152;510;709;2212;861;2722
241170;201304;1320;3981;1214;3785;166;595;766;2485;932;3080
241180;201304;988;2724;804;2416;96;363;533;1538;629;1901
241190;201304;1010;2877;933;2750;100;383;633;1764;733;2147
241200;201304;19393;60631;18238;58709;4934;17122;9566;31285;14500;48407
241210;201304;1432;4402;1261;4068;252;910;706;2268;958;3178
241220;201304;7813;27001;7495;26385;1825;6890;4197;15111;6022;22001
241230;201304;2889;9286;2681;8976;259;1020;2128;7115;2387;8135
241240;201304;1115;3273;873;2778;114;376;528;1705;642;2081
241250;201304;5385;17724;4902;16771;423;1874;3984;13388;4407;15262
241255;201304;1846;7203;1779;7061;407;1690;973;4014;1380;5704
241260;201304;4151;12381;3551;11305;554;1861;2278;7300;2832;9161
241270;201304;1964;6098;1785;5768;308;1147;1058;3472;1366;4619
241280;201304;2075;6173;1949;5919;387;1238;1198;3691;1585;4929
241290;201304;3169;9000;2600;8101;485;1650;1538;4762;2023;6412
241300;201304;1262;3921;1206;3838;114;422;958;3052;1072;3474
241310;201304;1468;4856;1427;4780;203;683;1059;3640;1262;4323
241320;201304;821;2816;790;2758;163;611;468;1661;631;2272
241330;201304;1453;4740;1379;4640;159;639;1105;3672;1264;4311
241335;201304;2380;7723;2330;7634;208;679;1969;6501;2177;7180
241340;201304;1891;6051;1744;5756;472;1716;875;2829;1347;4545
241350;201304;1864;6127;1770;5937;189;790;1342;4384;1531;5174
241355;201304;1190;3386;1120;3273;29;127;1035;2974;1064;3101
241360;201304;2021;5783;1864;5471;173;668;1392;3910;1565;4578
241370;201304;1314;4187;1096;3732;184;761;687;2256;871;3017
241380;201304;700;2093;612;1913;89;353;336;1018;425;1371
241390;201304;2744;9567;2620;9322;696;2514;1507;5591;2203;8105
241400;201304;3471;10861;3327;10653;505;1828;2394;7680;2899;9508
241410;201304;2581;7869;2399;7602;443;1560;1635;5113;2078;6673
241415;201304;1523;4886;1415;4658;162;622;998;3237;1160;3859
241420;201304;1903;7030;1753;6793;559;2369;845;3262;1404;5631
241430;201304;408;1261;392;1214;61;227;263;772;324;999
241440;201304;6340;23156;6008;22556;1072;4226;4158;15790;5230;20016
241445;201304;991;3221;950;3159;168;484;701;2475;869;2959
241450;201304;3074;9069;2951;8853;497;1690;2087;6168;2584;7858
241460;201304;3252;9957;2922;9290;291;1118;2126;6661;2417;7779
241470;201304;1318;3856;1174;3676;120;467;916;2803;1036;3270
241475;201304;1179;3949;1092;3799;97;457;807;2754;904;3211
241480;201304;3135;10382;2898;10021;943;3362;1142;4300;2085;7662
241490;201304;603;1693;506;1531;57;237;352;995;409;1232
241500;201304;734;2415;721;2396;21;79;673;2236;694;2315
250010;201304;2575;8490;2315;8053;276;1175;1630;5532;1906;6707
250020;201304;1640;4879;1297;4238;125;534;912;2903;1037;3437
250030;201304;7469;22290;6765;21286;859;2938;5009;16049;5868;18987
250040;201304;4319;15071;4040;14538;793;3039;2611;9469;3404;12508
250050;201304;3504;11449;3253;11093;539;2040;2214;7592;2753;9632
250053;201304;1228;3866;1184;3807;175;641;842;2699;1017;3340
250057;201304;775;2522;755;2495;74;262;609;2045;683;2307
250060;201304;4547;15183;4424;14977;615;2452;3368;11152;3983;13604
250070;201304;4142;13091;3915;12688;489;2009;2989;9338;3478;11347
250073;201304;767;2351;705;2239;87;310;501;1603;588;1913
250077;201304;2191;6563;1859;6017;273;960;1126;3671;1399;4631
250080;201304;4568;13798;4417;13578;630;2023;3267;10141;3897;12164
250090;201304;2558;7915;2496;7825;157;636;2110;6451;2267;7087
250100;201304;3861;13355;3707;13074;441;1757;2850;10017;3291;11774
250110;201304;5587;17620;5357;17290;903;3209;3899;12534;4802;15743
250115;201304;553;1846;484;1687;62;286;291;948;353;1234
250120;201304;2102;6476;1836;5982;236;917;1277;4083;1513;5000
250130;201304;5434;17428;5155;17025;380;1405;4327;14403;4707;15808
250135;201304;1025;3259;946;3121;111;383;690;2333;801;2716
250140;201304;1949;6634;1803;6442;255;897;1351;4978;1606;5875
250150;201304;4941;17142;4639;16581;549;2230;3512;12536;4061;14766
250153;201304;1566;4148;1423;3945;132;450;1136;3127;1268;3577
250157;201304;1568;5616;1433;5315;359;1348;779;2992;1138;4340
250160;201304;3223;10398;3098;10203;221;827;2656;8741;2877;9568
250170;201304;1573;4685;1482;4533;326;1044;911;2833;1237;3877
250180;201304;15628;50989;15271;50300;3051;11229;9924;32034;12975;43263
250190;201304;4206;12661;3984;12289;714;2462;2547;7788;3261;10250
250200;201304;2138;6001;1755;5524;149;535;1500;4674;1649;5209
250205;201304;996;3367;876;3154;94;434;612;2188;706;2622
250210;201304;1611;5396;1491;5224;207;905;1061;3619;1268;4524
250215;201304;1369;4825;1332;4754;217;887;850;3020;1067;3907
250220;201304;792;2315;677;2176;51;177;589;1881;640;2058
250230;201304;1662;4360;1369;3884;162;581;1051;2856;1213;3437
250240;201304;2547;8506;2282;8118;277;1047;1706;6172;1983;7219
250250;201304;4108;13150;3825;12745;522;1814;2883;9774;3405;11588
250260;201304;1881;5921;1681;5589;139;525;1284;4275;1423;4800
250270;201304;1205;3974;1134;3886;165;603;840;2898;1005;3501
250280;201304;3635;11237;3391;10851;682;2282;2175;7225;2857;9507
250290;201304;2106;5638;1751;5171;60;220;1533;4515;1593;4735
250300;201304;5311;16000;5023;15624;659;2604;3874;11620;4533;14224
250310;201304;1115;3686;1025;3538;165;666;734;2508;899;3174
250320;201304;7467;24273;7123;23517;1358;5003;4417;14228;5775;19231
250330;201304;2444;7913;2146;7488;284;1129;1605;5535;1889;6664
250340;201304;1099;3301;1061;3246;78;271;857;2649;935;2920
250350;201304;4484;12509;4142;12076;196;690;3610;10620;3806;11310
250355;201304;2063;6519;1895;6254;142;597;1492;4902;1634;5499
250360;201304;2009;6075;1869;5867;120;453;1462;4607;1582;5060
250370;201304;13205;38133;11689;36275;798;2499;10182;31934;10980;34433
250375;201304;1059;3421;1018;3348;78;319;839;2744;917;3063
250380;201304;1592;4614;1525;4532;96;347;1334;3937;1430;4284
250390;201304;1925;5269;1603;4721;218;721;1082;3175;1300;3896
250400;201304;56575;171585;53967;167542;14985;47859;29276;93859;44261;141718
250403;201304;1291;4797;1267;4762;200;867;952;3533;1152;4400
250407;201304;1046;3209;944;3033;107;354;735;2371;842;2725
250410;201304;651;2139;574;2003;73;317;425;1458;498;1775
250415;201304;1763;5755;1657;5542;110;466;1269;4173;1379;4639
250420;201304;1276;4108;1204;3987;104;431;1004;3253;1108;3684
250430;201304;6417;18321;6095;17854;510;1839;5047;14466;5557;16305
250435;201304;1597;4951;1440;4645;195;744;871;2871;1066;3615
250440;201304;4279;13458;4169;13285;316;1141;3504;11198;3820;12339
250450;201304;2043;5855;1836;5577;78;280;1640;4971;1718;5251
250460;201304;5596;17999;5281;17538;902;3175;3695;12433;4597;15608
250470;201304;1552;4332;1419;4142;130;491;1073;3061;1203;3552
250480;201304;3710;11519;3360;10996;190;762;2893;9404;3083;10166
250485;201304;582;1598;488;1427;27;118;382;1061;409;1179
250490;201304;4029;13517;3932;13363;595;2253;2946;9985;3541;12238
250500;201304;1855;5809;1722;5592;377;1273;1004;3301;1381;4574
250510;201304;4889;14054;4331;13279;369;1380;3551;10777;3920;12157
250520;201304;1814;5812;1735;5676;377;1445;1070;3407;1447;4852
250523;201304;1760;5726;1680;5621;209;754;1322;4469;1531;5223
250527;201304;1394;4434;1307;4309;65;302;1155;3745;1220;4047
250530;201304;670;2103;595;2005;54;214;481;1613;535;1827
250535;201304;1215;4085;1187;4025;102;424;948;3158;1050;3582
250540;201304;2417;7285;2278;7126;100;342;2073;6509;2173;6851
250550;201304;898;3047;832;2942;82;363;620;2141;702;2504
250560;201304;1675;5602;1655;5571;148;568;1394;4691;1542;5259
250570;201304;2481;8403;2285;8028;237;974;1732;6003;1969;6977
250580;201304;1044;3125;902;2886;130;518;609;1864;739;2382
250590;201304;1025;3196;925;3060;83;359;734;2374;817;2733
250600;201304;7445;23046;7081;22472;1199;3868;4990;16241;6189;20109
250610;201304;3229;10130;3068;9880;409;1422;2241;7262;2650;8684
250620;201304;862;2549;799;2425;139;459;534;1613;673;2072
250625;201304;2009;6894;1974;6843;90;294;1802;6310;1892;6604
250630;201304;9763;32558;9307;31703;2175;8149;5298;17895;7473;26044
250640;201304;3835;11432;3590;11140;262;1028;3099;9481;3361;10509
250650;201304;886;2697;838;2600;171;625;439;1409;610;2034
250660;201304;2158;5241;1655;4634;26;71;1583;4434;1609;4505
250670;201304;2502;8912;2396;8714;299;1271;1700;6184;1999;7455
250680;201304;4758;14164;4503;13787;318;1186;3773;11468;4091;12654
250690;201304;5922;16952;5743;16697;646;2185;4703;13422;5349;15607
250700;201304;5116;16068;4867;15677;641;2372;3616;11491;4257;13863
250710;201304;4377;14426;4085;14051;615;2259;2925;10248;3540;12507
250720;201304;2492;8213;2382;8015;244;941;1839;6210;2083;7151
250730;201304;3491;11357;3351;11130;472;1768;2489;8248;2961;10016
250740;201304;2010;6142;1779;5720;296;1046;1167;3698;1463;4744
250750;201304;97531;300157;93397;293654;18880;65336;60945;189618;79825;254954
250760;201304;2075;6537;1940;6305;298;1143;1295;4153;1593;5296
250770;201304;3671;13007;3512;12777;787;2987;2147;7963;2934;10950
250780;201304;1874;5745;1669;5363;177;717;1174;3672;1351;4389
250790;201304;2417;8037;2293;7851;600;2063;1419;4960;2019;7023
250800;201304;2640;7937;2356;7444;176;665;1775;5483;1951;6148
250810;201304;1317;4021;1158;3789;116;490;945;3019;1061;3509
250820;201304;1921;6232;1870;6151;114;433;1558;5203;1672;5636
250830;201304;5667;19549;5449;19120;872;3575;3751;12961;4623;16536
250840;201304;1029;3361;932;3162;142;551;588;1996;730;2547
250850;201304;2307;6927;2029;6467;248;961;1317;4351;1565;5312
250855;201304;979;2991;926;2902;64;221;780;2440;844;2661
250860;201304;2799;9730;2632;9406;671;2653;1183;4246;1854;6899
250870;201304;1167;3448;1021;3203;95;374;734;2231;829;2605
250880;201304;1260;3866;1241;3836;116;399;1013;3097;1129;3496
250890;201304;8808;29797;8284;29094;1682;6628;5443;19006;7125;25634
250900;201304;3001;10267;2701;9689;329;1260;1913;6970;2242;8230
250905;201304;2067;6526;1984;6413;313;1096;1482;4786;1795;5882
250910;201304;5068;15533;4762;15056;703;2283;3463;11093;4166;13376
250915;201304;1696;5148;1563;4951;131;423;1317;4214;1448;4637
250920;201304;3401;10053;3217;9800;406;1319;2411;7478;2817;8797
250930;201304;1858;6217;1792;6103;381;1495;1176;3912;1557;5407
250933;201304;1111;3885;1074;3821;196;739;706;2584;902;3323
250937;201304;853;2732;775;2570;127;504;467;1547;594;2051
250939;201304;1677;5441;1539;5214;301;1081;1026;3491;1327;4572
250940;201304;3869;11754;3607;11355;293;1069;2914;9185;3207;10254
250950;201304;1274;4110;1196;4015;87;302;1000;3406;1087;3708
250960;201304;1334;4262;1187;4069;78;312;1011;3485;1089;3797
250970;201304;8406;23860;7714;22977;972;2934;5879;17788;6851;20722
250980;201304;2589;8111;2418;7835;325;1305;1680;5255;2005;6560
250990;201304;2055;7460;1958;7263;325;1373;1350;4958;1675;6331
251000;201304;2496;7258;2069;6653;139;541;1655;5293;1794;5834
251010;201304;2768;8181;2542;7873;192;700;2074;6443;2266;7143
251020;201304;1641;5289;1542;5172;173;638;1253;4236;1426;4874
251030;201304;1290;3713;1176;3520;136;480;758;2267;894;2747
251040;201304;1923;6300;1745;6025;208;958;1264;4208;1472;5166
251050;201304;1111;3384;978;3139;184;652;545;1820;729;2472
251060;201304;973;2531;807;2323;111;405;587;1604;698;2009
251065;201304;568;1737;500;1632;74;284;305;953;379;1237
251070;201304;561;1678;535;1637;44;184;424;1231;468;1415
251080;201304;20859;59167;19831;57520;5205;16013;11423;33504;16628;49517
251090;201304;2972;9585;2705;9107;333;1294;1929;6413;2262;7707
251100;201304;951;3204;844;3004;128;520;542;1878;670;2398
251110;201304;2072;6123;1918;5905;236;816;1403;4332;1639;5148
251120;201304;5855;20085;5705;19826;825;3406;4430;15047;5255;18453
251130;201304;3799;10071;3460;9680;69;252;3304;9183;3373;9435
251140;201304;4287;13498;4032;13104;288;1157;3180;10293;3468;11450
251150;201304;2824;9303;2613;9017;322;1293;1979;6887;2301;8180
251160;201304;1840;6153;1771;6061;102;397;1548;5311;1650;5708
251170;201304;1412;4543;1382;4511;98;351;1218;3981;1316;4332
251180;201304;2882;8822;2660;8544;599;2027;1649;5426;2248;7453
251190;201304;4108;12403;3993;12252;306;1046;3469;10656;3775;11702
251200;201304;4122;12787;3931;12530;282;1009;3356;10716;3638;11725
251203;201304;1301;4231;1183;3983;128;538;714;2498;842;3036
251207;201304;1209;3892;1054;3584;100;417;749;2504;849;2921
251210;201304;7430;22662;6898;22018;911;2906;5440;17689;6351;20595
251220;201304;1247;3503;1126;3316;179;578;704;2130;883;2708
251230;201304;5052;15761;4484;15081;478;1799;3736;12508;4214;14307
251240;201304;3008;10173;2936;10054;327;1387;2293;7690;2620;9077
251250;201304;9874;30851;9320;29953;1726;6034;6385;20369;8111;26403
251260;201304;527;1668;480;1604;42;158;363;1218;405;1376
251270;201304;3982;12552;3764;12267;188;732;3410;11084;3598;11816
251272;201304;1319;4165;1233;4039;120;430;961;3195;1081;3625
251274;201304;933;3078;893;2997;128;544;491;1684;619;2228
251275;201304;1345;3920;1274;3805;161;600;951;2759;1112;3359
251276;201304;1434;4382;1363;4240;255;849;781;2535;1036;3384
251278;201304;579;1910;511;1749;88;347;281;1008;369;1355
251280;201304;2240;7306;2170;7181;317;1169;1564;5186;1881;6355
251290;201304;5865;17241;5577;16867;859;3118;4003;11712;4862;14830
251300;201304;771;2678;724;2604;72;340;512;1782;584;2122
251310;201304;3121;9441;2880;9083;242;904;2317;7228;2559;8132
251315;201304;1557;5843;1523;5769;327;1307;958;3704;1285;5011
251320;201304;2073;5972;1774;5494;151;571;1306;4068;1457;4639
251330;201304;2009;5324;1679;4894;147;621;1369;3787;1516;4408
251335;201304;939;3316;920;3281;103;432;742;2608;845;3040
251340;201304;3921;11128;3365;10301;396;1508;2378;7119;2774;8627
251350;201304;1616;5078;1466;4857;271;993;941;3139;1212;4132
251360;201304;1815;6026;1756;5948;127;499;1483;5040;1610;5539
251365;201304;905;2695;736;2334;80;326;482;1477;562;1803
251370;201304;20458;73016;20200;72512;4354;17099;13577;48224;17931;65323
251380;201304;1249;4044;1150;3881;149;598;831;2735;980;3333
251385;201304;847;2448;786;2344;89;326;550;1596;639;1922
251390;201304;5577;20249;5327;19877;1037;4230;3610;13365;4647;17595
251392;201304;997;3050;928;2929;138;480;621;1984;759;2464
251394;201304;611;1925;524;1756;49;208;368;1221;417;1429
251396;201304;865;2521;814;2442;61;203;661;1970;722;2173
251398;201304;1118;3296;937;2958;108;413;640;1993;748;2406
251400;201304;1340;3957;1253;3844;175;685;897;2671;1072;3356
251410;201304;1566;4264;1436;4052;194;602;958;2786;1152;3388
251420;201304;2213;6583;1920;6255;178;700;1563;5034;1741;5734
251430;201304;1659;6076;1515;5850;134;604;1227;4722;1361;5326
251440;201304;1447;4516;1265;4186;180;688;896;2928;1076;3616
251445;201304;1479;4821;1415;4723;145;582;1149;3771;1294;4353
251450;201304;4743;15127;4295;14569;163;640;3918;13340;4081;13980
251455;201304;1193;3759;1036;3505;97;430;776;2579;873;3009
251460;201304;866;2719;845;2677;161;531;618;1983;779;2514
251465;201304;508;1626;467;1545;54;221;313;1010;367;1231
251470;201304;1193;3584;1006;3245;158;603;615;1971;773;2574
251480;201304;1096;3078;1001;2921;69;263;799;2288;868;2551
251490;201304;2049;6209;1810;5898;350;1310;1138;3636;1488;4946
251500;201304;1595;5681;1548;5602;238;1007;1138;4048;1376;5055
251510;201304;2428;8496;2328;8275;522;2015;1405;5040;1927;7055
251520;201304;1075;3023;992;2893;136;417;623;1847;759;2264
251530;201304;10654;33688;10415;33326;1067;4063;8517;26789;9584;30852
251540;201304;2731;9294;2581;8961;315;1331;1860;6404;2175;7735
251550;201304;3913;10040;3357;9334;220;795;2800;7619;3020;8414
251560;201304;910;2788;835;2677;176;681;469;1415;645;2096
251570;201304;1020;3145;934;2997;135;514;601;1982;736;2496
251580;201304;2164;6068;2020;5878;182;520;1685;4949;1867;5469
251590;201304;1681;5662;1649;5625;115;426;1444;4968;1559;5394
251593;201304;965;3165;921;3090;134;516;616;2015;750;2531
251597;201304;1946;6108;1884;6012;242;917;1453;4543;1695;5460
251600;201304;6933;21575;6642;21096;1120;3628;4603;15115;5723;18743
251610;201304;3507;10804;3234;10441;401;1398;2410;7856;2811;9254
251615;201304;1198;3575;1059;3329;88;260;786;2610;874;2870
251620;201304;16269;48582;14889;46717;2418;8038;10635;33683;13053;41721
251630;201304;5259;13613;4633;12859;409;1254;3699;10333;4108;11587
251640;201304;2639;7848;2165;6988;285;1080;1453;4641;1738;5721
251650;201304;4287;12436;3874;11906;357;1271;3125;9693;3482;10964
251660;201304;3507;11933;3231;11503;276;1305;2604;9048;2880;10353
251670;201304;3636;11082;3293;10552;276;1017;2619;8348;2895;9365
251675;201304;737;2548;708;2498;134;556;454;1558;588;2114
251680;201304;2811;7962;2298;7190;153;650;1871;5729;2024;6379
251690;201304;3246;10728;3050;10374;476;1733;2028;6966;2504;8699
251700;201304;2050;7031;1967;6914;248;952;1532;5379;1780;6331
251710;201304;863;2420;684;2083;97;374;395;1119;492;1493
251720;201304;1321;4204;1249;4095;131;523;951;3092;1082;3615
251740;201304;727;2081;591;1834;109;381;331;1037;440;1418
260005;201304;23824;60091;21448;57014;4413;12035;13816;37133;18229;49168
260010;201304;9178;25773;7604;23834;691;2456;6143;19180;6834;21636
260020;201304;5583;17221;5050;16407;666;2012;3681;12610;4347;14622
260030;201304;5403;16670;5054;16204;572;1960;3982;12804;4554;14764
260040;201304;9108;23398;8350;22562;515;1133;7381;20508;7896;21641
260050;201304;10400;34680;9865;34067;675;2526;8638;30046;9313;32572
260060;201304;4003;11337;3762;10985;327;1019;3075;9092;3402;10111
260070;201304;8913;28148;8607;27710;2325;8016;5053;16375;7378;24391
260080;201304;5093;15463;4598;14702;554;2127;3243;10217;3797;12344
260090;201304;5083;13966;4841;13648;744;1923;3751;10943;4495;12866
260100;201304;3392;9262;3137;8924;277;1021;2480;7056;2757;8077
260105;201304;4100;12984;3998;12809;750;2576;2752;8810;3502;11386
260110;201304;20601;63795;19322;62237;1643;5271;16385;53453;18028;58724
260120;201304;10920;34797;10664;34338;3044;10042;5633;18827;8677;28869
260130;201304;2991;8820;2867;8612;390;1166;2133;6531;2523;7697
260140;201304;11375;32971;10515;31800;1369;4627;7964;24214;9333;28841
260150;201304;2802;8969;2550;8573;184;734;2036;6936;2220;7670
260160;201304;5862;17995;5377;17435;511;1735;4427;14671;4938;16406
260170;201304;16758;47939;16136;47096;1460;4049;13364;39707;14824;43756
260180;201304;3294;10642;3056;10263;221;897;2556;8538;2777;9435
260190;201304;15239;38037;14571;37175;1250;3425;12155;31010;13405;34435
260200;201304;10512;32451;9351;30685;1245;4298;6625;22376;7870;26674
260210;201304;11126;35399;10401;34362;837;3118;8578;28638;9415;31756
260220;201304;8904;28821;8726;28560;751;3074;7450;23978;8201;27052
260230;201304;9450;28635;9130;28198;717;2350;7603;23811;8320;26161
260240;201304;2780;9112;2523;8711;384;1427;1709;5927;2093;7354
260250;201304;2718;7493;2513;7237;186;505;2122;6218;2308;6723
260260;201304;11081;33399;10909;33179;945;3104;9126;28387;10071;31491
260270;201304;3488;11119;3315;10868;438;1722;2556;8236;2994;9958
260280;201304;11987;41886;11166;40580;885;3623;9177;33677;10062;37300
260290;201304;32739;101401;31861;100007;5890;21073;22022;67631;27912;88704
260300;201304;8182;25721;7408;24637;800;2946;5699;19163;6499;22109
260310;201304;5048;15596;4762;15140;1414;4247;2480;8469;3894;12716
260320;201304;6416;22710;6044;22178;554;2149;4871;18156;5425;20305
260330;201304;3057;9803;2813;9377;321;1241;1877;6528;2198;7769
260340;201304;1804;5569;1732;5477;109;402;1525;4794;1634;5196
260345;201304;24852;84522;24057;82951;7755;28965;11173;37521;18928;66486
260350;201304;4158;12746;4006;12513;626;2148;2764;8685;3390;10833
260360;201304;2257;7362;2199;7267;581;2032;1263;4304;1844;6336
260370;201304;5931;18805;5518;18081;858;2849;3857;12979;4715;15828
260380;201304;4768;16214;4491;15854;414;1299;3788;13706;4202;15005
260390;201304;4708;15118;4135;14234;507;1981;3053;10394;3560;12375
260392;201304;2846;10285;2734;10118;194;753;2364;8839;2558;9592
260400;201304;12985;39866;12615;39291;2354;8267;8823;26950;11177;35217
260410;201304;59882;181468;57510;177582;17881;55404;29646;95180;47527;150584
260415;201304;3912;13240;3537;12550;567;2341;2265;8038;2832;10379
260420;201304;10930;27121;10074;26204;965;2812;8098;21084;9063;23896
260430;201304;2652;9051;2459;8752;272;1169;1914;6694;2186;7863
260440;201304;3340;10576;3149;10209;541;2001;1970;6295;2511;8296
260450;201304;4729;15294;4503;14899;557;2004;3374;11260;3931;13264
260460;201304;5756;18337;5527;18005;855;3169;3968;12737;4823;15906
260470;201304;4822;14582;4567;14230;414;1445;3666;11595;4080;13040
260480;201304;3690;11124;3431;10748;660;2226;2349;7301;3009;9527
260490;201304;6003;16012;5325;14944;763;2528;3502;9833;4265;12361
260500;201304;6554;18537;6170;17998;645;2036;4746;14107;5391;16143
260510;201304;9636;27599;8921;26596;1088;3489;6553;20308;7641;23797
260515;201304;4705;15168;3936;13612;584;2212;2354;8354;2938;10566
260520;201304;14733;41655;14506;41350;2246;6076;11253;32674;13499;38750
260530;201304;10039;30289;8960;28866;539;1666;7817;25657;8356;27323
260540;201304;5553;14947;5347;14714;667;1618;4260;12114;4927;13732
260545;201304;40;156;28;115;4;19;6;23;10;42
260550;201304;2704;9388;2472;8989;722;2898;1181;4258;1903;7156
260560;201304;6510;17246;5947;16462;360;980;5221;14527;5581;15507
260570;201304;5776;21596;5530;21137;1107;4572;3673;14190;4780;18762
260580;201304;3851;10840;3685;10591;326;1082;3066;8646;3392;9728
260590;201304;5880;15774;5726;15579;476;1225;4890;13602;5366;14827
260600;201304;23433;76803;22506;75172;5538;19212;12848;44154;18386;63366
260610;201304;6895;20878;6615;20508;1293;4214;4643;14529;5936;18743
260620;201304;16704;53506;16196;52665;2940;10992;11107;35143;14047;46135
260630;201304;2243;6946;1974;6520;253;1007;1445;4722;1698;5729
260640;201304;16726;47235;16099;46319;1909;5816;12576;36298;14485;42114
260650;201304;5557;18099;5377;17807;876;2919;3519;12495;4395;15414
260660;201304;7625;23201;6946;22288;672;2284;5563;18134;6235;20418
260670;201304;2319;6869;2005;6445;307;1112;1335;4317;1642;5429
260680;201304;22616;61963;21636;60459;4622;13739;13358;37199;17980;50938
260690;201304;3386;9756;2986;9128;331;1192;2255;6820;2586;8012
260700;201304;4855;15549;4805;15496;111;261;4598;15051;4709;15312
260710;201304;1289;4085;1168;3905;154;620;861;2814;1015;3434
260720;201304;17222;57320;16416;55821;4777;16773;8702;30252;13479;47025
260730;201304;7258;24502;6588;23531;905;3374;4920;17847;5825;21221
260740;201304;1327;4123;1169;3836;202;750;706;2332;908;3082
260750;201304;6455;22044;6328;21836;552;1901;5299;18615;5851;20516
260760;201304;4398;12926;4174;12617;566;1838;3072;9292;3638;11130
260765;201304;7435;28339;7220;28006;1745;7150;4392;17466;6137;24616
260770;201304;4173;11187;3840;10741;255;932;3089;8454;3344;9386
260775;201304;5253;15727;5044;15403;566;2045;3833;11491;4399;13536
260780;201304;3824;13203;3709;13004;812;3169;2308;8028;3120;11197
260790;201304;115320;304771;111580;299437;26884;75822;67989;183161;94873;258983
260795;201304;2924;9854;2786;9640;448;1681;1951;6855;2399;8536
260800;201304;4480;12770;4211;12397;275;1087;3572;10261;3847;11348
260805;201304;3933;11998;3620;11506;603;1984;2468;7962;3071;9946
260810;201304;7325;21907;7142;21648;522;1916;6170;18500;6692;20416
260820;201304;4486;13643;4317;13395;1218;3878;2490;7825;3708;11703
260825;201304;2958;9775;2822;9576;276;924;2334;8040;2610;8964
260830;201304;3571;11963;3361;11600;888;2904;1965;7168;2853;10072
260840;201304;4021;12186;3794;11849;241;917;3320;10328;3561;11245
260845;201304;4016;12320;3751;11783;613;2096;2576;8087;3189;10183
260850;201304;4765;17211;4403;16423;1211;4939;2140;8000;3351;12939
260860;201304;2871;9846;2701;9574;350;1251;2011;7294;2361;8545
260870;201304;4099;11792;3799;11423;515;1413;2895;9002;3410;10415
260875;201304;7131;19250;6624;18485;750;2133;4838;13912;5588;16045
260880;201304;8100;26832;7752;26310;1092;3731;5908;20361;7000;24092
260890;201304;14547;42614;14027;41856;1661;5638;10578;31559;12239;37197
260900;201304;5911;18742;5185;17554;1085;3816;3101;10758;4186;14574
260910;201304;2828;9060;2610;8749;287;1083;2048;6840;2335;7923
260915;201304;4343;14809;4244;14670;114;348;3957;13911;4071;14259
260920;201304;3272;10556;3137;10353;605;2183;2091;7014;2696;9197
260930;201304;3988;13097;3619;12564;527;1921;2601;9113;3128;11034
260940;201304;13290;39675;12285;37879;2553;9240;6727;20246;9280;29486
260950;201304;6103;20397;5899;20005;1082;4538;3905;12469;4987;17007
260960;201304;65364;186396;62360;181738;13492;42016;37693;110788;51185;152804
260970;201304;5212;17566;4890;17041;653;2642;3562;12343;4215;14985
260980;201304;3901;12661;3755;12460;266;978;3138;10598;3404;11576
260990;201304;16476;54948;15339;53335;1923;6308;11490;42028;13413;48336
261000;201304;13496;41697;12203;39544;2953;10361;6801;22230;9754;32591
261010;201304;2676;7735;2529;7529;251;598;2101;6556;2352;7154
261020;201304;5964;18649;5664;18177;387;1647;4747;14853;5134;16500
261030;201304;3079;10900;2995;10769;340;1360;2370;8476;2710;9836
261040;201304;5097;17189;4460;16186;664;2694;3105;11256;3769;13950
261050;201304;8368;24157;7946;23545;656;2051;6537;19388;7193;21439
261060;201304;10302;33675;10054;33278;2071;7457;6748;22027;8819;29484
261070;201304;45643;123295;42132;118502;10211;30321;24267;69185;34478;99506
261080;201304;5502;17557;5262;17168;442;1403;4385;14584;4827;15987
261090;201304;15449;45061;14650;43986;1392;4478;12032;36307;13424;40785
261100;201304;7050;23355;6696;22836;530;2218;5542;18782;6072;21000
261110;201304;63325;186000;58703;179576;14004;43492;34501;111547;48505;155039
261120;201304;3189;9387;3057;9206;96;307;2814;8523;2910;8830
261130;201304;6660;17969;6432;17726;273;781;5894;16236;6167;17017
261140;201304;3099;9010;2954;8806;621;2049;1893;5577;2514;7626
261150;201304;5364;16903;4891;16260;496;1879;3860;12907;4356;14786
261153;201304;1925;5658;1662;5299;108;413;1410;4532;1518;4945
261160;201304;220036;586412;211814;575668;42269;116912;138286;386595;180555;503507
261170;201304;5726;16619;5394;16128;692;2194;4231;12682;4923;14876
261180;201304;8847;27240;8723;27084;1076;3275;7112;22536;8188;25811
261190;201304;5284;17165;5080;16885;822;3586;3650;11516;4472;15102
261200;201304;3775;10121;3637;9941;491;1312;2767;7723;3258;9035
261210;201304;1825;5201;1753;5100;142;398;1495;4438;1637;4836
261220;201304;11945;40561;10820;38079;2279;8681;5914;20759;8193;29440
261230;201304;4187;12913;3932;12617;185;600;3543;11491;3728;12091
261240;201304;4759;14355;4535;13935;816;2465;3163;9924;3979;12389
261245;201304;3783;12429;3324;11659;322;1350;2449;8722;2771;10072
261247;201304;3393;10969;3035;10297;482;1698;2021;6975;2503;8673
261250;201304;18520;51053;18096;50485;1929;5666;15203;42375;17132;48041
261255;201304;4233;13468;3846;12840;418;1574;2856;9679;3274;11253
261260;201304;11536;34781;10740;33860;639;1920;9525;30475;10164;32395
261270;201304;3622;10725;3412;10390;508;1647;2383;7298;2891;8945
261280;201304;2663;8500;2433;8151;286;1101;1790;5954;2076;7055
261290;201304;2838;8400;2582;8073;174;600;2198;6963;2372;7563
261300;201304;9813;34639;9080;33329;1500;5994;6346;23504;7846;29498
261310;201304;8148;25432;7853;24932;1712;5663;4978;15940;6690;21603
261320;201304;5666;18160;5416;17699;778;2525;3879;13036;4657;15561
261330;201304;5505;16717;5406;16589;396;1368;4624;14218;5020;15586
261340;201304;4498;14982;4306;14678;756;2943;2811;9598;3567;12541
261350;201304;7728;26956;7374;26324;717;3079;5787;20451;6504;23530
261360;201304;9112;24389;8452;23465;1286;3797;5803;16396;7089;20193
261370;201304;20094;61615;19253;60414;2815;9540;14312;45102;17127;54642
261380;201304;4069;14346;3831;13963;645;2381;2631;9890;3276;12271
261390;201304;16401;52316;15221;50259;2796;10218;9501;31146;12297;41364
261400;201304;4765;17079;4397;16366;676;2801;2986;11200;3662;14001
261410;201304;7859;24599;7610;24208;803;2612;6016;19581;6819;22193
261420;201304;7465;25835;7279;25557;1890;7258;4252;15154;6142;22412
261430;201304;3473;11001;2972;10340;432;1546;2134;7607;2566;9153
261440;201304;1621;5012;1539;4891;128;506;1246;3923;1374;4429
261450;201304;13560;41435;13322;41125;1163;3784;11565;35763;12728;39547
261460;201304;8265;24148;7755;23434;833;2419;5692;18545;6525;20964
261470;201304;3797;10588;3489;10219;275;930;2940;8562;3215;9492
261480;201304;3219;12241;3057;11952;360;1627;2387;9173;2747;10800
261485;201304;4740;15294;4532;14938;1026;3614;2661;8881;3687;12495
261500;201304;5606;16067;5116;15407;786;2189;3839;12078;4625;14267
261510;201304;2014;6835;1947;6746;110;322;1726;6115;1836;6437
261520;201304;2500;8413;2293;8106;237;958;1701;6016;1938;6974
261530;201304;12252;40535;11043;38185;2553;9817;5496;18850;8049;28667
261540;201304;6967;22795;6832;22574;2049;6295;4206;14715;6255;21010
261550;201304;3208;10373;3109;10218;537;2205;2277;7120;2814;9325
261560;201304;6102;20887;5752;20454;1174;3753;4166;15602;5340;19355
261570;201304;3548;11418;3307;11028;482;1662;2360;8028;2842;9690
261580;201304;5594;18651;5070;17779;452;1787;4037;14419;4489;16206
261590;201304;2728;7882;2415;7437;246;836;1786;5576;2032;6412
261600;201304;4930;14362;4263;13376;555;1851;3090;9830;3645;11681
261610;201304;2153;6882;1961;6609;130;573;1661;5471;1791;6044
261618;201304;2466;7290;2353;7128;256;923;1840;5453;2096;6376
261620;201304;4415;13854;4214;13541;492;1725;3055;9993;3547;11718
261630;201304;7918;23992;7209;22778;1539;5587;4110;12704;5649;18291
261640;201304;32277;85544;30372;83392;1816;5177;26498;73912;28314;79089
261650;201304;3528;12149;3440;12019;446;1770;2734;9546;3180;11316
270010;201304;4416;17196;4086;16496;512;2426;2925;11774;3437;14200
270020;201304;3783;11955;3571;11601;552;2101;2572;8170;3124;10271
270030;201304;42197;131941;40767;129835;11230;36564;23774;77856;35004;114420
270040;201304;10286;32451;10035;32180;1063;2853;8509;28161;9572;31014
270050;201304;3726;11273;3528;11012;402;1566;2674;8154;3076;9720
270060;201304;1468;5193;1416;5116;363;1448;840;3028;1203;4476
270070;201304;3942;12592;3744;12305;133;600;3375;10998;3508;11598
270080;201304;1255;4108;1144;3958;279;1071;677;2320;956;3391
270090;201304;1976;6437;1935;6385;61;228;1816;5999;1877;6227
270100;201304;6282;20287;6065;20002;1192;4293;4282;14030;5474;18323
270110;201304;3345;9800;3106;9507;633;2020;1939;6362;2572;8382
270120;201304;2987;8900;2712;8508;170;639;2289;7193;2459;7832
270130;201304;4919;15720;4703;15467;630;2093;3631;12205;4261;14298
270135;201304;1680;5024;1606;4936;76;190;1469;4602;1545;4792
270140;201304;8645;24215;7932;23285;1052;4239;6066;16799;7118;21038
270150;201304;2483;8915;2420;8826;287;1202;1957;7064;2244;8266
270160;201304;4669;16724;4403;16354;333;1167;3787;14289;4120;15456
270170;201304;3941;13433;3646;12974;805;3293;2091;7366;2896;10659
270180;201304;2120;7469;1921;7219;219;947;1509;5686;1728;6633
270190;201304;1807;6199;1731;6068;211;780;1309;4664;1520;5444
270200;201304;2580;8995;2492;8854;240;1110;2028;7018;2268;8128
270210;201304;3869;14009;3781;13888;533;2139;2967;10958;3500;13097
270220;201304;1663;5355;1576;5181;310;1186;867;2910;1177;4096
270230;201304;10794;36496;9694;34810;1468;6010;6945;24847;8413;30857
270235;201304;6366;21436;6090;20977;366;1658;5234;17899;5600;19557
270240;201304;9557;29287;8665;28068;1607;5492;5714;18618;7321;24110
270250;201304;3358;9047;3124;8792;158;467;2840;7995;2998;8462
270255;201304;5034;15870;4254;14514;472;2014;3025;10180;3497;12194
270260;201304;5984;19937;5831;19656;953;3720;4075;13784;5028;17504
270270;201304;1213;3622;1148;3524;190;637;831;2528;1021;3165
270280;201304;3618;11202;3461;10972;566;2064;2493;7845;3059;9909
270290;201304;8192;29723;7881;29180;756;3099;6376;23680;7132;26779
270300;201304;3179;11197;3041;11028;187;854;2706;9756;2893;10610
270310;201304;6862;22269;6353;21417;468;2107;5099;16792;5567;18899
270320;201304;6068;20685;5888;20351;1690;6471;2829;9985;4519;16456
270330;201304;4593;15723;4385;15439;390;1457;3647;12998;4037;14455
270340;201304;1722;5525;1588;5366;236;835;1169;4035;1405;4870
270350;201304;2065;6014;1931;5839;335;1080;1245;3994;1580;5074
270360;201304;1947;6285;1928;6263;152;522;1698;5561;1850;6083
270370;201304;1688;5679;1557;5441;196;788;1086;3880;1282;4668
270375;201304;2895;9295;2771;9101;523;2103;1841;5749;2364;7852
270380;201304;5959;18511;5749;18236;620;2069;4485;14526;5105;16595
270390;201304;1364;3967;1274;3852;177;628;906;2662;1083;3290
270400;201304;5950;18886;5583;18369;510;1979;4413;14443;4923;16422
270410;201304;4716;15150;4549;14830;630;2293;3410;11089;4040;13382
270420;201304;5068;17295;4945;17116;307;1394;4317;14772;4624;16166
270430;201304;137298;405987;132820;399782;35169;108260;78471;242257;113640;350517
270440;201304;4801;15368;4564;14994;397;1488;3702;12211;4099;13699
270450;201304;6165;20218;6042;20058;725;2764;4748;15786;5473;18550
270460;201304;3329;9696;3028;9267;264;1069;2409;7176;2673;8245
270470;201304;10481;34780;10110;34115;1314;4216;7650;26846;8964;31062
270480;201304;3039;10019;2873;9739;373;1548;2025;6669;2398;8217
270490;201304;964;3189;920;3125;118;460;712;2385;830;2845
270500;201304;5400;19368;5252;19158;441;1592;4433;16590;4874;18182
270510;201304;5818;18775;5383;18164;1043;4462;3794;12128;4837;16590
270520;201304;3643;12360;3459;12040;971;3608;1842;6533;2813;10141
270530;201304;1526;4629;1358;4408;243;755;905;3090;1148;3845
270540;201304;1929;6976;1786;6747;215;1000;1384;5138;1599;6138
270550;201304;6828;21829;6143;20885;1104;3902;4066;14283;5170;18185
270560;201304;2846;9489;2773;9393;492;1925;1986;6607;2478;8532
270570;201304;4172;14006;3866;13516;521;2206;2634;9127;3155;11333
270580;201304;1943;6828;1882;6722;322;1194;1371;4964;1693;6158
270590;201304;1265;4614;1195;4485;116;554;960;3564;1076;4118
270600;201304;2779;9583;2567;9284;226;1120;2043;7180;2269;8300
270610;201304;3142;10219;2977;9970;361;1293;2301;7685;2662;8978
270620;201304;1407;4909;1282;4722;166;787;958;3425;1124;4212
270630;201304;17645;50362;17017;49532;2110;5950;13641;40416;15751;46366
270640;201304;5661;18094;5210;17575;410;1722;4394;14631;4804;16353
270642;201304;2426;8489;2291;8280;398;1603;1529;5564;1927;7167
270644;201304;2235;6968;2116;6836;387;1163;1597;5344;1984;6507
270650;201304;3826;12789;3714;12629;950;3672;2174;7332;3124;11004
270660;201304;2486;6714;2033;6005;220;780;1435;4186;1655;4966
270670;201304;13339;40316;12296;38883;1587;5716;9275;29265;10862;34981
270680;201304;4028;12595;3927;12474;250;739;3511;11275;3761;12014
270690;201304;8026;24219;7729;23849;2392;6966;4246;14248;6638;21214
270700;201304;789;2573;755;2516;151;589;469;1543;620;2132
270710;201304;5292;18483;5122;18258;510;1798;4269;15488;4779;17286
270720;201304;3182;11348;2991;11015;299;1372;2381;8668;2680;10040
270730;201304;6276;20398;5975;19998;1266;4574;4005;13320;5271;17894
270740;201304;2340;7123;2215;6933;388;1392;1455;4505;1843;5897
270750;201304;4713;15652;4467;15297;551;2132;3383;11542;3934;13674
270760;201304;3204;10123;3030;9876;389;1355;2311;7555;2700;8910
270770;201304;16784;46799;14675;44236;2836;9285;9587;29226;12423;38511
270780;201304;1893;6125;1775;5939;153;537;1438;4871;1591;5408
270790;201304;1550;5016;1430;4815;381;1366;706;2436;1087;3802
270800;201304;10724;33475;10203;32780;1008;3659;8256;26456;9264;30115
270810;201304;3186;10283;2735;9468;413;1624;1725;6014;2138;7638
270820;201304;1866;6510;1735;6276;246;1079;1243;4417;1489;5496
270830;201304;4932;16682;4615;16246;1476;5858;2444;8475;3920;14333
270840;201304;7016;25492;6501;24824;541;2475;5360;20428;5901;22903
270850;201304;7334;25113;7212;24955;1554;6565;5062;16656;6616;23221
270860;201304;10786;34308;10237;33488;1889;7093;7067;22625;8956;29718
270870;201304;2174;6464;1861;5881;281;993;1156;3660;1437;4653
270880;201304;7904;26395;7566;25900;659;2684;6307;21406;6966;24090
270890;201304;2525;8007;2379;7778;398;1550;1635;5191;2033;6741
270895;201304;2942;11221;2808;11042;279;1064;2349;9444;2628;10508
270900;201304;1855;5267;1567;4857;125;470;1201;3637;1326;4107
270910;201304;3212;11771;3174;11699;348;1545;2634;9517;2982;11062
270915;201304;9607;33843;8924;32591;2155;8765;4694;17160;6849;25925
270920;201304;5689;19574;5350;19072;452;1994;4407;15630;4859;17624
270930;201304;16390;46264;13801;42947;2973;9945;7935;25087;10908;35032
270940;201304;5709;19927;5561;19752;846;3069;4255;15397;5101;18466
280010;201304;705;2117;630;2001;73;295;411;1276;484;1571
280020;201304;4702;14869;4325;14191;861;3000;2727;8990;3588;11990
280030;201304;66693;183957;61132;175827;15741;47741;32841;96118;48582;143859
280040;201304;3009;9887;2771;9577;362;1289;2080;7422;2442;8711
280050;201304;4002;13157;3769;12823;1087;3743;2144;7595;3231;11338
280060;201304;4098;14131;3980;13941;978;3743;2358;8284;3336;12027
280067;201304;7217;21362;6217;19986;635;2380;4790;15314;5425;17694
280070;201304;1763;6430;1702;6337;315;1248;1153;4347;1468;5595
280100;201304;3871;12626;3573;12094;869;3032;1966;6833;2835;9865
280110;201304;1281;4149;1205;4021;126;520;920;3030;1046;3550
280120;201304;7308;24330;6880;23619;1489;4818;4520;16517;6009;21335
280130;201304;7538;22427;7179;21922;1164;4142;4996;15037;6160;19179
280140;201304;5248;15294;4825;14752;392;1219;4061;12581;4453;13800
280150;201304;3188;10301;2950;9831;490;1983;1833;5821;2323;7804
280160;201304;1497;4379;1378;4190;193;661;973;2962;1166;3623
280170;201304;4296;13770;3973;13379;552;1914;2992;10361;3544;12275
280190;201304;1073;3238;983;3091;121;474;684;2080;805;2554
280200;201304;958;3207;929;3172;172;721;656;2156;828;2877
280210;201304;11285;38577;10903;37938;2520;9304;6758;23886;9278;33190
280220;201304;1489;4701;1439;4636;100;376;1268;4068;1368;4444
280230;201304;3748;11207;3417;10658;746;2480;2000;6387;2746;8867
280240;201304;3336;10380;3120;10049;255;832;2516;8222;2771;9054
280250;201304;700;1961;660;1901;50;170;540;1515;590;1685
280260;201304;1879;5318;1731;5128;136;421;1465;4345;1601;4766
280270;201304;2104;6804;1865;6398;138;574;1468;4932;1606;5506
280280;201304;3950;13463;3756;13130;798;2469;2282;8783;3080;11252
280290;201304;15122;51367;14409;50143;2602;9895;10231;35550;12833;45445
280300;201304;9477;29808;8944;29207;643;2299;7833;25616;8476;27915
280310;201304;1377;4026;1246;3826;117;461;913;2722;1030;3183
280320;201304;7022;25141;6740;24629;1206;4984;4409;16108;5615;21092
280330;201304;4178;12698;3990;12458;564;1901;3031;9542;3595;11443
280340;201304;3475;11257;3397;11152;294;1087;2787;9295;3081;10382
280350;201304;20141;62683;19324;61392;3085;10183;13625;44262;16710;54445
280360;201304;5660;18367;5372;17924;1197;4526;3305;10870;4502;15396
280370;201304;1823;5440;1705;5241;219;805;1251;3728;1470;4533
280380;201304;857;2906;806;2824;143;599;575;1936;718;2535
280390;201304;3079;9467;2819;9013;679;2013;1752;5775;2431;7788
280400;201304;4189;12408;3870;11987;778;2364;2560;8246;3338;10610
280410;201304;2247;7631;2091;7376;362;1469;1279;4408;1641;5877
280420;201304;3825;11687;3620;11392;271;888;3110;9888;3381;10776
280430;201304;1878;5648;1790;5533;277;964;1280;3992;1557;4956
280440;201304;4735;14814;4505;14511;399;1451;3806;12215;4205;13666
280445;201304;2406;7080;2265;6845;131;528;1883;5587;2014;6115
280450;201304;8395;23989;7857;23366;794;2059;6594;20245;7388;22304
280460;201304;6387;18598;5852;17873;1330;4176;3747;11749;5077;15925
280470;201304;1651;5245;1532;5062;180;675;1145;3751;1325;4426
280480;201304;29162;91740;28351;90580;4685;17895;19835;61474;24520;79369
280490;201304;3598;11371;3407;11035;377;1474;2670;8557;3047;10031
280500;201304;797;2266;777;2243;44;160;669;1897;713;2057
280510;201304;2613;7932;2267;7454;315;1192;1673;5515;1988;6707
280520;201304;1552;4813;1430;4649;202;724;997;3316;1199;4040
280530;201304;1919;6325;1841;6217;228;871;1442;4892;1670;5763
280540;201304;8409;24337;8037;23827;376;1351;7187;21161;7563;22512
280550;201304;6690;19231;6229;18503;559;2041;4741;13951;5300;15992
280560;201304;7566;23154;7217;22560;559;1987;5901;18398;6460;20385
280570;201304;6436;18926;6045;18428;827;3007;4519;13576;5346;16583
280580;201304;5526;17178;4890;16147;676;2374;3519;11790;4195;14164
280590;201304;2276;7145;2122;6969;264;1068;1614;5291;1878;6359
280600;201304;3893;12321;3670;11908;406;1619;2642;8378;3048;9997
280610;201304;2216;6740;2125;6603;364;1280;1354;4200;1718;5480
280620;201304;4516;14783;4278;14293;860;3091;2706;9055;3566;12146
280630;201304;3702;12643;3604;12493;427;1440;2855;10200;3282;11640
280640;201304;2008;6105;1904;5976;123;380;1680;5337;1803;5717
280650;201304;1051;3412;983;3285;193;695;606;2066;799;2761
280660;201304;2447;7511;2355;7356;186;735;2008;6137;2194;6872
280670;201304;14944;40643;14342;39915;1389;4149;11745;32745;13134;36894
280680;201304;2591;7251;2321;6918;197;615;1948;5829;2145;6444
280690;201304;931;2795;834;2640;124;465;560;1678;684;2143
280700;201304;1164;3524;1043;3355;84;266;814;2694;898;2960
280710;201304;9416;27747;9043;27270;558;1895;7835;23561;8393;25456
280720;201304;2377;6676;2130;6363;198;654;1682;5048;1880;5702
280730;201304;886;2761;870;2739;92;311;710;2262;802;2573
280740;201304;12083;34424;10807;32559;1697;5026;7640;23742;9337;28768
280750;201304;3437;11268;3250;10928;291;1225;2445;8111;2736;9336
280760;201304;5279;17022;4902;16534;615;2126;3794;13165;4409;15291
290010;201304;2901;6657;2148;5473;95;383;1722;4153;1817;4536
290020;201304;4798;15476;4370;15031;372;1208;3810;13336;4182;14544
290030;201304;2982;10140;2923;10021;345;1305;2274;7748;2619;9053
290035;201304;4336;12522;3973;12043;266;950;3390;10251;3656;11201
290040;201304;3504;10897;3321;10648;281;1103;2745;8685;3026;9788
290050;201304;2676;8936;2518;8693;250;964;1950;6789;2200;7753
290060;201304;1232;3311;1049;3096;82;232;908;2697;990;2929
290070;201304;28033;78431;25376;75046;5425;16795;14840;45729;20265;62524
290080;201304;5487;17654;5006;17040;614;2225;3882;13399;4496;15624
290090;201304;2289;5173;1843;4700;200;512;1525;3947;1725;4459
290100;201304;9836;29065;8630;26987;1899;5993;4740;15517;6639;21510
290110;201304;5071;15918;4930;15675;867;2997;3416;10806;4283;13803
290115;201304;4780;14980;4307;14355;353;1260;3315;11263;3668;12523
290120;201304;6398;18399;6061;17997;399;1240;5329;15926;5728;17166
290130;201304;4445;12038;4000;11509;317;805;3417;10060;3734;10865
290135;201304;4916;13371;4357;12440;468;1614;2988;8513;3456;10127
290140;201304;3531;12175;3195;11732;432;1697;2495;9227;2927;10924
290150;201304;2059;6269;2008;6185;172;577;1722;5289;1894;5866
290160;201304;3393;9724;3337;9659;381;776;2837;8591;3218;9367
290170;201304;2670;9300;2483;8985;273;1151;1936;7003;2209;8154
290180;201304;2847;8426;2617;8127;293;1031;1960;6081;2253;7112
290190;201304;4136;13855;4001;13616;450;1608;3141;10810;3591;12418
290195;201304;2099;6100;1847;5722;133;442;1502;4714;1635;5156
290200;201304;3653;12346;3400;11880;478;1813;2436;8546;2914;10359
290205;201304;2663;8933;2531;8750;432;1756;1789;6047;2221;7803
290210;201304;15040;42999;14470;42325;2521;5917;10391;33424;12912;39341
290220;201304;2228;7178;2160;7079;348;1314;1531;4916;1879;6230
290225;201304;2928;8117;2769;7944;268;606;2351;7015;2619;7621
290230;201304;2259;7731;2226;7683;261;911;1815;6368;2076;7279
290240;201304;3791;10267;3462;9824;412;1280;2579;7287;2991;8567
290250;201304;3666;12068;3133;11206;312;1212;2364;8543;2676;9755
290260;201304;4472;14510;4264;14188;508;1783;3339;11143;3847;12926
290265;201304;3231;10854;3110;10647;332;1325;2388;8150;2720;9475
290270;201304;11283;43335;10717;42530;1262;5557;8419;33675;9681;39232
290280;201304;4846;16711;4643;16299;739;2715;3124;11260;3863;13975
290290;201304;9358;31010;8697;29937;1625;5925;5821;20350;7446;26275
290300;201304;4273;12482;3465;11119;333;1063;2555;8450;2888;9513
290310;201304;1465;4628;1422;4583;214;797;1065;3370;1279;4167
290320;201304;22168;75541;21176;74080;4832;17753;13520;48086;18352;65839
290323;201304;3821;10803;3183;10132;211;790;2724;8649;2935;9439
290327;201304;3830;12764;3633;12356;528;1895;2549;8725;3077;10620
290330;201304;1784;4967;1718;4892;289;921;1308;3657;1597;4578
290340;201304;5397;17642;5102;17202;1235;4235;2961;10350;4196;14585
290350;201304;4789;15076;3972;13954;505;1827;2900;10461;3405;12288
290360;201304;3904;12845;3682;12576;224;819;3262;11250;3486;12069
290370;201304;4350;13706;4052;13262;578;1939;3128;10370;3706;12309
290380;201304;5223;16093;4737;15457;423;1568;3927;12812;4350;14380
290390;201304;14377;48929;13903;48136;2839;9567;9248;33616;12087;43183
290395;201304;2690;9002;2455;8614;272;1155;1832;6430;2104;7585
290400;201304;3320;11358;3048;10969;381;1497;2310;8422;2691;9919
290405;201304;4142;13767;3696;13021;516;1897;2521;9164;3037;11061
290410;201304;5732;17936;4982;16842;583;2517;3697;12146;4280;14663
290420;201304;2998;9559;2633;9041;293;1189;1979;6735;2272;7924
290430;201304;3270;10829;3023;10490;616;2113;1996;7211;2612;9324
290440;201304;2686;7748;2295;7258;227;789;1882;6003;2109;6792
290450;201304;3380;10290;3105;9902;700;2133;1919;6432;2619;8565
290460;201304;12516;40722;11949;39761;3039;10829;6528;21561;9567;32390
290470;201304;4517;13349;3684;12311;871;3293;2012;6796;2883;10089
290475;201304;5008;18232;4603;17514;563;2269;3383;13097;3946;15366
290480;201304;2550;6820;2296;6481;388;1219;1570;4443;1958;5662
290485;201304;4325;14854;4088;14505;484;2159;3122;10996;3606;13155
290490;201304;7194;20960;7017;20732;953;3031;5520;16343;6473;19374
290500;201304;4504;14808;3950;13856;741;2799;2232;7889;2973;10688
290510;201304;3366;10115;2980;9543;259;990;2357;7528;2616;8518
290515;201304;2591;8548;2511;8389;143;467;2085;7149;2228;7616
290520;201304;11427;36722;9570;33242;1328;5385;6139;21215;7467;26600
290530;201304;5056;15151;4402;14229;375;1354;3579;11567;3954;12921
290540;201304;3910;11431;3752;11219;519;1516;2829;8683;3348;10199
290550;201304;3972;11170;3542;10618;305;853;2904;8866;3209;9719
290560;201304;6642;19802;5844;18733;1353;4519;3485;11440;4838;15959
290570;201304;37059;113426;34991;110239;4781;16313;25984;81719;30765;98032
290580;201304;7187;26209;6944;25838;1192;4459;5078;19434;6270;23893
290590;201304;6994;23444;6070;22005;464;2018;4954;17910;5418;19928
290600;201304;17568;56710;16747;55430;2356;8010;11953;40687;14309;48697
290610;201304;2264;8192;1973;7636;219;1047;1490;5655;1709;6702
290620;201304;7089;21659;6429;20720;532;1851;5389;17400;5921;19251
290630;201304;7951;22411;7161;21582;765;2266;5907;18075;6672;20341
290640;201304;2676;8043;2257;7307;258;901;1601;5198;1859;6099
290650;201304;11396;34889;10738;33871;3332;10537;5661;18713;8993;29250
290660;201304;3613;10505;3053;9697;221;817;2438;7772;2659;8589
290670;201304;6187;20471;5728;19758;803;2561;4450;16013;5253;18574
290680;201304;9869;30191;9369;29614;545;1603;8313;26709;8858;28312
290682;201304;4054;12859;3760;12446;231;943;3152;10393;3383;11336
290685;201304;3105;8384;2450;7469;306;1037;1591;4913;1897;5950
290687;201304;8148;22549;6726;20879;1063;3609;4552;14359;5615;17968
290689;201304;3057;8913;2609;8182;270;918;2015;6355;2285;7273
290690;201304;5065;15538;4711;15047;626;2229;3582;11445;4208;13674
290700;201304;2158;7017;2083;6905;244;869;1590;5327;1834;6196
290710;201304;7306;24603;6877;23937;412;1430;6085;21439;6497;22869
290720;201304;16808;52546;15274;50636;2298;6916;11686;40383;13984;47299
290730;201304;7126;20554;6618;19921;1317;3814;4322;13612;5639;17426
290740;201304;966;3016;844;2819;199;649;454;1610;653;2259
290750;201304;8639;27377;8128;26411;1718;6531;4902;14991;6620;21522
290755;201304;2357;6953;2044;6437;142;564;1676;5216;1818;5780
290760;201304;4349;13306;3686;12407;376;1321;2865;9728;3241;11049
290770;201304;2491;8844;2343;8650;155;635;1991;7401;2146;8036
290780;201304;8304;23131;7626;22231;1022;2807;5720;17142;6742;19949
290790;201304;4233;13564;4017;13287;471;1503;3119;10759;3590;12262
290800;201304;6964;16228;5447;14615;1113;2778;3783;10637;4896;13415
290810;201304;4575;15453;4196;14880;380;1428;3280;11834;3660;13262
290820;201304;5185;15611;4698;14926;643;2296;3419;10891;4062;13187
290830;201304;4066;12743;3937;12504;546;2128;2792;8641;3338;10769
290840;201304;16670;48669;15720;47369;2314;6716;11486;35987;13800;42703
290850;201304;6502;20209;6378;20018;1662;5165;4027;13065;5689;18230
290860;201304;4575;17206;4432;17012;724;2733;3258;12933;3982;15666
290870;201304;4593;14629;3905;13731;430;1778;3001;10537;3431;12315
290880;201304;1342;3880;1106;3504;118;389;748;2427;866;2816
290890;201304;6053;17548;5873;17316;547;1722;4884;14403;5431;16125
290900;201304;2332;7044;1801;6202;309;1211;947;3211;1256;4422
290910;201304;4564;13429;4006;12625;376;1275;3195;10119;3571;11394
290920;201304;4613;14533;4273;14117;289;846;3716;12538;4005;13384
290930;201304;7042;23503;6624;22832;761;3009;4920;16755;5681;19764
290940;201304;3226;10877;3073;10671;270;1031;2612;9157;2882;10188
290950;201304;1548;4577;1477;4479;226;740;1086;3272;1312;4012
290960;201304;5517;16826;5177;16352;412;1356;4192;13424;4604;14780
290970;201304;3676;12265;3460;11890;528;1885;2307;8160;2835;10045
290980;201304;10176;32384;9344;30699;2747;9633;4211;13718;6958;23351
290990;201304;8921;27493;8290;26508;950;3177;6494;20900;7444;24077
291000;201304;2806;9435;2688;9275;431;1438;1993;7149;2424;8587
291005;201304;10082;32622;9642;31916;2028;7180;6400;21233;8428;28413
291010;201304;2802;9934;2435;9076;515;2036;1250;4727;1765;6763
291020;201304;1304;3671;1029;3155;130;503;591;1755;721;2258
291030;201304;1985;5866;1711;5290;188;657;1135;3464;1323;4121
291040;201304;4995;16839;4767;16494;652;2485;3497;12120;4149;14605
291050;201304;7853;27019;7321;26047;1923;7329;4013;14411;5936;21740
291060;201304;6019;22972;5793;22699;795;3520;4480;17533;5275;21053
291070;201304;15309;47049;14321;45585;1991;5922;10750;35382;12741;41304
291072;201304;17426;58130;15794;54989;6253;22968;5119;19076;11372;42044
291075;201304;4996;15163;4586;14594;339;1100;3619;11710;3958;12810
291077;201304;1455;4478;1270;4197;153;624;879;2832;1032;3456
291080;201304;79053;246201;73178;237144;18448;63339;38759;125438;57207;188777
291085;201304;5362;15200;4752;14381;611;2005;3641;11025;4252;13030
291090;201304;1159;3386;1022;3177;177;763;648;1839;825;2602
291100;201304;2611;7281;2218;6864;129;518;1919;5905;2048;6423
291110;201304;4818;17852;4394;17180;569;2550;3229;12565;3798;15115
291120;201304;7211;19982;6857;19479;1034;3097;5107;14566;6141;17663
291125;201304;1633;3774;1353;3481;135;329;1059;2856;1194;3185
291130;201304;2934;9131;2595;8566;278;1067;1850;6073;2128;7140
291140;201304;3911;12187;3751;11907;556;1888;2759;8770;3315;10658
291150;201304;1953;5255;1891;5181;190;553;1523;4146;1713;4699
291160;201304;5351;16727;4791;15916;1117;3906;2929;9729;4046;13635
291165;201304;2202;7059;1939;6544;201;845;1382;4539;1583;5384
291170;201304;19767;52428;17490;49715;1415;4839;14214;40124;15629;44963
291180;201304;6101;16943;5171;15679;535;1861;4063;12220;4598;14081
291185;201304;3450;10259;3316;10087;231;833;2842;8576;3073;9409
291190;201304;7291;21251;6661;20525;921;2703;4984;16063;5905;18766
291200;201304;2993;9386;2647;8836;372;1453;1891;6258;2263;7711
291210;201304;7420;18268;6663;17452;703;1906;5182;13761;5885;15667
291220;201304;3826;12718;3658;12426;591;2297;2570;8624;3161;10921
291230;201304;3673;10064;3319;9625;222;673;2862;8351;3084;9024
291240;201304;4546;12988;3920;11895;334;1088;3022;9080;3356;10168
291250;201304;3643;11242;2938;10086;313;1127;2122;7391;2435;8518
291260;201304;1152;3523;1104;3463;105;371;895;2801;1000;3172
291270;201304;4586;15632;4389;15343;283;1126;3718;13032;4001;14158
291280;201304;2311;5980;1781;5386;540;1567;1033;3265;1573;4832
291290;201304;5701;17094;5310;16621;463;1423;4347;13922;4810;15345
291300;201304;4320;13348;3631;12185;466;1745;2525;8504;2991;10249
291310;201304;5072;15259;4571;14465;445;1523;3516;11142;3961;12665
291320;201304;5263;18257;4842;17420;1365;5297;2361;8403;3726;13700
291330;201304;1526;4875;1439;4719;219;855;908;2840;1127;3695
291340;201304;3691;11432;3013;10462;403;1608;2241;7705;2644;9313
291345;201304;3215;11252;3099;11125;242;907;2710;9845;2952;10752
291350;201304;5934;18058;5349;17170;724;2440;3539;11679;4263;14119
291360;201304;35285;105718;33311;102796;7752;23782;21689;69114;29441;92896
291370;201304;8734;27280;8433;26895;1392;4122;6118;20499;7510;24621
291380;201304;3573;11507;3271;11022;304;1053;2443;8450;2747;9503
291390;201304;9824;28853;9053;27976;1171;3655;7137;22324;8308;25979
291400;201304;16248;44218;13416;40454;1929;6044;9093;28420;11022;34464
291410;201304;3145;8392;2349;7220;209;867;1741;5139;1950;6006
291420;201304;2168;5893;1994;5681;153;384;1768;5130;1921;5514
291430;201304;3263;9952;2915;9495;273;1060;2278;7363;2551;8423
291440;201304;5526;18549;4762;17080;598;2282;3515;12815;4113;15097
291450;201304;7005;22545;6712;22039;504;1632;5442;18256;5946;19888
291460;201304;11967;38409;10870;36809;2716;9530;6449;22306;9165;31836
291465;201304;7179;22558;6758;22080;986;3430;5188;17164;6174;20594
291470;201304;14973;43583;13554;41833;1164;3649;10962;34759;12126;38408
291480;201304;32921;92964;29662;88376;5623;18287;18943;56335;24566;74622
291490;201304;3960;14201;3900;14105;544;1996;3103;11360;3647;13356
291500;201304;4027;12113;3569;11483;309;1074;2884;9329;3193;10403
291510;201304;3286;10628;3128;10402;180;654;2791;9331;2971;9985
291520;201304;3917;11383;3548;10875;642;1874;2356;7732;2998;9606
291530;201304;2005;6226;1747;5831;511;1810;859;2972;1370;4782
291535;201304;4218;12748;3859;12230;422;1404;2882;9530;3304;10934
291540;201304;2169;5580;1901;5299;160;425;1612;4590;1772;5015
291550;201304;5389;15370;4912;14696;1224;3945;2762;8316;3986;12261
291560;201304;15897;43601;12911;40150;1807;5788;9389;29974;11196;35762
291570;201304;2221;6273;2191;6235;67;158;2083;5986;2150;6144
291580;201304;5663;17993;5077;17039;854;3506;3196;10503;4050;14009
291590;201304;1884;6151;1694;5825;363;1423;1015;3530;1378;4953
291600;201304;5321;15348;3996;13503;1024;3737;2033;6841;3057;10578
291610;201304;5094;14807;4949;14594;530;1895;3976;11427;4506;13322
291620;201304;2941;7194;2493;6712;216;577;1986;5522;2202;6099
291630;201304;3151;8190;2844;7843;245;644;2459;6924;2704;7568
291640;201304;16396;47223;14118;44344;4109;14160;6429;20303;10538;34463
291650;201304;7827;23903;7290;23278;637;1641;6168;20484;6805;22125
291660;201304;2377;6530;2148;6230;275;909;1555;4460;1830;5369
291670;201304;2473;7141;2290;6837;379;1180;1297;4202;1676;5382
291680;201304;4876;14339;4471;13713;1186;4080;2141;6869;3327;10949
291685;201304;4010;11163;3666;10744;218;680;3149;9417;3367;10097
291690;201304;3860;10998;3217;9970;339;1105;2222;6941;2561;8046
291700;201304;8954;29685;8469;28875;944;3389;6544;22648;7488;26037
291710;201304;5616;15720;4962;14820;1385;4559;2274;7066;3659;11625
291720;201304;3524;12935;3367;12601;405;1708;2527;9345;2932;11053
291730;201304;5569;18763;5253;18347;1392;4902;3143;11434;4535;16336
291733;201304;2383;7670;2121;7315;256;973;1510;5287;1766;6260
291735;201304;1990;6187;1785;5872;101;402;1536;4995;1637;5397
291740;201304;3878;11562;3107;10379;331;1297;2200;7311;2531;8608
291750;201304;20825;57501;17224;52314;3852;12127;9827;30430;13679;42557
291760;201304;11762;38765;11189;37768;3735;13512;5474;18885;9209;32397
291770;201304;7689;22985;7208;22188;1111;3740;5010;15303;6121;19043
291780;201304;4163;13368;4047;13167;609;1917;3065;10153;3674;12070
291790;201304;2318;7772;2218;7641;216;822;1807;6260;2023;7082
291800;201304;29624;90862;27407;87687;6500;21535;16602;54604;23102;76139
291810;201304;9979;30461;8893;29204;698;2467;7316;24398;8014;26865
291820;201304;3459;10873;3241;10575;371;1218;2520;8347;2891;9565
291830;201304;4176;11749;3929;11375;544;1756;2977;8533;3521;10289
291835;201304;5926;19007;5105;17740;1020;3857;3438;11912;4458;15769
291840;201304;44836;129201;39371;123465;4915;15454;31560;100964;36475;116418
291845;201304;2985;8977;2707;8673;205;605;2401;7818;2606;8423
291850;201304;4766;13802;4100;12899;426;1317;3259;10516;3685;11833
291855;201304;1860;5110;1646;4850;291;1012;1148;3307;1439;4319
291860;201304;1839;5777;1702;5553;205;774;1144;3716;1349;4490
291870;201304;1311;3723;1071;3294;111;423;731;2222;842;2645
291875;201304;2691;9147;2527;8882;272;1113;1893;6581;2165;7694
291880;201304;4269;14022;4167;13888;281;968;3669;12322;3950;13290
291890;201304;1386;3596;1192;3358;157;469;880;2498;1037;2967
291900;201304;1236;3730;1119;3552;112;400;847;2666;959;3066
291905;201304;2767;7751;2387;7151;264;884;1630;4992;1894;5876
291910;201304;2364;6897;2170;6659;182;681;1795;5424;1977;6105
291915;201304;6383;20667;5874;19610;513;1806;4919;16596;5432;18402
291920;201304;32075;95033;29941;91960;5833;18134;19394;61571;25227;79705
291930;201304;2413;7533;2245;7301;234;770;1782;5927;2016;6697
291940;201304;3481;10257;2715;8928;404;1561;1710;5484;2114;7045
291950;201304;8913;31411;8191;30239;2081;7857;4524;17135;6605;24992
291955;201304;7205;24459;7101;24316;1394;4849;5003;17446;6397;22295
291960;201304;3277;10085;2876;9552;368;1176;2051;7196;2419;8372
291970;201304;4294;13199;3854;12678;633;2114;2707;9157;3340;11271
291980;201304;11079;33044;8789;29812;1012;3626;6368;22055;7380;25681
291990;201304;2063;7028;1927;6820;220;803;1407;5141;1627;5944
291992;201304;2714;8563;2662;8453;504;1665;1887;5982;2391;7647
291995;201304;2022;6237;1855;6017;227;773;1438;4727;1665;5500
292000;201304;2179;6762;2007;6496;570;2006;1085;3451;1655;5457
292010;201304;5939;15985;4655;14027;361;1220;3654;10999;4015;12219
292020;201304;4373;15433;4047;14896;548;2220;3004;11210;3552;13430
292030;201304;2090;6911;1915;6667;261;993;1326;4706;1587;5699
292040;201304;4353;12754;4003;12374;334;1015;3393;10794;3727;11809
292045;201304;2239;8392;2214;8348;122;408;2024;7714;2146;8122
292050;201304;5855;19330;5453;18532;646;2671;3891;13008;4537;15679
292060;201304;10515;30547;10171;30079;936;2927;8503;25089;9439;28016
292070;201304;4146;13766;4052;13644;415;1243;3484;11988;3899;13231
292080;201304;3552;9791;3138;9237;314;968;2519;7474;2833;8442
292090;201304;4175;11578;3636;10960;393;1353;2898;8724;3291;10077
292100;201304;10331;30203;9220;28823;2354;7691;5634;17966;7988;25657
292105;201304;3087;9660;2721;9147;226;916;2165;7230;2391;8146
292110;201304;6869;18640;5327;16468;1040;3473;3269;10279;4309;13752
292120;201304;8180;24303;7363;23036;1505;4952;4450;14224;5955;19176
292130;201304;3186;8694;2955;8396;391;916;2297;6838;2688;7754
292140;201304;5254;14275;4715;13554;524;1578;3422;10088;3946;11666
292145;201304;2628;8332;2427;8016;221;722;1822;6290;2043;7012
292150;201304;13077;40976;12253;39649;898;3462;9693;31487;10591;34949
292160;201304;2521;7581;2191;7129;206;638;1763;5922;1969;6560
292170;201304;8346;26109;7342;24388;1109;4121;4786;16109;5895;20230
292180;201304;3428;10528;2900;9733;339;1228;2095;7146;2434;8374
292190;201304;2999;8796;2674;8340;548;1896;1742;5412;2290;7308
292200;201304;4677;17118;4306;16248;1570;6229;1488;5778;3058;12007
292205;201304;3912;12498;3637;12130;322;1220;2862;9553;3184;10773
292210;201304;6334;19238;5652;18290;591;2015;4405;14613;4996;16628
292220;201304;1888;5638;1802;5514;319;1015;1244;3774;1563;4789
292225;201304;2775;9192;2567;8866;228;823;2027;7128;2255;7951
292230;201304;5861;18267;5647;17923;670;2631;4374;13485;5044;16116
292240;201304;4140;13806;3906;13265;601;2141;2462;8418;3063;10559
292250;201304;5269;16474;4988;15938;1047;3513;2868;9242;3915;12755
292260;201304;2829;9519;2731;9360;354;1294;2058;7056;2412;8350
292265;201304;2952;10204;2776;9860;247;1029;2094;7410;2341;8439
292270;201304;3648;10551;3003;9792;284;1145;2432;7881;2716;9026
292273;201304;2695;6696;2091;5920;325;896;1447;4285;1772;5181
292275;201304;1885;4996;1776;4840;226;708;1344;3624;1570;4332
292280;201304;1993;6201;1867;6067;197;561;1480;5098;1677;5659
292285;201304;2402;7107;2159;6752;335;1120;1459;4724;1794;5844
292290;201304;7331;22741;6281;21404;259;980;5453;19000;5712;19980
292300;201304;8046;25711;7155;24752;2389;8314;3970;14328;6359;22642
292303;201304;2664;8833;2535;8635;95;366;2226;7627;2321;7993
292305;201304;3034;8661;2889;8464;118;368;2588;7620;2706;7988
292310;201304;5772;18508;5331;17912;383;1281;4555;15544;4938;16825
292320;201304;5461;17717;5139;17144;595;2346;3902;12882;4497;15228
292330;201304;1833;5634;1731;5513;296;1042;1217;3836;1513;4878
292335;201304;5027;13818;4661;13323;402;1168;3922;11296;4324;12464
292340;201304;6194;18738;5520;17719;515;1809;4185;13472;4700;15281
292350;201304;2020;6536;1912;6406;208;792;1523;5102;1731;5894
292360;201304;4695;14360;4559;13873;207;646;3971;12350;4178;12996
292370;201304;8011;26451;7377;25500;930;3102;5330;19467;6260;22569
292380;201304;7066;21138;6741;20674;546;1583;5692;17678;6238;19261
292390;201304;3475;8247;3106;7848;114;245;2896;7384;3010;7629
292400;201304;21530;64931;20680;63559;3083;10060;14723;46186;17806;56246
292405;201304;4278;11903;3785;11309;295;893;3181;9650;3476;10543
292410;201304;1594;4875;1562;4837;99;412;1383;4200;1482;4612
292420;201304;3479;11640;3370;11514;241;643;2983;10532;3224;11175
292430;201304;5059;16777;4412;15953;341;1390;3505;12733;3846;14123
292440;201304;8346;27831;7879;27176;313;1210;7024;24561;7337;25771
292450;201304;3993;12634;3363;11602;381;1474;2334;8156;2715;9630
292460;201304;5536;17136;4990;16142;826;2827;3307;10763;4133;13590
292465;201304;2239;7121;1967;6685;249;989;1433;4877;1682;5866
292467;201304;2149;7198;2047;7022;462;1718;1273;4395;1735;6113
292470;201304;3113;8616;2642;7869;234;841;2009;5893;2243;6734
292480;201304;5353;15922;4655;14895;419;1493;3739;12062;4158;13555
292490;201304;2138;6407;1888;6025;227;870;1387;4369;1614;5239
292500;201304;6296;19763;5572;18492;617;2365;4070;13589;4687;15954
292510;201304;12655;37732;11423;35973;1151;4055;8976;28571;10127;32626
292520;201304;5493;17648;5155;17034;1549;5261;2581;8623;4130;13884
292525;201304;5321;14456;4723;13756;477;1516;3745;11005;4222;12521
292530;201304;23874;73690;22163;71741;3902;12927;15887;53038;19789;65965
292540;201304;2584;8202;2395;7914;470;1798;1554;5084;2024;6882
292550;201304;5879;20390;5408;19627;1026;3976;3535;13062;4561;17038
292560;201304;4114;11704;3554;10970;323;1202;2873;8723;3196;9925
292570;201304;3781;11643;3720;11578;145;462;3241;10422;3386;10884
292575;201304;5691;20101;5564;19848;1270;4640;3576;12807;4846;17447
292580;201304;6748;20996;6328;20458;564;1889;5242;17116;5806;19005
292590;201304;6898;22934;6683;22553;1082;3616;4663;16104;5745;19720
292593;201304;3151;8624;2723;7998;256;788;2103;6177;2359;6965
292595;201304;5385;16381;4918;15754;486;1684;3789;12180;4275;13864
292600;201304;9954;29268;9566;28787;1403;3292;7604;24138;9007;27430
292610;201304;4243;12616;3608;11564;651;2192;2187;7141;2838;9333
292620;201304;5682;18120;5099;17444;268;1001;4635;15961;4903;16962
292630;201304;9676;25007;8585;23419;661;1992;6778;18629;7439;20621
292640;201304;8181;26950;7284;25782;685;2499;5732;20794;6417;23293
292650;201304;4505;13117;4364;12949;507;1158;3513;11100;4020;12258
292660;201304;10674;33724;10326;33197;1505;4806;7648;25233;9153;30039
292665;201304;2827;8653;2760;8549;101;280;2585;8080;2686;8360
292670;201304;3720;10942;3011;9750;385;1428;1992;6482;2377;7910
292680;201304;3446;10773;3316;10604;238;863;2841;9005;3079;9868
292690;201304;3291;9236;2457;7966;326;1173;1677;5518;2003;6691
292700;201304;8479;27260;7681;26162;941;3083;5911;20881;6852;23964
292710;201304;1848;6207;1786;6115;112;408;1566;5395;1678;5803
292720;201304;9227;24903;8273;23813;836;2486;6805;19829;7641;22315
292730;201304;3198;10067;3110;9919;627;1920;2036;6752;2663;8672
292740;201304;337843;989605;323806;968676;80058;252377;193924;583249;273982;835626
292750;201304;5588;15959;5154;15393;414;1203;4193;12842;4607;14045
292760;201304;4179;13712;3874;13155;575;2161;2626;9000;3201;11161
292770;201304;5677;18154;5423;17759;1412;4624;3143;10735;4555;15359
292780;201304;1732;4625;1411;4240;229;816;992;2916;1221;3732
292790;201304;2967;8640;2897;8558;256;655;2395;7423;2651;8078
292800;201304;9110;28365;8620;27571;950;3305;6675;21387;7625;24692
292805;201304;2942;9228;2759;8953;513;1811;1899;6253;2412;8064
292810;201304;9290;29966;8179;28504;1256;4501;6086;21681;7342;26182
292820;201304;7041;21014;5317;18590;444;1753;4356;15290;4800;17043
292830;201304;1812;5557;1665;5358;133;533;1352;4313;1485;4846
292840;201304;6222;22360;5786;21745;555;2068;4745;18177;5300;20245
292850;201304;2907;8140;2600;7694;401;1247;1793;5260;2194;6507
292860;201304;14627;41186;14191;40655;2034;5768;11033;32204;13067;37972
292870;201304;17554;51273;15955;48659;3059;10469;9571;28644;12630;39113
292880;201304;11379;35196;10430;33659;2023;6752;6636;21714;8659;28466
292890;201304;5217;18726;4779;17869;1068;4098;2690;10427;3758;14525
292895;201304;2631;6995;2255;6439;321;985;1686;4778;2007;5763
292900;201304;3017;9606;2852;9333;481;1847;1868;5895;2349;7742
292905;201304;3821;12132;3236;11363;397;1273;2549;9304;2946;10577
292910;201304;4851;15619;4570;15108;823;2899;2979;9820;3802;12719
292920;201304;7358;22716;7050;22248;704;2531;5623;17562;6327;20093
292925;201304;4835;15925;4367;15304;376;1423;3523;12439;3899;13862
292930;201304;6181;20480;5955;20057;895;3636;4263;14022;5158;17658
292935;201304;2040;5969;1751;5645;202;611;1362;4588;1564;5199
292937;201304;3182;8474;2759;7931;348;1120;2063;5864;2411;6984
292940;201304;2985;8544;2419;7766;291;949;1651;5521;1942;6470
292950;201304;7896;24937;7618;24456;1130;4241;5404;16926;6534;21167
292960;201304;4388;12804;4159;12461;519;1695;2998;8910;3517;10605
292970;201304;4029;13119;3761;12777;214;881;3188;10848;3402;11729
292975;201304;2975;8785;2893;8649;350;1116;2294;6869;2644;7985
292980;201304;3458;10135;2880;9444;414;1638;2006;6514;2420;8152
292990;201304;11550;34229;10956;33377;797;2548;9453;28966;10250;31514
293000;201304;2817;7785;2382;7218;146;528;2050;6177;2196;6705
293010;201304;16579;50745;15447;48799;3229;11080;9494;29904;12723;40984
293015;201304;7602;25912;6232;23920;1075;4447;4176;16014;5251;20461
293020;201304;9186;31006;8636;30210;651;2565;7161;25336;7812;27901
293030;201304;5328;16183;4423;14852;512;1828;3117;10817;3629;12645
293040;201304;3576;11805;3461;11678;257;917;2993;10133;3250;11050
293050;201304;18184;54138;16461;51857;2376;7654;11651;37658;14027;45312
293060;201304;4224;11065;3645;10147;427;1286;2533;7015;2960;8301
293070;201304;18305;58456;17512;57079;4790;16386;9888;32558;14678;48944
293075;201304;3541;11263;3241;10920;199;697;2866;9744;3065;10441
293076;201304;3618;10596;3420;10293;326;907;2832;8743;3158;9650
293077;201304;5138;16163;4508;15375;699;2532;3230;11088;3929;13620
293080;201304;4692;15232;4344;14639;373;1606;3398;11204;3771;12810
293090;201304;3514;11261;2936;10466;278;1069;2341;8446;2619;9515
293100;201304;5457;17358;4784;16186;502;1864;3617;12419;4119;14283
293105;201304;3670;12775;3305;12065;469;1882;2315;8531;2784;10413
293110;201304;1887;5823;1803;5686;109;404;1535;4842;1644;5246
293120;201304;3883;13445;3648;13117;357;1314;2919;10654;3276;11968
293130;201304;3850;11549;3169;10783;200;783;2758;9514;2958;10297
293135;201304;23191;67560;19967;63216;3967;15031;11312;34974;15279;50005
293140;201304;1980;6209;1930;6130;203;848;1502;4618;1705;5466
293150;201304;5738;19160;5285;18296;1027;3631;3269;11691;4296;15322
293160;201304;2878;8957;2749;8798;427;1098;2085;7049;2512;8147
293170;201304;3321;10457;3144;10185;467;1613;2312;7632;2779;9245
293180;201304;5244;15093;4493;13972;444;1645;3511;10754;3955;12399
293190;201304;12985;40999;12587;40336;670;2903;10888;34236;11558;37139
293200;201304;5842;18149;5308;17298;363;1397;4555;14709;4918;16106
293210;201304;4524;14240;4305;13873;553;1914;3108;10141;3661;12055
293220;201304;4750;15240;4464;14823;1200;4143;2472;8426;3672;12569
293230;201304;3910;12611;3653;12259;387;1500;2948;9848;3335;11348
293240;201304;4378;11655;3540;10555;210;655;2843;8546;3053;9201
293245;201304;4246;12800;3927;12274;522;1685;2791;8986;3313;10671
293250;201304;5798;17133;5448;16649;915;2905;3825;11841;4740;14746
293260;201304;4541;14147;3860;13154;371;1416;2916;10066;3287;11482
293270;201304;5598;15890;5377;15649;535;1498;4577;13528;5112;15026
293280;201304;5462;16228;4874;15449;442;1334;3823;12573;4265;13907
293290;201304;15644;54894;15202;53980;3091;11123;9885;35983;12976;47106
293300;201304;5942;15834;5220;15038;535;1482;4123;12137;4658;13619
293305;201304;4391;11743;4083;11332;439;1332;3187;8907;3626;10239
293310;201304;2614;6999;2199;6323;339;1081;1446;4126;1785;5207
293315;201304;4700;12406;4271;11721;794;2146;2615;7585;3409;9731
293317;201304;2437;7532;2250;7180;335;1115;1465;4720;1800;5835
293320;201304;8014;26485;7826;26225;946;3486;6258;20867;7204;24353
293325;201304;1862;5604;1560;5124;278;995;1015;3378;1293;4373
293330;201304;51857;169703;47341;162091;10998;40825;26712;92781;37710;133606
293340;201304;2618;7719;2127;6883;291;1087;1473;4671;1764;5758
293345;201304;3228;10178;2734;9447;392;1374;1854;6649;2246;8023
293350;201304;6480;18546;6257;18271;339;942;5648;16733;5987;17675
293360;201304;13317;41456;12341;40161;814;2682;10479;34858;11293;37540
310010;201304;1222;3406;891;2871;259;984;391;1162;650;2146
310020;201304;3675;11968;3183;10874;1183;4346;647;2018;1830;6364
310030;201304;2345;8097;2130;7690;757;2868;859;3156;1616;6024
310040;201304;912;2644;778;2457;123;465;512;1563;635;2028
310050;201304;1914;6970;1699;6430;366;1593;835;3149;1201;4742
310060;201304;2937;10690;2849;10559;310;1210;2309;8649;2619;9859
310070;201304;309;944;235;801;44;187;99;296;143;483
310080;201304;715;2272;595;2038;175;691;194;616;369;1307
310090;201304;4307;13794;3882;13050;738;2753;2416;8155;3154;10908
310100;201304;3082;10173;2761;9710;445;1699;1908;6758;2353;8457
310110;201304;5706;16632;4858;15369;1182;4276;2613;8153;3795;12429
310120;201304;552;1868;529;1831;234;919;196;591;430;1510
310130;201304;450;1486;413;1427;117;460;210;693;327;1153
310140;201304;250;887;217;822;77;326;44;150;121;476
310150;201304;4484;14706;4126;14038;962;3764;2199;7416;3161;11180
310160;201304;6436;21483;5777;20398;1669;6597;2795;9702;4464;16299
310163;201304;634;2251;604;2195;162;679;281;996;443;1675
310170;201304;9348;27866;8683;26840;1911;6345;5134;16424;7045;22769
310180;201304;1741;5285;1426;4879;366;1457;770;2551;1136;4008
310190;201304;2402;8330;2220;8045;712;2893;406;1522;1118;4415
310200;201304;1761;6138;1515;5628;521;2099;474;1737;995;3836
310205;201304;896;2938;823;2781;162;570;502;1728;664;2298
310210;201304;2278;7636;2132;7391;420;1568;1417;4922;1837;6490
310220;201304;1246;3619;1013;3328;180;650;664;2175;844;2825
310230;201304;2701;9325;2433;8718;831;3395;835;2733;1666;6128
310240;201304;982;3591;834;3287;145;633;482;1993;627;2626
310250;201304;922;3320;900;3284;186;772;546;1911;732;2683
310260;201304;3183;10749;2828;10014;957;3727;1031;3533;1988;7260
310270;201304;2222;7004;2043;6749;343;1256;1406;4701;1749;5957
310280;201304;2012;6150;1835;5858;640;2428;673;1940;1313;4368
310285;201304;2257;8080;2166;7963;272;947;1669;6358;1941;7305
310290;201304;1304;4261;1217;4126;406;1610;549;1648;955;3258
310300;201304;1807;6441;1721;6251;503;2012;940;3364;1443;5376
310310;201304;366;1062;285;885;59;211;141;418;200;629
310320;201304;330;1222;304;1151;84;342;143;547;227;889
310330;201304;466;1255;357;1064;57;206;207;573;264;779
310340;201304;8005;26555;7247;25345;1368;5089;4580;16478;5948;21567
310350;201304;13232;40781;11200;37071;4208;15122;2918;9703;7126;24825
310360;201304;426;1439;415;1419;108;428;247;800;355;1228
310370;201304;1341;5058;1300;4971;504;1976;499;1948;1003;3924
310375;201304;1226;3392;947;2937;136;516;560;1708;696;2224
310380;201304;365;1100;313;1033;144;525;120;366;264;891
310390;201304;434;1620;378;1495;121;517;71;273;192;790
310400;201304;9538;29927;7874;26887;2869;10724;2024;6732;4893;17456
310410;201304;1019;3321;678;2815;301;1342;129;514;430;1856
310420;201304;5342;15956;3123;10593;895;3410;456;1388;1351;4798
310430;201304;1490;5294;1300;4874;476;1904;372;1389;848;3293
310440;201304;618;1861;544;1745;167;617;201;599;368;1216
310445;201304;1167;4095;1011;3825;162;700;640;2457;802;3157
310450;201304;4259;13200;3616;12200;829;2984;2134;7385;2963;10369
310460;201304;1406;4757;1244;4464;498;1919;298;1130;796;3049
310470;201304;3652;9821;3116;9162;337;1169;2453;7175;2790;8344
310480;201304;962;3145;873;2999;242;948;393;1278;635;2226
310490;201304;3162;11000;2755;10195;960;3793;948;3607;1908;7400
310500;201304;1406;5092;1322;4924;463;1866;476;1763;939;3629
310510;201304;2443;8231;2159;7585;869;3333;496;1634;1365;4967
310520;201304;1212;3607;1097;3413;98;335;717;2234;815;2569
310530;201304;770;2586;534;1959;127;522;93;326;220;848
310540;201304;3550;12017;3316;11685;1201;4501;1230;4387;2431;8888
310550;201304;1030;3405;890;3165;338;1349;264;893;602;2242
310560;201304;15082;49127;13313;45691;4637;17609;4589;15042;9226;32651
310570;201304;1228;3953;1162;3861;178;678;849;2776;1027;3454
310590;201304;3889;11917;3175;10487;748;2848;1136;3540;1884;6388
310600;201304;1590;5486;1525;5335;532;2075;527;1740;1059;3815
310610;201304;535;1877;490;1777;171;724;154;502;325;1226
310620;201304;185980;612493;155020;547960;49466;192212;56935;193748;106401;385960
310630;201304;3908;13400;3726;13050;990;3876;2139;7258;3129;11134
310640;201304;1411;4487;1158;4027;372;1417;385;1268;757;2685
310650;201304;2719;9362;2312;8692;483;1966;1337;5183;1820;7149
310660;201304;1246;4044;1124;3867;217;859;789;2643;1006;3502
310665;201304;1080;3574;1011;3482;205;758;650;2271;855;3029
310670;201304;53242;173402;50159;166342;16179;57032;22692;73656;38871;130688
310680;201304;792;2439;729;2341;166;594;411;1277;577;1871
310690;201304;1145;4034;971;3642;284;1256;253;885;537;2141
310700;201304;473;1365;412;1271;93;329;214;622;307;951
310710;201304;6980;23879;5904;22418;1420;5619;3264;13100;4684;18719
310720;201304;791;2531;736;2447;217;803;385;1213;602;2016
310730;201304;9045;29866;8476;28997;1912;7101;5268;18114;7180;25215
310740;201304;4732;16713;4161;15504;1723;6958;982;3450;2705;10408
310750;201304;1487;4057;1263;3751;275;874;769;2287;1044;3161
310760;201304;589;1927;518;1809;152;568;206;710;358;1278
310770;201304;676;2594;669;2583;229;927;339;1324;568;2251
310780;201304;3467;10497;3233;10139;356;1040;2588;8297;2944;9337
310790;201304;1629;5482;1536;5342;485;1747;799;2861;1284;4608
310800;201304;3058;10305;2561;9290;1125;4438;445;1616;1570;6054
310810;201304;1496;4278;1405;4134;360;1192;721;2038;1081;3230
310820;201304;1423;4228;1090;3662;334;1223;379;1230;713;2453
310825;201304;2187;7947;1882;7406;175;862;1400;5483;1575;6345
310830;201304;1467;5117;1250;4669;490;1960;441;1625;931;3585
310840;201304;2148;7450;1989;7130;752;2956;624;2113;1376;5069
310850;201304;1395;4537;1229;4307;266;1043;750;2608;1016;3651
310855;201304;2963;10014;2722;9616;796;2943;1373;5045;2169;7988
310860;201304;7525;24530;6844;23393;1188;4361;4119;14440;5307;18801
310870;201304;934;2951;841;2778;185;708;432;1421;617;2129
310880;201304;1216;3886;934;3345;204;830;457;1642;661;2472
310890;201304;2557;8443;2058;7472;696;2836;404;1381;1100;4217
310900;201304;3923;13855;3549;13048;1142;4616;1420;5066;2562;9682
310910;201304;1741;5422;1417;4860;462;1761;437;1472;899;3233
310920;201304;1731;5693;1461;5290;418;1704;705;2527;1123;4231
310925;201304;885;3023;801;2870;322;1254;214;770;536;2024
310930;201304;4820;15697;4325;14906;1092;3844;2478;8774;3570;12618
310940;201304;6037;18673;5327;17585;983;3732;3139;10200;4122;13932
310945;201304;1240;3654;1011;3337;237;904;564;1810;801;2714
310950;201304;1751;6262;1545;5838;655;2678;433;1563;1088;4241
310960;201304;439;1538;395;1454;142;579;140;510;282;1089
310970;201304;1444;5190;1127;4308;467;1925;145;514;612;2439
310980;201304;439;1196;319;977;60;214;143;398;203;612
310990;201304;1095;3906;963;3645;235;1021;376;1327;611;2348
311000;201304;4535;16259;4083;15305;1359;5647;1478;5347;2837;10994
311010;201304;920;3052;814;2856;259;965;377;1294;636;2259
311020;201304;862;2782;748;2586;80;322;530;1826;610;2148
311030;201304;1640;5335;1402;4808;473;1785;529;1645;1002;3430
311040;201304;453;1604;405;1474;125;472;115;403;240;875
311050;201304;2438;8135;2054;7327;704;2732;744;2644;1448;5376
311060;201304;2110;6911;1791;6209;557;2073;415;1423;972;3496
311070;201304;1686;6151;1491;5734;478;2052;459;1749;937;3801
311080;201304;1175;3259;1062;3095;180;614;701;2042;881;2656
311090;201304;1561;6172;1379;5786;508;2396;323;1306;831;3702
311100;201304;2195;7948;2017;7582;958;3737;523;1998;1481;5735
311110;201304;3614;9179;2795;8093;657;2170;1502;4203;2159;6373
311115;201304;1059;3420;925;3214;128;535;630;2215;758;2750
311120;201304;8083;24739;6988;22755;2525;9229;2105;6412;4630;15641
311130;201304;2344;7331;1930;6809;706;2809;778;2641;1484;5450
311140;201304;1166;3572;1019;3399;194;751;692;2246;886;2997
311150;201304;2371;8008;2194;7726;497;1746;1290;4736;1787;6482
311160;201304;4705;16392;4067;15374;1569;6324;1392;5221;2961;11545
311170;201304;691;2300;590;2090;82;320;361;1330;443;1650
311180;201304;1521;4328;1100;3480;344;1198;210;580;554;1778
311190;201304;1078;3364;933;3064;228;846;446;1424;674;2270
311200;201304;2433;7704;2178;7208;990;3562;500;1494;1490;5056
311205;201304;1110;3808;1010;3623;262;1072;395;1482;657;2554
311210;201304;890;2983;832;2887;131;462;617;2182;748;2644
311220;201304;871;2922;738;2629;203;750;254;889;457;1639
311230;201304;8554;26959;7507;25190;1640;6073;4081;13941;5721;20014
311240;201304;1288;4120;1120;3839;390;1497;332;1094;722;2591
311250;201304;1286;4435;1166;4219;382;1500;381;1282;763;2782
311260;201304;2824;7911;2172;6753;715;2445;661;1930;1376;4375
311265;201304;1252;3517;1009;3200;150;595;719;2250;869;2845
311270;201304;3235;11202;2967;10846;628;2632;1936;7021;2564;9653
311280;201304;1308;3754;1030;3282;299;1071;323;1004;622;2075
311290;201304;2271;7610;2115;7279;405;1372;1249;4511;1654;5883
311300;201304;4905;17018;4532;16460;696;2857;3113;11402;3809;14259
311310;201304;480;1757;461;1723;106;490;200;690;306;1180
311320;201304;3900;13586;3416;12488;1083;4459;1133;3940;2216;8399
311330;201304;5287;16803;4653;15830;1680;6192;1818;6133;3498;12325
311340;201304;11939;39975;11169;38497;4436;16418;3172;10893;7608;27311
311350;201304;2095;6681;1857;6270;478;1895;836;2698;1314;4593
311360;201304;1276;3717;1017;3362;476;1662;285;973;761;2635
311370;201304;4328;13558;3942;12898;1085;4222;1720;5452;2805;9674
311380;201304;459;1573;394;1444;133;545;122;412;255;957
311390;201304;1890;7207;1813;7042;778;3295;587;2229;1365;5524
311400;201304;1644;5675;1533;5476;487;1975;656;2160;1143;4135
311410;201304;1941;7223;1830;7063;699;2896;811;3136;1510;6032
311420;201304;2170;7851;1992;7416;787;3099;428;1439;1215;4538
311430;201304;3526;11614;2841;10073;706;2757;595;2065;1301;4822
311440;201304;2043;7437;1773;7016;856;3687;434;1693;1290;5380
311450;201304;2387;8753;2151;8230;912;3729;635;2329;1547;6058
311455;201304;1478;4139;1316;3897;284;960;731;2110;1015;3070
311460;201304;580;1989;470;1744;129;588;117;417;246;1005
311470;201304;551;1837;472;1670;144;588;164;559;308;1147
311480;201304;758;2285;738;2252;239;773;348;1017;587;1790
311490;201304;307;1256;297;1218;108;466;101;415;209;881
311500;201304;490;1536;401;1356;185;682;105;338;290;1020
311510;201304;2969;9610;2530;8787;1017;3911;666;2201;1683;6112
311520;201304;664;2342;635;2281;254;973;256;897;510;1870
311530;201304;9526;27110;6879;22201;2286;8655;1808;5513;4094;14168
311535;201304;647;2095;499;1782;147;594;121;419;268;1013
311540;201304;666;2530;639;2490;234;942;302;1165;536;2107
311545;201304;1921;6578;1873;6499;395;1481;1220;4258;1615;5739
311547;201304;1617;4685;1409;4359;158;531;968;3035;1126;3566
311550;201304;3111;10741;2841;10208;1059;4277;911;3168;1970;7445
311560;201304;244;694;228;676;59;191;129;369;188;560
311570;201304;1823;4916;1608;4685;142;455;1376;4021;1518;4476
311580;201304;1973;4908;1842;4754;508;1283;1105;2907;1613;4190
311590;201304;344;1151;308;1097;91;380;89;307;180;687
311600;201304;1257;3926;1093;3719;236;797;637;2324;873;3121
311610;201304;3665;12886;3415;12498;932;3399;1790;7077;2722;10476
311615;201304;2372;8375;2169;8038;279;1094;1583;6000;1862;7094
311620;201304;422;1432;380;1371;99;423;198;681;297;1104
311630;201304;1443;4417;1253;4047;211;742;765;2449;976;3191
311640;201304;823;2627;719;2461;102;386;544;1853;646;2239
311650;201304;2392;7043;2012;6417;332;1218;1175;3777;1507;4995
311660;201304;2383;8797;2223;8438;740;3150;599;2012;1339;5162
311670;201304;1264;4167;1133;3916;445;1704;417;1365;862;3069
311680;201304;2169;7094;1863;6693;344;1298;1234;4565;1578;5863
311690;201304;469;1397;412;1338;94;339;256;809;350;1148
311700;201304;2085;6345;1893;6069;216;865;1446;4553;1662;5418
311710;201304;1556;5100;1283;4593;569;2181;372;1352;941;3533
311720;201304;378;1333;364;1312;55;212;265;944;320;1156
311730;201304;3375;10800;2769;9588;882;3324;1151;3796;2033;7120
311740;201304;987;2915;865;2771;377;1195;390;1319;767;2514
311750;201304;3674;12901;3480;12640;626;2535;2363;8611;2989;11146
311760;201304;764;2751;714;2628;268;1125;201;616;469;1741
311770;201304;2565;8349;2169;7677;656;2626;742;2535;1398;5161
311780;201304;897;3502;782;3197;290;1324;88;339;378;1663
311783;201304;2002;6799;1813;6443;215;938;1190;4327;1405;5265
311787;201304;661;2328;519;1922;124;499;120;399;244;898
311790;201304;1073;3706;920;3370;304;1202;174;602;478;1804
311800;201304;4668;16731;3990;14748;1311;5144;719;2277;2030;7421
311810;201304;1004;3446;982;3408;35;168;900;3092;935;3260
311820;201304;771;2605;685;2435;255;1035;295;951;550;1986
311830;201304;9948;36902;9353;35423;4038;16068;2317;8720;6355;24788
311840;201304;3250;10088;2776;9357;990;3644;983;3274;1973;6918
311850;201304;305;949;264;883;74;273;123;401;197;674
311860;201304;53273;177689;48059;167444;15477;58748;19804;67197;35281;125945
311870;201304;2206;6873;1863;6228;505;1925;721;2317;1226;4242
311880;201304;6457;21217;6065;20716;880;3147;4487;15735;5367;18882
311890;201304;1552;5071;1340;4632;444;1694;533;1777;977;3471
311900;201304;779;2501;703;2389;173;608;408;1449;581;2057
311910;201304;4553;13988;3759;12867;1227;4576;1493;5159;2720;9735
311920;201304;1921;6622;1697;6312;261;1108;1191;4376;1452;5484
311930;201304;4591;14357;4194;13712;1609;5720;1401;4561;3010;10281
311940;201304;13935;44629;12560;41827;4690;16898;3723;12303;8413;29201
311950;201304;2098;6679;1883;6397;167;606;1548;5289;1715;5895
311960;201304;350;1282;328;1239;98;381;171;655;269;1036
311970;201304;444;1653;396;1552;159;675;61;216;220;891
311980;201304;703;2041;561;1848;145;512;252;850;397;1362
311990;201304;448;1447;419;1395;183;619;146;481;329;1100
311995;201304;978;3100;782;2679;265;1025;244;736;509;1761
312000;201304;656;2139;630;2099;118;457;383;1266;501;1723
312010;201304;998;3321;930;3198;210;789;435;1486;645;2275
312015;201304;1532;4933;1347;4620;205;834;830;2862;1035;3696
312020;201304;869;2938;781;2811;238;959;385;1339;623;2298
312030;201304;1621;5359;1492;5187;268;1112;1026;3465;1294;4577
312040;201304;673;2660;626;2531;253;1100;173;690;426;1790
312050;201304;1472;5211;1287;4821;484;1997;351;1265;835;3262
312060;201304;772;2424;700;2338;236;862;379;1222;615;2084
312070;201304;815;2663;582;2162;176;721;210;757;386;1478
312080;201304;2515;7325;2024;6540;560;2223;897;2614;1457;4837
312083;201304;850;2644;739;2488;78;315;505;1695;583;2010
312087;201304;2205;7136;1992;6858;403;1450;1351;4751;1754;6201
312090;201304;9398;31601;8718;30413;2620;10293;3941;13210;6561;23503
312100;201304;1329;4651;1198;4451;267;1119;668;2528;935;3647
312110;201304;1174;4351;1074;4147;436;1855;223;792;659;2647
312120;201304;876;3110;798;2935;264;1117;220;702;484;1819
312125;201304;1013;3433;908;3188;254;987;357;1190;611;2177
312130;201304;705;2269;593;2037;189;719;216;715;405;1434
312140;201304;1405;4535;1209;4073;322;1140;440;1420;762;2560
312150;201304;583;1718;518;1609;107;397;303;893;410;1290
312160;201304;7607;27403;7124;26422;2383;9543;2840;10806;5223;20349
312170;201304;991;3100;919;2958;166;578;568;1866;734;2444
312180;201304;1521;4990;1461;4895;505;1752;601;2054;1106;3806
312190;201304;588;2036;489;1847;205;827;122;455;327;1282
312200;201304;4251;13901;3772;13004;588;2176;2490;8648;3078;10824
312210;201304;1084;3170;908;2926;237;866;456;1412;693;2278
312220;201304;1767;6025;1624;5852;335;1202;1104;4199;1439;5401
312230;201304;16798;58274;14694;53928;7247;28160;2648;10044;9895;38204
312235;201304;1722;5065;1430;4598;190;749;972;3135;1162;3884
312240;201304;1080;3799;948;3524;295;1162;325;1217;620;2379
312245;201304;2286;6961;2026;6601;178;518;1678;5627;1856;6145
312247;201304;853;2645;689;2406;209;782;348;1260;557;2042
312250;201304;1051;3317;983;3208;196;753;581;1855;777;2608
312260;201304;872;2987;769;2851;117;534;539;1965;656;2499
312270;201304;764;2516;667;2320;189;788;206;605;395;1393
312280;201304;460;1616;423;1520;182;703;47;161;229;864
312290;201304;696;2515;652;2455;312;1302;122;453;434;1755
312300;201304;1039;3561;906;3256;311;1188;132;418;443;1606
312310;201304;895;3562;814;3348;280;1241;322;1302;602;2543
312320;201304;2366;6800;2032;6214;597;2105;659;1733;1256;3838
312330;201304;1040;3366;969;3254;367;1363;386;1274;753;2637
312340;201304;291;797;277;778;41;151;216;575;257;726
312350;201304;350;942;336;922;50;161;268;705;318;866
312352;201304;1570;5382;1480;5248;513;1857;768;2798;1281;4655
312360;201304;3483;12229;3091;11390;1091;4275;681;2521;1772;6796
312370;201304;1577;5379;1465;5178;490;1937;563;1926;1053;3863
312380;201304;1859;5709;1766;5578;279;964;1191;3848;1470;4812
312385;201304;1117;3751;1087;3705;151;620;805;2667;956;3287
312390;201304;1909;6755;1743;6387;629;2481;439;1562;1068;4043
312400;201304;3200;11109;3015;10754;1010;3737;1440;5262;2450;8999
312410;201304;9847;34439;9013;32722;3020;11944;2988;10574;6008;22518
312420;201304;3827;12852;3665;12660;693;2471;2576;9123;3269;11594
312430;201304;8190;25432;7270;24058;1517;5255;4467;15350;5984;20605
312440;201304;500;1740;445;1632;159;623;151;546;310;1169
312450;201304;1072;4150;1024;4026;491;1911;332;1337;823;3248
312460;201304;373;1200;336;1158;92;369;152;481;244;850
312470;201304;711;2089;497;1656;148;572;95;297;243;869
312480;201304;1226;3996;1079;3819;429;1583;433;1522;862;3105
312490;201304;2250;6073;1832;5545;308;1116;1104;3221;1412;4337
312500;201304;564;2095;535;2042;157;674;268;1010;425;1684
312510;201304;1705;6224;1529;5807;483;2068;451;1534;934;3602
312520;201304;357;1285;331;1228;123;483;109;407;232;890
312530;201304;545;1857;519;1800;113;459;278;913;391;1372
312540;201304;1427;4816;1206;4361;249;993;699;2507;948;3500
312550;201304;568;1989;538;1921;76;315;353;1243;429;1558
312560;201304;1867;5441;1751;5278;261;825;1256;3861;1517;4686
312570;201304;2592;8278;2312;7755;797;2891;671;2174;1468;5065
312580;201304;513;1785;422;1598;115;497;181;653;296;1150
312590;201304;1771;6276;1567;5818;570;2353;515;1782;1085;4135
312595;201304;1988;7007;1815;6604;365;1437;1075;3880;1440;5317
312600;201304;739;2798;699;2702;237;1011;240;864;477;1875
312610;201304;8167;26526;7148;24505;2792;10297;2047;6827;4839;17124
312620;201304;1906;5821;1527;5354;114;357;1263;4627;1377;4984
312630;201304;481;1672;451;1618;127;529;193;651;320;1180
312640;201304;554;1870;479;1720;124;521;223;756;347;1277
312650;201304;2259;6955;1646;5773;182;766;870;3002;1052;3768
312660;201304;1174;3437;1026;3234;218;795;599;1835;817;2630
312670;201304;5761;18873;5490;18454;870;3385;3904;13050;4774;16435
312675;201304;1422;4699;1298;4455;274;1022;743;2609;1017;3631
312680;201304;1652;5200;1489;4904;311;1154;859;2860;1170;4014
312690;201304;2297;6606;1971;6169;422;1568;1126;3365;1548;4933
312695;201304;842;3124;796;3049;140;559;534;2092;674;2651
312700;201304;2057;6214;1595;5324;352;1342;807;2644;1159;3986
312705;201304;1350;4165;1204;3966;226;758;797;2669;1023;3427
312707;201304;1782;5696;1524;5254;364;1433;739;2536;1103;3969
312710;201304;7575;22433;5886;19428;2423;8860;1414;4356;3837;13216
312720;201304;726;2507;663;2393;201;807;263;890;464;1697
312730;201304;1793;4805;1423;4390;243;884;890;2732;1133;3616
312733;201304;1691;4746;1387;4185;143;542;968;2827;1111;3369
312735;201304;814;2654;734;2511;262;954;322;1087;584;2041
312737;201304;936;2389;704;2085;165;532;378;1153;543;1685
312738;201304;486;1610;401;1450;143;602;149;484;292;1086
312740;201304;480;1408;338;1231;136;536;103;376;239;912
312750;201304;1263;4772;1213;4668;341;1447;573;2198;914;3645
312760;201304;2289;7757;1889;6989;665;2699;454;1698;1119;4397
312770;201304;41184;117813;32817;105550;10422;36350;10826;35080;21248;71430
312780;201304;2333;9022;2133;8685;448;1959;1286;5427;1734;7386
312790;201304;294;881;243;799;80;279;67;214;147;493
312800;201304;4760;17073;4301;16082;1509;6026;1352;5217;2861;11243
312810;201304;2129;6753;1672;6029;722;2841;476;1665;1198;4506
312820;201304;2020;6324;1935;6173;276;1040;1272;3936;1548;4976
312825;201304;1469;4174;1313;3978;143;475;1051;3161;1194;3636
312830;201304;2538;8421;1923;7179;632;2681;254;861;886;3542
312840;201304;1030;3651;908;3424;279;1178;298;1069;577;2247
312850;201304;661;2269;589;2112;180;721;203;718;383;1439
312860;201304;1289;3834;1024;3461;378;1512;396;1184;774;2696
312870;201304;5387;17563;4312;15625;1473;6074;1296;4488;2769;10562
312880;201304;1071;3364;911;3091;305;1171;369;1145;674;2316
312890;201304;1485;4776;1198;4258;468;1849;362;1233;830;3082
312900;201304;1265;4479;1231;4429;466;1714;567;2082;1033;3796
312910;201304;1435;3518;1196;3200;341;1106;575;1413;916;2519
312920;201304;897;3097;797;2943;287;1147;320;1169;607;2316
312930;201304;2078;6491;1889;6204;453;1595;995;3332;1448;4927
312940;201304;889;3107;800;2930;270;1137;234;798;504;1935
312950;201304;3148;9451;2698;8810;935;3295;1191;3908;2126;7203
312960;201304;1827;5816;1647;5572;223;755;1218;4241;1441;4996
312965;201304;1682;5703;1492;5359;368;1412;825;3050;1193;4462
312970;201304;1107;3884;996;3733;464;1934;163;610;627;2544
312980;201304;19454;71084;18896;69733;7782;30643;6913;24907;14695;55550
312990;201304;335;1100;274;1001;120;487;74;253;194;740
313000;201304;485;1745;454;1689;161;695;124;418;285;1113
313005;201304;2437;8309;2190;7893;312;1325;1538;5498;1850;6823
313010;201304;3682;12852;3328;12240;1091;4425;1314;4547;2405;8972
313020;201304;1001;3441;924;3284;316;1277;346;1098;662;2375
313030;201304;1520;4447;1248;4060;357;1309;643;1983;1000;3292
313040;201304;929;3345;796;2957;207;841;207;727;414;1568
313050;201304;1755;5992;1503;5586;534;2173;476;1702;1010;3875
313055;201304;1342;4760;1265;4645;124;453;983;3725;1107;4178
313060;201304;906;3264;861;3164;413;1570;158;580;571;2150
313065;201304;1836;6355;1725;6189;251;1064;1281;4523;1532;5587
313070;201304;1107;3490;956;3216;259;1033;503;1583;762;2616
313080;201304;432;1440;363;1303;122;495;98;299;220;794
313090;201304;4558;15107;4408;14867;1042;3658;2757;9553;3799;13211
313100;201304;961;3264;907;3192;179;741;603;2026;782;2767
313110;201304;1609;5010;1303;4426;350;1412;525;1653;875;3065
313115;201304;2822;10352;2709;10128;976;4041;1154;4084;2130;8125
313120;201304;3661;10990;3190;10313;1173;3990;1361;4478;2534;8468
313130;201304;25028;82703;23073;78576;7222;27332;8583;27811;15805;55143
313140;201304;734;1964;544;1659;60;230;331;984;391;1214
313150;201304;1596;5158;1459;4913;670;2327;395;1378;1065;3705
313160;201304;1155;3593;1044;3422;263;995;582;1829;845;2824
313170;201304;9186;35164;8766;34046;3733;15010;1934;7649;5667;22659
313180;201304;2586;7051;2051;6371;677;2375;712;2165;1389;4540
313190;201304;3175;12233;3096;12050;957;3910;1333;5218;2290;9128
313200;201304;1408;4653;1277;4436;211;901;795;2744;1006;3645
313210;201304;4460;14687;3849;13857;922;3683;2144;7716;3066;11399
313220;201304;1065;3502;935;3231;292;1159;231;697;523;1856
313230;201304;2323;8649;2237;8510;434;1734;1374;5457;1808;7191
313240;201304;7146;26042;6372;24509;2052;8558;2470;9530;4522;18088
313250;201304;7456;24519;7023;23984;811;2644;5434;19409;6245;22053
313260;201304;558;1854;489;1713;163;644;133;445;296;1089
313270;201304;5078;16010;4665;15387;1131;3963;2747;9232;3878;13195
313280;201304;507;1774;441;1616;114;485;170;603;284;1088
313290;201304;1021;3791;881;3501;307;1310;214;795;521;2105
313300;201304;1876;6672;1700;6259;568;2271;489;1707;1057;3978
313310;201304;1022;3696;943;3521;299;1263;224;787;523;2050
313320;201304;2297;7333;1993;6801;385;1382;996;3466;1381;4848
313330;201304;3695;12889;3432;12393;773;3110;1793;6514;2566;9624
313340;201304;2106;5230;1655;4592;351;1068;959;2587;1310;3655
313350;201304;3219;10381;2581;8978;872;3335;573;1839;1445;5174
313360;201304;1140;3658;900;3171;329;1333;351;1109;680;2442
313370;201304;1394;5013;1337;4859;300;1257;608;2059;908;3316
313375;201304;1814;5025;1283;4300;297;1224;631;2055;928;3279
313380;201304;6324;22546;5609;20963;2412;9588;1402;4979;3814;14567
313390;201304;868;3298;833;3236;149;685;517;1968;666;2653
313400;201304;3555;11109;3303;10804;450;1560;2501;8280;2951;9840
313410;201304;1335;3967;1155;3733;249;895;712;2294;961;3189
313420;201304;17658;46078;11953;35611;3159;10709;3209;9173;6368;19882
313430;201304;1263;4291;1146;4084;384;1518;410;1431;794;2949
313440;201304;6095;15272;4750;13730;826;2585;3321;9639;4147;12224
313450;201304;678;2094;581;1910;171;687;200;578;371;1265
313460;201304;2587;9478;2369;9111;932;3877;741;2730;1673;6607
313470;201304;3342;9648;3202;9485;371;1036;2638;7985;3009;9021
313480;201304;1073;3325;832;2884;199;783;328;1099;527;1882
313490;201304;1171;4522;1061;4232;469;1830;196;818;665;2648
313500;201304;423;1389;403;1355;106;410;232;757;338;1167
313505;201304;7779;24634;7389;24135;529;1456;6462;21826;6991;23282
313507;201304;1260;3957;1148;3784;262;984;662;2191;924;3175
313510;201304;15240;47207;13825;45407;2607;9113;9275;30950;11882;40063
313520;201304;15384;48483;13514;45557;2005;7901;9166;30783;11171;38684
313530;201304;501;1807;445;1663;70;302;192;678;262;980
313535;201304;2383;7487;2169;7137;388;1403;1364;4534;1752;5937
313540;201304;1113;3595;937;3178;292;1065;261;835;553;1900
313545;201304;1343;5125;1207;4888;231;1105;767;3041;998;4146
313550;201304;1838;6581;1791;6471;508;1995;964;3368;1472;5363
313560;201304;2179;5703;1971;5461;190;518;1616;4587;1806;5105
313570;201304;741;2882;671;2740;253;1106;282;1137;535;2243
313580;201304;5836;17452;5269;16709;652;2209;4059;12981;4711;15190
313590;201304;1040;3236;867;3033;335;1181;464;1686;799;2867
313600;201304;3780;11873;3395;11251;709;2622;2016;6720;2725;9342
313610;201304;1093;3568;962;3305;283;1045;379;1285;662;2330
313620;201304;7339;25174;6939;24306;2443;9121;2335;8023;4778;17144
313630;201304;8034;26318;7184;25079;2430;9291;2430;8814;4860;18105
313640;201304;821;2707;734;2591;265;1017;302;1057;567;2074
313650;201304;2255;7603;2019;7214;310;1166;1460;5334;1770;6500
313652;201304;972;3636;907;3492;190;776;539;2079;729;2855
313655;201304;908;3206;796;3029;186;820;505;1868;691;2688
313657;201304;1038;3730;1003;3667;190;896;656;2203;846;3099
313660;201304;852;3087;790;2978;229;997;395;1412;624;2409
313665;201304;3447;11895;3252;11500;950;3783;1435;4875;2385;8658
313670;201304;49831;150622;36916;129281;13007;49601;11501;39306;24508;88907
313680;201304;1065;3287;952;3124;124;425;680;2270;804;2695
313690;201304;854;3164;806;3085;248;956;329;1329;577;2285
313695;201304;1455;4963;1271;4673;205;891;889;3220;1094;4111
313700;201304;3705;13019;3229;12339;469;1906;2339;9025;2808;10931
313710;201304;1335;3942;1154;3684;326;1155;636;1963;962;3118
313720;201304;4951;17370;4445;16236;1308;5338;1409;4662;2717;10000
313730;201304;1214;3532;1012;3275;149;523;687;2263;836;2786
313740;201304;1981;7402;1660;6547;679;2977;238;892;917;3869
313750;201304;2845;8976;2539;8395;859;3110;694;2132;1553;5242
313753;201304;1751;5511;1539;5136;496;1790;644;2161;1140;3951
313760;201304;4272;14799;3782;13763;1373;5592;1173;4015;2546;9607
313770;201304;3570;12390;3421;12043;1268;4701;1043;3698;2311;8399
313780;201304;3684;11101;3039;10127;957;3560;1215;3987;2172;7547
313790;201304;548;1957;531;1929;107;419;314;1152;421;1571
313800;201304;1211;3578;1103;3402;184;660;716;2183;900;2843
313810;201304;1363;4490;1313;4411;330;1131;739;2558;1069;3689
313820;201304;12453;37849;10348;33999;3409;12447;3324;10852;6733;23299
313830;201304;456;1631;393;1494;157;675;103;366;260;1041
313835;201304;1048;3633;1011;3571;237;910;558;1973;795;2883
313840;201304;6866;21863;6048;20509;1913;7298;2197;7190;4110;14488
313850;201304;1223;3537;1126;3369;244;852;672;1918;916;2770
313860;201304;2481;8058;2213;7508;740;2788;543;1674;1283;4462
313862;201304;881;2659;659;2292;238;890;173;571;411;1461
313865;201304;2134;7080;2013;6865;336;1312;1396;4686;1732;5998
313867;201304;946;3412;823;3157;255;1030;339;1324;594;2354
313868;201304;1414;5294;1312;5078;229;960;827;3248;1056;4208
313870;201304;910;2889;808;2719;217;856;375;1185;592;2041
313880;201304;2222;7296;2042;7031;509;2072;1038;3291;1547;5363
313890;201304;1939;5612;1685;5307;195;633;1249;4025;1444;4658
313900;201304;4412;16706;4196;16261;1763;7474;1109;4308;2872;11782
313910;201304;738;2591;639;2376;295;1201;128;443;423;1644
313920;201304;3447;11612;3235;11236;516;1777;2157;7863;2673;9640
313925;201304;2085;5719;1589;4815;141;503;1072;3222;1213;3725
313930;201304;5092;17454;4432;16298;879;3570;2583;9691;3462;13261
313940;201304;7532;27380;6674;25971;2765;11445;2333;9354;5098;20799
313950;201304;4471;13720;3897;12773;1198;4384;1514;4903;2712;9287
313960;201304;5523;16086;4843;15099;1718;5990;1391;4374;3109;10364
313970;201304;1407;4303;1211;4080;268;981;749;2538;1017;3519
313980;201304;1147;3961;993;3667;324;1328;249;887;573;2215
313990;201304;1992;7722;1807;7308;711;3108;526;2020;1237;5128
314000;201304;7493;27132;7042;26254;2239;9076;3412;12664;5651;21740
314010;201304;1016;3121;862;2930;191;733;453;1508;644;2241
314015;201304;1564;6020;1453;5761;583;2425;422;1712;1005;4137
314020;201304;474;1587;410;1444;161;625;131;440;292;1065
314030;201304;809;2679;648;2304;163;692;191;603;354;1295
314040;201304;669;2102;612;2010;80;311;455;1471;535;1782
314050;201304;1833;6168;1558;5590;512;2039;417;1378;929;3417
314053;201304;1301;4645;1249;4577;233;834;899;3378;1132;4212
314055;201304;2161;6703;1980;6454;223;751;1490;4970;1713;5721
314060;201304;1060;3528;932;3291;156;651;556;1925;712;2576
314070;201304;3491;11626;2947;10514;953;3765;890;3082;1843;6847
314080;201304;1749;5709;1356;4856;352;1450;351;1154;703;2604
314085;201304;1732;6486;1541;6225;541;2396;643;2616;1184;5012
314090;201304;3406;12043;3147;11536;1055;4124;1228;4634;2283;8758
314100;201304;3284;9430;2920;8903;416;1322;2148;6657;2564;7979
314110;201304;4294;14637;3811;13609;1039;4291;1474;4868;2513;9159
314120;201304;904;2267;541;1724;213;778;129;376;342;1154
314130;201304;610;1916;412;1457;139;550;81;266;220;816
314140;201304;4879;15872;4485;15153;1151;4217;2353;8016;3504;12233
314150;201304;1649;4594;1347;4140;230;788;828;2525;1058;3313
314160;201304;2149;6269;1885;5925;206;723;1510;4757;1716;5480
314170;201304;1027;3347;901;3069;183;734;482;1566;665;2300
314180;201304;6231;21102;5774;20430;1714;6588;2695;9707;4409;16295
314190;201304;801;2618;716;2476;229;902;283;937;512;1839
314200;201304;2960;10023;2733;9620;464;1866;1828;6348;2292;8214
314210;201304;1864;6222;1710;5917;459;1723;830;2785;1289;4508
314220;201304;1600;5515;1425;5140;481;1909;492;1604;973;3513
314225;201304;1135;3638;1026;3483;63;181;925;3207;988;3388
314230;201304;692;2485;647;2394;216;865;230;822;446;1687
314240;201304;1077;3560;997;3428;304;1035;540;1920;844;2955
314250;201304;479;1571;419;1456;160;612;134;424;294;1036
314260;201304;1272;4709;1230;4632;459;1825;514;1974;973;3799
314270;201304;2644;9528;2503;9264;395;1587;1613;6037;2008;7624
314280;201304;3106;9277;2341;7823;779;2989;646;1899;1425;4888
314290;201304;5202;15270;4538;14230;598;2081;3263;10254;3861;12335
314300;201304;1881;6603;1788;6383;630;2389;734;2582;1364;4971
314310;201304;6140;20615;5541;19280;2409;8922;1170;3941;3579;12863
314315;201304;947;3708;890;3592;170;763;509;2094;679;2857
314320;201304;3196;10139;2692;9432;1052;4009;854;2913;1906;6922
314330;201304;49537;168448;47645;165013;15706;58834;22007;75448;37713;134282
314340;201304;1985;5905;1259;4388;347;1376;155;369;502;1745
314345;201304;1268;4479;1137;4270;398;1534;529;2085;927;3619
314350;201304;1238;4040;1095;3788;486;1816;281;959;767;2775
314360;201304;682;2255;544;2004;184;790;135;444;319;1234
314370;201304;536;1968;505;1929;169;707;256;957;425;1664
314380;201304;975;3173;797;2872;330;1247;240;868;570;2115
314390;201304;14503;45969;12479;42076;4314;15731;3816;12693;8130;28424
314400;201304;5160;15237;4311;14047;1030;3283;2793;9478;3823;12761
314410;201304;2421;8214;2198;7772;733;2916;869;2893;1602;5809
314420;201304;753;2299;636;2138;102;420;466;1533;568;1953
314430;201304;8060;24795;7287;23364;2574;8988;2303;7589;4877;16577
314435;201304;1111;3893;1011;3683;233;1050;519;1770;752;2820
314437;201304;1123;2977;1021;2839;100;285;812;2277;912;2562
314440;201304;729;2056;511;1770;198;768;113;369;311;1137
314450;201304;1689;5216;1462;4891;479;1904;681;2114;1160;4018
314460;201304;4504;16146;4071;15201;1508;6111;804;3043;2312;9154
314465;201304;2327;7702;2143;7358;235;963;1625;5504;1860;6467
314467;201304;1056;3201;961;3044;435;1413;350;1145;785;2558
314470;201304;2294;7787;1817;6627;587;2446;385;1186;972;3632
314480;201304;6990;24914;5484;20798;1482;6085;601;2098;2083;8183
314490;201304;919;2939;803;2712;259;1019;320;1005;579;2024
314500;201304;2721;7980;2225;7007;725;2560;746;2314;1471;4874
314505;201304;1680;5555;1601;5404;420;1570;851;2841;1271;4411
314510;201304;1424;4710;1243;4375;548;2033;349;1225;897;3258
314520;201304;3460;14031;3046;12805;1234;5585;587;2319;1821;7904
314530;201304;7043;25938;6496;25031;1304;5271;3867;15427;5171;20698
314535;201304;2593;7818;2338;7482;374;1386;1558;4987;1932;6373
314537;201304;1419;4499;1218;4146;281;1063;618;2194;899;3257
314540;201304;457;1443;402;1316;133;501;124;376;257;877
314545;201304;1249;4266;1165;4132;245;951;667;2389;912;3340
314550;201304;499;1639;430;1544;167;694;119;404;286;1098
314560;201304;5099;18763;4462;17053;1417;5874;928;3524;2345;9398
314570;201304;370;1190;335;1120;100;360;159;511;259;871
314580;201304;451;1605;392;1488;168;697;91;332;259;1029
314585;201304;629;2336;542;2161;179;790;135;529;314;1319
314587;201304;1669;5626;1562;5404;279;1049;930;3215;1209;4264
314590;201304;3895;13973;3040;11643;840;3451;411;1454;1251;4905
314600;201304;1991;7071;1678;6511;660;2850;291;1047;951;3897
314610;201304;7866;29298;7452;28317;2706;11054;2241;8344;4947;19398
314620;201304;1595;5064;1495;4940;228;726;1110;3793;1338;4519
314625;201304;1318;4501;1272;4414;256;959;769;2737;1025;3696
314630;201304;4886;15105;4310;14139;584;2181;3016;10056;3600;12237
314640;201304;794;2401;710;2253;260;896;213;639;473;1535
314650;201304;1218;3908;1014;3501;293;1176;423;1326;716;2502
314655;201304;1669;5235;1372;4703;260;993;763;2606;1023;3599
314660;201304;144;443;133;422;36;125;74;230;110;355
314670;201304;1351;3968;1145;3604;248;861;610;1901;858;2762
314675;201304;1854;5857;1668;5532;230;839;1107;3746;1337;4585
314690;201304;2701;8837;2320;8151;761;3029;705;2325;1466;5354
314700;201304;9676;37915;8833;36149;4267;18170;2023;8756;6290;26926
314710;201304;7505;25435;5663;21234;1592;6691;744;2588;2336;9279
314720;201304;2576;8911;2200;8178;758;3112;898;3265;1656;6377
314730;201304;2349;7713;2052;7278;706;2790;654;2213;1360;5003
314740;201304;2874;10103;2678;9722;956;3734;992;3489;1948;7223
314750;201304;312;1068;293;1026;65;278;159;526;224;804
314760;201304;1797;6632;1417;5581;362;1633;256;848;618;2481
314770;201304;1171;3832;818;2859;151;620;104;287;255;907
314780;201304;282;826;217;743;81;305;87;297;168;602
314790;201304;13083;41350;10184;36145;4223;16899;2417;8062;6640;24961
314795;201304;1433;4581;1291;4353;149;665;967;3133;1116;3798
314800;201304;16533;52157;14116;47375;6043;21348;2931;10112;8974;31460
314810;201304;12461;39313;9989;34717;3451;13497;2516;8627;5967;22124
314820;201304;1027;2996;748;2621;323;1238;244;782;567;2020
314830;201304;1604;5701;1413;5319;563;2312;463;1745;1026;4057
314840;201304;1127;4044;908;3715;185;854;536;2216;721;3070
314850;201304;2168;6569;1907;6170;404;1509;1060;3403;1464;4912
314860;201304;3188;11519;3008;11238;610;2477;1902;7186;2512;9663
314870;201304;5529;18622;5006;17881;892;3565;3294;12012;4186;15577
314875;201304;1652;5862;1623;5819;303;1003;1251;4627;1554;5630
314880;201304;745;2342;687;2220;112;386;436;1400;548;1786
314890;201304;571;1820;423;1513;140;556;97;294;237;850
314900;201304;335;1120;285;1037;87;340;137;483;224;823
314910;201304;1653;5951;1490;5689;700;2898;361;1294;1061;4192
314915;201304;2376;7688;2140;7367;215;905;1746;5966;1961;6871
314920;201304;630;1915;516;1766;102;404;270;882;372;1286
314930;201304;4918;17331;4367;16114;1623;6578;920;3360;2543;9938
314940;201304;405;1240;382;1198;89;272;210;665;299;937
314950;201304;360;1309;319;1216;100;429;57;199;157;628
314960;201304;761;2588;661;2395;219;870;180;616;399;1486
314970;201304;777;2917;736;2854;329;1374;241;907;570;2281
314980;201304;2187;6880;2013;6603;874;3082;316;991;1190;4073
314990;201304;2966;9910;2468;8771;1004;3868;389;1253;1393;5121
314995;201304;1457;4869;1355;4717;296;1232;839;2782;1135;4014
315000;201304;948;3031;843;2892;171;696;529;1763;700;2459
315010;201304;459;1555;394;1409;144;598;134;420;278;1018
315015;201304;1738;5624;1653;5528;345;1214;1147;3937;1492;5151
315020;201304;725;2493;661;2371;207;849;250;803;457;1652
315030;201304;996;3138;867;2898;354;1290;175;575;529;1865
315040;201304;911;2887;844;2778;113;421;598;1946;711;2367
315050;201304;1491;4698;1301;4364;510;1881;367;1177;877;3058
315053;201304;1071;3303;938;3089;271;1074;356;1085;627;2159
315057;201304;1849;6630;1538;6166;245;1018;1021;4229;1266;5247
315060;201304;933;3238;782;2838;249;980;201;755;450;1735
315070;201304;609;1878;569;1820;145;500;346;1089;491;1589
315080;201304;3303;11896;3080;11456;941;3731;1376;5151;2317;8882
315090;201304;746;2747;668;2588;195;818;235;949;430;1767
315100;201304;1146;4110;940;3641;281;1242;285;1073;566;2315
315110;201304;1552;4903;1389;4640;417;1492;589;1952;1006;3444
315120;201304;12098;31524;9520;28223;1892;6155;5389;16744;7281;22899
315130;201304;1725;5901;1580;5622;625;2452;432;1497;1057;3949
315140;201304;2229;7750;1871;6931;572;2412;503;1632;1075;4044
315150;201304;4286;12430;3475;11019;956;3470;1324;4005;2280;7475
315160;201304;1301;3789;1192;3656;234;807;762;2288;996;3095
315170;201304;1286;3978;1143;3789;294;1095;656;2200;950;3295
315180;201304;12279;40234;10143;35651;3247;13021;2621;8780;5868;21801
315190;201304;2294;6406;1879;5801;584;1954;865;2674;1449;4628
315200;201304;4000;14147;3536;13170;1196;4884;991;3555;2187;8439
315210;201304;8049;26071;7168;24494;2905;10671;2134;7173;5039;17844
315213;201304;1031;3517;994;3458;136;465;745;2677;881;3142
315217;201304;2585;9187;2262;8608;404;1724;1350;5143;1754;6867
315220;201304;9744;29996;8804;28777;1209;4411;6382;21036;7591;25447
315230;201304;2248;6389;2115;6232;148;449;1804;5380;1952;5829
315240;201304;2997;10419;2861;10186;657;2525;1649;5877;2306;8402
315250;201304;7720;26683;6349;24202;2359;10041;2032;7666;4391;17707
315260;201304;1031;3551;906;3276;384;1512;149;487;533;1999
315270;201304;856;3118;748;2880;266;1104;159;570;425;1674
315280;201304;3704;11888;3156;10656;1186;4262;817;2615;2003;6877
315290;201304;1282;3806;1018;3387;421;1554;168;542;589;2096
315300;201304;459;1394;376;1290;198;731;96;298;294;1029
315310;201304;1148;4022;1081;3923;142;598;748;2671;890;3269
315320;201304;768;2807;685;2678;251;1023;286;1166;537;2189
315330;201304;816;3036;685;2756;296;1340;132;514;428;1854
315340;201304;4018;12044;3507;11257;647;2227;2137;6969;2784;9196
315350;201304;1772;5282;1536;4965;173;523;1228;4109;1401;4632
315360;201304;1598;5628;1399;5099;388;1499;473;1668;861;3167
315370;201304;607;1873;540;1774;139;518;291;928;430;1446
315380;201304;271;995;254;945;97;375;47;175;144;550
315390;201304;1894;6890;1648;6273;611;2483;340;1282;951;3765
315400;201304;4257;13992;3970;13436;1172;4204;1938;6760;3110;10964
315410;201304;1583;4644;1342;4213;285;1094;722;2146;1007;3240
315415;201304;1022;3625;963;3514;463;1736;327;1229;790;2965
315420;201304;1494;4818;1161;4241;387;1552;276;967;663;2519
315430;201304;3842;11183;3054;9880;813;2852;1181;3939;1994;6791
315440;201304;945;2982;872;2884;139;529;577;1932;716;2461
315445;201304;2001;6164;1760;5843;295;1076;1214;4081;1509;5157
315450;201304;2413;8052;2316;7915;402;1414;1662;5820;2064;7234
315460;201304;36951;127887;33385;120205;11478;44961;9812;34085;21290;79046
315470;201304;465;1545;435;1497;102;381;248;832;350;1213
315480;201304;1368;4722;1081;4064;297;1215;257;941;554;2156
315490;201304;3171;9292;2817;8824;537;2073;1790;5380;2327;7453
315500;201304;462;1536;319;1164;77;329;129;407;206;736
315510;201304;1451;4384;1263;4067;189;756;791;2476;980;3232
315520;201304;1104;3644;949;3442;193;787;616;2179;809;2966
315530;201304;472;1712;448;1673;218;869;134;470;352;1339
315540;201304;1249;3923;1032;3592;232;1012;439;1467;671;2479
315550;201304;1559;4818;1392;4596;465;1680;622;2032;1087;3712
315560;201304;6532;23236;6237;22818;1012;4044;4330;15931;5342;19975
315570;201304;2327;7528;2209;7369;366;1359;1530;5131;1896;6490
315580;201304;2569;8296;2131;7455;644;2620;777;2556;1421;5176
315590;201304;853;2578;801;2499;118;446;582;1787;700;2233
315600;201304;2505;9466;2141;8912;331;1505;1422;6162;1753;7667
315610;201304;935;2921;826;2693;237;906;270;742;507;1648
315620;201304;323;1177;318;1166;101;386;150;556;251;942
315630;201304;971;3186;840;2963;244;901;229;794;473;1695
315640;201304;731;2403;646;2222;244;960;197;618;441;1578
315645;201304;761;2594;683;2389;264;1025;149;494;413;1519
315650;201304;1789;5587;1686;5453;167;707;1306;4105;1473;4812
315660;201304;2540;7313;2345;7056;344;1174;1676;5000;2020;6174
315670;201304;11125;40913;10309;39265;3959;16212;3321;12378;7280;28590
315680;201304;2779;10052;2344;9221;932;3841;602;2486;1534;6327
315690;201304;2928;9882;2536;9154;974;3848;666;2397;1640;6245
315700;201304;6806;22835;6141;21456;1503;5951;3000;10048;4503;15999
315710;201304;1798;5536;1494;5049;263;1085;844;2777;1107;3862
315720;201304;2730;9680;2545;9282;789;3259;905;3094;1694;6353
315725;201304;1571;5026;1308;4703;286;1012;904;3324;1190;4336
315727;201304;625;2082;582;1982;149;542;307;1037;456;1579
315730;201304;965;3153;878;2974;258;914;410;1437;668;2351
315733;201304;1075;3578;999;3410;473;1711;303;1010;776;2721
315737;201304;1332;4281;1158;3990;165;640;751;2608;916;3248
315740;201304;994;3340;867;3091;289;1173;339;1124;628;2297
315750;201304;1054;3452;945;3304;145;603;653;2226;798;2829
315760;201304;821;2635;812;2619;51;175;732;2372;783;2547
315765;201304;1407;4625;1334;4495;191;674;985;3381;1176;4055
315770;201304;1576;5160;1486;5000;446;1618;663;2204;1109;3822
315780;201304;25994;88460;24658;85699;9376;34395;8524;30318;17900;64713
315790;201304;2976;10660;2794;10279;357;1261;1893;7213;2250;8474
315800;201304;1495;6027;1268;5351;436;2004;215;869;651;2873
315810;201304;1439;4330;1257;4031;243;882;768;2359;1011;3241
315820;201304;3034;10299;2631;9710;646;2563;1450;5423;2096;7986
315830;201304;1459;5040;1346;4798;359;1447;472;1622;831;3069
315840;201304;659;1910;531;1641;106;361;145;439;251;800
315850;201304;1341;4878;1297;4776;408;1568;501;1818;909;3386
315860;201304;391;1477;340;1373;107;476;109;466;216;942
315870;201304;453;1415;400;1331;107;405;160;499;267;904
315880;201304;1007;2896;869;2721;279;981;377;1159;656;2140
315890;201304;1562;5551;1429;5356;397;1518;804;3160;1201;4678
315895;201304;4794;15567;4505;15013;1572;5729;1778;5784;3350;11513
315900;201304;730;2459;679;2373;221;884;309;1000;530;1884
315910;201304;599;2185;552;2088;244;959;191;706;435;1665
315920;201304;1104;3666;1000;3464;379;1422;411;1359;790;2781
315930;201304;1030;3058;901;2827;315;1070;290;899;605;1969
315935;201304;1110;3874;1041;3724;361;1415;321;1125;682;2540
315940;201304;604;2008;571;1958;159;597;317;1059;476;1656
315950;201304;1178;3796;1112;3667;336;1126;605;2042;941;3168
315960;201304;2719;9972;2340;9133;1097;4823;258;960;1355;5783
315970;201304;767;2273;644;2081;84;276;477;1579;561;1855
315980;201304;3856;10165;2870;8471;832;2842;926;2417;1758;5259
315990;201304;4200;13048;3743;12297;879;3371;2048;6582;2927;9953
316000;201304;550;1889;485;1760;250;962;107;377;357;1339
316010;201304;418;1578;376;1479;126;565;60;191;186;756
316020;201304;1156;3858;931;3468;184;754;530;2016;714;2770
316030;201304;3540;10419;2622;8962;389;1482;1453;5119;1842;6601
316040;201304;3259;10462;2470;8668;535;2155;550;1689;1085;3844
316045;201304;2009;6790;1894;6623;315;973;1328;5007;1643;5980
316050;201304;317;1122;302;1092;63;255;178;638;241;893
316060;201304;754;2391;641;2238;132;570;393;1303;525;1873
316070;201304;5772;20004;5436;19330;1872;7289;2348;8007;4220;15296
316080;201304;705;2711;640;2533;177;774;157;622;334;1396
316090;201304;582;1781;453;1524;131;507;118;354;249;861
316095;201304;1120;3950;1062;3814;232;864;662;2461;894;3325
316100;201304;2799;9820;2355;8687;796;3264;506;1779;1302;5043
316105;201304;845;2490;680;2256;178;658;359;1183;537;1841
316110;201304;11840;43771;10843;41842;1508;6542;7857;30713;9365;37255
316120;201304;1249;4496;1223;4459;437;1626;596;2251;1033;3877
316130;201304;903;2361;712;2059;223;767;262;689;485;1456
316140;201304;986;3105;787;2774;173;656;415;1502;588;2158
316150;201304;1205;3932;1152;3849;322;1236;611;1958;933;3194
316160;201304;1193;3724;1007;3357;137;511;611;2056;748;2567
316165;201304;855;2541;751;2367;156;567;412;1265;568;1832
316170;201304;1306;4024;1049;3523;248;983;443;1352;691;2335
316180;201304;1152;3821;1001;3566;313;1336;369;1194;682;2530
316190;201304;2522;7899;1635;5771;406;1578;330;1020;736;2598
316200;201304;4026;13462;3285;12001;977;4168;947;3259;1924;7427
316210;201304;4791;16077;4530;15575;2281;8330;1004;3493;3285;11823
316220;201304;615;1968;467;1711;149;617;76;299;225;916
316225;201304;973;3108;896;2994;166;626;565;1867;731;2493
316230;201304;415;1330;355;1217;66;249;199;690;265;939
316240;201304;5921;20148;5280;19381;622;2134;4232;15981;4854;18115
316245;201304;2680;10329;2568;10160;240;1034;2099;8414;2339;9448
316250;201304;8326;27462;7578;25903;3468;12667;2036;6588;5504;19255
316255;201304;2264;7457;2043;7197;324;1075;1513;5482;1837;6557
316257;201304;1232;3655;991;3225;311;1146;318;962;629;2108
316260;201304;1707;5020;1322;4471;472;1759;631;2092;1103;3851
316265;201304;1136;3419;1026;3193;90;334;736;2263;826;2597
316270;201304;5142;17019;4833;16397;1524;5620;2029;6973;3553;12593
316280;201304;3191;11031;2893;10435;686;2766;1418;5102;2104;7868
316290;201304;2944;10213;2796;9924;833;3320;1212;4075;2045;7395
316292;201304;3614;12430;3363;11944;1037;4123;1426;4794;2463;8917
316294;201304;851;2945;582;2273;157;709;81;309;238;1018
316295;201304;1844;6772;1723;6513;493;2126;801;2835;1294;4961
316300;201304;886;3103;816;2970;99;374;569;2144;668;2518
316310;201304;594;2055;517;1876;149;604;198;700;347;1304
316320;201304;525;1839;476;1768;185;768;171;586;356;1354
316330;201304;903;2850;801;2675;174;583;447;1561;621;2144
316340;201304;1071;3677;999;3542;386;1518;246;787;632;2305
316350;201304;1441;4911;1320;4706;270;995;752;2854;1022;3849
316360;201304;727;1994;593;1820;70;227;458;1411;528;1638
316370;201304;4819;16549;4413;15710;1538;5798;1120;4109;2658;9907
316380;201304;1333;3976;1138;3658;155;553;760;2457;915;3010
316390;201304;853;2710;739;2523;270;985;292;1021;562;2006
316400;201304;1426;4956;1291;4731;388;1500;592;2256;980;3756
316410;201304;1189;4162;1117;4048;222;895;708;2555;930;3450
316420;201304;1936;6847;1829;6692;314;1255;1193;4482;1507;5737
316430;201304;828;2666;730;2508;249;921;277;922;526;1843
316440;201304;563;1960;505;1884;194;852;235;793;429;1645
316443;201304;650;2092;571;1920;159;595;208;675;367;1270
316447;201304;1285;4440;1233;4342;213;829;908;3173;1121;4002
316450;201304;2097;7766;1898;7366;463;1765;1048;4294;1511;6059
316460;201304;765;2506;719;2434;196;754;423;1364;619;2118
316470;201304;6359;23174;5876;22122;2313;9745;1767;6210;4080;15955
316480;201304;250;907;226;856;73;290;72;268;145;558
316490;201304;345;1142;332;1116;129;449;139;467;268;916
316500;201304;1058;3949;768;3065;220;938;62;237;282;1175
316510;201304;920;3454;841;3302;384;1582;282;1103;666;2685
316520;201304;1089;3585;933;3348;320;1312;335;1108;655;2420
316530;201304;1179;3921;1001;3530;287;1217;402;1227;689;2444
316540;201304;985;3322;890;3162;299;1258;305;972;604;2230
316550;201304;1216;4290;1123;4141;242;994;717;2640;959;3634
316553;201304;2136;8084;1821;7270;686;2930;379;1488;1065;4418
316555;201304;2542;9575;2375;9379;196;733;1975;8053;2171;8786
316556;201304;563;1697;474;1515;57;228;314;949;371;1177
316557;201304;863;3212;839;3166;310;1215;418;1567;728;2782
316560;201304;338;1175;301;1106;80;354;102;341;182;695
316570;201304;1320;4417;1238;4243;240;908;739;2533;979;3441
316580;201304;230;779;213;740;83;299;76;251;159;550
316590;201304;1256;3988;1095;3705;201;812;665;2214;866;3026
316600;201304;1096;3874;999;3654;269;1058;477;1692;746;2750
316610;201304;585;2290;554;2239;174;777;287;1139;461;1916
316620;201304;2003;6884;1878;6626;571;2153;820;2932;1391;5085
316630;201304;1351;4872;1268;4671;551;2161;358;1273;909;3434
316640;201304;251;853;228;807;70;291;87;285;157;576
316650;201304;903;3672;812;3509;198;841;443;2038;641;2879
316660;201304;131;419;114;390;30;132;52;160;82;292
316670;201304;1542;4877;1319;4434;519;1966;371;1122;890;3088
316680;201304;1828;5730;1653;5455;238;825;1256;4187;1494;5012
316690;201304;1030;3642;953;3528;383;1585;319;1121;702;2706
316695;201304;1230;3935;1112;3729;127;418;781;2744;908;3162
316700;201304;346;1216;325;1168;96;413;152;505;248;918
316710;201304;3318;13255;2937;12386;1004;4380;944;4180;1948;8560
316720;201304;19529;68046;17085;62582;6442;24878;4624;16904;11066;41782
316730;201304;408;1358;360;1250;98;373;183;585;281;958
316740;201304;710;2570;658;2478;272;1100;173;614;445;1714
316750;201304;387;1441;362;1388;126;532;124;452;250;984
316760;201304;3462;12077;2988;11547;1775;6812;917;3797;2692;10609
316770;201304;1415;4413;1258;4191;250;934;795;2704;1045;3638
316780;201304;675;2395;641;2328;290;1116;155;544;445;1660
316790;201304;818;2459;617;2106;178;711;240;795;418;1506
316800;201304;5921;20304;5441;19378;1204;5006;2931;10049;4135;15055
316805;201304;877;2388;834;2332;156;421;597;1732;753;2153
316810;201304;498;1607;469;1553;134;489;236;763;370;1252
316820;201304;298;973;252;890;113;435;48;158;161;593
316830;201304;569;2131;549;2085;213;854;207;779;420;1633
316840;201304;3298;10023;2888;9376;891;3288;1207;3768;2098;7056
316850;201304;2028;6712;1894;6472;484;1848;972;3267;1456;5115
316860;201304;22711;73551;21327;71064;6299;23263;9773;32565;16072;55828
316870;201304;6740;23348;6103;21827;2442;9388;1395;4840;3837;14228
316880;201304;840;2971;817;2938;374;1447;219;759;593;2206
316890;201304;1330;3633;1075;3279;514;1719;313;909;827;2628
316900;201304;2467;8238;2303;7896;764;2910;705;2187;1469;5097
316905;201304;378;1401;360;1359;157;620;101;381;258;1001
316910;201304;633;2278;556;2119;148;604;260;998;408;1602
316920;201304;1410;4537;1137;4061;183;737;537;1919;720;2656
316930;201304;9198;32632;8378;31043;2802;11838;2780;9889;5582;21727
316935;201304;4684;14401;3518;12342;1285;5017;943;3131;2228;8148
316940;201304;6414;22700;5661;21107;1612;6816;1700;6004;3312;12820
316950;201304;1401;4388;1256;4194;238;908;802;2644;1040;3552
316960;201304;5028;13745;4363;12923;925;3023;2694;8005;3619;11028
316970;201304;3327;11522;3158;11203;1372;5442;863;2804;2235;8246
316980;201304;909;2967;758;2725;367;1410;217;777;584;2187
316990;201304;9368;32494;8715;31043;3760;14546;1487;5091;5247;19637
317000;201304;2396;9115;2332;9031;299;920;1926;7826;2225;8746
317005;201304;2196;7554;2126;7455;448;1652;1465;5145;1913;6797
317010;201304;25697;75932;18741;63359;5801;21769;4776;16697;10577;38466
317020;201304;38417;121813;28387;100104;8600;33439;6012;19929;14612;53368
317030;201304;854;2473;721;2271;132;506;409;1282;541;1788
317040;201304;12112;38471;11031;36511;4317;14864;4012;13658;8329;28522
317043;201304;756;2228;637;2065;223;769;273;879;496;1648
317047;201304;1122;3168;916;2847;179;620;444;1390;623;2010
317050;201304;1720;6446;1550;6043;505;2148;475;1759;980;3907
317052;201304;2184;7589;1966;7271;414;1575;1314;5008;1728;6583
317057;201304;1668;5064;1335;4497;231;929;712;2384;943;3313
317060;201304;369;1131;290;958;91;335;106;330;197;665
317065;201304;1202;4165;1105;4014;142;563;854;3127;996;3690
317070;201304;8601;29801;7090;26448;2391;9864;1704;6354;4095;16218
317075;201304;1169;3880;1078;3733;429;1617;409;1361;838;2978
317080;201304;6652;20314;6269;19710;2123;7226;2643;8397;4766;15623
317090;201304;4612;16601;4372;16132;760;2949;2938;11027;3698;13976
317100;201304;3069;9449;2739;8927;914;3378;1227;3784;2141;7162
317103;201304;1967;7145;1695;6536;405;1861;810;3079;1215;4940
317107;201304;1218;4068;1106;3839;285;1171;536;1751;821;2922
317110;201304;600;1718;497;1565;160;599;199;566;359;1165
317115;201304;995;3316;904;3117;134;477;611;2122;745;2599
317120;201304;12526;43845;11178;40763;4107;15899;4148;14993;8255;30892
317130;201304;8611;28583;7933;27332;2311;8946;3492;11681;5803;20627
317140;201304;624;2268;584;2173;88;364;366;1355;454;1719
317150;201304;1005;2832;859;2661;124;460;596;1810;720;2270
317160;201304;3659;10331;2902;9365;448;1690;1936;6162;2384;7852
317170;201304;1908;5927;1811;5736;278;1032;1085;3302;1363;4334
317180;201304;1667;6003;1389;5346;443;1847;383;1462;826;3309
317190;201304;1295;4068;1218;3962;124;466;995;3231;1119;3697
317200;201304;4054;14322;3915;14021;1546;5964;978;3373;2524;9337
317210;201304;1045;3383;894;3136;309;1211;347;1189;656;2400
317220;201304;340;1269;335;1263;149;575;148;566;297;1141
320010;201304;5900;18981;5322;17636;863;3112;3034;10081;3897;13193
320013;201304;1785;5529;1438;4997;215;810;933;3295;1148;4105
320016;201304;3388;9710;2952;9093;512;1622;2014;6309;2526;7931
320020;201304;4054;13655;3778;13063;1376;5051;1391;4827;2767;9878
320030;201304;1689;5690;1561;5410;442;1675;739;2506;1181;4181
320035;201304;1546;5163;1425;4932;521;1942;444;1528;965;3470
320040;201304;2948;10350;2587;9497;790;3111;838;3026;1628;6137
320050;201304;1845;5440;1593;4915;350;1216;798;2416;1148;3632
320060;201304;10648;35210;8961;31295;2750;10439;3093;10353;5843;20792
320070;201304;1739;6061;1587;5700;574;2218;420;1407;994;3625
320080;201304;4973;15562;4308;14258;1393;5013;1618;5212;3011;10225
320090;201304;7949;23943;6880;22097;1882;6594;3700;11625;5582;18219
320100;201304;3171;9799;2675;8829;664;2418;1276;4114;1940;6532
320110;201304;1507;4748;1392;4513;378;1333;485;1549;863;2882
320115;201304;1925;7221;1884;7121;615;2370;1046;4020;1661;6390
320120;201304;16107;57111;14653;54167;5700;22371;4254;15772;9954;38143
320130;201304;37000;128169;35172;124264;11568;43973;15842;55091;27410;99064
320140;201304;3923;13262;2932;10708;842;3355;383;1357;1225;4712
320150;201304;17154;50603;13147;42770;4620;16083;2095;6758;6715;22841
320160;201304;5254;16640;4665;15709;1257;4695;2263;7359;3520;12054
320170;201304;1922;6488;1783;6181;710;2549;535;1903;1245;4452
320180;201304;897;3062;823;2944;273;1035;391;1403;664;2438
320190;201304;4011;15024;3756;14372;1489;5909;1113;4257;2602;10166
320200;201304;1065;3631;972;3440;303;1165;419;1489;722;2654
320210;201304;6013;17096;5270;15832;1408;4679;2609;7716;4017;12395
320220;201304;2652;8511;2109;7501;721;2784;689;2485;1410;5269
320225;201304;1388;5082;1238;4652;469;1889;242;916;711;2805
320230;201304;4078;14059;3848;13621;1313;4973;1443;5250;2756;10223
320240;201304;10591;35947;9315;33422;3585;13445;2379;8982;5964;22427
320245;201304;4064;14286;3881;13877;1263;4675;1823;6571;3086;11246
320250;201304;1641;5303;1278;4439;376;1451;290;932;666;2383
320255;201304;1926;6637;1695;6240;703;2749;594;2257;1297;5006
320260;201304;1357;4478;1164;3959;360;1351;411;1249;771;2600
320265;201304;2330;7448;1996;7038;273;1015;1477;5330;1750;6345
320270;201304;2103;7210;1988;6938;483;1760;1079;3809;1562;5569
320280;201304;7099;21881;6678;21323;1192;3993;4515;14839;5707;18832
320290;201304;1494;5259;1417;5049;554;2043;466;1626;1020;3669
320300;201304;4544;15710;4248;15163;1224;4567;2195;7929;3419;12496
320305;201304;4393;15052;4056;14233;1223;4699;1748;5976;2971;10675
320310;201304;1881;5914;1756;5734;402;1429;1053;3383;1455;4812
320313;201304;2110;6727;1671;5732;500;1981;274;847;774;2828
320316;201304;2180;7084;2086;6867;587;2040;996;3274;1583;5314
320320;201304;17247;58564;15651;55475;4973;19703;6747;23184;11720;42887
320330;201304;2660;8695;2433;8244;650;2201;1260;4431;1910;6632
320332;201304;4966;17386;4651;16821;1530;5719;2076;7811;3606;13530
320334;201304;1612;5844;1369;5229;525;2193;225;748;750;2941
320335;201304;1792;5817;1557;5305;628;2309;295;948;923;3257
320340;201304;5319;15778;4467;14341;1075;3860;2217;7049;3292;10909
320350;201304;5278;13951;4036;11935;870;2936;1918;5479;2788;8415
320360;201304;1693;4714;1366;4134;305;1040;667;1928;972;2968
320370;201304;3404;11652;2991;10820;905;3425;1292;4705;2197;8130
320380;201304;2538;8310;2285;7772;754;2689;891;3031;1645;5720
320390;201304;7945;24940;6843;22797;1814;6777;3155;10276;4969;17053
320400;201304;4244;12533;3700;11796;695;2424;2436;7723;3131;10147
320405;201304;4103;12567;3830;12208;1050;3769;2243;7015;3293;10784
320410;201304;5787;15222;4462;13748;528;1529;3554;11286;4082;12815
320420;201304;2365;7684;1915;6987;881;3437;355;1280;1236;4717
320425;201304;2430;6388;2050;5878;317;1095;1344;3822;1661;4917
320430;201304;2147;6672;2002;6411;313;1173;1228;3823;1541;4996
320435;201304;1909;7035;1753;6646;496;1918;861;3387;1357;5305
320440;201304;1421;4956;1361;4804;434;1643;535;1832;969;3475
320450;201304;2250;7733;2074;7346;627;2403;917;3186;1544;5589
320455;201304;4246;15729;3580;14037;1194;4841;728;2829;1922;7670
320460;201304;2772;9542;2344;8611;842;3307;666;2343;1508;5650
320465;201304;1475;4938;1325;4565;288;1042;606;2072;894;3114
320470;201304;3989;12959;3070;10882;1105;4255;488;1664;1593;5919
320480;201304;1966;6125;1672;5567;415;1623;777;2433;1192;4056
320490;201304;16538;54838;14473;50794;5172;19339;5248;18960;10420;38299
320495;201304;1262;4254;1147;3996;508;1899;352;1190;860;3089
320500;201304;40011;132168;36371;125184;12973;48114;15399;51831;28372;99945
320501;201304;4113;13950;3887;13532;1488;5644;1574;5407;3062;11051
320503;201304;2179;8196;1933;7493;697;2855;507;1840;1204;4695
320506;201304;2995;9799;2212;7761;669;2481;402;1426;1071;3907
320510;201304;7646;25318;7062;24209;2627;9577;2534;8664;5161;18241
320515;201304;2025;5902;1838;5539;491;1559;813;2486;1304;4045
320517;201304;1988;7040;1797;6590;606;2354;634;2351;1240;4705
320520;201304;29020;98108;25825;91866;9118;35393;10904;38638;20022;74031
320530;201304;25666;83593;22574;77294;6798;26227;9617;31632;16415;57859
330010;201304;14156;47166;13328;45375;3430;13200;7162;23358;10592;36558
330015;201304;1889;5462;1670;5036;562;1891;534;1534;1096;3425
330020;201304;15191;47691;14074;45878;3984;13889;7311;23724;11295;37613
330022;201304;1374;4639;1284;4483;318;1319;696;2296;1014;3615
330023;201304;3122;10474;2990;10206;882;3294;1280;4269;2162;7563
330025;201304;3081;9809;2887;9513;678;2429;1853;6078;2531;8507
330030;201304;7019;24958;6500;23856;2199;8819;2616;9146;4815;17965
330040;201304;13811;40291;11892;37307;3201;10934;6384;19665;9585;30599
330045;201304;57294;174368;54023;169664;9110;30330;37529;118726;46639;149056
330050;201304;2809;9308;2530;8735;975;3761;728;2368;1703;6129
330060;201304;5111;16507;4696;15906;1194;4496;2757;9380;3951;13876
330070;201304;24046;77191;22254;73967;6859;24555;9615;31978;16474;56533
330080;201304;8620;26063;8308;25637;2204;6837;4994;15929;7198;22766
330090;201304;2982;8799;2857;8560;976;3115;1260;3709;2236;6824
330093;201304;1838;5523;1655;5241;399;1374;836;2647;1235;4021
330095;201304;1157;4109;1080;3910;418;1673;218;713;636;2386
330100;201304;50068;175401;47739;171188;12887;50698;24140;86973;37027;137671
330110;201304;2567;8289;2362;7908;872;3149;688;2277;1560;5426
330115;201304;2386;7507;2239;7238;789;2800;891;2785;1680;5585
330120;201304;2290;7130;2131;6903;479;1708;1295;4139;1774;5847
330130;201304;3676;12588;3381;11990;1243;4688;1144;4075;2387;8763
330140;201304;3255;10159;2974;9767;772;2822;1466;4797;2238;7619
330150;201304;2838;8885;2331;7817;855;3109;528;1728;1383;4837
330160;201304;1310;4687;1240;4528;513;2035;354;1241;867;3276
330170;201304;94208;296952;89160;289172;13494;47619;65018;210733;78512;258352
330180;201304;1564;4980;1443;4750;280;1167;921;2798;1201;3965
330185;201304;7251;23918;6903;23328;1999;7058;3597;12564;5596;19622
330187;201304;3834;11376;3523;10860;854;3026;1947;5875;2801;8901
330190;201304;26850;83820;25831;82065;7107;24056;14708;45926;21815;69982
330200;201304;12204;39948;11489;38534;2640;9121;6578;22529;9218;31650
330205;201304;2476;6928;2266;6582;531;1780;1187;3329;1718;5109
330210;201304;4558;12319;3491;10353;1101;3593;1049;3082;2150;6675
330220;201304;10650;34899;10134;33893;3773;13644;3466;11206;7239;24850
330225;201304;3854;12558;3653;12242;681;2615;2466;8235;3147;10850
330227;201304;16972;48884;15624;47167;3253;10642;10208;30281;13461;40923
330230;201304;1466;4402;1363;4238;420;1480;611;1777;1031;3257
330240;201304;19256;61123;17356;57916;7306;26432;3348;11187;10654;37619
330245;201304;1152;3792;982;3436;304;1152;240;846;544;1998
330250;201304;35251;106094;33783;103829;8619;26594;20599;64746;29218;91340
330260;201304;3204;10442;3072;10189;880;3230;1499;4811;2379;8041
330270;201304;12762;39751;11564;37789;3618;12480;4973;16432;8591;28912
330280;201304;1842;6122;1614;5650;399;1613;802;2653;1201;4266
330285;201304;17080;52608;15845;50892;3671;12515;9874;31864;13545;44379
330290;201304;3326;9417;3013;9065;495;1739;2116;6157;2611;7896
330300;201304;4057;13728;3895;13455;1065;3885;2028;7203;3093;11088
330310;201304;2625;8043;2447;7733;655;2199;1197;3725;1852;5924
330320;201304;14878;44939;14194;43876;3773;11865;8383;26573;12156;38438
330330;201304;29096;86743;27376;84056;7414;24345;15923;48436;23337;72781
330340;201304;13200;42433;11232;38398;3623;13474;3634;12227;7257;25701
330350;201304;87837;292171;85919;289504;17093;57516;60265;207596;77358;265112
330360;201304;5164;16880;5052;16695;905;3273;3500;11474;4405;14747
330370;201304;3611;13832;3443;13380;1435;5811;1176;4587;2611;10398
330380;201304;3721;12578;3374;12023;1135;4245;1454;5346;2589;9591
330385;201304;3852;13790;3573;13205;1071;4242;1457;5373;2528;9615
330390;201304;22041;76930;20680;74286;5251;21050;10924;38520;16175;59570
330395;201304;3165;9907;2993;9614;526;1806;1928;6276;2454;8082
330400;201304;2383;8249;2174;7847;552;2246;1019;3412;1571;5658
330410;201304;2895;9568;2548;8823;628;2313;1213;4211;1841;6524
330411;201304;2394;7746;2183;7329;501;1961;1133;3564;1634;5525
330412;201304;1309;4641;1071;4181;247;1116;466;1746;713;2862
330414;201304;24796;72351;21337;67683;4419;15083;13192;41974;17611;57057
330415;201304;3575;11481;3187;10774;850;3236;1386;4636;2236;7872
330420;201304;6226;21735;5461;20157;1895;7660;995;3768;2890;11428
330430;201304;7865;24001;7128;22685;1857;6568;3421;10557;5278;17125
330440;201304;2046;7038;1741;6406;586;2390;444;1573;1030;3963
330450;201304;1524;5520;1446;5345;503;2080;488;1752;991;3832
330452;201304;10277;32307;8645;29041;2496;9330;3627;11622;6123;20952
330455;201304;428062;1306991;376516;1222193;105293;364836;193797;628854;299090;993690
330460;201304;1350;4705;1272;4551;385;1562;595;2081;980;3643
330470;201304;3972;13750;3823;13445;1556;5821;1036;3574;2592;9395
330475;201304;7637;25599;7083;24746;1792;6781;4035;14263;5827;21044
330480;201304;6342;19553;5946;18812;1786;6125;2252;7025;4038;13150
330490;201304;92618;269324;87200;261493;13557;42909;64735;194786;78292;237695
330500;201304;6460;20159;6066;19372;1527;5216;2974;9809;4501;15025
330510;201304;39324;131735;37520;128692;13873;48330;17354;61375;31227;109705
330513;201304;1542;4771;1432;4555;427;1419;721;2330;1148;3749
330515;201304;2689;9040;2570;8832;823;3038;1186;4019;2009;7057
330520;201304;12442;38538;11783;37614;2544;8647;7701;24814;10245;33461
330530;201304;1527;4668;1420;4481;380;1325;766;2344;1146;3669
330540;201304;3021;9581;2690;9078;913;3306;1005;3334;1918;6640
330550;201304;8627;29075;7779;27556;3091;11528;2260;8197;5351;19725
330555;201304;9844;30966;9007;29645;1960;6743;5617;18721;7577;25464
330560;201304;3954;12522;3729;12146;811;3110;2199;6954;3010;10064
330570;201304;3524;10480;3157;9903;810;2660;1736;5553;2546;8213
330575;201304;5108;16086;4810;15540;1109;3855;2912;9183;4021;13038
330580;201304;15355;51545;13905;48747;5177;18983;4717;17133;9894;36116
330590;201304;1896;5961;1797;5794;519;1757;926;3034;1445;4791
330600;201304;8811;27420;7705;25701;1254;5272;4998;15772;6252;21044
330610;201304;8427;28270;7820;27114;2402;9148;3569;12219;5971;21367
330615;201304;1649;5987;1539;5679;596;2273;639;2454;1235;4727
330620;201304;3823;13851;3588;13427;1287;4982;1436;5711;2723;10693
330630;201304;19300;66196;17892;63099;5447;21256;8246;27862;13693;49118
350010;201304;2823;9210;2321;8046;765;2863;455;1534;1220;4397
350020;201304;543;1642;446;1438;129;471;158;472;287;943
350030;201304;4078;13672;3794;13181;1496;5617;1396;4889;2892;10506
350040;201304;559;2093;499;1966;184;787;98;351;282;1138
350050;201304;1346;4543;1130;4136;330;1370;376;1278;706;2648
350055;201304;551;1948;532;1916;178;681;226;820;404;1501
350060;201304;75;259;69;249;23;104;21;62;44;166
350070;201304;2631;8922;2241;8056;610;2432;580;1897;1190;4329
350075;201304;462;1737;427;1656;175;730;118;408;293;1138
350080;201304;574;1754;486;1578;135;506;188;602;323;1108
350090;201304;569;1691;452;1493;131;457;152;495;283;952
350100;201304;1736;6284;1623;6047;630;2520;559;2039;1189;4559
350110;201304;433;1353;348;1160;109;410;109;318;218;728
350115;201304;1225;4181;1094;3833;268;1071;469;1511;737;2582
350120;201304;709;2052;556;1768;159;569;140;448;299;1017
350130;201304;3573;11308;3284;10745;930;3409;1355;4114;2285;7523
350140;201304;671;2148;609;2019;154;593;237;743;391;1336
350150;201304;378;1341;361;1300;167;619;77;287;244;906
350160;201304;6305;21123;5093;18428;1742;6924;1654;5500;3396;12424
350170;201304;2157;7881;1948;7352;759;2969;463;1692;1222;4661
350180;201304;1427;3799;1191;3391;293;869;541;1537;834;2406
350190;201304;2820;10135;2456;9398;876;3757;916;3185;1792;6942
350200;201304;391;1391;367;1362;145;598;143;507;288;1105
350210;201304;7269;21175;5980;18875;2441;8251;1933;5831;4374;14082
350220;201304;3035;10041;2752;9512;1061;4074;743;2324;1804;6398
350230;201304;716;2503;660;2408;248;987;199;723;447;1710
350240;201304;580;1801;509;1688;126;485;269;859;395;1344
350250;201304;2688;10153;2580;9932;1146;4680;808;3085;1954;7765
350260;201304;935;2630;864;2525;224;676;397;1220;621;1896
350270;201304;5049;16319;4618;15446;1312;4796;2083;6920;3395;11716
350275;201304;1889;6371;1708;6126;546;2148;708;2402;1254;4550
350280;201304;21220;58390;14172;44816;3962;13472;2960;9443;6922;22915
350290;201304;1454;5177;1352;4937;493;1894;456;1707;949;3601
350300;201304;472;1539;437;1458;162;591;124;407;286;998
350310;201304;991;3392;935;3271;255;1049;396;1317;651;2366
350315;201304;542;1773;446;1564;88;382;150;476;238;858
350320;201304;11400;38372;10478;36193;3578;13129;1917;6433;5495;19562
350330;201304;9111;27824;8284;26070;1772;6381;4802;14188;6574;20569
350335;201304;528;1579;490;1502;138;445;191;640;329;1085
350340;201304;972;3190;783;2835;283;1101;172;597;455;1698
350350;201304;735;2452;652;2323;205;830;248;877;453;1707
350360;201304;705;2566;629;2402;203;833;235;905;438;1738
350370;201304;677;2147;509;1736;109;415;126;393;235;808
350380;201304;3465;11561;2962;10803;1392;5400;603;2129;1995;7529
350390;201304;8126;27338;7435;26096;1800;7007;4078;13787;5878;20794
350395;201304;293;969;236;839;74;279;42;144;116;423
350400;201304;7604;23322;6453;21200;2127;7568;2277;7209;4404;14777
350410;201304;6960;26577;6328;25145;2429;10358;1714;6648;4143;17006
350420;201304;1007;3285;834;2934;409;1516;76;267;485;1783
350430;201304;885;2853;778;2668;230;928;386;1266;616;2194
350440;201304;1341;4466;1276;4350;477;1711;570;1916;1047;3627
350450;201304;7793;24590;6756;22593;2438;8848;1943;6301;4381;15149
350460;201304;1389;4219;1037;3461;337;1246;285;817;622;2063
350470;201304;204;646;185;617;56;211;76;233;132;444
350480;201304;744;2361;509;1774;102;413;88;251;190;664
350490;201304;2058;6066;1829;5814;433;1564;1225;3818;1658;5382
350500;201304;604;1845;535;1739;153;563;247;752;400;1315
350510;201304;1093;3603;972;3357;319;1247;358;1112;677;2359
350520;201304;1242;4922;1154;4740;473;2036;295;1196;768;3232
350530;201304;2401;7429;2015;6564;795;2806;531;1573;1326;4379
350535;201304;1450;4331;1418;4287;84;265;1251;3820;1335;4085
350540;201304;1959;5873;1731;5489;505;1784;735;2299;1240;4083
350550;201304;10539;31969;8609;28598;2748;10204;3044;9452;5792;19656
350560;201304;3291;11227;3069;10866;621;2353;1808;6592;2429;8945
350570;201304;19704;70279;18230;66838;6328;24714;6458;22813;12786;47527
350580;201304;1905;6473;1663;5963;547;2145;269;849;816;2994
350590;201304;3841;13084;3129;11467;1030;4169;1113;3754;2143;7923
350600;201304;26916;80352;22136;71633;5287;18963;10873;34059;16160;53022
350610;201304;8800;26515;7310;24153;2058;7658;3522;11251;5580;18909
350620;201304;417;1384;375;1305;96;378;157;521;253;899
350630;201304;1574;5125;1279;4544;421;1716;137;436;558;2152
350635;201304;3753;13675;3493;13138;1219;4750;1448;5551;2667;10301
350640;201304;658;2143;603;2022;205;743;249;807;454;1550
350650;201304;3782;12814;2993;10974;1252;5008;328;1141;1580;6149
350660;201304;3604;11960;3215;11266;919;3458;1495;5190;2414;8648
350670;201304;1806;5822;1701;5635;355;1375;1081;3410;1436;4785
350680;201304;1137;3621;934;3218;288;1170;378;1233;666;2403
350690;201304;1028;3552;886;3237;291;1182;209;695;500;1877
350700;201304;2709;9672;2419;9006;953;3893;869;2879;1822;6772
350710;201304;1972;6424;1799;6156;390;1527;1102;3689;1492;5216
350715;201304;1112;3493;991;3261;243;925;420;1307;663;2232
350720;201304;120;392;115;377;47;159;41;126;88;285
350730;201304;389;1551;379;1521;132;576;98;366;230;942
350740;201304;2248;6964;2039;6489;608;2102;798;2544;1406;4646
350745;201304;339;1109;294;1001;73;286;132;409;205;695
350750;201304;8948;28810;7183;25151;2272;8725;1796;5927;4068;14652
350760;201304;10978;36482;10096;34919;3720;14191;4029;13264;7749;27455
350770;201304;830;2581;634;2170;154;602;213;721;367;1323
350775;201304;612;1860;555;1748;147;527;235;736;382;1263
350780;201304;1955;6161;1527;5262;361;1371;342;1167;703;2538
350790;201304;2012;6778;1684;6112;607;2332;382;1257;989;3589
350800;201304;2872;10106;2749;9883;756;3054;1484;5180;2240;8234
350810;201304;2551;7627;2245;7054;782;2669;778;2509;1560;5178
350820;201304;501;1444;395;1229;86;319;147;401;233;720
350830;201304;847;2776;630;2219;131;501;131;419;262;920
350840;201304;2994;11415;2615;10380;1036;4430;552;2004;1588;6434
350850;201304;6395;22142;5515;20046;1895;7336;1556;5414;3451;12750
350860;201304;3116;10653;3016;10504;563;2181;2156;7446;2719;9627
350870;201304;2275;8144;2091;7856;792;3139;978;3701;1770;6840
350880;201304;1621;5626;1387;5087;468;1845;256;950;724;2795
350890;201304;605;1858;488;1607;105;376;156;426;261;802
350900;201304;4505;15391;3892;14126;1145;4515;1351;4621;2496;9136
350910;201304;858;2739;823;2664;354;1174;283;920;637;2094
350920;201304;8984;28078;8449;27232;1526;5568;5559;17290;7085;22858
350925;201304;5205;16659;4752;15781;1482;5414;2080;6726;3562;12140
350930;201304;1453;4203;1231;3832;177;660;828;2474;1005;3134
350940;201304;2269;7727;2086;7423;416;1756;1332;4538;1748;6294
350945;201304;920;3160;828;2963;248;963;319;1118;567;2081
350950;201304;66602;221313;58427;204673;18276;69702;23664;80629;41940;150331
350960;201304;4428;16092;3970;15089;881;3824;2098;7692;2979;11516
350970;201304;4017;15155;3726;14431;1546;6459;1176;4433;2722;10892
350980;201304;627;2098;599;2053;278;1032;119;411;397;1443
350990;201304;1696;6201;1536;5881;551;2271;563;2141;1114;4412
350995;201304;801;2979;763;2905;242;1030;348;1254;590;2284
351000;201304;3411;10852;3037;10099;567;2224;1736;5501;2303;7725
351010;201304;406;1278;311;1084;129;487;57;202;186;689
351015;201304;929;3178;819;2965;317;1301;230;747;547;2048
351020;201304;7429;25196;6658;23986;1864;7272;3584;13037;5448;20309
351030;201304;1282;4970;1202;4789;401;1737;415;1640;816;3377
351040;201304;3476;11558;3237;11140;850;3449;1857;5953;2707;9402
351050;201304;7610;26349;6714;24557;2594;10210;2233;8085;4827;18295
351060;201304;30065;97451;25737;89539;9264;34056;8649;30689;17913;64745
351070;201304;1714;5106;1309;4362;498;1817;254;753;752;2570
351080;201304;2693;8337;2131;7647;706;2748;831;2909;1537;5657
351090;201304;375;1345;309;1203;109;488;50;189;159;677
351100;201304;1739;5895;1653;5758;636;2259;688;2473;1324;4732
351110;201304;7032;21773;5707;19233;2076;7647;1737;5578;3813;13225
351120;201304;614;1971;536;1791;87;353;240;707;327;1060
351130;201304;831;2346;464;1595;118;483;111;325;229;808
351140;201304;1952;6965;1802;6651;722;2901;575;2077;1297;4978
351150;201304;2036;7180;1722;6378;519;2116;442;1504;961;3620
351160;201304;1450;5252;1317;4930;466;1935;435;1566;901;3501
351170;201304;1415;4917;1237;4487;384;1497;481;1625;865;3122
351190;201304;1061;3493;981;3286;281;1027;250;796;531;1823
351200;201304;2192;6726;1904;6176;371;1423;982;2927;1353;4350
351210;201304;896;3112;824;2955;299;1151;255;872;554;2023
351220;201304;3411;11765;2983;10832;946;3746;1073;3806;2019;7552
351230;201304;1816;6310;1649;5967;581;2292;708;2524;1289;4816
351240;201304;990;3339;741;2705;236;980;200;628;436;1608
351250;201304;809;2404;620;2019;141;501;286;899;427;1400
351260;201304;1184;3615;1062;3357;299;1036;409;1232;708;2268
351270;201304;373;1377;339;1305;130;565;108;381;238;946
351280;201304;4176;13618;3624;12274;1150;4148;1107;3404;2257;7552
351290;201304;952;2982;843;2752;295;1008;227;693;522;1701
351300;201304;9575;36282;8505;33732;2567;11008;3307;13074;5874;24082
351310;201304;3264;10540;2763;9604;770;3050;1271;4107;2041;7157
351320;201304;945;3491;867;3297;343;1412;196;657;539;2069
351330;201304;273;834;249;784;100;322;71;216;171;538
351340;201304;6211;22499;5783;21648;1695;6708;3054;11473;4749;18181
351350;201304;8837;30286;8084;28622;2662;9839;3107;10731;5769;20570
351360;201304;4768;14961;4517;14554;1231;4352;2389;7701;3620;12053
351370;201304;1847;6222;1510;5468;529;2139;362;1155;891;3294
351380;201304;35633;115691;33509;111303;9477;34507;15847;50516;25324;85023
351385;201304;240;781;235;772;98;324;72;247;170;571
351390;201304;1183;4144;1072;3906;440;1691;350;1228;790;2919
351400;201304;1184;3944;1117;3799;351;1288;448;1572;799;2860
351410;201304;2762;8862;2518;8415;642;2312;1205;3976;1847;6288
351420;201304;448;1342;312;1034;75;269;48;146;123;415
351430;201304;844;2765;764;2616;214;810;406;1347;620;2157
351440;201304;4572;14394;4087;13384;1657;5690;1108;3448;2765;9138
351450;201304;1785;5221;1580;4954;489;1557;855;2776;1344;4333
351460;201304;793;2563;663;2301;327;1221;184;582;511;1803
351470;201304;1029;3326;930;3141;416;1518;284;934;700;2452
351480;201304;2854;9625;2626;9241;712;3014;1265;4294;1977;7308
351490;201304;1902;6691;1728;6325;417;1778;918;3195;1335;4973
351492;201304;292;1019;221;821;54;236;58;171;112;407
351495;201304;144;518;127;471;47;186;46;165;93;351
351500;201304;17618;59949;15904;56619;5284;19802;6702;23630;11986;43432
351510;201304;6943;23366;6147;22075;1548;6079;3367;11983;4915;18062
351512;201304;301;977;275;921;83;298;89;281;172;579
351515;201304;1784;6284;1585;5818;566;2230;458;1627;1024;3857
351518;201304;2088;7559;1689;6836;569;2489;300;1196;869;3685
351519;201304;730;2485;652;2312;202;824;279;953;481;1777
351520;201304;730;2175;379;1391;67;281;47;155;114;436
351530;201304;444;1452;402;1347;97;357;116;339;213;696
351535;201304;2478;6648;2092;6133;194;618;1643;4849;1837;5467
351540;201304;2031;6713;1856;6405;974;3523;367;1273;1341;4796
351550;201304;5543;17497;4463;15195;1709;6131;1084;3629;2793;9760
351560;201304;419;1410;368;1285;147;562;61;198;208;760
351565;201304;225;788;208;742;69;290;80;255;149;545
351570;201304;12455;42229;11052;39269;3820;13992;4555;16317;8375;30309
351580;201304;383;1139;302;946;58;198;112;319;170;517
351590;201304;442;1254;385;1122;146;458;89;248;235;706
351600;201304;1794;5407;1646;5121;447;1629;759;2120;1206;3749
351610;201304;626;1795;537;1632;121;419;271;783;392;1202
351620;201304;22504;77451;18984;69582;6701;26596;4776;16313;11477;42909
351630;201304;14009;48500;12901;46657;3526;13219;7258;26652;10784;39871
351640;201304;7845;26967;6835;25172;1967;7788;3435;12651;5402;20439
351650;201304;331;1032;246;831;60;221;60;196;120;417
351660;201304;879;2894;724;2527;188;733;204;636;392;1369
351670;201304;4031;13175;3493;12077;902;3526;1591;5191;2493;8717
351680;201304;676;2206;546;1867;161;592;129;408;290;1000
351685;201304;425;1313;339;1162;104;373;113;398;217;771
351690;201304;1259;3763;1019;3256;484;1570;257;780;741;2350
351700;201304;1373;4288;1261;4078;431;1476;406;1264;837;2740
351710;201304;761;2449;647;2195;175;626;183;564;358;1190
351720;201304;1522;5012;1224;4228;293;1125;421;1391;714;2516
351730;201304;979;3256;951;3206;322;1183;441;1495;763;2678
351740;201304;4405;13051;3864;11919;1149;3777;1315;3822;2464;7599
351750;201304;1476;5001;1291;4591;412;1587;326;1080;738;2667
351760;201304;3704;12384;3306;11482;882;3322;1523;5154;2405;8476
351770;201304;2125;7167;1851;6662;758;2818;763;2766;1521;5584
351780;201304;1552;4593;1154;3774;354;1260;278;894;632;2154
351790;201304;1097;3388;944;3176;290;1069;465;1527;755;2596
351800;201304;298;760;262;691;41;143;162;376;203;519
351810;201304;1172;3686;1114;3613;293;1110;686;2092;979;3202
351820;201304;2419;7264;1713;5961;739;2745;211;699;950;3444
351830;201304;3798;12931;3498;12276;1000;3864;1516;5137;2516;9001
351840;201304;8653;30731;7811;28927;2714;10721;2698;9821;5412;20542
351850;201304;1110;4005;986;3727;315;1336;173;590;488;1926
351860;201304;3436;11343;3206;10899;775;3005;1848;5982;2623;8987
351870;201304;34203;109357;31786;105164;7267;26094;19593;64389;26860;90483
351880;201304;111554;374790;99687;350478;33986;125557;31373;110207;65359;235764
351885;201304;593;2269;554;2181;165;694;251;959;416;1653
351890;201304;821;2497;672;2163;240;820;153;471;393;1291
351900;201304;1428;4532;1282;4302;477;1699;506;1712;983;3411
351905;201304;346;1295;300;1205;115;510;88;317;203;827
351907;201304;13688;45190;12031;41824;3105;12063;5454;18153;8559;30216
351910;201304;1091;3618;1000;3440;264;1022;284;899;548;1921
351920;201304;1165;3465;1111;3384;280;969;663;1948;943;2917
351925;201304;965;2819;915;2735;107;418;699;2005;806;2423
351930;201304;3010;10671;2774;10150;893;3631;1070;3585;1963;7216
351940;201304;963;3027;912;2923;287;1016;525;1603;812;2619
351950;201304;962;3065;870;2889;240;878;355;1091;595;1969
351960;201304;3594;11991;3129;11042;1259;4684;1045;3612;2304;8296
351970;201304;6745;26233;6267;25213;2469;10492;2064;8204;4533;18696
351980;201304;877;2821;755;2592;178;707;317;1034;495;1741
351990;201304;1531;4571;1266;4036;378;1378;381;1088;759;2466
352000;201304;2315;7693;2139;7322;541;1998;1038;3452;1579;5450
352010;201304;2247;7833;2072;7400;801;2995;485;1775;1286;4770
352020;201304;1446;4813;1329;4589;434;1578;431;1524;865;3102
352030;201304;4243;13840;3900;13400;875;3239;2354;8262;3229;11501
352040;201304;1621;5893;1421;5379;461;1836;337;1200;798;3036
352042;201304;1798;5451;1505;4871;390;1406;788;2531;1178;3937
352044;201304;1260;4448;1075;3953;327;1299;253;869;580;2168
352050;201304;6996;24331;5279;20393;1700;7355;1134;3878;2834;11233
352060;201304;780;2401;705;2285;225;831;268;796;493;1627
352070;201304;684;1927;636;1848;308;963;166;516;474;1479
352080;201304;529;1690;456;1558;131;509;163;499;294;1008
352090;201304;1645;5462;1376;4905;368;1513;478;1537;846;3050
352100;201304;1692;6001;1525;5662;543;2238;542;1822;1085;4060
352110;201304;399;1539;370;1479;122;548;111;407;233;955
352115;201304;323;1096;274;992;90;368;123;406;213;774
352120;201304;969;2915;846;2740;187;626;511;1716;698;2342
352130;201304;1656;4759;1301;4184;345;1232;604;1798;949;3030
352140;201304;1123;3869;984;3551;338;1290;373;1331;711;2621
352150;201304;629;1907;526;1724;212;747;180;569;392;1316
352160;201304;1170;3497;1084;3367;294;1010;568;1760;862;2770
352170;201304;2979;9477;2750;9094;779;2787;1320;4223;2099;7010
352180;201304;3342;9889;2953;9184;886;3014;1312;3894;2198;6908
352190;201304;1000;3199;916;3050;230;911;447;1352;677;2263
352200;201304;358;1265;307;1160;78;327;120;456;198;783
352210;201304;15105;42308;12231;38062;2481;8365;7420;23487;9901;31852
352215;201304;545;1807;491;1724;95;364;294;1051;389;1415
352220;201304;14532;49851;13697;48173;4727;17580;5766;20308;10493;37888
352230;201304;13195;46602;11820;44053;3937;15955;4594;16830;8531;32785
352240;201304;13528;43695;12624;42110;4369;16160;5093;16429;9462;32589
352250;201304;24658;82149;22117;77365;6047;23008;10020;34983;16067;57991
352260;201304;4620;14985;3611;13078;1100;4431;1018;3340;2118;7771
352265;201304;924;3039;822;2885;149;605;529;1830;678;2435
352270;201304;2489;8669;2197;7940;896;3399;509;1762;1405;5161
352280;201304;2401;7684;2092;7157;618;2339;730;2435;1348;4774
352290;201304;1374;4615;1223;4287;342;1350;338;1071;680;2421
352300;201304;874;2711;753;2499;248;875;321;1054;569;1929
352310;201304;28978;103429;26824;99541;7955;31580;14938;54352;22893;85932
352320;201304;6673;21639;5992;20449;2301;8568;1928;6088;4229;14656
352330;201304;2139;7289;1889;6988;738;2945;682;2541;1420;5486
352340;201304;5557;19501;4680;17355;1704;6782;984;3408;2688;10190
352350;201304;1640;6244;1495;5904;450;1923;487;1871;937;3794
352360;201304;1146;3946;1016;3667;298;1260;514;1712;812;2972
352370;201304;877;3017;810;2873;210;848;383;1316;593;2164
352380;201304;987;3241;866;3027;354;1368;250;836;604;2204
352390;201304;11689;36861;9519;32765;2534;10049;4161;13240;6695;23289
352400;201304;2792;8623;1931;6942;581;2300;815;2847;1396;5147
352410;201304;4338;13380;3490;11932;1425;5208;1031;3420;2456;8628
352420;201304;1271;3793;1186;3663;474;1608;423;1291;897;2899
352430;201304;6021;19537;5333;18347;2185;8091;1658;5572;3843;13663
352440;201304;14709;48002;12432;43455;3461;13158;5043;17080;8504;30238
352450;201304;595;1843;418;1506;115;439;88;304;203;743
352460;201304;2564;8939;2346;8556;893;3623;919;3142;1812;6765
352470;201304;4742;13619;2942;9860;645;2355;1320;4312;1965;6667
352480;201304;5299;15420;4470;13879;1295;4594;1887;5423;3182;10017
352490;201304;703;2583;598;2329;159;681;115;437;274;1118
352500;201304;9509;32386;9081;31646;3761;14211;3548;11527;7309;25738
352510;201304;3212;11531;2677;10349;1011;4187;663;2496;1674;6683
352520;201304;2346;8496;2160;8096;554;2267;1306;4834;1860;7101
352530;201304;6997;23710;5606;20634;1760;7013;1294;4509;3054;11522
352540;201304;497;1672;420;1507;110;445;172;616;282;1061
352550;201304;1015;3508;838;3129;316;1265;204;744;520;2009
352560;201304;523;1660;455;1536;95;383;239;752;334;1135
352570;201304;1681;5442;1226;4374;309;1240;335;1048;644;2288
352580;201304;906;2817;794;2620;283;1062;330;1011;613;2073
352585;201304;171;601;148;552;39;166;50;167;89;333
352590;201304;13116;43716;11830;41257;2856;11209;6469;21960;9325;33169
352600;201304;1798;5966;1677;5696;613;2188;575;1888;1188;4076
352610;201304;3475;11625;3129;11036;1274;4832;1038;3656;2312;8488
352620;201304;5305;17611;5071;17273;1272;4614;3173;10792;4445;15406
352630;201304;823;2829;781;2729;245;939;360;1234;605;2173
352640;201304;2931;9679;2381;8390;603;2364;892;3030;1495;5394
352650;201304;812;2467;616;2068;163;599;162;494;325;1093
352660;201304;1058;3823;881;3405;307;1279;282;1070;589;2349
352670;201304;7630;26445;6734;24723;2549;9691;2134;7975;4683;17666
352680;201304;3100;11564;2666;10362;741;3168;793;2779;1534;5947
352690;201304;22671;70284;18596;62701;5355;19769;7775;25608;13130;45377
352700;201304;744;2296;597;2068;176;697;266;881;442;1578
352710;201304;4957;15202;3747;12725;1095;4141;1339;4268;2434;8409
352720;201304;8223;28967;7809;28140;2681;10297;3139;11294;5820;21591
352725;201304;391;1196;267;903;54;219;58;184;112;403
352730;201304;2427;8630;2125;7800;617;2483;639;2068;1256;4551
352740;201304;2143;6606;1884;6101;519;2022;854;2467;1373;4489
352750;201304;340;1131;307;1071;119;446;56;162;175;608
352760;201304;862;3115;804;3005;265;1077;404;1465;669;2542
352770;201304;901;2858;852;2761;247;869;311;1019;558;1888
352780;201304;589;2083;523;1929;173;711;157;507;330;1218
352790;201304;625;1883;516;1708;174;651;120;397;294;1048
352800;201304;1042;4086;876;3589;304;1280;146;560;450;1840
352810;201304;981;2667;751;2238;143;501;327;943;470;1444
352820;201304;483;1564;428;1446;203;734;67;227;270;961
352830;201304;395;1206;313;1018;94;317;52;169;146;486
352840;201304;3252;11744;2883;10915;915;3736;1043;3935;1958;7671
352850;201304;9384;31560;8333;29658;2701;10159;2844;10382;5545;20541
352860;201304;1015;3457;930;3262;401;1491;234;750;635;2241
352870;201304;933;2602;778;2303;152;564;403;1080;555;1644
352880;201304;2110;6581;1740;5746;443;1599;444;1321;887;2920
352885;201304;290;1017;275;983;96;366;91;305;187;671
352890;201304;695;2056;609;1880;151;518;203;582;354;1100
352900;201304;17512;55541;14058;48328;4105;15306;5674;18810;9779;34116
352910;201304;280;926;248;853;81;291;35;101;116;392
352920;201304;3360;10562;2914;9668;978;3588;1007;3101;1985;6689
352930;201304;6738;22148;5447;19250;1791;6782;992;3374;2783;10156
352940;201304;26852;94159;23812;86744;8837;33835;5101;18345;13938;52180
352950;201304;312;1014;226;827;67;292;62;202;129;494
352960;201304;469;1556;392;1384;93;368;96;320;189;688
352965;201304;349;1014;290;897;77;245;51;163;128;408
352970;201304;3284;8826;2924;8358;366;1110;2166;6325;2532;7435
352980;201304;1381;4248;1218;3978;417;1436;487;1612;904;3048
352990;201304;3503;12151;3304;11791;1153;4367;1410;5024;2563;9391
353000;201304;514;1484;401;1247;97;348;113;302;210;650
353010;201304;2774;8331;2243;7246;771;2743;778;2313;1549;5056
353020;201304;4195;12216;3275;10262;654;2286;1339;3888;1993;6174
353030;201304;4884;15069;4335;13979;1596;5537;1134;3486;2730;9023
353040;201304;659;1942;570;1798;213;726;191;590;404;1316
353050;201304;5177;18853;4687;17830;1951;7951;1474;5338;3425;13289
353060;201304;31912;107280;29841;103904;5869;23881;19362;64459;25231;88340
353070;201304;8113;28716;6555;25022;2462;9914;1564;6056;4026;15970
353080;201304;4546;16104;3864;14487;1359;5476;1074;3804;2433;9280
353090;201304;563;1947;502;1828;98;432;239;803;337;1235
353100;201304;257;785;215;691;100;320;38;122;138;442
353110;201304;7532;24262;6761;22811;1497;5365;3871;13332;5368;18697
353120;201304;464;1638;404;1492;154;640;94;313;248;953
353130;201304;2919;9281;2589;8700;996;3656;958;3031;1954;6687
353140;201304;2423;7058;1961;6099;698;2360;527;1444;1225;3804
353150;201304;1778;5899;1524;5395;669;2477;315;1154;984;3631
353160;201304;564;1787;485;1607;152;527;110;337;262;864
353170;201304;512;1875;468;1792;200;849;155;563;355;1412
353180;201304;4540;15117;4028;14142;838;3439;2302;7694;3140;11133
353190;201304;3408;11256;2999;10294;821;3130;1293;4055;2114;7185
353200;201304;796;2860;726;2703;223;952;279;975;502;1927
353205;201304;535;1762;430;1519;112;405;139;503;251;908
353210;201304;934;2627;781;2345;142;488;453;1316;595;1804
353215;201304;539;1751;475;1616;101;400;186;636;287;1036
353220;201304;885;2787;817;2659;226;817;314;995;540;1812
353230;201304;1162;3703;1092;3584;332;1207;411;1279;743;2486
353240;201304;2029;7089;1877;6776;652;2612;747;2480;1399;5092
353250;201304;1124;3295;969;3012;295;992;329;949;624;1941
353260;201304;1141;3449;1015;3240;344;1154;372;1153;716;2307
353270;201304;591;1859;514;1713;172;630;151;462;323;1092
353280;201304;523;1768;459;1657;160;616;115;402;275;1018
353282;201304;1665;5775;1622;5705;319;1233;1126;3910;1445;5143
353284;201304;331;984;270;878;89;311;85;266;174;577
353286;201304;141;431;97;326;27;88;19;66;46;154
353290;201304;422;1571;387;1495;162;656;140;533;302;1189
353300;201304;1847;6005;1672;5617;614;2235;548;1677;1162;3912
353310;201304;345;1112;328;1073;144;493;90;279;234;772
353320;201304;469;1361;412;1267;116;433;184;504;300;937
353325;201304;463;1691;396;1556;140;600;48;194;188;794
353330;201304;481;1524;406;1359;101;384;172;523;273;907
353340;201304;3015;10053;2598;9167;950;3602;831;2834;1781;6436
353350;201304;3228;10055;2868;9390;1033;3636;1257;3968;2290;7604
353360;201304;408;1480;358;1361;105;455;176;617;281;1072
353370;201304;690;2287;628;2149;201;736;282;957;483;1693
353380;201304;394;1345;355;1275;110;445;155;538;265;983
353390;201304;4726;13532;3800;11775;1084;3672;1444;4102;2528;7774
353400;201304;584;1852;495;1659;121;454;172;504;293;958
353410;201304;648;2068;555;1920;186;710;272;911;458;1621
353420;201304;596;1856;523;1648;173;582;162;465;335;1047
353430;201304;2387;8360;1880;6939;675;2564;140;448;815;3012
353440;201304;57534;192740;53117;182366;17347;62970;18081;60590;35428;123560
353450;201304;446;1405;401;1324;110;430;144;443;254;873
353460;201304;3802;11219;3371;10408;987;3293;1530;4657;2517;7950
353470;201304;10716;35071;8584;30476;2883;11174;2008;6952;4891;18126
353475;201304;1587;4777;1225;3968;354;1258;322;943;676;2201
353480;201304;1499;4629;1377;4403;327;1204;735;2219;1062;3423
353490;201304;1650;4838;1413;4371;402;1388;398;1125;800;2513
353500;201304;1158;3450;1081;3313;481;1560;356;1042;837;2602
353510;201304;1349;4484;1183;4037;338;1280;413;1262;751;2542
353520;201304;1104;3511;942;3202;412;1496;228;767;640;2263
353530;201304;2611;8173;2350;7675;713;2593;987;3076;1700;5669
353540;201304;1831;5797;1694;5557;719;2443;568;1919;1287;4362
353550;201304;6464;19307;5806;18217;1301;4805;3100;8974;4401;13779
353560;201304;2315;7814;1995;7228;539;2246;785;2695;1324;4941
353570;201304;474;1547;395;1377;97;390;199;618;296;1008
353580;201304;2279;7754;2153;7518;820;3187;1047;3440;1867;6627
353590;201304;778;2287;668;2095;269;925;178;573;447;1498
353600;201304;1787;5357;1647;5111;404;1405;831;2581;1235;3986
353610;201304;556;2053;503;1957;179;777;185;711;364;1488
353620;201304;2272;8161;2106;7856;737;3025;776;2730;1513;5755
353625;201304;349;984;258;824;108;394;61;170;169;564
353630;201304;1798;6272;1514;5633;460;1914;360;1240;820;3154
353640;201304;1489;4340;1411;4213;425;1371;712;2179;1137;3550
353650;201304;4313;14420;3798;13250;1024;3886;1904;6329;2928;10215
353657;201304;278;963;259;922;71;288;95;329;166;617
353660;201304;1324;3460;1008;3016;470;1533;143;302;613;1835
353670;201304;4688;15834;4143;14636;1300;4962;1435;4879;2735;9841
353680;201304;614;2282;584;2223;337;1316;123;486;460;1802
353690;201304;483;1368;341;1130;122;455;104;309;226;764
353700;201304;2242;7478;2010;6959;515;2068;665;2110;1180;4178
353710;201304;1805;6619;1603;6167;632;2667;536;2006;1168;4673
353715;201304;468;1424;415;1337;63;232;245;801;308;1033
353720;201304;2028;6551;1801;6207;372;1237;1115;4091;1487;5328
353730;201304;4331;13883;3520;11975;960;3516;923;2940;1883;6456
353740;201304;2217;6970;1808;6099;661;2322;488;1596;1149;3918
353750;201304;590;2185;523;2031;189;784;128;508;317;1292
353760;201304;6161;21174;5192;19161;1716;6658;1905;7130;3621;13788
353770;201304;792;2533;551;1933;134;514;83;228;217;742
353780;201304;5490;20301;5039;19387;2543;9973;1162;4769;3705;14742
353790;201304;3059;11182;2763;10565;1057;4423;516;2028;1573;6451
353800;201304;13111;44130;10948;39781;3088;12374;4842;17182;7930;29556
353810;201304;1127;3815;1015;3564;330;1207;407;1450;737;2657
353820;201304;1158;4266;1111;4170;442;1833;384;1362;826;3195
353830;201304;765;2155;600;1831;135;452;255;770;390;1222
353850;201304;1756;6025;1643;5813;480;1822;750;2583;1230;4405
353860;201304;2304;8053;2019;7423;755;3023;743;2645;1498;5668
353870;201304;22633;73573;17700;63374;4479;18058;6281;20515;10760;38573
353880;201304;2605;8863;2398;8534;545;2229;1367;4719;1912;6948
353890;201304;2235;6069;1693;5202;550;1865;699;2020;1249;3885
353900;201304;1115;3592;850;2979;234;908;194;608;428;1516
353910;201304;2059;7430;1959;7151;653;2546;837;3068;1490;5614
353920;201304;2610;8008;2055;6841;521;1791;411;1289;932;3080
353930;201304;3547;13023;3139;12164;1234;5085;751;2784;1985;7869
353940;201304;1479;4851;1319;4530;356;1422;518;1616;874;3038
353950;201304;3555;11949;3287;11457;618;2472;2083;7067;2701;9539
353960;201304;568;1878;467;1638;123;485;128;380;251;865
353970;201304;520;1567;458;1485;52;211;340;1073;392;1284
353980;201304;13602;41135;11580;37989;3013;10696;6026;19502;9039;30198
353990;201304;516;1664;471;1549;149;544;171;505;320;1049
354000;201304;1769;5435;1254;4398;311;1230;124;382;435;1612
354010;201304;373;1210;336;1144;175;614;83;278;258;892
354020;201304;4566;14357;4187;13561;1426;5005;1721;5249;3147;10254
354025;201304;1034;3036;840;2693;241;857;215;669;456;1526
354030;201304;585;1575;431;1360;147;524;140;398;287;922
354040;201304;759;2123;616;1870;99;381;376;1065;475;1446
354050;201304;863;3032;807;2900;344;1303;219;791;563;2094
354060;201304;4027;13700;3398;12377;1046;4151;1352;4693;2398;8844
354070;201304;3474;11809;3064;10890;1207;4584;746;2618;1953;7202
354075;201304;2233;8644;2137;8472;780;3308;901;3521;1681;6829
354080;201304;1823;5722;1502;4943;426;1470;525;1634;951;3104
354085;201304;285;835;255;780;35;141;170;472;205;613
354090;201304;1046;3262;1009;3205;167;604;733;2261;900;2865
354100;201304;16297;57283;14220;53484;3751;15063;6955;26195;10706;41258
354105;201304;802;2666;672;2411;205;864;203;644;408;1508
354110;201304;679;2216;617;2099;174;636;199;639;373;1275
354120;201304;2112;6255;1883;5867;596;2074;642;1860;1238;3934
354130;201304;6004;19058;5415;17878;1928;6767;1881;6062;3809;12829
354140;201304;16393;46152;11753;36731;2473;8819;5260;15308;7733;24127
354150;201304;4178;12330;3511;11191;1169;4104;1362;4202;2531;8306
354160;201304;3813;12957;3416;12118;1043;3984;1389;4735;2432;8719
354165;201304;378;1437;347;1358;125;506;87;362;212;868
354170;201304;1584;5330;1310;4655;317;1266;466;1495;783;2761
354180;201304;497;1545;474;1497;48;178;350;1062;398;1240
354190;201304;1595;5530;1393;5053;483;1848;406;1430;889;3278
354200;201304;1107;3309;917;2956;231;896;349;973;580;1869
354210;201304;843;3028;765;2847;204;884;308;1061;512;1945
354220;201304;2943;9647;2708;9173;1025;3668;1011;3335;2036;7003
354230;201304;766;2621;728;2556;246;925;336;1175;582;2100
354240;201304;1217;4289;1028;3886;334;1387;275;999;609;2386
354250;201304;465;1581;414;1519;194;777;113;391;307;1168
354260;201304;9240;28785;8425;27456;2690;9557;3494;11389;6184;20946
354270;201304;1092;3993;1018;3825;334;1382;406;1524;740;2906
354280;201304;856;2619;804;2527;175;621;425;1343;600;1964
354290;201304;1292;4703;1194;4488;413;1664;301;1126;714;2790
354300;201304;3777;13642;3700;13488;1051;4058;2016;7313;3067;11371
354310;201304;761;2598;603;2197;188;751;135;475;323;1226
354320;201304;805;2516;710;2324;216;788;241;739;457;1527
354323;201304;324;1004;272;916;99;367;101;306;200;673
354325;201304;1286;4524;1179;4285;362;1473;420;1409;782;2882
354330;201304;7775;24923;7161;23752;1982;7028;3886;12712;5868;19740
354340;201304;28639;96188;24810;89085;9672;37249;8727;30469;18399;67718
354350;201304;1128;3516;1059;3387;321;1080;542;1669;863;2749
354360;201304;426;1441;358;1318;99;397;62;235;161;632
354370;201304;1127;3865;1020;3656;189;796;711;2481;900;3277
354380;201304;1292;3961;1084;3586;429;1581;193;559;622;2140
354390;201304;10633;35993;8437;30834;2388;9616;2699;9356;5087;18972
354400;201304;2069;7475;1831;6889;483;2006;595;2109;1078;4115
354410;201304;6087;19270;5222;17972;1300;4861;2896;9972;4196;14833
354420;201304;1622;4875;1396;4392;462;1563;465;1409;927;2972
354425;201304;3390;10143;2979;9407;1101;3678;958;3118;2059;6796
354430;201304;1281;4335;1191;4205;304;1202;598;2054;902;3256
354440;201304;492;1560;419;1415;113;418;150;484;263;902
354450;201304;427;1271;333;1066;58;238;102;280;160;518
354460;201304;704;2256;670;2194;267;897;334;1097;601;1994
354470;201304;425;1299;369;1189;72;289;166;488;238;777
354480;201304;715;2235;646;2110;156;603;276;776;432;1379
354490;201304;710;2497;549;2080;162;673;159;524;321;1197
354500;201304;2494;8645;2295;8277;866;3424;745;2723;1611;6147
354510;201304;645;2258;576;2096;208;811;195;699;403;1510
354515;201304;327;1168;272;1046;76;327;81;283;157;610
354520;201304;4944;18119;4283;16565;1470;6304;1436;5339;2906;11643
354530;201304;2551;9563;2395;9249;724;2965;1271;4911;1995;7876
354540;201304;1320;4249;1169;3983;411;1479;409;1446;820;2925
354550;201304;510;1775;451;1613;105;400;156;521;261;921
354560;201304;1321;4135;1064;3542;340;1165;297;956;637;2121
354570;201304;578;1861;486;1633;188;689;123;387;311;1076
354580;201304;8619;26542;7437;24201;1804;6673;3588;11001;5392;17674
354600;201304;1647;5885;1472;5537;514;2194;577;2044;1091;4238
354610;201304;468;1327;339;1082;85;289;98;272;183;561
354620;201304;406;1446;339;1317;107;487;104;360;211;847
354625;201304;271;929;234;853;57;234;63;225;120;459
354630;201304;1734;6284;1562;5856;636;2423;490;1747;1126;4170
354640;201304;4045;13854;3502;12664;1126;4569;822;2754;1948;7323
354650;201304;968;3015;876;2821;188;706;474;1461;662;2167
354660;201304;1893;5894;1498;5109;545;2077;479;1532;1024;3609
354670;201304;1710;5789;1392;4972;428;1682;374;1167;802;2849
354680;201304;5017;17535;4680;16807;1440;5459;1815;6412;3255;11871
354690;201304;614;2339;510;2035;132;564;170;605;302;1169
354700;201304;1120;3326;809;2646;148;609;322;913;470;1522
354710;201304;608;1873;534;1738;160;617;177;516;337;1133
354720;201304;182;537;145;458;56;175;40;132;96;307
354730;201304;7134;26074;6443;24601;2155;8720;2459;9165;4614;17885
354740;201304;224;756;191;682;44;165;44;156;88;321
354750;201304;2236;7361;1906;6895;691;2670;691;2516;1382;5186
354760;201304;2100;7200;1835;6602;655;2510;497;1720;1152;4230
354765;201304;243;688;185;593;37;145;46;132;83;277
354770;201304;2691;8181;2182;7327;1015;3661;362;1137;1377;4798
354780;201304;31345;105216;29664;101278;8145;30558;14607;47647;22752;78205
354790;201304;866;2873;785;2757;237;927;403;1330;640;2257
354800;201304;1874;6106;1721;5888;620;2233;855;2969;1475;5202
354805;201304;836;2677;657;2284;131;518;128;409;259;927
354810;201304;638;2165;521;1941;214;865;89;318;303;1183
354820;201304;1005;3713;915;3519;306;1324;221;775;527;2099
354830;201304;415;1338;374;1259;103;392;144;466;247;858
354840;201304;770;2394;725;2298;242;837;242;739;484;1576
354850;201304;14359;48260;11416;41977;3473;14178;3908;13434;7381;27612
354860;201304;1217;4084;1114;3902;347;1452;485;1561;832;3013
354870;201304;41237;136821;39140;132501;11916;43531;20042;65890;31958;109421
354880;201304;3858;12544;2892;10354;953;3728;693;2267;1646;5995
354890;201304;14179;45121;12383;41507;3673;13627;4605;14741;8278;28368
354900;201304;595;1706;483;1547;173;606;170;544;343;1150
354910;201304;4656;15760;3752;13792;1125;4523;580;2067;1705;6590
354920;201304;483;1448;374;1242;112;401;88;283;200;684
354925;201304;367;1097;221;780;39;148;48;161;87;309
354930;201304;240;754;221;708;72;267;59;180;131;447
354940;201304;2489;8900;1967;7488;855;3420;355;1296;1210;4716
354950;201304;1425;4888;1307;4718;257;1092;812;2839;1069;3931
354960;201304;766;2471;687;2346;186;717;365;1209;551;1926
354970;201304;3736;13084;3360;12302;951;3912;1559;5425;2510;9337
354980;201304;32084;81461;17998;56681;4208;14688;5946;17454;10154;32142
354990;201304;32660;114823;30916;111121;7651;30650;16767;58465;24418;89115
354995;201304;1895;6120;1792;5961;499;1760;893;2989;1392;4749
355000;201304;1617;5606;1433;5279;565;2215;398;1451;963;3666
355010;201304;3413;11115;3042;10415;753;2888;1548;5165;2301;8053
355020;201304;3108;11602;2742;10882;1393;5813;761;3076;2154;8889
355030;201304;721374;2231719;671827;2134617;205619;705817;267426;833493;473045;1539310
355040;201304;2743;9406;2461;8864;945;3734;1052;3608;1997;7342
355050;201304;1179;3915;995;3529;310;1205;281;972;591;2177
355060;201304;4635;16450;3791;14432;1176;4980;784;2672;1960;7652
355070;201304;5967;19613;5397;18654;1372;5426;2860;9355;4232;14781
355080;201304;1247;4752;1075;4283;432;1910;161;544;593;2454
355090;201304;1032;3853;889;3502;207;891;392;1489;599;2380
355100;201304;28888;96330;26078;91244;9590;35059;8784;31729;18374;66788
355110;201304;1248;4494;1151;4288;411;1655;409;1493;820;3148
355120;201304;632;2069;558;1919;176;661;238;788;414;1449
355130;201304;421;1226;329;1037;103;354;94;241;197;595
355140;201304;982;3649;947;3566;298;1230;439;1604;737;2834
355150;201304;3114;11117;2833;10519;999;3865;1057;3785;2056;7650
355160;201304;1448;5213;1280;4928;563;2395;355;1231;918;3626
355170;201304;8422;25956;6557;22451;2347;8700;1902;6300;4249;15000
355180;201304;2750;8860;2437;8288;771;2980;903;2942;1674;5922
355190;201304;1228;4450;1142;4256;491;1883;324;1168;815;3051
355200;201304;875;3365;839;3290;423;1758;204;776;627;2534
355210;201304;2631;9404;2395;8879;790;3257;885;3045;1675;6302
355220;201304;27464;97135;25605;93486;11904;44893;7383;27770;19287;72663
355230;201304;944;2995;638;2269;132;543;151;470;283;1013
355240;201304;20837;66218;16319;55925;4122;15887;6504;20546;10626;36433
355250;201304;23084;80602;21200;77049;6361;24706;10208;36767;16569;61473
355255;201304;862;2475;638;1996;124;446;191;552;315;998
355260;201304;1556;4580;1414;4323;399;1389;646;1860;1045;3249
355270;201304;1603;5095;1523;4966;251;1010;1049;3236;1300;4246
355280;201304;21034;66452;19099;62802;5272;19414;8770;27782;14042;47196
355290;201304;843;2790;780;2674;178;682;367;1186;545;1868
355300;201304;821;2804;659;2426;171;699;144;483;315;1182
355310;201304;1003;3209;904;3021;261;900;385;1335;646;2235
355320;201304;709;2348;633;2166;196;741;219;651;415;1392
355330;201304;1463;5509;1269;5123;517;2304;312;1149;829;3453
355340;201304;2828;8050;2684;7809;698;2289;1487;4081;2185;6370
355350;201304;1293;4835;1196;4606;450;1860;294;1173;744;3033
355360;201304;1048;3874;991;3757;291;1237;591;2174;882;3411
355365;201304;311;1006;265;910;83;326;66;216;149;542
355370;201304;6512;17691;4913;15891;2016;7087;1830;5955;3846;13042
355380;201304;3627;11338;2868;9569;878;3194;629;1853;1507;5047
355385;201304;948;3243;916;3191;388;1486;258;856;646;2342
355390;201304;1384;3992;1204;3625;328;1070;410;1221;738;2291
355395;201304;1446;4699;1212;4111;231;921;560;1732;791;2653
355400;201304;8396;29928;7802;28725;2312;9468;4187;14890;6499;24358
355410;201304;12017;45744;11423;44514;4779;19635;3385;13365;8164;33000
355420;201304;793;2966;764;2905;332;1309;247;964;579;2273
355430;201304;3514;10820;3094;10050;963;3435;1224;3821;2187;7256
355440;201304;830;2863;710;2556;223;845;221;727;444;1572
355450;201304;2416;8300;2055;7551;689;2756;598;2070;1287;4826
355460;201304;549;1628;433;1412;128;487;121;349;249;836
355465;201304;418;1279;361;1170;107;375;98;305;205;680
355470;201304;901;2882;736;2592;296;1151;210;678;506;1829
355475;201304;140;542;120;477;31;129;37;161;68;290
355480;201304;3153;11812;2974;11396;998;4127;1253;4661;2251;8788
355490;201304;776;2354;628;2053;191;684;141;462;332;1146
355495;201304;676;2331;651;2289;215;835;257;856;472;1691
355500;201304;7835;24730;5683;19812;1495;5771;1149;3662;2644;9433
355510;201304;1618;5039;1392;4538;360;1338;380;1181;740;2519
355520;201304;368;1016;266;810;69;246;74;193;143;439
355530;201304;148;429;102;334;26;94;20;66;46;160
355535;201304;735;2302;613;2069;180;719;197;569;377;1288
355540;201304;9812;32847;9340;32036;2712;10037;4783;16142;7495;26179
355550;201304;693;2258;655;2183;197;733;304;983;501;1716
355560;201304;1417;4267;1110;3678;279;1056;282;816;561;1872
355570;201304;182;623;162;570;48;180;38;120;86;300
355580;201304;1186;3711;1043;3411;440;1572;322;1011;762;2583
355590;201304;238;692;216;654;50;180;109;324;159;504
355600;201304;962;3301;839;3026;405;1533;205;710;610;2243
355610;201304;1408;4224;1205;3906;386;1360;495;1541;881;2901
355620;201304;3689;12330;3039;10861;783;3217;1276;4167;2059;7384
355630;201304;3170;9431;2052;7053;444;1740;773;2477;1217;4217
355635;201304;924;3191;836;3026;229;909;417;1466;646;2375
355640;201304;3682;12638;3177;11455;1236;4647;640;2322;1876;6969
355645;201304;3301;12259;3162;11989;703;2957;1936;7241;2639;10198
355650;201304;6196;20261;5477;18843;1416;5767;3007;9544;4423;15311
355660;201304;1237;4156;1040;3754;373;1510;323;1071;696;2581
355670;201304;1973;6607;1393;5185;398;1681;421;1366;819;3047
355680;201304;1659;5896;1400;5254;590;2308;276;999;866;3307
355690;201304;337;1187;306;1131;193;743;25;74;218;817
355695;201304;321;979;241;791;46;171;32;82;78;253
355700;201304;6077;22436;5668;21420;1791;7414;2523;9096;4314;16510
355710;201304;11456;30953;7850;24375;2845;9385;1948;5893;4793;15278
355715;201304;184;603;146;528;46;175;27;97;73;272
355720;201304;1513;5157;1290;4681;488;1950;369;1201;857;3151
355730;201304;752;2699;688;2573;293;1162;169;649;462;1811
410010;201304;1580;5210;1476;5012;423;1517;643;2230;1066;3747
410020;201304;1154;4118;1100;4030;382;1462;392;1417;774;2879
410030;201304;1159;4178;1036;3869;382;1491;220;853;602;2344
410040;201304;11745;40837;10974;39297;4319;16539;3057;10836;7376;27375
410045;201304;1067;3196;829;2759;259;906;339;1099;598;2005
410050;201304;2785;8430;2048;7034;763;2859;601;2009;1364;4868
410060;201304;1763;5905;1621;5600;511;1954;568;1911;1079;3865
410070;201304;2030;6008;1753;5466;724;2510;341;902;1065;3412
410080;201304;1346;4252;1188;4003;305;1090;686;2293;991;3383
410090;201304;1099;3602;1001;3391;390;1430;294;935;684;2365
410100;201304;2670;8419;2254;7557;712;2728;541;1760;1253;4488
410105;201304;482;1601;399;1402;110;448;78;244;188;692
410110;201304;2095;6929;1965;6654;566;2143;800;2690;1366;4833
410115;201304;514;1489;450;1357;116;422;139;353;255;775
410120;201304;2793;9907;2661;9698;1089;4210;1025;3806;2114;8016
410130;201304;1297;4536;1207;4341;297;1026;701;2581;998;3607
410140;201304;12790;38443;9991;33113;3531;12933;3530;11497;7061;24430
410150;201304;16645;44257;8761;27619;1995;7213;1712;4877;3707;12090
410160;201304;3207;10666;2948;10211;1002;3808;1107;3875;2109;7683
410165;201304;723;2312;655;2162;142;508;328;1061;470;1569
410170;201304;1528;4915;1345;4527;557;2023;378;1231;935;3254
410180;201304;8029;26805;7141;24898;1960;7868;3380;10951;5340;18819
410185;201304;649;1857;601;1778;135;418;381;1148;516;1566
410190;201304;2092;6480;1943;6177;677;2337;600;1816;1277;4153
410200;201304;4909;14553;4166;13135;1539;5334;780;2387;2319;7721
410210;201304;2514;7850;2049;6853;570;2160;430;1267;1000;3427
410220;201304;583;1756;485;1557;102;359;184;572;286;931
410230;201304;1750;5840;1643;5670;676;2533;555;1855;1231;4388
410240;201304;4862;15758;4591;15209;1601;5694;1697;5609;3298;11303
410250;201304;2346;6874;1805;5814;632;2281;384;1104;1016;3385
410260;201304;1586;5072;1427;4798;468;1697;489;1609;957;3306
410270;201304;513;1567;451;1450;160;562;174;565;334;1127
410275;201304;849;2584;668;2270;118;452;392;1342;510;1794
410280;201304;2682;8271;1928;6597;497;1946;304;1001;801;2947
410290;201304;3010;9839;2762;9385;799;2952;1223;4146;2022;7098
410300;201304;589;1752;544;1666;97;371;314;889;411;1260
410302;201304;532;1626;475;1544;58;189;317;1052;375;1241
410304;201304;1382;4742;1286;4550;397;1443;571;2089;968;3532
410305;201304;1954;5560;1705;5194;562;1793;862;2691;1424;4484
410310;201304;2204;7719;2056;7425;706;2746;703;2626;1409;5372
410315;201304;583;1920;505;1767;137;523;230;775;367;1298
410320;201304;1157;3497;841;2875;209;837;94;268;303;1105
410322;201304;464;1512;408;1384;121;443;124;412;245;855
410330;201304;1384;4108;1212;3763;401;1360;360;1077;761;2437
410335;201304;1008;3097;875;2851;261;969;297;904;558;1873
410337;201304;734;2068;647;1919;144;500;276;777;420;1277
410340;201304;566;1770;435;1427;91;343;104;285;195;628
410345;201304;1589;4982;1406;4645;516;1864;305;924;821;2788
410347;201304;808;2386;613;2016;216;782;118;346;334;1128
410350;201304;894;2970;734;2666;250;1008;99;328;349;1336
410360;201304;3134;10075;2890;9670;1057;3822;788;2678;1845;6500
410370;201304;11848;36231;9494;31344;2786;10385;2779;8585;5565;18970
410380;201304;1277;4180;1192;4011;331;1184;599;2018;930;3202
410390;201304;2716;8204;2248;7392;864;3035;650;1987;1514;5022
410395;201304;822;2960;772;2865;212;864;410;1520;622;2384
410400;201304;4869;16257;4361;15242;1473;5731;1279;4342;2752;10073
410405;201304;884;2741;747;2461;188;724;348;1072;536;1796
410410;201304;1306;4614;1257;4522;461;1824;334;1168;795;2992
410420;201304;9427;31667;8525;29647;3046;11567;2492;8222;5538;19789
410425;201304;3557;11764;2775;9994;837;3352;475;1679;1312;5031
410430;201304;13938;40571;11038;35241;3544;12379;3339;10655;6883;23034
410440;201304;3434;11339;3204;10933;820;2948;1645;5715;2465;8663
410442;201304;2831;10174;2647;9747;959;3732;918;3382;1877;7114
410445;201304;2206;7822;1962;7383;647;2593;832;3248;1479;5841
410450;201304;2430;7269;2075;6608;692;2397;566;1667;1258;4064
410460;201304;2259;7028;1919;6307;523;1839;755;2418;1278;4257
410465;201304;1598;6270;1489;5994;620;2576;420;1613;1040;4189
410470;201304;1788;5865;1638;5545;488;1749;631;2138;1119;3887
410480;201304;26726;82435;23073;75439;9306;33267;6389;19996;15695;53263
410490;201304;10195;35335;9193;33112;3218;12515;3147;11368;6365;23883
410500;201304;1336;4490;1209;4226;448;1699;341;1221;789;2920
410510;201304;2108;5936;1683;5150;498;1648;648;1892;1146;3540
410520;201304;3117;11187;2983;10914;1196;4600;1023;3782;2219;8382
410530;201304;1535;4610;1335;4199;369;1338;527;1551;896;2889
410540;201304;3692;11070;2771;9393;769;2801;1043;3585;1812;6386
410550;201304;5954;19210;4855;16718;1701;6484;672;2084;2373;8568
410560;201304;1130;3861;935;3331;253;962;220;660;473;1622
410570;201304;2581;9002;2405;8696;738;2733;1052;4032;1790;6765
410580;201304;23612;77837;21540;73873;7819;29274;6734;22254;14553;51528
410590;201304;1185;3953;863;3041;181;723;219;692;400;1415
410600;201304;1723;5504;1544;5145;475;1658;720;2437;1195;4095
410610;201304;798;2574;719;2422;220;794;305;992;525;1786
410620;201304;1643;6117;1517;5793;514;2109;435;1629;949;3738
410630;201304;2356;7197;2097;6743;609;2234;923;2906;1532;5140
410640;201304;4390;13695;3797;12641;1380;5177;935;2947;2315;8124
410645;201304;1235;4520;1196;4436;484;1939;400;1505;884;3444
410650;201304;2346;7482;2027;6863;766;2735;634;2103;1400;4838
410655;201304;851;2739;759;2554;243;890;220;719;463;1609
410657;201304;520;1699;487;1633;158;620;196;598;354;1218
410660;201304;3680;11011;2978;9496;1137;3868;621;1859;1758;5727
410670;201304;966;2861;753;2428;217;794;226;685;443;1479
410680;201304;2118;7834;1855;7128;545;2152;721;2884;1266;5036
410685;201304;623;1950;588;1887;128;411;373;1215;501;1626
410690;201304;111776;334389;82563;274759;22862;84876;23027;69511;45889;154387
410700;201304;2142;7372;2036;7156;740;2825;765;2576;1505;5401
410710;201304;1014;3337;853;2950;228;901;241;795;469;1696
410712;201304;687;2225;628;2109;303;1098;169;598;472;1696
410715;201304;1065;3451;959;3233;266;975;353;1159;619;2134
410720;201304;3620;11988;3205;11098;1003;3682;988;3314;1991;6996
410725;201304;1024;3023;817;2650;223;781;276;810;499;1591
410730;201304;684;2134;633;2029;292;994;167;512;459;1506
410740;201304;861;2706;644;2263;167;664;270;936;437;1600
410750;201304;1680;5269;1530;4915;567;2031;436;1284;1003;3315
410752;201304;229;731;215;711;56;222;111;339;167;561
410753;201304;449;1447;405;1363;112;436;148;457;260;893
410754;201304;978;3185;870;3000;149;569;569;2015;718;2584
410755;201304;594;1810;525;1686;138;511;235;695;373;1206
410760;201304;2329;7885;2235;7692;901;3245;818;2814;1719;6059
410765;201304;14399;44789;11557;39091;3170;11913;2461;8287;5631;20200
410770;201304;808;2393;710;2223;213;735;298;906;511;1641
410773;201304;1165;3828;1056;3614;296;1128;461;1465;757;2593
410775;201304;1763;5397;1736;5357;405;1167;1195;3861;1600;5028
410780;201304;584;1875;519;1746;154;541;143;518;297;1059
410785;201304;876;2972;724;2508;260;924;264;933;524;1857
410790;201304;711;2278;620;2069;221;824;141;415;362;1239
410800;201304;2052;6206;1818;5828;845;2889;518;1608;1363;4497
410810;201304;293;919;237;789;32;132;99;314;131;446
410820;201304;1003;3154;907;2945;292;1047;273;863;565;1910
410830;201304;28618;90719;24664;83486;7755;28581;8750;29442;16505;58023
410832;201304;1105;3429;1031;3293;247;933;514;1518;761;2451
410840;201304;7460;24540;6735;22985;2438;9115;1709;5409;4147;14524
410845;201304;1501;4687;1340;4373;309;1103;709;2315;1018;3418
410850;201304;2566;7858;2361;7581;493;1885;1352;4276;1845;6161
410855;201304;673;2008;616;1897;181;595;218;687;399;1282
410860;201304;2976;9278;2707;8820;781;2653;1252;4237;2033;6890
410865;201304;1585;5726;1448;5451;256;1020;892;3455;1148;4475
410870;201304;1344;4362;1287;4267;589;2131;395;1254;984;3385
410880;201304;4935;14951;4128;13501;1364;4993;1229;3795;2593;8788
410890;201304;1060;3389;836;2961;311;1204;122;375;433;1579
410895;201304;1193;4367;1110;4166;407;1610;380;1392;787;3002
410900;201304;806;2369;642;2110;143;527;181;576;324;1103
410910;201304;301;967;267;903;64;236;121;388;185;624
410920;201304;775;2494;638;2236;206;767;166;541;372;1308
410930;201304;1964;6448;1770;6135;548;2160;688;2316;1236;4476
410940;201304;19135;67976;17769;65568;5999;23939;8070;29993;14069;53932
410950;201304;1858;6365;1710;6092;382;1405;1029;3749;1411;5154
410960;201304;5672;16900;4264;14449;1592;5747;1405;4938;2997;10685
410965;201304;1008;3460;932;3311;220;825;531;1947;751;2772
410970;201304;4798;15203;4141;13851;1516;5638;962;3278;2478;8916
410975;201304;1234;3881;1103;3639;208;797;589;1944;797;2741
410980;201304;4692;14487;3389;11660;997;3824;852;2734;1849;6558
410990;201304;978;3135;778;2686;275;1064;177;520;452;1584
411000;201304;368;1189;293;1017;77;296;52;166;129;462
411005;201304;431;1319;369;1171;99;318;84;243;183;561
411007;201304;2087;6977;1999;6835;632;2285;1030;3630;1662;5915
411010;201304;3575;12691;3402;12332;1505;5894;961;3331;2466;9225
411020;201304;2504;8380;2325;8066;799;3056;886;3088;1685;6144
411030;201304;795;2295;700;2126;240;814;196;550;436;1364
411040;201304;334;1125;288;1015;109;399;62;215;171;614
411050;201304;2065;7735;1903;7363;788;3253;429;1662;1217;4915
411060;201304;2019;6593;1799;6152;637;2427;335;1045;972;3472
411065;201304;371;1160;300;1012;51;193;109;332;160;525
411070;201304;3531;12117;2849;10710;1014;4205;353;1243;1367;5448
411080;201304;1886;6182;1774;5938;467;1737;819;2689;1286;4426
411090;201304;1015;2948;894;2779;267;959;265;771;532;1730
411095;201304;1507;4502;1212;3943;343;1232;305;956;648;2188
411100;201304;1457;4316;1124;3669;297;1082;277;915;574;1997
411110;201304;878;2724;709;2371;223;804;131;366;354;1170
411120;201304;1583;5180;1433;4852;478;1739;470;1561;948;3300
411125;201304;4534;15063;4430;14864;1609;5698;2127;7065;3736;12763
411130;201304;712;2245;617;2049;208;729;229;771;437;1500
411140;201304;2172;8061;1955;7503;782;3098;492;2068;1274;5166
411150;201304;5583;16537;5032;15531;1616;5418;1493;4303;3109;9721
411155;201304;1065;3340;994;3182;385;1332;302;890;687;2222
411160;201304;287;900;265;855;116;394;78;239;194;633
411170;201304;757;2658;696;2505;226;859;216;758;442;1617
411180;201304;5775;18420;5199;17389;1751;6392;1633;5461;3384;11853
411190;201304;1717;5239;1470;4787;468;1686;436;1350;904;3036
411200;201304;3573;11941;3217;11357;1303;4967;1087;3807;2390;8774
411210;201304;2715;8042;2258;7219;906;3160;305;903;1211;4063
411220;201304;1125;3401;925;3030;270;990;364;1093;634;2083
411230;201304;942;3005;802;2709;289;1067;233;736;522;1803
411240;201304;788;2542;715;2383;326;1173;168;491;494;1664
411250;201304;3033;8675;2542;7772;790;2493;841;2595;1631;5088
411260;201304;253;745;203;659;68;257;86;255;154;512
411270;201304;1936;6374;1807;6154;640;2428;751;2485;1391;4913
411275;201304;1480;4587;1366;4362;441;1496;506;1597;947;3093
411280;201304;1662;5271;1360;4630;439;1687;213;668;652;2355
411290;201304;997;2909;852;2630;237;790;313;989;550;1779
411295;201304;1050;3260;984;3159;218;781;449;1408;667;2189
411300;201304;1327;3541;937;2784;88;313;394;1084;482;1397
411310;201304;797;2405;656;2160;168;641;300;953;468;1594
411320;201304;5488;17506;4606;15718;1332;4782;1352;4484;2684;9266
411325;201304;1466;5005;1345;4777;167;703;931;3332;1098;4035
411330;201304;3347;11463;3111;11067;1197;4570;1022;3621;2219;8191
411340;201304;911;2746;641;2115;133;489;261;873;394;1362
411342;201304;871;2577;734;2264;207;714;234;643;441;1357
411345;201304;998;3386;940;3275;283;1067;478;1654;761;2721
411350;201304;2415;7905;1949;6967;684;2615;296;984;980;3599
411360;201304;489;1283;332;995;41;165;163;420;204;585
411370;201304;40130;120822;30888;103070;7700;30205;10283;31372;17983;61577
411373;201304;1298;4303;1137;3965;358;1423;255;827;613;2250
411375;201304;1273;3661;1032;3177;311;999;298;888;609;1887
411380;201304;1221;3319;788;2430;174;607;231;694;405;1301
411390;201304;1669;5466;1571;5318;247;980;1150;3757;1397;4737
411400;201304;1496;4680;1291;4241;345;1274;479;1566;824;2840
411410;201304;2295;7391;2071;6903;734;2815;607;1738;1341;4553
411420;201304;4269;12676;3508;11130;1115;3968;823;2368;1938;6336
411430;201304;2456;8555;2258;8159;680;2675;1030;3585;1710;6260
411435;201304;502;1712;455;1597;138;524;148;503;286;1027
411440;201304;2450;8363;2270;8024;868;3324;698;2476;1566;5800
411450;201304;1725;5556;1588;5322;437;1521;820;2822;1257;4343
411460;201304;3706;12536;3315;11659;1469;5460;604;2051;2073;7511
411470;201304;895;2840;717;2426;223;799;155;497;378;1296
411480;201304;4247;13659;3649;12528;1689;6233;825;2728;2514;8961
411490;201304;1578;5205;1425;4918;645;2470;323;1014;968;3484
411500;201304;1242;4053;1051;3595;388;1443;257;842;645;2285
411510;201304;2358;7102;1942;6323;648;2326;418;1220;1066;3546
411520;201304;25976;76828;18487;61126;6461;23698;3875;12045;10336;35743
411530;201304;808;2433;587;2016;266;1006;113;358;379;1364
411535;201304;463;1452;282;1020;64;245;21;69;85;314
411540;201304;2567;7382;2124;6614;488;1655;1050;3348;1538;5003
411545;201304;928;3479;907;3435;210;870;594;2235;804;3105
411550;201304;634;1872;533;1710;249;852;118;361;367;1213
411560;201304;2441;7615;2135;6919;622;2230;542;1620;1164;3850
411570;201304;4590;13971;3946;12943;1415;5073;1094;3771;2509;8844
411573;201304;937;3049;899;2988;243;870;466;1579;709;2449
411575;201304;1322;4451;1202;4156;348;1292;468;1611;816;2903
411580;201304;3150;9905;2565;8741;662;2610;510;1563;1172;4173
411585;201304;407;1492;332;1264;101;408;39;129;140;537
411590;201304;549;1698;498;1590;145;536;130;386;275;922
411600;201304;318;1019;277;922;71;295;52;168;123;463
411605;201304;2116;6268;1694;5476;484;1729;673;2118;1157;3847
411610;201304;2069;6293;1988;6167;491;1617;1297;3990;1788;5607
411620;201304;2582;8868;2453;8643;862;3284;995;3578;1857;6862
411630;201304;663;1855;419;1452;142;569;76;238;218;807
411640;201304;544;1737;458;1559;145;547;158;496;303;1043
411650;201304;252;846;213;754;66;267;66;207;132;474
411660;201304;681;2141;625;2038;162;541;259;874;421;1415
411670;201304;1571;4820;1450;4608;530;1892;472;1380;1002;3272
411680;201304;1612;5200;1448;4932;409;1368;771;2812;1180;4180
411690;201304;3297;10360;2951;9729;1102;3931;873;2900;1975;6831
411695;201304;781;2566;678;2362;146;530;353;1232;499;1762
411700;201304;1726;5332;1374;4668;432;1624;386;1259;818;2883
411705;201304;2157;7654;1920;7216;478;1863;1126;4319;1604;6182
411710;201304;2115;6693;1698;5705;542;2008;332;974;874;2982
411720;201304;817;2554;666;2196;168;619;192;587;360;1206
411721;201304;652;2054;590;1948;155;570;252;808;407;1378
411722;201304;648;2026;543;1820;148;580;185;575;333;1155
411725;201304;1177;3978;929;3412;275;1121;291;1065;566;2186
411727;201304;2290;6792;1956;6153;489;1726;937;2836;1426;4562
411729;201304;475;1421;403;1290;72;261;175;527;247;788
411730;201304;5082;16048;4474;14845;1311;4724;1841;6095;3152;10819
411740;201304;500;1526;420;1363;128;490;164;478;292;968
411745;201304;800;2621;693;2377;210;793;179;566;389;1359
411750;201304;3625;11651;3125;10590;1052;3941;526;1606;1578;5547
411760;201304;7972;25285;7399;24298;2979;10318;2320;8060;5299;18378
411770;201304;3573;13264;3347;12725;1436;5708;791;3058;2227;8766
411780;201304;2786;9755;2714;9658;430;1474;1942;7299;2372;8773
411790;201304;2463;7804;2137;7231;760;2899;599;1968;1359;4867
411800;201304;1169;3637;780;2657;156;593;114;291;270;884
411810;201304;1404;4554;1250;4209;350;1363;320;909;670;2272
411820;201304;15505;50097;13217;45962;4748;16933;4343;16070;9091;33003
411830;201304;430;1226;362;1136;115;374;154;507;269;881
411840;201304;7882;24505;6663;22196;2191;8069;2103;6829;4294;14898
411845;201304;458;1539;376;1366;120;482;80;281;200;763
411850;201304;5606;18035;4953;16782;1514;5654;1735;5864;3249;11518
411860;201304;792;2707;708;2504;241;908;183;610;424;1518
411870;201304;867;3308;800;3138;145;611;214;786;359;1397
411880;201304;2393;7061;2051;6504;505;1765;1057;3393;1562;5158
411885;201304;1303;3765;1113;3504;403;1427;335;952;738;2379
411890;201304;1176;3742;919;3174;296;1152;216;651;512;1803
411900;201304;814;2745;697;2477;241;921;174;610;415;1531
411910;201304;1125;4037;1042;3826;318;1269;380;1331;698;2600
411915;201304;10336;31640;7720;26016;2239;8464;1948;5968;4187;14432
411920;201304;953;3514;881;3326;315;1278;208;780;523;2058
411925;201304;549;1673;459;1514;138;472;200;670;338;1142
411930;201304;5827;20123;5219;18831;1680;6426;2107;7804;3787;14230
411940;201304;3375;11868;3129;11343;1073;4116;979;3553;2052;7669
411950;201304;10452;34896;9343;33029;3213;12343;4072;14251;7285;26594
411960;201304;5465;17312;5176;16786;1557;5628;2398;7531;3955;13159
411965;201304;388;1387;350;1296;107;426;97;366;204;792
411970;201304;713;2172;585;1956;185;653;194;638;379;1291
411980;201304;1987;5604;1435;4747;182;672;854;2815;1036;3487
411990;201304;25949;93461;23207;87571;9293;37218;6224;24093;15517;61311
411995;201304;2806;9186;2614;8824;1098;3918;772;2651;1870;6569
412000;201304;1912;5760;1597;5172;375;1379;629;1798;1004;3177
412010;201304;700;2427;632;2275;223;863;207;726;430;1589
412015;201304;546;1863;507;1783;105;408;280;962;385;1370
412020;201304;395;1246;322;1096;122;454;131;420;253;874
412030;201304;432;1439;341;1250;78;346;119;411;197;757
412033;201304;651;2103;525;1802;146;547;87;277;233;824
412035;201304;858;2665;763;2484;204;760;327;1009;531;1769
412040;201304;670;2280;623;2165;261;957;185;639;446;1596
412050;201304;1534;4786;1253;4177;345;1291;282;895;627;2186
412060;201304;7128;26003;6661;24886;2148;8496;2927;11083;5075;19579
412065;201304;900;2896;826;2745;290;1098;246;749;536;1847
412070;201304;1031;3039;933;2831;214;710;383;1139;597;1849
412080;201304;1822;5960;1418;5086;451;1789;164;525;615;2314
412085;201304;215;662;156;542;49;191;42;134;91;325
412090;201304;4649;16010;4491;15723;1048;3914;2860;10181;3908;14095
412100;201304;2137;6998;1908;6590;663;2433;668;2284;1331;4717
412110;201304;767;2579;720;2491;292;1051;260;877;552;1928
412120;201304;2266;7945;2129;7621;535;2097;1103;3826;1638;5923
412125;201304;939;3004;847;2856;274;992;334;1150;608;2142
412130;201304;752;2196;561;1838;137;505;167;542;304;1047
412135;201304;541;1604;420;1346;87;318;197;579;284;897
412140;201304;1735;5451;1493;4978;472;1676;435;1449;907;3125
412150;201304;2598;8152;2347;7643;405;1492;1363;4288;1768;5780
412160;201304;1004;3317;895;3099;283;1091;367;1238;650;2329
412170;201304;3944;14090;3594;13396;1499;5880;1171;4322;2670;10202
412175;201304;1434;5245;1358;5085;405;1647;563;2141;968;3788
412180;201304;1618;5382;1289;4774;556;2237;306;1098;862;3335
412190;201304;2773;8820;2410;8232;969;3474;727;2632;1696;6106
412200;201304;2072;7353;1627;6061;411;1640;516;1869;927;3509
412210;201304;643;1956;465;1556;145;550;96;299;241;849
412215;201304;2964;10270;2736;9826;560;2080;1681;6226;2241;8306
412217;201304;1076;3402;1038;3332;252;907;596;1820;848;2727
412220;201304;6540;21789;6283;21295;2386;8493;2836;9706;5222;18199
412230;201304;2694;9713;2461;9189;884;3562;704;2583;1588;6145
412240;201304;7474;21870;4689;15796;1144;4281;657;2000;1801;6281
412250;201304;2018;6511;1861;6191;670;2415;587;1894;1257;4309
412260;201304;1197;3711;834;2889;206;816;234;704;440;1520
412265;201304;1078;3575;1016;3469;302;1221;471;1526;773;2747
412270;201304;705;2447;569;2087;142;607;96;323;238;930
412280;201304;830;2704;756;2584;155;562;401;1367;556;1929
412290;201304;1159;3370;999;3075;235;836;423;1247;658;2083
412300;201304;1555;4795;1312;4304;400;1533;421;1278;821;2811
412310;201304;1170;3410;1037;3241;226;597;665;2326;891;2923
412320;201304;820;2262;603;1906;144;528;266;829;410;1357
412330;201304;1913;5421;1494;4714;403;1375;662;2067;1065;3442
412340;201304;829;2742;651;2310;156;618;116;381;272;999
412350;201304;2287;7666;1964;6919;670;2536;350;1129;1020;3665
412360;201304;312;1039;287;981;77;281;70;212;147;493
412370;201304;1082;3465;869;3044;320;1178;251;876;571;2054
412380;201304;1885;5916;1726;5622;376;1266;873;3000;1249;4266
412382;201304;676;1971;551;1723;158;568;170;482;328;1050
412385;201304;2346;7840;2249;7651;544;1819;1180;4351;1724;6170
412390;201304;2307;7194;2144;6922;831;2904;779;2499;1610;5403
412395;201304;936;2679;768;2413;102;322;518;1677;620;1999
412400;201304;1177;3708;1067;3514;340;1213;449;1502;789;2715
412402;201304;1852;5995;1635;5562;526;1921;423;1377;949;3298
412405;201304;3540;10916;2578;8821;730;2856;244;734;974;3590
412410;201304;5942;20130;5503;19258;2539;9638;1065;3700;3604;13338
412420;201304;502;1556;433;1459;150;569;133;400;283;969
412430;201304;436;1351;373;1220;134;491;151;454;285;945
412440;201304;3885;12002;3473;11288;672;2402;1585;5397;2257;7799
412450;201304;520;1696;465;1552;133;487;148;436;281;923
412460;201304;959;2733;664;2182;162;624;179;560;341;1184
412470;201304;1891;6720;1794;6502;564;2190;820;2949;1384;5139
412480;201304;1262;3850;959;3209;250;926;238;708;488;1634
412490;201304;1237;3776;1121;3516;334;1098;328;1031;662;2129
412500;201304;1891;5856;1641;5379;555;2000;426;1304;981;3304
412510;201304;3062;10464;2774;9703;963;3653;774;2735;1737;6388
412520;201304;1711;5018;1370;4482;377;1303;624;2071;1001;3374
412530;201304;743;2259;649;2081;230;800;172;527;402;1327
412535;201304;484;1459;426;1343;147;509;163;458;310;967
412540;201304;1155;3575;989;3226;215;822;389;1239;604;2061
412545;201304;860;2566;749;2336;149;524;286;813;435;1337
412550;201304;21949;69222;16397;56871;5081;19089;3390;11005;8471;30094
412555;201304;291;951;225;781;66;245;40;120;106;365
412560;201304;4249;15104;3817;14138;1287;5120;887;3072;2174;8192
412570;201304;3839;12325;3193;10918;1129;4162;734;2528;1863;6690
412575;201304;975;3216;842;2890;223;866;281;895;504;1761
412580;201304;1404;3993;1070;3435;282;972;358;1107;640;2079
412590;201304;439;1425;375;1305;170;629;79;270;249;899
412600;201304;1399;4608;1250;4312;448;1691;393;1307;841;2998
412610;201304;709;2377;599;2116;212;822;147;455;359;1277
412620;201304;1293;4387;1186;4176;485;1809;348;1234;833;3043
412625;201304;13152;38246;11260;34731;4368;14516;2598;8001;6966;22517
412627;201304;892;2873;685;2429;243;922;117;408;360;1330
412630;201304;3305;11012;2989;10296;916;3408;880;2933;1796;6341
412635;201304;465;1481;387;1313;112;390;67;210;179;600
412640;201304;886;2799;707;2414;213;834;197;634;410;1468
412650;201304;2217;6410;1825;5724;507;1715;751;2201;1258;3916
412660;201304;2921;9068;2470;8130;669;2507;670;2094;1339;4601
412665;201304;678;1865;446;1490;141;525;123;385;264;910
412667;201304;1499;4697;1240;4182;361;1403;375;1159;736;2562
412670;201304;626;2040;430;1545;108;440;63;193;171;633
412680;201304;1273;4397;1126;4036;359;1365;306;998;665;2363
412690;201304;591;1917;472;1644;178;678;61;204;239;882
412700;201304;1713;5952;1553;5653;586;2337;570;2027;1156;4364
412710;201304;8641;27828;7246;24921;2203;8280;1852;6190;4055;14470
412720;201304;1494;4851;1143;3977;304;1151;127;356;431;1507
412730;201304;2695;8368;1949;6784;644;2408;246;784;890;3192
412740;201304;1979;6700;1855;6437;810;2990;235;858;1045;3848
412750;201304;3025;10874;2929;10712;634;2562;2013;7239;2647;9801
412760;201304;2020;7080;1956;6963;716;2793;693;2352;1409;5145
412770;201304;10774;32951;7632;25963;1985;7562;1572;4844;3557;12406
412780;201304;1428;4886;1290;4538;402;1499;413;1386;815;2885
412785;201304;2230;6872;1792;6031;604;2182;744;2457;1348;4639
412788;201304;1271;4399;1212;4289;324;1364;581;1931;905;3295
412790;201304;1057;3458;920;3149;235;903;319;975;554;1878
412795;201304;952;2942;848;2757;308;1086;284;884;592;1970
412796;201304;3086;9879;2933;9612;845;3020;1383;4494;2228;7514
412800;201304;3278;10213;2710;9156;816;3007;822;2651;1638;5658
412810;201304;7950;23346;5846;18973;1870;6677;1468;4417;3338;11094
412820;201304;5389;17489;4278;15270;1421;5530;1021;3700;2442;9230
412830;201304;357;1250;326;1185;104;429;73;236;177;665
412840;201304;2215;6609;1907;6027;631;2227;522;1645;1153;3872
412850;201304;2698;8483;2422;8109;520;1962;1299;4295;1819;6257
412853;201304;1742;5469;1568;5175;386;1535;770;2343;1156;3878
412855;201304;1595;4794;1329;4288;461;1694;402;1179;863;2873
412860;201304;1164;3755;1067;3576;320;1187;462;1470;782;2657
412862;201304;686;2020;604;1860;190;636;198;587;388;1223
412863;201304;1191;4226;1154;4154;176;663;817;2947;993;3610
412865;201304;598;1964;449;1568;96;367;172;599;268;966
412870;201304;962;2922;854;2764;322;1114;327;1091;649;2205
412880;201304;1553;4339;1319;3981;403;1352;402;1174;805;2526
420005;201304;465;1523;366;1299;89;350;156;517;245;867
420010;201304;3056;10028;2675;9352;439;1657;1840;6489;2279;8146
420020;201304;693;2451;520;1964;123;516;89;297;212;813
420030;201304;398;1304;276;1029;81;353;59;196;140;549
420040;201304;951;3062;676;2559;237;993;186;647;423;1640
420050;201304;665;2252;612;2136;207;771;219;739;426;1510
420055;201304;239;859;202;754;55;208;45;152;100;360
420060;201304;369;1328;285;1107;74;311;42;153;116;464
420070;201304;1876;6250;1701;5821;276;1068;820;2928;1096;3996
420075;201304;139;473;107;385;33;130;29;97;62;227
420080;201304;528;1912;489;1813;195;785;95;348;290;1133
420090;201304;642;2398;511;2046;147;609;103;422;250;1031
420100;201304;1433;4886;1345;4766;291;1032;902;3280;1193;4312
420110;201304;420;1479;388;1402;129;461;162;611;291;1072
420120;201304;297;1063;250;957;112;463;35;115;147;578
420125;201304;344;1465;331;1434;131;599;89;363;220;962
420127;201304;498;1632;274;1037;98;393;30;117;128;510
420130;201304;2645;9315;2419;8874;737;3045;959;3229;1696;6274
420140;201304;6182;19059;4839;16710;1772;6768;1293;4330;3065;11098
420150;201304;653;2091;521;1766;189;697;138;419;327;1116
420160;201304;245;807;168;604;51;224;35;101;86;325
420165;201304;148;531;130;485;31;120;31;121;62;241
420170;201304;221;749;163;630;64;293;20;52;84;345
420180;201304;363;1257;261;968;88;337;58;198;146;535
420190;201304;451;1551;335;1316;146;635;67;265;213;900
420195;201304;1314;3828;1054;3487;290;1072;499;1669;789;2741
420200;201304;2733;9147;1835;7072;670;2867;321;1092;991;3959
420205;201304;992;3433;901;3254;302;1184;387;1407;689;2591
420207;201304;1090;3387;854;2907;280;1068;247;804;527;1872
420208;201304;461;1571;406;1440;167;620;118;420;285;1040
420209;201304;275;981;207;775;47;188;46;173;93;361
420210;201304;1659;5620;1135;4455;334;1493;143;507;477;2000
420213;201304;828;3201;793;3120;187;764;485;1929;672;2693
420215;201304;451;1612;377;1372;114;437;65;212;179;649
420220;201304;407;1644;387;1591;173;759;75;265;248;1024
420230;201304;4003;13063;3364;11925;864;3425;1821;6315;2685;9740
420240;201304;11729;37479;8196;29987;2066;8865;3098;10196;5164;19061
420243;201304;465;1626;424;1519;137;546;140;496;277;1042
420245;201304;890;2982;712;2640;218;935;143;485;361;1420
420250;201304;842;2770;794;2691;305;1113;321;1111;626;2224
420253;201304;618;1685;530;1562;117;363;262;850;379;1213
420257;201304;399;1305;338;1187;97;338;157;556;254;894
420260;201304;1254;4424;1168;4260;378;1485;537;1985;915;3470
420270;201304;335;1226;266;1009;35;133;18;62;53;195
420280;201304;2501;7624;1833;6453;577;2300;561;1751;1138;4051
420285;201304;131;404;59;220;10;42;2;5;12;47
420287;201304;601;1949;538;1828;142;518;222;750;364;1268
420290;201304;5226;16146;3734;12909;1002;3851;1314;4313;2316;8164
420300;201304;5372;17658;3816;14224;1200;5081;761;2793;1961;7874
420310;201304;728;2365;697;2306;186;660;385;1241;571;1901
420315;201304;771;2889;691;2706;191;837;315;1223;506;2060
420320;201304;4425;14984;3866;13948;1264;5168;1511;5211;2775;10379
420325;201304;477;1584;459;1535;161;604;141;451;302;1055
420330;201304;1184;4302;1006;3808;373;1524;179;585;552;2109
420340;201304;1396;4486;1220;4108;318;1192;471;1510;789;2702
420350;201304;1511;5121;1386;4884;388;1452;681;2443;1069;3895
420360;201304;3263;11167;2794;10098;1155;4549;512;1746;1667;6295
420370;201304;1815;5246;1651;5047;211;688;1345;4065;1556;4753
420380;201304;5075;17913;4405;16271;1517;6099;1134;4154;2651;10253
420390;201304;1912;5954;1239;4489;452;1778;263;852;715;2630
420395;201304;2184;6946;1757;6004;542;2090;416;1315;958;3405
420400;201304;1418;4434;1129;3869;359;1433;372;1179;731;2612
420410;201304;705;2130;570;1908;138;514;288;952;426;1466
420415;201304;426;1446;391;1358;112;411;159;554;271;965
420417;201304;766;2609;701;2469;153;545;358;1279;511;1824
420419;201304;397;1345;317;1205;156;621;88;347;244;968
420420;201304;13973;44969;11239;39010;3935;14756;3335;11476;7270;26232
420425;201304;1143;3372;787;2621;124;507;308;935;432;1442
420430;201304;3992;12891;2760;9926;891;3480;736;2610;1627;6090
420435;201304;188;661;143;537;68;281;22;80;90;361
420440;201304;1372;4141;914;3245;318;1219;164;525;482;1744
420445;201304;425;1298;339;1149;102;364;149;513;251;877
420450;201304;1167;3532;710;2602;176;753;141;413;317;1166
420455;201304;2128;6923;1941;6584;624;2391;815;2696;1439;5087
420460;201304;9319;30653;7929;27960;2442;9672;3073;10367;5515;20039
420470;201304;994;2951;781;2597;262;944;233;763;495;1707
420475;201304;144;524;120;448;45;176;32;128;77;304
420480;201304;5731;17764;4907;16475;2116;7843;865;2879;2981;10722
420490;201304;655;2385;573;2162;185;725;143;519;328;1244
420500;201304;2056;6610;1789;6132;535;1938;952;3319;1487;5257
420510;201304;181;799;177;780;79;351;36;151;115;502
420515;201304;155;592;131;525;43;180;22;87;65;267
420517;201304;903;2912;826;2743;122;416;554;1881;676;2297
420519;201304;325;1033;275;914;58;192;129;444;187;636
420520;201304;628;2059;560;1925;133;506;254;847;387;1353
420530;201304;1323;4770;1124;4245;416;1723;264;907;680;2630
420535;201304;237;810;225;783;71;277;69;223;140;500
420540;201304;18768;59933;14788;51315;5366;20267;4459;15042;9825;35309
420543;201304;422;1270;330;1118;54;196;225;759;279;955
420545;201304;1297;4339;1128;3976;374;1490;371;1217;745;2707
420550;201304;4425;15275;3921;14092;1351;5428;1227;4347;2578;9775
420555;201304;419;1443;371;1334;155;593;99;359;254;952
420560;201304;563;1708;486;1564;70;250;265;869;335;1119
420570;201304;1751;6018;1453;5290;469;1864;394;1357;863;3221
420580;201304;883;3200;786;3012;259;1102;329;1257;588;2359
420590;201304;2992;9838;2279;8150;587;2302;476;1624;1063;3926
420600;201304;642;2392;604;2301;205;865;240;883;445;1748
420610;201304;548;1882;420;1577;156;640;67;224;223;864
420620;201304;1165;3795;1042;3556;410;1524;239;796;649;2320
420630;201304;939;3206;792;2826;255;997;222;689;477;1686
420640;201304;540;1923;351;1392;94;414;42;174;136;588
420650;201304;2043;6742;1339;4969;373;1589;282;867;655;2456
420660;201304;651;2005;553;1830;114;425;302;977;416;1402
420665;201304;713;2221;518;1789;99;380;197;610;296;990
420670;201304;1584;5349;1270;4601;369;1490;209;700;578;2190
420675;201304;215;710;160;576;37;148;73;241;110;389
420680;201304;484;1385;375;1216;99;365;153;478;252;843
420690;201304;791;2881;623;2411;177;761;195;713;372;1474
420700;201304;6165;19521;5221;17531;1937;7151;1245;3989;3182;11140
420710;201304;688;2594;613;2431;246;1034;149;566;395;1600
420720;201304;1817;5969;1652;5734;494;1792;901;3125;1395;4917
420730;201304;4356;14033;3883;13208;1566;5646;1320;4474;2886;10120
420740;201304;603;2231;590;2206;174;659;342;1302;516;1961
420750;201304;2335;7854;1744;6417;462;1954;552;1796;1014;3750
420757;201304;100;362;89;343;26;110;19;64;45;174
420760;201304;409;1398;336;1197;81;323;114;398;195;721
420765;201304;516;1890;395;1534;126;512;83;311;209;823
420768;201304;1172;4378;1068;4128;349;1385;439;1788;788;3173
420770;201304;812;2720;581;2150;197;793;170;587;367;1380
420775;201304;562;1885;519;1802;121;430;297;1036;418;1466
420780;201304;1610;5140;1200;4124;379;1396;366;1197;745;2593
420785;201304;385;1287;320;1117;81;311;127;424;208;735
420790;201304;1261;4777;1085;4268;315;1317;467;1796;782;3113
420800;201304;822;2505;540;1876;156;588;122;395;278;983
420810;201304;2364;8766;2007;7851;732;3145;544;2059;1276;5204
420820;201304;7321;26567;6388;24825;2359;10176;2308;8837;4667;19013
420830;201304;2539;8851;2223;8237;880;3519;740;2647;1620;6166
420840;201304;936;3299;763;2935;273;1157;225;790;498;1947
420845;201304;997;3607;861;3323;338;1425;146;533;484;1958
420850;201304;1642;5790;1261;4975;464;1986;271;1081;735;3067
420860;201304;623;1950;452;1590;193;746;152;519;345;1265
420870;201304;1293;3979;1071;3664;449;1664;321;1092;770;2756
420880;201304;1407;4877;1201;4341;362;1368;274;975;636;2343
420890;201304;11690;28386;5660;18194;1198;4607;2243;6547;3441;11154
420895;201304;170;487;98;319;28;97;40;125;68;222
420900;201304;2111;6394;1500;5203;491;1874;374;1229;865;3103
420910;201304;20823;67110;14522;53265;4223;17534;3576;12478;7799;30012
420915;201304;639;2579;603;2466;159;647;290;1259;449;1906
420917;201304;290;927;226;764;58;222;84;238;142;460
420920;201304;160;481;110;384;40;151;19;65;59;216
420930;201304;18952;60666;16729;56493;5922;21763;5726;19347;11648;41110
420940;201304;4413;14174;3914;13060;1244;4599;1311;4097;2555;8696
420945;201304;170;593;145;521;52;208;38;124;90;332
420950;201304;470;1557;281;1106;85;379;44;164;129;543
420960;201304;1351;4447;1160;4076;439;1677;322;1031;761;2708
420970;201304;2532;8423;2274;8022;689;2518;1171;4283;1860;6801
420980;201304;352;1323;328;1259;102;386;181;722;283;1108
420985;201304;432;1457;332;1227;110;431;78;269;188;700
420990;201304;855;2634;591;2155;154;622;181;596;335;1218
421000;201304;648;2368;473;1885;157;694;54;160;211;854
421003;201304;558;1711;266;975;71;281;36;119;107;400
421005;201304;220;779;210;760;67;264;101;358;168;622
421010;201304;6225;20552;5226;18448;1866;7050;1631;5582;3497;12632
421020;201304;495;1764;443;1646;102;384;227;906;329;1290
421030;201304;1045;3882;954;3637;348;1390;294;1153;642;2543
421040;201304;792;2634;738;2530;235;879;294;959;529;1838
421050;201304;1786;5109;1189;4143;331;1314;469;1545;800;2859
421055;201304;236;860;192;733;54;234;53;175;107;409
421060;201304;515;1986;424;1716;137;597;84;314;221;911
421070;201304;741;2470;545;1990;143;600;194;720;337;1320
421080;201304;602;2058;576;1992;203;743;230;779;433;1522
421085;201304;490;1411;280;1015;76;296;56;222;132;518
421090;201304;402;1228;316;1033;88;306;139;455;227;761
421100;201304;902;2996;738;2609;232;855;186;593;418;1448
421105;201304;1294;4441;1178;4224;332;1271;536;2013;868;3284
421110;201304;1606;5407;1397;5061;529;2096;455;1588;984;3684
421120;201304;1447;4987;1215;4442;326;1392;392;1327;718;2719
421125;201304;328;1168;310;1114;122;464;102;340;224;804
421130;201304;4669;16022;4104;14991;1752;6826;1191;4509;2943;11335
421140;201304;388;1304;334;1175;109;416;115;389;224;805
421145;201304;442;1577;405;1468;77;318;197;682;274;1000
421150;201304;422;1540;349;1392;108;446;149;598;257;1044
421160;201304;713;2332;520;1935;134;551;145;516;279;1067
421165;201304;305;1130;251;944;65;257;102;392;167;649
421170;201304;1786;5987;1532;5286;499;1806;699;2363;1198;4169
421175;201304;1201;3871;1009;3557;379;1498;313;1017;692;2515
421180;201304;430;1368;304;1102;102;420;112;359;214;779
421185;201304;392;1231;335;1119;65;211;169;590;234;801
421187;201304;295;968;255;887;74;271;96;319;170;590
421189;201304;522;1636;470;1527;131;462;188;604;319;1066
421190;201304;8654;29636;7268;26636;2545;9908;2343;8568;4888;18476
421200;201304;1014;3583;916;3365;288;1176;420;1502;708;2678
421205;201304;195;663;152;562;35;150;35;109;70;259
421210;201304;1894;6188;1768;5857;603;2121;621;2045;1224;4166
421220;201304;2330;8348;2113;7919;719;2870;747;2855;1466;5725
421223;201304;778;2360;540;1948;176;663;273;977;449;1640
421225;201304;1082;3494;959;3245;283;1013;381;1271;664;2284
421227;201304;900;3223;853;3146;250;916;487;1882;737;2798
421230;201304;742;2587;681;2431;197;753;261;902;458;1655
421240;201304;512;1793;392;1439;125;497;59;197;184;694
421250;201304;1788;5760;1305;4871;489;1988;376;1364;865;3352
421260;201304;229;766;161;628;39;156;36;135;75;291
421270;201304;596;1763;383;1381;144;541;90;347;234;888
421280;201304;1496;4935;1245;4543;475;1990;303;1103;778;3093
421290;201304;1897;5617;1323;4485;462;1675;298;918;760;2593
421300;201304;270;947;250;902;131;521;66;208;197;729
421310;201304;504;1781;435;1586;156;574;105;375;261;949
421315;201304;341;1075;226;805;59;226;78;267;137;493
421320;201304;499;1750;343;1302;77;339;61;166;138;505
421330;201304;602;2203;538;2069;236;1020;66;246;302;1266
421335;201304;541;1876;444;1679;143;594;106;397;249;991
421340;201304;1563;5450;1481;5307;532;2025;592;2127;1124;4152
421350;201304;940;3345;796;3032;309;1304;217;799;526;2103
421360;201304;3069;10008;2272;8313;601;2495;781;2735;1382;5230
421370;201304;1054;3908;921;3602;340;1453;250;967;590;2420
421380;201304;972;2928;825;2650;181;613;403;1292;584;1905
421390;201304;184;615;149;529;24;93;44;159;68;252
421400;201304;359;1465;304;1320;137;609;70;291;207;900
421410;201304;303;1076;270;1002;67;250;136;521;203;771
421415;201304;307;1036;206;817;72;297;58;224;130;521
421420;201304;1371;4472;1098;3770;276;1015;251;815;527;1830
421430;201304;250;872;193;745;74;318;34;134;108;452
421440;201304;739;2367;554;2018;197;757;211;775;408;1532
421450;201304;606;2205;525;2001;229;932;139;525;368;1457
421460;201304;559;1986;452;1751;136;574;104;374;240;948
421470;201304;463;1852;434;1767;141;611;176;686;317;1297
421480;201304;2246;7784;1766;6712;599;2532;547;1916;1146;4448
421490;201304;216;839;195;787;96;402;37;147;133;549
421500;201304;2584;9592;2344;9092;1045;4381;559;2142;1604;6523
421505;201304;383;1361;352;1277;139;508;116;427;255;935
421507;201304;556;2031;513;1911;129;493;204;755;333;1248
421510;201304;265;1044;246;999;84;378;92;331;176;709
421520;201304;673;2023;544;1770;76;296;333;1049;409;1345
421530;201304;395;1435;302;1226;97;441;112;435;209;876
421535;201304;564;1923;440;1680;104;432;212;807;316;1239
421540;201304;357;1145;313;1056;75;285;113;360;188;645
421545;201304;1146;4170;994;3851;344;1466;206;761;550;2227
421550;201304;1888;6836;1769;6587;706;2817;592;2188;1298;5005
421555;201304;215;744;132;493;35;144;32;112;67;256
421560;201304;188;664;123;486;42;170;16;58;58;228
421565;201304;1023;3395;948;3257;449;1631;285;960;734;2591
421567;201304;932;3643;820;3328;417;1723;152;630;569;2353
421568;201304;378;1445;360;1399;126;514;120;462;246;976
421569;201304;145;537;128;484;32;137;40;132;72;269
421570;201304;885;3172;743;2840;286;1200;191;680;477;1880
421575;201304;606;2105;543;1971;118;443;281;1043;399;1486
421580;201304;3932;13732;3289;12296;1352;5572;746;2602;2098;8174
421590;201304;248;833;213;740;50;180;97;323;147;503
421600;201304;728;2387;619;2164;206;756;179;621;385;1377
421605;201304;607;1980;441;1645;148;623;103;382;251;1005
421610;201304;1801;4817;1422;4259;225;750;882;2641;1107;3391
421620;201304;4492;14257;3412;12049;1253;4761;1119;3995;2372;8756
421625;201304;319;1182;263;1007;89;368;89;314;178;682
421630;201304;2234;7253;1606;5748;467;1818;411;1457;878;3275
421635;201304;270;1000;238;944;67;288;98;361;165;649
421640;201304;1061;3559;958;3382;219;791;578;2081;797;2872
421650;201304;2266;8028;2079;7610;903;3602;341;1198;1244;4800
421660;201304;8386;29711;7011;26945;2614;11000;2080;7631;4694;18631
421670;201304;1041;3697;869;3255;254;1036;267;990;521;2026
421680;201304;1353;4689;1252;4429;531;2030;220;700;751;2730
421690;201304;1944;6719;1569;5776;502;1983;323;1172;825;3155
421700;201304;719;2338;509;1916;179;732;141;474;320;1206
421710;201304;323;1187;277;1062;113;443;67;249;180;692
421715;201304;223;752;183;651;49;182;57;209;106;391
421720;201304;2092;6290;1493;5383;632;2519;447;1542;1079;4061
421725;201304;118;445;113;431;39;155;47;173;86;328
421730;201304;480;1670;323;1240;100;436;87;280;187;716
421740;201304;635;2118;511;1823;160;664;133;395;293;1059
421750;201304;1281;4187;1079;3742;355;1319;341;1092;696;2411
421755;201304;398;1406;336;1221;97;371;87;307;184;678
421760;201304;335;1158;272;1032;95;407;118;418;213;825
421770;201304;3469;10994;2964;10041;1422;4998;722;2569;2144;7567
421775;201304;514;1676;394;1432;98;372;132;477;230;849
421780;201304;1670;6008;1391;5387;599;2481;370;1355;969;3836
421790;201304;845;2662;590;2176;205;862;125;418;330;1280
421795;201304;317;1049;275;927;51;179;86;290;137;469
421800;201304;2175;7704;1837;6984;573;2439;584;1996;1157;4435
421810;201304;698;2436;599;2176;203;792;128;448;331;1240
421820;201304;963;3327;856;3099;208;889;327;1103;535;1992
421825;201304;1212;4350;1156;4203;207;845;641;2284;848;3129
421830;201304;2928;10500;2789;10240;660;2436;1646;6397;2306;8833
421835;201304;162;560;137;510;55;228;47;158;102;386
421840;201304;500;1833;453;1707;183;764;158;552;341;1316
421850;201304;530;1632;433;1485;157;553;154;577;311;1130
421860;201304;416;1431;323;1217;79;329;86;303;165;632
421870;201304;4969;15223;3665;12493;1211;4433;688;2284;1899;6717
421875;201304;233;824;170;648;44;193;43;136;87;329
421880;201304;856;3075;757;2840;288;1223;150;489;438;1712
421885;201304;345;1257;320;1185;90;348;152;567;242;915
421890;201304;1042;3699;908;3405;330;1329;282;1017;612;2346
421895;201304;405;1447;395;1430;119;433;207;774;326;1207
421900;201304;820;2786;688;2448;186;706;254;842;440;1548
421910;201304;456;1618;366;1387;109;483;88;278;197;761
421915;201304;584;1897;520;1772;88;341;328;1110;416;1451
421917;201304;479;1656;417;1534;152;638;113;367;265;1005
421920;201304;692;2291;610;2176;293;1117;187;606;480;1723
421930;201304;3516;10928;2704;9275;869;3317;442;1484;1311;4801
421935;201304;792;3016;693;2770;209;904;256;1027;465;1931
421940;201304;285;1153;253;1047;90;405;78;299;168;704
421950;201304;3911;11560;2517;8849;847;3142;535;1936;1382;5078
421960;201304;230;783;195;698;59;224;57;194;116;418
421970;201304;1846;6048;1542;5334;563;2119;343;1061;906;3180
421985;201304;385;1160;267;914;49;204;93;325;142;529
430003;201304;900;2672;732;2389;227;827;278;910;505;1737
430005;201304;265;946;245;901;59;242;130;441;189;683
430010;201304;1892;5964;1539;5182;518;1800;560;1933;1078;3733
430020;201304;1053;2992;942;2821;248;835;498;1416;746;2251
430030;201304;1447;4258;1309;3962;413;1304;519;1529;932;2833
430040;201304;12492;32921;11231;31290;3476;9846;5717;16621;9193;26467
430045;201304;638;1919;573;1792;90;327;379;1151;469;1478
430047;201304;187;552;166;510;39;125;89;278;128;403
430050;201304;876;2596;607;2061;97;401;311;1023;408;1424
430055;201304;235;739;199;644;48;174;109;342;157;516
430057;201304;69;186;30;101;7;30;13;31;20;61
430060;201304;13128;45242;12178;43611;4328;16035;5516;20256;9844;36291
430063;201304;931;2985;839;2748;270;901;365;1256;635;2157
430064;201304;1623;5007;1401;4620;347;1142;801;2757;1148;3899
430066;201304;141;389;115;350;38;124;51;152;89;276
430070;201304;472;1651;415;1519;108;422;148;516;256;938
430080;201304;529;1851;448;1647;126;514;102;349;228;863
430085;201304;478;1616;430;1528;142;558;201;684;343;1242
430087;201304;923;2845;906;2810;96;322;766;2366;862;2688
430090;201304;679;1866;272;904;37;141;99;321;136;462
430100;201304;887;3065;811;2890;319;1252;211;643;530;1895
430105;201304;614;2137;549;2005;219;843;134;471;353;1314
430107;201304;252;854;208;726;46;175;107;360;153;535
430110;201304;2106;6444;1979;6243;655;2248;954;2978;1609;5226
430120;201304;1573;5081;1394;4704;217;758;1001;3375;1218;4133
430130;201304;4371;11424;4084;11063;693;1981;2786;7716;3479;9697
430140;201304;1079;3641;905;3214;308;1101;331;1200;639;2301
430150;201304;812;2354;627;1999;154;520;222;707;376;1227
430155;201304;481;1569;373;1324;96;328;156;564;252;892
430160;201304;17484;53291;16453;51617;3895;13367;9059;29112;12954;42479
430163;201304;1755;5529;1531;5099;372;1397;704;2359;1076;3756
430165;201304;256;968;233;920;108;429;44;174;152;603
430170;201304;688;2121;416;1488;122;499;115;364;237;863
430175;201304;898;3156;815;2969;215;762;449;1724;664;2486
430180;201304;1135;3239;1013;3064;201;648;599;1868;800;2516
430185;201304;698;1818;405;1242;67;252;143;362;210;614
430187;201304;730;2344;678;2270;185;726;332;1080;517;1806
430190;201304;2205;6763;1958;6324;521;1927;941;3059;1462;4986
430192;201304;194;627;156;517;36;132;73;226;109;358
430195;201304;188;613;87;334;15;63;14;42;29;105
430200;201304;1722;5803;1528;5447;618;2321;297;1092;915;3413
430205;201304;457;1437;385;1308;44;186;263;882;307;1068
430210;201304;5638;17017;3553;12367;1047;3882;684;2217;1731;6099
430215;201304;295;943;250;853;66;252;124;406;190;658
430220;201304;572;1551;314;1077;73;284;54;167;127;451
430222;201304;300;948;234;806;75;290;96;308;171;598
430223;201304;259;885;254;872;74;262;148;505;222;767
430225;201304;39;134;35;118;4;9;7;20;11;29
430230;201304;2134;6855;2010;6723;387;1207;1480;5143;1867;6350
430235;201304;215;743;178;656;67;275;35;107;102;382
430237;201304;354;1067;319;1000;39;164;229;676;268;840
430240;201304;983;3123;819;2782;316;1204;225;666;541;1870
430245;201304;770;2792;687;2578;190;726;298;1159;488;1885
430250;201304;1587;4531;1460;4298;496;1541;615;1880;1111;3421
430258;201304;171;533;136;451;27;89;69;227;96;316
430260;201304;773;2279;545;1800;77;303;308;1007;385;1310
430265;201304;319;1056;278;960;136;496;42;110;178;606
430270;201304;3323;9818;3068;9410;879;3053;1509;4540;2388;7593
430280;201304;4937;14916;4514;14099;1479;4987;1962;6022;3441;11009
430290;201304;2334;6793;2219;6668;336;1030;1763;5395;2099;6425
430300;201304;9279;29781;8223;27802;3477;12261;3010;10582;6487;22843
430310;201304;7966;26044;7347;24878;2584;9376;3051;10167;5635;19543
430320;201304;765;2440;592;2088;101;348;294;1088;395;1436
430330;201304;916;2623;835;2478;218;712;391;1086;609;1798
430340;201304;637;1792;452;1531;120;462;213;707;333;1169
430350;201304;5889;19622;5239;18157;1881;6972;2025;6916;3906;13888
430355;201304;203;592;141;475;31;134;32;99;63;233
430360;201304;991;2763;910;2632;150;475;575;1666;725;2141
430367;201304;330;956;236;777;35;134;95;296;130;430
430370;201304;540;1682;486;1563;175;604;132;391;307;995
430380;201304;847;2236;472;1550;153;509;151;533;304;1042
430390;201304;3712;11879;3147;10613;849;3138;1028;3278;1877;6416
430400;201304;1223;3034;893;2567;198;690;492;1315;690;2005
430410;201304;660;1880;535;1675;112;388;294;929;406;1317
430420;201304;4178;12738;3619;11472;1162;3792;1483;4726;2645;8518
430430;201304;636;1908;491;1628;164;587;129;393;293;980
430435;201304;1718;4966;1623;4812;336;1001;1075;3250;1411;4251
430440;201304;4081;13177;3552;12328;900;3474;1483;5227;2383;8701
430450;201304;8777;26580;7552;23939;2564;8468;2926;9333;5490;17801
430460;201304;22536;71489;19238;65646;7051;25698;6993;24160;14044;49858
430461;201304;462;1320;153;510;36;119;35;124;71;243
430462;201304;314;991;274;920;112;386;88;297;200;683
430463;201304;3574;12202;3212;11443;897;3506;1533;5446;2430;8952
430465;201304;580;1694;490;1528;129;448;281;866;410;1314
430466;201304;4021;12379;3830;12035;1305;4408;1702;5384;3007;9792
430467;201304;538;1725;479;1622;140;514;220;743;360;1257
430468;201304;1337;4100;1212;3899;523;1838;256;798;779;2636
430469;201304;117;337;40;165;12;51;9;39;21;90
430470;201304;6421;18039;5265;16208;1847;6154;2017;6245;3864;12399
430471;201304;908;3153;832;2982;330;1255;187;662;517;1917
430480;201304;772;2289;513;1723;107;397;125;374;232;771
430485;201304;213;678;130;483;26;90;50;206;76;296
430490;201304;481;1476;352;1224;119;442;111;387;230;829
430495;201304;387;1219;283;987;78;301;75;258;153;559
430500;201304;1573;4583;1408;4295;400;1367;707;2112;1107;3479
430510;201304;25257;81522;19891;67897;6986;25979;5623;18459;12609;44438
430511;201304;455;1442;296;1038;89;305;57;198;146;503
430512;201304;1268;3455;1139;3240;335;980;494;1482;829;2462
430513;201304;580;1764;447;1469;88;301;208;676;296;977
430515;201304;565;1775;497;1610;102;356;218;727;320;1083
430517;201304;1263;4454;1205;4316;244;928;740;2622;984;3550
430520;201304;1654;5109;1442;4670;495;1722;616;1968;1111;3690
430530;201304;869;2589;607;2017;150;571;187;570;337;1141
430535;201304;2168;7387;1928;6805;560;2157;663;2343;1223;4500
430537;201304;556;1646;406;1406;60;204;310;1108;370;1312
430540;201304;692;1818;562;1638;130;430;324;896;454;1326
430543;201304;569;1567;521;1518;130;405;319;950;449;1355
430544;201304;658;2302;584;2087;140;530;297;1030;437;1560
430545;201304;1222;4169;1093;4008;356;1162;626;2582;982;3744
430550;201304;564;1884;469;1647;129;497;184;640;313;1137
430558;201304;113;337;86;284;34;124;15;39;49;163
430560;201304;313;887;253;776;57;221;109;314;166;535
430570;201304;1075;2995;850;2602;212;720;451;1320;663;2040
430580;201304;923;2823;680;2315;247;873;183;650;430;1523
430583;201304;117;335;56;188;6;26;12;38;18;64
430585;201304;297;888;244;764;81;289;113;323;194;612
430587;201304;301;964;268;896;132;454;78;254;210;708
430590;201304;1544;4431;1469;4310;320;1071;878;2486;1198;3557
430593;201304;36;143;34;136;14;58;10;37;24;95
430595;201304;147;465;100;373;40;156;13;41;53;197
430597;201304;366;1183;314;1062;55;201;145;465;200;666
430600;201304;1783;5337;1394;4458;343;1146;543;1733;886;2879
430605;201304;1230;4085;1061;3702;280;1075;428;1535;708;2610
430607;201304;657;1860;585;1728;114;387;363;1019;477;1406
430610;201304;7726;22039;6449;19989;1470;5112;3342;10298;4812;15410
430613;201304;187;526;139;428;38;131;63;175;101;306
430620;201304;923;2978;787;2667;250;946;301;938;551;1884
430630;201304;412;1319;271;944;86;304;61;196;147;500
430632;201304;687;1994;482;1572;73;287;290;905;363;1192
430635;201304;607;1819;473;1547;90;323;273;891;363;1214
430637;201304;477;1404;448;1353;63;222;326;945;389;1167
430640;201304;1579;4802;1098;3677;275;1002;235;663;510;1665
430642;201304;435;1253;346;1117;67;227;205;676;272;903
430645;201304;163;516;105;373;30;116;22;72;52;188
430650;201304;1871;6657;1682;6168;428;1623;884;3336;1312;4959
430655;201304;295;939;275;887;63;234;103;276;166;510
430660;201304;5528;17478;4635;15741;1657;6097;1755;5921;3412;12018
430670;201304;486;1448;445;1375;48;142;338;1079;386;1221
430673;201304;675;1758;457;1420;134;430;212;665;346;1095
430675;201304;165;506;126;424;21;82;64;214;85;296
430676;201304;4345;13720;4094;13316;1253;4402;2013;6710;3266;11112
430680;201304;1147;3547;923;3054;221;850;379;1151;600;2001
430690;201304;4183;12614;3613;11545;1200;3934;1564;5230;2764;9164
430692;201304;268;959;208;822;40;164;122;496;162;660
430693;201304;1715;5010;1405;4309;325;1094;485;1447;810;2541
430695;201304;489;1462;410;1300;93;333;193;568;286;901
430697;201304;386;1141;324;1049;108;355;138;476;246;831
430700;201304;9850;27380;5778;19112;1330;4936;969;3031;2299;7967
430705;201304;405;1289;378;1241;115;406;186;615;301;1021
430710;201304;1749;4786;1465;4333;323;1012;840;2620;1163;3632
430720;201304;724;2028;525;1732;156;551;236;786;392;1337
430730;201304;1601;4761;1464;4538;348;1061;878;2840;1226;3901
430740;201304;539;1685;415;1407;152;533;91;312;243;845
430745;201304;499;1498;404;1308;63;222;243;760;306;982
430750;201304;1700;5076;1531;4774;474;1656;767;2260;1241;3916
430755;201304;612;1814;465;1490;127;469;189;543;316;1012
430760;201304;3245;8990;2799;8424;593;1909;1631;5069;2224;6978
430770;201304;6313;19969;5457;18390;1437;5273;2510;8351;3947;13624
430780;201304;1711;5437;1540;5133;553;2007;587;1790;1140;3797
430781;201304;610;1951;484;1695;152;552;203;716;355;1268
430783;201304;520;1447;441;1315;93;302;208;576;301;878
430786;201304;115;406;104;373;40;156;13;43;53;199
430790;201304;2857;8417;2130;6976;512;1933;946;2973;1458;4906
430800;201304;702;2307;638;2164;197;712;238;789;435;1501
430805;201304;416;1287;356;1170;27;108;254;835;281;943
430807;201304;247;820;235;792;53;194;125;413;178;607
430810;201304;480;1499;304;1082;59;252;56;174;115;426
430820;201304;1095;3793;969;3482;327;1275;319;1095;646;2370
430825;201304;446;1311;259;851;50;184;79;230;129;414
430830;201304;2671;8178;2497;7867;438;1418;1574;5262;2012;6680
430840;201304;886;2916;855;2858;228;693;503;1785;731;2478
430843;201304;97;326;76;255;16;51;31;102;47;153
430845;201304;461;1416;397;1298;138;474;88;283;226;757
430850;201304;3186;10136;2911;9619;945;3302;1147;3816;2092;7118
430860;201304;579;2029;518;1878;182;772;119;374;301;1146
430865;201304;699;2013;653;1922;194;591;352;1042;546;1633
430870;201304;429;1412;352;1247;123;445;129;445;252;890
430880;201304;1311;4000;1113;3588;471;1639;273;895;744;2534
430885;201304;157;558;138;516;52;198;35;133;87;331
430890;201304;1789;5067;1594;4759;201;676;1140;3457;1341;4133
430900;201304;3180;8910;3023;8702;586;1742;2054;6075;2640;7817
430905;201304;858;2831;739;2550;265;984;211;698;476;1682
430910;201304;1647;5518;1476;5220;599;2304;528;1821;1127;4125
430912;201304;559;1680;452;1495;90;353;232;731;322;1084
430915;201304;364;1330;297;1170;92;403;99;369;191;772
430920;201304;15949;52916;15257;51800;5557;19458;8360;28371;13917;47829
430925;201304;90;259;74;229;21;71;39;120;60;191
430930;201304;8466;27872;7504;25949;2282;8358;3289;11691;5571;20049
430940;201304;1017;3294;873;3038;226;901;302;1008;528;1909
430950;201304;1559;4564;1249;3889;400;1312;396;1210;796;2522
430955;201304;90;309;72;261;28;110;15;51;43;161
430957;201304;293;1060;258;976;68;262;123;472;191;734
430960;201304;1616;4910;1394;4512;549;1864;495;1609;1044;3473
430965;201304;1136;3841;992;3524;246;965;540;1853;786;2818
430970;201304;475;1429;341;1134;100;362;98;317;198;679
430975;201304;589;2007;527;1857;107;389;342;1205;449;1594
430980;201304;538;1382;347;1096;100;357;126;350;226;707
430990;201304;608;2048;475;1688;170;631;104;368;274;999
430995;201304;673;2103;624;2009;210;681;270;905;480;1586
431000;201304;1556;4410;1027;3328;291;1071;154;429;445;1500
431010;201304;2316;7425;1800;6336;571;2193;575;1931;1146;4124
431020;201304;13483;35047;9808;28353;2980;9102;3131;9341;6111;18443
431030;201304;381;1216;260;909;52;193;70;261;122;454
431033;201304;2626;8061;2468;7835;622;2030;1447;4846;2069;6876
431036;201304;146;452;93;319;25;92;22;64;47;156
431040;201304;948;2901;837;2707;256;908;416;1313;672;2221
431041;201304;565;1607;509;1523;187;592;164;518;351;1110
431043;201304;362;1238;297;1083;144;574;93;295;237;869
431046;201304;110;340;87;290;26;92;36;117;62;209
431050;201304;1736;4532;1562;4315;304;830;1062;3051;1366;3881
431053;201304;570;1957;512;1843;174;689;194;672;368;1361
431055;201304;616;1858;598;1829;78;241;456;1424;534;1665
431057;201304;272;827;180;641;48;191;82;280;130;471
431060;201304;5970;18060;5718;17773;1057;2937;4209;13755;5266;16692
431065;201304;432;1366;418;1344;40;129;320;1042;360;1171
431070;201304;733;2200;576;1865;142;453;241;777;383;1230
431075;201304;249;787;179;622;34;136;57;197;91;333
431080;201304;592;1994;498;1790;147;558;89;313;236;871
431085;201304;891;2470;728;2194;144;466;395;1189;539;1655
431087;201304;585;1761;541;1680;32;82;460;1458;492;1540
431090;201304;426;1201;290;942;95;329;83;254;178;583
431100;201304;4579;13151;3974;12103;1142;3717;1817;5636;2959;9353
431110;201304;1458;4212;1267;3837;350;1101;696;2072;1046;3173
431112;201304;721;2336;693;2288;233;795;346;1165;579;1960
431113;201304;609;1903;481;1605;165;544;133;463;298;1007
431115;201304;1414;4426;1333;4279;327;1106;786;2493;1113;3599
431120;201304;2545;8553;2347;8176;758;2932;1006;3363;1764;6295
431123;201304;504;1675;440;1542;111;400;225;809;336;1209
431125;201304;1223;4102;1093;3833;349;1263;508;1856;857;3119
431127;201304;106;310;71;228;12;41;20;61;32;102
431130;201304;3686;11003;3195;10192;981;3432;1444;4648;2425;8080
431140;201304;3245;9439;2253;7582;522;2075;775;2388;1297;4463
431142;201304;533;1639;498;1586;75;260;339;1101;414;1361
431150;201304;1294;4047;1083;3651;314;1082;396;1376;710;2458
431160;201304;833;2629;716;2361;159;522;395;1327;554;1849
431162;201304;404;1177;268;901;49;190;67;204;116;394
431164;201304;77;226;33;123;10;37;1;4;11;41
431170;201304;876;2710;749;2452;241;846;240;770;481;1616
431171;201304;839;2650;769;2514;272;964;204;623;476;1587
431173;201304;459;1449;435;1402;97;328;273;877;370;1205
431175;201304;1301;3724;1149;3491;387;1244;502;1516;889;2760
431177;201304;962;3268;883;3105;303;1129;390;1395;693;2524
431179;201304;111;320;90;281;19;75;40;104;59;179
431180;201304;3022;9584;2603;8559;766;2785;837;2576;1603;5361
431190;201304;732;2102;494;1646;148;542;182;599;330;1141
431198;201304;335;1128;305;1066;140;557;62;197;202;754
431200;201304;226;701;118;414;26;102;23;77;49;179
431205;201304;280;947;229;799;61;219;77;258;138;477
431210;201304;741;2207;653;2018;162;522;353;1077;515;1599
431213;201304;315;1018;272;939;83;320;110;362;193;682
431215;201304;307;931;180;629;53;208;32;97;85;305
431217;201304;213;704;194;662;72;270;49;169;121;439
431220;201304;1193;3146;994;2817;156;503;574;1595;730;2098
431225;201304;1300;4048;1186;3864;297;1026;704;2344;1001;3370
431230;201304;905;2828;750;2502;132;489;410;1371;542;1860
431235;201304;38;112;34;102;14;45;13;38;27;83
431237;201304;401;1383;361;1318;153;642;131;438;284;1080
431238;201304;49;167;43;155;11;46;15;50;26;96
431240;201304;2749;9114;2431;8516;890;3304;824;2869;1714;6173
431242;201304;425;1416;407;1384;191;717;31;100;222;817
431244;201304;419;1075;335;944;65;224;170;448;235;672
431245;201304;825;2486;750;2354;175;581;452;1438;627;2019
431247;201304;188;611;167;573;63;230;62;205;125;435
431250;201304;1857;6063;1676;5793;579;2142;681;2450;1260;4592
431260;201304;305;980;267;904;70;268;57;181;127;449
431261;201304;223;835;206;799;54;237;81;298;135;535
431262;201304;294;901;168;617;29;134;71;255;100;389
431265;201304;1151;3288;827;2563;223;791;298;788;521;1579
431267;201304;175;572;159;542;46;169;63;198;109;367
431270;201304;2257;6690;2054;6385;693;2300;985;3088;1678;5388
431275;201304;209;702;154;553;52;188;34;110;86;298
431280;201304;136;454;100;366;33;139;20;59;53;198
431290;201304;301;1005;242;843;65;254;63;213;128;467
431295;201304;201;670;123;426;26;103;24;67;50;170
431300;201304;123;455;95;367;33;128;9;37;42;165
431301;201304;227;812;179;669;64;235;29;101;93;336
431303;201304;585;1700;517;1590;146;504;229;683;375;1187
431306;201304;1959;5659;1526;4854;339;1279;571;1621;910;2900
431308;201304;52;184;50;179;38;139;9;29;47;168
431310;201304;732;2439;572;2056;103;412;242;881;345;1293
431320;201304;763;2340;502;1801;161;633;107;358;268;991
431330;201304;1692;4589;978;3247;291;1072;224;727;515;1799
431333;201304;291;841;229;712;62;205;81;237;143;442
431335;201304;100;316;87;290;19;61;30;94;49;155
431337;201304;2306;7586;2100;7161;711;2561;752;2597;1463;5158
431339;201304;656;1983;535;1700;115;380;288;930;403;1310
431340;201304;25678;71949;19987;62282;5216;18197;8782;26703;13998;44900
431342;201304;565;1592;532;1532;119;355;338;961;457;1316
431344;201304;358;1042;291;925;23;77;187;605;210;682
431346;201304;240;707;183;561;55;185;56;164;111;349
431349;201304;497;1550;433;1388;87;278;215;699;302;977
431350;201304;3552;11132;3312;10743;536;1987;2246;7113;2782;9100
431360;201304;710;2059;583;1839;188;624;211;653;399;1277
431365;201304;1236;4005;1097;3767;457;1702;388;1305;845;3007
431370;201304;5253;16007;4671;15096;1166;4009;2566;8528;3732;12537
431380;201304;1120;3419;1052;3249;163;569;764;2314;927;2883
431390;201304;3505;10875;2859;9559;1055;3803;815;2599;1870;6402
431395;201304;1561;4878;1422;4657;358;1262;638;2150;996;3412
431400;201304;135;498;105;423;39;176;12;35;51;211
431402;201304;1125;2975;772;2339;154;515;376;1102;530;1617
431403;201304;309;922;234;784;82;311;49;148;131;459
431405;201304;4143;12257;3379;11078;783;3098;1671;5197;2454;8295
431406;201304;720;2405;583;2047;206;752;208;717;414;1469
431407;201304;622;1999;496;1681;166;571;147;489;313;1060
431410;201304;15815;51127;13480;46553;5716;20911;3375;12290;9091;33201
431413;201304;159;441;107;333;14;52;56;168;70;220
431415;201304;835;2515;758;2374;195;675;423;1302;618;1977
431417;201304;654;1747;528;1545;100;314;288;874;388;1188
431420;201304;1571;4481;1423;4251;354;1139;790;2381;1144;3520
431430;201304;521;1546;436;1404;132;475;180;550;312;1025
431440;201304;31344;95244;29026;91289;9881;32460;13307;43374;23188;75834
431442;201304;198;656;154;539;49;192;18;47;67;239
431445;201304;433;1274;356;1097;63;209;164;500;227;709
431446;201304;476;1426;374;1232;79;265;218;724;297;989
431447;201304;821;2446;624;1992;111;371;300;989;411;1360
431449;201304;833;2532;733;2360;130;454;409;1335;539;1789
431450;201304;2147;5872;2010;5674;551;1568;1176;3350;1727;4918
431455;201304;574;1534;440;1281;72;259;262;729;334;988
431460;201304;3638;10598;3240;9836;899;2903;1458;4486;2357;7389
431470;201304;2085;6387;1914;6009;568;1783;898;2950;1466;4733
431475;201304;91;310;60;239;18;71;4;16;22;87
431477;201304;584;1758;497;1589;126;408;258;825;384;1233
431478;201304;168;453;92;284;23;76;37;111;60;187
431480;201304;2302;7195;1904;6433;665;2406;482;1638;1147;4044
431490;201304;98432;293444;88717;279126;17904;63729;56828;175918;74732;239647
431500;201304;1170;3130;942;2707;293;865;315;899;608;1764
431505;201304;343;1029;332;1014;39;115;264;813;303;928
431507;201304;426;1112;391;1055;114;318;221;602;335;920
431510;201304;2169;6158;1893;5718;321;1044;1214;3635;1535;4679
431513;201304;205;653;183;598;47;165;77;255;124;420
431514;201304;107;270;64;201;12;41;34;110;46;151
431515;201304;740;2320;595;1972;140;510;300;933;440;1443
431517;201304;84;301;81;292;37;133;18;59;55;192
431520;201304;428;1389;346;1196;116;417;88;316;204;733
431530;201304;4371;11205;3633;10407;845;2351;2302;7129;3147;9480
431531;201304;262;764;195;635;55;204;79;269;134;473
431532;201304;513;1538;487;1483;101;337;284;852;385;1189
431535;201304;371;1115;256;810;64;233;59;163;123;396
431540;201304;2037;6916;1883;6713;186;534;1463;5599;1649;6133
431545;201304;132;411;66;242;6;26;10;37;16;63
431550;201304;2392;7463;2250;7192;574;2083;1064;3350;1638;5433
431555;201304;739;2051;678;1955;149;438;366;1050;515;1488
431560;201304;22349;72682;20650;69431;9074;30851;6842;24439;15916;55290
431570;201304;5361;15997;5101;15583;779;2365;3814;11851;4593;14216
431575;201304;389;1188;342;1115;65;235;186;583;251;818
431580;201304;689;2262;600;2056;160;617;229;725;389;1342
431590;201304;880;2706;730;2356;88;310;403;1309;491;1619
431595;201304;599;1779;539;1651;136;450;224;705;360;1155
431600;201304;2098;6622;1729;5811;525;1994;385;1118;910;3112
431610;201304;1546;4559;1209;3960;313;1117;614;1999;927;3116
431620;201304;274;897;228;759;81;288;94;292;175;580
431630;201304;1312;3730;1101;3279;251;770;596;1798;847;2568
431640;201304;5450;17469;5134;16929;1663;5956;2482;8015;4145;13971
431642;201304;483;1515;449;1430;64;240;266;816;330;1056
431643;201304;173;536;163;517;48;165;84;246;132;411
431645;201304;1766;5583;1646;5377;412;1369;959;3232;1371;4601
431647;201304;162;470;136;414;45;142;38;96;83;238
431650;201304;186;617;134;509;33;146;31;104;64;250
431660;201304;1423;4388;1156;3822;400;1395;423;1330;823;2725
431670;201304;1290;3782;1096;3430;341;1211;442;1305;783;2516
431673;201304;150;525;131;477;41;161;36;137;77;298
431675;201304;279;948;225;777;57;206;65;196;122;402
431680;201304;9339;28062;7739;25168;2585;8999;2900;9514;5485;18513
431690;201304;24089;71846;20402;66340;6764;23436;8443;27983;15207;51419
431695;201304;134;486;111;414;27;100;25;72;52;172
431697;201304;468;1393;447;1355;137;438;203;618;340;1056
431700;201304;1622;4727;1442;4380;299;1008;783;2312;1082;3320
431710;201304;12399;37736;10709;34807;3100;10556;5069;17106;8169;27662
431720;201304;6817;20172;5997;18756;1482;5240;3295;10054;4777;15294
431725;201304;41;150;40;147;22;82;6;22;28;104
431730;201304;3517;11353;3017;10411;908;3489;1252;4293;2160;7782
431740;201304;5877;17926;5375;16980;1840;6238;2003;6243;3843;12481
431750;201304;10049;29835;8764;27689;1792;6109;4834;15577;6626;21686
431755;201304;214;600;82;289;25;102;21;58;46;160
431760;201304;3589;11521;3151;10669;997;3635;926;3090;1923;6725
431770;201304;2250;6478;1972;6018;502;1687;1056;3148;1558;4835
431775;201304;229;677;190;602;77;263;59;170;136;433
431780;201304;2443;6883;2049;6148;658;2112;599;1736;1257;3848
431790;201304;1067;3555;996;3428;291;1075;520;1772;811;2847
431795;201304;416;1372;361;1199;54;193;225;741;279;934
431800;201304;9228;28245;8049;26119;2591;9202;2937;9403;5528;18605
431805;201304;231;574;66;238;19;81;12;42;31;123
431810;201304;3648;10715;3214;9800;880;2889;1488;4497;2368;7386
431820;201304;2652;8696;2426;8250;820;3014;724;2421;1544;5435
431830;201304;9957;28103;8782;26177;3328;10756;3168;9437;6496;20193
431840;201304;3455;10788;3095;10055;1010;3380;1324;4393;2334;7773
431842;201304;695;1875;436;1364;94;326;149;446;243;772
431843;201304;306;977;285;938;82;295;145;470;227;765
431844;201304;158;491;126;427;37;141;38;131;75;272
431845;201304;535;1697;507;1642;52;170;370;1226;422;1396
431846;201304;499;1586;450;1479;83;310;259;846;342;1156
431848;201304;194;532;96;331;19;79;23;72;42;151
431849;201304;299;793;142;443;27;91;40;113;67;204
431850;201304;4911;14705;4433;13814;1126;3904;2305;6973;3431;10877
431860;201304;941;2803;832;2616;236;806;397;1196;633;2002
431861;201304;79;261;57;196;16;61;12;38;28;99
431862;201304;472;1668;420;1555;160;638;127;461;287;1099
431870;201304;26030;75317;22241;68524;6366;21592;9763;29418;16129;51010
431880;201304;4507;14939;3890;13456;1257;4799;1570;5239;2827;10038
431890;201304;5735;17234;5186;16185;2128;6961;1612;5173;3740;12134
431900;201304;921;3073;820;2876;267;1037;316;1025;583;2062
431910;201304;748;1926;458;1373;101;347;194;527;295;874
431912;201304;596;1763;480;1521;146;459;169;550;315;1009
431915;201304;1207;3540;1007;3148;308;989;346;1094;654;2083
431920;201304;1455;4361;1408;4295;201;598;1093;3411;1294;4009
431930;201304;1205;3528;1008;3185;150;459;595;2011;745;2470
431935;201304;92;365;87;352;39;163;18;60;57;223
431936;201304;485;1415;444;1340;71;209;293;959;364;1168
431937;201304;286;817;208;659;51;173;67;205;118;378
431940;201304;2646;7544;1948;6243;579;1992;558;1742;1137;3734
431950;201304;1829;6032;1644;5676;517;1966;628;2062;1145;4028
431960;201304;3680;11292;3396;10722;1105;3717;1249;3985;2354;7702
431970;201304;498;1405;291;981;56;197;97;312;153;509
431971;201304;126;395;112;374;22;80;67;217;89;297
431973;201304;457;1689;410;1590;68;261;236;999;304;1260
431975;201304;12;51;9;43;2;12;4;17;6;29
431980;201304;1486;4422;1407;4305;347;1235;772;2310;1119;3545
431990;201304;8538;24763;7297;22888;1426;5136;3944;12273;5370;17409
432000;201304;10036;30721;8543;28078;2954;10082;3615;12042;6569;22124
432010;201304;2424;7420;2161;6915;542;1989;1044;3194;1586;5183
432020;201304;1928;5559;1781;5359;359;1148;1108;3331;1467;4479
432023;201304;507;1517;402;1280;115;408;161;479;276;887
432026;201304;1219;3880;1102;3647;234;785;643;2185;877;2970
432030;201304;396;1230;344;1113;99;347;145;442;244;789
432032;201304;426;1177;331;1035;49;172;216;651;265;823
432035;201304;834;2771;771;2634;213;793;426;1417;639;2210
432040;201304;633;2004;493;1677;127;482;112;302;239;784
432045;201304;187;646;168;603;49;191;75;264;124;455
432050;201304;749;2250;687;2132;146;476;401;1271;547;1747
432055;201304;738;2417;679;2292;156;567;422;1409;578;1976
432057;201304;470;1313;416;1204;65;208;244;665;309;873
432060;201304;374;1123;191;691;64;244;48;166;112;410
432065;201304;198;634;174;586;45;178;76;227;121;405
432067;201304;890;3079;695;2609;217;834;281;1029;498;1863
432070;201304;2144;6461;1951;6069;714;2423;733;2282;1447;4705
432080;201304;4006;12140;3667;11555;1155;3856;1666;5204;2821;9060
432085;201304;254;851;225;798;85;356;67;217;152;573
432090;201304;1592;5216;1420;4825;566;2057;372;1092;938;3149
432100;201304;1056;3292;681;2406;207;776;150;469;357;1245
432110;201304;2955;9165;2503;8273;951;3386;550;1807;1501;5193
432120;201304;4864;15534;4262;14347;1566;5759;1158;3782;2724;9541
432130;201304;1873;6098;1778;5930;536;1928;986;3293;1522;5221
432132;201304;392;1263;267;954;48;172;99;331;147;503
432135;201304;783;2381;742;2306;145;480;477;1477;622;1957
432140;201304;2855;8670;2450;7944;699;2311;1010;3676;1709;5987
432143;201304;1282;4121;1167;3934;260;906;769;2665;1029;3571
432145;201304;778;2535;598;2156;229;918;122;398;351;1316
432146;201304;234;780;193;674;66;245;59;203;125;448
432147;201304;805;2661;697;2440;215;781;330;1198;545;1979
432149;201304;385;1217;294;978;78;279;116;375;194;654
432150;201304;2867;9172;2464;8548;1055;3844;738;2688;1793;6532
432160;201304;4307;14594;3909;13904;1489;5592;1419;5315;2908;10907
432162;201304;309;779;96;322;25;95;24;65;49;160
432163;201304;323;844;108;339;21;63;24;75;45;138
432166;201304;732;2297;627;2088;157;585;264;809;421;1394
432170;201304;742;2559;550;2115;141;598;112;380;253;978
432180;201304;2638;7236;2010;6263;631;2153;663;1983;1294;4136
432183;201304;396;1355;374;1314;165;597;103;374;268;971
432185;201304;776;2337;533;1800;133;496;185;604;318;1100
432190;201304;3323;9567;2634;8034;755;2488;837;2403;1592;4891
432195;201304;1246;3643;1131;3471;199;667;721;2201;920;2868
432200;201304;3002;9667;2508;8809;866;3225;1012;3663;1878;6888
432210;201304;423;1297;382;1244;114;428;184;557;298;985
432215;201304;821;2735;773;2650;150;489;503;1812;653;2301
432218;201304;286;852;238;740;43;147;114;331;157;478
432220;201304;3659;10276;3132;9412;600;2069;1851;5419;2451;7488
432225;201304;57;205;51;197;30;119;6;29;36;148
432230;201304;970;2863;870;2716;285;989;419;1246;704;2235
432232;201304;537;1638;436;1440;101;372;235;776;336;1148
432234;201304;554;1583;479;1426;120;362;229;674;349;1036
432235;201304;67;222;42;159;21;92;9;31;30;123
432237;201304;485;1390;452;1336;41;155;375;1088;416;1243
432240;201304;14595;51035;13008;48890;3365;13554;7631;29399;10996;42953
432250;201304;5351;19408;5118;18924;2504;9860;1242;4726;3746;14586
432252;201304;390;1261;377;1233;123;407;192;658;315;1065
432253;201304;1150;4073;1002;3677;352;1338;337;1244;689;2582
432254;201304;286;793;159;528;49;171;21;71;70;242
432255;201304;163;429;94;320;25;95;39;134;64;229
432260;201304;5913;16787;4909;15151;1177;3887;2586;8033;3763;11920
432270;201304;2479;8191;2302;7875;631;2225;1271;4420;1902;6645
432280;201304;1002;3144;734;2548;193;774;206;600;399;1374
432285;201304;106;340;70;240;23;87;15;42;38;129
432290;201304;551;1765;412;1420;84;330;171;560;255;890
432300;201304;21838;69577;20474;67260;5764;20047;10794;35592;16558;55639
432310;201304;961;3150;852;2938;217;818;430;1431;647;2249
432320;201304;255;762;198;652;59;198;69;241;128;439
432330;201304;197;613;106;380;25;100;12;38;37;138
432335;201304;199;596;105;365;38;136;14;39;52;175
432340;201304;272;733;150;468;47;150;40;118;87;268
432345;201304;715;2127;673;2069;175;642;369;1055;544;1697
432350;201304;403;1239;322;1087;89;322;89;285;178;607
432360;201304;51;172;44;153;16;58;18;59;34;117
432370;201304;443;1300;397;1217;34;100;271;838;305;938
432375;201304;779;2130;702;2007;121;357;447;1295;568;1652
432377;201304;60;212;33;122;5;21;8;20;13;41
432380;201304;814;2981;752;2827;349;1432;234;823;583;2255
500020;201304;1614;5699;1383;5195;519;2146;341;1191;860;3337
500025;201304;832;2303;611;1921;144;475;270;818;414;1293
500060;201304;5210;15979;4631;15312;393;1274;3926;13358;4319;14632
500070;201304;3309;10688;2917;10041;803;3080;1304;4426;2107;7506
500080;201304;1558;4961;1288;4493;448;1683;439;1579;887;3262
500085;201304;2129;6020;1635;5236;261;924;963;2994;1224;3918
500090;201304;2028;6383;1735;5857;405;1395;921;3212;1326;4607
500100;201304;2250;7130;2155;7020;846;3057;921;2908;1767;5965
500110;201304;7253;22208;6181;20612;1032;3901;3774;12924;4806;16825
500124;201304;1439;5187;1308;4955;255;933;784;3215;1039;4148
500150;201304;1242;3506;1062;3254;307;995;513;1567;820;2562
500190;201304;4301;12083;3452;11067;883;3079;1847;6145;2730;9224
500200;201304;2381;6526;1789;5678;485;1756;843;2548;1328;4304
500210;201304;4573;14471;4076;13745;985;3531;2130;7459;3115;10990
500215;201304;1636;5340;1422;4884;366;1434;623;2026;989;3460
500220;201304;2400;8058;2077;7459;573;2235;835;3051;1408;5286
500230;201304;1513;4933;1383;4744;695;2537;413;1417;1108;3954
500240;201304;3936;13375;3263;11961;802;3242;1421;5395;2223;8637
500260;201304;2319;6696;1977;6159;505;1723;921;2714;1426;4437
500270;201304;90947;251597;66877;210426;22167;75883;18104;58000;40271;133883
500280;201304;1220;3774;1083;3581;257;916;589;1982;846;2898
500290;201304;3293;9216;2474;7752;772;2774;882;2538;1654;5312
500295;201304;2117;6949;1705;5922;467;1840;494;1529;961;3369
500310;201304;781;2195;711;2100;174;570;401;1129;575;1699
500315;201304;2658;8653;2347;8236;553;1893;1416;5285;1969;7178
500320;201304;11775;41697;10694;39804;3807;14785;4131;16486;7938;31271
500325;201304;3547;10199;2875;9101;907;3190;1030;3057;1937;6247
500330;201304;4679;13865;4219;13129;1347;4596;1960;5971;3307;10567
500345;201304;2079;6927;1974;6703;562;2085;939;3106;1501;5191
500348;201304;2262;7150;2158;6971;291;1026;1635;5281;1926;6307
500350;201304;1087;3471;744;2694;143;534;213;835;356;1369
500370;201304;20438;67400;17322;61343;4737;18656;7369;26014;12106;44670
500375;201304;2209;6603;1853;5968;485;1641;910;3027;1395;4668
500380;201304;2774;8382;2446;7712;748;2505;975;3082;1723;5587
500390;201304;514;1190;360;964;56;190;251;620;307;810
500400;201304;1125;3791;1021;3543;349;1317;300;965;649;2282
500410;201304;1948;5631;1681;5276;481;1639;768;2429;1249;4068
500430;201304;2296;7480;1997;7034;606;2233;904;3305;1510;5538
500440;201304;1255;3832;1103;3589;315;1169;588;1813;903;2982
500450;201304;2055;6615;1662;5795;475;1872;334;1043;809;2915
500460;201304;3335;10780;2828;10033;756;2871;1350;4795;2106;7666
500470;201304;3147;10337;2815;9510;989;3576;721;2319;1710;5895
500480;201304;1937;6541;1806;6329;194;728;1399;5001;1593;5729
500490;201304;892;2814;823;2701;293;1035;333;1099;626;2134
500500;201304;2842;9319;2452;8807;955;3838;937;3239;1892;7077
500510;201304;741;2123;571;1868;172;678;237;671;409;1349
500515;201304;1656;4876;1401;4504;282;881;876;2987;1158;3868
500520;201304;2462;9031;2234;8744;599;2439;1343;5462;1942;7901
500525;201304;1016;3590;934;3454;269;1060;451;1736;720;2796
500540;201304;3443;11488;2851;10395;964;3835;979;3527;1943;7362
500560;201304;4256;15148;3912;14654;921;3636;2423;9243;3344;12879
500568;201304;3374;9432;2650;8406;669;2312;1297;4229;1966;6541
500570;201304;6969;19924;5266;17015;1606;5549;2149;6992;3755;12541
500580;201304;2853;9204;2400;8349;565;2061;1267;4441;1832;6502
500600;201304;2117;6748;1847;6321;646;2354;725;2421;1371;4775
500620;201304;7256;21187;5494;18384;1452;5452;2654;8741;4106;14193
500625;201304;778;2461;589;2065;170;658;196;639;366;1297
500630;201304;5797;16848;4773;15386;1789;6383;1329;4272;3118;10655
500635;201304;2116;8817;1935;8528;338;1412;1217;5847;1555;7259
500640;201304;1178;3303;997;3032;167;576;651;1927;818;2503
500660;201304;12883;41507;11378;38856;2410;8899;6831;23428;9241;32327
500690;201304;2884;8650;2423;8076;595;2072;1389;4853;1984;6925
500710;201304;2980;9931;2866;9754;887;3140;1510;5211;2397;8351
500720;201304;3580;11556;3128;10722;1126;4225;1111;3771;2237;7996
500730;201304;839;2549;703;2284;208;755;283;885;491;1640
500740;201304;3347;9704;2564;8363;640;2393;1132;3476;1772;5869
500750;201304;699;2262;662;2208;170;634;388;1263;558;1897
500755;201304;1107;3509;898;3118;229;851;365;1246;594;2097
500769;201304;4032;11562;2993;9495;758;2686;1041;3064;1799;5750
500770;201304;1494;4731;1279;4332;387;1391;493;1716;880;3107
500780;201304;882;3036;847;2957;316;1189;348;1168;664;2357
500790;201304;7237;22276;6330;20652;1501;5647;3288;10253;4789;15900
500793;201304;2285;6883;1883;6202;367;1396;842;2600;1209;3996
500795;201304;2059;6432;1871;6156;206;626;1439;4948;1645;5574
500797;201304;824;2405;681;2180;173;610;306;995;479;1605
500800;201304;1929;6179;1711;5871;542;2025;839;2878;1381;4903
500830;201304;12634;40639;10368;35708;3585;13244;2840;9688;6425;22932
500840;201304;1176;3754;1016;3444;207;769;521;1743;728;2512
510010;201304;1198;3922;1137;3824;382;1356;504;1731;886;3087
510020;201304;2348;7162;1864;6349;598;2193;516;1656;1114;3849
510025;201304;8547;26833;7667;25371;2558;9307;3105;10058;5663;19365
510030;201304;2053;5700;1767;5294;540;1685;879;2693;1419;4378
510035;201304;866;2689;749;2511;185;635;403;1421;588;2056
510040;201304;1500;4299;1201;3859;309;1146;585;1817;894;2963
510050;201304;1517;4765;1259;4340;384;1450;506;1771;890;3221
510060;201304;1098;3334;879;2934;272;997;268;859;540;1856
510080;201304;1267;4047;1080;3735;312;1264;431;1367;743;2631
510100;201304;553;1528;387;1208;105;367;151;448;256;815
510120;201304;262;560;189;479;14;35;169;432;183;467
510125;201304;2688;7441;2295;6831;465;1692;1217;3471;1682;5163
510130;201304;1875;5517;1698;5283;526;1724;758;2383;1284;4107
510140;201304;2794;9523;2397;8932;848;3273;993;3816;1841;7089
510160;201304;1262;4380;1211;4321;90;359;1068;3808;1158;4167
510170;201304;5161;16840;4611;15839;1300;4990;2102;7003;3402;11993
510180;201304;9089;26947;7241;23793;2391;8368;2738;9655;5129;18023
510185;201304;1016;3321;957;3238;255;829;573;2063;828;2892
510190;201304;1441;5174;1250;4881;343;1462;561;2271;904;3733
510250;201304;13097;43356;11577;41323;3644;13691;5840;21370;9484;35061
510260;201304;2465;9144;2357;8951;621;2238;1395;5677;2016;7915
510263;201304;3738;10838;3024;9698;900;3131;1134;3573;2034;6704
510267;201304;3929;12193;3384;11103;879;3202;1505;4763;2384;7965
510268;201304;805;2387;707;2255;217;758;350;1109;567;1867
510269;201304;800;2676;725;2549;242;886;285;1046;527;1932
510270;201304;2110;6939;1926;6676;488;1740;1001;3695;1489;5435
510279;201304;1998;6657;1854;6412;722;2757;680;2211;1402;4968
510285;201304;1381;4459;1205;4112;387;1420;388;1252;775;2672
510300;201304;2883;9348;2668;9070;392;1488;1986;6725;2378;8213
510305;201304;1572;5226;1341;4796;373;1454;479;1797;852;3251
510310;201304;1048;3119;845;2795;312;1144;260;845;572;1989
510320;201304;3669;11416;3098;10278;1023;3927;618;1740;1641;5667
510325;201304;5262;17398;4663;16498;599;2079;3547;13011;4146;15090
510330;201304;2576;8742;2283;8198;640;2534;898;3296;1538;5830
510335;201304;4179;13801;3762;13229;675;2392;2688;9779;3363;12171
510336;201304;455;1493;423;1438;100;369;212;718;312;1087
510337;201304;2220;7707;2039;7376;853;3153;740;2873;1593;6026
510340;201304;53574;168018;45257;155522;18809;69942;11095;40171;29904;110113
510343;201304;1034;3239;977;3170;134;418;771;2581;905;2999
510345;201304;1541;4721;1388;4499;423;1430;583;1932;1006;3362
510350;201304;2965;9390;2602;8906;813;2963;1319;4599;2132;7562
510360;201304;1584;4632;1332;4308;292;1000;871;2802;1163;3802
510370;201304;760;2830;678;2687;225;950;301;1218;526;2168
510380;201304;457;1553;388;1399;145;585;73;239;218;824
510385;201304;823;3253;751;3077;140;587;388;1728;528;2315
510390;201304;983;3341;909;3250;254;923;494;1878;748;2801
510395;201304;812;2200;643;1982;131;433;393;1262;524;1695
510410;201304;3632;12523;3470;12250;1122;4268;1695;5949;2817;10217
510420;201304;2072;5675;1649;4988;278;1017;923;2748;1201;3765
510450;201304;541;1575;427;1412;145;527;134;439;279;966
510452;201304;549;1744;425;1478;122;490;149;462;271;952
510454;201304;670;2246;597;2138;170;639;319;1183;489;1822
510455;201304;910;2915;749;2638;199;827;305;1049;504;1876
510460;201304;1643;5137;1542;5001;380;1414;938;2920;1318;4334
510480;201304;3769;10762;3068;9453;806;2701;1330;4060;2136;6761
510490;201304;1384;4814;1279;4661;405;1539;694;2547;1099;4086
510500;201304;1216;3974;1018;3659;285;1156;534;1880;819;3036
510510;201304;2824;10227;2556;9796;1005;3996;1029;4014;2034;8010
510515;201304;5091;16315;4320;14768;1246;4762;1341;4376;2587;9138
510517;201304;1564;5045;1426;4843;427;1431;848;2996;1275;4427
510520;201304;2083;5616;1693;5067;146;520;1298;3838;1444;4358
510523;201304;980;3123;834;2877;271;1017;363;1223;634;2240
510525;201304;7324;18890;4630;14579;1210;4152;1584;4900;2794;9052
510530;201304;528;1599;477;1525;90;337;281;898;371;1235
510550;201304;2433;8372;2217;8055;650;2393;1150;4402;1800;6795
510558;201304;1910;5738;1512;5146;517;1890;503;1696;1020;3586
510560;201304;1385;4810;1117;4342;442;1776;264;1088;706;2864
510562;201304;4438;14253;4125;13660;1540;5557;1450;4789;2990;10346
510590;201304;2421;7476;1974;6901;601;2314;877;3061;1478;5375
510600;201304;1335;3550;998;3062;178;611;581;1741;759;2352
510610;201304;2384;7694;2284;7582;299;1156;1853;6063;2152;7219
510615;201304;2005;6927;1812;6579;597;2344;799;2853;1396;5197
510617;201304;468;1597;443;1560;79;316;330;1144;409;1460
510618;201304;1161;3606;895;3079;241;915;390;1345;631;2260
510619;201304;732;2100;493;1658;113;424;169;570;282;994
510620;201304;1102;3120;811;2708;291;1083;174;541;465;1624
510621;201304;1125;4030;996;3734;316;1294;373;1359;689;2653
510622;201304;2904;9596;2270;8082;666;2673;487;1529;1153;4202
510623;201304;3195;9768;2866;9301;1200;4004;908;3050;2108;7054
510624;201304;957;3311;857;3097;215;840;378;1324;593;2164
510625;201304;1882;6039;1634;5539;544;2019;541;1720;1085;3739
510626;201304;1122;3804;971;3559;306;1190;490;1836;796;3026
510627;201304;606;2027;514;1843;199;766;182;648;381;1414
510628;201304;1385;3825;1166;3560;187;653;806;2428;993;3081
510629;201304;1630;5613;1462;5269;568;2168;336;1212;904;3380
510630;201304;2541;8681;2184;8086;768;3107;684;2610;1452;5717
510631;201304;386;1187;350;1128;79;254;228;744;307;998
510637;201304;2350;7463;2213;7207;709;2580;1064;3336;1773;5916
510642;201304;4268;14423;3698;13685;1269;4818;1803;7036;3072;11854
510645;201304;621;1637;520;1512;188;583;185;584;373;1167
510650;201304;5514;19585;5264;19253;1295;5016;3223;12152;4518;17168
510665;201304;1103;3003;846;2695;221;801;462;1474;683;2275
510670;201304;342;863;207;667;53;190;83;250;136;440
510675;201304;5790;19767;5110;18513;1905;7511;1564;5610;3469;13121
510677;201304;2334;6183;1780;5493;255;824;1313;4120;1568;4944
510680;201304;760;2465;664;2319;182;708;263;846;445;1554
510682;201304;2119;7161;1832;6625;505;1904;839;3200;1344;5104
510685;201304;681;2265;658;2227;188;672;357;1243;545;1915
510700;201304;2778;8677;2427;8183;556;2078;1474;4906;2030;6984
510704;201304;6918;20881;6078;19405;1852;6650;2817;8630;4669;15280
510706;201304;1309;4499;1220;4328;407;1526;582;2008;989;3534
510710;201304;3363;9953;2857;8980;844;3063;1101;3123;1945;6186
510715;201304;672;1814;458;1459;135;472;157;452;292;924
510718;201304;1557;5042;1459;4884;327;1160;947;3184;1274;4344
510719;201304;428;1014;261;780;36;154;125;332;161;486
510720;201304;1212;2980;912;2626;96;313;688;1991;784;2304
510724;201304;794;2538;699;2359;148;527;433;1465;581;1992
510726;201304;631;1768;566;1666;166;531;253;715;419;1246
510729;201304;556;1693;488;1582;142;497;222;709;364;1206
510730;201304;2050;6716;1914;6475;467;1852;1135;3651;1602;5503
510735;201304;1042;3753;921;3562;330;1317;415;1653;745;2970
510740;201304;954;2540;811;2354;142;421;546;1624;688;2045
510757;201304;593;2205;584;2182;163;653;315;1146;478;1799
510760;201304;22859;70936;20050;65938;7743;27218;6793;22266;14536;49484
510770;201304;3386;10738;3258;10563;612;2008;2185;7428;2797;9436
510774;201304;363;1036;305;957;44;159;198;620;242;779
510775;201304;820;2375;690;2193;276;976;276;902;552;1878
510776;201304;347;1102;308;1035;82;309;151;470;233;779
510777;201304;1304;4298;1056;3986;242;1078;642;2361;884;3439
510779;201304;601;1832;476;1602;100;365;195;678;295;1043
510780;201304;3423;10794;3140;10393;748;2620;1866;6281;2614;8901
510785;201304;1771;5440;1501;5002;515;1788;583;1990;1098;3778
510787;201304;1796;5902;1633;5607;502;1896;597;1996;1099;3892
510788;201304;332;1059;305;1023;128;414;111;391;239;805
510790;201304;12716;39513;9350;32982;3012;12112;1479;5092;4491;17204
510792;201304;4935;17023;3926;14813;1148;4951;724;2530;1872;7481
510794;201304;1264;4098;1041;3775;544;2089;201;674;745;2763
510795;201304;7285;25731;6414;23843;2371;9341;1773;6741;4144;16082
510800;201304;1619;4900;1428;4649;410;1493;719;2239;1129;3732
510805;201304;1526;4616;1271;4248;304;1160;780;2530;1084;3690
510810;201304;628;1616;510;1453;153;472;267;736;420;1208
510820;201304;817;2100;639;1828;169;572;254;658;423;1230
510830;201304;524;1900;481;1832;176;719;212;842;388;1561
510835;201304;632;2071;511;1842;201;787;204;692;405;1479
510840;201304;43026;115352;36170;106923;9661;30209;19417;59310;29078;89519
510850;201304;1574;4821;1318;4414;586;2176;200;541;786;2717
510860;201304;2257;7905;1981;7333;751;2957;463;1729;1214;4686
510880;201304;783;2718;699;2561;275;1055;249;910;524;1965
510885;201304;486;1446;374;1274;96;369;163;547;259;916
510890;201304;862;3016;753;2800;254;1051;183;634;437;1685
510895;201304;980;3304;912;3193;295;1155;397;1320;692;2475
520005;201304;987;3395;936;3313;307;1151;393;1387;700;2538
520010;201304;1731;6240;1561;5864;714;2971;232;726;946;3697
520013;201304;3630;10487;2968;9408;796;2696;1450;4641;2246;7337
520015;201304;568;1585;462;1434;124;393;227;739;351;1132
520017;201304;1139;3756;1020;3556;300;1134;440;1507;740;2641
520020;201304;357;1015;303;939;93;299;153;491;246;790
520025;201304;18578;64180;18247;63740;3497;12936;13441;46904;16938;59840
520030;201304;4082;13889;3723;13287;1397;5324;1315;4911;2712;10235
520050;201304;321;992;304;956;66;232;199;606;265;838
520055;201304;632;1937;548;1804;143;485;274;933;417;1418
520060;201304;1568;5114;1406;4804;362;1386;561;1972;923;3358
520080;201304;1425;4966;1369;4862;325;1201;827;2971;1152;4172
520082;201304;594;2099;566;2039;168;605;326;1219;494;1824
520085;201304;969;3146;853;2868;225;830;348;1179;573;2009
520090;201304;757;2119;698;2018;117;338;457;1344;574;1682
520110;201304;33191;106678;27120;97565;11544;45025;7339;26751;18883;71776
520120;201304;255;663;146;472;41;147;43;157;84;304
520130;201304;3245;10175;3122;9994;864;3003;1694;5408;2558;8411
520140;201304;40391;140055;37262;133708;14022;54122;12002;42989;26024;97111
520145;201304;532;1413;396;1231;93;313;169;509;262;822
520150;201304;621;1697;535;1586;167;536;253;741;420;1277
520160;201304;767;2394;700;2300;252;881;295;980;547;1861
520170;201304;3484;9025;2841;8340;686;2097;1772;5393;2458;7490
520180;201304;1366;4624;1283;4479;428;1599;550;1897;978;3496
520215;201304;1344;3812;1201;3608;244;850;742;2225;986;3075
520235;201304;740;2092;607;1902;194;672;265;806;459;1478
520250;201304;1082;3730;1009;3600;355;1338;480;1747;835;3085
520260;201304;675;1874;540;1631;94;329;282;818;376;1147
520280;201304;542;1636;495;1559;234;771;138;476;372;1247
520310;201304;818;2240;678;2079;160;495;466;1469;626;1964
520320;201304;1295;4353;1137;4067;293;1112;535;1938;828;3050
520330;201304;2565;8341;2119;7602;716;2798;698;2495;1414;5293
520340;201304;1798;4760;1490;4397;259;744;1113;3381;1372;4125
520350;201304;2710;8692;2437;8145;954;3393;1014;3308;1968;6701
520355;201304;1068;3834;1050;3794;424;1599;449;1625;873;3224
520357;201304;874;2477;762;2317;78;269;533;1610;611;1879
520360;201304;496;1399;451;1336;117;346;252;760;369;1106
520380;201304;970;2728;776;2444;163;559;439;1410;602;1969
520390;201304;1153;3164;817;2703;286;1088;294;895;580;1983
520393;201304;545;1509;503;1445;96;280;342;1002;438;1282
520396;201304;647;2162;625;2125;72;281;487;1660;559;1941
520400;201304;1734;5070;1494;4737;273;934;1021;3265;1294;4199
520410;201304;1332;3945;1103;3604;368;1320;495;1566;863;2886
520420;201304;309;894;252;801;61;227;121;368;182;595
520425;201304;1393;3976;1325;3849;437;1365;643;1835;1080;3200
520430;201304;1772;4925;1377;4288;327;1171;636;1944;963;3115
520440;201304;2398;7138;2025;6578;791;2792;631;2010;1422;4802
520450;201304;8526;25689;7127;23223;2312;8409;1959;5994;4271;14403
520455;201304;644;1988;543;1820;222;787;149;517;371;1304
520460;201304;687;2145;599;2002;212;769;211;714;423;1483
520465;201304;796;2232;702;2105;181;652;318;878;499;1530
520470;201304;1610;5415;1485;5227;373;1341;913;3329;1286;4670
520480;201304;814;2530;753;2448;187;624;490;1610;677;2234
520485;201304;1089;3795;1021;3683;391;1513;443;1579;834;3092
520490;201304;4209;13511;3489;12375;1172;4512;1498;5390;2670;9902
520495;201304;1374;3785;1157;3525;59;139;1056;3306;1115;3445
520500;201304;1931;5269;1765;5057;581;1736;795;2516;1376;4252
520505;201304;824;2453;717;2290;109;323;532;1750;641;2073
520510;201304;10419;30153;7031;24239;2247;8513;1761;6040;4008;14553
520520;201304;940;2879;839;2742;342;1188;321;1064;663;2252
520530;201304;2274;7284;2028;6886;481;1645;1028;3872;1509;5517
520540;201304;2757;8816;2490;8334;865;3041;1056;3480;1921;6521
520545;201304;1268;4045;1102;3694;352;1279;331;1051;683;2330
520547;201304;786;2509;625;2215;212;835;185;618;397;1453
520549;201304;7384;23607;6634;22759;1457;5475;4571;15530;6028;21005
520551;201304;3451;10826;3326;10668;999;3316;1856;6243;2855;9559
520552;201304;665;2285;650;2260;136;528;437;1497;573;2025
520570;201304;559;1698;425;1470;185;676;81;285;266;961
520580;201304;1849;5616;1514;5081;492;1859;356;1112;848;2971
520590;201304;1418;4172;1266;3934;338;1159;601;1733;939;2892
520620;201304;6454;21736;5976;20994;1478;5579;3414;12164;4892;17743
520630;201304;578;1624;498;1530;146;409;312;1022;458;1431
520640;201304;2132;6767;2038;6634;755;2515;935;3188;1690;5703
520650;201304;758;2289;691;2166;299;994;258;797;557;1791
520660;201304;350;1142;314;1066;110;407;95;318;205;725
520670;201304;702;2220;693;2208;76;191;592;1953;668;2144
520680;201304;474;1601;452;1568;185;686;158;542;343;1228
520690;201304;302;801;214;680;27;91;121;403;148;494
520710;201304;293;841;270;810;7;24;210;619;217;643
520725;201304;1625;4493;1328;4100;334;1129;711;2190;1045;3319
520735;201304;572;1828;498;1703;192;683;151;505;343;1188
520740;201304;1569;4777;1358;4484;390;1356;658;2205;1048;3561
520750;201304;657;1803;507;1612;149;525;295;932;444;1457
520753;201304;1036;3163;1022;3142;159;442;819;2587;978;3029
520760;201304;1075;3122;967;2988;325;1082;533;1599;858;2681
520780;201304;1798;4794;1606;4546;187;530;1279;3685;1466;4215
520790;201304;2360;7165;2160;6869;301;1023;1566;5069;1867;6092
520800;201304;16127;49865;14494;47895;3326;11196;8848;31050;12174;42246
520810;201304;799;2463;784;2434;108;356;613;1933;721;2289
520815;201304;333;1209;286;1108;162;683;43;168;205;851
520830;201304;1646;4384;1298;4021;67;184;1166;3705;1233;3889
520840;201304;1589;5505;1451;5217;484;1842;561;2066;1045;3908
520850;201304;770;2284;612;2063;188;677;282;932;470;1609
520860;201304;6688;20038;5251;18150;1607;6048;2571;8993;4178;15041
520870;201304;115348;334267;83592;275627;27938;99726;24976;82178;52914;181904
520880;201304;5535;17134;4276;15022;1356;5279;568;1778;1924;7057
520890;201304;3295;10317;3057;9941;774;2676;1645;5325;2419;8001
520910;201304;3632;12046;3251;11262;1141;4260;1039;3471;2180;7731
520915;201304;862;2497;637;2045;141;485;240;734;381;1219
520920;201304;2394;7199;2030;6680;568;2024;885;2978;1453;5002
520929;201304;418;1301;391;1267;113;384;199;642;312;1026
520940;201304;893;2883;854;2831;114;434;662;2160;776;2594
520945;201304;621;1597;567;1515;163;472;294;737;457;1209
520960;201304;848;2561;723;2386;118;410;469;1560;587;1970
520970;201304;3230;9613;2647;8567;578;2113;1160;3712;1738;5825
520980;201304;986;2750;925;2666;127;387;749;2159;876;2546
520990;201304;3596;11459;3200;10767;699;2493;1739;6366;2438;8859
520993;201304;952;2898;784;2552;183;647;380;1198;563;1845
520995;201304;2423;6837;2202;6544;362;1106;1612;4833;1974;5939
521000;201304;7242;22411;6323;20953;1612;5805;3457;11530;5069;17335
521010;201304;3225;10644;2923;10076;820;3022;1407;4892;2227;7914
521015;201304;663;1964;580;1835;135;445;319;1000;454;1445
521020;201304;4126;12625;3461;11278;1353;4771;768;2241;2121;7012
521030;201304;787;2167;704;2052;137;423;484;1431;621;1854
521040;201304;4853;14902;4444;14239;1258;4023;2557;8523;3815;12546
521056;201304;955;3007;822;2786;277;987;357;1234;634;2221
521060;201304;1092;3169;950;2919;248;824;360;1061;608;1885
521080;201304;1071;2859;753;2313;195;723;278;748;473;1471
521090;201304;2967;9177;2607;8662;915;3256;1076;3578;1991;6834
521100;201304;1375;3666;1281;3562;226;625;928;2643;1154;3268
521120;201304;4474;13432;4114;12816;1028;3134;2332;7549;3360;10683
521130;201304;978;2948;857;2757;180;646;455;1500;635;2146
521140;201304;859;2982;782;2798;329;1242;165;567;494;1809
521150;201304;10183;28479;8491;25819;2696;8983;4195;12720;6891;21703
521160;201304;595;1659;505;1484;99;321;296;834;395;1155
521170;201304;1281;3174;1116;2973;307;794;659;1774;966;2568
521180;201304;5841;20806;5427;19897;2163;8416;1502;5518;3665;13934
521190;201304;7769;24228;6132;21444;2274;8316;2097;7426;4371;15742
521200;201304;771;2131;732;2082;111;323;535;1542;646;1865
521205;201304;447;1502;423;1454;64;237;276;964;340;1201
521210;201304;713;2218;571;1970;224;868;216;660;440;1528
521220;201304;3396;10176;3014;9627;1115;3825;1119;3530;2234;7355
521225;201304;336;930;271;844;50;178;169;536;219;714
521230;201304;1213;3979;1171;3883;410;1454;566;1823;976;3277
521250;201304;23976;83056;23114;81616;9569;35841;9055;32486;18624;68327
521260;201304;557;1477;443;1241;100;354;195;508;295;862
521270;201304;1650;5505;1564;5356;155;459;1246;4457;1401;4916
521280;201304;1516;4959;1339;4672;473;1735;608;2130;1081;3865
521290;201304;477;1440;369;1255;99;408;156;503;255;911
521295;201304;1016;3012;954;2923;212;706;629;1905;841;2611
521300;201304;1614;4876;1470;4623;480;1628;546;1754;1026;3382
521305;201304;784;2117;672;1967;128;362;453;1386;581;1748
521308;201304;4601;14333;3845;13108;748;2827;2372;7981;3120;10808
521310;201304;6220;19930;5451;18706;2287;8295;1627;5546;3914;13841
521340;201304;235;774;216;741;72;272;91;297;163;569
521350;201304;1957;5349;1627;4924;230;796;1057;3359;1287;4155
521370;201304;974;3208;910;3080;339;1219;346;1136;685;2355
521375;201304;1280;3755;1139;3532;307;1013;620;1925;927;2938
521377;201304;940;2988;917;2955;102;314;766;2520;868;2834
521380;201304;3444;10462;2898;9633;679;2489;1445;4759;2124;7248
521385;201304;573;1680;520;1608;162;528;264;823;426;1351
521390;201304;1078;2937;840;2604;333;1154;258;794;591;1948
521400;201304;2327;6412;2028;6077;284;906;1595;4765;1879;5671
521405;201304;990;3163;974;3141;154;481;733;2427;887;2908
521410;201304;718;2380;667;2293;323;1092;229;835;552;1927
521440;201304;1397;3979;1374;3955;145;378;1182;3473;1327;3851
521450;201304;4724;14545;3999;13194;1350;4787;1000;3118;2350;7905
521460;201304;6389;21137;5935;20406;1884;6891;2914;10182;4798;17073
521470;201304;688;2025;534;1730;135;487;126;424;261;911
521480;201304;509;1503;382;1283;132;464;99;333;231;797
521483;201304;2676;7582;2443;7220;580;1815;1408;4126;1988;5941
521486;201304;1462;4320;1337;4069;396;1349;748;2152;1144;3501
521487;201304;568;1559;449;1400;108;358;267;832;375;1190
521490;201304;757;2285;638;2127;132;482;386;1307;518;1789
521500;201304;1099;3746;1047;3669;93;330;905;3181;998;3511
521520;201304;847;2056;760;1958;177;366;441;1287;618;1653
521523;201304;10689;40566;10067;39487;2798;11840;5239;20725;8037;32565
521525;201304;891;2419;801;2303;111;342;533;1501;644;1843
521530;201304;1850;5694;1335;4666;571;2110;230;761;801;2871
521540;201304;858;2595;667;2199;217;821;166;474;383;1295
521550;201304;737;2051;685;1977;220;696;352;979;572;1675
521560;201304;4946;15351;3957;14028;1707;6596;981;3310;2688;9906
521565;201304;582;1757;537;1701;91;314;396;1259;487;1573
521570;201304;3492;10666;3070;10007;1244;4278;1071;3560;2315;7838
521580;201304;563;1519;455;1368;169;534;170;535;339;1069
521590;201304;702;2056;615;1914;259;872;138;463;397;1335
521600;201304;605;1598;441;1315;112;372;158;416;270;788
521630;201304;1715;4806;1471;4416;613;2138;269;651;882;2789
521640;201304;1536;4732;1405;4529;539;1976;376;1226;915;3202
521645;201304;595;1931;533;1793;157;580;221;691;378;1271
521680;201304;1303;4420;1237;4270;766;2745;267;908;1033;3653
521690;201304;542;1648;492;1550;106;376;265;797;371;1173
521710;201304;1986;6391;1791;6018;388;1395;1080;3592;1468;4987
521720;201304;1944;5975;1792;5764;442;1459;1087;3580;1529;5039
521730;201304;3530;12244;3380;11945;1494;5749;1083;3599;2577;9348
521740;201304;3205;9185;2634;8449;1293;4284;882;2917;2175;7201
521760;201304;11406;40437;10889;39651;1836;7515;7687;28058;9523;35573
521770;201304;2663;8266;2302;7565;1008;3549;530;1639;1538;5188
521800;201304;8095;25043;7141;23664;2707;9360;3311;11320;6018;20680
521805;201304;637;1676;636;1675;239;570;337;1027;576;1597
521810;201304;784;2390;708;2273;192;678;364;1168;556;1846
521830;201304;5295;18327;5040;17921;1071;4130;3429;12143;4500;16273
521839;201304;625;1971;537;1780;147;528;229;721;376;1249
521850;201304;6049;17821;5701;17418;1279;3785;3919;12451;5198;16236
521860;201304;1644;5179;1455;4779;426;1534;544;1694;970;3228
521870;201304;540;1924;507;1836;162;638;143;479;305;1117
521878;201304;375;1330;355;1297;149;602;91;302;240;904
521880;201304;21853;60440;15594;50086;5990;20593;4498;14619;10488;35212
521890;201304;3408;10956;2959;10067;1181;4276;705;2399;1886;6675
521900;201304;1606;4353;1347;3996;363;1206;569;1598;932;2804
521910;201304;1129;3326;1002;3175;266;915;573;1846;839;2761
521920;201304;395;1283;387;1266;159;554;186;600;345;1154
521925;201304;528;1700;497;1613;98;339;322;1023;420;1362
521930;201304;4038;13375;3727;12732;1503;5466;1129;3800;2632;9266
521935;201304;668;2038;636;1977;174;583;373;1122;547;1705
521940;201304;1136;3113;949;2827;372;1171;322;963;694;2134
521945;201304;638;2265;595;2213;127;430;434;1695;561;2125
521950;201304;441;1509;408;1443;157;597;150;517;307;1114
521960;201304;901;2688;783;2486;202;695;405;1283;607;1978
521970;201304;2263;6711;2155;6560;385;1220;1525;4734;1910;5954
521971;201304;884;2532;744;2306;201;686;345;1021;546;1707
521973;201304;771;2702;716;2588;224;841;224;812;448;1653
521975;201304;12012;36594;11406;35809;2375;8166;7380;23236;9755;31402
521980;201304;1656;5509;1622;5468;289;931;1253;4365;1542;5296
521990;201304;979;3220;931;3126;204;752;547;1794;751;2546
522000;201304;2021;6162;1818;5903;397;1359;1107;3754;1504;5113
522005;201304;305;891;246;794;65;228;127;395;192;623
522010;201304;2730;8458;2424;7964;907;3270;740;2349;1647;5619
522015;201304;957;2932;818;2721;238;888;432;1425;670;2313
522020;201304;3934;11687;3547;11189;1023;3377;1913;6046;2936;9423
522026;201304;486;1601;418;1530;232;889;143;517;375;1406
522028;201304;508;1561;463;1487;126;443;260;813;386;1256
522040;201304;2803;7407;2030;6395;747;2548;781;2437;1528;4985
522045;201304;11926;40817;10577;37886;3632;14182;2351;8190;5983;22372
522050;201304;1005;3030;852;2771;282;1016;354;1095;636;2111
522060;201304;2583;8736;2432;8529;792;2955;1393;4862;2185;7817
522068;201304;1354;4654;1282;4570;126;394;1079;3989;1205;4383
522070;201304;803;2506;742;2410;137;530;467;1495;604;2025
522100;201304;795;2218;706;2079;266;895;324;879;590;1774
522108;201304;856;2566;785;2466;82;276;596;1914;678;2190
522119;201304;1392;4344;1229;4141;131;437;1013;3482;1144;3919
522130;201304;493;1442;425;1366;127;453;220;706;347;1159
522140;201304;15669;46132;14118;44189;4154;13858;7717;24256;11871;38114
522145;201304;901;2643;853;2563;466;1478;200;585;666;2063
522150;201304;1219;3252;1007;2982;341;1073;445;1378;786;2451
522155;201304;697;2144;640;2063;153;526;380;1252;533;1778
522157;201304;641;1958;589;1870;78;266;446;1428;524;1694
522160;201304;5325;15841;4201;14097;1962;7216;873;2763;2835;9979
522170;201304;3110;8728;2683;8161;699;2146;1394;4462;2093;6608
522180;201304;427;1294;342;1187;174;660;115;385;289;1045
522185;201304;13358;44331;12774;43542;2717;10076;8193;28098;10910;38174
522190;201304;660;1981;597;1837;119;386;361;1117;480;1503
522200;201304;1520;5204;1425;5006;539;2024;452;1553;991;3577
522205;201304;1468;4307;1249;3948;385;1246;559;1793;944;3039
522220;201304;957;3107;881;3001;229;826;481;1726;710;2552
522230;201304;823;2833;789;2779;202;750;473;1714;675;2464
530010;201304;241126;804329;218304;756927;69209;263733;70280;244150;139489;507883
110001;201303;4115;13998;3585;13161;1093;4155;1957;7302;3050;11457
110002;201303;11205;38491;10271;36794;3784;14336;4291;15571;8075;29907
110003;201303;999;3326;938;3230;280;1013;494;1692;774;2705
110004;201303;8706;29849;7918;28216;2567;9947;3208;11455;5775;21402
110005;201303;2267;7916;2183;7754;797;2897;1015;3651;1812;6548
110006;201303;3394;9262;2195;7685;785;2909;834;2900;1619;5809
110007;201303;1392;4674;1288;4524;364;1306;756;2716;1120;4022
110008;201303;2343;8458;2209;8263;591;2143;1431;5589;2022;7732
110009;201303;4737;14278;3924;13202;840;2900;2648;9039;3488;11939
110010;201303;7981;23252;7205;22405;1193;3087;5357;18058;6550;21145
110011;201303;10299;32905;8685;30166;3526;12964;3007;10521;6533;23485
110012;201303;15006;48758;13726;46371;5200;18514;5678;19227;10878;37741
110013;201303;5003;16454;4239;15386;1253;4781;2215;8153;3468;12934
110014;201303;4070;12687;3485;11875;729;2553;2342;8096;3071;10649
110015;201303;4724;15864;4030;14684;1631;6289;1469;5345;3100;11634
110018;201303;4789;14650;3969;13606;1337;5022;1751;5799;3088;10821
110020;201303;46959;149266;42479;143583;9845;34224;26325;91422;36170;125646
110025;201303;4079;12593;3502;11514;615;2222;2502;8147;3117;10369
110026;201303;705;2213;603;2099;141;496;412;1452;553;1948
110028;201303;7190;21927;5589;19425;1702;6421;2108;7330;3810;13751
110029;201303;1596;4907;1288;4374;425;1486;594;2072;1019;3558
110030;201303;10681;31622;8836;29267;2723;9578;4466;15387;7189;24965
110032;201303;3962;13380;3651;12716;978;3610;1898;6619;2876;10229
110033;201303;4855;16007;4611;15667;1347;4532;2722;9732;4069;14264
110034;201303;3659;9668;3164;9112;404;1053;2623;7733;3027;8786
110037;201303;1988;6973;1798;6637;289;1078;1332;4981;1621;6059
110040;201303;3358;11509;3230;11269;1101;4067;1561;5475;2662;9542
110045;201303;4881;17856;4675;17587;1257;4909;2957;11249;4214;16158
110050;201303;1727;5812;1467;5484;514;1935;775;2977;1289;4912
110060;201303;980;3516;881;3329;210;788;537;2081;747;2869
110070;201303;1833;6513;1808;6452;293;1104;1366;4859;1659;5963
110080;201303;2699;9434;2650;9369;447;1512;2087;7543;2534;9055
110090;201303;925;2865;761;2604;242;924;299;958;541;1882
110092;201303;1592;5377;1451;5179;354;1269;865;3247;1219;4516
110094;201303;2602;9101;2458;8903;680;2576;1473;5376;2153;7952
110100;201303;2604;8658;2293;8170;591;2129;1423;5188;2014;7317
110110;201303;1626;5663;1534;5552;617;2294;712;2659;1329;4953
110120;201303;1561;5443;1418;5115;400;1514;607;2202;1007;3716
110130;201303;2691;8011;2155;7262;588;2113;1112;3754;1700;5867
110140;201303;2261;8080;2191;7976;557;2084;1363;5009;1920;7093
110143;201303;1473;5119;1240;4724;322;1293;717;2736;1039;4029
110145;201303;896;2921;820;2792;191;673;485;1666;676;2339
110146;201303;437;1447;393;1374;110;399;213;757;323;1156
110147;201303;849;2646;713;2456;211;795;342;1137;553;1932
110148;201303;1344;4125;1175;3832;324;1161;521;1670;845;2831
110149;201303;3296;10286;2782;9575;506;1822;2027;7079;2533;8901
110150;201303;2545;8041;2153;7476;468;1674;1398;4912;1866;6586
110155;201303;857;2961;835;2913;299;1096;384;1319;683;2415
110160;201303;2080;6937;1820;6568;345;1269;1294;4765;1639;6034
110170;201303;2736;8602;2373;8051;557;2010;1560;5285;2117;7295
110175;201303;1539;5240;1239;4867;112;467;980;3860;1092;4327
110180;201303;1650;5404;1464;5080;337;1216;909;3164;1246;4380
120001;201303;2601;9856;2547;9733;708;2834;1450;5657;2158;8491
120005;201303;1459;6299;1422;6234;168;657;1123;5159;1291;5816
120010;201303;3695;13938;3544;13660;700;2656;2319;9303;3019;11959
120013;201303;1600;6464;1576;6423;302;1183;1112;4737;1414;5920
120017;201303;1897;7047;1830;6926;498;1939;943;3847;1441;5786
120020;201303;13363;59208;13198;58822;2586;10875;9481;44191;12067;55066
120025;201303;2470;8960;2420;8879;653;2453;1433;5419;2086;7872
120030;201303;4917;21799;4893;21737;737;2994;3831;17654;4568;20648
120032;201303;1266;6287;1236;6224;178;1016;928;4728;1106;5744
120033;201303;3461;13501;3435;13453;184;746;3095;12260;3279;13006
120034;201303;1779;7134;1777;7132;69;264;1659;6713;1728;6977
120035;201303;2246;11605;2229;11555;341;1593;1687;9276;2028;10869
120038;201303;3004;11447;2939;11316;812;3215;1696;6683;2508;9898
120039;201303;1331;7585;1310;7534;185;1093;1024;6005;1209;7098
120040;201303;40299;151918;38114;147021;12035;47939;19148;76156;31183;124095
120042;201303;2462;11271;2404;11134;223;1047;1994;9426;2217;10473
120043;201303;752;3711;744;3689;74;373;621;3133;695;3506
120045;201303;4138;15147;4114;15103;919;3318;2958;11131;3877;14449
120050;201303;7788;33079;7617;32694;1859;7729;4630;21272;6489;29001
120060;201303;4822;25213;4782;25129;779;3782;3615;20024;4394;23806
120070;201303;2484;9775;2448;9687;587;2174;1532;6442;2119;8616
120080;201303;3321;12817;3206;12638;606;2450;2256;9140;2862;11590
130002;201303;2557;11415;2413;11165;339;1594;1816;8574;2155;10168
130006;201303;1677;7420;1534;7151;179;905;1176;5547;1355;6452
130008;201303;1799;7661;1740;7545;218;977;1306;5850;1524;6827
130010;201303;2702;9297;2355;8886;249;881;1945;7536;2194;8417
130014;201303;3107;10500;2726;9949;402;1599;1893;6961;2295;8560
130020;201303;2286;8336;2266;8311;76;292;2161;7929;2237;8221
130030;201303;5829;24301;5656;24062;554;2010;4758;20999;5312;23009
130040;201303;3331;10757;3189;10537;184;644;2815;9341;2999;9985
130050;201303;5341;22935;4764;21955;836;3681;3225;15921;4061;19602
130060;201303;5394;23411;5095;22999;583;2544;4142;19198;4725;21742
130063;201303;2737;12606;2716;12556;343;1584;2235;10510;2578;12094
130068;201303;2705;11915;2572;11631;346;1740;1925;8720;2271;10460
130070;201303;5916;21207;5631;20819;379;1480;4848;18186;5227;19666
130080;201303;4566;20819;4450;20634;792;3767;3175;15174;3967;18941
130083;201303;1645;7042;1586;6940;291;1297;1142;5070;1433;6367
130090;201303;2200;8385;2104;8250;184;826;1780;6981;1964;7807
130100;201303;4947;19980;4764;19723;516;2275;3868;16244;4384;18519
130110;201303;5880;19649;5515;19199;1162;3843;3786;13909;4948;17752
130115;201303;3400;13218;3251;13013;195;635;2954;12034;3149;12669
130120;201303;12176;47855;11946;47526;1173;4318;10145;41598;11318;45916
130130;201303;3265;14490;3175;14330;477;2119;2448;11320;2925;13439
130140;201303;5698;23012;5655;22956;149;445;5456;22406;5605;22851
130150;201303;3212;12599;3149;12512;330;1588;2581;10177;2911;11765
130160;201303;3747;15732;3697;15649;208;765;3396;14568;3604;15333
130165;201303;2685;11185;2647;11119;573;2445;1950;8277;2523;10722
130170;201303;7322;29281;6576;28351;1341;5577;4479;20436;5820;26013
130180;201303;3098;9996;3041;9904;167;479;2752;9074;2919;9553
130185;201303;7467;28601;7281;28321;1689;6321;4848;19770;6537;26091
130190;201303;15863;57498;14257;55406;3042;11349;9309;38440;12351;49789
130195;201303;1710;7140;1655;7056;113;520;1459;6254;1572;6774
130200;201303;1831;6844;1731;6667;286;1146;1205;4695;1491;5841
130210;201303;1057;4232;1002;4130;188;736;722;3118;910;3854
130220;201303;1948;8145;1840;7994;236;1069;1415;6319;1651;7388
130230;201303;3262;15040;3130;14816;210;948;2735;13271;2945;14219
130240;201303;7738;30996;7201;30194;584;2709;6013;25635;6597;28344
130250;201303;16535;63193;16361;62921;2338;8309;13000;51844;15338;60153
130255;201303;3616;13783;3434;13467;252;1029;2970;11819;3222;12848
130260;201303;216526;718551;199736;693982;54366;189143;115339;418347;169705;607490
130270;201303;7271;30744;6627;29734;1103;4817;4755;22354;5858;27171
130280;201303;2804;11360;2748;11278;182;663;2432;10241;2614;10904
130290;201303;10087;38081;10037;38008;255;797;9500;36589;9755;37386
130300;201303;4119;16634;3928;16365;362;1568;3231;13702;3593;15270
130310;201303;4298;17581;3995;17191;596;2534;2987;13315;3583;15849
130320;201303;2460;8727;2255;8442;308;1172;1655;6369;1963;7541
130330;201303;3187;12445;2870;11990;293;1346;2348;9925;2641;11271
130340;201303;16640;65846;16271;65263;2585;9784;11919;50396;14504;60180
130350;201303;3155;12806;3026;12660;142;339;2829;12209;2971;12548
130353;201303;4363;15360;4004;14877;1183;4323;2180;8641;3363;12964
130356;201303;3230;12421;3145;12268;609;2390;2236;9021;2845;11411
130360;201303;2541;8146;2275;7830;73;234;2085;7348;2158;7582
130370;201303;4468;17847;3832;17013;350;1928;3074;13585;3424;15513
130380;201303;5976;26107;5820;25803;516;2479;4759;21350;5275;23829
130390;201303;4376;19425;4138;19033;474;2021;3390;16125;3864;18146
130395;201303;1856;7366;1737;7133;247;1197;1223;4941;1470;6138
130400;201303;2034;7567;1970;7469;111;443;1735;6674;1846;7117
130406;201303;7997;32584;7226;31237;1878;7886;4095;19026;5973;26912
130410;201303;3954;15286;3667;14742;911;3784;2034;8501;2945;12285
130420;201303;9117;40318;8867;39734;1359;5893;6623;30584;7982;36477
130423;201303;2705;11155;2616;11037;165;788;2318;9842;2483;10630
130426;201303;1768;7952;1707;7853;292;1231;1233;6036;1525;7267
130430;201303;3213;12071;3052;11842;377;1527;2277;9100;2654;10627
130440;201303;3404;12913;3133;12617;233;778;2737;11448;2970;12226
140002;201303;1288;4722;1251;4655;280;948;825;3303;1105;4251
140005;201303;2332;7655;2199;7508;133;441;1961;6792;2094;7233
140010;201303;40094;135182;36980;129865;7930;29618;23200;83012;31130;112630
140015;201303;2495;9158;2422;9066;180;565;2108;8135;2288;8700
140017;201303;2764;9372;2689;9274;189;665;2368;8260;2557;8925
140020;201303;3866;13708;3654;13413;474;1749;2785;10485;3259;12234
140023;201303;1790;6759;1735;6681;181;677;1457;5735;1638;6412
140028;201303;1997;5877;1934;5803;112;285;1733;5328;1845;5613
140030;201303;3276;11103;3177;10976;305;690;2755;10047;3060;10737
140040;201303;1427;7044;1372;6868;139;763;992;5082;1131;5845
140045;201303;2017;8115;2004;8094;187;580;1744;7330;1931;7910
140047;201303;4772;15011;4701;14927;669;1641;3793;12816;4462;14457
140050;201303;1443;4658;1379;4565;144;443;1138;3854;1282;4297
140060;201303;1198;4044;1135;3963;165;552;889;3184;1054;3736
140070;201303;1441;7105;1438;7099;59;239;1365;6815;1424;7054
150010;201303;28545;102744;27515;101308;2077;7745;23597;88471;25674;96216
150013;201303;1448;4737;1408;4690;136;472;1173;3939;1309;4411
150020;201303;9546;35119;9426;34925;838;3185;8067;30204;8905;33389
150030;201303;5717;25814;5578;25569;626;2436;4591;22039;5217;24475
150034;201303;4459;12332;4247;12081;147;352;4038;11616;4185;11968
150040;201303;11322;41745;10082;40146;1961;7135;6935;29536;8896;36671
150050;201303;5724;22333;5620;22140;716;3042;4446;17643;5162;20685
150060;201303;13006;45044;12461;44230;3440;11886;7319;27368;10759;39254
150070;201303;4946;21609;4572;21150;589;2590;3649;17401;4238;19991
150080;201303;55754;156334;49853;148891;5396;14426;39221;120701;44617;135127
150085;201303;4283;16378;4147;16177;686;2288;3190;13085;3876;15373
150090;201303;8888;36315;8462;35728;1084;4384;6744;29228;7828;33612
150095;201303;4583;16827;4339;16439;531;1982;3476;13481;4007;15463
150100;201303;3217;12679;3049;12438;326;1501;2468;10018;2794;11519
150110;201303;3133;15259;3125;15240;129;539;2945;14516;3074;15055
150120;201303;5469;22461;5385;22288;495;1954;4577;19257;5072;21211
150125;201303;758;2441;699;2342;153;540;419;1407;572;1947
150130;201303;16282;56783;15878;56135;1933;6862;12723;45657;14656;52519
150140;201303;128132;401764;124086;396614;19911;64026;94816;307384;114727;371410
150145;201303;4501;15082;4201;14702;596;2149;3162;11280;3758;13429
150150;201303;7844;27654;7490;27051;1669;6264;4912;17969;6581;24233
150157;201303;2441;8489;2293;8278;347;1343;1775;6430;2122;7773
150160;201303;2396;8751;2332;8656;587;2095;1509;5834;2096;7929
150170;201303;20976;79002;20061;77914;2869;10886;15987;63062;18856;73948
150172;201303;2766;9922;2529;9578;300;1161;2083;8007;2383;9168
150175;201303;1853;6151;1796;6081;177;537;1537;5350;1714;5887
150178;201303;10175;33182;8941;31736;577;1792;8046;29211;8623;31003
150180;201303;15508;65806;15121;65277;1493;6862;12771;55653;14264;62515
150190;201303;6663;22076;6310;21568;437;1147;5487;19502;5924;20649
150195;201303;3974;15178;3756;14767;463;1805;2943;11763;3406;13568
150200;201303;3954;14292;3922;14248;122;413;3708;13574;3830;13987
150210;201303;21210;81723;20991;81415;1474;5451;18806;73788;20280;79239
150215;201303;4661;15861;4339;15377;1128;4079;2596;9425;3724;13504
150220;201303;11395;39146;10932;38363;2437;8732;6908;24697;9345;33429
150230;201303;10209;37184;9569;36263;791;3667;8137;30472;8928;34139
150240;201303;28723;93898;27029;90919;7215;25538;15203;51613;22418;77151
150250;201303;3203;12909;3127;12787;567;2065;2291;9936;2858;12001
150260;201303;1775;7798;1759;7767;256;1259;1318;5807;1574;7066
150270;201303;8900;28298;7119;26073;1535;5930;4609;17173;6144;23103
150275;201303;5067;19967;4911;19694;742;2958;3718;15236;4460;18194
150276;201303;1918;6086;1844;5990;255;881;1487;4851;1742;5732
150277;201303;4771;15389;4250;14786;526;1869;3447;12209;3973;14078
150280;201303;5556;24559;5467;24358;528;2315;4536;20578;5064;22893
150285;201303;2509;10319;2489;10277;184;761;2240;9316;2424;10077
150290;201303;7201;24838;7076;24655;945;3162;5586;20019;6531;23181
150293;201303;8245;27438;7479;26272;2520;8921;3675;13620;6195;22541
150295;201303;5621;20458;5132;19791;1250;5001;3203;12600;4453;17601
150300;201303;1641;5981;1614;5939;89;309;1438;5339;1527;5648
150304;201303;3694;12194;3297;11683;521;1865;2464;8900;2985;10765
150307;201303;6286;22597;5921;22065;426;1486;5012;19258;5438;20744
150309;201303;5706;22045;5477;21670;1569;6111;3345;13840;4914;19951
150310;201303;4806;22739;4743;22631;539;2397;3917;19269;4456;21666
150320;201303;7194;23004;7092;22874;504;1669;6289;20394;6793;22063
150330;201303;11878;46210;11498;45554;1338;5300;9299;37555;10637;42855
150340;201303;1894;7140;1822;7035;533;2090;1025;4102;1558;6192
150345;201303;5869;21955;5601;21584;669;2640;4576;17870;5245;20510
150350;201303;6698;23573;6462;23200;886;3327;4862;17642;5748;20969
150360;201303;18803;62520;16736;59964;2520;9115;12566;46454;15086;55569
150370;201303;9096;35864;8843;35499;1173;4388;7120;29563;8293;33951
150375;201303;2517;10907;2476;10852;238;769;2110;9765;2348;10534
150380;201303;8928;28718;8167;27670;951;3479;6783;22944;7734;26423
150390;201303;7327;32787;7114;32306;1645;7087;4484;21515;6129;28602
150400;201303;5006;21684;4877;21367;642;2697;3622;16393;4264;19090
150405;201303;7700;25057;7057;24233;1588;4983;4658;17082;6246;22065
150410;201303;1566;6258;1547;6225;224;947;1111;4558;1335;5505
150420;201303;28397;107068;26169;103460;7198;29327;14596;60331;21794;89658
150430;201303;5850;22974;5757;22803;804;3515;4449;17597;5253;21112
150440;201303;4941;18137;4869;18019;661;2476;3774;14201;4435;16677
150442;201303;20341;59634;18747;57645;3068;9557;13436;42544;16504;52101
150445;201303;4600;17261;4299;16818;682;2511;3284;13280;3966;15791
150450;201303;3980;19422;3863;19260;370;1815;3282;16680;3652;18495
150460;201303;6115;23917;5272;23037;347;1615;4765;20965;5112;22580
150470;201303;13688;47751;13407;47355;1734;5247;10986;40279;12720;45526
150480;201303;13179;46976;12918;46624;856;2817;11469;42233;12325;45050
150490;201303;5662;22621;5576;22511;354;1414;5035;20487;5389;21901
150495;201303;3965;15589;3884;15420;544;2345;3019;11993;3563;14338
150497;201303;3155;11307;2927;10936;759;2804;1798;7037;2557;9841
150500;201303;2768;8806;2671;8633;405;1388;1999;6441;2404;7829
150503;201303;3692;11970;3186;11310;1235;4560;1376;5104;2611;9664
150506;201303;11237;42131;10797;41532;2513;8354;7553;31084;10066;39438
150510;201303;8903;36625;8447;35836;1436;6118;6006;26474;7442;32592
150520;201303;5341;23446;5282;23344;416;1521;4684;21242;5100;22763
150530;201303;10309;39084;9521;37951;1273;4614;7293;30243;8566;34857
150540;201303;4202;14181;3932;13773;328;1260;3303;11532;3631;12792
150543;201303;4163;14007;3867;13580;1097;3918;2341;8446;3438;12364
150548;201303;7228;24459;6857;23972;834;2661;5577;20159;6411;22820
150549;201303;2106;6964;2027;6869;102;296;1847;6376;1949;6672
150550;201303;19364;64414;18039;62362;5029;17983;10092;35651;15121;53634
150553;201303;19617;74861;18103;70769;7416;30667;3862;15180;11278;45847
150555;201303;1483;4964;1318;4717;262;1038;858;3082;1120;4120
150560;201303;1932;6395;1890;6298;210;782;1485;4912;1695;5694
150563;201303;2716;9507;2589;9280;616;2346;1649;5938;2265;8284
150565;201303;3175;11902;3030;11682;259;1137;2498;9659;2757;10796
150570;201303;4673;18906;4621;18817;418;1701;3921;16283;4339;17984
150580;201303;8129;34343;7993;34074;808;3055;6789;29964;7597;33019
150590;201303;4852;20308;4750;20183;188;881;4391;18755;4579;19636
150600;201303;6761;28020;6673;27865;706;2635;5593;24147;6299;26782
150610;201303;2385;8391;2238;8088;287;1158;1585;5685;1872;6843
150611;201303;2439;9572;2366;9389;312;1304;1761;7086;2073;8390
150613;201303;10437;34218;9396;32702;3220;11385;4730;17250;7950;28635
150616;201303;2878;8493;2355;7936;578;1897;1576;5513;2154;7410
150618;201303;7112;25578;6881;25175;2286;8687;3440;12858;5726;21545
150619;201303;4722;17264;4477;16896;890;3358;3001;11659;3891;15017
150620;201303;5843;21843;5394;21257;789;3154;4104;16737;4893;19891
150630;201303;4759;16159;4554;15885;444;1580;3754;13255;4198;14835
150635;201303;4055;14102;3875;13743;839;3071;2457;8951;3296;12022
150640;201303;1348;4551;1335;4530;34;100;1269;4346;1303;4446
150650;201303;11178;36180;10361;34699;2815;9840;5646;19167;8461;29007
150655;201303;4870;17399;4541;16941;849;3181;3280;12508;4129;15689
150658;201303;3782;13105;3664;12921;328;1392;2980;10403;3308;11795
150660;201303;5393;17757;4980;17231;1407;4777;2905;10474;4312;15251
150670;201303;5454;17230;4825;16461;1710;5900;2531;9129;4241;15029
150680;201303;45438;189208;43754;185949;15292;64050;21286;96589;36578;160639
150690;201303;1768;5988;1671;5815;283;969;1093;3943;1376;4912
150700;201303;5189;17184;5064;17000;1010;3383;3529;12110;4539;15493
150710;201303;3473;11703;3384;11581;350;899;2910;10335;3260;11234
150715;201303;4331;15589;4113;15320;493;1763;3391;12972;3884;14735
150720;201303;5669;24960;5476;24613;788;3306;4156;19485;4944;22791
150730;201303;8284;30060;7841;29455;1189;4376;6221;23886;7410;28262
150740;201303;3298;11272;3150;10989;490;1818;2225;7851;2715;9669
150745;201303;5798;18816;5456;18361;715;2425;4291;14679;5006;17104
150746;201303;1281;4561;1234;4476;191;804;875;3160;1066;3964
150747;201303;4742;16190;4497;15875;424;1472;3725;13460;4149;14932
150750;201303;2366;8909;2359;8901;136;317;2197;8531;2333;8848
150760;201303;10620;35302;10325;34889;2274;7542;6985;24314;9259;31856
150770;201303;4968;20096;4836;19889;759;2807;3715;15929;4474;18736
150775;201303;999;3350;924;3214;213;882;540;1798;753;2680
150780;201303;2892;9995;2871;9972;93;241;2705;9548;2798;9789
150790;201303;4572;15014;4353;14765;344;1011;3775;13201;4119;14212
150795;201303;13105;43091;12308;42086;1890;6282;9452;33251;11342;39533
150796;201303;2489;8165;2458;8127;383;1173;1925;6571;2308;7744
150797;201303;3544;12224;3411;12011;216;794;2978;10599;3194;11393
150800;201303;12773;45072;11857;43927;2671;9269;8020;31303;10691;40572
150803;201303;6139;23701;5967;23452;838;3532;4600;18299;5438;21831
150805;201303;2543;9211;2386;8989;388;1367;1716;6731;2104;8098
150808;201303;5486;19420;4791;18128;2089;8181;1422;5752;3511;13933
150810;201303;17671;58361;15248;55405;2599;9245;10872;41421;13471;50666
150812;201303;4548;15145;4302;14865;380;1552;3511;12068;3891;13620
150815;201303;7668;25875;7031;25104;516;1559;6194;22760;6710;24319
150820;201303;9855;30059;9036;29168;370;752;8360;27677;8730;28429
150830;201303;11726;46769;11277;45979;927;3743;9182;38716;10109;42459
150835;201303;1937;7359;1813;7054;522;2146;878;3424;1400;5570
150840;201303;6063;18829;4976;17465;1487;5716;2685;9162;4172;14878
160005;201303;693;2725;658;2646;116;539;404;1612;520;2151
160010;201303;1458;5285;1448;5274;197;555;1185;4546;1382;5101
160015;201303;1496;5769;1463;5707;263;952;1052;4347;1315;5299
160020;201303;2192;7380;2052;7189;294;1039;1533;5523;1827;6562
160021;201303;743;3448;721;3404;125;645;503;2432;628;3077
160023;201303;912;3519;903;3506;111;393;756;3010;867;3403
160025;201303;1157;3175;1127;3143;27;88;1082;3009;1109;3097
160027;201303;7198;25128;6900;24775;1382;5194;4860;17716;6242;22910
160030;201303;35593;137518;35044;136427;7972;29858;24350;97889;32322;127747
160040;201303;3039;13200;2985;13104;204;950;2648;11707;2852;12657
160050;201303;2888;11500;2631;11083;1011;3867;1188;5797;2199;9664
160053;201303;1753;7645;1739;7613;508;2145;1107;5088;1615;7233
160055;201303;758;3062;742;3039;142;621;524;2175;666;2796
160060;201303;17173;57325;16212;56251;3741;12256;11045;40310;14786;52566
160070;201303;1924;8653;1910;8629;179;747;1672;7712;1851;8459
160080;201303;2414;9830;2396;9800;160;558;2184;9103;2344;9661
170025;201303;551;1928;509;1863;188;718;239;900;427;1618
170030;201303;1077;3722;1019;3625;296;1085;553;1991;849;3076
170035;201303;1494;4668;1242;4182;447;1605;395;1366;842;2971
170040;201303;1629;5705;1487;5482;371;1509;832;3090;1203;4599
170070;201303;1975;5588;1646;5176;417;1428;920;2946;1337;4374
170100;201303;2405;6614;2169;6198;231;762;1766;4981;1997;5743
170105;201303;661;2297;591;2149;135;598;334;1166;469;1764
170110;201303;1119;3573;1004;3376;164;509;696;2423;860;2932
170130;201303;1286;4220;1162;4057;159;571;861;3106;1020;3677
170190;201303;1525;4707;1329;4438;440;1452;552;2035;992;3487
170200;201303;1406;4561;1128;4056;312;1249;357;1264;669;2513
170210;201303;23677;80223;21428;76056;9571;36125;6003;21928;15574;58053
170215;201303;1061;3589;976;3449;152;552;701;2529;853;3081
170220;201303;6021;20725;5583;20068;787;2998;4051;14960;4838;17958
170230;201303;1395;4926;1265;4695;362;1506;595;2144;957;3650
170240;201303;2887;8198;2399;7634;326;1173;1749;5638;2075;6811
170255;201303;3352;11092;2893;10310;1040;3624;1177;4543;2217;8167
170270;201303;1017;2696;750;2334;207;664;427;1360;634;2024
170290;201303;2757;8814;2433;8415;281;945;1972;7029;2253;7974
170300;201303;1962;6497;1758;6167;318;1213;1174;4159;1492;5372
170305;201303;651;2183;566;2014;120;461;352;1243;472;1704
170307;201303;1063;3795;936;3573;305;1180;357;1540;662;2720
170310;201303;1539;4385;1261;3938;277;911;680;2223;957;3134
170320;201303;874;2753;748;2528;163;582;455;1541;618;2123
170330;201303;733;2318;618;2199;106;307;475;1817;581;2124
170360;201303;441;1592;420;1558;97;381;206;755;303;1136
170370;201303;1348;4102;1146;3813;198;785;690;2271;888;3056
170380;201303;2025;6657;1718;6210;386;1587;956;3443;1342;5030
170382;201303;543;1943;513;1899;53;186;428;1612;481;1798
170384;201303;1248;5721;1219;5666;275;1321;838;3972;1113;5293
170386;201303;797;2507;663;2300;211;797;228;839;439;1636
170388;201303;617;1911;543;1793;129;502;233;751;362;1253
170389;201303;951;3402;895;3317;115;511;685;2505;800;3016
170390;201303;1233;3853;1079;3655;199;677;769;2682;968;3359
170410;201303;433;1519;420;1495;67;262;276;992;343;1254
170460;201303;392;1239;354;1174;103;364;132;442;235;806
170510;201303;765;2693;670;2550;130;565;403;1521;533;2086
170550;201303;5053;16488;4323;15157;1754;6555;1311;4765;3065;11320
170555;201303;1253;3815;1073;3545;285;1048;578;1911;863;2959
170560;201303;1000;3500;866;3346;181;690;614;2475;795;3165
170600;201303;1289;3743;1157;3586;65;217;977;3084;1042;3301
170610;201303;1554;4787;1241;4291;211;817;714;2495;925;3312
170625;201303;387;1296;315;1135;98;374;82;306;180;680
170650;201303;1203;4045;1146;3943;276;1005;637;2249;913;3254
170700;201303;3720;12940;3205;12081;848;3505;1598;6266;2446;9771
170710;201303;1623;5013;1399;4689;193;764;990;3339;1183;4103
170720;201303;1768;4851;1585;4556;256;739;1202;3501;1458;4240
170730;201303;1120;3312;940;3048;289;1032;434;1410;723;2442
170740;201303;2102;7980;1979;7790;285;1245;1451;5750;1736;6995
170755;201303;877;2827;755;2568;217;795;308;1032;525;1827
170765;201303;1514;4191;1243;3758;327;1062;531;1656;858;2718
170770;201303;1753;6298;1651;6098;392;1509;942;3599;1334;5108
170820;201303;3975;13098;3633;12562;1005;3681;1730;6088;2735;9769
170825;201303;691;2243;561;2012;167;674;267;936;434;1610
170830;201303;1180;3794;1153;3752;53;137;1047;3447;1100;3584
170900;201303;2716;9934;2619;9739;334;1208;2014;7716;2348;8924
170930;201303;4128;12813;3402;11803;1373;4996;1169;4095;2542;9091
170950;201303;9441;30635;7798;27936;3897;15018;1700;5726;5597;20744
170980;201303;421;1381;366;1279;114;402;147;511;261;913
171050;201303;1184;4369;1146;4302;65;290;1025;3815;1090;4105
171070;201303;1559;5350;1479;5230;360;1333;894;3207;1254;4540
171090;201303;750;2486;706;2411;172;583;420;1488;592;2071
171110;201303;600;1857;512;1720;161;595;291;937;452;1532
171150;201303;860;2613;654;2218;139;505;366;1248;505;1753
171180;201303;570;1889;475;1679;117;447;223;813;340;1260
171190;201303;1813;6621;1570;6129;381;1560;769;3140;1150;4700
171195;201303;827;3067;765;2962;111;483;509;2023;620;2506
171200;201303;613;2087;518;1901;151;627;227;779;378;1406
171215;201303;425;1334;354;1215;67;255;186;645;253;900
171240;201303;864;2966;840;2927;74;166;729;2659;803;2825
171245;201303;654;2198;553;1953;117;446;289;1021;406;1467
171250;201303;1061;3179;967;3070;93;312;794;2545;887;2857
171270;201303;381;1605;359;1556;77;313;221;1007;298;1320
171280;201303;807;2636;750;2540;171;570;404;1487;575;2057
171320;201303;3657;11745;3218;11119;1151;4134;1512;5269;2663;9403
171330;201303;2615;8375;2403;8061;620;2191;1367;4662;1987;6853
171360;201303;1466;4952;1261;4655;345;1357;674;2530;1019;3887
171370;201303;656;1926;597;1829;140;525;331;953;471;1478
171380;201303;1185;4308;1103;4160;243;907;688;2694;931;3601
171395;201303;857;2797;742;2584;144;587;435;1495;579;2082
171420;201303;2194;6803;1832;6190;348;1323;1051;3543;1399;4866
171430;201303;982;3241;911;3137;221;761;563;1979;784;2740
171488;201303;2260;7263;2112;7035;551;1855;1165;4005;1716;5860
171500;201303;804;2592;724;2424;129;422;392;1348;521;1770
171510;201303;878;3272;806;3161;162;638;508;2100;670;2738
171515;201303;594;1799;482;1642;122;432;228;797;350;1229
171525;201303;565;1988;491;1840;101;423;262;969;363;1392
171550;201303;300;1083;274;1007;131;536;39;146;170;682
171570;201303;1060;3570;957;3421;166;602;664;2421;830;3023
171575;201303;1846;5486;1522;4916;489;1639;610;2070;1099;3709
171610;201303;5756;20398;5398;19718;1997;7600;1893;7010;3890;14610
171620;201303;2060;7045;1960;6875;219;851;1553;5478;1772;6329
171630;201303;831;2879;696;2639;177;757;298;1120;475;1877
171650;201303;2172;7162;1869;6658;516;2029;882;3054;1398;5083
171660;201303;2486;7197;2090;6514;524;1722;1072;3438;1596;5160
171665;201303;1282;4181;1176;3993;236;897;739;2523;975;3420
171670;201303;2214;6117;1872;5685;462;1505;1173;3548;1635;5053
171700;201303;1049;3684;963;3543;172;706;629;2319;801;3025
171720;201303;637;2100;568;1963;163;641;300;1015;463;1656
171750;201303;1183;4029;1068;3793;387;1430;408;1485;795;2915
171780;201303;1089;3277;831;2910;145;564;522;1826;667;2390
171790;201303;1687;5555;1380;5107;309;1162;794;3084;1103;4246
171800;201303;682;2275;633;2206;91;355;440;1540;531;1895
171820;201303;9010;29238;8441;28556;1866;6803;5397;18486;7263;25289
171830;201303;1585;5931;1468;5669;344;1422;750;2936;1094;4358
171840;201303;716;2271;659;2191;94;338;478;1603;572;1941
171845;201303;747;2107;589;1830;84;318;347;1038;431;1356
171850;201303;996;3744;921;3585;119;558;617;2394;736;2952
171855;201303;1183;3950;1086;3788;118;500;828;2840;946;3340
171865;201303;464;1555;396;1450;99;401;201;732;300;1133
171870;201303;630;2150;542;1997;125;492;285;1091;410;1583
171875;201303;1328;4384;1134;4086;190;745;793;2851;983;3596
171880;201303;990;3634;969;3601;126;487;753;2863;879;3350
171884;201303;784;2393;617;2143;126;480;275;997;401;1477
171886;201303;1400;4922;1295;4698;451;1764;498;1796;949;3560
171888;201303;585;1918;516;1795;101;361;320;1164;421;1525
171889;201303;470;1647;463;1634;78;234;329;1245;407;1479
171890;201303;1055;3690;981;3581;142;636;672;2402;814;3038
171900;201303;407;1625;392;1596;100;425;216;882;316;1307
172000;201303;599;1992;514;1869;93;407;304;1074;397;1481
172010;201303;1092;3872;1041;3778;90;360;838;3090;928;3450
172015;201303;340;1297;299;1233;58;245;177;772;235;1017
172020;201303;2230;7481;2019;7174;295;1171;1456;5209;1751;6380
172025;201303;640;2025;555;1867;92;346;346;1153;438;1499
172030;201303;1047;3677;970;3536;176;721;614;2265;790;2986
172049;201303;1020;3156;975;3095;142;462;720;2326;862;2788
172065;201303;987;3262;850;3086;163;642;599;2188;762;2830
172080;201303;2622;8188;2282;7626;324;1266;1538;5049;1862;6315
172085;201303;480;1387;390;1240;125;473;94;270;219;743
172090;201303;3253;10029;2580;9179;540;2074;1571;5728;2111;7802
172093;201303;544;1856;449;1684;185;773;175;652;360;1425
172097;201303;648;1971;564;1829;196;692;188;603;384;1295
172100;201303;23049;82619;21312;79083;7741;31034;6822;25478;14563;56512
172110;201303;1572;5912;1479;5775;170;673;1133;4546;1303;5219
172120;201303;5365;16546;4571;15553;462;1633;3635;12657;4097;14290
172125;201303;307;961;248;873;55;206;122;456;177;662
172130;201303;473;1468;438;1417;89;317;281;930;370;1247
172208;201303;2103;6769;2006;6604;471;1635;1159;3927;1630;5562
172210;201303;2243;6867;2158;6765;147;499;1907;5987;2054;6486
210005;201303;19918;68070;18494;65733;4704;17817;10925;39198;15629;57015
210010;201303;1537;5575;1396;5399;138;494;1137;4543;1275;5037
210015;201303;3209;10085;3012;9817;182;424;2629;8954;2811;9378
210020;201303;6659;18045;6271;17569;486;1553;5096;14510;5582;16063
210030;201303;5590;19340;5432;19112;470;2041;4541;15779;5011;17820
210040;201303;1929;5758;1774;5574;178;563;1428;4551;1606;5114
210043;201303;5405;17588;5206;17265;319;1156;4547;15161;4866;16317
210047;201303;6524;25986;6174;25332;969;4274;4188;17340;5157;21614
210050;201303;2367;8232;1980;7826;160;639;1680;6745;1840;7384
210055;201303;1571;5650;1506;5560;194;679;1187;4466;1381;5145
210060;201303;7736;28826;7072;27825;821;3593;5320;21300;6141;24893
210070;201303;6322;20907;6154;20714;286;1061;5660;19140;5946;20201
210080;201303;3360;11941;3301;11846;115;460;3062;11027;3177;11487
210083;201303;3207;12012;3158;11951;227;788;2807;10810;3034;11598
210087;201303;2218;7507;2158;7427;152;562;1948;6698;2100;7260
210090;201303;8975;30693;8759;30346;641;2289;7530;26323;8171;28612
210095;201303;6005;24144;5917;23972;655;2718;4880;20050;5535;22768
210100;201303;7231;22035;6968;21735;223;902;6420;19992;6643;20894
210110;201303;3025;10854;2943;10732;214;838;2481;9215;2695;10053
210120;201303;21622;71107;19613;68376;2122;7872;15281;54070;17403;61942
210125;201303;3108;10694;3005;10566;248;849;2611;9314;2859;10163
210130;201303;3399;10705;3349;10651;213;709;2957;9457;3170;10166
210135;201303;1435;4638;1338;4491;102;367;1138;3864;1240;4231
210140;201303;15762;53322;13796;50795;2917;10988;9167;34767;12084;45755
210150;201303;4158;11652;3981;11449;176;478;3658;10585;3834;11063
210160;201303;17318;58947;16352;57529;1848;6451;13190;47419;15038;53870
210170;201303;13533;51321;13340;51041;1046;3639;11648;45502;12694;49141
210173;201303;1684;7495;1646;7411;174;769;1378;6303;1552;7072
210177;201303;2713;9461;2584;9288;315;1250;2047;7330;2362;8580
210180;201303;1365;4459;1302;4351;137;473;1051;3535;1188;4008
210190;201303;4931;16598;4719;16247;397;1807;3733;12592;4130;14399
210193;201303;1367;4541;1306;4445;89;349;1101;3773;1190;4122
210197;201303;1590;6048;1539;5988;105;478;1361;5273;1466;5751
210200;201303;8495;30311;7994;29605;1136;4060;5970;22965;7106;27025
210203;201303;5809;20388;5482;19971;414;1312;4775;17830;5189;19142
210207;201303;2877;10018;2751;9799;371;1340;2090;7557;2461;8897
210210;201303;8219;28959;8016;28615;363;1408;6986;25263;7349;26671
210215;201303;1755;7117;1721;7069;156;708;1464;6037;1620;6745
210220;201303;5998;23935;5837;23667;473;1959;4846;20092;5319;22051
210230;201303;5109;18221;4799;17696;507;1903;3769;14136;4276;16039
210232;201303;10723;41200;10305;40524;2126;8254;7323;29606;9449;37860
210235;201303;3126;10414;2927;10145;214;779;2556;8902;2770;9681
210237;201303;2431;8866;2409;8833;49;126;2318;8607;2367;8733
210240;201303;2514;8745;2455;8648;203;764;2042;7213;2245;7977
210250;201303;4471;15460;4337;15292;163;625;4003;14219;4166;14844
210255;201303;2482;8417;2290;8095;610;2322;1309;4688;1919;7010
210260;201303;4845;16070;4528;15588;600;1998;3534;12391;4134;14389
210270;201303;4813;14675;4539;14323;189;661;4082;13019;4271;13680
210275;201303;3144;8612;2951;8401;101;270;2792;7999;2893;8269
210280;201303;5624;16999;5022;16241;376;1352;4298;14009;4674;15361
210290;201303;5739;18606;5348;18109;543;1799;4371;15110;4914;16909
210300;201303;33218;109001;29657;104255;3245;12236;24202;85963;27447;98199
210310;201303;2448;7753;2409;7697;161;533;2154;6911;2315;7444
210312;201303;1764;6448;1746;6414;141;565;1493;5524;1634;6089
210315;201303;1972;7615;1922;7551;79;334;1757;6974;1836;7308
210317;201303;4066;12580;3986;12486;162;487;3734;11770;3896;12257
210320;201303;17012;58811;16560;58177;821;3225;15093;53139;15914;56364
210325;201303;3143;10716;2941;10443;369;1409;2352;8407;2721;9816
210330;201303;29191;85327;25467;81197;3536;10420;19252;65061;22788;75481
210340;201303;11249;36917;10507;36004;1267;3919;8269;29601;9536;33520
210350;201303;9661;32361;9227;31759;856;2999;7595;26672;8451;29671
210355;201303;3846;13989;3549;13623;125;335;3304;12990;3429;13325
210360;201303;16181;51421;15348;50172;1437;4954;12341;41013;13778;45967
210370;201303;7419;22011;6885;21435;260;851;6375;19960;6635;20811
210375;201303;3117;9948;2775;9546;515;1921;2009;6980;2524;8901
210380;201303;5709;17704;5259;16952;357;1250;4450;14391;4807;15641
210390;201303;2491;9577;2409;9447;93;396;2232;8823;2325;9219
210400;201303;4417;15483;4278;15302;381;1269;3666;13383;4047;14652
210405;201303;8113;23548;6847;21833;1967;6317;3412;11798;5379;18115
210407;201303;1984;7070;1806;6792;193;684;1403;5538;1596;6222
210408;201303;1938;8158;1878;8084;78;316;1737;7603;1815;7919
210409;201303;3645;13714;3506;13496;285;1190;2814;11081;3099;12271
210410;201303;3130;11057;2939;10813;296;1031;2497;9344;2793;10375
210420;201303;3878;13517;3697;13205;374;1315;2998;10909;3372;12224
210430;201303;1813;5962;1791;5929;130;441;1581;5274;1711;5715
210440;201303;3897;12983;3805;12837;235;842;3308;11293;3543;12135
210450;201303;2566;8747;2431;8523;217;861;1987;6970;2204;7831
210455;201303;3997;12309;3435;11414;614;2096;2317;7917;2931;10013
210460;201303;4052;13356;3877;13140;206;737;3435;11794;3641;12531
210462;201303;1718;6370;1679;6298;184;716;1300;4990;1484;5706
210465;201303;2682;8998;2558;8834;318;942;2065;7423;2383;8365
210467;201303;5571;20062;5243;19583;768;2969;3947;15062;4715;18031
210470;201303;1604;5199;1484;5036;111;419;1210;4151;1321;4570
210480;201303;12452;44851;11429;43440;2692;10546;7374;28798;10066;39344
210490;201303;3120;10009;2946;9743;396;1387;2254;7492;2650;8879
210500;201303;6530;26031;6276;25581;729;2899;4876;20589;5605;23488
210510;201303;6248;21968;6167;21876;163;563;5748;20778;5911;21341
210515;201303;3432;11363;3385;11285;292;898;2924;9946;3216;10844
210520;201303;2494;8302;2376;8135;273;971;1881;6558;2154;7529
210530;201303;37374;130122;33648;124299;11310;44213;17054;64168;28364;108381
210535;201303;2949;10928;2901;10840;141;589;2574;9676;2715;10265
210540;201303;11186;41702;10283;40197;2121;8244;6435;26662;8556;34906
210542;201303;6204;19081;5563;18364;279;839;5003;16876;5282;17715
210545;201303;2104;7402;2025;7278;89;389;1765;6364;1854;6753
210547;201303;3260;12480;3130;12285;211;915;2710;10719;2921;11634
210550;201303;5987;18003;5204;17121;270;802;4695;15777;4965;16579
210560;201303;3362;11853;3202;11611;265;1059;2686;9761;2951;10820
210565;201303;1463;5192;1328;4996;74;339;1098;4170;1172;4509
210570;201303;11563;36142;10649;35056;1030;3254;8935;30131;9965;33385
210580;201303;2500;8716;2255;8391;280;1069;1759;6678;2039;7747
210590;201303;4288;13833;4102;13603;264;891;3613;12157;3877;13048
210592;201303;2379;7759;2334;7689;117;456;2086;6836;2203;7292
210594;201303;2540;7730;2220;7351;133;465;1937;6485;2070;6950
210596;201303;2762;10749;2647;10534;344;1404;1998;8084;2342;9488
210598;201303;1936;6162;1863;6079;112;479;1710;5479;1822;5958
210600;201303;3188;9601;3015;9369;270;917;2489;7698;2759;8615
210610;201303;2520;8303;2290;8023;253;899;1882;6654;2135;7553
210620;201303;1680;5372;1579;5242;56;190;1469;4909;1525;5099
210630;201303;3178;12133;2812;11393;548;2214;1637;6946;2185;9160
210632;201303;4550;16289;4229;15831;507;1959;3317;12533;3824;14492
210635;201303;1809;6842;1790;6811;60;200;1673;6462;1733;6662
210637;201303;2579;9076;2491;8950;144;550;2220;8060;2364;8610
210640;201303;4076;13810;4030;13747;35;118;3919;13439;3954;13557
210650;201303;5949;19734;5871;19621;419;1438;5245;17637;5664;19075
210660;201303;7026;23276;6695;22761;276;879;6132;20958;6408;21837
210663;201303;2611;8047;2538;7968;70;220;2408;7647;2478;7867
210667;201303;1557;6021;1516;5964;118;504;1282;5107;1400;5611
210670;201303;4538;17611;4431;17420;421;1715;3586;14414;4007;16129
210675;201303;4648;13607;4532;13463;325;979;3894;11786;4219;12765
210680;201303;4153;12923;3807;12502;210;757;3362;11063;3572;11820
210690;201303;6259;22674;6073;22478;361;1399;5493;20416;5854;21815
210700;201303;2429;7175;2173;6872;148;365;1845;6183;1993;6548
210710;201303;4548;15434;4440;15271;163;506;4129;14348;4292;14854
210720;201303;2198;8757;2154;8695;164;690;1866;7585;2030;8275
210725;201303;1133;4276;992;4034;144;648;614;2516;758;3164
210730;201303;1116;3699;1023;3600;68;219;909;3246;977;3465
210735;201303;3548;13600;3362;13125;600;2386;2402;9596;3002;11982
210740;201303;4323;12334;4068;12075;191;413;3729;11381;3920;11794
210745;201303;3198;10707;3121;10584;256;1001;2636;8863;2892;9864
210750;201303;19336;55741;17896;54056;1807;5600;14810;45202;16617;50802
210760;201303;5352;15151;5154;14939;87;266;5004;14520;5091;14786
210770;201303;5842;16407;5109;15588;218;622;4682;14425;4900;15047
210780;201303;8243;29193;7871;28512;998;3975;5909;21545;6907;25520
210790;201303;4423;13844;3923;13297;182;629;3551;12212;3733;12841
210800;201303;4432;14262;4092;13900;223;823;3532;12409;3755;13232
210805;201303;3537;15652;3488;15552;207;923;3052;13884;3259;14807
210810;201303;5279;17049;4814;16519;482;1361;4093;14521;4575;15882
210820;201303;8573;25543;8242;25104;1286;3908;6123;19107;7409;23015
210825;201303;5132;17664;5051;17567;198;719;4634;16262;4832;16981
210830;201303;7602;25785;7361;25522;262;721;6992;24530;7254;25251
210840;201303;3471;10067;3254;9722;305;833;2584;7783;2889;8616
210845;201303;5182;17218;5050;17053;237;767;4551;15640;4788;16407
210850;201303;5394;21218;5157;20774;1020;4543;3412;13784;4432;18327
210860;201303;15816;52556;15445;52003;1489;5260;12854;43407;14343;48667
210870;201303;5927;20366;5470;19735;761;2808;4021;14761;4782;17569
210880;201303;3640;12215;3610;12181;201;615;3289;11271;3490;11886
210890;201303;5183;16153;4899;15776;386;1422;4120;13171;4506;14593
210900;201303;4276;14657;4060;14268;1399;5017;1937;7063;3336;12080
210905;201303;1742;5621;1692;5558;96;256;1546;5184;1642;5440
210910;201303;10076;33079;9623;32376;2000;7107;6340;21622;8340;28729
210920;201303;3323;11435;3248;11333;174;516;2918;10407;3092;10923
210923;201303;1422;5578;1388;5515;204;846;1036;4196;1240;5042
210927;201303;4478;14532;4401;14455;41;106;4325;14266;4366;14372
210930;201303;2325;9172;2280;9098;200;915;1921;7689;2121;8604
210940;201303;2783;11453;2748;11385;316;1199;2236;9527;2552;10726
210945;201303;5611;16851;5442;16679;140;208;5249;16372;5389;16580
210950;201303;5066;16895;4546;16109;687;2472;3150;11535;3837;14007
210955;201303;1750;6141;1626;5914;282;1145;1105;3996;1387;5141
210960;201303;8593;29868;8368;29495;1691;5837;5969;21652;7660;27489
210970;201303;1260;4903;1155;4740;210;903;805;3355;1015;4258
210975;201303;1608;5940;1545;5812;149;633;1246;4692;1395;5325
210980;201303;8075;21959;7923;21781;278;790;7375;20307;7653;21097
210990;201303;13991;40711;11929;38494;808;2322;10566;34747;11374;37069
211000;201303;14708;50293;13647;48869;1397;5210;11093;40395;12490;45605
211003;201303;4983;17951;4652;17435;868;3395;3151;12066;4019;15461
211010;201303;6384;21514;6246;21327;167;570;5798;19979;5965;20549
211020;201303;7114;22317;7056;22245;278;590;6678;21404;6956;21994
211023;201303;2356;8346;2279;8211;167;619;1938;7080;2105;7699
211027;201303;2932;11712;2809;11508;298;1174;2267;9633;2565;10807
211030;201303;4023;12869;3703;12493;850;2380;2639;9477;3489;11857
211040;201303;4005;15514;3943;15411;115;475;3605;14287;3720;14762
211050;201303;9565;27120;9460;26998;540;1401;8723;25119;9263;26520
211060;201303;5226;20379;5144;20204;464;1644;4368;17610;4832;19254
211065;201303;1585;5719;1470;5559;94;375;1318;5011;1412;5386
211070;201303;8324;28829;8047;28355;847;3095;6419;22972;7266;26067
211080;201303;1294;4219;1088;3943;97;468;899;3195;996;3663
211085;201303;1905;6618;1675;6329;300;1087;1273;4986;1573;6073
211090;201303;3250;11029;3109;10824;248;976;2588;9004;2836;9980
211100;201303;6079;17581;5964;17434;170;594;5516;16137;5686;16731
211102;201303;2924;11285;2847;11174;309;1264;2352;9331;2661;10595
211105;201303;2658;8710;2469;8470;171;633;2163;7443;2334;8076
211107;201303;4183;13439;4013;13217;125;415;3732;12379;3857;12794
211110;201303;6067;19080;5045;17798;820;2796;3551;13185;4371;15981
211120;201303;28136;82646;25689;79249;2981;9029;20174;63613;23155;72642
211125;201303;1962;6967;1903;6861;137;531;1628;5917;1765;6448
211130;201303;137527;423594;131799;416316;23500;73886;97096;313156;120596;387042
211140;201303;5528;18567;5382;18334;320;1183;4693;16023;5013;17206
211150;201303;9063;30564;8921;30371;618;2034;7935;27396;8553;29430
211153;201303;3122;9582;2876;9289;272;719;2411;8118;2683;8837
211157;201303;1134;3990;1001;3794;135;619;729;2787;864;3406
211160;201303;3941;14178;3544;13501;432;1891;2710;10341;3142;12232
211163;201303;1544;5279;1485;5204;73;298;1352;4727;1425;5025
211167;201303;1381;4939;1294;4782;69;296;1113;4133;1182;4429
211170;201303;6245;18024;6094;17835;179;661;5668;16523;5847;17184
211172;201303;2149;6629;1938;6314;162;670;1563;4998;1725;5668
211174;201303;2726;8377;2544;8138;140;561;2215;7033;2355;7594
211176;201303;5406;16221;4660;15346;494;1404;3823;13048;4317;14452
211178;201303;2822;9602;2762;9537;67;200;2639;9205;2706;9405
211180;201303;4079;15274;3851;14902;417;1773;3005;11698;3422;13471
211190;201303;2637;9488;2436;9211;161;701;2126;8077;2287;8778
211195;201303;1372;4553;1225;4389;102;370;1011;3695;1113;4065
211200;201303;1966;7260;1794;7008;297;1098;1258;5224;1555;6322
211210;201303;6728;22952;6570;22684;516;1843;5593;19493;6109;21336
211220;201303;32938;102993;29350;98182;6681;23197;18237;62794;24918;85991
211223;201303;5684;16675;5343;16123;725;2221;3719;11804;4444;14025
211227;201303;1428;5702;1403;5658;173;823;1075;4305;1248;5128
211230;201303;8206;29621;7882;29018;1376;5121;5487;20624;6863;25745
211240;201303;8300;28567;8117;28343;382;1425;7477;26215;7859;27640
211245;201303;4820;15738;4743;15639;242;705;4323;14496;4565;15201
211250;201303;11123;43715;10672;43179;1278;4404;8833;37189;10111;41593
211260;201303;6455;24670;6394;24562;376;1265;5813;22688;6189;23953
211270;201303;9504;35079;9159;34613;663;2788;7684;29383;8347;32171
211280;201303;10671;33092;10601;32997;1103;2857;9085;29177;10188;32034
211285;201303;1907;7053;1694;6681;414;1647;953;3975;1367;5622
211290;201303;7560;25467;7440;25325;545;1528;6607;23035;7152;24563
211300;201303;7922;25553;7186;24421;742;2732;5694;19434;6436;22166
211400;201303;11631;35545;10962;34826;2065;6408;7508;25743;9573;32151
220005;201303;1729;5196;1670;5091;71;312;1453;4322;1524;4634
220010;201303;1671;4564;1274;4066;153;566;971;3055;1124;3621
220020;201303;3506;11105;3410;10926;601;2067;2325;7404;2926;9471
220025;201303;2017;5305;1938;5198;78;256;1737;4587;1815;4843
220027;201303;1276;3782;1218;3703;89;253;1043;3232;1132;3485
220030;201303;3164;10041;3109;9949;252;900;2657;8504;2909;9404
220040;201303;8123;25829;7831;25347;1430;4961;5189;16854;6619;21815
220045;201303;1396;4608;1289;4442;160;615;972;3336;1132;3951
220050;201303;4533;13473;4140;12961;370;1327;3453;10715;3823;12042
220060;201303;1878;5124;1782;5008;119;362;1567;4401;1686;4763
220070;201303;2515;7755;2271;7421;203;665;1859;6188;2062;6853
220080;201303;802;2554;758;2475;101;403;534;1690;635;2093
220090;201303;1625;4790;1477;4564;152;550;1144;3465;1296;4015
220095;201303;628;1874;610;1829;39;118;550;1643;589;1761
220100;201303;1365;4247;1210;4005;164;501;881;3027;1045;3528
220105;201303;2103;7291;2020;7139;206;785;1498;5308;1704;6093
220110;201303;3417;10199;3035;9650;298;1132;2458;7682;2756;8814
220115;201303;2071;7942;1998;7818;313;1259;1513;6017;1826;7276
220117;201303;1362;3737;1141;3409;97;333;889;2615;986;2948
220120;201303;11530;35154;10874;34316;461;1738;9771;30900;10232;32638
220130;201303;766;2910;682;2798;75;217;574;2479;649;2696
220140;201303;1470;4135;1438;4096;78;174;1339;3864;1417;4038
220150;201303;6620;22431;6457;22187;548;2142;5428;18656;5976;20798
220155;201303;1019;3304;889;3048;91;391;626;2092;717;2483
220157;201303;1007;2801;938;2700;47;129;822;2397;869;2526
220160;201303;2762;8564;2506;8119;269;1018;1902;6111;2171;7129
220170;201303;1176;4026;1140;3949;109;426;914;3172;1023;3598
220173;201303;2074;6419;1769;5835;105;451;1440;4699;1545;5150
220177;201303;1478;4745;1458;4712;122;407;1253;4077;1375;4484
220180;201303;1123;3167;1020;3012;93;328;789;2284;882;2612
220190;201303;4485;15030;3923;14307;470;1818;3020;11090;3490;12908
220191;201303;1320;4704;1275;4625;210;775;939;3439;1149;4214
220192;201303;1731;5229;1460;4774;185;579;1088;3644;1273;4223
220194;201303;1584;4867;1529;4777;147;535;1274;3921;1421;4456
220196;201303;1933;6086;1856;5964;204;762;1456;4651;1660;5413
220198;201303;1306;3597;1128;3356;51;165;1023;3061;1074;3226
220200;201303;4522;16075;4296;15700;751;3017;2942;10702;3693;13719
220202;201303;1919;6433;1797;6208;98;405;1554;5345;1652;5750
220205;201303;2627;7830;2353;7455;133;542;2037;6381;2170;6923
220207;201303;901;2814;812;2665;107;395;602;1979;709;2374
220208;201303;1445;5520;1374;5365;285;1212;867;3418;1152;4630
220209;201303;1532;4961;1425;4771;107;425;1101;3689;1208;4114
220210;201303;1826;4957;1610;4671;102;344;1285;3759;1387;4103
220211;201303;1522;4896;1451;4794;113;512;1181;3882;1294;4394
220213;201303;1738;5256;1633;5065;125;433;1290;3960;1415;4393
220217;201303;1749;5588;1707;5528;90;279;1527;4999;1617;5278
220220;201303;10892;33118;10386;32282;1434;4426;7603;24146;9037;28572
220225;201303;887;2964;873;2937;40;172;783;2619;823;2791
220230;201303;5580;15453;4588;14098;270;853;4021;12445;4291;13298
220240;201303;2591;8504;2507;8352;218;841;1987;6544;2205;7385
220245;201303;1297;3773;1252;3711;58;149;1138;3412;1196;3561
220250;201303;3218;8853;2966;8537;65;169;2799;8149;2864;8318
220253;201303;1804;5568;1581;5155;120;477;1184;3903;1304;4380
220255;201303;1665;5012;1489;4719;124;495;1188;3679;1312;4174
220260;201303;5097;16814;4741;16168;531;2091;3575;12126;4106;14217
220265;201303;1151;4332;1116;4276;111;520;886;3345;997;3865
220270;201303;5938;21863;5828;21665;452;2010;4941;18186;5393;20196
220271;201303;1310;3968;1281;3928;103;333;1091;3371;1194;3704
220272;201303;1733;5467;1629;5311;119;492;1286;4144;1405;4636
220273;201303;1189;3574;1094;3439;97;361;875;2732;972;3093
220275;201303;1938;5453;1701;5143;97;313;1453;4429;1550;4742
220277;201303;2450;6929;2114;6435;195;646;1578;4842;1773;5488
220280;201303;1734;4612;1526;4324;105;390;1240;3444;1345;3834
220285;201303;1567;4336;1470;4205;107;287;1224;3616;1331;3903
220290;201303;6388;21059;5434;19838;414;1523;4589;17052;5003;18575
220300;201303;1877;6216;1686;5959;87;386;1480;5235;1567;5621
220310;201303;2466;8099;2030;7575;111;364;1837;7006;1948;7370
220320;201303;3241;9853;2778;9109;397;1283;2035;6809;2432;8092
220323;201303;1394;5335;1300;5197;223;948;931;3735;1154;4683
220325;201303;1208;3871;1123;3718;153;530;767;2645;920;3175
220327;201303;1288;4294;1182;4108;99;450;960;3299;1059;3749
220330;201303;3492;10537;3393;10390;331;1134;2805;8622;3136;9756
220335;201303;1953;5854;1777;5623;126;468;1520;4784;1646;5252
220340;201303;1655;4945;1520;4763;171;614;1185;3673;1356;4287
220342;201303;1198;4042;1139;3958;118;467;867;3114;985;3581
220345;201303;2696;7960;2355;7393;64;225;2076;6489;2140;6714
220350;201303;4374;12078;3888;11426;326;1049;3090;9066;3416;10115
220360;201303;1362;3965;1092;3536;113;440;798;2556;911;2996
220370;201303;8713;25921;8164;25237;409;1202;7473;23251;7882;24453
220375;201303;1407;4594;1337;4493;91;359;1160;3871;1251;4230
220380;201303;1242;3670;1109;3478;88;308;830;2619;918;2927
220385;201303;603;1797;570;1740;50;178;477;1416;527;1594
220390;201303;10084;32681;9550;31683;2153;7645;5636;18836;7789;26481
220400;201303;1394;3467;1285;3319;61;206;1121;2835;1182;3041
220410;201303;1362;4066;1189;3836;112;483;943;2949;1055;3432
220415;201303;813;2293;742;2194;86;256;553;1651;639;1907
220420;201303;2119;6420;2052;6305;150;476;1748;5384;1898;5860
220430;201303;2808;8618;2679;8437;468;1536;1894;5968;2362;7504
220435;201303;1523;4661;1452;4575;77;245;1265;4026;1342;4271
220440;201303;2744;8339;2285;7821;152;418;2043;7141;2195;7559
220450;201303;2683;8095;2359;7671;506;1668;1540;5124;2046;6792
220455;201303;1334;4302;1198;4104;64;215;1074;3726;1138;3941
220460;201303;958;2792;912;2728;57;189;797;2369;854;2558
220465;201303;2363;8004;2226;7828;318;1194;1721;6111;2039;7305
220470;201303;3878;12141;3569;11577;271;1028;2819;9034;3090;10062
220480;201303;2174;6914;2039;6715;172;597;1690;5565;1862;6162
220490;201303;2224;6881;2155;6788;143;522;1875;5885;2018;6407
220500;201303;3339;9345;2953;8724;237;904;2390;6886;2627;7790
220510;201303;2826;8121;2217;7268;126;552;1791;5809;1917;6361
220515;201303;1785;4864;1593;4618;92;278;1342;3924;1434;4202
220520;201303;4675;13841;4453;13518;265;741;3883;11972;4148;12713
220525;201303;1393;4149;1321;4044;103;369;1109;3359;1212;3728
220527;201303;1348;4499;1325;4460;126;413;1133;3851;1259;4264
220530;201303;953;3061;928;3021;152;530;710;2283;862;2813
220535;201303;848;2787;825;2750;72;299;668;2203;740;2502
220540;201303;3437;11947;3338;11766;296;1167;2707;9600;3003;10767
220545;201303;1345;4829;1303;4755;208;856;901;3242;1109;4098
220550;201303;8482;29533;8132;28854;1514;5667;5560;19818;7074;25485
220551;201303;1303;4795;1264;4720;141;600;981;3636;1122;4236
220552;201303;1539;5057;1360;4763;162;712;984;3324;1146;4036
220553;201303;1577;4792;1403;4536;63;200;1226;3994;1289;4194
220554;201303;887;2526;785;2389;138;422;534;1658;672;2080
220555;201303;2299;7038;2188;6877;112;394;1852;5921;1964;6315
220556;201303;1406;4606;1289;4383;112;488;969;3242;1081;3730
220557;201303;1567;5366;1467;5167;179;771;1059;3681;1238;4452
220558;201303;980;3172;938;3104;89;329;763;2517;852;2846
220559;201303;1508;4398;1406;4248;83;290;1210;3640;1293;3930
220560;201303;1697;4358;1452;4014;80;241;1234;3389;1314;3630
220570;201303;7215;23481;6856;23045;634;1763;5860;20341;6494;22104
220580;201303;6190;21079;6021;20869;430;1467;5287;18589;5717;20056
220585;201303;1672;6731;1642;6674;103;435;1446;5916;1549;6351
220590;201303;1355;4435;1238;4260;216;785;849;2959;1065;3744
220595;201303;2335;6997;2189;6799;100;342;1965;6134;2065;6476
220600;201303;1203;3323;1083;3179;122;358;825;2452;947;2810
220605;201303;1941;6018;1762;5736;134;457;1376;4517;1510;4974
220610;201303;2590;8678;2518;8569;193;761;2115;7168;2308;7929
220620;201303;7548;26397;7354;26093;358;1540;6528;23087;6886;24627
220630;201303;369;1190;333;1130;92;327;170;591;262;918
220635;201303;1797;6687;1674;6391;185;817;1103;4233;1288;5050
220640;201303;2622;8133;2572;8032;252;934;2042;6306;2294;7240
220650;201303;2432;6904;2218;6581;122;409;1889;5598;2011;6007
220660;201303;2483;8686;2060;8169;153;611;1849;7395;2002;8006
220665;201303;1174;4120;1133;4059;63;249;998;3590;1061;3839
220667;201303;1719;5985;1634;5860;102;426;1398;4990;1500;5416
220669;201303;1800;6123;1687;5891;225;900;1217;4238;1442;5138
220670;201303;2036;6410;1977;6342;159;422;1732;5751;1891;6173
220672;201303;1994;6030;1951;5968;254;763;1574;4873;1828;5636
220675;201303;1229;3832;1165;3721;131;395;874;2833;1005;3228
220680;201303;2187;7454;2115;7351;115;459;1858;6473;1973;6932
220690;201303;1677;4991;1549;4774;133;503;1266;3841;1399;4344
220695;201303;807;2633;784;2590;65;233;607;2017;672;2250
220700;201303;8796;26565;8129;25568;787;2733;6476;20467;7263;23200
220710;201303;731;2228;661;2126;88;283;481;1556;569;1839
220720;201303;2041;5691;1941;5545;107;246;1724;5027;1831;5273
220730;201303;1265;3751;1166;3595;74;259;956;2949;1030;3208
220735;201303;1009;2745;892;2561;101;319;657;1897;758;2216
220740;201303;1252;4328;1101;4127;79;245;956;3686;1035;3931
220750;201303;3691;11555;3580;11383;432;1342;2795;9105;3227;10447
220755;201303;1138;3507;1109;3466;63;173;996;3151;1059;3324
220760;201303;2495;9116;2330;8854;121;509;2023;7742;2144;8251
220770;201303;22296;79280;21142;77168;7246;27338;9609;36158;16855;63496
220775;201303;1024;2697;1016;2689;18;27;991;2645;1009;2672
220777;201303;1634;4843;1571;4753;135;428;1311;3948;1446;4376
220779;201303;1110;3558;1091;3525;72;289;961;3080;1033;3369
220780;201303;6104;16279;5588;15613;461;1183;4731;13480;5192;14663
220785;201303;1280;3591;1237;3500;66;196;1109;3112;1175;3308
220790;201303;8320;30266;8171;29965;713;2952;6789;24900;7502;27852
220793;201303;802;2545;764;2474;81;295;599;1934;680;2229
220795;201303;1337;4224;1299;4159;79;304;1110;3552;1189;3856
220800;201303;15946;47634;15167;46359;2093;7372;11384;34112;13477;41484
220810;201303;3067;9450;2725;8839;250;1008;2103;6721;2353;7729
220820;201303;5292;15787;4889;15266;386;1272;4087;12910;4473;14182
220830;201303;7459;21922;7212;21511;887;2622;5599;17000;6486;19622
220840;201303;13102;44869;12304;43248;3297;11930;5892;21355;9189;33285
220850;201303;2513;9733;2429;9598;383;1606;1808;7237;2191;8843
220855;201303;581;1926;540;1851;79;318;385;1305;464;1623
220860;201303;902;2653;850;2571;53;216;699;2067;752;2283
220865;201303;2590;7580;2229;7013;133;582;1809;5600;1942;6182
220870;201303;2213;7630;1942;7282;166;678;1611;6041;1777;6719
220880;201303;5194;14103;4782;13592;275;959;4167;11809;4442;12768
220885;201303;1313;4706;1173;4459;124;576;866;3300;990;3876
220887;201303;1163;3390;1069;3256;59;196;926;2836;985;3032
220890;201303;1554;5725;1415;5498;126;475;1173;4677;1299;5152
220900;201303;1780;5633;1614;5239;135;421;1296;4291;1431;4712
220910;201303;1705;5043;1540;4783;90;316;1322;4134;1412;4450
220915;201303;1022;3050;926;2895;61;263;753;2279;814;2542
220920;201303;1287;4942;1232;4862;120;547;959;3786;1079;4333
220930;201303;1337;4598;1189;4403;110;481;970;3570;1080;4051
220935;201303;1096;3515;1042;3402;107;462;769;2407;876;2869
220937;201303;1454;4195;1282;3898;84;308;1029;3080;1113;3388
220940;201303;1468;4616;1379;4421;101;377;1115;3583;1216;3960
220945;201303;462;1741;437;1657;56;244;322;1217;378;1461
220950;201303;1224;3195;919;2663;56;223;690;1922;746;2145
220955;201303;1494;4377;1278;4037;141;508;981;3070;1122;3578
220960;201303;752;2243;680;2119;80;318;505;1514;585;1832
220965;201303;1572;5029;1494;4919;80;331;1275;4193;1355;4524
220970;201303;2077;5799;1608;5038;200;630;1129;3614;1329;4244
220975;201303;460;1917;458;1912;63;230;380;1631;443;1861
220980;201303;1443;4456;1300;4195;132;508;891;2929;1023;3437
220985;201303;1317;3910;1267;3840;119;401;1009;3062;1128;3463
220987;201303;1418;4918;1351;4791;132;572;1023;3561;1155;4133
220990;201303;1766;5397;1609;5133;107;451;1289;4057;1396;4508
220995;201303;1130;3590;969;3311;81;342;785;2653;866;2995
220997;201303;2039;6593;1979;6503;167;559;1721;5657;1888;6216
221000;201303;3948;12988;3678;12503;437;1646;2749;9312;3186;10958
221005;201303;1357;4461;1297;4352;358;1142;754;2636;1112;3778
221010;201303;1213;3445;1081;3278;79;263;920;2806;999;3069
221020;201303;1872;6006;1785;5849;148;654;1391;4445;1539;5099
221030;201303;1804;5053;1594;4754;82;327;1309;3866;1391;4193
221035;201303;1422;4103;1302;3952;81;265;1134;3471;1215;3736
221037;201303;600;1919;576;1878;37;162;467;1460;504;1622
221038;201303;574;1731;484;1581;49;170;347;1144;396;1314
221039;201303;856;2751;832;2713;70;241;727;2367;797;2608
221040;201303;4984;15894;4786;15568;429;1562;3792;12409;4221;13971
221050;201303;3444;11276;3206;10918;253;1061;2691;9052;2944;10113
221060;201303;8740;24310;7656;22959;899;2742;6084;18470;6983;21212
221062;201303;1218;4453;1174;4396;39;115;1107;4184;1146;4299
221063;201303;1051;3528;1012;3468;276;899;641;2296;917;3195
221065;201303;2449;7841;2374;7698;269;919;1851;5987;2120;6906
221070;201303;4354;13727;4028;13236;305;1159;3253;10674;3558;11833
221080;201303;3012;9257;2833;9015;258;882;2288;7360;2546;8242
221090;201303;1292;3683;1168;3505;79;320;986;2890;1065;3210
221093;201303;1712;5284;1651;5174;246;907;1143;3489;1389;4396
221095;201303;924;2621;804;2454;47;127;700;2173;747;2300
221097;201303;756;2298;697;2203;65;254;536;1684;601;1938
221100;201303;117713;373899;112904;365768;25615;91828;72833;230596;98448;322424
221110;201303;9097;32675;8983;32500;731;2907;7614;27620;8345;30527
221120;201303;3906;13650;3798;13443;1168;3923;2212;8296;3380;12219
221130;201303;4441;13697;4032;12854;980;3276;2298;7244;3278;10520
221135;201303;1334;4470;1268;4354;199;763;881;3021;1080;3784
221140;201303;1355;3564;1260;3436;180;395;961;2735;1141;3130
221150;201303;1186;3183;1052;2952;42;167;855;2372;897;2539
221160;201303;887;2499;853;2445;57;197;674;1931;731;2128
221170;201303;1075;3655;1042;3586;85;347;865;2942;950;3289
230010;201303;3224;9197;2800;8508;184;633;2246;6901;2430;7534
230015;201303;3131;11020;2932;10592;593;2392;1788;6403;2381;8795
230020;201303;13475;47168;13023;46242;1519;5867;9905;35394;11424;41261
230030;201303;11634;36595;11254;35923;1260;4380;8808;28131;10068;32511
230040;201303;4393;13096;3822;12076;378;1362;2974;9352;3352;10714
230050;201303;2511;8828;2232;8154;426;1713;1245;4569;1671;6282
230060;201303;1889;5980;1724;5652;195;736;1278;4168;1473;4904
230070;201303;4556;12927;4099;12288;401;1271;3143;9647;3544;10918
230075;201303;8390;33069;8053;32383;1123;5027;5884;23858;7007;28885
230080;201303;2227;6545;1965;6164;145;550;1571;4899;1716;5449
230090;201303;3065;10152;2827;9705;395;1528;2050;6971;2445;8499
230100;201303;16135;52838;15273;51290;4716;16706;7516;25674;12232;42380
230110;201303;13468;46427;12684;44730;2551;9747;7826;27620;10377;37367
230120;201303;7280;21529;6743;20807;804;2818;5126;15763;5930;18581
230125;201303;2746;8485;2354;7735;210;835;1801;5869;2011;6704
230130;201303;6045;20381;4972;18113;505;2223;3476;12575;3981;14798
230140;201303;3168;11044;2894;10577;489;1846;1884;7074;2373;8920
230150;201303;1672;5608;1509;5276;281;1145;1004;3363;1285;4508
230160;201303;5876;18972;5262;18046;579;2243;4028;13829;4607;16072
230170;201303;6252;20919;5538;19595;576;2330;4001;14075;4577;16405
230180;201303;1840;5583;1679;5300;169;674;1188;3733;1357;4407
230185;201303;4019;14017;3756;13491;740;2718;2324;8594;3064;11312
230190;201303;12178;41293;11279;39516;2082;8312;6881;23905;8963;32217
230195;201303;4627;15104;4245;14513;389;1696;3298;10919;3687;12615
230200;201303;5340;16576;5014;15940;773;2611;3482;11077;4255;13688
230205;201303;4256;14215;3864;13540;450;1791;2808;9986;3258;11777
230210;201303;8853;26782;8074;25594;1960;6377;4711;15457;6671;21834
230220;201303;13004;40817;12219;39492;2222;8050;8156;25997;10378;34047
230230;201303;6775;24107;6168;22751;1025;4105;3846;14336;4871;18441
230240;201303;12659;39200;11690;37351;884;3514;9142;28681;10026;32195
230250;201303;10109;31743;9881;31397;589;2181;8503;27015;9092;29196
230260;201303;14434;51583;13535;49653;3271;12838;7109;26696;10380;39534
230270;201303;6831;21696;6190;20593;702;2628;4621;15468;5323;18096
230280;201303;19482;61318;18309;59427;2499;8868;13749;44657;16248;53525
230290;201303;4862;15763;4355;14744;611;2258;3006;10179;3617;12437
230300;201303;4486;14908;4334;14677;598;2236;3208;10921;3806;13157
230310;201303;4717;14655;4234;13847;413;1666;3246;10430;3659;12096
230320;201303;6954;23641;6644;23100;942;3665;4844;16919;5786;20584
230330;201303;4515;14130;4169;13441;443;1721;3123;9842;3566;11563
230340;201303;3231;11871;3090;11551;511;2233;2001;7287;2512;9520
230350;201303;17321;55738;15734;52916;3237;11694;9618;32755;12855;44449
230360;201303;2545;8245;2464;8093;265;1030;1963;6351;2228;7381
230365;201303;2753;8611;2454;8098;221;871;1820;5983;2041;6854
230370;201303;51256;178753;48372;173858;14902;55744;24763;91916;39665;147660
230380;201303;6865;20621;6009;19181;645;2431;4257;13521;4902;15952
230390;201303;3531;11663;3194;11107;447;1793;2194;7651;2641;9444
230393;201303;3223;11253;2887;10536;316;1508;2046;7247;2362;8755
230395;201303;4718;15739;4452;15207;647;2628;3095;10431;3742;13059
230400;201303;4959;16199;4433;15485;428;1918;3592;12307;4020;14225
230410;201303;15789;51710;14419;49268;2352;8808;9394;32143;11746;40951
230420;201303;23099;79794;22028;77651;5846;22466;11475;40319;17321;62785
230423;201303;4652;15902;4330;15336;550;2119;3053;10985;3603;13104
230425;201303;5028;18012;4827;17548;738;2933;3429;12470;4167;15403
230426;201303;2722;7917;2368;7294;165;665;1825;5514;1990;6179
230427;201303;1648;5320;1322;4585;179;688;887;3056;1066;3744
230428;201303;8585;29665;8416;29362;1869;7283;5391;18551;7260;25834
230430;201303;4446;15003;4268;14648;439;1831;3182;10775;3621;12606
230435;201303;4301;15447;3997;14934;1172;4691;1876;7338;3048;12029
230440;201303;344076;1113527;328447;1085064;87635;312810;170253;563487;257888;876297
230445;201303;4512;13072;3989;12342;432;1319;2964;9456;3396;10775
230450;201303;3455;11742;2991;10894;507;2013;1870;6919;2377;8932
230460;201303;1813;6346;1708;6136;184;703;1328;4844;1512;5547
230465;201303;3958;12934;3369;11819;413;1751;2262;7895;2675;9646
230470;201303;10308;40049;10029;39500;1518;6387;7162;28823;8680;35210
230480;201303;1384;4681;1280;4490;179;689;928;3253;1107;3942
230490;201303;2864;8680;2575;8158;455;1643;1471;4660;1926;6303
230495;201303;5553;19303;5082;18534;942;4050;3145;11482;4087;15532
230500;201303;10413;36553;10002;35903;894;3285;8013;29502;8907;32787
230510;201303;1442;5388;1297;5031;382;1561;598;2404;980;3965
230520;201303;4913;15546;4320;14481;506;1958;3019;10093;3525;12051
230523;201303;12604;43936;11843;42209;3855;15194;3754;13592;7609;28786
230526;201303;3848;12818;3452;12069;511;1956;2335;8312;2846;10268
230530;201303;4790;17036;4510;16639;529;2169;3526;12988;4055;15157
230533;201303;3669;11303;3482;10937;321;1186;2695;8394;3016;9580
230535;201303;5069;16002;4534;14987;541;1944;3288;10987;3829;12931
230540;201303;17734;54184;16233;51985;1319;4848;13302;42468;14621;47316
230550;201303;19877;62089;18421;59319;4465;15459;10224;33019;14689;48478
230560;201303;6450;19539;6053;18785;359;1460;4844;14887;5203;16347
230565;201303;3537;10604;3141;9859;295;1119;2278;7071;2573;8190
230570;201303;3753;10692;3421;10265;277;1026;2794;8266;3071;9292
230580;201303;9764;31682;9513;31337;576;2024;8355;27751;8931;29775
230590;201303;9220;30858;8732;29983;877;3727;6608;22276;7485;26003
230600;201303;3495;10307;2919;9124;332;1161;2002;6196;2334;7357
230610;201303;5791;20097;5483;19597;739;2927;4061;14552;4800;17479
230620;201303;1901;5710;1670;5253;179;653;1156;3609;1335;4262
230625;201303;7027;24568;6563;23491;1874;7343;2749;9760;4623;17103
230630;201303;10493;36191;9815;34753;1715;6115;6229;22629;7944;28744
230640;201303;23859;87647;23389;86681;4089;16148;16145;60440;20234;76588
230650;201303;4737;15837;4432;15235;437;1902;3380;11400;3817;13302
230655;201303;7829;31484;7622;31137;874;3553;6200;25853;7074;29406
230660;201303;6067;19970;5437;18799;631;2558;3896;13569;4527;16127
230670;201303;5709;16384;4790;14810;349;1289;3770;11537;4119;12826
230680;201303;2805;8738;2461;8127;472;1705;1471;4874;1943;6579
230690;201303;6783;22687;6322;21892;646;2771;4505;15277;5151;18048
230700;201303;8611;26499;7737;24911;911;3601;5251;16508;6162;20109
230710;201303;6880;24009;6531;23276;903;3362;4650;16906;5553;20268
230720;201303;1899;6169;1645;5680;252;926;1096;3818;1348;4744
230725;201303;3699;12643;3579;12391;557;2242;2577;8783;3134;11025
230730;201303;55038;173397;47725;162286;11844;43879;26719;92544;38563;136423
230740;201303;4759;16322;4704;16198;383;1675;3892;13196;4275;14871
230750;201303;8528;26073;7435;24247;785;3097;5549;17957;6334;21054
230760;201303;9297;30155;9094;29678;1364;5572;6606;20445;7970;26017
230763;201303;4022;13340;3858;13026;358;1614;3007;9820;3365;11434
230765;201303;41554;142048;39513;137790;13618;50266;15308;54486;28926;104752
230770;201303;21369;64533;20602;63454;1893;7403;16675;50667;18568;58070
230780;201303;5790;23837;5597;23408;1259;5350;3242;14265;4501;19615
230790;201303;2359;8648;2277;8521;294;1197;1796;6772;2090;7969
230800;201303;7639;28891;7148;27773;1739;7452;3705;14458;5444;21910
230810;201303;12041;40664;11640;39996;1456;5381;8898;30906;10354;36287
230820;201303;3150;11357;2902;10840;626;2543;1708;6513;2334;9056
230830;201303;7481;23755;6893;22711;758;2992;5004;16359;5762;19351
230835;201303;3996;11361;3491;10710;333;1104;2733;8437;3066;9541
230837;201303;3082;10936;2702;10143;420;1758;1749;6605;2169;8363
230840;201303;8927;31150;8309;30036;1521;5816;5256;19439;6777;25255
230850;201303;10999;34852;10476;34193;1324;4795;7999;26124;9323;30919
230860;201303;4937;15380;4546;14576;445;1720;3378;10657;3823;12377
230870;201303;18335;53389;16715;50583;2009;6954;12394;37202;14403;44156
230880;201303;1892;6840;1783;6621;305;1279;1164;4337;1469;5616
230890;201303;3969;15016;3728;14519;505;2340;2688;10340;3193;12680
230900;201303;2974;10268;2655;9597;436;1748;1628;5871;2064;7619
230910;201303;2853;9012;2405;8130;305;1221;1671;5547;1976;6768
230920;201303;4408;13612;4108;13223;369;1255;3308;10833;3677;12088
230930;201303;7417;23692;6901;22734;912;3247;4924;16311;5836;19558
230940;201303;7449;21620;6764;20699;320;973;6020;18669;6340;19642
230945;201303;6173;19796;5662;19076;760;2711;4076;13839;4836;16550
230950;201303;6619;19031;5875;18072;407;1451;4682;14419;5089;15870
230960;201303;11374;38367;10694;36949;2743;10444;5137;17669;7880;28113
230970;201303;12631;42715;11750;40933;2663;10607;6249;21377;8912;31984
230980;201303;2620;9220;2490;8939;671;2500;1350;4949;2021;7449
230990;201303;1519;5075;1318;4634;170;703;839;2898;1009;3601
231000;201303;2760;7795;2298;6916;256;927;1595;4684;1851;5611
231010;201303;2793;8669;2516;8247;342;1357;1789;5762;2131;7119
231020;201303;7811;26667;7423;25870;1395;5196;4753;16842;6148;22038
231025;201303;7333;24387;6756;23447;563;1989;5430;19235;5993;21224
231030;201303;7566;26166;6594;24108;1271;4932;4056;14997;5327;19929
231040;201303;2854;10037;2632;9554;325;1423;1812;6483;2137;7906
231050;201303;11309;35018;10380;33291;1122;4125;7609;24379;8731;28504
231060;201303;2336;7572;2174;7293;223;998;1642;5331;1865;6329
231070;201303;8713;29205;8330;28469;1414;5183;5620;19385;7034;24568
231080;201303;4041;13489;3823;13043;344;1593;2836;9317;3180;10910
231085;201303;4450;15014;4306;14746;686;2610;3130;10732;3816;13342
231090;201303;4140;11911;3584;10815;282;1060;2717;8062;2999;9122
231095;201303;2110;7267;1879;6811;224;888;1334;4873;1558;5761
231100;201303;2976;9572;2591;8815;268;1035;1923;6529;2191;7564
231110;201303;3631;12602;3544;12452;410;1584;2633;9296;3043;10880
231120;201303;2359;8056;2216;7807;393;1456;1474;5211;1867;6667
231123;201303;2151;6277;1912;5909;167;581;1526;4729;1693;5310
231126;201303;6482;18729;5463;17338;492;1806;4287;13477;4779;15283
231130;201303;19394;63756;18075;61418;4746;17030;9654;33791;14400;50821
231135;201303;4471;13712;3861;12760;397;1546;2837;9236;3234;10782
231140;201303;14979;50537;14345;49331;1748;7914;10362;34276;12110;42190
231150;201303;5645;17368;4865;15822;1069;3855;2484;7925;3553;11780
231160;201303;5585;20014;5447;19706;1634;6083;2973;10818;4607;16901
231170;201303;4516;15135;4284;14687;558;2295;3012;10239;3570;12534
231180;201303;13356;43872;12761;42662;2703;10027;7772;25525;10475;35552
231190;201303;4613;14001;4137;13297;414;1504;3164;10162;3578;11666
231195;201303;4626;16348;4095;15333;437;1881;3127;11833;3564;13714
231200;201303;7329;26695;6790;25685;839;3774;4966;18722;5805;22496
231210;201303;4674;15623;4113;14830;373;1586;3116;11450;3489;13036
231220;201303;13600;40756;11729;37595;1355;5191;7657;24612;9012;29803
231230;201303;9090;33883;8624;32939;1329;5501;6006;23070;7335;28571
231240;201303;11225;36955;10303;35330;1427;5511;7007;24284;8434;29795
231250;201303;2060;6188;1422;4578;268;910;602;1810;870;2720
231260;201303;3968;11522;3643;11087;485;1561;2589;8076;3074;9637
231270;201303;7263;21837;6770;21100;792;3121;4916;14956;5708;18077
231280;201303;1680;5803;1628;5711;160;577;1298;4632;1458;5209
231290;201303;31486;116411;29427;111199;8293;34214;12605;46890;20898;81104
231300;201303;4280;13225;3666;11938;398;1668;2656;8330;3054;9998
231310;201303;7099;21802;6374;20355;1465;4894;3478;11179;4943;16073
231320;201303;6962;22327;6321;21124;532;2099;4890;16324;5422;18423
231325;201303;2530;8080;2324;7725;205;732;1829;6180;2034;6912
231330;201303;13628;43874;11646;40029;2073;7336;7203;25071;9276;32407
231335;201303;4736;14364;4345;13656;383;1482;3502;10804;3885;12286
231340;201303;16882;57633;16110;56513;1577;5359;13088;47170;14665;52529
231350;201303;11726;41574;11574;41333;1362;4737;9460;34451;10822;39188
231355;201303;4279;14171;4150;13965;283;933;3558;12158;3841;13091
231360;201303;6650;23012;6337;22533;1461;5157;3968;14663;5429;19820
231370;201303;2235;6734;1857;6183;147;609;1407;4578;1554;5187
231375;201303;4014;14297;3839;13956;491;2129;2858;10250;3349;12379
231380;201303;5117;17211;4857;16836;884;3296;3353;11809;4237;15105
231390;201303;3260;10783;3131;10612;213;826;2680;9174;2893;10000
231395;201303;4136;13789;3752;13190;812;3010;2332;8375;3144;11385
231400;201303;10043;31092;9295;29789;1107;4127;6612;21197;7719;25324
231410;201303;14509;49356;13265;47627;1480;5463;9944;36749;11424;42212
240010;201303;2265;7452;2128;7147;637;2380;934;3051;1571;5431
240020;201303;11281;36692;10303;34837;2947;10721;4803;16533;7750;27254
240030;201303;2694;8196;2601;8044;278;1069;1996;6021;2274;7090
240040;201303;745;2330;663;2179;85;359;459;1434;544;1793
240050;201303;3362;9723;3074;9236;284;1061;2307;6751;2591;7812
240060;201303;1334;4238;1289;4164;147;590;967;3032;1114;3622
240070;201303;2617;7778;2518;7581;309;1087;1820;5297;2129;6384
240080;201303;2870;8050;2714;7810;197;632;2273;6549;2470;7181
240090;201303;2100;6053;1842;5537;88;368;1425;4181;1513;4549
240100;201303;9784;29846;9196;28664;1259;4688;5843;18206;7102;22894
240110;201303;4889;15259;4558;14767;988;3611;2857;8964;3845;12575
240120;201303;2862;9752;2795;9626;579;2176;1789;6236;2368;8412
240130;201303;2598;7583;2278;7067;183;706;1807;5485;1990;6191
240140;201303;2161;7023;2028;6785;478;1837;1071;3501;1549;5338
240145;201303;5975;18988;5513;18213;1381;5053;3171;10490;4552;15543
240150;201303;997;3167;867;2914;149;615;482;1576;631;2191
240160;201303;1418;4891;1353;4774;173;673;969;3424;1142;4097
240165;201303;849;2865;778;2730;94;371;531;1884;625;2255
240170;201303;2515;7922;2299;7521;616;2113;1245;4168;1861;6281
240180;201303;2797;9184;2667;8979;664;2306;1533;5385;2197;7691
240185;201303;1461;5033;1419;4970;179;664;1090;3850;1269;4514
240190;201303;831;2686;812;2658;129;507;539;1716;668;2223
240200;201303;13112;36112;11389;33947;2135;6351;7618;23626;9753;29977
240210;201303;2624;7732;2457;7506;245;890;2001;6018;2246;6908
240220;201303;7139;23248;6961;23043;249;979;6493;21464;6742;22443
240230;201303;5119;15497;4851;15000;533;1921;3691;11252;4224;13173
240240;201303;1657;5438;1350;4637;446;1636;339;1078;785;2714
240250;201303;2728;8141;2614;7959;215;815;2142;6379;2357;7194
240260;201303;14042;48908;13496;47991;2429;9866;8890;31546;11319;41412
240270;201303;2267;7809;2170;7648;277;989;1610;5784;1887;6773
240280;201303;1553;4654;1396;4367;164;612;984;3025;1148;3637
240290;201303;1410;4549;1230;4210;133;619;831;2732;964;3351
240300;201303;1927;5410;1667;4985;335;1126;972;2825;1307;3951
240310;201303;9913;29141;9234;28084;2205;7430;5106;15428;7311;22858
240320;201303;1996;6140;1732;5595;139;626;1192;3698;1331;4324
240325;201303;34116;99009;28039;88552;8267;28887;10591;33647;18858;62534
240330;201303;1501;4664;1301;4261;175;717;835;2614;1010;3331
240340;201303;1543;4826;1404;4646;307;1111;873;2878;1180;3989
240350;201303;1935;6367;1850;6213;346;1330;1329;4360;1675;5690
240360;201303;6701;21391;6028;20324;1036;3800;4078;14041;5114;17841
240370;201303;1870;5323;1693;5051;136;503;1303;3885;1439;4388
240375;201303;857;2352;775;2234;177;575;422;1174;599;1749
240380;201303;2489;7696;2202;7111;344;1157;1405;4550;1749;5707
240390;201303;876;2595;733;2309;81;325;474;1465;555;1790
240400;201303;1391;3907;1234;3686;135;506;942;2757;1077;3263
240410;201303;509;1691;456;1576;87;347;266;905;353;1252
240420;201303;4694;18220;4557;17910;1335;5285;2431;10099;3766;15384
240430;201303;3322;9962;3091;9551;399;1401;2179;6652;2578;8053
240440;201303;2523;7355;2381;7075;617;1822;1239;3817;1856;5639
240450;201303;3433;10812;3250;10502;608;2274;1935;6239;2543;8513
240460;201303;2712;9431;2648;9313;325;1316;2006;7061;2331;8377
240470;201303;3745;11629;3244;10642;898;3079;1592;5409;2490;8488
240480;201303;291;823;284;816;30;93;227;661;257;754
240485;201303;2036;6287;1822;5872;263;974;1175;3799;1438;4773
240490;201303;1568;4236;1445;4065;101;387;1151;3136;1252;3523
240500;201303;1872;6076;1835;6012;182;662;1449;4790;1631;5452
240510;201303;1685;5384;1576;5168;250;896;1071;3517;1321;4413
240520;201303;1407;4240;1249;4016;209;792;851;2674;1060;3466
240530;201303;2004;6891;1840;6605;293;1155;1232;4439;1525;5594
240540;201303;1803;5581;1725;5450;150;558;1322;4107;1472;4665
240550;201303;697;2154;677;2120;56;217;550;1694;606;1911
240560;201303;3082;9287;2962;9105;260;905;2431;7443;2691;8348
240570;201303;3004;8847;2518;7768;548;1911;1153;3311;1701;5222
240580;201303;7786;24920;7446;24391;1345;4601;5310;17402;6655;22003
240590;201303;810;2388;747;2283;59;230;536;1602;595;1832
240600;201303;1409;4374;1195;3911;222;813;655;2027;877;2840
240610;201303;4969;14220;4439;13273;472;1584;3172;9359;3644;10943
240615;201303;985;2930;871;2719;143;464;535;1683;678;2147
240620;201303;1499;5225;1441;5111;311;1177;982;3491;1293;4668
240630;201303;1967;6254;1891;6127;173;582;1480;4927;1653;5509
240640;201303;814;2584;718;2430;127;502;449;1498;576;2000
240650;201303;3629;11538;3418;11251;315;1212;2768;9060;3083;10272
240660;201303;2309;7881;2236;7768;253;987;1722;6042;1975;7029
240670;201303;2659;8204;2337;7547;398;1531;1402;4379;1800;5910
240680;201303;1403;4272;1166;3841;146;534;745;2450;891;2984
240690;201303;1058;3083;942;2898;104;382;681;2077;785;2459
240700;201303;2592;8057;2224;7357;176;772;1662;5334;1838;6106
240710;201303;16811;44526;15322;42737;2830;8030;9942;28610;12772;36640
240720;201303;5306;15928;5087;15583;1299;4447;2901;8813;4200;13260
240725;201303;1072;3233;843;2726;100;334;472;1505;572;1839
240730;201303;2231;7047;2026;6659;211;800;1437;4646;1648;5446
240740;201303;2219;6859;2040;6541;256;910;1433;4588;1689;5498
240750;201303;2082;7997;1947;7736;406;1715;1201;4846;1607;6561
240760;201303;1165;3603;1113;3523;107;322;897;2918;1004;3240
240770;201303;3356;10265;3099;9870;466;1653;2111;6748;2577;8401
240780;201303;5187;16033;4491;14847;997;3411;2454;8495;3451;11906
240790;201303;817;2715;698;2496;69;285;520;1851;589;2136
240800;201303;37772;113662;35330;109305;10483;34877;16008;50111;26491;84988
240810;201303;90523;281044;86042;272590;29318;96607;38937;125719;68255;222326
240820;201303;6524;20156;5753;18901;914;3363;3533;11928;4447;15291
240830;201303;8715;27940;8381;27420;847;2884;6747;22505;7594;25389
240840;201303;1229;3571;1092;3321;100;376;707;2124;807;2500
240850;201303;1091;3502;851;2995;176;705;429;1438;605;2143
240860;201303;1274;3717;1118;3473;97;366;823;2502;920;2868
240870;201303;1090;3165;977;2959;131;521;677;1919;808;2440
240880;201303;1038;3753;1011;3705;153;668;687;2511;840;3179
240890;201303;5263;15290;4809;14554;797;2764;2944;8813;3741;11577
240895;201303;2637;9305;2445;8962;375;1501;1717;6349;2092;7850
240910;201303;2435;8212;2319;7996;263;1090;1771;6063;2034;7153
240920;201303;813;2716;765;2596;186;724;420;1382;606;2106
240930;201303;3443;9708;3171;9327;313;1007;2504;7405;2817;8412
240933;201303;1313;4302;1216;4137;361;1236;579;2160;940;3396
240940;201303;6326;18565;5518;17193;1146;3867;3141;9759;4287;13626
240950;201303;1099;3576;1047;3489;101;422;769;2574;870;2996
240960;201303;710;2408;659;2295;108;408;462;1603;570;2011
240970;201303;1924;5761;1721;5365;149;616;1230;3779;1379;4395
240980;201303;3297;11100;3099;10715;755;2806;1785;6197;2540;9003
240990;201303;2970;9179;2816;8860;641;2263;1734;5300;2375;7563
241000;201303;1017;2996;909;2807;101;393;656;1979;757;2372
241010;201303;2818;9927;2565;9467;460;1911;1675;6111;2135;8022
241020;201303;2012;5852;1728;5321;174;664;1109;3244;1283;3908
241025;201303;1439;4577;1367;4457;164;685;966;3084;1130;3769
241030;201303;2400;8170;2225;7871;180;700;1800;6414;1980;7114
241040;201303;1978;7147;1847;6890;215;943;1400;5184;1615;6127
241050;201303;1245;3872;1154;3719;124;510;865;2695;989;3205
241060;201303;977;2875;900;2753;132;421;665;2051;797;2472
241070;201303;908;2710;791;2483;101;405;558;1678;659;2083
241080;201303;1129;3523;1028;3348;90;382;747;2370;837;2752
241090;201303;1905;5833;1730;5553;135;573;1442;4536;1577;5109
241100;201303;1137;3529;1051;3335;108;409;736;2302;844;2711
241105;201303;1053;3297;1000;3197;128;465;701;2269;829;2734
241110;201303;832;2758;722;2527;153;570;378;1328;531;1898
241120;201303;7913;24019;7275;23026;1389;4501;4997;16133;6386;20634
241140;201303;3147;9488;2884;8954;375;1384;1964;5920;2339;7304
241142;201303;683;2139;522;1789;165;638;181;589;346;1227
241150;201303;5362;17021;5093;16581;731;2591;3672;11986;4403;14577
241160;201303;1027;3166;999;3122;137;448;744;2361;881;2809
241170;201303;1273;3937;1178;3756;174;653;743;2475;917;3128
241180;201303;943;2608;781;2372;103;395;533;1555;636;1950
241190;201303;1008;2878;934;2754;99;381;631;1755;730;2136
241200;201303;19135;60265;18072;58483;4943;17187;9484;31248;14427;48435
241210;201303;1433;4420;1265;4090;250;905;719;2316;969;3221
241220;201303;7822;27122;7507;26508;1832;6940;4213;15217;6045;22157
241230;201303;2860;9261;2662;8972;263;1069;2114;7088;2377;8157
241240;201303;1080;3212;869;2793;124;435;518;1674;642;2109
241250;201303;5879;19065;5351;18052;543;2290;4141;13803;4684;16093
241255;201303;1857;7261;1791;7122;403;1679;991;4094;1394;5773
241260;201303;4047;12247;3469;11199;681;2206;2062;6804;2743;9010
241270;201303;1937;6067;1759;5733;306;1152;1026;3394;1332;4546
241280;201303;2066;6181;1942;5932;387;1241;1194;3705;1581;4946
241290;201303;3137;8962;2580;8087;472;1641;1528;4746;2000;6387
241300;201303;1254;3902;1199;3822;113;424;954;3038;1067;3462
241310;201303;1457;4835;1417;4761;203;680;1057;3646;1260;4326
241320;201303;787;2739;766;2698;162;606;470;1681;632;2287
241330;201303;1399;4678;1330;4583;162;653;1051;3592;1213;4245
241335;201303;2342;7681;2299;7605;213;688;1934;6464;2147;7152
241340;201303;1802;5918;1680;5675;467;1731;854;2823;1321;4554
241350;201303;1853;6143;1767;5969;193;820;1346;4425;1539;5245
241355;201303;1192;3384;1124;3277;23;104;1066;3073;1089;3177
241360;201303;1986;5776;1849;5494;186;728;1371;3893;1557;4621
241370;201303;1304;4168;1090;3721;183;762;686;2263;869;3025
241380;201303;693;2088;607;1912;87;354;333;1012;420;1366
241390;201303;2708;9520;2588;9287;670;2378;1521;5729;2191;8107
241400;201303;3347;10695;3226;10513;484;1774;2357;7634;2841;9408
241410;201303;2550;7807;2377;7551;439;1546;1619;5079;2058;6625
241415;201303;1510;4879;1406;4661;164;639;990;3225;1154;3864
241420;201303;1798;6864;1677;6665;564;2416;786;3119;1350;5535
241430;201303;409;1272;393;1225;63;239;263;774;326;1013
241440;201303;6290;23064;5962;22470;1057;4191;4131;15745;5188;19936
241445;201303;985;3219;946;3159;163;467;704;2497;867;2964
241450;201303;3043;9014;2923;8802;500;1700;2061;6114;2561;7814
241460;201303;3221;9928;2891;9259;280;1091;2107;6659;2387;7750
241470;201303;1315;3872;1180;3706;117;447;940;2909;1057;3356
241475;201303;1155;3910;1072;3768;101;459;793;2741;894;3200
241480;201303;3131;10409;2900;10055;946;3363;1146;4338;2092;7701
241490;201303;591;1666;496;1506;58;236;342;973;400;1209
241500;201303;730;2428;717;2409;22;86;669;2242;691;2328
250010;201303;2561;8516;2302;8077;285;1208;1608;5510;1893;6718
250020;201303;1636;4873;1297;4243;128;549;911;2897;1039;3446
250030;201303;7402;22217;6702;21216;851;2955;4951;15953;5802;18908
250040;201303;4306;15081;4032;14561;796;3054;2610;9502;3406;12556
250050;201303;3501;11460;3250;11102;542;2062;2212;7589;2754;9651
250053;201303;1234;3895;1191;3837;175;641;847;2725;1022;3366
250057;201303;778;2521;758;2494;75;269;610;2031;685;2300
250060;201303;4499;15183;4382;14988;617;2484;3327;11130;3944;13614
250070;201303;4127;13081;3901;12679;494;2032;2975;9328;3469;11360
250073;201303;752;2328;695;2221;95;339;489;1572;584;1911
250077;201303;2177;6547;1852;6012;281;988;1119;3660;1400;4648
250080;201303;4497;13800;4354;13591;584;1986;3311;10386;3895;12372
250090;201303;2533;7871;2472;7782;158;654;2088;6402;2246;7056
250100;201303;3838;13337;3689;13070;440;1765;2834;10009;3274;11774
250110;201303;5590;17657;5360;17326;907;3228;3906;12575;4813;15803
250115;201303;555;1852;486;1694;65;291;283;922;348;1213
250120;201303;2025;6372;1779;5919;245;961;1221;3990;1466;4951
250130;201303;5430;17527;5162;17147;393;1457;4337;14534;4730;15991
250135;201303;1023;3278;946;3143;106;370;693;2363;799;2733
250140;201303;1932;6603;1787;6413;252;888;1345;4980;1597;5868
250150;201303;5018;17470;4748;16993;597;2392;3569;12776;4166;15168
250153;201303;1556;4137;1414;3935;132;446;1131;3137;1263;3583
250157;201303;1543;5584;1411;5290;354;1345;761;2961;1115;4306
250160;201303;3211;10388;3088;10195;223;830;2646;8730;2869;9560
250170;201303;1560;4668;1471;4520;318;1032;910;2832;1228;3864
250180;201303;15317;50550;14982;49902;3099;11407;9634;31599;12733;43006
250190;201303;4185;12729;3977;12375;690;2385;2610;8087;3300;10472
250200;201303;2134;5980;1756;5510;146;523;1511;4704;1657;5227
250205;201303;989;3355;868;3139;102;456;592;2137;694;2593
250210;201303;1601;5394;1491;5237;199;881;1083;3709;1282;4590
250215;201303;1357;4808;1320;4737;231;940;832;2988;1063;3928
250220;201303;777;2367;667;2234;51;184;580;1945;631;2129
250230;201303;1657;4373;1367;3902;165;597;1045;2859;1210;3456
250240;201303;2545;8512;2280;8124;279;1057;1699;6155;1978;7212
250250;201303;3966;12875;3691;12481;544;1891;2741;9459;3285;11350
250260;201303;1879;5944;1681;5613;140;531;1292;4324;1432;4855
250270;201303;1178;3927;1117;3852;161;594;833;2886;994;3480
250280;201303;3589;11233;3351;10852;683;2303;2148;7244;2831;9547
250290;201303;2087;5602;1737;5140;70;255;1506;4442;1576;4697
250300;201303;5283;16038;4995;15662;684;2704;3841;11626;4525;14330
250310;201303;1118;3700;1031;3555;167;674;739;2520;906;3194
250320;201303;7412;24394;7073;23649;1397;5205;4364;14233;5761;19438
250330;201303;2425;7917;2132;7500;307;1216;1567;5467;1874;6683
250340;201303;1070;3272;1038;3235;83;290;838;2656;921;2946
250350;201303;4457;12484;4129;12064;199;707;3602;10608;3801;11315
250355;201303;2060;6574;1895;6317;147;620;1484;4930;1631;5550
250360;201303;1988;6061;1850;5853;121;464;1444;4578;1565;5042
250370;201303;13012;37966;11533;36139;806;2535;10015;31735;10821;34270
250375;201303;1045;3408;1008;3339;83;336;825;2722;908;3058
250380;201303;1562;4565;1497;4488;90;332;1317;3920;1407;4252
250390;201303;1919;5272;1600;4730;216;719;1079;3175;1295;3894
250400;201303;55081;169117;52583;165207;14932;48119;28127;91610;43059;139729
250403;201303;1243;4729;1219;4690;217;938;879;3359;1096;4297
250407;201303;1033;3215;944;3063;111;372;734;2394;845;2766
250410;201303;649;2145;573;2013;73;317;422;1461;495;1778
250415;201303;1751;5736;1649;5529;113;481;1268;4180;1381;4661
250420;201303;1253;4088;1201;3991;103;432;1008;3272;1111;3704
250430;201303;6390;18285;6078;17834;513;1855;5031;14444;5544;16299
250435;201303;1561;4892;1408;4587;201;759;828;2778;1029;3537
250440;201303;4217;13382;4109;13211;341;1220;3417;11035;3758;12255
250450;201303;2029;5846;1826;5572;76;270;1631;4970;1707;5240
250460;201303;5329;17587;5044;17165;891;3179;3466;11999;4357;15178
250470;201303;1541;4312;1413;4128;125;465;1105;3174;1230;3639
250480;201303;3648;11386;3301;10869;201;817;2825;9233;3026;10050
250485;201303;572;1581;481;1414;28;123;375;1047;403;1170
250490;201303;4023;13492;3926;13338;588;2234;2947;9981;3535;12215
250500;201303;1859;5813;1730;5605;379;1259;1006;3309;1385;4568
250510;201303;4886;14085;4338;13327;379;1423;3560;10820;3939;12243
250520;201303;1811;5843;1736;5713;383;1480;1081;3467;1464;4947
250523;201303;1762;5741;1685;5640;208;760;1331;4491;1539;5251
250527;201303;1358;4386;1284;4276;67;311;1129;3696;1196;4007
250530;201303;669;2094;594;1996;55;218;478;1597;533;1815
250535;201303;1202;4061;1175;4005;107;450;935;3134;1042;3584
250540;201303;2400;7317;2266;7165;99;339;2060;6541;2159;6880
250550;201303;893;3029;828;2925;82;354;614;2129;696;2483
250560;201303;1674;5615;1654;5584;141;551;1402;4723;1543;5274
250570;201303;2428;8415;2275;8127;251;1030;1758;6225;2009;7255
250580;201303;1031;3110;890;2875;124;481;598;1868;722;2349
250590;201303;1024;3198;924;3062;85;360;728;2363;813;2723
250600;201303;7444;23122;7085;22558;1209;3904;4998;16338;6207;20242
250610;201303;3227;10139;3067;9890;410;1429;2243;7279;2653;8708
250620;201303;863;2559;801;2437;142;470;533;1611;675;2081
250625;201303;1995;6916;1961;6866;97;324;1786;6318;1883;6642
250630;201303;9563;32257;9126;31429;2124;8082;5247;17892;7371;25974
250640;201303;3817;11426;3575;11137;262;1019;3083;9476;3345;10495
250650;201303;888;2702;840;2606;173;633;437;1400;610;2033
250660;201303;2138;5203;1634;4593;24;69;1567;4403;1591;4472
250670;201303;2470;8847;2370;8661;296;1272;1678;6148;1974;7420
250680;201303;4614;14036;4385;13691;328;1237;3640;11303;3968;12540
250690;201303;5867;17059;5695;16814;625;2199;4680;13518;5305;15717
250700;201303;5080;16026;4837;15641;633;2374;3603;11473;4236;13847
250710;201303;4323;14366;4036;14001;605;2253;2911;10265;3516;12518
250720;201303;2494;8235;2385;8038;243;933;1847;6255;2090;7188
250730;201303;3422;11250;3297;11051;472;1784;2442;8152;2914;9936
250740;201303;1997;6120;1769;5702;305;1092;1148;3642;1453;4734
250750;201303;95765;298069;91856;291886;18553;65010;60435;189936;78988;254946
250760;201303;2027;6500;1903;6283;312;1201;1233;4038;1545;5239
250770;201303;3641;12970;3502;12763;805;3054;2140;7970;2945;11024
250780;201303;1867;5761;1669;5393;184;748;1174;3695;1358;4443
250790;201303;2405;8003;2279;7810;583;1996;1422;4989;2005;6985
250800;201303;2632;8066;2350;7573;174;690;1785;5635;1959;6325
250810;201303;1304;3979;1144;3744;110;464;941;3010;1051;3474
250820;201303;1898;6192;1847;6111;109;408;1541;5192;1650;5600
250830;201303;5599;19576;5405;19190;897;3727;3736;13083;4633;16810
250840;201303;1017;3348;929;3167;156;600;577;1976;733;2576
250850;201303;2284;6903;2019;6468;253;975;1309;4376;1562;5351
250855;201303;947;2927;895;2844;79;280;752;2381;831;2661
250860;201303;2753;9623;2600;9331;665;2657;1187;4279;1852;6936
250870;201303;1164;3463;1019;3217;97;383;734;2250;831;2633
250880;201303;1246;3865;1230;3841;118;415;999;3085;1117;3500
250890;201303;8585;29458;8072;28768;1655;6541;5337;19015;6992;25556
250900;201303;2990;10307;2708;9763;335;1293;1912;7007;2247;8300
250905;201303;2065;6548;1985;6438;307;1091;1500;4842;1807;5933
250910;201303;5047;15617;4745;15146;721;2370;3448;11174;4169;13544
250915;201303;1692;5166;1559;4969;131;423;1312;4229;1443;4652
250920;201303;3404;10109;3221;9854;408;1322;2428;7565;2836;8887
250930;201303;1832;6180;1769;6069;377;1494;1155;3864;1532;5358
250933;201303;1112;3890;1076;3827;196;739;707;2588;903;3327
250937;201303;854;2742;776;2580;130;516;468;1553;598;2069
250939;201303;1678;5462;1543;5243;314;1117;1026;3518;1340;4635
250940;201303;3855;11794;3595;11397;285;1034;2929;9315;3214;10349
250950;201303;1253;4097;1177;4003;78;262;996;3454;1074;3716
250960;201303;1336;4268;1190;4077;79;315;1012;3488;1091;3803
250970;201303;8381;23855;7698;22984;979;2965;5886;17875;6865;20840
250980;201303;2571;8135;2409;7873;355;1425;1641;5179;1996;6604
250990;201303;2059;7486;1966;7301;335;1410;1362;5014;1697;6424
251000;201303;2489;7253;2066;6661;139;538;1644;5278;1783;5816
251010;201303;2739;8163;2518;7862;185;688;2055;6440;2240;7128
251020;201303;1644;5317;1545;5200;176;651;1255;4258;1431;4909
251030;201303;1281;3696;1172;3512;139;493;750;2245;889;2738
251040;201303;1930;6375;1756;6104;225;1024;1282;4316;1507;5340
251050;201303;1113;3397;981;3153;186;661;548;1829;734;2490
251060;201303;948;2509;787;2308;127;454;547;1533;674;1987
251065;201303;562;1736;494;1631;75;288;298;948;373;1236
251070;201303;551;1649;527;1614;47;194;416;1207;463;1401
251080;201303;20610;58677;19661;57166;5055;15555;11572;34034;16627;49589
251090;201303;2973;9611;2707;9134;337;1309;1934;6448;2271;7757
251100;201303;938;3182;832;2985;124;514;530;1851;654;2365
251110;201303;2073;6144;1920;5928;238;833;1407;4354;1645;5187
251120;201303;5852;20046;5702;19789;819;3379;4444;15069;5263;18448
251130;201303;3761;10001;3424;9610;69;248;3269;9122;3338;9370
251140;201303;4284;13514;4051;13153;295;1185;3202;10351;3497;11536
251150;201303;2821;9319;2612;9035;319;1284;1982;6916;2301;8200
251160;201303;1847;6191;1778;6099;101;396;1559;5371;1660;5767
251170;201303;1414;4571;1383;4538;94;327;1224;4033;1318;4360
251180;201303;2871;8814;2652;8542;562;1898;1690;5591;2252;7489
251190;201303;4056;12381;3947;12238;309;1074;3424;10610;3733;11684
251200;201303;4071;12704;3883;12454;299;1074;3273;10515;3572;11589
251203;201303;1303;4250;1184;3999;127;538;714;2506;841;3044
251207;201303;1207;3931;1056;3630;105;440;747;2532;852;2972
251210;201303;7370;22622;6853;21997;903;2887;5424;17735;6327;20622
251220;201303;1240;3497;1119;3309;183;594;696;2115;879;2709
251230;201303;5041;15802;4476;15126;480;1807;3726;12542;4206;14349
251240;201303;3001;10176;2931;10059;340;1438;2277;7653;2617;9091
251250;201303;9702;30534;9162;29650;1733;6167;6247;19972;7980;26139
251260;201303;519;1657;473;1594;43;163;360;1222;403;1385
251270;201303;3943;12472;3729;12195;183;720;3389;11053;3572;11773
251272;201303;1301;4154;1216;4029;130;470;935;3148;1065;3618
251274;201303;923;3073;886;2997;127;544;487;1693;614;2237
251275;201303;1335;3914;1264;3801;159;594;942;2760;1101;3354
251276;201303;1378;4291;1318;4177;247;848;763;2540;1010;3388
251278;201303;582;1914;514;1753;88;344;285;1018;373;1362
251280;201303;2199;7248;2131;7122;319;1173;1523;5111;1842;6284
251290;201303;5880;17286;5592;16912;858;3116;4017;11751;4875;14867
251300;201303;745;2635;704;2571;83;396;500;1757;583;2153
251310;201303;3097;9446;2863;9101;251;934;2294;7224;2545;8158
251315;201303;1535;5788;1504;5723;328;1303;949;3699;1277;5002
251320;201303;2077;6001;1792;5552;143;515;1378;4334;1521;4849
251330;201303;2004;5317;1673;4886;149;631;1362;3771;1511;4402
251335;201303;942;3325;923;3290;103;432;745;2617;848;3049
251340;201303;3914;11151;3364;10335;410;1568;2381;7156;2791;8724
251350;201303;1609;5081;1460;4863;272;996;935;3145;1207;4141
251360;201303;1809;6042;1750;5963;129;507;1477;5055;1606;5562
251365;201303;904;2707;740;2360;84;345;479;1473;563;1818
251370;201303;20447;73318;20200;72837;4387;17287;13603;48566;17990;65853
251380;201303;1233;4038;1135;3871;156;618;805;2690;961;3308
251385;201303;836;2431;776;2328;87;322;544;1595;631;1917
251390;201303;5531;20146;5289;19788;1030;4206;3605;13382;4635;17588
251392;201303;988;3051;919;2930;153;542;577;1864;730;2406
251394;201303;614;1933;528;1765;50;212;372;1229;422;1441
251396;201303;867;2523;820;2451;57;188;681;2029;738;2217
251398;201303;1119;3303;937;2963;114;439;639;1991;753;2430
251400;201303;1329;3955;1248;3848;178;700;887;2653;1065;3353
251410;201303;1551;4257;1424;4051;196;619;948;2779;1144;3398
251420;201303;2193;6564;1906;6243;178;707;1550;5010;1728;5717
251430;201303;1655;6083;1511;5856;136;623;1221;4714;1357;5337
251440;201303;1436;4529;1257;4205;186;713;888;2943;1074;3656
251445;201303;1453;4772;1390;4676;152;609;1118;3699;1270;4308
251450;201303;4700;15029;4259;14477;165;663;3877;13209;4042;13872
251455;201303;1188;3769;1039;3538;95;416;787;2633;882;3049
251460;201303;869;2727;848;2685;162;529;619;1984;781;2513
251465;201303;512;1646;471;1562;57;236;316;1022;373;1258
251470;201303;1191;3572;1005;3236;159;606;614;1966;773;2572
251480;201303;1084;3071;993;2921;74;282;791;2287;865;2569
251490;201303;2033;6196;1796;5887;356;1329;1124;3621;1480;4950
251500;201303;1599;5705;1552;5626;241;1010;1135;4058;1376;5068
251510;201303;2386;8393;2303;8208;529;2045;1375;4941;1904;6986
251520;201303;1069;3015;987;2887;137;431;622;1846;759;2277
251530;201303;10438;33657;10235;33348;1122;4203;8357;26911;9479;31114
251540;201303;2707;9283;2559;8953;313;1312;1843;6418;2156;7730
251550;201303;3906;10048;3355;9351;219;790;2802;7657;3021;8447
251560;201303;919;2854;847;2748;176;682;507;1569;683;2251
251570;201303;1012;3116;930;2976;136;522;593;1945;729;2467
251580;201303;2143;6040;2002;5853;172;501;1681;4954;1853;5455
251590;201303;1695;5717;1664;5681;116;426;1457;5022;1573;5448
251593;201303;965;3183;921;3108;135;520;617;2027;752;2547
251597;201303;1931;6107;1871;6011;246;933;1431;4512;1677;5445
251600;201303;6930;21648;6643;21179;1128;3652;4593;15164;5721;18816
251610;201303;3472;10773;3214;10427;398;1412;2393;7835;2791;9247
251615;201303;1188;3584;1056;3346;117;365;743;2494;860;2859
251620;201303;16036;48340;14794;46623;2338;7873;10651;33804;12989;41677
251630;201303;5177;13486;4556;12735;408;1253;3620;10189;4028;11442
251640;201303;2629;7862;2157;7003;284;1080;1443;4635;1727;5715
251650;201303;4261;12401;3851;11875;369;1315;3089;9618;3458;10933
251660;201303;3494;11930;3219;11502;281;1333;2590;9027;2871;10360
251670;201303;3561;11065;3218;10529;278;1055;2541;8259;2819;9314
251675;201303;728;2534;699;2484;136;568;445;1535;581;2103
251680;201303;2801;7962;2288;7191;154;659;1861;5722;2015;6381
251690;201303;3210;10720;3023;10387;464;1716;2028;7036;2492;8752
251700;201303;2034;7038;1957;6929;258;995;1514;5359;1772;6354
251710;201303;842;2392;674;2067;99;390;385;1082;484;1472
251720;201303;1310;4183;1240;4077;121;486;950;3101;1071;3587
251740;201303;724;2069;588;1821;105;370;336;1047;441;1417
260005;201303;23623;59847;21263;56798;4297;11775;13811;37339;18108;49114
260010;201303;9141;25783;7599;23886;681;2426;6168;19317;6849;21743
260020;201303;5443;17023;4927;16235;654;1969;3581;12500;4235;14469
260030;201303;5348;16648;5009;16202;530;1834;4024;13072;4554;14906
260040;201303;9039;23622;8313;22826;494;1129;7397;20855;7891;21984
260050;201303;10224;34412;9711;33824;669;2547;8496;29764;9165;32311
260060;201303;3988;11336;3754;10995;330;1033;3073;9098;3403;10131
260070;201303;8842;28026;8551;27608;2324;8042;5036;16374;7360;24416
260080;201303;5054;15497;4573;14753;560;2179;3211;10203;3771;12382
260090;201303;5067;13968;4828;13653;739;1919;3760;10981;4499;12900
260100;201303;3358;9252;3113;8928;289;1061;2445;7023;2734;8084
260105;201303;4044;12916;3947;12747;700;2456;2784;8970;3484;11426
260110;201303;20470;63644;19214;62111;1641;5300;16308;53367;17949;58667
260120;201303;10855;34759;10611;34324;2997;9894;5709;19171;8706;29065
260130;201303;2969;8844;2846;8641;392;1169;2100;6531;2492;7700
260140;201303;11231;32745;10389;31593;1372;4646;7849;24014;9221;28660
260150;201303;2694;8883;2451;8492;176;730;1959;6890;2135;7620
260160;201303;5768;17894;5333;17395;516;1761;4391;14643;4907;16404
260170;201303;16801;48077;16179;47234;1464;4060;13402;39830;14866;43890
260180;201303;3300;10727;3065;10351;225;925;2563;8604;2788;9529
260190;201303;15197;38155;14545;37309;1272;3489;12091;31043;13363;34532
260200;201303;10460;32515;9303;30748;1220;4255;6601;22452;7821;26707
260210;201303;11058;35331;10374;34363;831;3111;8569;28684;9400;31795
260220;201303;8856;28806;8698;28566;746;3062;7445;24054;8191;27116
260230;201303;9409;28556;9096;28128;720;2370;7572;23718;8292;26088
260240;201303;2753;9075;2497;8674;383;1435;1680;5859;2063;7294
260250;201303;2718;7533;2517;7282;188;517;2128;6264;2316;6781
260260;201303;10945;33251;10777;33034;938;3079;9032;28364;9970;31443
260270;201303;3457;11053;3295;10826;433;1714;2540;8204;2973;9918
260280;201303;11858;41993;11064;40725;905;3696;9071;33803;9976;37499
260290;201303;32667;101283;31812;99929;5898;21125;22060;67805;27958;88930
260300;201303;8134;25695;7381;24638;821;3007;5665;19145;6486;22152
260310;201303;5010;15552;4729;15103;1369;4136;2515;8603;3884;12739
260320;201303;6287;22565;5928;22053;560;2160;4760;18062;5320;20222
260330;201303;3054;9845;2810;9419;324;1258;1873;6555;2197;7813
260340;201303;1782;5518;1711;5429;113;419;1503;4735;1616;5154
260345;201303;24687;84345;23929;82849;7745;29025;11167;37707;18912;66732
260350;201303;4101;12684;3952;12455;638;2171;2696;8583;3334;10754
260360;201303;2258;7424;2202;7332;596;2087;1265;4358;1861;6445
260370;201303;5885;18755;5512;18094;862;2877;3845;12957;4707;15834
260380;201303;4773;16274;4506;15928;413;1290;3811;13811;4224;15101
260390;201303;4674;15108;4112;14245;506;1989;3055;10468;3561;12457
260392;201303;2776;10400;2668;10233;212;833;2283;8872;2495;9705
260400;201303;12930;39823;12575;39274;2223;7926;8938;27330;11161;35256
260410;201303;59222;180622;57010;177021;17283;53836;30298;97687;47581;151523
260415;201303;3889;13252;3526;12579;568;2360;2272;8113;2840;10473
260420;201303;10711;27198;9893;26322;1011;2947;7858;21020;8869;23967
260430;201303;2651;9076;2460;8782;278;1194;1912;6716;2190;7910
260440;201303;3313;10521;3123;10159;532;1970;1981;6370;2513;8340
260450;201303;4711;15324;4490;14940;560;2014;3362;11290;3922;13304
260460;201303;5684;18348;5472;18046;776;2907;4095;13334;4871;16241
260470;201303;4831;14631;4582;14288;421;1469;3675;11629;4096;13098
260480;201303;3657;11068;3406;10711;654;2205;2346;7349;3000;9554
260490;201303;5976;15988;5315;14949;765;2527;3488;9841;4253;12368
260500;201303;6505;18440;6129;17912;630;2019;4735;14089;5365;16108
260510;201303;9608;27759;8900;26768;1087;3520;6542;20462;7629;23982
260515;201303;4691;15163;3929;13617;587;2221;2368;8443;2955;10664
260520;201303;14707;41797;14497;41521;2177;5907;11375;33184;13552;39091
260530;201303;9964;30149;8914;28768;542;1699;7783;25556;8325;27255
260540;201303;5479;15118;5307;14919;665;1646;4239;12315;4904;13961
260545;201303;40;156;28;115;4;19;6;23;10;42
260550;201303;2669;9306;2444;8923;731;2938;1180;4259;1911;7197
260560;201303;6413;16998;5858;16223;345;951;5158;14348;5503;15299
260570;201303;5748;21603;5520;21176;1112;4621;3665;14202;4777;18823
260580;201303;3815;10802;3661;10570;310;1050;3062;8663;3372;9713
260590;201303;5886;15860;5750;15690;497;1266;4887;13661;5384;14927
260600;201303;22816;75732;22025;74367;5823;20138;12192;42721;18015;62859
260610;201303;6902;20969;6623;20601;1330;4240;4602;14582;5932;18822
260620;201303;16570;53328;16076;52515;2895;10979;11158;35369;14053;46348
260630;201303;2211;6901;1950;6487;254;1023;1427;4684;1681;5707
260640;201303;16612;47022;15988;46107;1814;5515;12616;36536;14430;42051
260650;201303;5541;18171;5363;17882;876;2930;3508;12562;4384;15492
260660;201303;7560;23268;6885;22356;643;2236;5562;18321;6205;20557
260670;201303;2269;6814;1964;6400;309;1139;1297;4262;1606;5401
260680;201303;22513;61696;21572;60277;4454;13203;13710;38234;18164;51437
260690;201303;3353;9750;2966;9143;339;1219;2224;6794;2563;8013
260700;201303;4793;15551;4742;15497;115;282;4532;15032;4647;15314
260710;201303;1282;4083;1165;3908;153;610;862;2840;1015;3450
260720;201303;17195;57251;16396;55761;4789;16790;8693;30236;13482;47026
260730;201303;7249;24612;6580;23645;904;3386;4924;17979;5828;21365
260740;201303;1317;4112;1163;3833;212;800;691;2284;903;3084
260750;201303;6388;21969;6277;21782;528;1885;5303;18665;5831;20550
260760;201303;4317;12903;4113;12622;534;1799;3074;9401;3608;11200
260765;201303;7379;28372;7170;28044;1816;7423;4269;17202;6085;24625
260770;201303;4140;11197;3814;10761;250;933;3081;8505;3331;9438
260775;201303;5223;15762;5019;15448;566;2060;3824;11571;4390;13631
260780;201303;3804;13272;3692;13081;774;3076;2342;8248;3116;11324
260790;201303;114565;303403;110931;298222;26866;75816;67744;183010;94610;258826
260795;201303;2900;9889;2764;9679;435;1641;1956;6985;2391;8626
260800;201303;4465;12788;4203;12418;271;1064;3568;10300;3839;11364
260805;201303;3879;11969;3569;11475;592;1989;2427;7924;3019;9913
260810;201303;7310;22021;7129;21763;525;1941;6160;18604;6685;20545
260820;201303;4483;13697;4315;13450;1205;3859;2510;7934;3715;11793
260825;201303;2959;9795;2830;9606;275;920;2351;8097;2626;9017
260830;201303;3561;11952;3350;11586;884;2900;1972;7197;2856;10097
260840;201303;4017;12192;3796;11862;240;915;3322;10342;3562;11257
260845;201303;3964;12211;3703;11681;595;2039;2552;8070;3147;10109
260850;201303;4764;17260;4403;16472;1221;4982;2139;8031;3360;13013
260860;201303;2844;9816;2682;9559;346;1249;2009;7316;2355;8565
260870;201303;4108;11865;3809;11499;510;1408;2936;9184;3446;10592
260875;201303;7033;18905;6548;18170;692;1922;4892;14021;5584;15943
260880;201303;7565;25948;7254;25473;1076;3792;5470;19565;6546;23357
260890;201303;14495;42625;13987;41873;1647;5622;10580;31669;12227;37291
260900;201303;5882;18684;5164;17513;1073;3797;3106;10784;4179;14581
260910;201303;2798;9034;2592;8740;293;1109;2027;6815;2320;7924
260915;201303;4247;14639;4156;14510;117;366;3872;13761;3989;14127
260920;201303;3241;10506;3106;10302;608;2217;2046;6890;2654;9107
260930;201303;3980;13082;3623;12568;513;1857;2623;9200;3136;11057
260940;201303;13010;39450;12028;37685;2544;9309;6491;19954;9035;29263
260950;201303;6105;20423;5903;20033;1089;4566;3910;12490;4999;17056
260960;201303;65169;186287;62206;181696;13391;41822;37842;111502;51233;153324
260970;201303;5191;17584;4878;17077;655;2649;3560;12418;4215;15067
260980;201303;3876;12639;3733;12441;263;962;3125;10608;3388;11570
260990;201303;16443;54862;15318;53260;1829;5961;11601;42427;13430;48388
261000;201303;13347;41541;12121;39488;2940;10373;6783;22278;9723;32651
261010;201303;2641;7634;2504;7445;237;560;2099;6527;2336;7087
261020;201303;5935;18644;5642;18184;372;1618;4748;14906;5120;16524
261030;201303;3011;10870;2934;10753;360;1446;2300;8408;2660;9854
261040;201303;5035;17101;4416;16128;664;2703;3064;11170;3728;13873
261050;201303;8282;24073;7882;23504;553;1781;6683;19926;7236;21707
261060;201303;10150;33430;9921;33060;2063;7510;6651;21817;8714;29327
261070;201303;44989;122279;41635;117699;10120;30174;24053;68969;34173;99143
261080;201303;5457;17586;5220;17199;431;1396;4360;14641;4791;16037
261090;201303;15421;45263;14650;44226;1375;4509;12081;36618;13456;41127
261100;201303;6970;23114;6648;22661;502;2108;5558;18811;6060;20919
261110;201303;62655;185038;58384;179159;13997;43583;34431;111753;48428;155336
261120;201303;3147;9413;3025;9246;87;279;2803;8616;2890;8895
261130;201303;6593;18058;6376;17830;270;771;5871;16437;6141;17208
261140;201303;3079;9010;2949;8833;603;2003;1926;5716;2529;7719
261150;201303;5344;16913;4880;16281;486;1869;3870;12979;4356;14848
261153;201303;1922;5663;1658;5303;108;410;1409;4545;1517;4955
261160;201303;218940;585662;210861;575109;41602;115289;138564;388993;180166;504282
261170;201303;5693;16657;5359;16159;667;2144;4234;12800;4901;14944
261180;201303;8825;27448;8710;27298;1039;3162;7171;22957;8210;26119
261190;201303;5230;17033;5028;16757;834;3640;3584;11335;4418;14975
261200;201303;3756;10166;3653;10035;501;1339;2774;7792;3275;9131
261210;201303;1828;5248;1755;5146;136;388;1503;4495;1639;4883
261220;201303;11845;40411;10753;37989;2210;8440;5995;21174;8205;29614
261230;201303;4135;12820;3887;12533;178;572;3519;11485;3697;12057
261240;201303;4740;14392;4520;13977;802;2466;3176;9992;3978;12458
261245;201303;3761;12397;3311;11641;326;1365;2424;8665;2750;10030
261247;201303;3371;10959;3030;10319;470;1646;2030;7038;2500;8684
261250;201303;18395;50952;17990;50418;1425;4203;15681;43951;17106;48154
261255;201303;4243;13515;3855;12883;439;1653;2837;9631;3276;11284
261260;201303;11436;34764;10646;33851;651;1983;9432;30437;10083;32420
261270;201303;3587;10648;3385;10322;498;1625;2373;7278;2871;8903
261280;201303;2663;8533;2435;8186;280;1087;1803;6017;2083;7104
261290;201303;2736;8255;2492;7942;149;503;2138;6943;2287;7446
261300;201303;9714;34676;9024;33419;1481;5950;6362;23794;7843;29744
261310;201303;8120;25472;7844;25007;1626;5389;5144;16560;6770;21949
261320;201303;5576;17975;5352;17556;784;2524;3825;12926;4609;15450
261330;201303;5510;16693;5411;16565;385;1329;4660;14288;5045;15617
261340;201303;4481;14943;4293;14646;766;2977;2789;9537;3555;12514
261350;201303;7690;26911;7340;26284;723;3092;5771;20482;6494;23574
261360;201303;8970;24204;8325;23293;1287;3847;5685;16169;6972;20016
261370;201303;19967;61377;19156;60209;2761;9420;14300;45088;17061;54508
261380;201303;4035;14243;3799;13863;646;2385;2608;9823;3254;12208
261390;201303;16151;51853;15012;49858;2724;10047;9472;31217;12196;41264
261400;201303;4672;16935;4314;16239;684;2854;2896;11003;3580;13857
261410;201303;7891;24826;7650;24460;755;2476;6142;20076;6897;22552
261420;201303;7416;25729;7236;25465;1879;7252;4249;15168;6128;22420
261430;201303;3413;10871;2920;10223;429;1555;2085;7474;2514;9029
261440;201303;1612;4975;1537;4868;133;516;1253;3929;1386;4445
261450;201303;13303;41226;13069;40921;1174;3837;11303;35505;12477;39342
261460;201303;8278;24240;7766;23519;854;2488;5677;18549;6531;21037
261470;201303;3789;10658;3484;10294;270;942;2953;8650;3223;9592
261480;201303;3206;12214;3050;11932;358;1624;2388;9180;2746;10804
261485;201303;4710;15285;4507;14940;958;3449;2744;9162;3702;12611
261500;201303;5533;15956;5060;15324;804;2233;3791;12001;4595;14234
261510;201303;2004;6839;1940;6755;104;302;1730;6162;1834;6464
261520;201303;2497;8429;2289;8117;242;964;1698;6045;1940;7009
261530;201303;12206;40534;11007;38206;2545;9794;5477;18918;8022;28712
261540;201303;6876;22669;6752;22467;1788;5509;4404;15418;6192;20927
261550;201303;3133;10270;3039;10120;547;2258;2206;6990;2753;9248
261560;201303;5963;20638;5628;20221;1055;3303;4191;15912;5246;19215
261570;201303;3525;11412;3294;11034;472;1635;2362;8070;2834;9705
261580;201303;5577;18637;5061;17773;452;1781;4036;14428;4488;16209
261590;201303;2720;7886;2415;7449;246;835;1785;5588;2031;6423
261600;201303;4929;14389;4263;13404;552;1845;3090;9852;3642;11697
261610;201303;2137;6845;1961;6599;138;593;1654;5445;1792;6038
261618;201303;2458;7276;2350;7123;249;910;1846;5466;2095;6376
261620;201303;4387;13824;4189;13513;497;1733;3030;9966;3527;11699
261630;201303;7885;24042;7199;22859;1562;5728;4110;12739;5672;18467
261640;201303;32253;85555;30366;83431;1733;4956;26682;74476;28415;79432
261650;201303;3510;12158;3430;12043;434;1714;2755;9677;3189;11391
270010;201303;4426;17268;4101;16575;510;2419;2940;11854;3450;14273
270020;201303;3713;11893;3503;11545;545;2129;2531;8127;3076;10256
270030;201303;41766;131538;40427;129604;11063;36223;23813;78579;34876;114802
270040;201303;10275;32626;10041;32378;817;2151;8912;29463;9729;31614
270050;201303;3740;11336;3543;11078;404;1579;2689;8208;3093;9787
270060;201303;1466;5224;1415;5146;365;1453;837;3054;1202;4507
270070;201303;3895;12509;3703;12227;138;616;3342;10946;3480;11562
270080;201303;1253;4121;1144;3975;276;1062;678;2335;954;3397
270090;201303;1960;6400;1923;6353;59;223;1802;5965;1861;6188
270100;201303;6172;20526;5966;20256;1233;4528;4174;14136;5407;18664
270110;201303;3298;9879;3066;9595;663;2183;1888;6325;2551;8508
270120;201303;2971;8871;2701;8490;172;645;2275;7165;2447;7810
270130;201303;4885;15809;4679;15566;613;2065;3638;12350;4251;14415
270135;201303;1672;5032;1597;4943;77;194;1457;4603;1534;4797
270140;201303;8481;24172;7798;23286;1093;4390;5918;16735;7011;21125
270150;201303;2449;8896;2387;8808;291;1235;1919;7007;2210;8242
270160;201303;4676;16789;4414;16418;342;1179;3783;14326;4125;15505
270170;201303;3963;13545;3668;13086;811;3329;2108;7445;2919;10774
270180;201303;2101;7457;1904;7209;225;975;1490;5668;1715;6643
270190;201303;1812;6197;1737;6069;202;748;1326;4705;1528;5453
270200;201303;2571;9004;2486;8868;245;1135;2023;7028;2268;8163
270210;201303;3822;14077;3741;13965;549;2176;2921;11036;3470;13212
270220;201303;1647;5338;1562;5166;312;1214;853;2877;1165;4091
270230;201303;10528;36118;9615;34694;1401;5742;7013;25200;8414;30942
270235;201303;6342;21422;6070;20972;367;1671;5219;17896;5586;19567
270240;201303;9487;29220;8633;28059;1588;5452;5730;18728;7318;24180
270250;201303;3306;9017;3078;8768;151;450;2800;7985;2951;8435
270255;201303;5010;15891;4246;14566;470;2008;3037;10291;3507;12299
270260;201303;6001;20115;5848;19835;969;3802;4077;13885;5046;17687
270270;201303;1210;3645;1147;3549;189;645;829;2544;1018;3189
270280;201303;3579;11182;3425;10954;570;2081;2454;7812;3024;9893
270290;201303;8193;29842;7891;29317;749;3071;6431;23956;7180;27027
270300;201303;3043;10963;2907;10796;184;845;2571;9520;2755;10365
270310;201303;6833;22248;6332;21404;463;2093;5086;16813;5549;18906
270320;201303;6058;20736;5879;20403;1662;6400;2856;10115;4518;16515
270330;201303;4564;15741;4361;15465;380;1423;3639;13079;4019;14502
270340;201303;1703;5486;1569;5327;238;847;1155;4000;1393;4847
270350;201303;2055;6021;1922;5847;319;1032;1262;4075;1581;5107
270360;201303;1905;6273;1890;6255;136;497;1683;5593;1819;6090
270370;201303;1689;5714;1561;5481;201;810;1088;3907;1289;4717
270375;201303;2903;9376;2778;9181;528;2142;1837;5755;2365;7897
270380;201303;5960;18565;5750;18290;622;2090;4483;14543;5105;16633
270390;201303;1362;4017;1275;3905;174;635;925;2757;1099;3392
270400;201303;5908;18850;5576;18404;471;1763;4597;15189;5068;16952
270410;201303;4657;15056;4493;14742;618;2271;3370;11026;3988;13297
270420;201303;5073;17371;4952;17198;302;1364;4347;14948;4649;16312
270430;201303;136282;405317;132025;399401;35163;108444;78268;243151;113431;351595
270440;201303;4756;15296;4524;14931;400;1515;3676;12172;4076;13687
270450;201303;6155;20322;6033;20163;739;2820;4732;15863;5471;18683
270460;201303;3244;9680;2952;9255;290;1172;2301;7038;2591;8210
270470;201303;10428;34704;10059;34041;1315;4241;7602;26752;8917;30993
270480;201303;3026;10040;2867;9773;376;1568;2033;6750;2409;8318
270490;201303;948;3219;909;3166;115;442;728;2521;843;2963
270500;201303;5426;19705;5284;19503;389;1435;4544;17189;4933;18624
270510;201303;5780;18753;5349;18144;1062;4557;3751;12048;4813;16605
270520;201303;3605;12419;3423;12102;972;3694;1796;6468;2768;10162
270530;201303;1526;4655;1359;4437;241;753;914;3140;1155;3893
270540;201303;1904;6994;1767;6773;220;1019;1364;5153;1584;6172
270550;201303;6777;21981;6107;21047;1071;3826;4099;14621;5170;18447
270560;201303;2819;9524;2750;9434;410;1607;2110;7173;2520;8780
270570;201303;4251;14368;3958;13905;561;2373;2688;9363;3249;11736
270580;201303;1935;6821;1878;6722;296;1108;1416;5120;1712;6228
270590;201303;1260;4644;1191;4515;122;584;949;3563;1071;4147
270600;201303;2786;9712;2576;9419;219;1042;2097;7525;2316;8567
270610;201303;3126;10233;2967;9992;360;1286;2295;7716;2655;9002
270620;201303;1390;4889;1266;4703;166;802;942;3391;1108;4193
270630;201303;17587;50358;16995;49573;1999;5592;13812;41009;15811;46601
270640;201303;5613;18124;5175;17624;392;1663;4416;14876;4808;16539
270642;201303;2406;8486;2274;8282;386;1543;1539;5658;1925;7201
270644;201303;2221;6981;2102;6849;398;1219;1572;5298;1970;6517
270650;201303;3817;12812;3707;12654;958;3705;2161;7331;3119;11036
270660;201303;2457;6702;2014;6006;221;822;1418;4153;1639;4975
270670;201303;12674;39701;11948;38608;1545;5716;9117;29215;10662;34931
270680;201303;4000;12585;3900;12465;245;731;3490;11277;3735;12008
270690;201303;7949;24116;7666;23758;2380;6935;4225;14252;6605;21187
270700;201303;793;2591;760;2535;157;603;462;1529;619;2132
270710;201303;5293;18498;5135;18295;505;1771;4320;15654;4825;17425
270720;201303;3158;11393;2974;11073;298;1366;2367;8732;2665;10098
270730;201303;6260;20398;5955;19993;1302;4773;3939;13080;5241;17853
270740;201303;2341;7138;2217;6950;388;1391;1457;4521;1845;5912
270750;201303;4690;15735;4454;15394;507;2018;3446;11846;3953;13864
270760;201303;3188;10140;3020;9902;381;1312;2333;7697;2714;9009
270770;201303;16665;46718;14562;44166;2816;9308;9538;29246;12354;38554
270780;201303;1894;6129;1776;5943;151;523;1443;4899;1594;5422
270790;201303;1542;5025;1422;4820;381;1374;703;2446;1084;3820
270800;201303;10563;33337;10059;32663;1011;3709;8112;26283;9123;29992
270810;201303;3160;10309;2747;9571;433;1704;1731;6077;2164;7781
270820;201303;1858;6518;1728;6285;244;1069;1241;4446;1485;5515
270830;201303;4936;16786;4628;16356;1487;5896;2451;8571;3938;14467
270840;201303;6976;25556;6470;24900;561;2553;5318;20441;5879;22994
270850;201303;7317;25214;7199;25058;1591;6712;5040;16707;6631;23419
270860;201303;10520;34025;10082;33339;1922;7257;6950;22483;8872;29740
270870;201303;2123;6391;1869;5934;278;984;1152;3687;1430;4671
270880;201303;7855;26361;7523;25873;657;2649;6288;21469;6945;24118
270890;201303;2497;7970;2355;7746;400;1560;1614;5159;2014;6719
270895;201303;2921;11226;2794;11061;280;1073;2350;9512;2630;10585
270900;201303;1812;5239;1541;4845;127;462;1178;3638;1305;4100
270910;201303;3190;11763;3154;11696;337;1510;2631;9570;2968;11080
270915;201303;9542;33859;8874;32654;2108;8632;4744;17463;6852;26095
270920;201303;5603;19579;5269;19089;467;2079;4315;15569;4782;17648
270930;201303;16288;46230;13717;42926;2970;10023;7907;25076;10877;35099
270940;201303;5720;20028;5571;19853;821;2929;4338;15802;5159;18731
280010;201303;699;2111;624;1994;73;292;405;1272;478;1564
280020;201303;4674;14866;4305;14209;861;3000;2726;9063;3587;12063
280030;201303;65309;181609;60061;173957;15706;47833;32148;95017;47854;142850
280040;201303;2984;9840;2757;9540;369;1296;2062;7391;2431;8687
280050;201303;3963;13070;3744;12759;1080;3720;2150;7623;3230;11343
280060;201303;4035;13963;3928;13794;944;3638;2353;8274;3297;11912
280067;201303;7184;21382;6196;20020;639;2404;4776;15334;5415;17738
280070;201303;1774;6479;1713;6386;312;1230;1171;4435;1483;5665
280100;201303;3836;12573;3548;12065;850;2965;1984;6931;2834;9896
280110;201303;1272;4138;1197;4013;128;531;911;3012;1039;3543
280120;201303;7186;24067;6766;23362;1467;4770;4445;16318;5912;21088
280130;201303;7450;22379;7128;21920;1136;4089;5024;15193;6160;19282
280140;201303;5225;15337;4819;14813;320;1010;4149;12904;4469;13914
280150;201303;3176;10307;2943;9842;496;2010;1828;5819;2324;7829
280160;201303;1473;4358;1357;4172;199;689;955;2936;1154;3625
280170;201303;4234;13613;3914;13229;565;1944;2922;10190;3487;12134
280190;201303;1072;3253;983;3109;124;492;690;2117;814;2609
280200;201303;935;3183;908;3151;179;759;632;2103;811;2862
280210;201303;11039;38179;10680;37569;2509;9400;6568;23403;9077;32803
280220;201303;1483;4692;1434;4628;98;356;1269;4096;1367;4452
280230;201303;3690;11141;3373;10611;737;2455;1986;6410;2723;8865
280240;201303;3350;10509;3145;10196;244;833;2558;8380;2802;9213
280250;201303;697;1950;657;1890;46;161;540;1509;586;1670
280260;201303;1842;5298;1696;5111;142;451;1428;4306;1570;4757
280270;201303;2083;6798;1849;6393;137;583;1456;4927;1593;5510
280280;201303;3921;13428;3732;13104;805;2487;2262;8769;3067;11256
280290;201303;14716;50380;14090;49345;2496;9591;10184;35515;12680;45106
280300;201303;9412;29741;8884;29146;639;2326;7796;25582;8435;27908
280310;201303;1368;4024;1244;3837;120;477;914;2736;1034;3213
280320;201303;6973;25060;6695;24557;1206;5006;4416;16196;5622;21202
280330;201303;3995;12464;3817;12236;558;1895;2881;9360;3439;11255
280340;201303;3340;11097;3261;10989;278;1090;2722;9191;3000;10281
280350;201303;19913;62339;19156;61132;3077;10252;13537;44078;16614;54330
280360;201303;5613;18271;5333;17842;1191;4512;3292;10846;4483;15358
280370;201303;1800;5429;1687;5244;220;807;1242;3749;1462;4556
280380;201303;822;2904;773;2820;148;635;532;1870;680;2505
280390;201303;3068;9460;2822;9028;658;1928;1777;5882;2435;7810
280400;201303;4049;12216;3738;11800;709;2229;2545;8299;3254;10528
280410;201303;2242;7619;2089;7370;359;1456;1278;4415;1637;5871
280420;201303;3731;11553;3538;11278;257;858;3049;9820;3306;10678
280430;201303;1789;5520;1705;5409;278;975;1238;3896;1516;4871
280440;201303;4688;14713;4458;14410;391;1430;3774;12147;4165;13577
280445;201303;2403;7062;2263;6828;131;526;1883;5571;2014;6097
280450;201303;8313;23858;7786;23249;792;2064;6527;20120;7319;22184
280460;201303;6211;18383;5729;17728;1338;4200;3634;11582;4972;15782
280470;201303;1650;5278;1536;5099;189;722;1144;3749;1333;4471
280480;201303;29026;91717;28240;90597;4573;17642;19986;62145;24559;79787
280490;201303;3588;11396;3400;11064;352;1409;2696;8672;3048;10081
280500;201303;759;2211;745;2195;46;175;633;1823;679;1998
280510;201303;2582;7886;2238;7416;313;1196;1649;5482;1962;6678
280520;201303;1529;4774;1408;4608;217;780;945;3174;1162;3954
280530;201303;1925;6354;1848;6248;225;857;1450;4929;1675;5786
280540;201303;8376;24278;8018;23787;384;1394;7165;21112;7549;22506
280550;201303;6599;19179;6155;18471;571;2095;4669;13892;5240;15987
280560;201303;7465;23048;7129;22472;572;2043;5797;18228;6369;20271
280570;201303;6440;19074;6059;18591;823;2998;4596;13939;5419;16937
280580;201303;5514;17185;4890;16173;597;2106;3635;12203;4232;14309
280590;201303;2235;7076;2086;6906;254;1037;1610;5295;1864;6332
280600;201303;3900;12362;3678;11949;404;1607;2653;8431;3057;10038
280610;201303;2178;6723;2087;6584;345;1250;1362;4258;1707;5508
280620;201303;4453;14621;4245;14205;848;3052;2692;9021;3540;12073
280630;201303;3665;12621;3562;12461;486;1693;2728;9812;3214;11505
280640;201303;1948;6011;1850;5888;102;348;1651;5269;1753;5617
280650;201303;1028;3375;965;3259;199;714;594;2035;793;2749
280660;201303;2459;7568;2367;7413;178;709;2032;6230;2210;6939
280670;201303;14801;40446;14209;39736;1336;3993;11755;32935;13091;36928
280680;201303;2520;7289;2250;6954;197;634;1873;5839;2070;6473
280690;201303;906;2783;809;2627;121;471;532;1624;653;2095
280700;201303;1160;3520;1041;3354;80;259;820;2709;900;2968
280710;201303;9141;27355;8808;26920;552;1927;7604;23157;8156;25084
280720;201303;2340;6664;2111;6369;197;661;1682;5060;1879;5721
280730;201303;882;2762;867;2741;91;307;705;2262;796;2569
280740;201303;11888;34193;10709;32497;1689;5036;7621;23846;9310;28882
280750;201303;3411;11304;3235;10983;292;1238;2442;8190;2734;9428
280760;201303;5178;17051;4820;16594;561;1958;3824;13533;4385;15491
290010;201303;2862;6606;2126;5464;93;384;1699;4129;1792;4513
290020;201303;4795;15468;4367;15023;377;1232;3805;13319;4182;14551
290030;201303;2966;10110;2910;9996;338;1269;2273;7767;2611;9036
290035;201303;4309;12559;3955;12095;262;926;3369;10302;3631;11228
290040;201303;3492;11159;3313;10916;287;1146;2738;8926;3025;10072
290050;201303;2663;8921;2507;8683;242;944;1947;6798;2189;7742
290060;201303;1238;3334;1056;3120;82;232;914;2719;996;2951
290070;201303;27724;78112;25200;74901;5357;16614;14878;46123;20235;62737
290080;201303;5405;17498;4951;16917;620;2262;3856;13347;4476;15609
290090;201303;2279;5152;1835;4683;178;449;1541;3994;1719;4443
290100;201303;9709;28838;8536;26822;1917;6069;4637;15292;6554;21361
290110;201303;5041;15926;4907;15697;838;2938;3444;10948;4282;13886
290115;201303;4753;14986;4293;14378;361;1293;3311;11288;3672;12581
290120;201303;6401;18442;6066;18042;388;1202;5361;16056;5749;17258
290130;201303;4425;12037;4002;11532;316;790;3435;10148;3751;10938
290135;201303;4836;13295;4308;12411;457;1578;2991;8619;3448;10197
290140;201303;3487;12134;3165;11714;418;1658;2502;9307;2920;10965
290150;201303;2052;6258;2004;6176;166;552;1732;5323;1898;5875
290160;201303;3374;9736;3322;9675;386;797;2816;8584;3202;9381
290170;201303;2650;9261;2466;8948;281;1198;1910;6916;2191;8114
290180;201303;2829;8407;2609;8125;278;950;2003;6270;2281;7220
290190;201303;4128;13851;4000;13625;465;1645;3171;10951;3636;12596
290195;201303;2098;6140;1851;5767;130;434;1510;4766;1640;5200
290200;201303;3566;12200;3316;11742;487;1878;2345;8321;2832;10199
290205;201303;2635;8890;2504;8711;436;1788;1763;5990;2199;7778
290210;201303;14693;42680;14186;42071;2470;5851;10204;33242;12674;39093
290220;201303;2228;7193;2166;7100;352;1334;1537;4930;1889;6264
290225;201303;2928;8149;2774;7981;266;618;2358;7036;2624;7654
290230;201303;2210;7653;2179;7608;260;912;1773;6295;2033;7207
290240;201303;3760;10241;3441;9812;399;1275;2590;7336;2989;8611
290250;201303;3618;12002;3086;11141;331;1301;2302;8394;2633;9695
290260;201303;4442;14558;4241;14249;528;1872;3318;11198;3846;13070
290265;201303;3208;10841;3094;10645;327;1298;2388;8194;2715;9492
290270;201303;11234;43171;10671;42370;1259;5546;8382;33544;9641;39090
290280;201303;4835;16694;4642;16302;756;2763;3119;11264;3875;14027
290290;201303;9236;30770;8603;29754;1565;5744;5823;20449;7388;26193
290300;201303;4220;12359;3434;11067;334;1077;2541;8426;2875;9503
290310;201303;1443;4587;1401;4543;205;772;1064;3379;1269;4151
290320;201303;21659;74682;20808;73416;4836;17914;13350;47823;18186;65737
290323;201303;3532;10430;2972;9842;196;781;2552;8415;2748;9196
290327;201303;3756;12628;3579;12263;529;1924;2517;8678;3046;10602
290330;201303;1757;4984;1702;4924;289;927;1298;3693;1587;4620
290340;201303;5443;17936;5161;17506;1204;4167;3035;10669;4239;14836
290350;201303;4754;15044;3956;13951;505;1835;2891;10458;3396;12293
290360;201303;3840;12735;3639;12491;231;838;3219;11163;3450;12001
290370;201303;4285;13661;4001;13239;582;1987;3071;10281;3653;12268
290380;201303;5184;15931;4726;15374;343;1289;4121;13397;4464;14686
290390;201303;14180;48656;13742;47924;2760;9397;9270;33814;12030;43211
290395;201303;2681;8988;2450;8607;272;1159;1832;6434;2104;7593
290400;201303;3252;11268;2984;10885;366;1485;2267;8367;2633;9852
290405;201303;4067;13646;3641;12939;530;1956;2488;9133;3018;11089
290410;201303;5701;17910;4966;16838;591;2564;3672;12090;4263;14654
290420;201303;2981;9596;2615;9077;309;1275;1924;6626;2233;7901
290430;201303;3210;10734;2983;10430;596;2039;2004;7290;2600;9329
290440;201303;2651;7712;2269;7234;243;844;1833;5898;2076;6742
290450;201303;3318;10189;3055;9812;689;2132;1860;6288;2549;8420
290460;201303;12456;40730;11902;39795;3002;10746;6582;21854;9584;32600
290470;201303;4470;13315;3664;12313;869;3311;2005;6798;2874;10109
290475;201303;5031;18346;4629;17627;579;2342;3414;13216;3993;15558
290480;201303;2562;6892;2316;6564;402;1274;1584;4498;1986;5772
290485;201303;4262;14752;4036;14415;487;2153;3078;10937;3565;13090
290490;201303;7107;20886;6940;20674;916;2962;5489;16372;6405;19334
290500;201303;4460;14728;3919;13800;734;2784;2223;7887;2957;10671
290510;201303;3364;10116;2979;9547;257;989;2359;7536;2616;8525
290515;201303;2542;8457;2471;8316;138;452;2049;7090;2187;7542
290520;201303;11279;36535;9494;33186;1358;5531;6078;21126;7436;26657
290530;201303;5048;15153;4403;14245;364;1329;3596;11620;3960;12949
290540;201303;3902;11416;3749;11209;522;1529;2823;8667;3345;10196
290550;201303;3885;11026;3449;10461;339;931;2753;8564;3092;9495
290560;201303;6586;19829;5806;18792;1261;4327;3617;11921;4878;16248
290570;201303;36712;113025;34715;109953;4748;16281;25906;81953;30654;98234
290580;201303;7159;26260;6920;25893;1199;4524;5061;19467;6260;23991
290590;201303;6885;23256;5980;21847;461;2027;4884;17782;5345;19809
290600;201303;17497;56778;16703;55531;2289;7895;12003;40990;14292;48885
290610;201303;2239;8171;1961;7640;226;1084;1473;5627;1699;6711
290620;201303;7032;21639;6384;20727;531;1883;5364;17432;5895;19315
290630;201303;7877;22152;7104;21347;666;1989;6009;18313;6675;20302
290640;201303;2666;8045;2252;7318;274;967;1590;5177;1864;6144
290650;201303;11236;34576;10585;33569;3294;10481;5580;18546;8874;29027
290660;201303;3585;10464;3051;9698;225;838;2444;7780;2669;8618
290670;201303;6156;20438;5704;19737;775;2467;4471;16131;5246;18598
290680;201303;9781;30102;9334;29591;540;1551;8325;26860;8865;28411
290682;201303;3998;12769;3718;12370;237;972;3137;10402;3374;11374
290685;201303;3071;8377;2453;7516;307;1060;1639;5069;1946;6129
290687;201303;8081;22418;6704;20801;1027;3514;4626;14564;5653;18078
290689;201303;3033;8928;2598;8217;283;980;2020;6427;2303;7407
290690;201303;5015;15450;4677;14984;623;2222;3550;11384;4173;13606
290700;201303;2147;7009;2077;6899;256;904;1604;5380;1860;6284
290710;201303;7275;24536;6851;23878;417;1444;6062;21388;6479;22832
290720;201303;16785;52643;15273;50762;2193;6530;11860;41096;14053;47626
290730;201303;7070;20508;6583;19905;1297;3785;4318;13652;5615;17437
290740;201303;970;3038;848;2839;207;682;451;1606;658;2288
290750;201303;8607;27349;8105;26399;1719;6572;4877;14920;6596;21492
290755;201303;2342;6931;2039;6430;145;576;1674;5215;1819;5791
290760;201303;4301;13270;3661;12415;362;1281;2909;9958;3271;11239
290770;201303;2481;8835;2335;8640;154;640;1986;7394;2140;8034
290780;201303;8137;22898;7519;22071;998;2827;5663;17002;6661;19829
290790;201303;4162;13529;3954;13262;396;1306;3150;10981;3546;12287
290800;201303;6897;16211;5393;14611;1092;2758;3796;10782;4888;13540
290810;201303;4496;15364;4151;14835;367;1392;3279;11905;3646;13297
290820;201303;5154;15539;4667;14855;625;2223;3428;10984;4053;13207
290830;201303;4060;12774;3931;12533;572;2234;2744;8507;3316;10741
290840;201303;16442;48304;15548;47079;2255;6550;11467;36063;13722;42613
290850;201303;6430;20137;6306;19946;1697;5281;3900;12813;5597;18094
290860;201303;4508;17113;4393;16961;705;2680;3259;12991;3964;15671
290870;201303;4589;14708;3904;13817;380;1589;3094;10971;3474;12560
290880;201303;1323;3879;1092;3512;111;387;738;2419;849;2806
290890;201303;6021;17508;5851;17294;531;1707;4895;14440;5426;16147
290900;201303;2316;7003;1789;6175;312;1220;935;3171;1247;4391
290910;201303;4503;13400;3954;12607;385;1310;3130;10052;3515;11362
290920;201303;4623;14640;4285;14230;249;719;3799;12878;4048;13597
290930;201303;7038;23505;6628;22857;764;3010;4948;16856;5712;19866
290940;201303;3174;10792;3022;10587;284;1085;2545;9013;2829;10098
290950;201303;1525;4577;1463;4494;228;761;1080;3286;1308;4047
290960;201303;5455;16713;5120;16243;416;1373;4138;13330;4554;14703
290970;201303;3626;12174;3413;11808;521;1876;2277;8100;2798;9976
290980;201303;10141;32425;9329;30780;2709;9576;4297;14045;7006;23621
290990;201303;8832;27431;8240;26498;971;3301;6455;20881;7426;24182
291000;201303;2814;9524;2706;9381;416;1401;2058;7393;2474;8794
291005;201303;9657;32077;9311;31495;2004;7218;6172;20928;8176;28146
291010;201303;2805;9968;2441;9116;518;2048;1246;4729;1764;6777
291020;201303;1295;3655;1026;3149;131;505;588;1746;719;2251
291030;201303;1917;5732;1674;5220;193;680;1093;3372;1286;4052
291040;201303;4900;16660;4692;16351;603;2367;3475;12094;4078;14461
291050;201303;7816;26970;7289;26012;1903;7293;4037;14521;5940;21814
291060;201303;5979;22882;5760;22617;797;3520;4456;17497;5253;21017
291070;201303;15345;47190;14358;45728;2003;5957;10774;35483;12777;41440
291072;201303;16697;56524;15270;53810;6166;22832;4987;18829;11153;41661
291075;201303;4914;15083;4565;14582;327;1090;3612;11697;3939;12787
291077;201303;1441;4465;1263;4198;150;615;877;2845;1027;3460
291080;201303;78910;245937;73170;237147;18310;62871;39279;127110;57589;189981
291085;201303;5280;15068;4686;14275;589;1986;3613;10967;4202;12953
291090;201303;1110;3285;975;3078;180;790;582;1657;762;2447
291100;201303;2604;7318;2221;6913;126;513;1928;5967;2054;6480
291110;201303;4735;17675;4314;17005;549;2491;3176;12464;3725;14955
291120;201303;7199;20146;6869;19676;1028;3109;5207;14994;6235;18103
291125;201303;1603;3734;1333;3453;140;328;1055;2852;1195;3180
291130;201303;2920;9144;2595;8608;278;1059;1870;6189;2148;7248
291140;201303;3910;12230;3757;11958;565;1924;2758;8795;3323;10719
291150;201303;1899;5197;1846;5138;176;491;1551;4339;1727;4830
291160;201303;5228;16512;4730;15777;1089;3867;2959;9843;4048;13710
291165;201303;2160;7085;1939;6649;224;932;1381;4601;1605;5533
291170;201303;19481;52019;17278;49386;1439;4917;14039;39862;15478;44779
291180;201303;5959;16709;5055;15477;523;1875;3964;11992;4487;13867
291185;201303;3434;10234;3300;10061;236;853;2824;8539;3060;9392
291190;201303;7242;21202;6627;20503;918;2700;4974;16105;5892;18805
291200;201303;2996;9434;2658;8894;352;1385;1934;6416;2286;7801
291210;201303;7384;18369;6655;17584;728;1972;5173;13910;5901;15882
291220;201303;3800;12623;3630;12326;601;2336;2526;8471;3127;10807
291230;201303;3646;10068;3295;9629;228;702;2835;8327;3063;9029
291240;201303;4444;12822;3845;11790;338;1116;2947;8958;3285;10074
291250;201303;3613;11165;2923;10047;308;1104;2114;7376;2422;8480
291260;201303;1158;3548;1110;3488;105;371;901;2826;1006;3197
291270;201303;4659;15835;4454;15551;304;1210;3741;13097;4045;14307
291280;201303;2277;5996;1755;5411;562;1667;1011;3254;1573;4921
291290;201303;5631;17105;5269;16667;387;1200;4437;14324;4824;15524
291300;201303;4315;13383;3630;12229;466;1755;2526;8543;2992;10298
291310;201303;5014;15192;4533;14433;444;1545;3496;11145;3940;12690
291320;201303;5112;18038;4756;17313;1303;5137;2397;8642;3700;13779
291330;201303;1525;4880;1437;4721;221;854;908;2852;1129;3706
291340;201303;3649;11401;2999;10464;404;1598;2225;7720;2629;9318
291345;201303;3176;11148;3062;11023;248;940;2666;9705;2914;10645
291350;201303;5871;17978;5293;17104;731;2476;3472;11553;4203;14029
291360;201303;35180;105805;33261;102931;7571;23230;21969;70165;29540;93395
291370;201303;8615;27268;8323;26894;1438;4302;5998;20397;7436;24699
291380;201303;3492;11396;3208;10949;260;907;2499;8775;2759;9682
291390;201303;9637;28590;8883;27748;1094;3510;7097;22398;8191;25908
291400;201303;16212;44247;13395;40507;1880;5924;9119;28598;10999;34522
291410;201303;3103;8334;2323;7189;208;870;1725;5127;1933;5997
291420;201303;2150;5903;1986;5705;175;442;1741;5102;1916;5544
291430;201303;3216;9871;2875;9427;283;1103;2242;7297;2525;8400
291440;201303;5508;18579;4748;17115;603;2310;3503;12841;4106;15151
291450;201303;6903;22334;6640;21887;509;1676;5391;18120;5900;19796
291460;201303;11855;38221;10785;36671;2770;9749;6349;22063;9119;31812
291465;201303;7163;22585;6742;22107;1005;3508;5152;17117;6157;20625
291470;201303;14823;43403;13446;41710;1153;3646;10905;34724;12058;38370
291480;201303;32932;93211;29706;88664;5658;18426;18970;56517;24628;74943
291490;201303;3916;14176;3856;14080;562;2081;3037;11228;3599;13309
291500;201303;4002;12061;3552;11444;309;1077;2866;9281;3175;10358
291510;201303;3261;10546;3106;10325;190;672;2761;9242;2951;9914
291520;201303;3924;11451;3555;10944;631;1856;2377;7822;3008;9678
291530;201303;1975;6173;1729;5795;517;1843;846;2922;1363;4765
291535;201303;4179;12768;3835;12276;450;1500;2835;9489;3285;10989
291540;201303;2163;5592;1899;5315;161;429;1613;4609;1774;5038
291550;201303;5314;15182;4851;14525;1185;3845;2758;8300;3943;12145
291560;201303;15698;43454;12789;40081;1808;5843;9277;29856;11085;35699
291570;201303;2224;6289;2197;6258;49;106;2123;6111;2172;6217
291580;201303;5599;17868;5021;16923;860;3540;3127;10325;3987;13865
291590;201303;1835;6058;1675;5782;368;1440;988;3463;1356;4903
291600;201303;5261;15282;3958;13472;1014;3756;2029;6883;3043;10639
291610;201303;5079;14751;4950;14570;454;1660;4155;11966;4609;13626
291620;201303;2880;7122;2440;6648;213;579;1939;5465;2152;6044
291630;201303;3114;8120;2818;7785;235;624;2447;6890;2682;7514
291640;201303;16245;47049;14050;44289;4170;14425;6394;20283;10564;34708
291650;201303;7709;23672;7191;23071;622;1622;6112;20337;6734;21959
291660;201303;2374;6556;2157;6280;273;917;1598;4588;1871;5505
291670;201303;2448;7124;2273;6831;378;1184;1286;4204;1664;5388
291680;201303;4845;14332;4450;13724;1171;4043;2159;6981;3330;11024
291685;201303;3807;10994;3537;10674;173;592;3141;9570;3314;10162
291690;201303;3825;10980;3206;9997;347;1149;2208;6939;2555;8088
291700;201303;8911;29695;8442;28914;912;3318;6592;22889;7504;26207
291710;201303;5611;15841;4964;14949;1255;4301;2371;7367;3626;11668
291720;201303;3496;12873;3343;12549;405;1709;2503;9293;2908;11002
291730;201303;5556;18802;5241;18385;1374;4864;3163;11544;4537;16408
291733;201303;2355;7816;2103;7473;259;992;1514;5518;1773;6510
291735;201303;1951;6089;1761;5792;88;362;1537;4999;1625;5361
291740;201303;3839;11506;3079;10338;341;1350;2190;7308;2531;8658
291750;201303;20542;57163;17103;52199;3806;11992;9873;30728;13679;42720
291760;201303;11643;38530;11145;37689;3652;13212;5614;19433;9266;32645
291770;201303;7641;22896;7192;22146;1097;3709;5042;15402;6139;19111
291780;201303;4149;13356;4044;13174;604;1878;3084;10261;3688;12139
291790;201303;2281;7721;2187;7603;226;858;1768;6191;1994;7049
291800;201303;29352;90565;27210;87495;6478;21539;16547;54726;23025;76265
291810;201303;9818;30246;8790;29056;698;2468;7265;24387;7963;26855
291820;201303;3425;10926;3221;10641;362;1227;2520;8435;2882;9662
291830;201303;4173;11772;3934;11414;530;1711;3008;8651;3538;10362
291835;201303;5887;18965;5089;17742;987;3734;3502;12186;4489;15920
291840;201303;44419;128384;39012;122724;4879;15442;31329;100475;36208;115917
291845;201303;2992;9069;2721;8778;196;569;2430;7984;2626;8553
291850;201303;4715;13735;4072;12865;412;1291;3249;10503;3661;11794
291855;201303;1828;5065;1621;4817;266;959;1158;3356;1424;4315
291860;201303;1840;5822;1708;5610;219;832;1144;3742;1363;4574
291870;201303;1298;3695;1058;3266;112;428;719;2198;831;2626
291875;201303;2668;9132;2507;8872;282;1166;1866;6521;2148;7687
291880;201303;4200;13857;4102;13730;282;995;3610;12157;3892;13152
291890;201303;1367;3572;1176;3338;138;401;890;2565;1028;2966
291900;201303;1215;3720;1108;3558;110;405;838;2665;948;3070
291905;201303;2723;7750;2355;7162;276;908;1579;4948;1855;5856
291910;201303;2297;6901;2121;6692;182;677;1790;5586;1972;6263
291915;201303;6318;20536;5823;19504;506;1789;4898;16570;5404;18359
291920;201303;32090;95249;29960;92176;5785;18018;19471;61918;25256;79936
291930;201303;2369;7499;2208;7269;233;775;1760;5937;1993;6712
291940;201303;3469;10303;2746;9067;422;1636;1731;5587;2153;7223
291950;201303;8881;31416;8164;30252;2030;7720;4569;17357;6599;25077
291955;201303;7239;24654;7139;24517;1299;4565;5219;18220;6518;22785
291960;201303;3257;10129;2866;9624;370;1185;2057;7319;2427;8504
291970;201303;4262;13132;3827;12616;646;2142;2676;9080;3322;11222
291980;201303;10983;33045;8808;29992;983;3562;6473;22464;7456;26026
291990;201303;2052;7019;1920;6812;228;841;1392;5090;1620;5931
291992;201303;2664;8466;2614;8362;482;1621;1868;5944;2350;7565
291995;201303;2004;6240;1839;6024;225;791;1428;4720;1653;5511
292000;201303;2133;6725;1958;6450;611;2157;986;3212;1597;5369
292010;201303;5934;16054;4652;14097;343;1186;3646;11047;3989;12233
292020;201303;4377;15511;4061;14989;500;2056;3073;11487;3573;13543
292030;201303;2092;6928;1917;6685;258;971;1346;4801;1604;5772
292040;201303;4279;12643;3963;12298;326;1001;3363;10732;3689;11733
292045;201303;2194;8322;2169;8276;124;410;1976;7639;2100;8049
292050;201303;5819;19304;5443;18558;654;2700;3901;13099;4555;15799
292060;201303;10500;30528;10158;30062;935;2929;8497;25096;9432;28025
292070;201303;4054;13702;3962;13579;431;1296;3388;11903;3819;13199
292080;201303;3489;9673;3083;9123;316;986;2465;7345;2781;8331
292090;201303;4140;11561;3615;10955;400;1376;2870;8700;3270;10076
292100;201303;10285;30129;9183;28765;2309;7551;5636;18040;7945;25591
292105;201303;3062;9618;2707;9119;229;920;2156;7220;2385;8140
292110;201303;6847;18666;5307;16492;983;3363;3360;10558;4343;13921
292120;201303;8131;24316;7337;23102;1507;5010;4467;14359;5974;19369
292130;201303;3170;8663;2945;8380;387;918;2297;6834;2684;7752
292140;201303;5265;14323;4731;13607;528;1591;3435;10136;3963;11727
292145;201303;2627;8368;2433;8063;226;740;1822;6322;2048;7062
292150;201303;12956;40840;12173;39574;896;3506;9625;31389;10521;34895
292160;201303;2487;7495;2158;7044;209;661;1719;5795;1928;6456
292170;201303;8291;26035;7324;24394;1122;4189;4786;16141;5908;20330
292180;201303;3407;10502;2884;9719;342;1246;2082;7145;2424;8391
292190;201303;2948;8740;2642;8311;542;1888;1727;5413;2269;7301
292200;201303;4535;16943;4174;16086;1605;6451;1339;5417;2944;11868
292205;201303;3847;12420;3591;12071;324;1227;2803;9453;3127;10680
292210;201303;6265;19151;5605;18238;591;2042;4371;14549;4962;16591
292220;201303;1891;5686;1806;5564;280;918;1294;3940;1574;4858
292225;201303;2750;9144;2540;8812;241;880;1976;6983;2217;7863
292230;201303;5808;18240;5611;17921;676;2680;4364;13538;5040;16218
292240;201303;4184;14025;3952;13491;608;2189;2520;8674;3128;10863
292250;201303;5269;16485;5009;16004;1039;3476;2946;9498;3985;12974
292260;201303;2765;9408;2667;9245;358;1326;1987;6899;2345;8225
292265;201303;2907;10151;2741;9820;243;1021;2064;7369;2307;8390
292270;201303;3582;10444;2949;9694;296;1219;2402;7810;2698;9029
292273;201303;2650;6634;2047;5857;319;894;1414;4230;1733;5124
292275;201303;1883;5011;1775;4856;226;707;1347;3646;1573;4353
292280;201303;1984;6199;1865;6073;199;574;1475;5085;1674;5659
292285;201303;2405;7125;2163;6771;337;1126;1462;4740;1799;5866
292290;201303;7302;22653;6258;21326;247;945;5449;18980;5696;19925
292300;201303;8013;25685;7124;24726;2395;8356;3948;14311;6343;22667
292303;201303;2648;8820;2530;8634;90;336;2226;7656;2316;7992
292305;201303;2977;8629;2838;8439;129;415;2524;7547;2653;7962
292310;201303;5697;18448;5264;17870;367;1262;4513;15546;4880;16808
292320;201303;5392;17647;5088;17102;597;2367;3854;12828;4451;15195
292330;201303;1836;5648;1734;5527;297;1048;1220;3847;1517;4895
292335;201303;5025;13852;4666;13362;410;1189;3922;11318;4332;12507
292340;201303;6051;18534;5414;17564;512;1812;4101;13352;4613;15164
292350;201303;2011;6511;1905;6383;206;783;1520;5094;1726;5877
292360;201303;4602;14204;4474;13730;197;630;3916;12249;4113;12879
292370;201303;7996;26553;7370;25611;928;3143;5335;19557;6263;22700
292380;201303;7024;21197;6717;20763;547;1600;5697;17861;6244;19461
292390;201303;3465;8373;3103;7982;122;250;2883;7512;3005;7762
292400;201303;21402;64765;20598;63461;3073;10059;14721;46278;17794;56337
292405;201303;4249;11904;3773;11332;288;877;3195;9750;3483;10627
292410;201303;1586;4890;1554;4852;96;418;1378;4213;1474;4631
292420;201303;3429;11593;3334;11481;281;716;2906;10427;3187;11143
292430;201303;4989;16683;4390;15913;354;1430;3469;12644;3823;14074
292440;201303;8342;27827;7882;27177;315;1213;7034;24596;7349;25809
292450;201303;3872;12506;3310;11554;390;1510;2269;8050;2659;9560
292460;201303;5513;17133;4976;16149;793;2731;3334;10867;4127;13598
292465;201303;2231;7101;1964;6675;250;994;1437;4885;1687;5879
292467;201303;2148;7234;2048;7061;462;1703;1280;4460;1742;6163
292470;201303;3087;8590;2623;7849;241;864;1985;5849;2226;6713
292480;201303;5287;15846;4604;14852;422;1508;3698;12030;4120;13538
292490;201303;2011;6244;1835;5952;218;863;1350;4313;1568;5176
292500;201303;6152;19657;5466;18446;642;2547;3958;13393;4600;15940
292510;201303;12526;37496;11321;35775;1141;4039;8909;28444;10050;32483
292520;201303;5494;17722;5168;17124;1552;5289;2596;8691;4148;13980
292525;201303;5253;14377;4678;13700;481;1542;3695;10919;4176;12461
292530;201303;23790;73516;22107;71608;3633;12084;16388;54588;20021;66672
292540;201303;2506;8070;2327;7785;444;1771;1499;4944;1943;6715
292550;201303;5866;20461;5396;19703;1009;3926;3546;13195;4555;17121
292560;201303;4081;11648;3529;10924;328;1211;2849;8681;3177;9892
292570;201303;3761;11609;3701;11545;143;458;3222;10387;3365;10845
292575;201303;5535;19732;5415;19492;1299;4773;3398;12295;4697;17068
292580;201303;6713;21043;6299;20507;561;1884;5232;17214;5793;19098
292590;201303;6850;22937;6644;22564;1119;3795;4583;15941;5702;19736
292593;201303;3127;8597;2714;7989;273;843;2077;6117;2350;6960
292595;201303;5279;16242;4832;15633;474;1668;3729;12109;4203;13777
292600;201303;9818;29093;9445;28628;1379;3277;7518;24031;8897;27308
292610;201303;4226;12581;3617;11585;682;2282;2160;7052;2842;9334
292620;201303;5659;17914;5077;17244;267;997;4626;15802;4893;16799
292630;201303;9639;24989;8578;23454;657;1990;6800;18725;7457;20715
292640;201303;8167;26920;7274;25757;701;2526;5717;20772;6418;23298
292650;201303;4450;13073;4306;12897;514;1204;3452;11007;3966;12211
292660;201303;10584;33634;10267;33148;1470;4752;7670;25373;9140;30125
292665;201303;2800;8656;2732;8551;101;285;2558;8077;2659;8362
292670;201303;3688;10913;2996;9744;372;1387;1994;6516;2366;7903
292680;201303;3436;10785;3308;10621;232;859;2847;9052;3079;9911
292690;201303;3256;9200;2447;7968;318;1159;1682;5554;2000;6713
292700;201303;8329;26968;7567;25933;897;2946;5906;20939;6803;23885
292710;201303;1774;6052;1715;5963;114;417;1491;5225;1605;5642
292720;201303;9189;25063;8260;24001;845;2521;6796;20018;7641;22539
292730;201303;3149;9969;3060;9818;611;1877;2015;6739;2626;8616
292740;201303;336132;988370;322634;968251;79790;252139;193728;584696;273518;836835
292750;201303;5543;15867;5114;15309;429;1249;4131;12707;4560;13956
292760;201303;4180;13759;3885;13226;573;2172;2670;9162;3243;11334
292770;201303;5591;17984;5341;17593;1413;4667;3080;10589;4493;15256
292780;201303;1713;4598;1395;4216;228;817;981;2896;1209;3713
292790;201303;2936;8548;2871;8470;259;654;2367;7334;2626;7988
292800;201303;9034;28320;8564;27560;968;3401;6618;21333;7586;24734
292805;201303;2935;9254;2755;8984;504;1782;1903;6307;2407;8089
292810;201303;9190;29978;8121;28571;1221;4437;6094;21884;7315;26321
292820;201303;6946;20914;5255;18537;443;1787;4311;15246;4754;17033
292830;201303;1810;5566;1662;5366;133;531;1355;4341;1488;4872
292840;201303;6205;22316;5795;21732;572;2142;4739;18107;5311;20249
292850;201303;2734;7903;2527;7601;398;1249;1741;5183;2139;6432
292860;201303;14453;40997;14038;40491;2026;5771;10900;32057;12926;37828
292870;201303;17344;50916;15772;48334;3025;10457;9488;28501;12513;38958
292880;201303;11400;35273;10450;33735;2026;6765;6653;21773;8679;28538
292890;201303;5197;18703;4768;17862;1070;4135;2686;10421;3756;14556
292895;201303;2602;6966;2238;6427;324;1000;1667;4752;1991;5752
292900;201303;3011;9620;2848;9349;483;1874;1866;5898;2349;7772
292905;201303;3778;12076;3191;11304;408;1348;2478;9108;2886;10456
292910;201303;4787;15517;4534;15056;818;2880;2969;9823;3787;12703
292920;201303;7165;22240;6847;21745;737;2677;5356;16809;6093;19486
292925;201303;4747;15850;4296;15256;342;1322;3517;12592;3859;13914
292930;201303;6042;20185;5836;19791;912;3703;4182;13846;5094;17549
292935;201303;2021;5905;1734;5582;205;629;1345;4513;1550;5142
292937;201303;3100;8388;2683;7853;367;1186;1968;5717;2335;6903
292940;201303;2941;8506;2391;7752;272;907;1658;5605;1930;6512
292950;201303;7807;24871;7540;24403;1178;4423;5314;16773;6492;21196
292960;201303;4347;12712;4137;12403;517;1683;3029;9019;3546;10702
292970;201303;4019;13111;3760;12783;218;884;3190;10867;3408;11751
292975;201303;2906;8825;2827;8693;346;1195;2213;6742;2559;7937
292980;201303;3462;10207;2896;9529;420;1657;2021;6583;2441;8240
292990;201303;11411;34041;10892;33306;781;2462;9470;29201;10251;31663
293000;201303;2745;7719;2370;7217;149;544;2036;6159;2185;6703
293010;201303;16192;50262;15181;48479;3179;11107;9389;29777;12568;40884
293015;201303;7586;25989;6226;24039;1069;4457;4222;16262;5291;20719
293020;201303;9185;31025;8645;30247;662;2609;7180;25392;7842;28001
293030;201303;5389;16279;4478;14939;523;1863;3139;10814;3662;12677
293040;201303;3541;11780;3435;11661;258;923;2977;10144;3235;11067
293050;201303;18038;53885;16374;51676;2245;7161;11788;38195;14033;45356
293060;201303;4196;10999;3638;10119;429;1300;2530;6981;2959;8281
293070;201303;18208;58283;17425;56916;4742;16258;9907;32685;14649;48943
293075;201303;3563;11345;3268;11012;180;620;2915;9924;3095;10544
293076;201303;3575;10622;3391;10336;311;865;2835;8875;3146;9740
293077;201303;5130;16122;4507;15349;680;2477;3272;11195;3952;13672
293080;201303;4611;15142;4271;14559;377;1629;3309;11057;3686;12686
293090;201303;3483;11220;2917;10441;269;1044;2348;8498;2617;9542
293100;201303;5427;17315;4783;16188;503;1866;3617;12422;4120;14288
293105;201303;3626;12747;3270;12048;462;1915;2320;8594;2782;10509
293110;201303;1873;5796;1800;5683;110;404;1530;4833;1640;5237
293120;201303;3866;13411;3634;13090;353;1302;2913;10652;3266;11954
293130;201303;3786;11461;3120;10714;204;795;2708;9450;2912;10245
293135;201303;22594;66802;19695;62888;3918;14981;11422;35601;15340;50582
293140;201303;1950;6163;1902;6087;207;848;1475;4583;1682;5431
293150;201303;5691;19048;5260;18227;978;3460;3334;11932;4312;15392
293160;201303;2919;9299;2799;9151;378;1020;2212;7569;2590;8589
293170;201303;3300;10443;3129;10183;450;1570;2328;7714;2778;9284
293180;201303;5161;14963;4441;13887;443;1634;3469;10697;3912;12331
293190;201303;12841;40803;12455;40151;684;2948;10758;34056;11442;37004
293200;201303;5820;18210;5312;17391;369;1444;4550;14743;4919;16187
293210;201303;4523;14272;4307;13911;548;1899;3112;10192;3660;12091
293220;201303;4665;15198;4422;14855;1217;4215;2463;8497;3680;12712
293230;201303;3912;12652;3661;12309;384;1481;2963;9921;3347;11402
293240;201303;4329;11559;3499;10473;215;674;2810;8488;3025;9162
293245;201303;4226;12774;3912;12257;525;1703;2777;8964;3302;10667
293250;201303;5733;17125;5400;16663;893;2846;3828;12001;4721;14847
293260;201303;4511;14082;3840;13102;363;1377;2911;10080;3274;11457
293270;201303;5546;15774;5334;15542;516;1463;4579;13522;5095;14985
293280;201303;5414;16243;4857;15496;464;1417;3795;12552;4259;13969
293290;201303;15542;54703;15129;53849;2998;10806;10043;36625;13041;47431
293300;201303;5874;15774;5174;15000;552;1542;4063;12049;4615;13591
293305;201303;4324;11684;4023;11278;445;1363;3119;8807;3564;10170
293310;201303;2612;7005;2205;6344;330;1052;1457;4157;1787;5209
293315;201303;4640;12339;4226;11677;794;2171;2577;7514;3371;9685
293317;201303;2409;7486;2230;7144;333;1110;1456;4706;1789;5816
293320;201303;7975;26374;7786;26108;851;3162;6337;21160;7188;24322
293325;201303;1846;5621;1549;5151;268;969;1015;3429;1283;4398
293330;201303;51552;169367;47148;161945;10930;40734;26743;93161;37673;133895
293340;201303;2590;7694;2103;6857;261;1006;1498;4794;1759;5800
293345;201303;3163;10092;2673;9366;398;1455;1791;6485;2189;7940
293350;201303;6462;18491;6242;18223;334;932;5652;16735;5986;17667
293360;201303;13137;41036;12189;39780;840;2761;10315;34428;11155;37189
310010;201303;1214;3402;887;2874;259;985;392;1176;651;2161
310020;201303;3649;11926;3170;10864;1187;4365;657;2058;1844;6423
310030;201303;2322;8068;2113;7670;764;2906;824;3049;1588;5955
310040;201303;899;2604;764;2416;126;469;495;1516;621;1985
310050;201303;1929;7039;1718;6511;376;1626;848;3204;1224;4830
310060;201303;2879;10571;2808;10472;310;1230;2299;8638;2609;9868
310070;201303;297;914;222;764;44;189;89;270;133;459
310080;201303;707;2252;590;2024;172;669;198;646;370;1315
310090;201303;4202;13579;3791;12866;723;2718;2388;8134;3111;10852
310100;201303;2985;10036;2686;9614;478;1829;1808;6555;2286;8384
310110;201303;5663;16579;4823;15330;1209;4370;2592;8140;3801;12510
310120;201303;540;1831;517;1794;232;914;196;604;428;1518
310130;201303;451;1490;414;1431;117;460;210;695;327;1155
310140;201303;252;893;218;827;78;331;44;150;122;481
310150;201303;4422;14621;4074;13973;950;3770;2198;7453;3148;11223
310160;201303;6377;21322;5737;20284;1663;6587;2800;9733;4463;16320
310163;201303;604;2164;577;2115;152;637;272;979;424;1616
310170;201303;9305;27837;8646;26821;1907;6345;5121;16438;7028;22783
310180;201303;1729;5270;1421;4887;351;1387;801;2690;1152;4077
310190;201303;2392;8328;2212;8045;711;2897;399;1515;1110;4412
310200;201303;1741;6104;1496;5594;521;2113;472;1749;993;3862
310205;201303;887;2934;815;2779;159;568;506;1752;665;2320
310210;201303;2246;7580;2104;7340;418;1568;1394;4879;1812;6447
310220;201303;1233;3600;1001;3311;178;652;661;2176;839;2828
310230;201303;2670;9302;2411;8713;855;3515;802;2647;1657;6162
310240;201303;982;3589;839;3297;142;612;502;2072;644;2684
310250;201303;910;3287;889;3253;186;773;534;1871;720;2644
310260;201303;3150;10664;2804;9951;975;3806;1004;3429;1979;7235
310270;201303;2173;7086;2015;6863;319;1190;1431;4961;1750;6151
310280;201303;1996;6134;1822;5850;624;2374;672;1968;1296;4342
310285;201303;2237;8126;2147;8009;289;1035;1635;6314;1924;7349
310290;201303;1296;4265;1211;4131;412;1648;546;1641;958;3289
310300;201303;1799;6423;1714;6237;506;2029;934;3343;1440;5372
310310;201303;357;1035;278;860;56;202;138;406;194;608
310320;201303;323;1195;297;1124;84;341;137;521;221;862
310330;201303;461;1243;359;1067;51;192;221;618;272;810
310340;201303;7896;26457;7172;25307;1285;4868;4596;16634;5881;21502
310350;201303;13096;40525;11139;36984;4198;15108;2924;9767;7122;24875
310360;201303;427;1440;416;1420;108;428;248;801;356;1229
310370;201303;1337;5056;1297;4972;496;1949;509;1993;1005;3942
310375;201303;1220;3374;952;2943;137;515;580;1766;717;2281
310380;201303;367;1105;318;1041;147;538;124;370;271;908
310390;201303;422;1579;371;1473;132;569;84;335;216;904
310400;201303;9362;29580;7767;26651;2856;10736;1983;6594;4839;17330
310410;201303;1012;3293;679;2812;301;1333;134;541;435;1874
310420;201303;5282;15842;3083;10518;888;3409;433;1326;1321;4735
310430;201303;1469;5244;1283;4832;484;1946;373;1390;857;3336
310440;201303;613;1855;539;1739;172;635;198;600;370;1235
310445;201303;1152;4055;997;3780;162;697;630;2424;792;3121
310450;201303;4196;13267;3560;12278;766;2860;2163;7628;2929;10488
310460;201303;1392;4731;1235;4445;515;1987;301;1141;816;3128
310470;201303;3611;9807;3090;9167;352;1247;2414;7106;2766;8353
310480;201303;964;3153;875;3006;244;959;392;1270;636;2229
310490;201303;3120;10929;2715;10124;934;3709;937;3585;1871;7294
310500;201303;1379;5011;1302;4863;458;1840;473;1764;931;3604
310510;201303;2415;8177;2142;7556;886;3403;492;1631;1378;5034
310520;201303;1210;3611;1097;3423;85;296;729;2273;814;2569
310530;201303;768;2583;534;1959;124;509;96;334;220;843
310540;201303;3536;12004;3309;11687;1212;4546;1227;4397;2439;8943
310550;201303;1034;3424;895;3185;340;1360;267;902;607;2262
310560;201303;15006;48987;13255;45594;4617;17584;4609;15159;9226;32743
310570;201303;1218;3942;1153;3852;182;702;836;2745;1018;3447
310590;201303;3867;11892;3159;10489;759;2904;1130;3536;1889;6440
310600;201303;1583;5458;1520;5310;534;2089;524;1720;1058;3809
310610;201303;525;1839;481;1740;172;722;157;517;329;1239
310620;201303;184884;611615;154402;548024;49946;194556;56758;194373;106704;388929
310630;201303;3856;13325;3676;12978;1042;4076;2044;7001;3086;11077
310640;201303;1386;4449;1150;4019;365;1405;394;1305;759;2710
310650;201303;2678;9390;2288;8746;496;2036;1328;5254;1824;7290
310660;201303;1239;4046;1118;3872;224;889;774;2608;998;3497
310665;201303;1072;3550;1003;3458;207;762;641;2239;848;3001
310670;201303;52967;173006;49953;166087;16221;57342;22709;73914;38930;131256
310680;201303;788;2437;727;2341;162;582;415;1294;577;1876
310690;201303;1113;3945;945;3566;286;1271;244;857;530;2128
310700;201303;469;1358;408;1264;94;333;209;615;303;948
310710;201303;6870;23602;5830;22187;1457;5776;3170;12762;4627;18538
310720;201303;787;2527;734;2447;217;801;388;1236;605;2037
310730;201303;8899;29591;8361;28784;1876;7008;5257;18196;7133;25204
310740;201303;4647;16495;4107;15367;1745;7085;964;3391;2709;10476
310750;201303;1452;4043;1247;3756;274;888;751;2273;1025;3161
310760;201303;591;1933;520;1815;153;575;207;709;360;1284
310770;201303;664;2550;657;2539;228;928;328;1275;556;2203
310780;201303;3439;10476;3223;10154;289;835;2704;8694;2993;9529
310790;201303;1615;5467;1526;5336;486;1759;802;2893;1288;4652
310800;201303;3046;10309;2558;9317;1139;4514;455;1667;1594;6181
310810;201303;1488;4281;1404;4147;294;970;805;2341;1099;3311
310820;201303;1414;4239;1098;3710;345;1274;419;1384;764;2658
310825;201303;2143;7896;1847;7365;183;900;1368;5438;1551;6338
310830;201303;1469;5149;1258;4709;497;1994;467;1727;964;3721
310840;201303;2126;7414;1972;7105;744;2944;636;2165;1380;5109
310850;201303;1387;4522;1221;4288;273;1059;717;2510;990;3569
310855;201303;2925;9934;2683;9525;799;2968;1318;4881;2117;7849
310860;201303;7495;24503;6826;23388;1199;4406;4100;14396;5299;18802
310870;201303;933;2972;844;2806;183;693;447;1494;630;2187
310880;201303;1209;3871;929;3335;208;851;451;1619;659;2470
310890;201303;2533;8409;2055;7490;703;2836;385;1345;1088;4181
310900;201303;3912;13873;3564;13133;1158;4691;1464;5240;2622;9931
310910;201303;1725;5452;1415;4925;463;1796;479;1645;942;3441
310920;201303;1712;5660;1456;5292;437;1788;703;2507;1140;4295
310925;201303;887;3037;804;2886;327;1277;224;814;551;2091
310930;201303;4722;15507;4262;14777;1061;3765;2464;8758;3525;12523
310940;201303;6025;18714;5320;17627;963;3715;3201;10398;4164;14113
310945;201303;1258;3727;1029;3410;241;918;578;1872;819;2790
310950;201303;1717;6182;1515;5764;670;2756;415;1508;1085;4264
310960;201303;429;1504;388;1425;142;576;130;478;272;1054
310970;201303;1435;5185;1123;4315;464;1916;158;578;622;2494
310980;201303;429;1167;313;959;61;218;137;383;198;601
310990;201303;1081;3864;953;3609;231;1011;378;1341;609;2352
311000;201303;4607;16587;4160;15642;1390;5751;1504;5500;2894;11251
311010;201303;908;3042;807;2860;249;929;379;1318;628;2247
311020;201303;855;2776;745;2585;84;342;520;1796;604;2138
311030;201303;1628;5322;1393;4799;476;1797;532;1659;1008;3456
311040;201303;447;1595;405;1488;127;485;121;433;248;918
311050;201303;2420;8086;2036;7279;717;2776;718;2571;1435;5347
311060;201303;2076;6816;1765;6121;550;2055;424;1451;974;3506
311070;201303;1679;6149;1485;5732;492;2119;450;1724;942;3843
311080;201303;1184;3292;1071;3128;182;623;709;2069;891;2692
311090;201303;1557;6178;1379;5804;520;2451;326;1321;846;3772
311100;201303;2138;7808;1974;7476;948;3718;537;2077;1485;5795
311110;201303;3581;9122;2781;8066;656;2178;1491;4175;2147;6353
311115;201303;1054;3414;921;3209;129;538;625;2205;754;2743
311120;201303;8008;24619;6964;22735;2536;9303;2130;6506;4666;15809
311130;201303;2324;7322;1915;6811;711;2840;780;2683;1491;5523
311140;201303;1161;3573;1016;3407;201;771;684;2237;885;3008
311150;201303;2336;7886;2161;7609;513;1817;1239;4540;1752;6357
311160;201303;4705;16454;4071;15447;1575;6356;1407;5323;2982;11679
311170;201303;689;2291;591;2089;83;322;359;1318;442;1640
311180;201303;1494;4283;1084;3457;347;1212;217;605;564;1817
311190;201303;1074;3352;931;3060;231;857;446;1425;677;2282
311200;201303;2423;7696;2175;7213;1004;3616;504;1511;1508;5127
311205;201303;1114;3823;1014;3638;263;1075;398;1494;661;2569
311210;201303;894;3022;836;2924;126;444;627;2240;753;2684
311220;201303;859;2895;728;2606;203;755;242;854;445;1609
311230;201303;8470;26848;7460;25135;1609;5981;4138;14218;5747;20199
311240;201303;1274;4111;1120;3851;398;1533;363;1209;761;2742
311250;201303;1279;4426;1163;4221;378;1485;383;1300;761;2785
311260;201303;2815;7929;2167;6773;701;2406;675;1991;1376;4397
311265;201303;1236;3495;996;3181;155;618;696;2192;851;2810
311270;201303;3208;11186;2946;10836;628;2609;1920;7042;2548;9651
311280;201303;1305;3757;1031;3301;307;1107;335;1062;642;2169
311290;201303;2263;7591;2115;7277;406;1382;1249;4496;1655;5878
311300;201303;4928;17144;4560;16599;625;2582;3263;11991;3888;14573
311310;201303;483;1771;464;1737;106;491;203;703;309;1194
311320;201303;3880;13552;3407;12478;1105;4580;1181;4103;2286;8683
311330;201303;5240;16720;4615;15770;1646;6108;1848;6247;3494;12355
311340;201303;12016;40479;11270;39065;4609;17063;3144;10957;7753;28020
311350;201303;2082;6679;1845;6271;459;1858;847;2740;1306;4598
311360;201303;1277;3731;1017;3376;479;1683;282;972;761;2655
311370;201303;4305;13531;3923;12869;1081;4192;1720;5492;2801;9684
311380;201303;453;1554;390;1430;137;554;117;394;254;948
311390;201303;1888;7300;1814;7143;823;3512;645;2503;1468;6015
311400;201303;1634;5677;1525;5481;498;2023;648;2142;1146;4165
311410;201303;1931;7208;1819;7046;713;2956;791;3068;1504;6024
311420;201303;2157;7812;1988;7400;789;3104;427;1434;1216;4538
311430;201303;3510;11614;2834;10097;738;2883;616;2147;1354;5030
311440;201303;2010;7430;1746;7019;845;3680;415;1669;1260;5349
311450;201303;2375;8713;2138;8188;925;3783;618;2262;1543;6045
311455;201303;1439;4019;1276;3778;246;880;724;2065;970;2945
311460;201303;575;1971;464;1726;138;623;112;394;250;1017
311470;201303;543;1810;467;1658;146;601;165;568;311;1169
311480;201303;749;2272;730;2240;237;773;349;1015;586;1788
311490;201303;303;1248;294;1214;106;461;99;414;205;875
311500;201303;482;1516;394;1337;188;692;91;294;279;986
311510;201303;2946;9543;2514;8738;1037;3972;670;2219;1707;6191
311520;201303;660;2341;632;2283;255;986;257;903;512;1889
311530;201303;9368;26813;6771;21995;2276;8642;1753;5393;4029;14035
311535;201303;628;2048;492;1762;143;579;121;429;264;1008
311540;201303;666;2535;640;2496;229;925;311;1202;540;2127
311545;201303;1859;6476;1812;6398;386;1471;1170;4168;1556;5639
311547;201303;1616;4699;1415;4391;162;547;972;3051;1134;3598
311550;201303;3076;10743;2815;10238;1081;4388;884;3135;1965;7523
311560;201303;247;712;231;694;62;201;129;376;191;577
311570;201303;1813;4940;1599;4710;145;476;1364;4020;1509;4496
311580;201303;1951;4941;1820;4786;463;1214;1098;2945;1561;4159
311590;201303;335;1138;300;1087;104;431;100;345;204;776
311600;201303;1237;3904;1072;3695;243;819;624;2313;867;3132
311610;201303;3687;13046;3449;12683;923;3374;1855;7353;2778;10727
311615;201303;2364;8369;2166;8039;276;1095;1585;6004;1861;7099
311620;201303;410;1403;368;1340;93;404;194;679;287;1083
311630;201303;1436;4415;1253;4058;182;684;817;2608;999;3292
311640;201303;735;2479;696;2417;102;394;532;1827;634;2221
311650;201303;2375;7000;1994;6359;334;1235;1160;3708;1494;4943
311660;201303;2353;8738;2221;8454;743;3198;676;2285;1419;5483
311670;201303;1239;4116;1108;3864;440;1694;400;1319;840;3013
311680;201303;2167;7133;1863;6735;322;1234;1280;4749;1602;5983
311690;201303;467;1419;412;1362;95;343;255;830;350;1173
311700;201303;2068;6328;1882;6059;220;876;1440;4567;1660;5443
311710;201303;1518;4998;1254;4515;544;2092;372;1365;916;3457
311720;201303;371;1310;357;1289;48;184;264;942;312;1126
311730;201303;3047;9997;2659;9323;873;3319;1184;4021;2057;7340
311740;201303;982;2919;859;2773;374;1189;393;1342;767;2531
311750;201303;3636;12835;3446;12581;625;2542;2337;8553;2962;11095
311760;201303;752;2718;703;2588;265;1113;197;600;462;1713
311770;201303;2552;8315;2160;7650;657;2645;745;2547;1402;5192
311780;201303;866;3425;755;3131;300;1373;88;351;388;1724
311783;201303;1970;6747;1788;6399;217;945;1162;4262;1379;5207
311787;201303;658;2326;516;1918;121;485;124;431;245;916
311790;201303;1038;3602;891;3280;303;1201;161;559;464;1760
311800;201303;4662;16760;4134;15326;1430;5612;768;2465;2198;8077
311810;201303;1000;3432;978;3394;35;168;896;3078;931;3246
311820;201303;766;2609;682;2442;256;1047;291;946;547;1993
311830;201303;9869;36734;9329;35400;4085;16283;2458;9244;6543;25527
311840;201303;3243;10130;2769;9399;985;3661;992;3338;1977;6999
311850;201303;304;958;264;893;73;270;124;413;197;683
311860;201303;52609;176288;47559;166360;15343;58398;19907;67897;35250;126295
311870;201303;2189;6838;1870;6257;501;1916;773;2499;1274;4415
311880;201303;6366;21161;6006;20702;852;3109;4505;15874;5357;18983
311890;201303;1542;5064;1338;4650;441;1689;535;1796;976;3485
311900;201303;774;2490;702;2388;178;615;403;1440;581;2055
311910;201303;4526;13986;3737;12869;1229;4614;1497;5193;2726;9807
311920;201303;1862;6505;1658;6227;272;1168;1157;4267;1429;5435
311930;201303;4577;14334;4195;13714;1612;5725;1432;4671;3044;10396
311940;201303;13753;44240;12430;41565;4661;16836;3740;12438;8401;29274
311950;201303;2066;6650;1868;6390;161;598;1538;5284;1699;5882
311960;201303;329;1230;320;1216;101;391;165;635;266;1026
311970;201303;443;1660;395;1559;163;693;60;219;223;912
311980;201303;698;2047;558;1856;145;516;259;884;404;1400
311990;201303;447;1445;418;1393;182;620;147;487;329;1107
311995;201303;953;3019;774;2635;267;1036;257;759;524;1795
312000;201303;661;2157;635;2117;118;457;388;1284;506;1741
312010;201303;987;3323;922;3207;217;828;435;1511;652;2339
312015;201303;1531;4987;1348;4674;210;854;831;2910;1041;3764
312020;201303;845;2891;757;2764;241;975;359;1277;600;2252
312030;201303;1589;5361;1471;5200;239;1039;1043;3573;1282;4612
312040;201303;667;2639;619;2506;253;1098;172;686;425;1784
312050;201303;1469;5205;1289;4828;485;1999;354;1273;839;3272
312060;201303;756;2389;693;2312;228;831;375;1217;603;2048
312070;201303;769;2598;583;2172;195;791;207;748;402;1539
312080;201303;2499;7314;2016;6542;561;2235;888;2605;1449;4840
312083;201303;838;2614;727;2459;80;328;494;1661;574;1989
312087;201303;2200;7131;1990;6861;394;1418;1365;4809;1759;6227
312090;201303;9344;31472;8679;30317;2587;10209;3995;13415;6582;23624
312100;201303;1326;4662;1196;4463;261;1099;676;2577;937;3676
312110;201303;1173;4373;1075;4172;442;1877;232;844;674;2721
312120;201303;869;3093;791;2919;273;1166;227;737;500;1903
312125;201303;980;3333;877;3088;255;990;320;1066;575;2056
312130;201303;677;2223;571;2007;185;704;209;717;394;1421
312140;201303;1410;4561;1215;4103;324;1152;444;1435;768;2587
312150;201303;592;1753;528;1645;111;409;307;913;418;1322
312160;201303;7530;27275;7073;26359;2343;9393;2895;11120;5238;20513
312170;201303;987;3101;919;2966;166;575;570;1880;736;2455
312180;201303;1498;4940;1441;4853;519;1797;607;2102;1126;3899
312190;201303;563;1996;481;1837;202;811;144;548;346;1359
312200;201303;4210;13874;3745;12993;587;2199;2464;8620;3051;10819
312210;201303;1068;3132;893;2891;236;869;452;1409;688;2278
312220;201303;1717;5927;1587;5771;313;1144;1087;4168;1400;5312
312230;201303;16726;58172;14682;53958;7258;28231;2665;10118;9923;38349
312235;201303;1704;5026;1412;4558;180;733;964;3108;1144;3841
312240;201303;1076;3791;944;3516;298;1174;329;1241;627;2415
312245;201303;2274;6937;2021;6584;181;531;1671;5602;1852;6133
312247;201303;844;2632;684;2398;207;781;354;1278;561;2059
312250;201303;1053;3334;988;3233;200;784;597;1910;797;2694
312260;201303;869;2979;766;2843;114;525;541;1970;655;2495
312270;201303;758;2513;662;2320;193;807;202;598;395;1405
312280;201303;456;1616;419;1519;180;699;56;202;236;901
312290;201303;688;2510;645;2451;317;1325;117;439;434;1764
312300;201303;1029;3536;899;3243;317;1215;134;428;451;1643
312310;201303;878;3513;799;3303;282;1254;303;1240;585;2494
312320;201303;2311;6725;2046;6279;616;2188;729;1946;1345;4134
312330;201303;1025;3373;971;3279;371;1380;384;1272;755;2652
312340;201303;289;792;275;773;38;139;219;591;257;730
312350;201303;348;938;335;920;52;167;265;697;317;864
312352;201303;1550;5330;1460;5196;516;1881;742;2704;1258;4585
312360;201303;3438;12160;3077;11407;1123;4442;697;2588;1820;7030
312370;201303;1532;5271;1424;5078;486;1956;574;1983;1060;3939
312380;201303;1825;5655;1736;5527;281;985;1168;3785;1449;4770
312385;201303;1091;3716;1068;3683;144;605;804;2703;948;3308
312390;201303;1897;6746;1748;6430;639;2527;468;1665;1107;4192
312400;201303;3173;11071;3001;10735;1009;3745;1442;5269;2451;9014
312410;201303;9735;34148;8931;32490;3070;12141;2935;10420;6005;22561
312420;201303;3737;12666;3588;12491;685;2475;2533;9012;3218;11487
312430;201303;8131;25337;7212;23969;1527;5284;4417;15279;5944;20563
312440;201303;502;1746;447;1638;160;626;152;549;312;1175
312450;201303;1065;4140;1018;4018;494;1936;324;1310;818;3246
312460;201303;370;1204;333;1162;96;390;140;449;236;839
312470;201303;698;2068;494;1649;147;569;97;304;244;873
312480;201303;1215;3977;1073;3805;434;1604;426;1505;860;3109
312490;201303;2250;6085;1833;5556;322;1160;1093;3194;1415;4354
312500;201303;554;2072;524;2015;154;663;271;1027;425;1690
312510;201303;1671;6151;1502;5750;481;2071;432;1490;913;3561
312520;201303;354;1272;329;1220;124;486;106;396;230;882
312530;201303;530;1815;505;1761;120;484;256;847;376;1331
312540;201303;1430;4854;1212;4411;242;982;726;2618;968;3600
312550;201303;562;2017;537;1967;78;327;358;1303;436;1630
312560;201303;1793;5386;1694;5239;266;860;1211;3828;1477;4688
312570;201303;2580;8252;2302;7733;787;2865;670;2170;1457;5035
312580;201303;521;1813;422;1612;123;528;180;663;303;1191
312590;201303;1758;6273;1555;5815;564;2341;512;1794;1076;4135
312595;201303;1984;7019;1822;6651;341;1345;1141;4143;1482;5488
312600;201303;733;2782;694;2687;244;1048;233;840;477;1888
312610;201303;8110;26414;7114;24439;2788;10268;2048;6870;4836;17138
312620;201303;1788;5711;1485;5322;74;214;1310;4868;1384;5082
312630;201303;481;1676;451;1622;124;515;196;666;320;1181
312640;201303;537;1841;469;1711;121;513;226;790;347;1303
312650;201303;2227;6899;1631;5741;177;754;867;2983;1044;3737
312660;201303;1167;3440;1022;3243;225;826;585;1802;810;2628
312670;201303;5741;18896;5470;18478;835;3240;3987;13426;4822;16666
312675;201303;1421;4697;1303;4467;272;1013;760;2671;1032;3684
312680;201303;1628;5164;1477;4883;319;1186;846;2823;1165;4009
312690;201303;2256;6574;1949;6165;407;1551;1137;3420;1544;4971
312695;201303;843;3131;797;3056;140;560;535;2098;675;2658
312700;201303;2026;6147;1577;5290;361;1382;791;2596;1152;3978
312705;201303;1338;4146;1193;3950;230;769;786;2653;1016;3422
312707;201303;1773;5700;1514;5258;378;1479;721;2515;1099;3994
312710;201303;7497;22284;5842;19334;2428;8875;1412;4384;3840;13259
312720;201303;718;2474;654;2356;196;780;259;873;455;1653
312730;201303;1758;4789;1407;4394;267;991;856;2642;1123;3633
312733;201303;1668;4707;1375;4166;146;555;950;2788;1096;3343
312735;201303;799;2638;719;2496;259;957;310;1052;569;2009
312737;201303;930;2377;696;2066;167;536;367;1128;534;1664
312738;201303;478;1579;395;1424;143;601;146;472;289;1073
312740;201303;474;1398;340;1246;148;586;119;439;267;1025
312750;201303;1252;4749;1204;4650;346;1460;573;2209;919;3669
312760;201303;2263;7707;1871;6957;677;2746;444;1698;1121;4444
312770;201303;40672;116819;32537;104990;10516;36755;10754;35119;21270;71874
312780;201303;2285;8944;2108;8645;441;1944;1272;5400;1713;7344
312790;201303;290;875;240;794;82;288;64;206;146;494
312800;201303;4727;17063;4279;16089;1501;5999;1371;5322;2872;11321
312810;201303;2131;6776;1680;6071;750;2965;510;1796;1260;4761
312820;201303;2008;6332;1926;6186;278;1058;1266;3941;1544;4999
312825;201303;1439;4113;1289;3922;141;484;1031;3103;1172;3587
312830;201303;2511;8378;1915;7175;648;2734;257;887;905;3621
312840;201303;1009;3625;894;3412;292;1240;281;1012;573;2252
312850;201303;663;2299;594;2150;181;731;206;742;387;1473
312860;201303;1278;3813;1011;3437;364;1462;416;1258;780;2720
312870;201303;5327;17482;4278;15605;1519;6261;1329;4666;2848;10927
312880;201303;1020;3255;879;3020;316;1213;349;1101;665;2314
312890;201303;1452;4712;1168;4198;454;1814;332;1146;786;2960
312900;201303;1260;4477;1228;4431;463;1698;568;2102;1031;3800
312910;201303;1418;3497;1196;3210;339;1106;587;1462;926;2568
312920;201303;863;3038;765;2886;266;1059;308;1199;574;2258
312930;201303;2058;6450;1873;6170;458;1615;978;3294;1436;4909
312940;201303;881;3109;794;2937;271;1146;244;852;515;1998
312950;201303;2981;9233;2643;8746;937;3320;1179;3921;2116;7241
312960;201303;1818;5800;1640;5559;217;740;1213;4231;1430;4971
312965;201303;1659;5650;1476;5320;366;1412;819;3027;1185;4439
312970;201303;1103;3877;992;3726;466;1943;161;605;627;2548
312980;201303;19380;70997;18834;69668;7774;30679;6893;24918;14667;55597
312990;201303;324;1054;264;959;108;430;76;267;184;697
313000;201303;463;1686;436;1637;161;699;116;401;277;1100
313005;201303;2427;8293;2181;7880;309;1304;1533;5504;1842;6808
313010;201303;3676;12839;3323;12229;1097;4457;1305;4507;2402;8964
313020;201303;1006;3451;930;3299;319;1293;349;1098;668;2391
313030;201303;1515;4444;1250;4059;353;1287;652;2023;1005;3310
313040;201303;919;3323;788;2932;198;815;206;722;404;1537
313050;201303;1737;6007;1490;5608;557;2283;429;1556;986;3839
313055;201303;1339;4750;1263;4636;120;439;980;3716;1100;4155
313060;201303;901;3254;859;3161;412;1568;159;586;571;2154
313065;201303;1808;6306;1703;6151;232;973;1301;4643;1533;5616
313070;201303;1089;3447;940;3176;252;1001;491;1561;743;2562
313080;201303;434;1462;366;1328;131;533;96;304;227;837
313090;201303;4540;15104;4394;14873;1107;3869;2665;9302;3772;13171
313100;201303;948;3247;898;3186;183;760;590;1995;773;2755
313110;201303;1598;5001;1296;4426;359;1445;515;1642;874;3087
313115;201303;2797;10300;2685;10074;972;4040;1138;4050;2110;8090
313120;201303;3570;10842;3131;10217;1152;3953;1406;4649;2558;8602
313130;201303;24959;82787;23112;78819;7256;27494;8601;27900;15857;55394
313140;201303;733;1967;544;1663;63;240;327;974;390;1214
313150;201303;1559;5084;1448;4872;685;2382;366;1276;1051;3658
313160;201303;1140;3567;1029;3396;273;1041;558;1765;831;2806
313170;201303;9076;34950;8673;33868;3777;15220;1891;7562;5668;22782
313180;201303;2557;7018;2025;6337;685;2412;700;2162;1385;4574
313190;201303;3181;12282;3102;12099;996;4088;1298;5082;2294;9170
313200;201303;1403;4655;1273;4438;210;906;793;2744;1003;3650
313210;201303;4450;14725;3844;13905;837;3396;2287;8247;3124;11643
313220;201303;1057;3482;927;3211;302;1204;225;676;527;1880
313230;201303;2302;8598;2220;8467;417;1665;1410;5636;1827;7301
313240;201303;6992;25695;6252;24228;2058;8655;2426;9416;4484;18071
313250;201303;7455;24540;7027;24016;798;2595;5466;19548;6264;22143
313260;201303;556;1860;491;1727;166;657;134;452;300;1109
313270;201303;5054;16053;4642;15428;1145;4038;2712;9221;3857;13259
313280;201303;504;1767;438;1609;117;496;167;597;284;1093
313290;201303;1016;3817;881;3546;340;1470;212;810;552;2280
313300;201303;1851;6600;1692;6228;564;2251;513;1791;1077;4042
313310;201303;1010;3677;928;3496;297;1265;232;824;529;2089
313320;201303;2297;7374;1993;6839;358;1304;1045;3658;1403;4962
313330;201303;3729;13019;3466;12529;788;3170;1806;6572;2594;9742
313340;201303;2072;5143;1630;4516;342;1046;948;2548;1290;3594
313350;201303;3205;10363;2572;8972;890;3422;582;1890;1472;5312
313360;201303;1125;3635;891;3156;326;1330;341;1087;667;2417
313370;201303;1377;4979;1328;4847;294;1249;634;2167;928;3416
313375;201303;1778;4945;1264;4258;293;1214;628;2065;921;3279
313380;201303;6258;22394;5550;20809;2395;9526;1373;4914;3768;14440
313390;201303;858;3287;823;3225;155;711;500;1929;655;2640
313400;201303;3520;11116;3285;10833;446;1562;2481;8291;2927;9853
313410;201303;1319;3946;1142;3714;244;875;712;2319;956;3194
313420;201303;17434;45788;11892;35583;3159;10776;3233;9262;6392;20038
313430;201303;1248;4261;1134;4059;380;1509;412;1451;792;2960
313440;201303;5937;15051;4657;13585;832;2629;3259;9522;4091;12151
313450;201303;669;2091;576;1915;176;706;191;567;367;1273
313460;201303;2579;9469;2366;9110;932;3860;745;2770;1677;6630
313470;201303;3298;9524;3158;9361;340;1017;2619;7864;2959;8881
313480;201303;1076;3332;835;2891;199;783;331;1106;530;1889
313490;201303;1141;4449;1042;4172;468;1838;185;781;653;2619
313500;201303;417;1375;398;1344;103;395;229;758;332;1153
313505;201303;7644;24202;7254;23701;562;1544;6271;21251;6833;22795
313507;201303;1250;3958;1138;3785;265;1005;654;2187;919;3192
313510;201303;15006;46711;13586;44896;2633;9255;8996;30192;11629;39447
313520;201303;15203;48164;13437;45452;2010;7909;9167;30963;11177;38872
313530;201303;489;1769;437;1630;72;308;181;637;253;945
313535;201303;2373;7474;2162;7130;373;1359;1372;4568;1745;5927
313540;201303;1106;3583;932;3178;289;1059;264;856;553;1915
313545;201303;1337;5122;1207;4904;232;1124;772;3073;1004;4197
313550;201303;1819;6565;1775;6461;527;2089;948;3345;1475;5434
313560;201303;2163;5679;1959;5442;190;512;1602;4572;1792;5084
313570;201303;745;2918;675;2776;259;1138;281;1145;540;2283
313580;201303;5801;17448;5251;16728;597;2028;4133;13282;4730;15310
313590;201303;1035;3233;863;3034;330;1166;474;1728;804;2894
313600;201303;3761;11851;3373;11217;723;2668;1976;6611;2699;9279
313610;201303;1073;3552;953;3307;284;1062;369;1273;653;2335
313620;201303;7310;25113;6918;24262;2480;9291;2287;7848;4767;17139
313630;201303;7948;26210;7101;24970;2471;9489;2312;8481;4783;17970
313640;201303;820;2719;735;2606;267;1019;298;1058;565;2077
313650;201303;2247;7615;2022;7244;306;1152;1475;5417;1781;6569
313652;201303;956;3601;895;3462;185;756;526;2044;711;2800
313655;201303;898;3200;785;3018;180;787;497;1880;677;2667
313657;201303;1040;3736;1005;3673;190;896;658;2209;848;3105
313660;201303;849;3093;790;2989;228;991;397;1424;625;2415
313665;201303;3403;11788;3211;11398;960;3826;1389;4756;2349;8582
313670;201303;49308;149733;36714;129041;13106;50229;11432;39177;24538;89406
313680;201303;1049;3240;936;3078;112;390;683;2280;795;2670
313690;201303;834;3086;787;3009;240;925;336;1350;576;2275
313695;201303;1457;4975;1276;4692;215;936;888;3202;1103;4138
313700;201303;3667;12966;3197;12290;457;1881;2334;9042;2791;10923
313710;201303;1318;3919;1149;3678;321;1138;642;1986;963;3124
313720;201303;4880;17217;4397;16131;1319;5422;1370;4542;2689;9964
313730;201303;1208;3534;1009;3278;146;520;697;2305;843;2825
313740;201303;1950;7322;1632;6468;661;2894;258;997;919;3891
313750;201303;2814;8932;2519;8370;858;3128;686;2127;1544;5255
313753;201303;1727;5460;1520;5093;486;1762;651;2190;1137;3952
313760;201303;4015;14166;3685;13487;1383;5591;1209;4199;2592;9790
313770;201303;3594;12499;3445;12152;1280;4764;1043;3700;2323;8464
313780;201303;3616;11007;2992;10077;982;3684;1189;3947;2171;7631
313790;201303;549;1963;532;1935;107;424;317;1160;424;1584
313800;201303;1188;3549;1090;3399;185;683;729;2234;914;2917
313810;201303;1343;4481;1296;4406;359;1261;680;2375;1039;3636
313820;201303;12381;37730;10287;33901;3476;12766;3212;10473;6688;23239
313830;201303;448;1613;386;1479;154;668;99;357;253;1025
313835;201303;1046;3640;1009;3578;242;930;556;1973;798;2903
313840;201303;6714;21517;5928;20217;1884;7219;2201;7275;4085;14494
313850;201303;1226;3555;1131;3394;243;857;686;1963;929;2820
313860;201303;2448;7982;2192;7451;739;2821;548;1685;1287;4506
313862;201303;868;2631;649;2269;234;881;173;572;407;1453
313865;201303;2086;6996;1966;6782;348;1359;1329;4524;1677;5883
313867;201303;944;3420;825;3174;244;978;378;1489;622;2467
313868;201303;1381;5211;1279;4987;264;1124;777;3059;1041;4183
313870;201303;901;2859;800;2689;220;864;364;1148;584;2012
313880;201303;2205;7248;2025;6983;514;2093;1021;3238;1535;5331
313890;201303;1933;5594;1682;5294;193;629;1252;4033;1445;4662
313900;201303;4381;16668;4178;16257;1804;7672;1113;4359;2917;12031
313910;201303;730;2573;631;2358;294;1195;129;458;423;1653
313920;201303;3401;11539;3191;11171;526;1802;2119;7810;2645;9612
313925;201303;2076;5705;1582;4804;142;507;1064;3204;1206;3711
313930;201303;5066;17388;4408;16244;877;3554;2570;9671;3447;13225
313940;201303;7432;27208;6605;25845;2865;11816;2226;9051;5091;20867
313950;201303;4411;13670;3907;12852;1191;4334;1564;5134;2755;9468
313960;201303;5469;16018;4817;15064;1756;6114;1382;4384;3138;10498
313970;201303;1386;4298;1194;4079;279;1033;722;2475;1001;3508
313980;201303;1129;3926;974;3624;323;1325;234;852;557;2177
313990;201303;1978;7683;1801;7294;709;3096;528;2035;1237;5131
314000;201303;7405;26980;6963;26114;2216;9017;3336;12494;5552;21511
314010;201303;1013;3124;861;2936;190;716;453;1529;643;2245
314015;201303;1558;6023;1446;5761;594;2483;414;1691;1008;4174
314020;201303;478;1597;415;1455;162;625;137;458;299;1083
314030;201303;806;2680;646;2305;171;739;188;582;359;1321
314040;201303;674;2127;617;2035;75;286;465;1522;540;1808
314050;201303;1814;6139;1559;5613;521;2070;414;1372;935;3442
314053;201303;1242;4510;1192;4445;225;802;864;3311;1089;4113
314055;201303;2142;6681;1963;6442;229;777;1474;4947;1703;5724
314060;201303;1045;3492;921;3257;153;647;549;1898;702;2545
314070;201303;3514;11815;2986;10751;979;3893;923;3214;1902;7107
314080;201303;1720;5651;1350;4846;361;1500;357;1185;718;2685
314085;201303;1727;6539;1537;6279;562;2480;636;2630;1198;5110
314090;201303;3392;12019;3145;11539;1030;3999;1266;4819;2296;8818
314100;201303;3182;9363;2836;8862;371;1266;2113;6660;2484;7926
314110;201303;4276;14612;3805;13613;1037;4281;1496;4968;2533;9249
314120;201303;902;2254;540;1718;216;789;127;369;343;1158
314130;201303;590;1886;410;1463;144;576;83;275;227;851
314140;201303;4827;15822;4447;15129;1163;4321;2338;8008;3501;12329
314150;201303;1653;4595;1345;4139;223;758;835;2555;1058;3313
314160;201303;2081;6215;1842;5906;230;809;1439;4634;1669;5443
314170;201303;1010;3312;892;3052;193;782;467;1508;660;2290
314180;201303;6210;21147;5765;20495;1735;6671;2685;9746;4420;16417
314190;201303;787;2595;706;2458;226;885;275;925;501;1810
314200;201303;2906;9952;2687;9557;459;1870;1802;6306;2261;8176
314210;201303;1858;6255;1711;5959;460;1744;853;2874;1313;4618
314220;201303;1585;5499;1416;5137;485;1925;504;1672;989;3597
314225;201303;1119;3609;1010;3454;62;180;910;3179;972;3359
314230;201303;688;2475;644;2387;218;876;230;822;448;1698
314240;201303;1062;3519;980;3383;234;801;592;2103;826;2904
314250;201303;468;1576;412;1471;156;630;149;486;305;1116
314260;201303;1253;4643;1213;4574;463;1834;496;1920;959;3754
314270;201303;2655;9591;2516;9334;403;1622;1621;6082;2024;7704
314280;201303;3086;9247;2341;7836;785;3012;642;1886;1427;4898
314290;201303;5159;15210;4512;14203;583;2048;3277;10325;3860;12373
314300;201303;1876;6594;1786;6386;618;2339;764;2714;1382;5053
314310;201303;6160;20708;5563;19375;2424;8980;1173;3955;3597;12935
314315;201303;942;3706;887;3593;173;775;503;2081;676;2856
314320;201303;3142;10025;2655;9347;1059;4034;815;2802;1874;6836
314330;201303;49001;167593;47193;164319;15688;59032;21901;75486;37589;134518
314340;201303;1885;5738;1273;4483;404;1617;169;424;573;2041
314345;201303;1270;4495;1140;4289;415;1594;524;2079;939;3673
314350;201303;1231;4044;1092;3802;490;1821;298;1054;788;2875
314360;201303;679;2265;541;2015;188;820;136;446;324;1266
314370;201303;530;1953;498;1911;169;709;252;947;421;1656
314380;201303;967;3171;799;2891;304;1154;298;1068;602;2222
314390;201303;14318;45613;12442;42074;4339;15851;3942;13198;8281;29049
314400;201303;5103;15136;4269;13954;988;3171;2809;9548;3797;12719
314410;201303;2410;8191;2193;7771;734;2929;882;2963;1616;5892
314420;201303;752;2298;638;2146;100;406;468;1547;568;1953
314430;201303;8078;24921;7310;23500;2576;9009;2335;7735;4911;16744
314435;201303;1091;3859;996;3656;239;1080;503;1729;742;2809
314437;201303;1113;2962;1012;2825;102;294;802;2256;904;2550
314440;201303;726;2056;506;1766;200;777;108;360;308;1137
314450;201303;1695;5258;1469;4933;486;1939;677;2117;1163;4056
314460;201303;4461;16043;4031;15103;1500;6088;794;3027;2294;9115
314465;201303;2313;7729;2133;7393;234;953;1632;5597;1866;6550
314467;201303;1050;3200;957;3047;440;1430;347;1139;787;2569
314470;201303;2282;7762;1809;6615;576;2410;392;1244;968;3654
314480;201303;6949;24804;5486;20823;1505;6189;603;2116;2108;8305
314490;201303;915;2933;802;2712;258;1012;315;996;573;2008
314500;201303;2695;7946;2202;6977;718;2561;730;2275;1448;4836
314505;201303;1616;5437;1542;5295;388;1469;813;2758;1201;4227
314510;201303;1358;4566;1203;4271;541;2019;349;1220;890;3239
314520;201303;3442;14014;3030;12791;1242;5630;593;2363;1835;7993
314530;201303;6962;25824;6426;24934;1327;5383;3762;15184;5089;20567
314535;201303;2584;7797;2331;7465;373;1399;1564;4999;1937;6398
314537;201303;1408;4479;1211;4131;274;1035;627;2238;901;3273
314540;201303;450;1424;396;1298;130;489;117;352;247;841
314545;201303;1240;4232;1161;4102;251;969;675;2418;926;3387
314550;201303;490;1619;422;1525;167;702;116;397;283;1099
314560;201303;5079;18730;4435;16996;1431;5946;882;3365;2313;9311
314570;201303;371;1200;336;1130;99;359;160;512;259;871
314580;201303;450;1610;390;1492;161;676;93;342;254;1018
314585;201303;602;2286;529;2142;182;813;130;524;312;1337
314587;201303;1633;5566;1545;5371;268;1022;945;3273;1213;4295
314590;201303;3807;13770;3017;11610;845;3485;409;1458;1254;4943
314600;201303;1960;6975;1649;6419;657;2845;279;1001;936;3846
314610;201303;7775;29049;7374;28102;2727;11189;2205;8228;4932;19417
314620;201303;1598;5080;1500;4959;236;759;1107;3779;1343;4538
314625;201303;1317;4509;1271;4420;269;989;770;2773;1039;3762
314630;201303;4848;15020;4277;14061;573;2174;3012;10029;3585;12203
314640;201303;783;2382;705;2243;260;897;213;642;473;1539
314650;201303;1206;3882;1007;3485;295;1189;414;1298;709;2487
314655;201303;1665;5280;1379;4772;257;1020;786;2696;1043;3716
314660;201303;127;409;121;397;20;72;84;279;104;351
314670;201303;1329;3949;1114;3572;266;951;538;1700;804;2651
314675;201303;1851;5881;1683;5584;232;841;1116;3776;1348;4617
314690;201303;2689;8822;2313;8150;765;3060;712;2361;1477;5421
314700;201303;9666;37882;8833;36144;4297;18273;2044;8887;6341;27160
314710;201303;7110;24547;5543;20956;1623;6845;763;2696;2386;9541
314720;201303;2521;8806;2167;8116;763;3141;896;3291;1659;6432
314730;201303;2320;7679;2040;7262;705;2792;646;2208;1351;5000
314740;201303;2855;10097;2666;9734;934;3663;1024;3653;1958;7316
314750;201303;306;1059;290;1025;62;269;160;537;222;806
314760;201303;1875;6907;1494;5853;378;1703;261;873;639;2576
314770;201303;1179;3868;827;2902;171;693;101;289;272;982
314780;201303;279;819;216;739;79;298;86;296;165;594
314790;201303;13006;41271;10146;36138;4236;16965;2410;8091;6646;25056
314795;201303;1418;4633;1283;4422;171;770;948;3128;1119;3898
314800;201303;16428;51942;14045;47222;6026;21311;2918;10091;8944;31402
314810;201303;12336;39136;9936;34668;3491;13688;2518;8669;6009;22357
314820;201303;1018;2979;746;2621;327;1260;244;778;571;2038
314830;201303;1593;5679;1402;5296;544;2230;462;1754;1006;3984
314840;201303;1124;4053;903;3721;191;886;532;2217;723;3103
314850;201303;2160;6540;1901;6144;404;1511;1063;3422;1467;4933
314860;201303;3150;11480;2978;11216;606;2466;1905;7262;2511;9728
314870;201303;5473;18555;4954;17817;906;3637;3233;11873;4139;15510
314875;201303;1641;5812;1613;5770;304;1015;1239;4566;1543;5581
314880;201303;713;2284;657;2168;142;484;368;1221;510;1705
314890;201303;555;1772;415;1491;157;623;102;319;259;942
314900;201303;335;1116;286;1035;88;345;137;476;225;821
314910;201303;1653;5977;1490;5714;707;2931;358;1296;1065;4227
314915;201303;2329;7586;2105;7286;208;887;1721;5900;1929;6787
314920;201303;596;1868;510;1764;104;411;265;882;369;1293
314930;201303;4846;17157;4309;15975;1629;6611;880;3265;2509;9876
314940;201303;400;1229;380;1190;85;265;211;660;296;925
314950;201303;338;1269;296;1174;89;413;54;195;143;608
314960;201303;744;2543;649;2362;221;875;188;656;409;1531
314970;201303;780;2942;742;2885;334;1394;242;919;576;2313
314980;201303;2171;6824;1999;6551;875;3093;333;1053;1208;4146
314990;201303;2864;9666;2423;8672;1048;4080;364;1174;1412;5254
314995;201303;1430;4832;1333;4685;304;1277;818;2732;1122;4009
315000;201303;942;3043;844;2916;175;705;523;1763;698;2468
315010;201303;458;1560;395;1419;146;613;135;422;281;1035
315015;201303;1702;5540;1621;5448;345;1218;1125;3884;1470;5102
315020;201303;716;2488;651;2362;211;868;240;782;451;1650
315030;201303;987;3126;857;2882;353;1292;171;568;524;1860
315040;201303;894;2866;826;2752;116;443;582;1905;698;2348
315050;201303;1475;4666;1286;4335;516;1902;355;1151;871;3053
315053;201303;1048;3296;922;3089;269;1076;347;1081;616;2157
315057;201303;1850;6677;1541;6214;252;1050;1025;4300;1277;5350
315060;201303;934;3251;795;2888;263;1039;207;775;470;1814
315070;201303;590;1833;551;1776;148;513;336;1067;484;1580
315080;201303;3323;11968;3100;11532;949;3767;1383;5174;2332;8941
315090;201303;738;2729;664;2583;211;895;247;999;458;1894
315100;201303;1133;4069;933;3615;282;1255;281;1047;563;2302
315110;201303;1495;4738;1340;4493;406;1457;566;1888;972;3345
315120;201303;11447;30639;9274;27884;1829;6073;5378;16878;7207;22951
315130;201303;1696;5836;1558;5569;617;2432;432;1499;1049;3931
315140;201303;2164;7588;1831;6843;589;2479;469;1534;1058;4013
315150;201303;4227;12301;3434;10924;942;3457;1314;3963;2256;7420
315160;201303;1284;3765;1178;3637;226;792;780;2351;1006;3143
315170;201303;1283;3999;1143;3814;297;1102;674;2286;971;3388
315180;201303;12037;39657;10029;35358;3241;13020;2625;8882;5866;21902
315190;201303;2290;6410;1876;5808;590;1976;849;2633;1439;4609
315200;201303;3988;14127;3531;13168;1191;4853;1012;3654;2203;8507
315210;201303;7982;25964;7134;24458;2911;10739;2128;7169;5039;17908
315213;201303;1009;3472;971;3412;148;527;705;2545;853;3072
315217;201303;2567;9162;2254;8600;419;1797;1372;5240;1791;7037
315220;201303;9671;29910;8761;28728;1187;4366;6360;21007;7547;25373
315230;201303;2208;6285;2079;6131;165;510;1734;5166;1899;5676
315240;201303;2975;10441;2843;10215;676;2625;1653;5934;2329;8559
315250;201303;7573;26340;6262;23978;2346;10022;2009;7626;4355;17648
315260;201303;1041;3606;913;3328;383;1526;157;533;540;2059
315270;201303;848;3104;742;2868;266;1102;151;545;417;1647
315280;201303;3662;11814;3134;10622;1188;4292;815;2633;2003;6925
315290;201303;1267;3766;1006;3355;427;1578;158;510;585;2088
315300;201303;447;1361;365;1258;196;724;84;264;280;988
315310;201303;1144;4025;1082;3932;143;598;753;2708;896;3306
315320;201303;761;2808;680;2679;252;1027;282;1169;534;2196
315330;201303;816;3051;685;2769;281;1245;167;688;448;1933
315340;201303;3994;12005;3490;11227;636;2198;2144;6999;2780;9197
315350;201303;1755;5256;1532;4955;180;545;1218;4083;1398;4628
315360;201303;1559;5525;1375;5046;382;1485;483;1719;865;3204
315370;201303;604;1868;537;1769;143;528;284;906;427;1434
315380;201303;271;995;254;945;97;375;47;175;144;550
315390;201303;1892;6895;1646;6278;606;2471;342;1288;948;3759
315400;201303;4234;13974;3968;13462;1182;4232;1955;6854;3137;11086
315410;201303;1534;4580;1305;4173;266;1043;733;2247;999;3290
315415;201303;1017;3620;959;3510;480;1810;305;1147;785;2957
315420;201303;1495;4829;1164;4261;404;1603;285;1003;689;2606
315430;201303;3841;11179;3079;9922;827;2893;1219;4007;2046;6900
315440;201303;934;2958;863;2864;124;467;593;1996;717;2463
315445;201303;1995;6186;1763;5877;304;1114;1215;4111;1519;5225
315450;201303;2422;8076;2327;7943;401;1406;1682;5883;2083;7289
315460;201303;36889;127849;33396;120331;11470;44997;10063;34990;21533;79987
315470;201303;465;1543;435;1495;106;401;241;798;347;1199
315480;201303;1402;4881;1124;4243;318;1302;253;919;571;2221
315490;201303;3151;9262;2815;8821;525;2021;1855;5591;2380;7612
315500;201303;456;1527;317;1166;76;330;130;419;206;749
315510;201303;1450;4408;1263;4093;190;757;787;2484;977;3241
315520;201303;1097;3629;945;3430;194;787;614;2177;808;2964
315530;201303;472;1709;448;1670;217;863;136;475;353;1338
315540;201303;1246;3924;1035;3607;221;952;479;1638;700;2590
315550;201303;1530;4777;1375;4568;466;1685;618;2036;1084;3721
315560;201303;6512;23359;6229;22965;993;3931;4431;16514;5424;20445
315570;201303;2299;7438;2186;7290;359;1334;1527;5110;1886;6444
315580;201303;2545;8273;2111;7437;643;2623;756;2531;1399;5154
315590;201303;850;2567;798;2488;116;441;584;1789;700;2230
315600;201303;2489;9429;2125;8879;330;1500;1414;6157;1744;7657
315610;201303;922;2890;817;2671;243;936;259;705;502;1641
315620;201303;320;1165;315;1154;105;405;143;525;248;930
315630;201303;967;3188;837;2969;248;910;257;918;505;1828
315640;201303;731;2403;646;2222;249;977;196;620;445;1597
315645;201303;744;2559;663;2335;264;1016;140;475;404;1491
315650;201303;1778;5603;1676;5469;161;685;1311;4177;1472;4862
315660;201303;2544;7362;2354;7114;322;1119;1748;5223;2070;6342
315670;201303;11006;40590;10212;38993;3907;16073;3339;12461;7246;28534
315680;201303;2751;10018;2336;9224;926;3835;620;2568;1546;6403
315690;201303;2761;9453;2430;8837;963;3816;622;2243;1585;6059
315700;201303;6710;22697;6059;21340;1465;5861;3031;10268;4496;16129
315710;201303;1796;5535;1492;5049;291;1195;808;2649;1099;3844
315720;201303;2645;9515;2469;9121;784;3289;845;2932;1629;6221
315725;201303;1521;4888;1262;4573;266;944;883;3269;1149;4213
315727;201303;619;2070;576;1970;144;532;309;1045;453;1577
315730;201303;962;3155;876;2977;244;881;420;1466;664;2347
315733;201303;1052;3534;982;3379;471;1699;299;1015;770;2714
315737;201303;1325;4275;1152;3985;165;641;746;2609;911;3250
315740;201303;983;3316;857;3068;284;1153;336;1128;620;2281
315750;201303;1034;3471;929;3332;141;580;655;2316;796;2896
315760;201303;762;2569;753;2553;54;186;671;2299;725;2485
315765;201303;1401;4633;1335;4511;192;680;984;3383;1176;4063
315770;201303;1557;5110;1472;4956;443;1610;714;2388;1157;3998
315780;201303;25948;88491;24641;85797;9428;34657;8571;30521;17999;65178
315790;201303;2951;10621;2792;10292;373;1325;1914;7297;2287;8622
315800;201303;1488;6019;1268;5358;439;2025;212;847;651;2872
315810;201303;1411;4347;1237;4067;212;858;806;2521;1018;3379
315820;201303;2976;10221;2631;9706;645;2563;1472;5505;2117;8068
315830;201303;1435;4989;1324;4753;375;1503;475;1662;850;3165
315840;201303;658;1906;531;1637;108;370;159;480;267;850
315850;201303;1334;4862;1290;4760;405;1559;497;1810;902;3369
315860;201303;379;1440;329;1337;100;447;116;488;216;935
315870;201303;452;1412;399;1328;100;380;184;591;284;971
315880;201303;979;2870;846;2704;269;940;397;1261;666;2201
315890;201303;1515;5443;1388;5260;357;1380;824;3263;1181;4643
315895;201303;4762;15511;4479;14968;1607;5871;1720;5626;3327;11497
315900;201303;711;2429;662;2345;216;864;297;983;513;1847
315910;201303;599;2194;552;2097;252;997;182;676;434;1673
315920;201303;1096;3649;993;3452;380;1424;419;1401;799;2825
315930;201303;1012;3056;898;2846;311;1081;317;1000;628;2081
315935;201303;1093;3855;1026;3706;367;1440;310;1107;677;2547
315940;201303;604;2015;572;1968;159;604;322;1076;481;1680
315950;201303;1166;3773;1102;3646;332;1118;598;2029;930;3147
315960;201303;2717;10019;2342;9186;1101;4828;283;1072;1384;5900
315970;201303;752;2238;631;2050;89;295;457;1523;546;1818
315980;201303;3781;9954;2834;8353;825;2817;939;2444;1764;5261
315990;201303;4176;13014;3725;12273;864;3316;2047;6624;2911;9940
316000;201303;552;1915;487;1786;257;994;105;380;362;1374
316010;201303;405;1542;364;1448;127;569;48;158;175;727
316020;201303;1157;3860;932;3470;191;776;526;2002;717;2778
316030;201303;3537;10432;2630;8996;392;1487;1460;5151;1852;6638
316040;201303;3248;10433;2485;8716;547;2201;583;1795;1130;3996
316045;201303;2016;6841;1910;6692;340;1029;1324;5064;1664;6093
316050;201303;319;1130;304;1100;63;255;180;646;243;901
316060;201303;755;2386;642;2235;134;577;397;1310;531;1887
316070;201303;5671;19778;5358;19159;1865;7292;2344;8064;4209;15356
316080;201303;686;2655;625;2487;182;796;157;628;339;1424
316090;201303;571;1755;451;1523;137;522;117;350;254;872
316095;201303;1108;3909;1054;3784;227;840;651;2432;878;3272
316100;201303;2793;9826;2359;8720;786;3241;536;1895;1322;5136
316105;201303;843;2491;681;2263;154;565;397;1336;551;1901
316110;201303;11636;43430;10714;41651;1499;6561;7820;30730;9319;37291
316120;201303;1251;4509;1225;4472;438;1630;603;2281;1041;3911
316130;201303;901;2367;711;2072;225;791;266;696;491;1487
316140;201303;974;3089;780;2767;180;680;393;1452;573;2132
316150;201303;1180;3889;1133;3815;325;1242;603;1944;928;3186
316160;201303;1176;3690;997;3339;140;532;600;2021;740;2553
316165;201303;838;2517;736;2343;147;535;410;1277;557;1812
316170;201303;1294;3996;1046;3514;246;973;461;1433;707;2406
316180;201303;1154;3834;1005;3584;311;1325;382;1240;693;2565
316190;201303;2490;7854;1619;5746;396;1561;332;1029;728;2590
316200;201303;3988;13337;3255;11898;957;4109;976;3346;1933;7455
316210;201303;4726;15910;4484;15464;2373;8668;1068;3771;3441;12439
316220;201303;609;1953;461;1695;147;609;74;297;221;906
316225;201303;944;3055;864;2937;168;642;524;1763;692;2405
316230;201303;415;1329;356;1219;67;254;198;684;265;938
316240;201303;5885;20157;5272;19430;614;2107;4236;16060;4850;18167
316245;201303;2631;10263;2519;10087;227;957;2074;8467;2301;9424
316250;201303;8148;27086;7482;25704;3515;12902;2088;6797;5603;19699
316255;201303;2236;7407;2026;7161;319;1074;1509;5473;1828;6547
316257;201303;1214;3615;978;3199;311;1142;313;962;624;2104
316260;201303;1659;4878;1265;4319;480;1798;566;1899;1046;3697
316265;201303;1129;3394;1017;3161;91;337;729;2233;820;2570
316270;201303;5148;17043;4840;16420;1538;5672;2025;6950;3563;12622
316280;201303;3159;10982;2868;10400;694;2826;1394;5021;2088;7847
316290;201303;2890;10115;2759;9862;846;3360;1196;4067;2042;7427
316292;201303;3560;12335;3322;11878;1026;4099;1414;4789;2440;8888
316294;201303;833;2891;573;2250;148;671;81;320;229;991
316295;201303;1828;6745;1709;6488;500;2149;787;2815;1287;4964
316300;201303;882;3094;813;2963;98;372;568;2140;666;2512
316310;201303;558;1975;506;1841;153;626;190;668;343;1294
316320;201303;520;1840;473;1773;175;733;179;629;354;1362
316330;201303;882;2782;784;2618;179;607;429;1489;608;2096
316340;201303;1062;3670;994;3541;382;1505;245;788;627;2293
316350;201303;1432;4905;1311;4698;263;972;748;2865;1011;3837
316360;201303;714;1967;581;1794;67;229;456;1401;523;1630
316370;201303;4723;16390;4349;15619;1526;5846;1163;4295;2689;10141
316380;201303;1303;3916;1121;3619;154;543;757;2459;911;3002
316390;201303;835;2682;727;2505;263;959;292;1041;555;2000
316400;201303;1420;4968;1285;4741;390;1527;583;2228;973;3755
316410;201303;1177;4152;1106;4041;219;885;700;2552;919;3437
316420;201303;1916;6801;1808;6644;310;1239;1187;4490;1497;5729
316430;201303;822;2653;724;2495;248;919;280;938;528;1857
316440;201303;551;1915;494;1840;178;786;246;832;424;1618
316443;201303;645;2083;568;1916;169;630;215;710;384;1340
316447;201303;1244;4336;1189;4231;222;855;850;3026;1072;3881
316450;201303;2078;7776;1882;7385;442;1689;1083;4509;1525;6198
316460;201303;758;2497;712;2425;204;793;409;1322;613;2115
316470;201303;6223;22830;5810;21973;2333;9840;1806;6423;4139;16263
316480;201303;247;900;223;849;73;292;73;272;146;564
316490;201303;338;1130;325;1104;131;462;133;452;264;914
316500;201303;1062;3983;774;3105;222;948;63;243;285;1191
316510;201303;900;3400;825;3256;383;1567;276;1107;659;2674
316520;201303;1081;3613;931;3384;334;1358;331;1135;665;2493
316530;201303;1178;3931;999;3536;289;1228;400;1226;689;2454
316540;201303;991;3349;897;3190;303;1274;306;977;609;2251
316550;201303;1195;4250;1101;4099;243;992;694;2598;937;3590
316553;201303;2078;7932;1781;7148;681;2925;367;1461;1048;4386
316555;201303;2540;9584;2375;9390;193;724;1975;8054;2168;8778
316556;201303;578;1750;486;1562;63;252;310;939;373;1191
316557;201303;856;3192;833;3149;311;1209;424;1606;735;2815
316560;201303;341;1196;305;1129;84;375;103;356;187;731
316570;201303;1315;4439;1232;4263;246;936;749;2593;995;3529
316580;201303;228;773;212;736;86;311;75;250;161;561
316590;201303;1247;4011;1091;3739;194;806;698;2352;892;3158
316600;201303;1091;3878;994;3657;272;1072;467;1671;739;2743
316610;201303;574;2275;547;2233;190;854;262;1049;452;1903
316620;201303;1966;6855;1851;6614;590;2244;777;2837;1367;5081
316630;201303;1336;4854;1258;4660;536;2113;353;1265;889;3378
316640;201303;248;854;226;810;72;301;86;288;158;589
316650;201303;896;3669;806;3511;200;857;436;2022;636;2879
316660;201303;119;398;109;379;31;137;49;153;80;290
316670;201303;1519;4826;1305;4403;505;1907;386;1209;891;3116
316680;201303;1764;5660;1650;5465;247;861;1240;4168;1487;5029
316690;201303;1014;3608;939;3497;392;1629;309;1106;701;2735
316695;201303;1230;3933;1113;3728;129;425;782;2743;911;3168
316700;201303;347;1218;326;1170;96;413;153;507;249;920
316710;201303;3302;13256;2924;12383;982;4330;944;4193;1926;8523
316720;201303;19175;67137;16969;62236;6469;25017;4699;17208;11168;42225
316730;201303;406;1360;359;1255;97;369;181;585;278;954
316740;201303;705;2572;662;2505;285;1149;168;600;453;1749
316750;201303;387;1441;362;1388;126;532;124;452;250;984
316760;201303;3451;12069;2981;11541;1765;6766;936;3885;2701;10651
316770;201303;1401;4390;1245;4170;257;959;770;2632;1027;3591
316780;201303;667;2375;633;2308;291;1118;154;546;445;1664
316790;201303;797;2432;601;2090;165;667;274;927;439;1594
316800;201303;5876;20242;5414;19351;1205;5008;2977;10308;4182;15316
316805;201303;865;2364;821;2306;148;410;596;1722;744;2132
316810;201303;472;1546;451;1514;136;506;235;769;371;1275
316820;201303;295;961;249;877;109;412;59;197;168;609
316830;201303;570;2137;550;2091;214;860;210;791;424;1651
316840;201303;3263;9924;2853;9278;897;3306;1180;3674;2077;6980
316850;201303;2001;6649;1867;6408;469;1790;945;3211;1414;5001
316860;201303;22673;73526;21300;71060;6325;23364;9794;32712;16119;56076
316870;201303;6697;23290;6085;21836;2462;9493;1397;4869;3859;14362
316880;201303;806;2898;784;2866;367;1437;199;715;566;2152
316890;201303;1305;3585;1060;3250;513;1727;305;893;818;2620
316900;201303;2431;8143;2271;7811;764;2921;681;2115;1445;5036
316905;201303;376;1403;359;1364;158;623;97;372;255;995
316910;201303;597;2199;542;2096;145;597;265;1030;410;1627
316920;201303;1386;4493;1122;4035;178;724;521;1882;699;2606
316930;201303;9092;32425;8313;30930;2795;11818;2841;10225;5636;22043
316935;201303;4647;14332;3489;12296;1290;5091;946;3158;2236;8249
316940;201303;6329;22496;5589;20939;1629;6936;1669;5923;3298;12859
316950;201303;1383;4349;1243;4164;246;944;791;2606;1037;3550
316960;201303;4966;13654;4304;12837;872;2872;2705;8117;3577;10989
316970;201303;3280;11479;3117;11163;1307;5210;938;3115;2245;8325
316980;201303;895;2935;746;2694;363;1399;211;764;574;2163
316990;201303;9182;32060;8558;30663;3719;14454;1457;5032;5176;19486
317000;201303;2376;9060;2312;8977;309;962;1901;7740;2210;8702
317005;201303;2088;7380;2022;7286;460;1767;1377;4907;1837;6674
317010;201303;25515;75751;18753;63520;5837;21925;4790;16810;10627;38735
317020;201303;37119;118557;27735;98267;8544;33317;5819;19456;14363;52773
317030;201303;856;2484;724;2284;135;514;414;1304;549;1818
317040;201303;11886;37946;10845;36055;4294;14848;3937;13503;8231;28351
317043;201303;714;2127;594;1962;247;861;206;687;453;1548
317047;201303;1106;3149;909;2838;176;610;433;1366;609;1976
317050;201303;1683;6378;1542;6059;536;2280;454;1701;990;3981
317052;201303;2197;7657;1979;7338;416;1592;1324;5053;1740;6645
317057;201303;1646;5044;1319;4488;223;907;713;2423;936;3330
317060;201303;374;1153;298;991;93;346;111;348;204;694
317065;201303;1194;4147;1103;4008;137;542;873;3198;1010;3740
317070;201303;8191;28856;6909;26025;2421;10043;1659;6236;4080;16279
317075;201303;1154;3878;1064;3733;425;1614;411;1400;836;3014
317080;201303;6620;20326;6264;19767;2120;7261;2687;8545;4807;15806
317090;201303;4534;16511;4301;16058;760;2985;2892;10986;3652;13971
317100;201303;3036;9392;2712;8875;915;3400;1234;3837;2149;7237
317103;201303;1950;7090;1683;6494;409;1885;820;3118;1229;5003
317107;201303;1200;4032;1092;3808;282;1165;530;1734;812;2899
317110;201303;577;1679;486;1551;157;588;206;590;363;1178
317115;201303;972;3257;892;3083;130;466;611;2121;741;2587
317120;201303;12279;43166;11094;40519;4113;15972;4169;15091;8282;31063
317130;201303;8493;28308;7846;27111;2290;8881;3468;11636;5758;20517
317140;201303;620;2273;581;2183;93;385;360;1352;453;1737
317150;201303;992;2843;848;2679;141;541;596;1842;737;2383
317160;201303;3608;10280;2886;9358;453;1718;1930;6151;2383;7869
317170;201303;1891;5911;1801;5731;281;1048;1090;3336;1371;4384
317180;201303;1627;5922;1363;5298;442;1857;366;1394;808;3251
317190;201303;1302;4119;1229;4018;122;467;1005;3273;1127;3740
317200;201303;4031;14304;3899;14020;1551;5995;982;3430;2533;9425
317210;201303;1035;3380;889;3139;316;1240;334;1147;650;2387
317220;201303;340;1267;335;1261;147;562;150;576;297;1138
320010;201303;5870;18950;5310;17647;850;3080;3092;10303;3942;13383
320013;201303;1749;5458;1427;4974;215;808;933;3313;1148;4121
320016;201303;3355;9684;2929;9088;496;1600;2023;6362;2519;7962
320020;201303;3983;13505;3733;12973;1389;5112;1360;4762;2749;9874
320030;201303;1680;5684;1574;5471;436;1650;753;2576;1189;4226
320035;201303;1511;5091;1394;4865;518;1941;418;1449;936;3390
320040;201303;2913;10266;2561;9444;806;3162;823;3022;1629;6184
320050;201303;1817;5427;1574;4915;366;1274;759;2342;1125;3616
320060;201303;10312;34387;8761;30801;2754;10506;3033;10262;5787;20768
320070;201303;1724;6009;1578;5664;573;2218;424;1423;997;3641
320080;201303;4899;15486;4269;14257;1399;5091;1655;5401;3054;10492
320090;201303;7932;23976;6874;22150;1813;6382;3823;12093;5636;18475
320100;201303;3151;9752;2665;8804;676;2462;1270;4095;1946;6557
320110;201303;1504;4746;1396;4524;386;1362;506;1613;892;2975
320115;201303;1972;7440;1932;7343;605;2354;1098;4231;1703;6585
320120;201303;15984;56900;14566;54039;5732;22579;4252;15795;9984;38374
320130;201303;36476;126975;34790;123370;11623;44261;15747;55034;27370;99295
320140;201303;3904;13231;2942;10756;878;3497;390;1404;1268;4901
320150;201303;16976;50291;13063;42635;4706;16450;2068;6707;6774;23157
320160;201303;5283;16813;4700;15898;1245;4672;2353;7707;3598;12379
320170;201303;1896;6418;1762;6126;715;2565;522;1878;1237;4443
320180;201303;890;3052;819;2940;265;1008;415;1490;680;2498
320190;201303;4003;15009;3749;14360;1507;5979;1094;4193;2601;10172
320200;201303;1051;3623;965;3451;307;1190;412;1498;719;2688
320210;201303;5939;17016;5222;15814;1443;4799;2549;7640;3992;12439
320220;201303;2636;8484;2098;7483;717;2786;685;2474;1402;5260
320225;201303;1352;4966;1239;4654;484;1935;248;938;732;2873
320230;201303;4037;14017;3811;13581;1319;5005;1425;5240;2744;10245
320240;201303;10221;35106;9182;33093;3600;13541;2366;9016;5966;22557
320245;201303;4044;14306;3874;13926;1266;4702;1858;6745;3124;11447
320250;201303;1586;5143;1258;4376;381;1478;283;906;664;2384
320255;201303;1885;6547;1673;6179;696;2726;584;2221;1280;4947
320260;201303;1329;4425;1153;3946;363;1361;413;1283;776;2644
320265;201303;2311;7419;1986;7018;273;1014;1465;5303;1738;6317
320270;201303;2065;7169;1970;6948;461;1686;1137;4061;1598;5747
320280;201303;7119;21930;6711;21414;1161;3869;4661;15354;5822;19223
320290;201303;1490;5277;1430;5112;566;2097;510;1793;1076;3890
320300;201303;4523;15696;4250;15210;1214;4532;2282;8277;3496;12809
320305;201303;4352;14973;4022;14166;1244;4811;1708;5844;2952;10655
320310;201303;1875;5910;1751;5733;402;1435;1056;3404;1458;4839
320313;201303;2062;6620;1650;5679;514;2053;271;844;785;2897
320316;201303;2185;7155;2101;6959;566;1977;1064;3530;1630;5507
320320;201303;17064;58195;15530;55230;4964;19765;6792;23412;11756;43177
320330;201303;2634;8677;2416;8236;682;2330;1205;4271;1887;6601
320332;201303;4894;17233;4609;16713;1468;5468;2158;8124;3626;13592
320334;201303;1813;6566;1578;5973;700;2829;285;981;985;3810
320335;201303;1782;5809;1556;5320;626;2307;301;976;927;3283
320340;201303;5224;15550;4426;14219;1022;3731;2317;7309;3339;11040
320350;201303;5228;13940;4038;12040;843;2916;2056;5954;2899;8870
320360;201303;1675;4666;1360;4111;303;1038;668;1924;971;2962
320370;201303;3378;11619;2973;10807;873;3310;1344;4925;2217;8235
320380;201303;2530;8320;2282;7789;761;2714;880;3016;1641;5730
320390;201303;7924;24906;6844;22814;1801;6732;3210;10470;5011;17202
320400;201303;4205;12525;3692;11839;656;2289;2494;7987;3150;10276
320405;201303;4133;12695;3870;12351;1028;3703;2313;7239;3341;10942
320410;201303;5587;14956;4363;13587;501;1485;3514;11222;4015;12707
320420;201303;2337;7626;1893;6942;897;3508;356;1289;1253;4797
320425;201303;2418;6359;2046;5861;318;1107;1351;3834;1669;4941
320430;201303;2152;6691;2009;6436;301;1128;1253;3911;1554;5039
320435;201303;1923;7094;1768;6706;498;1928;872;3432;1370;5360
320440;201303;1424;4971;1364;4819;436;1646;537;1847;973;3493
320450;201303;2235;7739;2072;7376;626;2415;937;3282;1563;5697
320455;201303;4175;15578;3564;14014;1209;4912;724;2831;1933;7743
320460;201303;2735;9490;2334;8626;863;3398;641;2261;1504;5659
320465;201303;1460;4896;1318;4549;256;939;661;2256;917;3195
320470;201303;3953;12857;3057;10834;1100;4230;494;1699;1594;5929
320480;201303;1953;6105;1659;5544;412;1623;776;2446;1188;4069
320490;201303;16110;54148;14263;50496;5166;19394;5240;19060;10406;38454
320495;201303;1477;5062;1359;4791;613;2286;385;1309;998;3595
320500;201303;39326;130838;35891;124259;12832;47860;15358;52066;28190;99926
320501;201303;4088;13919;3870;13510;1492;5679;1562;5381;3054;11060
320503;201303;2161;8163;1925;7495;718;2939;541;2001;1259;4940
320506;201303;2979;9761;2222;7803;665;2485;415;1452;1080;3937
320510;201303;7629;25364;7063;24288;2619;9580;2567;8810;5186;18390
320515;201303;2008;5871;1833;5531;446;1415;904;2769;1350;4184
320517;201303;1972;7025;1797;6612;580;2243;721;2679;1301;4922
320520;201303;28290;96199;25262;90306;8976;34985;10754;38314;19730;73299
320530;201303;25059;82058;22155;76144;6787;26232;9482;31384;16269;57616
330010;201303;13490;45759;12784;44253;3394;13142;6732;22435;10126;35577
330015;201303;1871;5464;1660;5057;577;1961;521;1510;1098;3471
330020;201303;15050;47590;13961;45821;4061;14203;7183;23550;11244;37753
330022;201303;1322;4505;1234;4353;320;1315;652;2188;972;3503
330023;201303;3064;10350;2941;10103;876;3291;1291;4332;2167;7623
330025;201303;3042;9726;2860;9456;662;2382;1875;6167;2537;8549
330030;201303;6828;24577;6330;23519;2203;8906;2527;8993;4730;17899
330040;201303;13731;40083;11843;37165;3170;10827;6400;19738;9570;30565
330045;201303;56645;173422;53472;168873;8996;30131;37266;118605;46262;148736
330050;201303;2802;9374;2525;8801;990;3844;734;2430;1724;6274
330060;201303;4976;16298;4586;15724;1206;4555;2660;9181;3866;13736
330070;201303;23919;76966;22152;73786;6863;24632;9562;31873;16425;56505
330080;201303;8622;26139;8313;25718;2212;6859;4987;15974;7199;22833
330090;201303;2944;8739;2829;8527;982;3142;1240;3700;2222;6842
330093;201303;1826;5489;1648;5217;394;1352;879;2793;1273;4145
330095;201303;1145;4084;1071;3898;418;1696;218;696;636;2392
330100;201303;49361;173770;47165;169817;12969;51070;23794;86237;36763;137307
330110;201303;2553;8257;2351;7880;847;3055;711;2363;1558;5418
330115;201303;2376;7494;2234;7236;792;2817;886;2776;1678;5593
330120;201303;2294;7151;2135;6924;479;1708;1299;4158;1778;5866
330130;201303;3631;12496;3347;11925;1239;4687;1130;4068;2369;8755
330140;201303;3207;10064;2930;9677;749;2743;1467;4833;2216;7576
330150;201303;2804;8813;2315;7793;869;3168;520;1721;1389;4889
330160;201303;1284;4640;1217;4487;499;1987;352;1266;851;3253
330170;201303;93063;295435;88197;287948;13640;48413;64204;209565;77844;257978
330180;201303;1541;4958;1427;4747;291;1229;903;2768;1194;3997
330185;201303;7166;23773;6831;23202;2000;7069;3542;12463;5542;19532
330187;201303;3735;11214;3433;10707;867;3105;1851;5661;2718;8766
330190;201303;26547;83451;25562;81753;7145;24336;14467;45488;21612;69824
330200;201303;11933;39265;11276;37964;2548;8813;6573;22622;9121;31435
330205;201303;2462;6906;2255;6565;518;1755;1201;3379;1719;5134
330210;201303;4524;12265;3475;10330;1108;3627;1059;3131;2167;6758
330220;201303;10626;34959;10117;33976;3806;13826;3486;11338;7292;25164
330225;201303;3798;12445;3607;12144;686;2628;2427;8161;3113;10789
330227;201303;16947;48850;15621;47175;3173;10413;10339;30660;13512;41073
330230;201303;1466;4393;1365;4234;421;1481;627;1831;1048;3312
330240;201303;19244;61174;17358;57999;7392;26739;3382;11356;10774;38095
330245;201303;1136;3777;977;3451;316;1195;249;892;565;2087
330250;201303;34666;105166;33302;103077;7949;24738;21220;67021;29169;91759
330260;201303;3119;10233;3009;10018;868;3189;1485;4811;2353;8000
330270;201303;12655;39570;11521;37712;3593;12397;5026;16659;8619;29056
330280;201303;1815;6083;1601;5649;407;1659;807;2708;1214;4367
330285;201303;17041;52650;15812;50942;3667;12507;9888;32030;13555;44537
330290;201303;3320;9390;3012;9049;444;1546;2245;6614;2689;8160
330300;201303;4023;13718;3864;13449;1086;3988;1996;7156;3082;11144
330310;201303;2609;8047;2436;7743;670;2264;1188;3736;1858;6000
330320;201303;14696;44671;14031;43636;3845;12111;8172;26155;12017;38266
330330;201303;28736;86349;27098;83789;7399;24327;15747;48446;23146;72773
330340;201303;13039;42164;11103;38192;3578;13391;3602;12201;7180;25592
330350;201303;87419;291788;85523;289158;17123;57808;59877;207009;77000;264817
330360;201303;5082;16805;4974;16625;919;3333;3414;11334;4333;14667
330370;201303;3578;13771;3414;13331;1415;5764;1173;4589;2588;10353
330380;201303;3458;11984;3179;11529;1128;4219;1315;5016;2443;9235
330385;201303;3816;13728;3537;13143;1022;4075;1512;5623;2534;9698
330390;201303;21707;76086;20381;73523;5194;20894;10794;38240;15988;59134
330395;201303;3161;9946;2990;9656;536;1858;1929;6315;2465;8173
330400;201303;2367;8220;2161;7822;551;2257;1001;3358;1552;5615
330410;201303;2832;9443;2513;8755;616;2306;1219;4237;1835;6543
330411;201303;2308;7563;2111;7184;517;2034;1047;3344;1564;5378
330412;201303;1310;4648;1074;4198;246;1113;475;1786;721;2899
330414;201303;24530;72100;21110;67495;4239;14645;13327;42783;17566;57428
330415;201303;3580;11518;3193;10812;852;3245;1385;4655;2237;7900
330420;201303;6078;21446;5367;19977;1907;7772;976;3745;2883;11517
330430;201303;7806;23995;7079;22705;1869;6654;3393;10585;5262;17239
330440;201303;2028;6989;1739;6393;585;2395;468;1651;1053;4046
330450;201303;1524;5528;1446;5353;502;2079;484;1740;986;3819
330452;201303;10118;32051;8559;28931;2451;9252;3658;11795;6109;21047
330455;201303;421105;1295009;371645;1213697;104025;362358;192471;629222;296496;991580
330460;201303;1355;4726;1277;4572;389;1579;596;2084;985;3663
330470;201303;3941;13758;3801;13468;1601;6036;1005;3497;2606;9533
330475;201303;7607;25586;7059;24738;1770;6709;4062;14405;5832;21114
330480;201303;6316;19547;5934;18843;1769;6091;2259;7112;4028;13203
330490;201303;91589;268127;86254;260424;13675;43685;63841;193324;77516;237009
330500;201303;6379;20015;5987;19228;1551;5320;2877;9559;4428;14879
330510;201303;38923;130843;37192;127923;13868;48429;17160;60915;31028;109344
330513;201303;1537;4765;1429;4555;429;1428;722;2336;1151;3764
330515;201303;2696;9077;2578;8871;816;3007;1203;4091;2019;7098
330520;201303;12381;38443;11738;37547;2518;8572;7712;24905;10230;33477
330530;201303;1527;4674;1421;4488;382;1333;768;2352;1150;3685
330540;201303;2985;9527;2663;9035;918;3347;993;3303;1911;6650
330550;201303;8505;28830;7688;27390;3032;11370;2300;8412;5332;19782
330555;201303;9630;30646;8873;29416;1968;6777;5506;18510;7474;25287
330560;201303;3916;12505;3695;12143;841;3218;2144;6852;2985;10070
330570;201303;3497;10476;3146;9923;819;2696;1735;5597;2554;8293
330575;201303;5038;15983;4747;15452;1093;3822;2879;9185;3972;13007
330580;201303;15111;51124;13703;48409;5168;19035;4620;17022;9788;36057
330590;201303;1885;5962;1786;5797;506;1722;933;3089;1439;4811
330600;201303;8692;27159;7616;25504;1254;5268;4955;15737;6209;21005
330610;201303;8396;28257;7795;27103;2413;9207;3539;12141;5952;21348
330615;201303;1645;6004;1534;5688;597;2281;634;2453;1231;4734
330620;201303;3796;13838;3569;13431;1297;5014;1476;5919;2773;10933
330630;201303;19143;65875;17827;62981;5467;21354;8214;27830;13681;49184
350010;201303;2809;9181;2317;8043;777;2899;453;1544;1230;4443
350020;201303;533;1611;439;1417;129;471;153;461;282;932
350030;201303;4078;13675;3802;13207;1504;5635;1454;5121;2958;10756
350040;201303;551;2087;495;1969;182;792;101;363;283;1155
350050;201303;1337;4556;1126;4157;332;1397;380;1325;712;2722
350055;201303;555;1969;536;1937;180;687;229;836;409;1523
350060;201303;71;250;67;244;23;104;22;69;45;173
350070;201303;2839;9776;2450;8930;698;2799;650;2191;1348;4990
350075;201303;452;1708;420;1636;177;736;115;398;292;1134
350080;201303;557;1721;479;1569;143;541;182;591;325;1132
350090;201303;572;1705;455;1507;132;463;154;503;286;966
350100;201303;1734;6277;1625;6052;627;2503;583;2136;1210;4639
350110;201303;433;1357;348;1165;108;408;110;324;218;732
350115;201303;1222;4207;1093;3869;271;1085;475;1561;746;2646
350120;201303;710;2058;556;1770;160;572;139;446;299;1018
350130;201303;3553;11294;3270;10742;946;3481;1335;4077;2281;7558
350140;201303;669;2168;612;2054;157;612;244;778;401;1390
350150;201303;354;1274;340;1244;168;617;72;285;240;902
350160;201303;6145;21034;5108;18720;1802;7226;1617;5459;3419;12685
350170;201303;2128;7832;1921;7305;758;2979;462;1707;1220;4686
350180;201303;1428;3816;1199;3416;298;880;540;1538;838;2418
350190;201303;2688;9918;2422;9358;872;3759;931;3285;1803;7044
350200;201303;384;1376;362;1352;147;606;141;508;288;1114
350210;201303;7264;21208;5980;18917;2461;8337;1929;5840;4390;14177
350220;201303;3012;10006;2734;9488;1069;4121;730;2299;1799;6420
350230;201303;704;2480;648;2386;252;1014;187;687;439;1701
350240;201303;583;1817;511;1698;126;485;270;866;396;1351
350250;201303;2653;10075;2550;9863;1142;4688;796;3057;1938;7745
350260;201303;932;2637;865;2541;237;721;395;1222;632;1943
350270;201303;5051;16351;4625;15485;1318;4819;2080;6923;3398;11742
350275;201303;1836;6243;1660;6001;519;2089;728;2499;1247;4588
350280;201303;20951;57864;14025;44498;3963;13510;2975;9516;6938;23026
350290;201303;1446;5161;1346;4923;491;1886;457;1717;948;3603
350300;201303;468;1529;433;1448;161;596;125;410;286;1006
350310;201303;985;3402;932;3287;272;1113;369;1245;641;2358
350315;201303;540;1771;448;1571;87;379;157;505;244;884
350320;201303;10972;37399;10173;35505;3556;13184;1907;6486;5463;19670
350330;201303;9008;27569;8238;25957;1734;6271;4818;14273;6552;20544
350335;201303;528;1586;490;1509;139;450;190;642;329;1092
350340;201303;968;3195;785;2856;287;1119;172;599;459;1718
350350;201303;712;2380;633;2262;217;881;230;820;447;1701
350360;201303;657;2409;585;2253;193;803;215;833;408;1636
350370;201303;679;2164;517;1767;114;437;129;398;243;835
350380;201303;3401;11435;2912;10701;1402;5457;569;2049;1971;7506
350390;201303;8010;27106;7368;25969;1733;6806;4156;14122;5889;20928
350395;201303;294;978;237;848;77;290;42;145;119;435
350400;201303;7455;23099;6325;20999;2150;7698;2174;6984;4324;14682
350410;201303;6793;26095;6185;24717;2428;10399;1660;6482;4088;16881
350420;201303;1015;3328;848;2985;415;1535;76;269;491;1804
350430;201303;887;2862;780;2678;230;922;393;1296;623;2218
350440;201303;1342;4484;1279;4370;485;1739;568;1916;1053;3655
350450;201303;7826;24768;6797;22782;2477;9015;1960;6380;4437;15395
350460;201303;1366;4174;1025;3435;339;1253;277;796;616;2049
350470;201303;200;639;183;614;56;211;76;234;132;445
350480;201303;756;2413;532;1850;110;444;89;251;199;695
350490;201303;2044;6040;1818;5791;420;1532;1231;3843;1651;5375
350500;201303;595;1831;527;1727;161;590;247;766;408;1356
350510;201303;1083;3578;973;3367;336;1313;365;1154;701;2467
350520;201303;1240;4938;1153;4754;477;2059;295;1200;772;3259
350530;201303;2367;7325;1995;6499;788;2787;542;1613;1330;4400
350535;201303;1449;4329;1417;4285;89;276;1244;3804;1333;4080
350540;201303;1917;5806;1695;5431;490;1769;732;2301;1222;4070
350550;201303;10444;31800;8541;28477;2755;10269;2980;9272;5735;19541
350560;201303;3229;11031;3021;10710;594;2252;1858;6778;2452;9030
350570;201303;19579;70033;18160;66721;6440;25216;6402;22675;12842;47891
350580;201303;1895;6462;1668;5989;551;2175;289;913;840;3088
350590;201303;3840;13088;3132;11478;1035;4181;1111;3761;2146;7942
350600;201303;25842;78608;21507;70529;5224;19006;10499;33322;15723;52328
350610;201303;8695;26317;7297;24127;2094;7790;3544;11354;5638;19144
350620;201303;410;1373;366;1287;96;380;151;503;247;883
350630;201303;1554;5117;1269;4560;438;1796;131;423;569;2219
350635;201303;3559;13214;3377;12840;1221;4807;1404;5444;2625;10251
350640;201303;647;2126;605;2039;212;763;250;823;462;1586
350650;201303;4259;14554;3509;12846;1638;6429;406;1425;2044;7854
350660;201303;3524;11809;3150;11137;915;3457;1489;5213;2404;8670
350670;201303;1805;5874;1701;5686;361;1414;1087;3459;1448;4873
350680;201303;1104;3532;906;3143;274;1117;371;1228;645;2345
350690;201303;1017;3537;879;3234;295;1201;200;674;495;1875
350700;201303;2678;9594;2398;8949;938;3834;863;2882;1801;6716
350710;201303;1907;6253;1740;5997;400;1572;1043;3521;1443;5093
350715;201303;1093;3474;994;3276;250;962;423;1320;673;2282
350720;201303;120;393;115;378;48;162;41;126;89;288
350730;201303;378;1504;368;1474;132;581;92;339;224;920
350740;201303;2206;6833;2022;6411;620;2139;771;2441;1391;4580
350745;201303;336;1100;295;1001;75;291;134;416;209;707
350750;201303;8688;28197;7045;24787;2265;8713;1857;6173;4122;14886
350760;201303;10790;35984;9924;34443;3732;14227;3945;13074;7677;27301
350770;201303;818;2559;631;2170;160;626;206;707;366;1333
350775;201303;595;1822;539;1711;147;527;223;710;370;1237
350780;201303;1933;6107;1516;5232;357;1349;352;1206;709;2555
350790;201303;1986;6740;1664;6094;600;2317;395;1330;995;3647
350800;201303;2797;10016;2684;9808;775;3165;1414;5012;2189;8177
350810;201303;2539;7607;2234;7038;771;2634;781;2535;1552;5169
350820;201303;493;1424;390;1212;90;331;143;389;233;720
350830;201303;839;2752;636;2248;130;501;135;430;265;931
350840;201303;2964;11350;2598;10353;1037;4463;564;2050;1601;6513
350850;201303;6230;21723;5469;19978;1946;7593;1700;5966;3646;13559
350860;201303;3076;10578;2979;10433;567;2210;2113;7339;2680;9549
350870;201303;2207;8010;2044;7757;796;3168;952;3657;1748;6825
350880;201303;1613;5619;1383;5087;469;1852;254;946;723;2798
350890;201303;600;1831;484;1581;102;365;150;397;252;762
350900;201303;4454;15301;3878;14092;1140;4519;1380;4730;2520;9249
350910;201303;850;2720;813;2640;342;1129;294;969;636;2098
350920;201303;8804;27653;8287;26851;1521;5575;5430;16995;6951;22570
350925;201303;5160;16641;4728;15806;1482;5442;2085;6817;3567;12259
350930;201303;1408;4113;1199;3761;182;670;790;2389;972;3059
350940;201303;2245;7702;2067;7411;417;1762;1321;4545;1738;6307
350945;201303;912;3148;821;2952;249;980;316;1098;565;2078
350950;201303;65146;218484;57721;203327;18183;69569;23684;81352;41867;150921
350960;201303;4400;16029;3954;15065;886;3848;2102;7730;2988;11578
350970;201303;3984;15105;3699;14398;1540;6430;1159;4433;2699;10863
350980;201303;615;2082;588;2040;272;1030;129;448;401;1478
350990;201303;1687;6191;1537;5893;550;2266;587;2263;1137;4529
350995;201303;792;2972;755;2899;251;1078;334;1218;585;2296
351000;201303;3384;10844;3015;10113;560;2228;1723;5516;2283;7744
351010;201303;397;1263;304;1067;130;497;54;193;184;690
351015;201303;916;3154;810;2953;314;1298;229;752;543;2050
351020;201303;7336;25155;6598;23983;1826;7237;3606;13176;5432;20413
351030;201303;1275;4953;1199;4778;402;1742;411;1618;813;3360
351040;201303;3434;11473;3201;11072;855;3475;1826;5877;2681;9352
351050;201303;7387;25814;6563;24169;2553;10100;2199;8029;4752;18129
351060;201303;29632;96332;25390;88628;9233;34047;8541;30453;17774;64500
351070;201303;1696;5084;1305;4368;504;1849;253;754;757;2603
351080;201303;2605;8225;2105;7596;692;2700;817;2882;1509;5582
351090;201303;360;1303;297;1170;102;460;61;236;163;696
351100;201303;1741;5909;1654;5771;638;2275;690;2482;1328;4757
351110;201303;6954;21622;5701;19238;2081;7665;1762;5670;3843;13335
351120;201303;604;1945;530;1774;85;348;239;699;324;1047
351130;201303;940;2743;596;2054;176;700;155;471;331;1171
351140;201303;1940;6945;1791;6630;722;2910;568;2061;1290;4971
351150;201303;2016;7126;1713;6354;513;2096;448;1533;961;3629
351160;201303;1441;5245;1308;4924;466;1935;432;1578;898;3513
351170;201303;1398;4898;1225;4477;384;1511;468;1599;852;3110
351190;201303;1054;3481;975;3278;285;1038;247;793;532;1831
351200;201303;2158;6714;1900;6206;377;1460;979;2943;1356;4403
351210;201303;883;3086;818;2941;302;1157;255;882;557;2039
351220;201303;3365;11683;2938;10756;947;3749;1010;3651;1957;7400
351230;201303;1764;6165;1607;5847;582;2302;678;2435;1260;4737
351240;201303;971;3292;723;2657;226;935;202;652;428;1587
351250;201303;791;2357;608;1987;141;508;275;862;416;1370
351260;201303;1185;3632;1063;3370;298;1043;415;1244;713;2287
351270;201303;372;1377;338;1305;130;564;110;393;240;957
351280;201303;4164;13637;3623;12315;1159;4219;1128;3481;2287;7700
351290;201303;947;2970;840;2746;297;1015;220;673;517;1688
351300;201303;9484;36034;8452;33585;2548;10932;3318;13172;5866;24104
351310;201303;3207;10407;2714;9492;775;3076;1222;3989;1997;7065
351320;201303;927;3442;851;3249;349;1431;179;602;528;2033
351330;201303;270;826;247;779;101;326;69;211;170;537
351340;201303;6156;22450;5753;21646;1667;6644;3078;11618;4745;18262
351350;201303;8811;30299;8071;28661;2658;9859;3137;10881;5795;20740
351360;201303;4776;14997;4529;14600;1225;4336;2409;7771;3634;12107
351370;201303;1825;6164;1497;5434;526;2118;360;1163;886;3281
351380;201303;35266;114902;33192;110603;9380;34317;15844;50662;25224;84979
351385;201303;228;757;226;753;99;332;68;244;167;576
351390;201303;1164;4098;1058;3873;442;1700;370;1319;812;3019
351400;201303;1162;3892;1097;3748;343;1270;454;1586;797;2856
351410;201303;2725;8774;2484;8335;651;2332;1180;3931;1831;6263
351420;201303;444;1327;309;1021;76;275;43;125;119;400
351430;201303;835;2741;756;2596;220;833;389;1291;609;2124
351440;201303;4524;14297;4058;13327;1661;5714;1105;3446;2766;9160
351450;201303;1771;5188;1575;4934;479;1511;874;2844;1353;4355
351460;201303;777;2521;652;2268;324;1207;179;569;503;1776
351470;201303;1023;3309;926;3130;411;1497;285;938;696;2435
351480;201303;2850;9666;2623;9280;722;3061;1260;4301;1982;7362
351490;201303;1874;6636;1713;6295;421;1798;904;3165;1325;4963
351492;201303;274;981;216;808;54;236;55;165;109;401
351495;201303;141;508;123;458;47;186;44;160;91;346
351500;201303;17270;59096;15659;55947;5215;19574;6615;23429;11830;43003
351510;201303;6917;23290;6133;22024;1541;6052;3391;12059;4932;18111
351512;201303;303;985;277;929;83;298;90;287;173;585
351515;201303;1741;6140;1549;5691;564;2234;449;1591;1013;3825
351518;201303;2132;7725;1730;7000;610;2687;304;1216;914;3903
351519;201303;704;2415;630;2248;201;811;268;940;469;1751
351520;201303;732;2187;381;1403;66;278;50;171;116;449
351530;201303;437;1424;395;1319;96;353;113;325;209;678
351535;201303;2456;6634;2087;6152;191;609;1651;4914;1842;5523
351540;201303;2012;6689;1839;6386;968;3517;377;1330;1345;4847
351550;201303;5633;17839;4566;15562;1778;6371;1100;3703;2878;10074
351560;201303;416;1402;370;1293;152;579;63;208;215;787
351565;201303;222;774;205;728;69;289;78;245;147;534
351570;201303;12329;41972;10952;39073;3818;14027;4506;16228;8324;30255
351580;201303;378;1126;304;951;61;210;109;310;170;520
351590;201303;430;1224;379;1104;143;448;101;279;244;727
351600;201303;1753;5354;1603;5061;442;1628;716;2038;1158;3666
351610;201303;620;1789;536;1637;123;430;275;798;398;1228
351620;201303;22330;77032;18873;69328;6749;26832;4751;16304;11500;43136
351630;201303;13885;48177;12794;46360;3499;13112;7218;26573;10717;39685
351640;201303;7769;26840;6770;25069;1964;7819;3422;12658;5386;20477
351650;201303;333;1039;248;838;61;224;60;196;121;420
351660;201303;915;3034;762;2673;197;784;231;731;428;1515
351670;201303;3995;13184;3471;12116;929;3642;1546;5115;2475;8757
351680;201303;662;2151;553;1885;165;603;153;500;318;1103
351685;201303;418;1294;332;1143;102;371;108;382;210;753
351690;201303;1259;3756;1021;3256;486;1570;257;781;743;2351
351700;201303;1369;4296;1258;4087;442;1511;405;1272;847;2783
351710;201303;764;2465;652;2215;179;640;181;565;360;1205
351720;201303;1499;4949;1219;4207;303;1163;414;1361;717;2524
351730;201303;975;3266;948;3217;306;1119;473;1638;779;2757
351740;201303;4362;12970;3836;11857;1159;3812;1293;3771;2452;7583
351750;201303;1465;4993;1281;4585;411;1586;321;1079;732;2665
351760;201303;3703;12414;3307;11513;895;3370;1511;5131;2406;8501
351770;201303;2093;7077;1824;6584;744;2776;753;2748;1497;5524
351780;201303;1529;4572;1163;3826;366;1301;309;1009;675;2310
351790;201303;1107;3431;954;3219;294;1088;470;1549;764;2637
351800;201303;292;747;260;684;41;145;156;356;197;501
351810;201303;1164;3684;1110;3616;291;1115;687;2096;978;3211
351820;201303;2396;7214;1689;5908;740;2761;198;671;938;3432
351830;201303;3770;12908;3475;12263;1010;3896;1478;5074;2488;8970
351840;201303;8583;30598;7753;28817;2695;10682;2683;9809;5378;20491
351850;201303;1116;4043;993;3766;321;1361;170;591;491;1952
351860;201303;3393;11279;3170;10851;781;3056;1829;5965;2610;9021
351870;201303;34024;109004;31617;104833;7241;26058;19502;64248;26743;90306
351880;201303;110829;372891;99146;349011;33957;125556;31192;109786;65149;235342
351885;201303;589;2259;550;2171;169;710;247;948;416;1658
351890;201303;812;2452;671;2134;246;834;155;477;401;1311
351900;201303;1427;4546;1286;4321;467;1664;537;1823;1004;3487
351905;201303;348;1303;302;1213;116;515;89;320;205;835
351907;201303;13396;44439;11782;41143;3058;11954;5325;17817;8383;29771
351910;201303;1088;3613;997;3435;269;1041;275;875;544;1916
351920;201303;1157;3463;1105;3386;278;971;665;1968;943;2939
351925;201303;951;2798;905;2723;109;434;697;2008;806;2442
351930;201303;2997;10652;2763;10132;899;3649;1060;3568;1959;7217
351940;201303;954;3033;902;2927;287;1024;515;1595;802;2619
351950;201303;959;3073;867;2896;242;896;353;1086;595;1982
351960;201303;3540;11853;3081;10909;1264;4718;993;3434;2257;8152
351970;201303;6514;25739;6188;25009;2504;10645;2069;8272;4573;18917
351980;201303;881;2833;759;2604;179;711;320;1042;499;1753
351990;201303;1469;4419;1244;3981;375;1355;392;1153;767;2508
352000;201303;2284;7620;2108;7248;544;1995;1007;3377;1551;5372
352010;201303;2235;7810;2063;7387;813;3031;473;1755;1286;4786
352020;201303;1420;4750;1307;4532;441;1620;415;1470;856;3090
352030;201303;4211;13845;3871;13408;861;3219;2343;8297;3204;11516
352040;201303;1576;5770;1384;5270;458;1846;327;1166;785;3012
352042;201303;1732;5270;1486;4803;388;1403;780;2501;1168;3904
352044;201303;1323;4760;1153;4294;365;1437;279;992;644;2429
352050;201303;6920;24128;5249;20308;1697;7322;1192;4146;2889;11468
352060;201303;768;2383;693;2267;225;836;255;757;480;1593
352070;201303;666;1891;625;1822;307;963;163;508;470;1471
352080;201303;524;1662;455;1540;131;502;162;497;293;999
352090;201303;1634;5446;1370;4903;374;1541;478;1551;852;3092
352100;201303;1671;5970;1509;5640;554;2324;542;1829;1096;4153
352110;201303;375;1468;347;1410;121;540;96;367;217;907
352115;201303;304;1028;259;934;85;352;118;385;203;737
352120;201303;1030;3062;897;2879;205;684;538;1791;743;2475
352130;201303;1600;4627;1268;4083;329;1196;610;1814;939;3010
352140;201303;1111;3840;976;3534;349;1332;361;1294;710;2626
352150;201303;623;1894;521;1713;211;745;173;548;384;1293
352160;201303;1142;3458;1064;3336;303;1043;543;1711;846;2754
352170;201303;2877;9323;2676;8986;735;2681;1328;4326;2063;7007
352180;201303;3310;9852;2932;9170;893;3056;1303;3875;2196;6931
352190;201303;964;3089;883;2945;245;979;424;1265;669;2244
352200;201303;342;1224;291;1117;80;336;103;397;183;733
352210;201303;14610;41405;11951;37450;2421;8253;7317;23298;9738;31551
352215;201303;545;1820;495;1742;95;360;303;1084;398;1444
352220;201303;14453;49653;13643;48027;4727;17561;5798;20474;10525;38035
352230;201303;13064;46371;11725;43901;3932;16026;4564;16818;8496;32844
352240;201303;13470;43762;12591;42230;4322;16049;5164;16826;9486;32875
352250;201303;24314;81423;21843;76801;5920;22629;10184;35718;16104;58347
352260;201303;4541;14858;3564;13030;1107;4498;980;3254;2087;7752
352265;201303;921;3063;824;2918;153;605;545;1925;698;2530
352270;201303;2486;8679;2202;7973;914;3464;519;1812;1433;5276
352280;201303;2386;7692;2081;7175;614;2353;737;2487;1351;4840
352290;201303;1468;4924;1319;4604;385;1512;336;1098;721;2610
352300;201303;871;2717;754;2511;249;876;319;1059;568;1935
352310;201303;28218;101789;26233;98194;7885;31507;14556;53428;22441;84935
352320;201303;6691;21714;6012;20531;2325;8668;1934;6107;4259;14775
352330;201303;2131;7279;1884;6983;740;2958;693;2595;1433;5553
352340;201303;5498;19363;4658;17312;1712;6835;1028;3585;2740;10420
352350;201303;1594;6133;1455;5811;442;1898;471;1834;913;3732
352360;201303;1135;3926;1008;3653;303;1282;504;1687;807;2969
352370;201303;868;2983;804;2848;213;864;382;1308;595;2172
352380;201303;975;3195;858;2994;357;1373;246;826;603;2199
352390;201303;11562;36688;9432;32680;2556;10154;4130;13303;6686;23457
352400;201303;2738;8462;1885;6797;543;2162;829;2932;1372;5094
352410;201303;4294;13279;3464;11874;1454;5335;996;3298;2450;8633
352420;201303;1264;3797;1180;3666;469;1604;424;1302;893;2906
352430;201303;5922;19343;5244;18175;2171;8081;1626;5529;3797;13610
352440;201303;14544;47600;12326;43182;3451;13150;5008;16997;8459;30147
352450;201303;591;1839;411;1499;114;436;84;303;198;739
352460;201303;2512;8815;2299;8440;890;3625;901;3108;1791;6733
352470;201303;4633;13334;2861;9647;636;2323;1269;4189;1905;6512
352480;201303;5271;15435;4470;13939;1323;4689;1865;5388;3188;10077
352490;201303;689;2530;591;2300;163;701;123;461;286;1162
352500;201303;9370;32090;8956;31375;3681;13975;3554;11647;7235;25622
352510;201303;3186;11486;2663;10331;1016;4216;665;2506;1681;6722
352520;201303;2306;8387;2123;7990;542;2218;1288;4788;1830;7006
352530;201303;6808;23211;5518;20362;1713;6905;1430;5000;3143;11905
352540;201303;496;1663;419;1498;108;433;176;632;284;1065
352550;201303;1004;3475;828;3099;314;1260;199;727;513;1987
352560;201303;516;1639;451;1521;94;378;244;766;338;1144
352570;201303;1690;5463;1239;4416;313;1265;337;1040;650;2305
352580;201303;912;2844;802;2653;289;1087;329;1010;618;2097
352585;201303;135;520;125;494;38;158;43;155;81;313
352590;201303;12993;43407;11714;40960;2846;11223;6390;21729;9236;32952
352600;201303;1771;5914;1662;5664;631;2254;575;1902;1206;4156
352610;201303;3461;11638;3127;11075;1288;4889;1047;3709;2335;8598
352620;201303;5167;17415;4958;17103;1299;4767;3039;10475;4338;15242
352630;201303;817;2821;778;2727;242;928;359;1237;601;2165
352640;201303;2899;9611;2358;8340;608;2396;862;2929;1470;5325
352650;201303;813;2477;621;2089;166;605;156;483;322;1088
352660;201303;1061;3838;884;3420;308;1283;284;1080;592;2363
352670;201303;7579;26302;6692;24610;2524;9593;2166;8125;4690;17718
352680;201303;3060;11468;2628;10275;740;3185;782;2791;1522;5976
352690;201303;22585;70199;18521;62639;5401;19957;7693;25469;13094;45426
352700;201303;726;2262;585;2043;166;670;263;879;429;1549
352710;201303;4868;15094;3709;12723;1085;4151;1338;4329;2423;8480
352720;201303;8174;29037;7778;28248;2691;10397;3135;11400;5826;21797
352725;201303;384;1182;265;899;52;210;54;175;106;385
352730;201303;2368;8462;2068;7628;604;2457;623;2021;1227;4478
352740;201303;2115;6556;1864;6062;509;1978;845;2476;1354;4454
352750;201303;340;1129;307;1069;118;445;57;159;175;604
352760;201303;829;3061;772;2953;229;981;406;1494;635;2475
352770;201303;886;2820;838;2727;256;903;283;933;539;1836
352780;201303;589;2095;525;1947;175;719;156;507;331;1226
352790;201303;605;1843;508;1684;167;630;123;408;290;1038
352800;201303;1038;4075;874;3584;305;1288;147;566;452;1854
352810;201303;964;2617;736;2194;141;488;316;916;457;1404
352820;201303;477;1537;421;1416;202;725;67;227;269;952
352830;201303;388;1189;308;1005;99;342;51;163;150;505
352840;201303;3206;11609;2844;10801;909;3718;1016;3846;1925;7564
352850;201303;9336;31509;8300;29637;2781;10481;2751;10113;5532;20594
352860;201303;1004;3438;927;3264;406;1519;233;748;639;2267
352870;201303;890;2536;748;2260;155;569;374;1042;529;1611
352880;201303;2067;6524;1719;5728;456;1649;428;1305;884;2954
352885;201303;288;1010;273;976;99;380;88;294;187;674
352890;201303;682;2036;599;1865;153;528;192;554;345;1082
352900;201303;17115;54573;13794;47676;4087;15330;5620;18720;9707;34050
352910;201303;281;926;248;851;81;287;37;111;118;398
352920;201303;3335;10553;2923;9713;988;3632;1007;3118;1995;6750
352930;201303;6649;21967;5386;19136;1785;6803;953;3266;2738;10069
352940;201303;26612;93778;23643;86558;8804;33860;5202;18902;14006;52762
352950;201303;308;1007;224;820;67;292;60;195;127;487
352960;201303;468;1555;393;1387;93;368;96;320;189;688
352965;201303;336;976;285;877;77;239;51;167;128;406
352970;201303;3270;8800;2912;8335;341;1043;2187;6389;2528;7432
352980;201303;1345;4210;1192;3957;406;1422;489;1649;895;3071
352990;201303;3449;12086;3265;11755;1133;4295;1501;5464;2634;9759
353000;201303;521;1507;408;1269;95;335;119;327;214;662
353010;201303;2598;8038;2134;7079;742;2663;729;2273;1471;4936
353020;201303;4146;12120;3284;10295;685;2391;1341;3900;2026;6291
353030;201303;4860;15009;4327;13955;1586;5504;1175;3621;2761;9125
353040;201303;646;1908;560;1772;219;750;186;575;405;1325
353050;201303;5132;18738;4653;17751;1943;7935;1472;5355;3415;13290
353060;201303;31548;106562;29491;103201;5903;24057;18962;63447;24865;87504
353070;201303;8004;28470;6481;24858;2498;10115;1514;5890;4012;16005
353080;201303;4523;16106;3845;14492;1360;5482;1089;3897;2449;9379
353090;201303;572;1973;514;1863;102;443;243;812;345;1255
353100;201303;258;788;217;699;103;333;39;127;142;460
353110;201303;7443;24102;6683;22663;1473;5287;3854;13364;5327;18651
353120;201303;462;1637;404;1496;156;649;96;317;252;966
353130;201303;2900;9264;2576;8692;990;3662;962;3054;1952;6716
353140;201303;2423;7079;1975;6145;707;2401;526;1437;1233;3838
353150;201303;1776;5920;1525;5423;672;2497;313;1162;985;3659
353160;201303;560;1781;485;1610;150;520;112;340;262;860
353170;201303;514;1883;470;1800;202;858;155;562;357;1420
353180;201303;4401;14763;3896;13793;849;3502;2155;7264;3004;10766
353190;201303;3364;11157;2967;10220;827;3165;1277;4032;2104;7197
353200;201303;766;2760;701;2610;213;910;279;977;492;1887
353205;201303;531;1757;428;1518;114;419;130;476;244;895
353210;201303;918;2612;759;2310;149;513;417;1230;566;1743
353215;201303;520;1686;462;1564;107;432;182;618;289;1050
353220;201303;884;2793;816;2665;227;823;313;997;540;1820
353230;201303;1157;3713;1092;3603;334;1233;419;1300;753;2533
353240;201303;2022;7081;1871;6768;655;2628;741;2462;1396;5090
353250;201303;1103;3243;954;2975;298;1005;323;942;621;1947
353260;201303;1132;3437;1009;3235;345;1158;367;1153;712;2311
353270;201303;578;1821;505;1682;167;616;150;468;317;1084
353280;201303;508;1727;445;1617;164;640;102;348;266;988
353282;201303;1665;5785;1627;5726;325;1251;1126;3916;1451;5167
353284;201303;322;964;265;862;86;298;84;268;170;566
353286;201303;140;429;97;327;26;85;19;66;45;151
353290;201303;413;1542;378;1466;159;645;133;508;292;1153
353300;201303;1834;5992;1663;5614;624;2284;531;1623;1155;3907
353310;201303;343;1101;326;1060;144;493;91;276;235;769
353320;201303;425;1280;375;1203;111;423;158;463;269;886
353325;201303;455;1665;390;1533;139;604;54;212;193;816
353330;201303;479;1536;410;1384;102;387;170;531;272;918
353340;201303;2997;10043;2584;9167;960;3640;809;2790;1769;6430
353350;201303;3160;9892;2804;9239;1024;3631;1207;3833;2231;7464
353360;201303;394;1436;345;1320;104;453;169;603;273;1056
353370;201303;688;2278;627;2142;201;737;281;951;482;1688
353380;201303;386;1323;347;1251;112;446;153;536;265;982
353390;201303;4514;13074;3670;11487;1131;3859;1367;3967;2498;7826
353400;201303;572;1815;485;1628;121;452;168;492;289;944
353410;201303;629;2024;540;1882;186;711;262;879;448;1590
353420;201303;591;1866;517;1648;187;631;155;444;342;1075
353430;201303;2395;8429;1895;7022;704;2678;155;503;859;3181
353440;201303;56794;190771;52611;180956;17206;62719;18176;60977;35382;123696
353450;201303;442;1396;398;1316;112;441;139;425;251;866
353460;201303;3770;11174;3351;10388;982;3302;1540;4710;2522;8012
353470;201303;10576;34816;8546;30437;2910;11297;2020;7026;4930;18323
353475;201303;1562;4724;1210;3946;356;1264;312;935;668;2199
353480;201303;1485;4602;1363;4376;321;1180;726;2209;1047;3389
353490;201303;1645;4838;1413;4378;401;1384;396;1124;797;2508
353500;201303;1136;3404;1057;3261;478;1560;340;1002;818;2562
353510;201303;1343;4458;1181;4020;333;1265;428;1306;761;2571
353520;201303;1095;3503;942;3220;421;1532;224;752;645;2284
353530;201303;2585;8135;2330;7650;729;2657;967;3033;1696;5690
353540;201303;1769;5691;1644;5471;701;2429;539;1858;1240;4287
353550;201303;6289;19029;5683;18031;1333;4954;2947;8612;4280;13566
353560;201303;2328;7911;2031;7383;565;2368;812;2798;1377;5166
353570;201303;469;1537;392;1371;97;392;197;612;294;1004
353580;201303;2245;7691;2124;7462;822;3202;1025;3391;1847;6593
353590;201303;768;2257;661;2073;269;928;177;574;446;1502
353600;201303;1747;5278;1613;5039;399;1391;821;2563;1220;3954
353610;201303;546;2022;492;1922;183;798;172;657;355;1455
353620;201303;2261;8160;2095;7857;740;3049;783;2772;1523;5821
353625;201303;350;992;259;831;109;397;60;167;169;564
353630;201303;1792;6275;1513;5653;462;1922;367;1283;829;3205
353640;201303;1505;4396;1427;4269;430;1386;724;2221;1154;3607
353650;201303;4191;14160;3704;13042;1023;3911;1855;6240;2878;10151
353657;201303;274;955;255;914;74;304;92;320;166;624
353660;201303;1306;3413;991;2967;471;1542;147;312;618;1854
353670;201303;4640;15726;4108;14553;1284;4923;1446;4946;2730;9869
353680;201303;614;2282;584;2223;337;1316;123;486;460;1802
353690;201303;471;1320;334;1096;120;435;99;293;219;728
353700;201303;2220;7450;2002;6968;526;2128;668;2141;1194;4269
353710;201303;1738;6452;1575;6095;635;2683;547;2052;1182;4735
353715;201303;453;1400;406;1320;65;237;243;798;308;1035
353720;201303;2013;6498;1789;6166;372;1231;1106;4061;1478;5292
353730;201303;4290;13803;3495;11926;959;3529;905;2879;1864;6408
353740;201303;2199;6934;1804;6095;667;2344;493;1607;1160;3951
353750;201303;571;2144;511;2009;192;813;120;476;312;1289
353760;201303;5997;20876;5072;18938;1708;6707;1854;7045;3562;13752
353770;201303;779;2486;540;1895;130;497;83;228;213;725
353780;201303;5411;20136;4971;19248;2528;9959;1144;4749;3672;14708
353790;201303;3043;11140;2753;10537;1059;4430;527;2088;1586;6518
353800;201303;13694;46761;11569;42442;3425;13757;4909;17607;8334;31364
353810;201303;1114;3786;1006;3540;329;1214;416;1478;745;2692
353820;201303;1120;4165;1074;4073;424;1771;367;1327;791;3098
353830;201303;756;2139;591;1816;140;464;238;729;378;1193
353850;201303;1723;5962;1612;5753;466;1770;744;2602;1210;4372
353860;201303;2244;7909;1972;7308;753;3022;730;2629;1483;5651
353870;201303;22225;72584;17417;62687;4474;18128;6187;20354;10661;38482
353880;201303;2608;8905;2400;8573;551;2248;1364;4742;1915;6990
353890;201303;2193;5991;1661;5142;552;1894;681;1980;1233;3874
353900;201303;1080;3476;829;2888;241;944;190;587;431;1531
353910;201303;2057;7423;1957;7144;653;2547;835;3060;1488;5607
353920;201303;2626;8076;2081;6927;530;1821;424;1332;954;3153
353930;201303;3502;12954;3111;12131;1244;5155;760;2830;2004;7985
353940;201303;1471;4842;1318;4531;357;1431;516;1616;873;3047
353950;201303;3528;11903;3267;11427;624;2498;2065;7042;2689;9540
353960;201303;564;1881;468;1652;127;513;129;383;256;896
353970;201303;516;1558;456;1482;48;195;340;1079;388;1274
353980;201303;13487;40933;11497;37859;3010;10727;5970;19390;8980;30117
353990;201303;516;1665;471;1550;149;545;172;507;321;1052
354000;201303;1678;5216;1211;4270;303;1194;118;360;421;1554
354010;201303;366;1188;331;1127;179;633;75;247;254;880
354020;201303;4523;14262;4162;13517;1425;5022;1738;5318;3163;10340
354025;201303;1012;3008;834;2702;243;872;226;712;469;1584
354030;201303;579;1571;427;1359;150;540;135;387;285;927
354040;201303;757;2125;611;1864;101;388;373;1067;474;1455
354050;201303;849;2990;795;2861;343;1301;218;788;561;2089
354060;201303;3970;13547;3367;12286;1084;4321;1347;4703;2431;9024
354070;201303;3434;11745;3034;10855;1219;4642;728;2591;1947;7233
354075;201303;2233;8678;2139;8508;780;3321;901;3533;1681;6854
354080;201303;1812;5716;1496;4943;426;1481;539;1686;965;3167
354085;201303;286;839;256;784;35;141;171;476;206;617
354090;201303;1049;3282;1012;3225;169;612;734;2274;903;2886
354100;201303;16153;56891;14110;53167;3697;14884;7046;26593;10743;41477
354105;201303;776;2614;653;2371;214;895;181;597;395;1492
354110;201303;653;2193;606;2094;173;656;197;630;370;1286
354120;201303;2026;6093;1842;5789;622;2194;601;1753;1223;3947
354130;201303;5924;18935;5356;17796;1861;6584;1942;6315;3803;12899
354140;201303;16504;47369;12207;38572;2796;10108;5441;16083;8237;26191
354150;201303;4110;12172;3460;11053;1184;4163;1318;4066;2502;8229
354160;201303;3756;12799;3373;11989;1032;3946;1367;4663;2399;8609
354165;201303;369;1394;338;1315;121;484;84;350;205;834
354170;201303;1572;5320;1308;4668;317;1273;461;1493;778;2766
354180;201303;481;1505;459;1459;51;196;338;1024;389;1220
354190;201303;1588;5528;1389;5056;480;1846;404;1429;884;3275
354200;201303;1108;3324;924;2986;238;920;345;959;583;1879
354210;201303;835;3007;757;2828;202;873;305;1059;507;1932
354220;201303;2848;9422;2630;8970;1015;3669;962;3178;1977;6847
354230;201303;750;2592;721;2542;249;933;331;1172;580;2105
354240;201303;1187;4224;1011;3851;341;1422;276;1015;617;2437
354250;201303;457;1556;408;1497;190;764;113;390;303;1154
354260;201303;9170;28741;8377;27454;2693;9603;3491;11477;6184;21080
354270;201303;1081;3985;1008;3819;332;1358;406;1560;738;2918
354280;201303;830;2586;791;2518;172;605;412;1332;584;1937
354290;201303;1281;4683;1186;4472;413;1661;295;1106;708;2767
354300;201303;3741;13622;3678;13491;1041;4023;2037;7437;3078;11460
354310;201303;752;2581;591;2171;186;755;126;451;312;1206
354320;201303;797;2486;705;2301;207;756;247;754;454;1510
354323;201303;323;1005;272;919;99;367;103;314;202;681
354325;201303;1292;4569;1186;4333;363;1492;425;1420;788;2912
354330;201303;7763;24962;7167;23836;1979;7032;3932;12920;5911;19952
354340;201303;28432;95717;24652;88699;9638;37227;8691;30401;18329;67628
354350;201303;1115;3489;1061;3392;327;1097;549;1696;876;2793
354360;201303;418;1427;353;1310;106;422;72;278;178;700
354370;201303;1133;3901;1028;3698;194;822;715;2504;909;3326
354380;201303;1289;3950;1081;3574;435;1592;191;555;626;2147
354390;201303;10317;35266;8302;30486;2381;9630;2700;9390;5081;19020
354400;201303;2052;7430;1824;6875;484;2018;594;2097;1078;4115
354410;201303;5995;19026;5145;17757;1271;4747;2880;9961;4151;14708
354420;201303;1622;4901;1414;4460;470;1604;464;1403;934;3007
354425;201303;3387;10167;2981;9439;1102;3691;970;3151;2072;6842
354430;201303;1279;4349;1195;4230;304;1209;608;2090;912;3299
354440;201303;481;1533;415;1404;116;422;149;490;265;912
354450;201303;422;1256;327;1052;55;229;103;288;158;517
354460;201303;677;2197;651;2147;265;900;327;1082;592;1982
354470;201303;412;1259;365;1172;74;293;172;514;246;807
354480;201303;711;2234;642;2109;159;614;267;761;426;1375
354490;201303;704;2482;543;2062;166;683;148;495;314;1178
354500;201303;2486;8645;2292;8291;879;3488;754;2761;1633;6249
354510;201303;640;2251;570;2086;213;835;190;684;403;1519
354515;201303;329;1177;275;1056;75;323;83;291;158;614
354520;201303;4607;17183;4135;16116;1514;6520;1455;5455;2969;11975
354530;201303;2422;9219;2269;8910;671;2802;1242;4879;1913;7681
354540;201303;1289;4160;1142;3899;402;1444;397;1407;799;2851
354550;201303;505;1768;446;1608;105;408;152;514;257;922
354560;201303;1294;4078;1045;3494;339;1170;276;885;615;2055
354570;201303;575;1857;488;1639;190;698;126;389;316;1087
354580;201303;8587;26486;7396;24116;1822;6742;3540;10882;5362;17624
354600;201303;1645;5901;1474;5563;526;2243;575;2045;1101;4288
354610;201303;466;1323;343;1090;88;300;104;287;192;587
354620;201303;401;1431;336;1304;106;483;103;360;209;843
354625;201303;264;914;229;846;54;227;62;226;116;453
354630;201303;1694;6186;1522;5758;608;2346;483;1737;1091;4083
354640;201303;4031;13898;3509;12769;1169;4767;853;2902;2022;7669
354650;201303;950;2999;862;2809;196;742;453;1409;649;2151
354660;201303;1861;5838;1477;5064;548;2105;459;1468;1007;3573
354670;201303;1705;5795;1399;5020;444;1776;379;1186;823;2962
354680;201303;4935;17342;4614;16661;1426;5420;1799;6428;3225;11848
354690;201303;606;2320;502;2014;129;554;169;606;298;1160
354700;201303;1117;3354;809;2682;147;602;316;920;463;1522
354710;201303;605;1863;536;1734;157;593;179;531;336;1124
354720;201303;176;527;140;451;54;176;38;126;92;302
354730;201303;7758;28534;7077;27065;2467;9913;2656;9963;5123;19876
354740;201303;218;738;186;666;48;184;46;168;94;352
354750;201303;2223;7321;1899;6877;689;2607;754;2810;1443;5417
354760;201303;2093;7201;1836;6630;664;2559;505;1752;1169;4311
354765;201303;239;675;183;583;37;147;58;170;95;317
354770;201303;2658;8105;2157;7267;1012;3654;350;1103;1362;4757
354780;201303;30173;102533;28546;98715;7917;30078;14105;46526;22022;76604
354790;201303;847;2815;766;2699;237;937;389;1277;626;2214
354800;201303;1843;6024;1690;5806;653;2347;794;2770;1447;5117
354805;201303;828;2659;656;2281;139;556;130;413;269;969
354810;201303;631;2138;516;1922;219;883;88;312;307;1195
354820;201303;986;3653;899;3468;310;1349;217;759;527;2108
354830;201303;414;1341;374;1263;103;392;142;466;245;858
354840;201303;761;2392;719;2301;240;845;240;742;480;1587
354850;201303;14259;48050;11378;41932;3494;14329;3930;13508;7424;27837
354860;201303;1218;4086;1115;3904;347;1452;486;1563;833;3015
354870;201303;40940;136054;38960;131994;11789;43115;20334;66896;32123;110011
354880;201303;3760;12278;2833;10198;976;3847;670;2214;1646;6061
354890;201303;13959;44588;12215;41096;3657;13597;4583;14771;8240;28368
354900;201303;594;1708;482;1546;177;618;167;534;344;1152
354910;201303;4626;15724;3751;13842;1155;4664;612;2196;1767;6860
354920;201303;480;1440;371;1234;114;413;86;273;200;686
354925;201303;365;1093;220;778;40;158;46;151;86;309
354930;201303;239;748;220;702;73;269;58;174;131;443
354940;201303;2490;8972;1982;7582;867;3483;361;1317;1228;4800
354950;201303;1406;4855;1287;4682;268;1142;783;2752;1051;3894
354960;201303;762;2482;685;2360;189;730;364;1219;553;1949
354970;201303;3699;13012;3325;12232;962;3965;1518;5322;2480;9287
354980;201303;31897;81079;17852;56374;4207;14722;5812;17112;10019;31834
354990;201303;31736;112461;30186;109125;7526;30321;16487;57784;24013;88105
354995;201303;1884;6108;1781;5949;510;1805;874;2938;1384;4743
355000;201303;1616;5608;1433;5283;565;2213;399;1458;964;3671
355010;201303;3367;11051;3010;10372;734;2844;1559;5239;2293;8083
355020;201303;3087;11553;2725;10842;1400;5865;773;3131;2173;8996
355030;201303;697195;2170873;651566;2081154;203007;700298;256203;804170;459210;1504468
355040;201303;2710;9353;2431;8817;943;3725;1019;3545;1962;7270
355050;201303;1144;3840;964;3453;337;1320;259;899;596;2219
355060;201303;4556;16281;3738;14327;1166;4953;769;2671;1935;7624
355070;201303;5905;19502;5348;18561;1399;5561;2813;9216;4212;14777
355080;201303;1251;4777;1079;4308;434;1920;160;545;594;2465
355090;201303;1018;3817;884;3490;214;922;387;1478;601;2400
355100;201303;28845;96345;26067;91313;9603;35128;8796;31864;18399;66992
355110;201303;1238;4478;1141;4270;404;1640;418;1536;822;3176
355120;201303;628;2087;559;1952;176;654;250;871;426;1525
355130;201303;412;1208;323;1022;103;354;88;226;191;580
355140;201303;973;3639;940;3558;304;1271;436;1584;740;2855
355150;201303;3114;11129;2838;10540;1003;3888;1060;3791;2063;7679
355160;201303;1428;5181;1264;4903;566;2423;356;1246;922;3669
355170;201303;8393;25892;6538;22406;2352;8741;1892;6270;4244;15011
355180;201303;2703;8759;2405;8213;764;2979;903;2969;1667;5948
355190;201303;1214;4425;1132;4240;494;1904;318;1161;812;3065
355200;201303;866;3340;833;3271;415;1733;207;780;622;2513
355210;201303;2584;9289;2352;8766;798;3299;834;2884;1632;6183
355220;201303;27223;96535;25416;93016;11880;44853;7402;27922;19282;72775
355230;201303;881;2824;598;2145;124;509;142;461;266;970
355240;201303;20480;65319;16051;55207;4084;15791;6350;20177;10434;35968
355250;201303;22687;79734;20852;76284;6357;24814;10074;36555;16431;61369
355255;201303;860;2470;634;1982;123;427;187;547;310;974
355260;201303;1549;4541;1407;4284;402;1406;643;1830;1045;3236
355270;201303;1579;5062;1500;4934;253;1009;1027;3206;1280;4215
355280;201303;20662;65719;18776;62165;5292;19548;8606;27490;13898;47038
355290;201303;827;2770;768;2661;178;690;352;1153;530;1843
355300;201303;806;2767;648;2402;172;710;149;495;321;1205
355310;201303;978;3123;881;2939;270;935;360;1245;630;2180
355320;201303;706;2339;632;2166;202;761;214;648;416;1409
355330;201303;1466;5523;1272;5137;521;2321;311;1144;832;3465
355340;201303;2795;8047;2677;7861;674;2226;1577;4423;2251;6649
355350;201303;1272;4779;1184;4569;458;1888;295;1187;753;3075
355360;201303;1051;3896;993;3778;292;1242;594;2195;886;3437
355365;201303;308;995;265;908;85;332;64;211;149;543
355370;201303;6408;17545;4848;15803;2020;7157;1807;5928;3827;13085
355380;201303;3598;11296;2846;9535;890;3255;626;1862;1516;5117
355385;201303;912;3162;885;3117;358;1373;286;1005;644;2378
355390;201303;1370;3970;1198;3622;324;1061;410;1236;734;2297
355395;201303;1448;4715;1220;4139;234;931;565;1754;799;2685
355400;201303;8261;29591;7697;28446;2281;9359;4185;14960;6466;24319
355410;201303;11900;45551;11334;44387;4732;19501;3415;13575;8147;33076
355420;201303;776;2926;748;2866;329;1306;240;948;569;2254
355430;201303;3474;10705;3055;9935;962;3434;1184;3693;2146;7127
355440;201303;826;2857;705;2545;219;835;222;729;441;1564
355450;201303;2401;8309;2044;7565;687;2757;591;2071;1278;4828
355460;201303;539;1607;425;1392;132;502;121;358;253;860
355465;201303;411;1266;355;1162;120;418;93;300;213;718
355470;201303;882;2838;721;2553;300;1175;186;604;486;1779
355475;201303;140;542;120;477;31;129;37;161;68;290
355480;201303;3117;11761;2943;11356;994;4141;1227;4622;2221;8763
355490;201303;770;2346;628;2060;193;688;141;472;334;1160
355495;201303;650;2265;624;2219;213;837;239;802;452;1639
355500;201303;7559;24145;5572;19611;1501;5838;1078;3464;2579;9302
355510;201303;1597;4993;1380;4514;369;1373;364;1129;733;2502
355520;201303;364;1005;264;806;69;244;72;185;141;429
355530;201303;149;432;103;337;27;97;20;66;47;163
355535;201303;735;2310;616;2082;186;747;196;571;382;1318
355540;201303;9759;32805;9296;32016;2708;10062;4763;16150;7471;26212
355550;201303;695;2244;661;2185;198;731;320;1032;518;1763
355560;201303;1403;4225;1101;3644;267;1005;291;862;558;1867
355570;201303;181;631;162;582;51;197;34;111;85;308
355580;201303;1151;3628;1034;3389;443;1583;318;1005;761;2588
355590;201303;227;672;209;644;48;175;111;337;159;512
355600;201303;931;3213;818;2964;406;1512;202;730;608;2242
355610;201303;1399;4206;1198;3892;379;1335;498;1561;877;2896
355620;201303;3656;12254;3019;10818;777;3207;1278;4193;2055;7400
355630;201303;3169;9452;2046;7047;448;1757;769;2479;1217;4236
355635;201303;858;3045;803;2930;233;927;382;1353;615;2280
355640;201303;3644;12526;3164;11422;1245;4675;670;2439;1915;7114
355645;201303;3253;12143;3121;11886;709;2973;1915;7207;2624;10180
355650;201303;6100;19973;5398;18592;1415;5785;2957;9371;4372;15156
355660;201303;1210;4081;1016;3679;378;1532;299;996;677;2528
355670;201303;1953;6555;1372;5129;401;1696;409;1339;810;3035
355680;201303;1654;5883;1399;5250;591;2315;276;997;867;3312
355690;201303;333;1189;304;1135;197;765;25;77;222;842
355695;201303;321;988;242;801;47;180;35;92;82;272
355700;201303;6010;22290;5636;21365;1767;7364;2571;9272;4338;16636
355710;201303;11292;30647;7816;24338;2863;9466;1951;5937;4814;15403
355715;201303;169;549;134;480;46;170;21;69;67;239
355720;201303;1474;5067;1266;4635;489;1966;356;1178;845;3144
355730;201303;747;2683;686;2568;301;1194;171;657;472;1851
410010;201303;1577;5206;1473;5008;423;1516;650;2258;1073;3774
410020;201303;1148;4114;1095;4027;386;1491;393;1421;779;2912
410030;201303;1129;4121;1023;3849;391;1540;222;852;613;2392
410040;201303;11619;40559;10882;39085;4321;16554;3049;10865;7370;27419
410045;201303;1075;3234;864;2876;280;975;357;1172;637;2147
410050;201303;2757;8368;2039;7014;762;2863;611;2054;1373;4917
410060;201303;1718;5808;1581;5508;514;1970;528;1804;1042;3774
410070;201303;2011;5998;1758;5504;751;2625;342;903;1093;3528
410080;201303;1323;4209;1169;3967;314;1120;684;2312;998;3432
410090;201303;1101;3621;1002;3404;394;1451;290;922;684;2373
410100;201303;2554;8135;2172;7348;716;2777;547;1797;1263;4574
410105;201303;483;1612;403;1418;110;451;83;259;193;710
410110;201303;2078;6905;1956;6651;570;2169;804;2718;1374;4887
410115;201303;511;1486;448;1356;116;425;136;345;252;770
410120;201303;2746;9790;2614;9581;1057;4091;1027;3846;2084;7937
410130;201303;1281;4537;1200;4372;278;977;751;2811;1029;3788
410140;201303;11988;36824;9667;32402;3568;13160;3373;11112;6941;24272
410150;201303;16549;44116;8713;27544;1992;7236;1688;4822;3680;12058
410160;201303;3182;10644;2930;10201;1034;3924;1083;3818;2117;7742
410165;201303;711;2282;649;2145;139;500;328;1057;467;1557
410170;201303;1507;4862;1332;4488;546;1997;371;1205;917;3202
410180;201303;8151;27276;7273;25390;1979;7984;3497;11347;5476;19331
410185;201303;640;1846;599;1781;127;398;390;1172;517;1570
410190;201303;2071;6432;1934;6158;690;2380;609;1853;1299;4233
410200;201303;4893;14538;4170;13174;1557;5400;809;2504;2366;7904
410210;201303;2477;7749;2039;6818;582;2205;445;1322;1027;3527
410220;201303;563;1713;484;1556;109;389;175;544;284;933
410230;201303;1745;5833;1640;5665;667;2494;564;1901;1231;4395
410240;201303;4826;15709;4556;15158;1581;5637;1695;5642;3276;11279
410250;201303;2299;6832;1782;5812;636;2330;399;1161;1035;3491
410260;201303;1562;5031;1408;4766;470;1685;494;1674;964;3359
410270;201303;511;1567;450;1451;158;556;174;568;332;1124
410275;201303;850;2604;674;2302;118;448;397;1379;515;1827
410280;201303;2672;8280;1929;6622;504;1980;296;986;800;2966
410290;201303;2966;9811;2729;9377;738;2803;1267;4330;2005;7133
410300;201303;561;1678;525;1622;93;362;313;896;406;1258
410302;201303;532;1630;479;1557;57;180;318;1058;375;1238
410304;201303;1357;4689;1262;4499;400;1458;557;2056;957;3514
410305;201303;1924;5529;1685;5175;559;1791;860;2709;1419;4500
410310;201303;2182;7673;2033;7377;707;2754;681;2576;1388;5330
410315;201303;575;1899;499;1749;134;516;233;781;367;1297
410320;201303;1136;3454;846;2898;224;895;92;260;316;1155
410322;201303;454;1516;412;1420;131;493;145;498;276;991
410330;201303;1369;4108;1202;3773;404;1390;358;1080;762;2470
410335;201303;986;3051;859;2820;257;953;294;913;551;1866
410337;201303;732;2070;646;1923;145;508;277;784;422;1292
410340;201303;562;1760;442;1464;95;357;103;292;198;649
410345;201303;1558;4922;1387;4604;518;1884;301;914;819;2798
410347;201303;805;2389;612;2023;217;783;121;365;338;1148
410350;201303;891;2968;733;2670;258;1044;95;319;353;1363
410360;201303;3125;10076;2885;9679;1067;3868;781;2665;1848;6533
410370;201303;11659;35752;9385;31056;2824;10572;2740;8489;5564;19061
410380;201303;1253;4162;1181;4015;341;1222;585;2007;926;3229
410390;201303;2699;8203;2249;7430;851;3025;670;2048;1521;5073
410395;201303;799;2920;752;2832;205;834;426;1614;631;2448
410400;201303;4756;15972;4277;15031;1457;5686;1259;4328;2716;10014
410405;201303;886;2740;750;2461;182;699;357;1100;539;1799
410410;201303;1287;4579;1243;4496;435;1734;369;1305;804;3039
410420;201303;9419;31756;8558;29845;3098;11813;2537;8397;5635;20210
410425;201303;3530;11704;2760;9960;840;3368;480;1714;1320;5082
410430;201303;13743;40178;10969;35095;3551;12417;3341;10744;6892;23161
410440;201303;3404;11334;3180;10938;800;2900;1668;5875;2468;8775
410442;201303;2792;10054;2628;9672;949;3664;943;3484;1892;7148
410445;201303;2173;7769;1950;7379;644;2567;839;3328;1483;5895
410450;201303;2392;7194;2050;6561;687;2395;563;1670;1250;4065
410460;201303;2259;7075;1920;6357;502;1772;800;2597;1302;4369
410465;201303;1537;6090;1445;5857;601;2491;406;1586;1007;4077
410470;201303;1728;5764;1594;5481;481;1737;625;2174;1106;3911
410480;201303;25975;80664;22673;74454;9224;33176;6370;20051;15594;53227
410490;201303;9979;34957;9143;33108;3223;12583;3177;11527;6400;24110
410500;201303;1311;4429;1190;4177;444;1687;332;1196;776;2883
410510;201303;2074;5912;1663;5160;509;1700;611;1815;1120;3515
410520;201303;3117;11220;2982;10942;1204;4628;1008;3752;2212;8380
410530;201303;1477;4474;1311;4129;365;1320;522;1550;887;2870
410540;201303;3658;10953;2756;9330;778;2829;1041;3580;1819;6409
410550;201303;5853;19022;4819;16672;1721;6595;655;2054;2376;8649
410560;201303;1117;3830;928;3313;253;959;222;677;475;1636
410570;201303;2553;8968;2386;8670;747;2798;1034;3967;1781;6765
410580;201303;23267;76991;21366;73468;7868;29486;6890;22941;14758;52427
410590;201303;1186;3979;880;3121;187;752;227;725;414;1477
410600;201303;1720;5517;1544;5163;476;1667;720;2450;1196;4117
410610;201303;776;2522;705;2387;216;773;305;1016;521;1789
410620;201303;1628;6070;1505;5757;517;2129;431;1610;948;3739
410630;201303;2331;7149;2089;6737;598;2213;951;3000;1549;5213
410640;201303;4295;13513;3748;12547;1380;5197;934;2962;2314;8159
410645;201303;1198;4432;1166;4357;470;1900;404;1526;874;3426
410650;201303;2325;7439;2015;6846;764;2741;650;2186;1414;4927
410655;201303;844;2724;753;2544;245;895;223;731;468;1626
410657;201303;516;1689;485;1624;153;601;198;604;351;1205
410660;201303;3655;10943;2971;9471;1154;3932;615;1840;1769;5772
410670;201303;962;2852;758;2444;218;797;234;722;452;1519
410680;201303;2098;7826;1852;7166;554;2220;739;2962;1293;5182
410685;201303;616;1941;584;1883;144;465;353;1152;497;1617
410690;201303;110857;332849;82216;274525;23128;86218;23230;70906;46358;157124
410700;201303;2134;7361;2030;7148;745;2847;747;2515;1492;5362
410710;201303;1016;3345;859;2970;229;903;245;809;474;1712
410712;201303;667;2193;610;2078;289;1065;173;622;462;1687
410715;201303;1085;3542;991;3355;283;1036;375;1249;658;2285
410720;201303;3541;11834;3158;11015;987;3630;992;3381;1979;7011
410725;201303;993;2945;798;2605;222;789;277;816;499;1605
410730;201303;683;2147;632;2042;293;1014;167;510;460;1524
410740;201303;838;2647;624;2207;170;684;251;869;421;1553
410750;201303;1639;5156;1499;4835;570;2033;436;1305;1006;3338
410752;201303;220;708;211;696;54;214;111;342;165;556
410753;201303;424;1390;388;1313;108;422;138;423;246;845
410754;201303;937;3152;843;2981;153;599;552;1975;705;2574
410755;201303;565;1747;508;1644;132;492;210;636;342;1128
410760;201303;2298;7819;2210;7637;886;3196;823;2863;1709;6059
410765;201303;13946;43662;11342;38436;3190;12025;2461;8331;5651;20356
410770;201303;798;2384;708;2223;203;710;308;939;511;1649
410773;201303;1157;3833;1053;3632;283;1116;470;1493;753;2609
410775;201303;1771;5426;1746;5392;392;1137;1233;3984;1625;5121
410780;201303;560;1808;492;1671;141;506;133;479;274;985
410785;201303;879;2988;727;2519;257;923;270;947;527;1870
410790;201303;708;2277;619;2072;226;846;143;426;369;1272
410800;201303;2036;6228;1813;5873;861;2966;524;1657;1385;4623
410810;201303;292;911;237;783;32;128;107;335;139;463
410820;201303;1000;3157;908;2957;301;1081;279;882;580;1963
410830;201303;28068;89635;24304;82771;7636;28190;8763;29819;16399;58009
410832;201303;1105;3440;1033;3307;252;960;518;1534;770;2494
410840;201303;7512;24821;6815;23314;2468;9232;1749;5562;4217;14794
410845;201303;1466;4649;1314;4345;324;1163;678;2253;1002;3416
410850;201303;2528;7779;2329;7511;476;1848;1355;4293;1831;6141
410855;201303;668;1999;614;1894;184;602;223;706;407;1308
410860;201303;2650;8360;2441;8061;759;2623;1137;3897;1896;6520
410865;201303;1576;5736;1443;5468;246;969;927;3632;1173;4601
410870;201303;1329;4338;1277;4253;552;1998;420;1371;972;3369
410880;201303;4857;14790;4100;13472;1373;5036;1278;4005;2651;9041
410890;201303;1048;3347;829;2934;311;1190;133;427;444;1617
410895;201303;1169;4309;1091;4123;402;1609;404;1494;806;3103
410900;201303;795;2344;634;2088;141;517;177;567;318;1084
410910;201303;293;944;260;882;66;248;112;355;178;603
410920;201303;767;2471;631;2215;198;747;166;535;364;1282
410930;201303;1935;6403;1756;6117;550;2171;687;2327;1237;4498
410940;201303;18899;67505;17593;65224;6003;24007;8027;30006;14030;54013
410950;201303;1839;6368;1694;6102;380;1398;1026;3798;1406;5196
410960;201303;5422;16278;4176;14235;1560;5618;1429;5077;2989;10695
410965;201303;979;3429;924;3316;207;800;564;2068;771;2868
410970;201303;4795;15290;4167;14000;1552;5806;964;3299;2516;9105
410975;201303;1208;3868;1079;3629;207;800;579;1963;786;2763
410980;201303;4540;14167;3328;11548;997;3841;842;2733;1839;6574
410990;201303;959;3094;769;2664;281;1080;172;506;453;1586
411000;201303;356;1159;288;1006;78;303;51;166;129;469
411005;201303;426;1306;366;1165;106;337;80;237;186;574
411007;201303;2065;6974;1994;6859;625;2287;1037;3663;1662;5950
411010;201303;3592;12792;3420;12435;1527;5979;971;3371;2498;9350
411020;201303;2477;8340;2307;8039;795;3028;886;3115;1681;6143
411030;201303;782;2280;691;2120;244;831;185;526;429;1357
411040;201303;338;1144;292;1034;114;419;63;225;177;644
411050;201303;2065;7754;1905;7389;801;3322;430;1679;1231;5001
411060;201303;2003;6547;1787;6117;637;2431;328;1011;965;3442
411065;201303;361;1133;292;982;53;205;110;328;163;533
411070;201303;3360;11611;2743;10399;999;4165;335;1180;1334;5345
411080;201303;1775;5905;1686;5717;406;1549;872;2898;1278;4447
411090;201303;1014;2948;893;2778;268;963;268;782;536;1745
411095;201303;1463;4385;1178;3845;335;1189;288;916;623;2105
411100;201303;1448;4311;1118;3672;300;1094;281;947;581;2041
411110;201303;876;2718;707;2363;226;815;129;364;355;1179
411120;201303;1563;5143;1423;4834;471;1717;476;1592;947;3309
411125;201303;4520;15045;4426;14873;1626;5761;2139;7119;3765;12880
411130;201303;714;2256;619;2060;208;729;230;777;438;1506
411140;201303;2148;8009;1932;7451;774;3094;489;2059;1263;5153
411150;201303;5550;16501;5020;15539;1643;5521;1508;4361;3151;9882
411155;201303;1056;3326;987;3170;385;1334;295;877;680;2211
411160;201303;280;883;259;839;112;389;87;276;199;665
411170;201303;748;2656;689;2508;226;879;209;744;435;1623
411180;201303;5716;18309;5153;17299;1751;6403;1623;5455;3374;11858
411190;201303;1714;5236;1473;4798;478;1713;435;1353;913;3066
411200;201303;3542;11881;3199;11316;1314;5016;1053;3688;2367;8704
411210;201303;2682;7970;2244;7181;897;3130;301;891;1198;4021
411220;201303;1113;3407;918;3044;266;994;368;1135;634;2129
411230;201303;922;2972;803;2725;281;1029;255;826;536;1855
411240;201303;784;2543;714;2390;334;1212;171;493;505;1705
411250;201303;3018;8665;2540;7792;785;2492;887;2756;1672;5248
411260;201303;244;727;195;643;56;214;95;295;151;509
411270;201303;1912;6307;1798;6123;649;2452;743;2460;1392;4912
411275;201303;1476;4592;1367;4379;442;1508;529;1686;971;3194
411280;201303;1644;5248;1350;4629;451;1746;208;654;659;2400
411290;201303;987;2898;852;2645;246;821;320;1025;566;1846
411295;201303;1031;3239;965;3138;217;783;446;1413;663;2196
411300;201303;1309;3501;928;2768;85;305;399;1095;484;1400
411310;201303;794;2402;662;2181;172;658;308;976;480;1634
411320;201303;5446;17421;4596;15709;1349;4877;1367;4545;2716;9422
411325;201303;1457;5014;1344;4808;153;646;959;3458;1112;4104
411330;201303;3335;11482;3104;11097;1192;4578;1044;3713;2236;8291
411340;201303;900;2703;641;2106;135;495;264;875;399;1370
411342;201303;857;2558;737;2288;217;771;251;687;468;1458
411345;201303;1009;3428;952;3320;286;1082;486;1684;772;2766
411350;201303;2398;7855;1935;6925;693;2655;308;1035;1001;3690
411360;201303;485;1289;332;1009;49;193;151;386;200;579
411370;201303;39806;120213;30689;102689;7730;30354;10153;31121;17883;61475
411373;201303;1293;4313;1135;3983;356;1416;257;841;613;2257
411375;201303;1257;3621;1024;3154;315;1008;310;929;625;1937
411380;201303;1224;3332;790;2440;175;607;227;688;402;1295
411390;201303;1646;5443;1551;5300;247;986;1134;3731;1381;4717
411400;201303;1468;4598;1273;4185;349;1293;492;1617;841;2910
411410;201303;2289;7388;2069;6910;738;2843;619;1773;1357;4616
411420;201303;4206;12524;3470;11039;1132;4048;803;2306;1935;6354
411430;201303;2392;8402;2223;8059;667;2627;1012;3535;1679;6162
411435;201303;495;1693;457;1612;139;534;153;517;292;1051
411440;201303;2400;8306;2242;7995;863;3321;694;2482;1557;5803
411450;201303;1690;5475;1557;5251;437;1518;796;2766;1233;4284
411460;201303;3663;12449;3327;11718;1512;5618;610;2094;2122;7712
411470;201303;896;2861;725;2463;234;847;162;519;396;1366
411480;201303;4187;13537;3614;12454;1686;6237;816;2714;2502;8951
411490;201303;1567;5186;1415;4899;645;2476;327;1026;972;3502
411500;201303;1178;3928;1028;3551;417;1542;253;851;670;2393
411510;201303;2346;7131;1947;6397;671;2404;450;1363;1121;3767
411520;201303;25678;76297;18395;60994;6506;23930;3851;12029;10357;35959
411530;201303;802;2443;587;2035;272;1036;107;343;379;1379
411535;201303;454;1445;288;1045;62;240;21;67;83;307
411540;201303;2525;7288;2095;6544;498;1707;1030;3281;1528;4988
411545;201303;917;3466;897;3424;207;863;590;2235;797;3098
411550;201303;625;1856;526;1696;243;843;121;372;364;1215
411560;201303;2421;7581;2124;6912;615;2214;541;1615;1156;3829
411570;201303;4527;13864;3905;12877;1429;5116;1092;3811;2521;8927
411573;201303;939;3044;901;2983;242;866;472;1588;714;2454
411575;201303;1283;4361;1172;4085;343;1275;459;1612;802;2887
411580;201303;3348;10579;2753;9403;745;2903;539;1662;1284;4565
411585;201303;400;1475;327;1252;101;413;34;113;135;526
411590;201303;547;1697;496;1589;147;540;127;380;274;920
411600;201303;312;1010;278;928;77;319;52;163;129;482
411605;201303;2058;6173;1682;5469;495;1770;655;2078;1150;3848
411610;201303;2027;6191;1953;6078;490;1621;1276;3938;1766;5559
411620;201303;2558;8827;2432;8604;852;3260;994;3580;1846;6840
411630;201303;652;1832;416;1446;142;571;76;236;218;807
411640;201303;535;1734;458;1577;148;563;160;516;308;1079
411650;201303;251;848;213;753;80;321;60;196;140;517
411660;201303;669;2125;619;2035;150;498;274;931;424;1429
411670;201303;1552;4802;1436;4600;533;1902;466;1396;999;3298
411680;201303;1591;5133;1435;4888;408;1378;763;2778;1171;4156
411690;201303;3214;10180;2896;9615;1075;3865;933;3125;2008;6990
411695;201303;774;2549;673;2349;146;533;352;1226;498;1759
411700;201303;1710;5301;1368;4657;431;1612;392;1285;823;2897
411705;201303;2112;7608;1879;7177;474;1869;1098;4291;1572;6160
411710;201303;2108;6703;1697;5727;565;2093;324;960;889;3053
411720;201303;790;2485;651;2152;173;641;190;579;363;1220
411721;201303;640;2040;580;1938;148;540;276;915;424;1455
411722;201303;644;2014;548;1834;157;610;195;613;352;1223
411725;201303;1172;3969;931;3431;269;1090;294;1087;563;2177
411727;201303;2268;6782;1968;6214;479;1681;988;3037;1467;4718
411729;201303;470;1418;399;1291;73;258;183;558;256;816
411730;201303;4836;15534;4380;14668;1262;4595;1912;6370;3174;10965
411740;201303;495;1537;424;1383;131;502;163;487;294;989
411745;201303;788;2583;687;2356;206;776;179;568;385;1344
411750;201303;3564;11529;3090;10531;1048;3949;531;1635;1579;5584
411760;201303;7877;25252;7351;24334;3004;10510;2276;7960;5280;18470
411770;201303;3550;13249;3330;12727;1442;5774;794;3101;2236;8875
411780;201303;2772;9749;2707;9662;430;1481;1936;7297;2366;8778
411790;201303;2437;7826;2158;7360;778;2955;609;2029;1387;4984
411800;201303;1140;3548;765;2608;158;604;112;287;270;891
411810;201303;1378;4485;1231;4154;344;1347;335;966;679;2313
411820;201303;15325;49644;13102;45670;4715;16831;4386;16312;9101;33143
411830;201303;421;1219;356;1130;111;372;151;498;262;870
411840;201303;7788;24232;6601;21999;2181;8028;2137;6959;4318;14987
411845;201303;452;1526;369;1348;120;478;82;291;202;769
411850;201303;5639;18269;5016;17071;1579;5899;1808;6156;3387;12055
411860;201303;771;2656;696;2473;243;926;181;607;424;1533
411870;201303;864;3303;798;3137;147;624;212;783;359;1407
411880;201303;2345;6939;2010;6394;498;1747;1029;3325;1527;5072
411885;201303;1293;3751;1106;3492;410;1453;323;919;733;2372
411890;201303;1160;3693;913;3150;297;1151;220;662;517;1813
411900;201303;796;2726;688;2475;257;991;180;634;437;1625
411910;201303;1100;3970;1019;3764;321;1294;378;1332;699;2626
411915;201303;9757;30221;7467;25339;2220;8451;1931;5996;4151;14447
411920;201303;950;3509;881;3327;318;1286;213;801;531;2087
411925;201303;550;1696;463;1543;139;477;204;699;343;1176
411930;201303;5764;20098;5172;18830;1526;5851;2315;8669;3841;14520
411940;201303;3339;11755;3104;11255;1080;4158;996;3595;2076;7753
411950;201303;10816;36122;9797;34508;3533;13332;4235;14835;7768;28167
411960;201303;5394;17169;5109;16651;1546;5610;2381;7522;3927;13132
411965;201303;367;1328;331;1244;101;410;94;357;195;767
411970;201303;714;2199;586;1983;180;632;212;717;392;1349
411980;201303;1962;5584;1427;4774;203;753;866;2901;1069;3654
411990;201303;25683;92886;23033;87221;9298;37353;6202;24099;15500;61452
411995;201303;2797;9183;2608;8828;1106;3952;780;2695;1886;6647
412000;201303;1887;5712;1576;5131;373;1384;617;1770;990;3154
412010;201303;692;2412;629;2272;231;894;209;738;440;1632
412015;201303;537;1848;500;1771;103;400;286;1005;389;1405
412020;201303;385;1210;314;1066;120;444;131;423;251;867
412030;201303;406;1353;331;1215;78;356;116;386;194;742
412033;201303;640;2085;521;1807;149;571;86;272;235;843
412035;201303;843;2639;756;2473;206;769;317;974;523;1743
412040;201303;669;2286;624;2174;263;964;183;637;446;1601
412050;201303;1531;4782;1260;4201;355;1318;285;909;640;2227
412060;201303;7289;26717;6816;25575;2220;8787;2971;11321;5191;20108
412065;201303;870;2831;808;2714;306;1164;233;732;539;1896
412070;201303;1015;3010;916;2798;215;718;366;1099;581;1817
412080;201303;1746;5735;1401;5021;457;1810;165;540;622;2350
412085;201303;170;535;141;486;47;193;38;110;85;303
412090;201303;4632;16061;4502;15835;1063;3967;2900;10397;3963;14364
412100;201303;2127;6974;1900;6568;653;2394;672;2313;1325;4707
412110;201303;735;2467;692;2387;281;1013;263;880;544;1893
412120;201303;2273;7986;2135;7660;537;2110;1109;3856;1646;5966
412125;201303;928;2972;838;2828;270;969;331;1155;601;2124
412130;201303;755;2210;562;1852;140;521;168;550;308;1071
412135;201303;532;1599;412;1343;89;325;193;581;282;906
412140;201303;1703;5389;1466;4932;477;1710;421;1429;898;3139
412150;201303;2601;8242;2354;7743;422;1575;1363;4321;1785;5896
412160;201303;991;3284;884;3077;264;1014;397;1372;661;2386
412170;201303;3869;13911;3535;13260;1501;5913;1144;4266;2645;10179
412175;201303;1409;5171;1344;5039;409;1676;563;2136;972;3812
412180;201303;1603;5336;1282;4745;559;2233;302;1089;861;3322
412190;201303;2738;8736;2383;8167;955;3424;746;2722;1701;6146
412200;201303;2065;7375;1632;6116;403;1619;515;1891;918;3510
412210;201303;622;1913;462;1551;145;552;97;300;242;852
412215;201303;2937;10267;2712;9830;591;2207;1633;6109;2224;8316
412217;201303;1073;3427;1038;3361;251;909;597;1846;848;2755
412220;201303;6397;21458;6153;20996;2386;8548;2729;9410;5115;17958
412230;201303;2697;9753;2472;9254;901;3641;715;2623;1616;6264
412240;201303;6995;21160;4625;15717;1170;4392;654;2022;1824;6414
412250;201303;1991;6472;1839;6164;654;2374;593;1944;1247;4318
412260;201303;1150;3607;825;2880;208;822;228;701;436;1523
412265;201303;1068;3551;1011;3454;308;1241;466;1512;774;2753
412270;201303;691;2393;559;2045;140;595;92;305;232;900
412280;201303;817;2685;752;2578;120;445;452;1557;572;2002
412290;201303;1151;3358;998;3082;241;857;424;1250;665;2107
412300;201303;1501;4632;1265;4155;380;1465;408;1241;788;2706
412310;201303;1167;3403;1038;3243;225;587;676;2365;901;2952
412320;201303;815;2262;606;1921;156;569;274;862;430;1431
412330;201303;1918;5476;1503;4777;406;1385;673;2135;1079;3520
412340;201303;802;2674;636;2266;158;633;116;388;274;1021
412350;201303;2290;7685;1968;6943;672;2541;353;1146;1025;3687
412360;201303;301;1023;285;987;80;307;69;217;149;524
412370;201303;1070;3443;861;3028;319;1178;249;872;568;2050
412380;201303;1863;5874;1713;5607;367;1244;896;3099;1263;4343
412382;201303;656;1918;542;1699;161;579;172;487;333;1066
412385;201303;2313;7789;2231;7633;527;1744;1239;4596;1766;6340
412390;201303;2307;7207;2145;6936;827;2894;788;2536;1615;5430
412395;201303;929;2682;764;2421;106;333;513;1670;619;2003
412400;201303;1178;3701;1071;3517;338;1203;457;1523;795;2726
412402;201303;1818;5913;1621;5526;530;1937;431;1409;961;3346
412405;201303;3459;10802;2614;9007;777;3063;227;683;1004;3746
412410;201303;5901;20050;5474;19208;2553;9708;1081;3752;3634;13460
412420;201303;501;1560;432;1463;143;544;137;419;280;963
412430;201303;425;1332;373;1234;142;516;146;447;288;963
412440;201303;3829;11949;3447;11289;661;2373;1601;5487;2262;7860
412450;201303;514;1692;460;1552;131;489;147;441;278;930
412460;201303;950;2706;657;2161;154;599;186;586;340;1185
412470;201303;1872;6659;1785;6470;532;2055;867;3148;1399;5203
412480;201303;1230;3741;959;3185;262;977;257;747;519;1724
412490;201303;1233;3774;1120;3523;339;1118;328;1038;667;2156
412500;201303;1844;5760;1600;5293;551;1976;456;1427;1007;3403
412510;201303;2998;10304;2758;9689;968;3666;758;2694;1726;6360
412520;201303;1715;5047;1375;4510;377;1303;628;2095;1005;3398
412530;201303;730;2213;637;2038;230;801;171;524;401;1325
412535;201303;522;1556;485;1494;175;575;216;631;391;1206
412540;201303;1155;3596;1001;3281;228;871;398;1275;626;2146
412545;201303;841;2535;742;2333;150;531;275;785;425;1316
412550;201303;21233;67236;16019;55726;5097;19283;3369;10965;8466;30248
412555;201303;291;951;226;782;66;245;42;126;108;371
412560;201303;4198;14990;3778;14036;1284;5117;875;3059;2159;8176
412570;201303;3796;12251;3171;10883;1147;4239;718;2514;1865;6753
412575;201303;953;3156;830;2855;217;841;284;909;501;1750
412580;201303;1385;3962;1066;3424;295;1027;349;1071;644;2098
412590;201303;423;1379;368;1280;165;610;78;268;243;878
412600;201303;1387;4592;1241;4302;448;1699;384;1301;832;3000
412610;201303;698;2352;591;2096;214;834;146;455;360;1289
412620;201303;1291;4392;1186;4189;482;1802;356;1275;838;3077
412625;201303;13103;38196;11253;34767;4390;14620;2612;8065;7002;22685
412627;201303;871;2823;680;2422;246;936;151;531;397;1467
412630;201303;3281;10951;2975;10265;911;3405;906;3043;1817;6448
412635;201303;466;1486;393;1330;120;417;76;239;196;656
412640;201303;885;2824;719;2468;225;883;208;672;433;1555
412650;201303;2209;6386;1818;5700;507;1718;748;2198;1255;3916
412660;201303;2891;9022;2447;8103;672;2529;665;2094;1337;4623
412665;201303;660;1833;434;1471;145;540;145;472;290;1012
412667;201303;1470;4629;1218;4127;359;1401;363;1136;722;2537
412670;201303;621;2029;427;1535;106;439;64;194;170;633
412680;201303;1236;4315;1098;3980;365;1402;291;965;656;2367
412690;201303;580;1904;466;1638;185;710;64;215;249;925
412700;201303;1702;5945;1546;5657;573;2285;587;2127;1160;4412
412710;201303;8647;27909;7257;25003;2223;8357;1849;6207;4072;14564
412720;201303;1482;4833;1149;4002;306;1155;132;372;438;1527
412730;201303;2683;8339;1949;6792;648;2438;249;800;897;3238
412740;201303;1961;6600;1844;6353;815;3002;231;809;1046;3811
412750;201303;2903;10719;2836;10612;669;2721;1910;7065;2579;9786
412760;201303;1990;7048;1933;6942;726;2839;677;2344;1403;5183
412770;201303;10732;32945;7644;26075;2019;7706;1572;4865;3591;12571
412780;201303;1421;4875;1286;4534;403;1501;407;1370;810;2871
412785;201303;2195;6789;1764;5956;600;2174;743;2479;1343;4653
412788;201303;1194;4197;1152;4131;304;1260;620;2166;924;3426
412790;201303;1054;3456;917;3147;236;912;320;977;556;1889
412795;201303;955;2957;853;2770;310;1092;288;897;598;1989
412796;201303;3075;9873;2929;9622;843;3014;1383;4516;2226;7530
412800;201303;3211;10007;2665;9026;824;3028;819;2676;1643;5704
412810;201303;7749;22853;5748;18735;1889;6749;1442;4372;3331;11121
412820;201303;5096;16883;4155;15012;1391;5501;1059;3862;2450;9363
412830;201303;358;1257;328;1193;104;430;74;240;178;670
412840;201303;2193;6557;1890;5983;634;2257;535;1683;1169;3940
412850;201303;2667;8429;2406;8086;515;1950;1317;4373;1832;6323
412853;201303;1707;5408;1537;5121;405;1606;737;2269;1142;3875
412855;201303;1577;4755;1313;4250;460;1684;397;1177;857;2861
412860;201303;1143;3722;1052;3558;335;1245;441;1417;776;2662
412862;201303;685;2029;603;1869;187;631;199;598;386;1229
412863;201303;1174;4176;1137;4101;167;637;813;2936;980;3573
412865;201303;594;1960;446;1562;94;359;170;592;264;951
412870;201303;953;2913;854;2775;319;1087;348;1181;667;2268
412880;201303;1555;4353;1322;3999;406;1363;412;1206;818;2569
420005;201303;430;1467;365;1300;90;354;158;523;248;877
420010;201303;3031;10024;2651;9347;442;1669;1808;6449;2250;8118
420020;201303;659;2361;506;1921;123;524;94;318;217;842
420030;201303;364;1248;262;1001;81;356;55;194;136;550
420040;201303;935;3019;662;2516;233;969;189;678;422;1647
420050;201303;647;2198;598;2092;198;734;225;767;423;1501
420055;201303;232;831;198;737;54;203;43;142;97;345
420060;201303;357;1305;279;1092;74;312;40;150;114;462
420070;201303;1855;6220;1681;5795;282;1095;802;2888;1084;3983
420075;201303;136;464;106;380;33;129;28;93;61;222
420080;201303;517;1892;480;1798;200;805;90;335;290;1140
420090;201303;641;2397;512;2050;148;612;106;435;254;1047
420100;201303;1431;4897;1345;4779;289;1026;912;3326;1201;4352
420110;201303;415;1467;383;1390;128;458;160;611;288;1069
420120;201303;288;1040;245;944;113;466;33;112;146;578
420125;201303;343;1468;330;1437;139;639;85;349;224;988
420127;201303;481;1600;276;1051;98;395;32;136;130;531
420130;201303;2628;9282;2419;8882;724;3022;1002;3390;1726;6412
420140;201303;6120;18906;4814;16651;1793;6868;1321;4433;3114;11301
420150;201303;639;2043;523;1761;195;723;148;459;343;1182
420160;201303;245;809;168;606;52;228;34;99;86;327
420165;201303;147;538;130;496;46;186;27;108;73;294
420170;201303;182;658;153;601;67;314;19;48;86;362
420180;201303;340;1204;260;972;86;331;64;226;150;557
420190;201303;427;1491;327;1286;145;626;67;266;212;892
420195;201303;1295;3797;1036;3458;294;1103;496;1660;790;2763
420200;201303;2674;8980;1813;7004;672;2881;318;1098;990;3979
420205;201303;995;3456;904;3277;305;1199;389;1421;694;2620
420207;201303;1070;3358;854;2925;289;1112;248;809;537;1921
420208;201303;447;1546;409;1456;177;654;120;438;297;1092
420209;201303;270;964;203;760;46;189;45;165;91;354
420210;201303;1654;5626;1136;4471;337;1508;142;508;479;2016
420213;201303;821;3201;796;3149;191;788;484;1932;675;2720
420215;201303;447;1610;377;1380;112;430;65;217;177;647
420220;201303;407;1644;387;1591;173;759;75;265;248;1024
420230;201303;3869;12757;3307;11785;846;3376;1861;6491;2707;9867
420240;201303;11546;36990;8058;29569;2062;8867;3048;10082;5110;18949
420243;201303;450;1593;419;1512;138;548;139;496;277;1044
420245;201303;854;2890;686;2578;210;909;140;491;350;1400
420250;201303;845;2783;797;2704;305;1113;324;1123;629;2236
420253;201303;608;1677;526;1561;117;363;262;855;379;1218
420257;201303;395;1298;335;1183;98;341;154;552;252;893
420260;201303;1221;4354;1141;4204;364;1433;541;2024;905;3457
420270;201303;329;1219;277;1061;34;140;23;79;57;219
420280;201303;2473;7574;1819;6427;585;2326;550;1720;1135;4046
420285;201303;121;383;61;233;12;56;3;10;15;66
420287;201303;607;1972;546;1856;143;523;232;784;375;1307
420290;201303;4965;15466;3611;12498;990;3812;1267;4157;2257;7969
420300;201303;5297;17532;3803;14256;1218;5179;769;2825;1987;8004
420310;201303;694;2311;666;2258;187;664;355;1191;542;1855
420315;201303;761;2862;687;2697;192;837;317;1239;509;2076
420320;201303;4269;14633;3763;13691;1246;5151;1475;5101;2721;10252
420325;201303;479;1600;461;1551;163;614;141;457;304;1071
420330;201303;1150;4211;1001;3794;381;1555;177;583;558;2138
420340;201303;1395;4495;1227;4139;326;1227;491;1580;817;2807
420350;201303;1493;5084;1385;4888;381;1425;705;2530;1086;3955
420360;201303;3183;10997;2767;10039;1173;4632;525;1808;1698;6440
420370;201303;1768;5104;1621;4924;209;693;1320;3945;1529;4638
420380;201303;5022;17832;4392;16276;1530;6159;1127;4152;2657;10311
420390;201303;1874;5916;1246;4542;465;1835;252;835;717;2670
420395;201303;2145;6875;1754;6016;548;2132;421;1350;969;3482
420400;201303;1391;4383;1118;3855;357;1444;373;1187;730;2631
420410;201303;673;2080;560;1884;137;516;281;929;418;1445
420415;201303;415;1430;393;1380;117;437;169;593;286;1030
420417;201303;764;2598;700;2460;149;528;368;1309;517;1837
420419;201303;372;1304;307;1181;157;621;88;352;245;973
420420;201303;13735;44413;11077;38642;3905;14678;3224;11198;7129;25876
420425;201303;1017;3167;773;2599;130;528;288;897;418;1425
420430;201303;3927;12742;2734;9870;904;3538;714;2538;1618;6076
420435;201303;190;669;145;545;70;289;22;80;92;369
420440;201303;1362;4111;914;3240;317;1214;167;539;484;1753
420445;201303;407;1282;324;1139;96;351;144;515;240;866
420450;201303;1158;3498;702;2564;176;751;141;411;317;1162
420455;201303;2087;6855;1917;6551;627;2406;816;2735;1443;5141
420460;201303;9204;30411;7851;27802;2435;9671;3041;10343;5476;20014
420470;201303;972;2920;775;2599;270;976;230;752;500;1728
420475;201303;144;524;120;448;45;176;32;128;77;304
420480;201303;5558;17345;4817;16252;2091;7761;884;2981;2975;10742
420490;201303;649;2391;574;2190;189;745;142;522;331;1267
420500;201303;2045;6597;1786;6132;535;1946;949;3310;1484;5256
420510;201303;181;799;177;780;79;351;36;151;115;502
420515;201303;154;587;130;520;43;179;21;83;64;262
420517;201303;883;2876;808;2701;124;422;542;1853;666;2275
420519;201303;308;981;271;898;59;197;137;472;196;669
420520;201303;608;2034;552;1921;128;494;250;842;378;1336
420530;201303;1296;4689;1118;4214;413;1701;265;918;678;2619
420535;201303;232;790;221;766;72;278;68;224;140;502
420540;201303;18611;59687;14684;51178;5344;20198;4444;15189;9788;35387
420543;201303;418;1260;327;1109;54;196;223;749;277;945
420545;201303;1258;4258;1098;3913;368;1472;359;1192;727;2664
420550;201303;4264;14932;3843;13954;1358;5472;1191;4296;2549;9768
420555;201303;420;1451;373;1345;155;593;99;360;254;953
420560;201303;552;1681;476;1540;65;232;260;860;325;1092
420570;201303;1699;5881;1419;5189;470;1856;360;1257;830;3113
420580;201303;836;3054;747;2878;255;1093;296;1141;551;2234
420590;201303;2918;9642;2243;8038;584;2303;460;1561;1044;3864
420600;201303;618;2344;583;2258;213;920;207;767;420;1687
420610;201303;542;1866;418;1569;156;639;67;223;223;862
420620;201303;1159;3790;1041;3561;415;1554;241;798;656;2352
420630;201303;925;3165;784;2797;259;1012;220;676;479;1688
420640;201303;488;1790;340;1370;101;429;68;292;169;721
420650;201303;1993;6603;1318;4909;374;1602;279;866;653;2468
420660;201303;623;1976;544;1826;113;417;308;1019;421;1436
420665;201303;675;2124;516;1778;101;391;211;665;312;1056
420670;201303;1548;5279;1257;4576;377;1524;208;704;585;2228
420675;201303;210;693;154;560;33;130;70;236;103;366
420680;201303;454;1347;362;1202;95;350;151;488;246;838
420690;201303;761;2793;610;2374;174;749;192;708;366;1457
420700;201303;6088;19365;5186;17449;1954;7193;1229;3993;3183;11186
420710;201303;681;2584;609;2426;250;1065;145;550;395;1615
420720;201303;1779;5910;1630;5704;484;1766;894;3126;1378;4892
420730;201303;4276;13862;3833;13090;1567;5651;1285;4396;2852;10047
420740;201303;575;2170;567;2154;172;658;320;1245;492;1903
420750;201303;2286;7739;1716;6352;474;2008;532;1746;1006;3754
420757;201303;98;355;87;336;26;110;17;56;43;166
420760;201303;404;1386;334;1194;80;320;117;408;197;728
420765;201303;517;1893;396;1537;127;516;84;312;211;828
420768;201303;1142;4313;1068;4138;347;1375;453;1846;800;3221
420770;201303;793;2685;577;2147;204;817;162;566;366;1383
420775;201303;566;1906;523;1823;123;435;299;1052;422;1487
420780;201303;1585;5123;1204;4168;395;1460;376;1260;771;2720
420785;201303;377;1271;317;1114;82;314;128;442;210;756
420790;201303;1238;4727;1082;4276;312;1309;477;1840;789;3149
420800;201303;784;2395;530;1842;160;603;114;370;274;973
420810;201303;2311;8678;1980;7813;734;3164;542;2075;1276;5239
420820;201303;7281;26440;6361;24726;2357;10175;2324;8908;4681;19083
420830;201303;2457;8652;2177;8105;864;3447;752;2714;1616;6161
420840;201303;915;3256;763;2949;272;1162;231;814;503;1976
420845;201303;971;3550;844;3270;335;1419;143;522;478;1941
420850;201303;1549;5588;1228;4887;476;2047;266;1071;742;3118
420860;201303;615;1941;450;1591;191;736;153;535;344;1271
420870;201303;1268;3927;1060;3643;455;1696;318;1087;773;2783
420880;201303;1408;4886;1207;4368;368;1387;273;982;641;2369
420890;201303;11591;28164;5617;18102;1206;4653;2209;6434;3415;11087
420895;201303;163;460;97;315;27;93;39;120;66;213
420900;201303;2057;6270;1476;5136;491;1877;362;1188;853;3065
420910;201303;20281;65751;14285;52615;4219;17595;3484;12271;7703;29866
420915;201303;640;2591;605;2480;163;668;293;1268;456;1936
420917;201303;249;821;222;752;62;240;83;232;145;472
420920;201303;157;487;112;401;46;172;19;71;65;243
420930;201303;18809;60406;16645;56343;5948;21911;5707;19337;11655;41248
420940;201303;4406;14176;3912;13063;1230;4554;1331;4167;2561;8721
420945;201303;166;578;146;524;49;194;38;126;87;320
420950;201303;461;1541;284;1110;86;382;45;161;131;543
420960;201303;1311;4359;1140;4019;444;1700;307;987;751;2687
420970;201303;2511;8369;2257;7974;696;2560;1161;4235;1857;6795
420980;201303;347;1311;325;1251;100;382;180;720;280;1102
420985;201303;428;1447;332;1226;109;423;80;278;189;701
420990;201303;801;2522;570;2105;151;627;175;572;326;1199
421000;201303;635;2332;468;1880;157;685;57;185;214;870
421003;201303;517;1612;261;967;70;280;37;128;107;408
421005;201303;222;786;212;768;67;265;103;365;170;630
421010;201303;6010;20216;5170;18398;1898;7224;1622;5596;3520;12820
421020;201303;494;1763;443;1647;103;390;226;901;329;1291
421030;201303;1048;3892;958;3651;349;1391;299;1172;648;2563
421040;201303;777;2612;732;2528;223;835;321;1071;544;1906
421050;201303;1770;5090;1179;4138;324;1300;474;1584;798;2884
421055;201303;231;861;195;751;57;244;56;190;113;434
421060;201303;508;1977;424;1728;135;595;88;334;223;929
421070;201303;730;2456;547;2007;123;510;240;918;363;1428
421080;201303;588;2032;561;1963;199;727;222;771;421;1498
421085;201303;478;1405;289;1059;74;280;66;274;140;554
421090;201303;397;1219;315;1032;89;309;139;456;228;765
421100;201303;881;2953;729;2598;229;842;182;592;411;1434
421105;201303;1236;4299;1143;4129;338;1297;532;2017;870;3314
421110;201303;1597;5426;1390;5086;535;2146;462;1630;997;3776
421120;201303;1426;4949;1213;4451;334;1420;392;1333;726;2753
421125;201303;320;1143;303;1090;112;427;103;347;215;774
421130;201303;4598;15870;4057;14906;1751;6843;1175;4485;2926;11328
421140;201303;376;1273;325;1150;108;419;113;383;221;802
421145;201303;446;1600;411;1497;79;328;206;723;285;1051
421150;201303;371;1443;332;1347;99;418;152;618;251;1036
421160;201303;681;2254;500;1881;143;596;134;480;277;1076
421165;201303;304;1128;250;942;63;248;103;396;166;644
421170;201303;1766;5955;1514;5262;499;1819;686;2346;1185;4165
421175;201303;1158;3774;988;3500;382;1500;322;1070;704;2570
421180;201303;429;1370;304;1107;106;444;111;355;217;799
421185;201303;377;1207;328;1109;69;227;162;570;231;797
421187;201303;296;977;257;899;71;257;103;350;174;607
421189;201303;525;1651;474;1543;134;474;189;608;323;1082
421190;201303;8321;28839;7138;26293;2532;9895;2380;8761;4912;18656
421200;201303;985;3482;895;3281;282;1153;409;1462;691;2615
421205;201303;193;661;149;557;34;149;35;111;69;260
421210;201303;1884;6176;1771;5881;609;2143;630;2094;1239;4237
421220;201303;2285;8289;2076;7875;714;2872;742;2875;1456;5747
421223;201303;772;2347;537;1944;175;663;273;980;448;1643
421225;201303;1049;3404;942;3192;276;986;373;1245;649;2231
421227;201303;896;3229;848;3150;251;924;481;1877;732;2801
421230;201303;742;2600;683;2446;198;756;259;904;457;1660
421240;201303;514;1806;410;1506;142;565;63;211;205;776
421250;201303;1765;5717;1294;4859;482;1964;388;1423;870;3387
421260;201303;228;765;161;629;38;154;37;138;75;292
421270;201303;582;1810;401;1484;159;604;101;397;260;1001
421280;201303;1423;4809;1209;4463;473;1996;276;1033;749;3029
421290;201303;1864;5571;1323;4504;466;1693;306;958;772;2651
421300;201303;240;865;226;835;129;523;48;151;177;674
421310;201303;501;1780;435;1591;159;586;101;365;260;951
421315;201303;334;1057;224;797;54;202;92;324;146;526
421320;201303;484;1707;332;1267;73;326;63;175;136;501
421330;201303;594;2167;530;2034;240;1036;63;232;303;1268
421335;201303;537;1871;444;1682;148;613;100;378;248;991
421340;201303;1510;5348;1454;5247;546;2118;569;2039;1115;4157
421350;201303;907;3247;779;2970;305;1297;217;790;522;2087
421360;201303;2906;9638;2223;8167;609;2531;785;2780;1394;5311
421370;201303;1046;3878;916;3577;348;1492;241;925;589;2417
421380;201303;939;2875;804;2620;182;634;389;1264;571;1898
421390;201303;183;616;149;531;24;93;44;161;68;254
421400;201303;357;1467;302;1320;140;626;67;286;207;912
421410;201303;291;1044;261;980;63;234;133;521;196;755
421415;201303;304;1019;201;802;73;303;57;221;130;524
421420;201303;1357;4429;1094;3763;276;1017;253;834;529;1851
421430;201303;251;878;194;751;74;321;35;137;109;458
421440;201303;707;2289;542;1981;194;751;202;744;396;1495
421450;201303;585;2167;524;2006;234;954;146;553;380;1507
421460;201303;545;1965;452;1754;140;593;97;345;237;938
421470;201303;461;1846;432;1761;142;619;174;674;316;1293
421480;201303;2117;7458;1732;6596;603;2542;541;1917;1144;4459
421490;201303;217;847;196;795;95;401;39;156;134;557
421500;201303;2517;9432;2290;8958;1029;4339;567;2213;1596;6552
421505;201303;379;1358;352;1285;136;496;124;463;260;959
421507;201303;547;2011;512;1911;132;506;202;750;334;1256
421510;201303;251;1001;234;959;81;365;84;310;165;675
421520;201303;662;2028;539;1790;82;310;336;1093;418;1403
421530;201303;395;1441;303;1233;98;447;112;436;210;883
421535;201303;537;1876;440;1697;104;439;212;816;316;1255
421540;201303;359;1151;315;1062;75;285;115;366;190;651
421545;201303;1129;4125;987;3825;347;1488;196;715;543;2203
421550;201303;1833;6715;1729;6513;719;2896;579;2185;1298;5081
421555;201303;214;739;133;494;34;140;32;112;66;252
421560;201303;198;727;138;554;51;206;20;81;71;287
421565;201303;1011;3380;941;3253;453;1650;292;1003;745;2653
421567;201303;931;3644;822;3336;416;1713;155;648;571;2361
421568;201303;382;1462;364;1416;128;524;122;469;250;993
421569;201303;145;536;128;484;32;137;40;132;72;269
421570;201303;859;3094;728;2788;287;1214;191;670;478;1884
421575;201303;609;2119;546;1985;117;443;284;1055;401;1498
421580;201303;3883;13627;3263;12241;1339;5544;750;2638;2089;8182
421590;201303;252;858;221;775;58;221;98;328;156;549
421600;201303;713;2357;607;2141;209;781;172;596;381;1377
421605;201303;597;1936;434;1608;151;631;99;365;250;996
421610;201303;1772;4770;1396;4219;223;748;862;2612;1085;3360
421620;201303;4407;14092;3370;11980;1237;4726;1113;4007;2350;8733
421625;201303;313;1173;263;1017;93;385;90;321;183;706
421630;201303;2204;7201;1591;5709;467;1830;413;1459;880;3289
421635;201303;264;987;232;931;64;274;96;366;160;640
421640;201303;1024;3499;926;3329;217;793;544;2004;761;2797
421650;201303;2238;7947;2062;7552;903;3604;350;1244;1253;4848
421660;201303;8204;29251;6888;26623;2606;11018;2039;7532;4645;18550
421670;201303;1029;3659;875;3272;263;1072;274;1008;537;2080
421680;201303;1328;4628;1240;4403;549;2102;225;721;774;2823
421690;201303;1924;6665;1569;5778;516;2032;336;1219;852;3251
421700;201303;708;2309;510;1914;187;764;145;495;332;1259
421710;201303;322;1191;277;1070;113;443;68;260;181;703
421715;201303;216;729;181;642;49;183;56;202;105;385
421720;201303;2137;6423;1522;5498;648;2586;451;1551;1099;4137
421725;201303;120;454;115;440;40;159;48;178;88;337
421730;201303;441;1624;321;1243;106;460;79;263;185;723
421740;201303;592;1993;493;1760;156;649;136;407;292;1056
421750;201303;1266;4164;1068;3731;363;1357;328;1066;691;2423
421755;201303;398;1417;338;1235;97;371;93;334;190;705
421760;201303;326;1137;272;1031;101;436;114;398;215;834
421770;201303;3369;10740;2924;9945;1443;5082;716;2573;2159;7655
421775;201303;501;1652;388;1421;95;363;129;474;224;837
421780;201303;1666;6011;1391;5405;601;2494;367;1353;968;3847
421790;201303;813;2615;584;2166;209;882;122;412;331;1294
421795;201303;298;1003;268;916;57;216;78;256;135;472
421800;201303;2120;7523;1801;6845;584;2500;563;1878;1147;4378
421810;201303;686;2430;597;2194;202;794;130;461;332;1255
421820;201303;922;3217;831;3024;208;894;332;1131;540;2025
421825;201303;1132;4105;1092;3989;184;747;652;2354;836;3101
421830;201303;2898;10450;2765;10199;656;2434;1633;6389;2289;8823
421835;201303;156;547;134;505;55;232;45;151;100;383
421840;201303;496;1829;450;1700;182;761;160;568;342;1329
421850;201303;514;1581;422;1443;156;549;156;579;312;1128
421860;201303;406;1421;319;1214;85;369;91;330;176;699
421870;201303;4861;14967;3619;12387;1202;4416;671;2228;1873;6644
421875;201303;234;832;171;656;47;207;40;127;87;334
421880;201303;842;3062;748;2837;293;1249;143;478;436;1727
421885;201303;348;1271;324;1203;96;371;155;578;251;949
421890;201303;1030;3669;897;3377;332;1343;277;1010;609;2353
421895;201303;396;1431;391;1423;117;424;207;781;324;1205
421900;201303;815;2775;684;2439;186;708;253;839;439;1547
421910;201303;439;1565;362;1369;111;487;90;287;201;774
421915;201303;583;1898;518;1772;83;321;338;1152;421;1473
421917;201303;469;1631;408;1512;148;622;110;366;258;988
421920;201303;670;2247;599;2148;289;1106;188;612;477;1718
421930;201303;3290;10610;2663;9211;878;3379;435;1477;1313;4856
421935;201303;772;2966;687;2757;210;898;250;1012;460;1910
421940;201303;284;1141;257;1060;91;408;84;325;175;733
421950;201303;3780;11260;2498;8820;860;3206;536;1951;1396;5157
421960;201303;232;800;199;717;64;246;63;215;127;461
421970;201303;1813;5980;1525;5303;564;2135;341;1067;905;3202
421985;201303;377;1142;266;909;49;203;96;333;145;536
430003;201303;890;2647;726;2376;224;816;280;928;504;1744
430005;201303;264;954;247;915;60;252;131;447;191;699
430010;201303;1853;5884;1521;5143;514;1804;554;1910;1068;3714
430020;201303;1046;2992;936;2826;253;844;489;1418;742;2262
430030;201303;1425;4248;1309;4002;416;1315;537;1624;953;2939
430040;201303;12340;32773;11150;31253;3478;9779;5841;17208;9319;26987
430045;201303;629;1901;566;1777;81;300;397;1206;478;1506
430047;201303;184;547;165;508;40;131;88;276;128;407
430050;201303;810;2480;591;2039;98;402;313;1042;411;1444
430055;201303;235;743;201;654;46;166;113;358;159;524
430057;201303;69;188;30;103;7;30;13;33;20;63
430060;201303;12880;44683;11959;43108;4340;16132;5316;19704;9656;35836
430063;201303;905;2921;825;2709;280;924;355;1228;635;2152
430064;201303;1580;4954;1383;4601;333;1118;819;2821;1152;3939
430066;201303;128;370;108;336;37;117;48;152;85;269
430070;201303;472;1659;416;1530;110;430;148;522;258;952
430080;201303;530;1855;448;1651;123;507;103;351;226;858
430085;201303;446;1547;407;1481;147;584;190;670;337;1254
430087;201303;920;2838;904;2803;90;300;774;2397;864;2697
430090;201303;635;1762;270;898;36;139;105;333;141;472
430100;201303;877;3063;807;2903;327;1293;211;644;538;1937
430105;201303;606;2129;549;2012;220;855;136;478;356;1333
430107;201303;252;852;210;732;46;177;112;374;158;551
430110;201303;2092;6414;1969;6221;652;2228;965;3039;1617;5267
430120;201303;1457;4785;1367;4612;192;668;1050;3544;1242;4212
430130;201303;4373;11424;4087;11064;690;1974;2801;7758;3491;9732
430140;201303;1047;3570;898;3199;311;1104;346;1269;657;2373
430150;201303;807;2347;624;1996;152;519;230;733;382;1252
430155;201303;481;1571;373;1326;96;329;156;565;252;894
430160;201303;17190;52719;16189;51102;3992;13734;8725;28313;12717;42047
430163;201303;1710;5399;1493;4983;372;1404;675;2254;1047;3658
430165;201303;252;951;230;904;109;431;44;169;153;600
430170;201303;671;2073;406;1460;118;483;126;409;244;892
430175;201303;870;3108;796;2934;216;769;442;1719;658;2488
430180;201303;1113;3194;1002;3034;198;634;596;1859;794;2493
430185;201303;691;1803;399;1226;55;212;151;404;206;616
430187;201303;717;2347;672;2285;180;709;343;1145;523;1854
430190;201303;2165;6660;1925;6231;519;1920;915;2988;1434;4908
430192;201303;196;636;158;527;38;142;71;220;109;362
430195;201303;181;595;83;323;15;63;10;29;25;92
430200;201303;1711;5871;1538;5561;673;2529;339;1296;1012;3825
430205;201303;423;1359;364;1251;44;193;247;831;291;1024
430210;201303;5544;16877;3556;12419;1057;3945;712;2308;1769;6253
430215;201303;288;925;243;835;65;250;120;397;185;647
430220;201303;567;1538;313;1070;74;288;57;182;131;470
430222;201303;292;924;231;794;77;295;92;294;169;589
430223;201303;253;872;248;859;74;262;137;477;211;739
430225;201303;39;134;35;118;4;9;7;20;11;29
430230;201303;2101;6804;1981;6670;404;1276;1434;5022;1838;6298
430235;201303;214;749;178;663;70;289;38;117;108;406
430237;201303;350;1053;315;986;39;166;223;654;262;820
430240;201303;954;3054;796;2730;307;1176;211;637;518;1813
430245;201303;753;2759;673;2553;186;715;294;1157;480;1872
430250;201303;1586;4551;1462;4323;496;1544;616;1888;1112;3432
430258;201303;172;534;137;452;27;90;69;225;96;315
430260;201303;765;2269;540;1793;76;302;303;997;379;1299
430265;201303;318;1055;277;959;141;515;42;107;183;622
430270;201303;3255;9688;3031;9338;865;3017;1529;4648;2394;7665
430280;201303;4868;14868;4462;14086;1504;5128;1923;5964;3427;11092
430290;201303;2322;6810;2207;6685;340;1045;1751;5407;2091;6452
430300;201303;9199;29673;8179;27758;3475;12283;3001;10586;6476;22869
430310;201303;7828;25752;7253;24671;2567;9343;3032;10177;5599;19520
430320;201303;747;2402;590;2086;94;323;307;1131;401;1454
430330;201303;913;2622;832;2477;217;714;392;1092;609;1806
430340;201303;615;1765;449;1524;126;477;212;710;338;1187
430350;201303;5872;19741;5244;18319;1877;7001;2069;7156;3946;14157
430355;201303;147;488;118;418;28;124;27;84;55;208
430360;201303;962;2696;891;2587;139;457;574;1658;713;2115
430367;201303;326;948;233;771;33;128;92;288;125;416
430370;201303;540;1685;488;1570;179;619;131;388;310;1007
430380;201303;842;2229;469;1546;145;479;156;551;301;1030
430390;201303;3656;11825;3168;10735;903;3360;1072;3457;1975;6817
430400;201303;1192;3008;883;2568;200;705;487;1318;687;2023
430410;201303;655;1861;530;1656;110;386;290;909;400;1295
430420;201303;4124;12704;3587;11468;1165;3822;1494;4816;2659;8638
430430;201303;624;1887;483;1613;165;600;121;365;286;965
430435;201303;1662;4864;1591;4755;310;937;1082;3290;1392;4227
430440;201303;3987;13010;3504;12227;888;3479;1429;5053;2317;8532
430450;201303;8741;26593;7539;23989;2575;8513;2960;9476;5535;17989
430460;201303;22104;70494;18936;64887;7064;25786;6815;23719;13879;49505
430461;201303;454;1300;148;496;35;120;32;110;67;230
430462;201303;306;977;269;914;106;366;87;304;193;670
430463;201303;3513;12066;3173;11354;887;3475;1516;5417;2403;8892
430465;201303;560;1647;478;1496;130;444;267;833;397;1277
430466;201303;3984;12284;3800;11952;1311;4437;1695;5348;3006;9785
430467;201303;524;1690;466;1588;139;513;211;717;350;1230
430468;201303;1322;4084;1208;3903;518;1816;262;834;780;2650
430469;201303;116;335;42;173;15;64;7;30;22;94
430470;201303;6002;17364;5086;15870;1804;6124;2035;6317;3839;12441
430471;201303;902;3157;828;2989;320;1217;195;715;515;1932
430480;201303;766;2271;509;1708;112;426;126;372;238;798
430485;201303;207;674;130;486;24;85;51;210;75;295
430490;201303;464;1430;343;1196;121;449;104;366;225;815
430495;201303;388;1225;288;1005;84;321;77;267;161;588
430500;201303;1565;4564;1404;4281;390;1329;721;2157;1111;3486
430510;201303;25020;81027;19691;67455;6910;25741;5576;18405;12486;44146
430511;201303;453;1438;300;1049;89;305;63;218;152;523
430512;201303;1241;3423;1118;3217;329;970;499;1517;828;2487
430513;201303;581;1784;449;1489;99;349;194;634;293;983
430515;201303;558;1777;498;1628;107;370;219;745;326;1115
430517;201303;1249;4443;1195;4317;244;934;742;2659;986;3593
430520;201303;1627;5056;1439;4671;507;1759;622;1994;1129;3753
430530;201303;861;2594;619;2070;166;624;192;587;358;1211
430535;201303;2142;7340;1910;6769;568;2206;657;2317;1225;4523
430537;201303;551;1641;401;1401;60;204;308;1109;368;1313
430540;201303;680;1812;558;1642;134;443;316;887;450;1330
430543;201303;570;1579;522;1530;132;415;318;950;450;1365
430544;201303;648;2272;577;2068;140;534;299;1034;439;1568
430545;201303;1191;4135;1092;4012;352;1143;635;2620;987;3763
430550;201303;551;1857;466;1645;141;546;168;587;309;1133
430558;201303;113;338;86;285;35;129;14;35;49;164
430560;201303;316;899;256;788;57;221;112;326;169;547
430570;201303;1057;2961;842;2589;197;672;463;1371;660;2043
430580;201303;896;2794;668;2307;244;872;180;653;424;1525
430583;201303;115;327;55;182;8;35;12;36;20;71
430585;201303;297;890;245;767;84;301;112;323;196;624
430587;201303;298;958;266;893;136;472;77;249;213;721
430590;201303;1560;4491;1485;4370;320;1074;893;2541;1213;3615
430593;201303;36;143;34;136;14;58;10;37;24;95
430595;201303;138;457;95;369;40;158;6;22;46;180
430597;201303;361;1161;313;1051;54;195;148;476;202;671
430600;201303;1756;5317;1406;4527;360;1221;577;1861;937;3082
430605;201303;1187;3978;1043;3655;279;1070;421;1520;700;2590
430607;201303;652;1865;583;1738;111;379;370;1050;481;1429
430610;201303;7611;21831;6381;19868;1447;5056;3344;10361;4791;15417
430613;201303;187;527;142;434;38;129;67;185;105;314
430620;201303;898;2942;774;2654;242;934;306;964;548;1898
430630;201303;413;1332;271;955;89;314;62;204;151;518
430632;201303;691;2012;486;1590;74;289;296;933;370;1222
430635;201303;601;1803;470;1537;85;309;273;890;358;1199
430637;201303;470;1385;443;1339;61;218;325;944;386;1162
430640;201303;1484;4591;1127;3769;299;1088;240;684;539;1772
430642;201303;398;1191;333;1087;67;225;202;673;269;898
430645;201303;161;512;103;369;30;116;21;70;51;186
430650;201303;1798;6495;1624;6026;427;1630;829;3172;1256;4802
430655;201303;293;932;273;880;63;236;106;284;169;520
430660;201303;5408;17306;4595;15718;1677;6199;1725;5864;3402;12063
430670;201303;464;1396;425;1325;45;133;329;1058;374;1191
430673;201303;665;1745;452;1415;140;447;202;643;342;1090
430675;201303;134;432;110;386;22;86;56;199;78;285
430676;201303;4260;13543;4038;13179;1220;4303;2028;6776;3248;11079
430680;201303;1106;3474;909;3040;220;848;364;1130;584;1978
430690;201303;4145;12591;3581;11538;1220;4010;1577;5328;2797;9338
430692;201303;268;967;210;835;43;180;122;494;165;674
430693;201303;1690;4982;1398;4311;333;1124;481;1447;814;2571
430695;201303;490;1470;415;1318;95;339;196;583;291;922
430697;201303;365;1106;317;1033;111;371;135;464;246;835
430700;201303;9500;26754;5839;19317;1383;5120;1038;3301;2421;8421
430705;201303;396;1267;369;1219;98;343;200;676;298;1019
430710;201303;1709;4718;1452;4306;324;1019;839;2618;1163;3637
430720;201303;710;2023;517;1735;150;532;234;800;384;1332
430730;201303;1570;4738;1455;4545;338;1032;898;2935;1236;3967
430740;201303;526;1654;408;1393;147;513;92;320;239;833
430745;201303;489;1476;399;1292;66;231;240;751;306;982
430750;201303;1677;5038;1529;4774;497;1745;749;2194;1246;3939
430755;201303;590;1766;464;1494;133;496;184;524;317;1020
430760;201303;3116;8872;2829;8467;639;1964;1620;5073;2259;7037
430770;201303;6233;19879;5394;18314;1457;5351;2422;8153;3879;13504
430780;201303;1681;5389;1523;5111;552;2019;574;1760;1126;3779
430781;201303;601;1939;482;1694;149;541;212;758;361;1299
430783;201303;520;1456;441;1324;97;322;210;588;307;910
430786;201303;116;421;106;390;43;176;12;40;55;216
430790;201303;2673;7963;2008;6648;484;1865;884;2804;1368;4669
430800;201303;684;2263;639;2168;202;729;240;798;442;1527
430805;201303;391;1251;349;1164;26;107;256;849;282;956
430807;201303;249;825;237;797;53;194;126;416;179;610
430810;201303;468;1472;295;1059;62;262;47;153;109;415
430820;201303;1079;3760;961;3464;329;1283;311;1071;640;2354
430825;201303;441;1298;257;846;51;188;75;225;126;413
430830;201303;2624;8172;2458;7869;446;1443;1534;5258;1980;6701
430840;201303;878;2924;855;2879;226;686;524;1855;750;2541
430843;201303;96;322;75;250;14;43;32;105;46;148
430845;201303;458;1426;401;1318;140;483;87;288;227;771
430850;201303;3168;10101;2909;9622;955;3332;1153;3858;2108;7190
430860;201303;617;2223;557;2072;203;869;120;387;323;1256
430865;201303;707;2049;661;1958;198;609;361;1066;559;1675
430870;201303;417;1390;342;1229;119;445;126;438;245;883
430880;201303;1299;3980;1104;3568;474;1653;270;891;744;2544
430885;201303;158;568;138;525;54;205;32;129;86;334
430890;201303;1785;5058;1594;4757;205;685;1145;3469;1350;4154
430900;201303;3160;8895;3004;8688;588;1756;2037;6054;2625;7810
430905;201303;847;2799;730;2522;266;1001;216;716;482;1717
430910;201303;1644;5545;1485;5280;606;2332;539;1873;1145;4205
430912;201303;550;1655;443;1469;90;356;225;705;315;1061
430915;201303;343;1267;285;1121;89;393;100;373;189;766
430920;201303;15789;52619;15117;51541;5503;19354;8338;28416;13841;47770
430925;201303;88;257;72;227;22;78;35;106;57;184
430930;201303;8343;27559;7475;25863;2256;8268;3380;12006;5636;20274
430940;201303;1015;3292;875;3046;226;899;308;1035;534;1934
430950;201303;1542;4558;1253;3926;403;1333;399;1232;802;2565
430955;201303;90;309;72;261;28;110;15;51;43;161
430957;201303;283;1053;253;974;67;266;119;463;186;729
430960;201303;1591;4868;1373;4474;547;1868;490;1610;1037;3478
430965;201303;1099;3761;962;3451;247;966;509;1771;756;2737
430970;201303;457;1417;346;1160;102;381;101;328;203;709
430975;201303;588;2017;528;1869;103;369;350;1243;453;1612
430980;201303;536;1379;345;1093;103;370;124;344;227;714
430990;201303;597;2039;473;1703;175;641;129;479;304;1120
430995;201303;674;2111;626;2019;210;684;272;912;482;1596
431000;201303;1537;4380;1024;3333;295;1091;164;462;459;1553
431010;201303;2189;7141;1753;6212;567;2190;572;1934;1139;4124
431020;201303;13344;34849;9774;28350;2981;9159;3150;9404;6131;18563
431030;201303;373;1195;257;897;51;191;78;280;129;471
431033;201303;2515;7835;2382;7649;592;1940;1422;4819;2014;6759
431036;201303;117;389;96;338;23;87;28;86;51;173
431040;201303;946;2900;836;2709;260;911;402;1284;662;2195
431041;201303;555;1593;500;1511;180;574;166;525;346;1099
431043;201303;353;1221;289;1069;146;593;84;264;230;857
431046;201303;104;330;84;285;27;96;34;114;61;210
431050;201303;1693;4487;1525;4281;306;841;1026;3013;1332;3854
431053;201303;557;1925;506;1828;176;696;190;658;366;1354
431055;201303;613;1863;595;1834;79;245;452;1425;531;1670
431057;201303;245;777;170;616;46;186;80;275;126;461
431060;201303;5892;17957;5649;17679;1016;2867;4211;13812;5227;16679
431065;201303;431;1384;418;1364;37;113;346;1155;383;1268
431070;201303;732;2203;576;1868;141;459;244;785;385;1244
431075;201303;245;779;171;607;36;144;52;190;88;334
431080;201303;593;1999;499;1795;147;558;90;318;237;876
431085;201303;896;2485;733;2209;144;467;400;1202;544;1669
431087;201303;580;1751;536;1670;32;82;458;1456;490;1538
431090;201303;423;1191;289;942;95;331;84;252;179;583
431100;201303;4538;13127;3947;12115;1118;3650;1849;5802;2967;9452
431110;201303;1440;4179;1271;3836;348;1094;712;2105;1060;3199
431112;201303;714;2335;687;2288;229;786;343;1171;572;1957
431113;201303;612;1916;485;1619;164;539;136;478;300;1017
431115;201303;1399;4407;1317;4257;334;1130;757;2438;1091;3568
431120;201303;2514;8471;2324;8112;764;2951;1008;3391;1772;6342
431123;201303;494;1659;435;1540;103;369;230;848;333;1217
431125;201303;1210;4081;1086;3829;340;1223;528;1941;868;3164
431127;201303;105;311;75;243;14;48;22;67;36;115
431130;201303;3609;10912;3166;10185;977;3421;1457;4746;2434;8167
431140;201303;3056;9131;2181;7462;517;2067;749;2338;1266;4405
431142;201303;526;1623;490;1567;72;246;336;1101;408;1347
431150;201303;1285;4048;1074;3649;320;1115;388;1360;708;2475
431160;201303;828;2629;715;2370;158;521;392;1328;550;1849
431162;201303;468;1396;330;1113;64;250;97;302;161;552
431164;201303;70;211;33;126;11;41;1;4;12;45
431170;201303;871;2713;743;2453;242;859;238;769;480;1628
431171;201303;831;2618;764;2489;277;979;212;645;489;1624
431173;201303;457;1448;436;1407;96;329;278;890;374;1219
431175;201303;1291;3733;1150;3514;390;1259;503;1534;893;2793
431177;201303;964;3289;885;3126;300;1117;396;1431;696;2548
431179;201303;111;322;90;283;18;72;43;116;61;188
431180;201303;2937;9395;2559;8452;766;2800;824;2554;1590;5354
431190;201303;730;2099;492;1642;148;541;180;593;328;1134
431198;201303;315;1076;293;1032;137;549;61;193;198;742
431200;201303;216;675;118;414;26;104;24;81;50;185
431205;201303;284;954;233;809;63;219;82;281;145;500
431210;201303;743;2220;656;2032;161;528;356;1084;517;1612
431213;201303;300;996;273;952;88;339;111;370;199;709
431215;201303;303;931;182;639;54;215;32;97;86;312
431217;201303;214;707;195;665;72;270;49;168;121;438
431220;201303;1195;3153;1002;2835;156;497;592;1656;748;2153
431225;201303;1284;4046;1181;3877;309;1073;689;2315;998;3388
431230;201303;894;2818;747;2515;144;538;410;1387;554;1925
431235;201303;38;111;34;101;14;44;13;38;27;82
431237;201303;392;1368;352;1303;157;660;126;433;283;1093
431238;201303;49;167;43;155;11;46;15;50;26;96
431240;201303;2698;9008;2382;8412;885;3330;811;2828;1696;6158
431242;201303;419;1401;401;1369;197;728;33;119;230;847
431244;201303;416;1072;334;944;63;220;171;451;234;671
431245;201303;729;2299;694;2233;169;585;423;1358;592;1943
431247;201303;187;607;166;569;61;220;65;216;126;436
431250;201303;1852;6060;1671;5786;588;2177;684;2462;1272;4639
431260;201303;300;971;265;903;73;279;51;160;124;439
431261;201303;215;817;201;789;61;261;75;282;136;543
431262;201303;269;844;162;598;29;132;70;257;99;389
431265;201303;1115;3219;819;2555;219;783;298;788;517;1571
431267;201303;172;564;155;532;45;163;63;204;108;367
431270;201303;2204;6604;2027;6330;706;2340;967;3051;1673;5391
431275;201303;211;712;156;560;55;198;34;109;89;307
431280;201303;126;430;95;355;33;144;18;54;51;198
431290;201303;282;947;229;800;61;239;62;212;123;451
431295;201303;201;670;123;426;26;103;24;67;50;170
431300;201303;121;448;93;360;33;133;9;37;42;170
431301;201303;224;802;180;667;65;234;29;102;94;336
431303;201303;572;1686;509;1587;145;499;232;711;377;1210
431306;201303;1895;5526;1500;4798;340;1295;557;1592;897;2887
431308;201303;51;184;49;179;38;142;8;26;46;168
431310;201303;725;2437;567;2056;108;436;241;882;349;1318
431320;201303;752;2311;497;1786;162;636;101;346;263;982
431330;201303;1493;4151;904;3053;270;1005;208;684;478;1689
431333;201303;288;849;227;725;62;207;86;260;148;467
431335;201303;100;320;87;294;21;70;29;94;50;164
431337;201303;2260;7482;2072;7098;708;2548;782;2723;1490;5271
431339;201303;652;1975;534;1694;118;388;287;927;405;1315
431340;201303;25308;71271;19795;61931;5141;18050;8899;27212;14040;45262
431342;201303;569;1609;537;1550;120;360;341;971;461;1331
431344;201303;352;1040;286;925;29;108;182;596;211;704
431346;201303;234;692;183;564;58;193;58;170;116;363
431349;201303;487;1509;425;1352;82;265;216;693;298;958
431350;201303;3467;10943;3248;10595;533;1996;2200;6996;2733;8992
431360;201303;705;2050;583;1841;197;662;210;656;407;1318
431365;201303;1237;4012;1098;3774;458;1708;388;1307;846;3015
431370;201303;5234;16028;4671;15156;1146;3951;2617;8741;3763;12692
431380;201303;1121;3433;1069;3309;172;598;772;2343;944;2941
431390;201303;3473;10793;2844;9516;1057;3818;812;2589;1869;6407
431395;201303;1545;4841;1408;4624;367;1306;624;2095;991;3401
431400;201303;130;485;105;424;37;168;13;39;50;207
431402;201303;1076;2891;756;2327;159;537;353;1065;512;1602
431403;201303;307;915;232;777;78;291;51;162;129;453
431405;201303;3910;11750;3252;10771;748;3021;1641;5116;2389;8137
431406;201303;692;2355;569;2028;204;749;203;718;407;1467
431407;201303;610;1973;491;1666;162;557;159;532;321;1089
431410;201303;15572;50613;13384;46343;5735;20963;3414;12514;9149;33477
431413;201303;159;444;107;336;13;47;56;171;69;218
431415;201303;837;2524;760;2383;197;684;423;1302;620;1986
431417;201303;660;1763;535;1562;102;321;291;880;393;1201
431420;201303;1568;4488;1423;4262;359;1159;786;2378;1145;3537
431430;201303;494;1497;417;1375;139;507;165;517;304;1024
431440;201303;31295;95232;29019;91342;9884;32485;13324;43472;23208;75957
431442;201303;198;657;154;540;49;194;18;47;67;241
431445;201303;427;1261;349;1082;65;215;155;479;220;694
431446;201303;468;1410;371;1227;73;246;224;747;297;993
431447;201303;789;2378;601;1937;106;348;287;971;393;1319
431449;201303;816;2494;718;2323;128;452;397;1297;525;1749
431450;201303;2124;5840;1995;5653;548;1565;1167;3331;1715;4896
431455;201303;576;1539;443;1289;73;260;263;734;336;994
431460;201303;3611;10565;3230;9837;904;2926;1469;4533;2373;7459
431470;201303;2056;6381;1916;6052;575;1820;901;2987;1476;4807
431475;201303;92;314;61;243;20;80;3;10;23;90
431477;201303;558;1712;479;1558;137;444;234;772;371;1216
431478;201303;167;450;92;284;24;78;36;109;60;187
431480;201303;2252;7123;1874;6398;643;2351;478;1660;1121;4011
431490;201303;96757;290355;87394;276593;17865;63825;55843;174095;73708;237920
431500;201303;1173;3142;944;2715;294;869;317;907;611;1776
431505;201303;339;1025;328;1010;39;115;260;809;299;924
431507;201303;426;1121;395;1069;118;329;221;608;339;937
431510;201303;2155;6144;1892;5735;309;998;1242;3747;1551;4745
431513;201303;203;654;185;605;47;165;81;269;128;434
431514;201303;107;270;65;203;12;41;38;124;50;165
431515;201303;742;2326;596;1975;141;515;301;934;442;1449
431517;201303;83;301;80;292;40;144;17;60;57;204
431520;201303;390;1300;328;1144;112;405;88;305;200;710
431530;201303;4327;11190;3605;10413;824;2308;2300;7183;3124;9491
431531;201303;266;781;199;653;56;207;82;284;138;491
431532;201303;515;1544;489;1489;101;335;286;860;387;1195
431535;201303;360;1083;261;823;61;220;63;176;124;396
431540;201303;2022;6924;1885;6741;180;506;1497;5726;1677;6232
431545;201303;130;404;67;246;7;30;11;40;18;70
431550;201303;2379;7464;2238;7188;574;2092;1058;3356;1632;5448
431555;201303;731;2032;674;1944;146;432;366;1048;512;1480
431560;201303;22218;72463;20569;69300;9072;30845;6887;24710;15959;55555
431570;201303;5289;15940;5038;15539;579;1817;3990;12447;4569;14264
431575;201303;390;1189;343;1116;68;242;184;577;252;819
431580;201303;679;2253;593;2055;160;621;222;711;382;1332
431590;201303;845;2646;723;2352;86;312;404;1309;490;1621
431595;201303;585;1747;538;1651;138;450;232;734;370;1184
431600;201303;2047;6537;1720;5823;537;2032;388;1139;925;3171
431610;201303;1532;4532;1203;3961;317;1147;607;1978;924;3125
431620;201303;274;897;228;759;81;288;94;292;175;580
431630;201303;1279;3655;1091;3257;254;784;587;1774;841;2558
431640;201303;5347;17366;5040;16836;1652;5927;2399;7902;4051;13829
431642;201303;469;1483;439;1409;58;225;266;821;324;1046
431643;201303;174;540;164;521;49;169;84;246;133;415
431645;201303;1746;5545;1629;5344;417;1389;940;3187;1357;4576
431647;201303;162;469;137;416;48;152;42;109;90;261
431650;201303;166;568;117;467;30;140;28;100;58;240
431660;201303;1420;4395;1158;3838;397;1386;442;1414;839;2800
431670;201303;1259;3740;1078;3410;341;1208;427;1284;768;2492
431673;201303;148;516;129;468;43;168;34;132;77;300
431675;201303;277;952;225;790;59;213;64;201;123;414
431680;201303;9263;27942;7691;25103;2611;9115;2889;9516;5500;18631
431690;201303;23676;71160;20159;65970;6649;23147;8571;28590;15220;51737
431695;201303;134;491;110;416;26;99;26;76;52;175
431697;201303;455;1357;436;1325;135;437;198;601;333;1038
431700;201303;1615;4729;1441;4391;292;994;799;2367;1091;3361
431710;201303;12244;37465;10638;34669;3033;10356;5130;17346;8163;27702
431720;201303;6610;19745;5909;18558;1465;5219;3334;10217;4799;15436
431725;201303;41;150;40;147;22;82;6;22;28;104
431730;201303;3444;11199;2980;10322;914;3505;1255;4303;2169;7808
431740;201303;5878;17948;5376;17006;1833;6224;2024;6323;3857;12547
431750;201303;9982;29704;8713;27585;1758;6026;4856;15679;6614;21705
431755;201303;208;588;80;287;26;105;20;61;46;166
431760;201303;3539;11424;3121;10624;1005;3688;930;3134;1935;6822
431770;201303;2222;6432;1951;5982;489;1655;1050;3148;1539;4803
431775;201303;230;681;191;608;80;274;61;175;141;449
431780;201303;2396;6795;2022;6097;650;2099;605;1770;1255;3869
431790;201303;1062;3555;993;3432;297;1098;514;1760;811;2858
431795;201303;414;1371;360;1200;50;184;229;750;279;934
431800;201303;9106;28022;7975;25974;2504;8922;3110;9991;5614;18913
431805;201303;217;538;70;246;21;87;17;58;38;145
431810;201303;3621;10697;3196;9796;873;2858;1486;4529;2359;7387
431820;201303;2591;8571;2373;8144;859;3182;625;2098;1484;5280
431830;201303;9850;27970;8707;26097;3285;10625;3184;9583;6469;20208
431840;201303;3428;10770;3076;10051;997;3342;1341;4481;2338;7823
431842;201303;687;1870;436;1370;96;337;152;458;248;795
431843;201303;283;935;267;903;84;299;135;457;219;756
431844;201303;158;493;127;431;37;141;38;132;75;273
431845;201303;536;1699;509;1646;51;165;370;1225;421;1390
431846;201303;501;1599;451;1489;86;322;259;851;345;1173
431848;201303;194;533;96;332;19;80;23;72;42;152
431849;201303;294;778;141;441;31;106;38;107;69;213
431850;201303;4881;14629;4421;13773;1123;3909;2335;7039;3458;10948
431860;201303;917;2757;823;2590;228;783;393;1182;621;1965
431861;201303;77;250;57;187;15;58;16;46;31;104
431862;201303;465;1653;417;1546;155;613;140;524;295;1137
431870;201303;25910;75236;22193;68569;6357;21628;9847;29756;16204;51384
431880;201303;4459;14876;3857;13428;1262;4837;1570;5279;2832;10116
431890;201303;5688;17143;5152;16116;2111;6876;1628;5278;3739;12154
431900;201303;932;3121;834;2935;279;1094;314;1016;593;2110
431910;201303;690;1834;449;1373;96;337;199;558;295;895
431912;201303;590;1754;478;1518;146;461;168;550;314;1011
431915;201303;1202;3542;1001;3144;311;1005;337;1071;648;2076
431920;201303;1450;4355;1404;4290;202;599;1087;3403;1289;4002
431930;201303;1198;3515;1003;3177;143;451;581;1962;724;2413
431935;201303;93;369;88;356;40;167;18;60;58;227
431936;201303;480;1418;442;1350;75;224;287;947;362;1171
431937;201303;281;809;205;653;53;184;65;197;118;381
431940;201303;2634;7550;1943;6261;594;2028;557;1778;1151;3806
431950;201303;1787;5922;1612;5581;504;1928;618;2035;1122;3963
431960;201303;3669;11271;3385;10700;1098;3710;1256;4012;2354;7722
431970;201303;495;1415;291;999;58;214;98;320;156;534
431971;201303;127;397;113;376;23;86;67;213;90;299
431973;201303;444;1659;399;1564;71;286;227;971;298;1257
431975;201303;12;51;9;43;2;12;4;17;6;29
431980;201303;1499;4456;1425;4353;353;1253;799;2393;1152;3646
431990;201303;8332;24404;7143;22597;1405;5100;3910;12290;5315;17390
432000;201303;9544;29719;8253;27429;2944;10103;3469;11757;6413;21860
432010;201303;2417;7428;2159;6931;550;2026;1037;3180;1587;5206
432020;201303;1886;5505;1753;5319;361;1175;1090;3284;1451;4459
432023;201303;505;1528;401;1296;122;438;159;486;281;924
432026;201303;1243;3953;1124;3720;210;706;711;2411;921;3117
432030;201303;387;1205;335;1088;96;335;145;447;241;782
432032;201303;440;1231;348;1098;49;178;244;758;293;936
432035;201303;839;2799;776;2662;215;800;430;1439;645;2239
432040;201303;607;1941;480;1643;132;499;106;290;238;789
432045;201303;184;637;168;602;49;190;74;261;123;451
432050;201303;738;2225;682;2117;143;464;402;1278;545;1742
432055;201303;712;2374;664;2268;158;573;414;1404;572;1977
432057;201303;471;1320;418;1214;67;217;242;660;309;877
432060;201303;367;1107;192;694;62;240;49;169;111;409
432065;201303;191;625;167;578;45;177;73;228;118;405
432067;201303;852;3017;679;2579;214;835;271;1004;485;1839
432070;201303;2139;6459;1952;6079;711;2413;741;2315;1452;4728
432080;201303;3963;12055;3640;11495;1146;3822;1664;5223;2810;9045
432085;201303;248;837;220;786;85;354;62;207;147;561
432090;201303;1579;5201;1409;4812;566;2062;363;1077;929;3139
432100;201303;1016;3212;688;2436;221;824;154;496;375;1320
432110;201303;2900;9061;2479;8233;940;3344;572;1914;1512;5258
432120;201303;4872;15576;4270;14386;1568;5775;1163;3802;2731;9577
432130;201303;1880;6125;1785;5957;540;1943;989;3305;1529;5248
432132;201303;386;1256;269;966;52;191;95;318;147;509
432135;201303;774;2349;732;2270;140;466;474;1459;614;1925
432140;201303;2836;8637;2442;7939;696;2297;1026;3752;1722;6049
432143;201303;1245;4048;1155;3904;259;892;763;2661;1022;3553
432145;201303;707;2345;563;2038;227;906;116;386;343;1292
432146;201303;230;770;192;673;68;250;57;200;125;450
432147;201303;803;2674;697;2456;217;791;336;1233;553;2024
432149;201303;381;1208;292;975;71;255;121;394;192;649
432150;201303;2818;9087;2442;8514;1061;3870;729;2675;1790;6545
432160;201303;4237;14439;3845;13764;1487;5613;1383;5221;2870;10834
432162;201303;308;779;97;326;25;95;24;65;49;160
432163;201303;319;841;108;344;22;68;26;83;48;151
432166;201303;718;2254;614;2041;153;569;253;773;406;1342
432170;201303;726;2531;541;2105;147;638;109;365;256;1003
432180;201303;2606;7182;1998;6256;625;2143;679;2052;1304;4195
432183;201303;380;1325;359;1287;160;587;104;386;264;973
432185;201303;727;2202;494;1688;135;506;155;520;290;1026
432190;201303;3269;9457;2617;8007;755;2497;856;2467;1611;4964
432195;201303;1221;3612;1107;3441;198;668;694;2155;892;2823
432200;201303;2956;9523;2472;8691;855;3165;1027;3741;1882;6906
432210;201303;410;1265;374;1218;111;421;177;534;288;955
432215;201303;818;2732;769;2645;150;491;502;1819;652;2310
432218;201303;283;856;244;770;42;154;130;389;172;543
432220;201303;3606;10199;3090;9352;631;2170;1771;5246;2402;7416
432225;201303;58;210;52;202;30;120;7;33;37;153
432230;201303;933;2812;860;2709;288;1000;409;1227;697;2227
432232;201303;519;1600;423;1411;96;358;229;764;325;1122
432234;201303;565;1644;516;1557;125;372;290;899;415;1271
432235;201303;67;222;42;159;21;92;9;31;30;123
432237;201303;476;1377;444;1324;40;154;367;1075;407;1229
432240;201303;14544;51036;12987;48929;3411;13740;7565;29231;10976;42971
432250;201303;5302;19292;5090;18848;2540;9977;1259;4843;3799;14820
432252;201303;386;1249;374;1223;116;382;199;682;315;1064
432253;201303;1156;4122;1014;3740;353;1360;348;1296;701;2656
432254;201303;286;801;160;537;55;193;22;81;77;274
432255;201303;163;429;94;320;25;95;39;134;64;229
432260;201303;5632;16291;4805;14946;1164;3879;2564;8004;3728;11883
432270;201303;2445;8109;2275;7803;624;2184;1262;4419;1886;6603
432280;201303;974;3092;724;2525;193;781;204;601;397;1382
432285;201303;106;340;71;241;23;87;16;43;39;130
432290;201303;544;1753;411;1422;84;337;168;549;252;886
432300;201303;21554;68931;20239;66709;5705;19899;10732;35539;16437;55438
432310;201303;954;3157;851;2963;216;812;435;1474;651;2286
432320;201303;252;751;197;645;60;198;67;233;127;431
432330;201303;188;591;105;377;26;106;11;33;37;139
432335;201303;198;595;108;372;38;136;15;40;53;176
432340;201303;264;715;148;463;45;145;42;123;87;268
432345;201303;716;2154;678;2100;182;666;367;1060;549;1726
432350;201303;401;1228;323;1085;91;328;91;290;182;618
432360;201303;50;172;43;153;15;56;18;61;33;117
432370;201303;441;1294;397;1214;35;104;270;832;305;936
432375;201303;772;2107;697;1987;121;354;447;1292;568;1646
432377;201303;54;193;29;108;5;21;7;19;12;40
432380;201303;817;3004;757;2856;355;1457;232;823;587;2280
500020;201303;1489;5456;1318;5064;528;2231;318;1125;846;3356
500025;201303;685;2035;595;1894;158;524;285;881;443;1405
500060;201303;4971;15771;4489;15206;359;1234;3864;13381;4223;14615
500070;201303;3224;10542;2836;9904;802;3133;1241;4270;2043;7403
500080;201303;1542;4935;1290;4514;453;1695;450;1644;903;3339
500085;201303;2062;5891;1593;5149;255;922;946;2963;1201;3885
500090;201303;1941;6158;1695;5730;399;1363;905;3164;1304;4527
500100;201303;2222;7048;2129;6943;843;3026;910;2892;1753;5918
500110;201303;7045;21739;6041;20268;991;3781;3734;12847;4725;16628
500124;201303;1326;4904;1208;4694;236;903;712;2983;948;3886
500150;201303;1229;3491;1054;3245;299;974;513;1578;812;2552
500190;201303;4210;11926;3375;10935;933;3299;1694;5702;2627;9001
500200;201303;2381;6574;1786;5720;481;1770;858;2610;1339;4380
500210;201303;4462;14176;3975;13465;926;3331;2161;7617;3087;10948
500215;201303;1614;5285;1413;4856;364;1423;632;2058;996;3481
500220;201303;2287;7841;2015;7342;576;2252;834;3071;1410;5323
500230;201303;1459;4841;1347;4672;670;2475;410;1414;1080;3889
500240;201303;3784;12933;3139;11585;810;3292;1316;5048;2126;8340
500260;201303;2291;6642;1957;6115;509;1750;903;2659;1412;4409
500270;201303;88492;246603;65953;208139;22177;76089;18163;58496;40340;134585
500280;201303;1203;3767;1066;3574;252;905;575;1973;827;2878
500290;201303;3242;9131;2445;7706;776;2794;864;2504;1640;5298
500295;201303;2056;6792;1668;5818;468;1848;489;1530;957;3378
500310;201303;762;2188;693;2095;179;588;377;1099;556;1687
500315;201303;2663;8688;2352;8268;553;1905;1427;5325;1980;7230
500320;201303;11419;40797;10436;39127;3761;14646;4114;16565;7875;31211
500325;201303;3135;9390;2616;8538;877;3174;880;2678;1757;5852
500330;201303;4683;13926;4231;13199;1350;4616;1968;6018;3318;10634
500345;201303;2071;6931;1970;6714;566;2110;936;3117;1502;5227
500348;201303;2257;7163;2163;6999;291;1012;1662;5386;1953;6398
500350;201303;1070;3450;743;2713;164;618;215;864;379;1482
500370;201303;20058;66550;17157;60946;4700;18522;7384;26190;12084;44712
500375;201303;2066;6306;1787;5812;489;1698;868;2890;1357;4588
500380;201303;2689;8180;2409;7621;766;2583;969;3081;1735;5664
500390;201303;512;1207;358;982;60;205;239;601;299;806
500400;201303;1095;3706;1011;3512;351;1326;302;984;653;2310
500410;201303;1890;5523;1655;5219;485;1673;755;2388;1240;4061
500430;201303;2231;7375;1951;6958;619;2300;882;3270;1501;5570
500440;201303;1237;3789;1092;3559;304;1133;589;1822;893;2955
500450;201303;2045;6607;1665;5816;477;1883;335;1048;812;2931
500460;201303;3316;10802;2829;10102;745;2846;1408;5027;2153;7873
500470;201303;3116;10344;2827;9626;1013;3697;803;2613;1816;6310
500480;201303;1923;6531;1790;6313;193;731;1385;4980;1578;5711
500490;201303;851;2746;794;2648;285;1025;334;1114;619;2139
500500;201303;2810;9293;2442;8806;912;3654;983;3424;1895;7078
500510;201303;738;2132;574;1885;171;676;243;696;414;1372
500515;201303;1622;4803;1373;4440;290;917;837;2875;1127;3792
500520;201303;2425;8989;2204;8709;603;2471;1323;5451;1926;7922
500525;201303;1010;3597;936;3478;272;1067;445;1737;717;2804
500540;201303;3072;10771;2713;10089;951;3816;973;3576;1924;7392
500560;201303;4234;15120;3894;14634;933;3706;2432;9282;3365;12988
500568;201303;3358;9470;2665;8500;669;2322;1363;4496;2032;6818
500570;201303;6800;19501;5189;16810;1579;5454;2166;7087;3745;12541
500580;201303;2675;8880;2331;8217;556;2080;1238;4355;1794;6435
500600;201303;2068;6657;1823;6279;675;2462;709;2376;1384;4838
500620;201303;7156;20969;5435;18281;1460;5480;2607;8674;4067;14154
500625;201303;759;2435;588;2078;180;698;192;637;372;1335
500630;201303;5709;16678;4702;15237;1803;6438;1276;4147;3079;10585
500635;201303;2056;8771;1882;8483;320;1377;1203;5867;1523;7244
500640;201303;1180;3329;1001;3060;172;600;652;1933;824;2533
500660;201303;12826;41372;11361;38808;2341;8585;6944;23872;9285;32457
500690;201303;2883;8647;2419;8071;536;1863;1453;5081;1989;6944
500710;201303;3007;10057;2894;9881;906;3199;1512;5257;2418;8456
500720;201303;3377;11102;3031;10509;1131;4260;1066;3673;2197;7933
500730;201303;778;2424;688;2255;199;720;284;902;483;1622
500740;201303;3178;9381;2464;8150;636;2411;1063;3314;1699;5725
500750;201303;681;2234;650;2186;158;607;391;1265;549;1872
500755;201303;1062;3403;874;3057;228;858;367;1266;595;2124
500769;201303;3971;11419;2960;9420;780;2772;1016;3013;1796;5785
500770;201303;1472;4679;1264;4295;374;1355;522;1805;896;3160
500780;201303;875;3037;844;2964;311;1171;360;1222;671;2393
500790;201303;6870;21571;6099;20193;1496;5670;3140;9953;4636;15623
500793;201303;2241;6791;1860;6147;377;1445;866;2706;1243;4151
500795;201303;2034;6484;1853;6218;194;629;1442;5018;1636;5647
500797;201303;828;2437;685;2210;176;622;320;1058;496;1680
500800;201303;1900;6148;1704;5877;538;2019;857;2965;1395;4984
500830;201303;12278;39964;10247;35535;3623;13428;2799;9692;6422;23120
500840;201303;1141;3688;1007;3431;207;774;529;1778;736;2552
510010;201303;1191;3913;1129;3806;375;1342;507;1745;882;3087
510020;201303;2267;6978;1824;6251;621;2269;507;1644;1128;3913
510025;201303;8493;26810;7636;25394;2596;9465;3060;10001;5656;19466
510030;201303;2057;5724;1773;5323;542;1688;888;2726;1430;4414
510035;201303;853;2698;740;2525;179;629;406;1456;585;2085
510040;201303;1478;4258;1194;3845;317;1172;572;1784;889;2956
510050;201303;1483;4707;1257;4356;408;1537;509;1805;917;3342
510060;201303;1068;3276;859;2897;277;1033;260;837;537;1870
510080;201303;1272;4081;1089;3779;306;1243;454;1451;760;2694
510100;201303;533;1493;384;1211;109;394;153;452;262;846
510120;201303;248;530;180;455;15;37;157;402;172;439
510125;201303;2584;7248;2229;6708;447;1637;1204;3503;1651;5140
510130;201303;1831;5433;1665;5213;512;1671;751;2404;1263;4075
510140;201303;2727;9359;2367;8840;815;3149;1017;3905;1832;7054
510160;201303;1258;4380;1208;4322;88;354;1066;3812;1154;4166
510170;201303;5184;16963;4635;15959;1307;5007;2100;7029;3407;12036
510180;201303;8666;26144;7029;23325;2312;8134;2711;9677;5023;17811
510185;201303;984;3229;928;3150;257;841;553;2005;810;2846
510190;201303;1400;5097;1230;4836;341;1443;556;2273;897;3716
510250;201303;13059;43482;11563;41480;3648;13737;5894;21685;9542;35422
510260;201303;2451;9099;2355;8941;618;2201;1465;5948;2083;8149
510263;201303;3648;10723;2979;9646;882;3087;1151;3674;2033;6761
510267;201303;3916;12185;3381;11115;887;3237;1498;4750;2385;7987
510268;201303;797;2370;699;2238;220;767;336;1072;556;1839
510269;201303;782;2634;710;2511;242;902;256;936;498;1838
510270;201303;1957;6523;1791;6290;467;1703;913;3423;1380;5126
510279;201303;1980;6647;1841;6413;697;2669;730;2424;1427;5093
510285;201303;1369;4457;1194;4109;395;1465;368;1192;763;2657
510300;201303;2877;9326;2666;9052;375;1402;2026;6888;2401;8290
510305;201303;1509;5069;1299;4689;372;1451;482;1829;854;3280
510310;201303;1055;3147;851;2824;314;1149;266;872;580;2021
510320;201303;3635;11361;3088;10271;1028;3963;645;1821;1673;5784
510325;201303;5148;17141;4558;16245;581;2039;3490;12880;4071;14919
510330;201303;2537;8689;2255;8164;632;2515;880;3279;1512;5794
510335;201303;4134;13763;3722;13194;684;2427;2662;9789;3346;12216
510336;201303;432;1446;404;1397;95;360;203;701;298;1061
510337;201303;2247;7845;2069;7520;868;3220;761;2955;1629;6175
510340;201303;52647;166333;44682;154399;18632;69513;11093;40536;29725;110049
510343;201303;1016;3236;967;3175;134;422;761;2580;895;3002
510345;201303;1511;4659;1369;4460;426;1439;573;1920;999;3359
510350;201303;2935;9403;2582;8932;806;2980;1312;4616;2118;7596
510360;201303;1427;4433;1300;4262;296;1019;868;2852;1164;3871
510370;201303;761;2855;680;2711;228;966;300;1227;528;2193
510380;201303;447;1540;382;1396;145;587;69;232;214;819
510385;201303;832;3296;759;3117;144;607;388;1736;532;2343
510390;201303;992;3378;918;3287;257;937;499;1896;756;2833
510395;201303;811;2206;650;1999;135;450;398;1265;533;1715
510410;201303;3566;12421;3406;12150;1115;4288;1652;5848;2767;10136
510420;201303;1908;5324;1612;4917;268;982;954;2883;1222;3865
510450;201303;514;1528;410;1382;139;521;125;416;264;937
510452;201303;507;1647;414;1445;121;487;146;458;267;945
510454;201303;666;2243;595;2139;176;654;315;1180;491;1834
510455;201303;870;2848;728;2608;202;850;296;1035;498;1885
510460;201303;1598;5005;1497;4869;380;1414;905;2819;1285;4233
510480;201303;3703;10606;3033;9378;807;2702;1312;4032;2119;6734
510490;201303;1375;4801;1269;4646;409;1556;684;2524;1093;4080
510500;201303;1135;3793;979;3566;287;1174;529;1878;816;3052
510510;201303;2778;10144;2517;9724;1019;4076;988;3901;2007;7977
510515;201303;4939;15990;4212;14540;1229;4742;1311;4328;2540;9070
510517;201303;1499;4937;1379;4755;415;1416;822;2940;1237;4356
510520;201303;2054;5560;1688;5055;149;535;1294;3817;1443;4352
510523;201303;941;3049;799;2807;257;986;353;1205;610;2191
510525;201303;7236;18685;4532;14347;1194;4128;1540;4796;2734;8924
510530;201303;521;1593;472;1521;89;325;282;919;371;1244
510550;201303;2429;8382;2216;8071;655;2416;1146;4397;1801;6813
510558;201303;1863;5598;1473;5020;518;1902;486;1639;1004;3541
510560;201303;1355;4762;1105;4334;441;1758;279;1173;720;2931
510562;201303;4339;14044;4045;13484;1520;5503;1448;4826;2968;10329
510590;201303;2401;7443;1961;6881;591;2282;885;3113;1476;5395
510600;201303;1316;3526;992;3059;183;636;580;1750;763;2386
510610;201303;2357;7653;2263;7547;312;1197;1815;5978;2127;7175
510615;201303;1975;6906;1784;6562;592;2358;801;2890;1393;5248
510617;201303;459;1589;436;1554;79;317;324;1138;403;1455
510618;201303;1128;3519;873;3022;239;924;375;1293;614;2217
510619;201303;689;2002;476;1613;117;443;164;554;281;997
510620;201303;1065;3050;799;2671;271;1006;183;592;454;1598
510621;201303;1121;4025;997;3740;321;1318;392;1429;713;2747
510622;201303;2887;9567;2273;8109;681;2730;485;1524;1166;4254
510623;201303;3170;9772;2854;9333;1235;4137;885;3004;2120;7141
510624;201303;917;3241;838;3070;212;839;383;1359;595;2198
510625;201303;1874;6041;1631;5551;541;2028;545;1731;1086;3759
510626;201303;1118;3807;969;3569;295;1155;506;1902;801;3057
510627;201303;600;2017;506;1831;199;770;172;625;371;1395
510628;201303;1390;3874;1174;3611;190;665;812;2472;1002;3137
510629;201303;1574;5502;1421;5187;576;2213;326;1209;902;3422
510630;201303;2711;9262;2353;8662;846;3372;772;2929;1618;6301
510631;201303;379;1173;343;1114;82;266;221;728;303;994
510637;201303;2330;7449;2201;7212;725;2657;1048;3294;1773;5951
510642;201303;4252;14421;3686;13695;1245;4733;1859;7283;3104;12016
510645;201303;626;1649;525;1524;189;586;187;591;376;1177
510650;201303;5473;19532;5245;19222;1301;5036;3202;12099;4503;17135
510665;201303;1087;2966;839;2671;222;805;459;1452;681;2257
510670;201303;345;888;214;697;62;226;83;248;145;474
510675;201303;5766;19714;5101;18506;1929;7603;1566;5634;3495;13237
510677;201303;2295;6099;1742;5410;245;803;1290;4064;1535;4867
510680;201303;744;2444;650;2303;178;693;257;845;435;1538
510682;201303;2082;7089;1809;6574;501;1899;831;3201;1332;5100
510685;201303;683;2283;659;2242;195;694;352;1238;547;1932
510700;201303;2666;8499;2356;8055;531;2034;1460;4896;1991;6930
510704;201303;6530;19970;5829;18768;1850;6664;2689;8336;4539;15000
510706;201303;1268;4434;1194;4287;407;1535;569;1988;976;3523
510710;201303;3215;9700;2805;8936;853;3120;1127;3274;1980;6394
510715;201303;663;1809;456;1466;135;480;152;438;287;918
510718;201303;1508;4945;1414;4791;326;1168;908;3093;1234;4261
510719;201303;421;1002;258;775;44;175;118;319;162;494
510720;201303;1200;2973;904;2623;97;319;678;1977;775;2296
510724;201303;757;2453;686;2324;146;519;424;1441;570;1960
510726;201303;629;1756;564;1654;169;541;246;687;415;1228
510729;201303;550;1697;484;1588;139;498;227;734;366;1232
510730;201303;1965;6575;1841;6352;482;1928;1096;3597;1578;5525
510735;201303;1055;3776;938;3610;310;1195;473;1908;783;3103
510740;201303;929;2501;799;2332;115;352;575;1715;690;2067
510757;201303;568;2154;562;2140;155;635;327;1217;482;1852
510760;201303;22472;70168;19769;65376;7642;27043;6703;22147;14345;49190
510770;201303;3355;10703;3230;10532;630;2078;2140;7321;2770;9399
510774;201303;363;1027;305;948;39;140;210;653;249;793
510775;201303;813;2366;683;2184;274;973;273;897;547;1870
510776;201303;324;1068;297;1019;76;295;147;466;223;761
510777;201303;1304;4305;1056;3993;245;1089;640;2358;885;3447
510779;201303;586;1809;470;1599;95;352;201;699;296;1051
510780;201303;3337;10628;3085;10268;746;2600;1819;6175;2565;8775
510785;201303;1745;5352;1489;4943;510;1750;596;2047;1106;3797
510787;201303;1794;5909;1636;5629;515;1946;577;1947;1092;3893
510788;201303;327;1040;302;1012;98;301;147;521;245;822
510790;201303;11981;37714;8947;31885;3006;12149;1463;5107;4469;17256
510792;201303;4578;16030;3742;14194;1137;4949;707;2491;1844;7440
510794;201303;1248;4071;1035;3762;553;2125;200;682;753;2807
510795;201303;7220;25557;6366;23713;2331;9177;1789;6885;4120;16062
510800;201303;1579;4837;1398;4605;411;1510;700;2214;1111;3724
510805;201303;1506;4563;1256;4200;306;1164;763;2489;1069;3653
510810;201303;586;1534;482;1389;142;455;256;706;398;1161
510820;201303;815;2110;639;1841;173;597;253;662;426;1259
510830;201303;519;1904;476;1834;173;699;208;850;381;1549
510835;201303;634;2088;515;1855;209;815;201;681;410;1496
510840;201303;41513;112742;35163;104919;9442;29760;18965;58421;28407;88181
510850;201303;1587;4862;1336;4461;605;2221;216;587;821;2808
510860;201303;2173;7711;1934;7215;723;2857;481;1827;1204;4684
510880;201303;771;2711;690;2558;277;1072;243;900;520;1972
510885;201303;479;1434;369;1264;89;359;168;557;257;916
510890;201303;831;2930;728;2726;239;1004;186;653;425;1657
510895;201303;977;3312;910;3200;299;1175;393;1308;692;2483
520005;201303;976;3364;926;3283;312;1181;380;1332;692;2513
520010;201303;1704;6188;1549;5845;713;2963;228;731;941;3694
520013;201303;3445;10165;2888;9270;807;2751;1436;4635;2243;7386
520015;201303;561;1569;455;1418;124;391;225;740;349;1131
520017;201303;1089;3672;989;3498;286;1085;442;1558;728;2643
520020;201303;326;944;283;888;92;304;148;476;240;780
520025;201303;18083;62783;17757;62338;3498;12955;12915;45327;16413;58282
520030;201303;4010;13773;3672;13225;1431;5478;1303;4943;2734;10421
520050;201303;299;943;286;915;68;245;178;547;246;792
520055;201303;608;1894;525;1764;138;473;258;902;396;1375
520060;201303;1556;5106;1405;4821;363;1385;575;2037;938;3422
520080;201303;1410;4945;1361;4852;316;1178;843;3042;1159;4220
520082;201303;594;2117;566;2057;176;641;316;1195;492;1836
520085;201303;953;3089;840;2818;225;818;337;1142;562;1960
520090;201303;756;2130;698;2032;107;306;467;1389;574;1695
520110;201303;31811;104029;26295;95822;11356;44689;7217;26636;18573;71325
520120;201303;257;683;153;506;47;171;54;199;101;370
520130;201303;3206;10099;3083;9917;891;3096;1642;5269;2533;8365
520140;201303;39741;138419;36849;132500;13969;53928;11926;42875;25895;96803
520145;201303;533;1417;396;1233;93;317;170;512;263;829
520150;201303;625;1712;539;1601;168;539;256;753;424;1292
520160;201303;750;2356;685;2264;253;888;302;1003;555;1891
520170;201303;3385;8885;2773;8235;693;2114;1701;5269;2394;7383
520180;201303;1352;4587;1271;4446;436;1628;532;1842;968;3470
520215;201303;1351;3843;1208;3639;244;850;749;2255;993;3105
520235;201303;741;2094;607;1902;195;678;261;792;456;1470
520250;201303;1027;3628;969;3520;338;1273;519;1892;857;3165
520260;201303;647;1812;527;1595;92;324;276;802;368;1126
520280;201303;533;1622;486;1544;225;742;139;487;364;1229
520310;201303;796;2198;660;2042;134;404;485;1542;619;1946
520320;201303;1176;3996;1026;3727;279;1079;466;1716;745;2795
520330;201303;2494;8151;2077;7467;700;2725;694;2492;1394;5217
520340;201303;1782;4776;1479;4418;295;854;1078;3325;1373;4179
520350;201303;2636;8545;2397;8076;968;3450;991;3267;1959;6717
520355;201303;1036;3746;1023;3717;399;1531;475;1720;874;3251
520357;201303;877;2492;765;2332;81;280;533;1620;614;1900
520360;201303;488;1363;448;1316;114;333;285;864;399;1197
520380;201303;947;2661;757;2384;184;636;411;1318;595;1954
520390;201303;1146;3154;815;2703;287;1093;292;889;579;1982
520393;201303;549;1537;508;1475;99;291;345;1021;444;1312
520396;201303;647;2162;625;2125;70;274;491;1673;561;1947
520400;201303;1738;5083;1506;4763;279;963;1040;3319;1319;4282
520410;201303;1318;3900;1095;3567;369;1325;491;1543;860;2868
520420;201303;308;914;255;829;65;248;130;410;195;658
520425;201303;1386;3979;1318;3853;432;1360;650;1861;1082;3221
520430;201303;1727;4829;1345;4217;330;1181;608;1882;938;3063
520440;201303;2262;6896;1946;6412;763;2723;632;2025;1395;4748
520450;201303;8179;24785;6960;22687;2295;8367;2105;6481;4400;14848
520455;201303;645;2005;546;1849;232;826;151;531;383;1357
520460;201303;665;2088;578;1947;220;799;210;722;430;1521
520465;201303;806;2267;712;2140;187;672;321;889;508;1561
520470;201303;1559;5300;1443;5126;364;1335;892;3268;1256;4603
520480;201303;799;2482;740;2406;174;578;491;1618;665;2196
520485;201303;1064;3740;1001;3637;379;1470;449;1624;828;3094
520490;201303;4207;13599;3503;12495;870;3464;1870;6756;2740;10220
520495;201303;1360;3769;1147;3513;69;171;1037;3266;1106;3437
520500;201303;1919;5280;1757;5075;549;1639;843;2708;1392;4347
520505;201303;825;2470;718;2307;99;289;543;1798;642;2087
520510;201303;10311;29817;6919;23884;2197;8338;1731;5960;3928;14298
520520;201303;902;2837;817;2728;344;1216;316;1065;660;2281
520530;201303;2229;7241;2011;6896;469;1597;1080;4115;1549;5712
520540;201303;2645;8641;2461;8330;877;3117;1083;3613;1960;6730
520545;201303;1264;4034;1101;3689;363;1321;330;1052;693;2373
520547;201303;771;2458;612;2175;211;837;187;628;398;1465
520549;201303;7203;23199;6469;22370;1405;5341;4499;15390;5904;20731
520551;201303;3338;10555;3212;10397;963;3209;1783;6094;2746;9303
520552;201303;654;2281;640;2257;141;555;425;1476;566;2031
520570;201303;559;1706;428;1484;189;692;85;298;274;990
520580;201303;1853;5637;1522;5114;502;1904;363;1125;865;3029
520590;201303;1397;4132;1252;3895;325;1120;604;1748;929;2868
520620;201303;6233;21371;5778;20660;1457;5571;3253;11825;4710;17396
520630;201303;567;1603;487;1509;147;420;301;992;448;1412
520640;201303;2048;6700;1975;6587;709;2412;959;3323;1668;5735
520650;201303;718;2209;673;2122;296;997;261;803;557;1800
520660;201303;344;1140;309;1068;109;405;94;324;203;729
520670;201303;699;2220;690;2208;76;188;591;1958;667;2146
520680;201303;463;1569;443;1540;183;679;148;505;331;1184
520690;201303;303;804;215;683;28;95;122;406;150;501
520710;201303;293;840;269;808;7;24;208;614;215;638
520725;201303;1531;4331;1285;4004;337;1145;722;2255;1059;3400
520735;201303;571;1836;498;1715;193;686;157;534;350;1220
520740;201303;1528;4676;1329;4409;386;1340;639;2162;1025;3502
520750;201303;649;1792;497;1598;147;513;292;944;439;1457
520753;201303;1025;3158;1012;3139;152;427;820;2603;972;3030
520760;201303;1081;3152;973;3018;329;1098;536;1616;865;2714
520780;201303;1749;4699;1569;4463;182;520;1258;3639;1440;4159
520790;201303;2339;7122;2139;6825;272;912;1574;5134;1846;6046
520800;201303;15931;49510;14335;47587;3083;10533;9013;31623;12096;42156
520810;201303;776;2427;761;2398;89;311;612;1945;701;2256
520815;201303;292;1104;261;1035;155;660;49;178;204;838
520830;201303;1621;4343;1279;3986;68;192;1149;3667;1217;3859
520840;201303;1577;5490;1453;5232;486;1846;564;2084;1050;3930
520850;201303;771;2288;614;2072;190;683;284;939;474;1622
520860;201303;6662;20000;5240;18144;1612;6086;2582;9030;4194;15116
520870;201303;112902;330415;82835;274677;27944;100127;25044;83085;52988;183212
520880;201303;5445;16954;4213;14876;1338;5240;551;1727;1889;6967
520890;201303;3262;10263;3028;9894;765;2645;1644;5340;2409;7985
520910;201303;3608;12034;3251;11313;1140;4284;1109;3723;2249;8007
520915;201303;850;2494;625;2040;130;465;252;775;382;1240
520920;201303;2293;6956;1966;6518;513;1866;957;3232;1470;5098
520929;201303;419;1317;392;1283;110;384;206;668;316;1052
520940;201303;870;2847;833;2800;102;390;671;2237;773;2627
520945;201303;619;1598;573;1531;133;389;339;863;472;1252
520960;201303;839;2548;717;2380;119;416;468;1570;587;1986
520970;201303;3183;9512;2611;8484;555;2051;1174;3782;1729;5833
520980;201303;974;2719;912;2634;83;239;783;2281;866;2520
520990;201303;3586;11462;3190;10765;686;2411;1756;6471;2442;8882
520993;201303;949;2908;780;2559;186;663;372;1185;558;1848
520995;201303;2368;6735;2169;6469;366;1116;1581;4768;1947;5884
521000;201303;7160;22328;6259;20900;1571;5640;3542;11980;5113;17620
521010;201303;3127;10404;2862;9908;813;2993;1393;4889;2206;7882
521015;201303;632;1909;564;1808;125;413;317;1021;442;1434
521020;201303;4097;12599;3450;11297;1360;4793;772;2283;2132;7076
521030;201303;779;2167;699;2055;118;370;506;1503;624;1873
521040;201303;4829;14863;4420;14196;1139;3630;2677;8939;3816;12569
521056;201303;948;2997;831;2815;278;990;368;1263;646;2253
521060;201303;1074;3130;933;2881;247;834;336;992;583;1826
521080;201303;1061;2836;746;2298;205;757;266;724;471;1481
521090;201303;2945;9153;2595;8647;914;3261;1055;3527;1969;6788
521100;201303;1376;3696;1281;3591;233;652;928;2664;1161;3316
521120;201303;4391;13344;4040;12748;880;2688;2497;8207;3377;10895
521130;201303;958;2922;841;2736;176;643;451;1503;627;2146
521140;201303;849;2950;775;2773;327;1236;164;559;491;1795
521150;201303;10047;28130;8400;25560;2644;8805;4194;12745;6838;21550
521160;201303;586;1640;513;1501;99;316;305;860;404;1176
521170;201303;1280;3175;1117;2977;309;798;662;1783;971;2581
521180;201303;5645;20314;5280;19512;2135;8313;1550;5794;3685;14107
521190;201303;7704;24145;6094;21415;2244;8245;2139;7604;4383;15849
521200;201303;757;2084;720;2039;107;308;529;1520;636;1828
521205;201303;441;1495;420;1458;70;268;269;943;339;1211
521210;201303;693;2173;561;1953;236;915;205;629;441;1544
521220;201303;3305;9978;2930;9441;1118;3863;1052;3335;2170;7198
521225;201303;323;918;262;836;49;174;164;537;213;711
521230;201303;1160;3866;1133;3809;377;1348;588;1957;965;3305
521250;201303;23843;82673;22999;81267;9541;35783;9000;32305;18541;68088
521260;201303;564;1505;450;1269;102;363;199;524;301;887
521270;201303;1638;5464;1553;5315;159;470;1231;4407;1390;4877
521280;201303;1457;4820;1291;4565;456;1711;631;2220;1087;3931
521290;201303;478;1448;370;1263;98;406;159;512;257;918
521295;201303;998;2970;940;2885;212;699;628;1921;840;2620
521300;201303;1610;4865;1467;4606;533;1841;427;1333;960;3174
521305;201303;788;2135;676;1985;127;364;457;1404;584;1768
521308;201303;4603;14355;3847;13133;741;2825;2387;8033;3128;10858
521310;201303;6228;19967;5464;18747;2308;8373;1653;5638;3961;14011
521340;201303;236;779;218;747;74;281;93;303;167;584
521350;201303;1936;5310;1624;4924;223;771;1072;3402;1295;4173
521370;201303;964;3174;905;3055;324;1156;367;1211;691;2367
521375;201303;1357;4007;1226;3813;322;1053;693;2185;1015;3238
521377;201303;948;3032;926;3000;106;324;772;2559;878;2883
521380;201303;3556;10862;3023;10064;732;2653;1534;5071;2266;7724
521385;201303;574;1690;522;1619;161;527;274;855;435;1382
521390;201303;1077;2954;839;2621;333;1156;280;875;613;2031
521400;201303;2320;6414;2025;6083;293;944;1582;4732;1875;5676
521405;201303;992;3188;978;3169;151;474;743;2472;894;2946
521410;201303;697;2355;655;2283;314;1078;230;844;544;1922
521440;201303;1380;3950;1357;3926;149;391;1161;3431;1310;3822
521450;201303;4633;14268;3928;12960;1365;4863;973;3037;2338;7900
521460;201303;6351;21154;5923;20455;1840;6758;2996;10514;4836;17272
521470;201303;613;1825;491;1607;139;512;123;404;262;916
521480;201303;510;1506;384;1291;133;469;97;326;230;795
521483;201303;2630;7442;2415;7120;561;1748;1430;4182;1991;5930
521486;201303;1436;4308;1315;4062;395;1353;726;2137;1121;3490
521487;201303;565;1545;447;1385;69;218;301;949;370;1167
521490;201303;755;2293;645;2152;135;496;389;1317;524;1813
521500;201303;1086;3721;1034;3644;85;296;905;3202;990;3498
521520;201303;821;2012;741;1921;172;355;433;1272;605;1627
521523;201303;10702;40610;10101;39592;2647;11131;5637;22354;8284;33485
521525;201303;894;2434;804;2318;111;345;537;1514;648;1859
521530;201303;1793;5612;1321;4666;590;2195;225;759;815;2954
521540;201303;858;2610;684;2260;228;853;168;490;396;1343
521550;201303;637;1836;579;1747;205;678;261;761;466;1439
521560;201303;4868;15157;3897;13882;1675;6502;957;3248;2632;9750
521565;201303;578;1773;533;1716;91;317;396;1281;487;1598
521570;201303;3433;10551;3046;9962;1262;4315;1087;3634;2349;7949
521580;201303;564;1527;457;1377;167;529;180;571;347;1100
521590;201303;696;2038;610;1899;262;882;142;478;404;1360
521600;201303;606;1571;454;1330;106;341;203;574;309;915
521630;201303;1710;4795;1468;4408;616;2152;275;668;891;2820
521640;201303;1456;4552;1356;4399;544;1999;340;1120;884;3119
521645;201303;593;1938;533;1807;169;625;224;720;393;1345
521680;201303;1305;4431;1247;4299;795;2840;282;962;1077;3802
521690;201303;496;1562;461;1491;94;335;260;836;354;1171
521710;201303;1925;6246;1739;5886;376;1365;1048;3511;1424;4876
521720;201303;1945;5998;1793;5787;440;1459;1097;3618;1537;5077
521730;201303;3491;12201;3352;11924;1475;5697;1107;3724;2582;9421
521740;201303;3146;9108;2588;8392;1287;4287;859;2902;2146;7189
521760;201303;11143;39767;10640;39002;1739;7186;7570;27858;9309;35044
521770;201303;2632;8208;2288;7544;996;3511;550;1712;1546;5223
521800;201303;8045;24976;7115;23634;2708;9369;3300;11312;6008;20681
521805;201303;620;1654;619;1653;225;547;335;1028;560;1575
521810;201303;780;2394;707;2287;202;705;368;1210;570;1915
521830;201303;5255;18248;5004;17848;1086;4211;3397;12054;4483;16265
521839;201303;619;1953;530;1760;145;526;228;719;373;1245
521850;201303;5996;17810;5697;17459;1269;3758;3951;12598;5220;16356
521860;201303;1630;5168;1443;4767;436;1580;530;1664;966;3244
521870;201303;543;1936;511;1853;165;644;162;553;327;1197
521878;201303;375;1337;356;1305;152;616;90;297;242;913
521880;201303;21578;59924;15394;49691;5976;20640;4388;14345;10364;34985
521890;201303;3368;10874;2951;10057;1186;4290;715;2440;1901;6730
521900;201303;1589;4316;1333;3961;365;1223;597;1700;962;2923
521910;201303;1120;3298;996;3153;263;907;572;1836;835;2743
521920;201303;390;1270;382;1253;158;549;183;593;341;1142
521925;201303;534;1721;528;1709;77;271;431;1392;508;1663
521930;201303;4232;14110;3919;13468;1617;5906;1131;3833;2748;9739
521935;201303;659;2025;634;1976;165;553;385;1164;550;1717
521940;201303;1130;3099;948;2828;373;1179;322;966;695;2145
521945;201303;619;2223;583;2179;125;432;425;1658;550;2090
521950;201303;430;1490;406;1438;159;604;148;509;307;1113
521960;201303;892;2686;775;2484;201;699;400;1282;601;1981
521970;201303;2193;6606;2110;6483;369;1203;1508;4698;1877;5901
521971;201303;960;2790;827;2581;236;817;394;1184;630;2001
521973;201303;721;2579;676;2484;222;855;219;802;441;1657
521975;201303;12057;36787;11449;35997;2379;8183;7419;23405;9798;31588
521980;201303;1643;5495;1611;5456;289;929;1239;4343;1528;5272
521990;201303;979;3221;933;3132;197;724;560;1840;757;2564
522000;201303;1997;6098;1794;5839;391;1347;1101;3736;1492;5083
522005;201303;303;889;245;794;67;234;127;397;194;631
522010;201303;2728;8473;2423;7982;913;3303;737;2341;1650;5644
522015;201303;946;2921;810;2718;236;886;429;1428;665;2314
522020;201303;3933;11720;3556;11234;1025;3391;1920;6077;2945;9468
522026;201303;489;1615;421;1544;234;899;144;521;378;1420
522028;201303;503;1556;458;1482;126;440;256;808;382;1248
522040;201303;2809;7430;2035;6418;746;2549;786;2453;1532;5002
522045;201303;11736;40416;10444;37584;3587;14087;2369;8287;5956;22374
522050;201303;987;3002;840;2752;263;946;378;1198;641;2144
522060;201303;2494;8651;2402;8521;760;2865;1418;4987;2178;7852
522068;201303;1332;4599;1264;4519;125;391;1062;3940;1187;4331
522070;201303;802;2512;741;2414;141;553;465;1487;606;2040
522100;201303;793;2217;704;2078;263;888;326;889;589;1777
522108;201303;855;2577;788;2482;79;279;605;1945;684;2224
522119;201303;1386;4342;1230;4149;128;422;1022;3512;1150;3934
522130;201303;485;1424;418;1349;127;455;213;686;340;1141
522140;201303;15729;46374;14175;44428;4171;13923;7791;24540;11962;38463
522145;201303;903;2657;856;2581;478;1518;199;587;677;2105
522150;201303;1223;3284;1014;3022;339;1074;483;1516;822;2590
522155;201303;693;2165;637;2086;153;540;383;1276;536;1816
522157;201303;618;1928;576;1860;76;267;437;1416;513;1683
522160;201303;5267;15778;4173;14095;1959;7238;899;2875;2858;10113
522170;201303;3070;8663;2647;8108;644;1976;1471;4737;2115;6713
522180;201303;428;1307;345;1203;178;672;115;391;293;1063
522185;201303;13251;44123;12696;43379;2688;10023;8193;28128;10881;38151
522190;201303;644;1946;581;1802;116;380;354;1103;470;1483
522200;201303;1516;5210;1424;5014;544;2044;451;1557;995;3601
522205;201303;1404;4119;1210;3817;374;1186;568;1850;942;3036
522220;201303;942;3107;868;3006;224;815;478;1750;702;2565
522230;201303;696;2581;685;2562;167;632;455;1736;622;2368
530010;201303;240106;802930;217550;755929;68990;263145;69768;243623;138758;506768
110001;201302;4119;14074;3589;13235;1109;4215;1963;7369;3072;11584
110002;201302;11156;38455;10242;36784;3826;14479;4234;15469;8060;29948
110003;201302;1003;3343;942;3247;278;1010;501;1713;779;2723
110004;201302;8646;29764;7903;28231;2555;9924;3260;11666;5815;21590
110005;201302;2277;7961;2192;7798;795;2889;1027;3696;1822;6585
110006;201302;3417;9321;2209;7739;790;2916;844;2952;1634;5868
110007;201302;1391;4678;1286;4527;363;1311;754;2712;1117;4023
110008;201302;2355;8524;2224;8334;605;2202;1441;5616;2046;7818
110009;201302;4735;14321;3935;13270;831;2864;2688;9198;3519;12062
110010;201302;7924;23172;7161;22341;1139;2910;5397;18258;6536;21168
110011;201302;10278;32924;8681;30224;3549;13017;2991;10550;6540;23567
110012;201302;14966;48817;13750;46581;5256;18697;5698;19388;10954;38085
110013;201302;5027;16560;4271;15508;1262;4825;2230;8217;3492;13042
110014;201302;4082;12757;3496;11946;733;2564;2351;8176;3084;10740
110015;201302;4719;15874;4036;14726;1654;6355;1453;5311;3107;11666
110018;201302;4769;14686;3957;13651;1368;5143;1713;5716;3081;10859
110020;201302;46305;148418;42246;143213;9808;34092;26275;91621;36083;125713
110025;201302;4067;12607;3492;11523;613;2230;2496;8163;3109;10393
110026;201302;699;2215;596;2100;141;497;404;1450;545;1947
110028;201302;7177;21950;5585;19483;1675;6350;2197;7652;3872;14002
110029;201302;1600;4948;1297;4427;423;1471;617;2165;1040;3636
110030;201302;10733;31836;8881;29473;2754;9680;4463;15450;7217;25130
110032;201302;3970;13435;3667;12785;980;3616;1917;6694;2897;10310
110033;201302;4847;16036;4606;15700;1362;4578;2711;9732;4073;14310
110034;201302;3705;9810;3206;9250;411;1062;2660;7865;3071;8927
110037;201302;1999;7013;1809;6677;289;1066;1346;5042;1635;6108
110040;201302;3346;11490;3225;11260;1097;4053;1570;5510;2667;9563
110045;201302;4926;18051;4719;17782;1273;4970;2983;11379;4256;16349
110050;201302;1730;5841;1469;5510;502;1895;800;3080;1302;4975
110060;201302;988;3538;887;3348;208;781;546;2112;754;2893
110070;201302;1840;6550;1817;6495;293;1108;1375;4908;1668;6016
110080;201302;2635;9321;2588;9258;450;1528;2023;7431;2473;8959
110090;201302;929;2883;763;2617;245;929;297;964;542;1893
110092;201302;1602;5435;1461;5237;361;1291;861;3268;1222;4559
110094;201302;2586;9036;2441;8838;687;2584;1448;5293;2135;7877
110100;201302;2620;8725;2307;8234;596;2150;1430;5226;2026;7376
110110;201302;1591;5587;1499;5473;601;2261;713;2667;1314;4928
110120;201302;1556;5432;1415;5108;385;1446;629;2294;1014;3740
110130;201302;2700;8062;2168;7321;593;2126;1121;3803;1714;5929
110140;201302;2221;8053;2182;7981;554;2087;1357;4996;1911;7083
110143;201302;1472;5134;1240;4739;336;1343;705;2711;1041;4054
110145;201302;885;2899;810;2772;196;692;462;1598;658;2290
110146;201302;433;1446;389;1373;111;405;210;753;321;1158
110147;201302;859;2696;724;2507;215;811;349;1171;564;1982
110148;201302;1351;4166;1186;3884;305;1101;552;1776;857;2877
110149;201302;3328;10407;2813;9695;514;1846;2040;7151;2554;8997
110150;201302;2561;8143;2172;7587;479;1733;1425;5036;1904;6769
110155;201302;856;2985;833;2936;307;1123;376;1322;683;2445
110160;201302;2100;7028;1842;6664;341;1245;1326;4903;1667;6148
110170;201302;2740;8628;2382;8084;554;2004;1573;5324;2127;7328
110175;201302;1556;5301;1256;4930;111;468;996;3910;1107;4378
110180;201302;1650;5423;1467;5103;339;1225;912;3181;1251;4406
120001;201302;2592;9865;2540;9743;715;2858;1444;5656;2159;8514
120005;201302;1455;6319;1420;6257;168;652;1123;5190;1291;5842
120010;201302;3670;13900;3521;13626;706;2691;2295;9242;3001;11933
120013;201302;1594;6461;1572;6424;305;1199;1110;4739;1415;5938
120017;201302;1884;7020;1818;6902;494;1931;938;3849;1432;5780
120020;201302;13292;59082;13134;58714;2603;10971;9417;44031;12020;55002
120025;201302;2473;9030;2423;8951;662;2498;1418;5416;2080;7914
120030;201302;4927;21886;4902;21821;748;3036;3826;17682;4574;20718
120032;201302;1259;6286;1229;6224;171;984;925;4743;1096;5727
120033;201302;3471;13548;3445;13500;182;730;3108;12318;3290;13048
120034;201302;1781;7139;1779;7137;72;269;1655;6705;1727;6974
120035;201302;2246;11627;2231;11583;347;1623;1684;9288;2031;10911
120038;201302;3015;11532;2953;11407;813;3220;1710;6769;2523;9989
120039;201302;1332;7598;1312;7550;190;1110;1022;6010;1212;7120
120040;201302;40196;152144;38089;147364;12086;48166;19136;76405;31222;124571
120042;201302;2455;11263;2399;11131;225;1056;1995;9451;2220;10507
120043;201302;726;3627;718;3605;77;389;590;3021;667;3410
120045;201302;4135;15172;4115;15135;899;3228;2967;11226;3866;14454
120050;201302;7770;33081;7607;32709;1888;7871;4581;21129;6469;29000
120060;201302;4770;25006;4738;24939;765;3638;3611;20090;4376;23728
120070;201302;2471;9734;2439;9656;582;2160;1535;6451;2117;8611
120080;201302;3335;12916;3222;12741;612;2468;2260;9209;2872;11677
130002;201302;2511;11262;2369;11016;346;1632;1770;8403;2116;10035
130006;201302;1678;7531;1540;7277;163;843;1208;5768;1371;6611
130008;201302;1801;7652;1741;7536;224;1009;1298;5801;1522;6810
130010;201302;2712;9328;2364;8916;252;884;1950;7559;2202;8443
130014;201302;3104;10531;2727;9987;402;1611;1902;7013;2304;8624
130020;201302;2289;8350;2269;8325;76;292;2164;7943;2240;8235
130030;201302;5806;24289;5633;24049;567;2083;4718;20904;5285;22987
130040;201302;3273;10628;3138;10414;183;647;2761;9207;2944;9854
130050;201302;5335;22954;4757;21974;850;3777;3201;15834;4051;19611
130060;201302;5367;23233;5069;22825;586;2546;4111;19013;4697;21559
130063;201302;2743;12656;2722;12606;344;1594;2240;10548;2584;12142
130068;201302;2679;11852;2556;11589;355;1791;1902;8633;2257;10424
130070;201302;5899;21213;5620;20835;373;1470;4844;18216;5217;19686
130080;201302;4572;20864;4458;20681;797;3801;3183;15214;3980;19015
130083;201302;1646;7045;1587;6943;291;1297;1143;5073;1434;6370
130090;201302;2202;8380;2104;8243;191;843;1772;6949;1963;7792
130100;201302;4928;19999;4746;19743;522;2301;3840;16227;4362;18528
130110;201302;5861;19644;5494;19186;1193;3921;3719;13774;4912;17695
130115;201302;3402;13244;3258;13048;197;654;2964;12070;3161;12724
130120;201302;12170;47839;11936;47506;1184;4363;10124;41537;11308;45900
130130;201302;3254;14482;3164;14324;478;2122;2449;11367;2927;13489
130140;201302;5700;23067;5657;23011;153;464;5453;22440;5606;22904
130150;201302;3220;12689;3157;12602;337;1609;2588;10260;2925;11869
130160;201302;3752;15758;3702;15675;206;755;3404;14607;3610;15362
130165;201302;2694;11232;2660;11171;583;2489;1958;8308;2541;10797
130170;201302;7329;29346;6582;28416;1337;5564;4494;20519;5831;26083
130180;201302;3099;9985;3044;9895;172;494;2748;9041;2920;9535
130185;201302;7476;28668;7288;28385;1698;6354;4852;19824;6550;26178
130190;201302;15899;57781;14306;55715;3043;11304;9379;38902;12422;50206
130195;201302;1710;7127;1654;7041;116;522;1453;6232;1569;6754
130200;201302;1835;6883;1734;6702;283;1135;1211;4740;1494;5875
130210;201302;1049;4198;993;4094;188;732;708;3057;896;3789
130220;201302;1933;8109;1824;7953;236;1073;1403;6291;1639;7364
130230;201302;3279;15095;3147;14871;214;961;2748;13313;2962;14274
130240;201302;7712;30989;7178;30192;590;2777;5983;25565;6573;28342
130250;201302;16593;63381;16418;63108;2340;8315;13054;52024;15394;60339
130255;201302;3621;13825;3438;13508;252;1039;2976;11856;3228;12895
130260;201302;215947;717515;199277;693223;54062;187837;115580;420103;169642;607940
130270;201302;7277;30789;6638;29790;1101;4814;4771;22430;5872;27244
130280;201302;2765;11274;2707;11183;190;700;2381;10100;2571;10800
130290;201302;10101;38414;10054;38344;255;796;9515;36920;9770;37716
130300;201302;4101;16617;3911;16346;378;1644;3208;13640;3586;15284
130310;201302;4317;17683;4014;17295;602;2564;2996;13372;3598;15936
130320;201302;2446;8697;2245;8424;299;1128;1667;6440;1966;7568
130330;201302;3194;12482;2875;12025;293;1346;2351;9954;2644;11300
130340;201302;16662;65990;16292;65406;2614;9889;11921;50474;14535;60363
130350;201302;3148;12772;3019;12626;142;344;2822;12170;2964;12514
130353;201302;4359;15415;4001;14931;1208;4419;2159;8626;3367;13045
130356;201302;3220;12477;3137;12326;614;2407;2231;9085;2845;11492
130360;201302;2549;8184;2284;7869;74;241;2091;7383;2165;7624
130370;201302;4461;17832;3823;16996;346;1941;3063;13511;3409;15452
130380;201302;5891;25750;5732;25440;514;2455;4673;21012;5187;23467
130390;201302;4373;19424;4136;19034;479;2028;3393;16146;3872;18174
130395;201302;1846;7347;1739;7152;244;1183;1232;4992;1476;6175
130400;201302;1994;7474;1932;7378;110;446;1694;6564;1804;7010
130406;201302;8001;32626;7227;31273;1899;7966;4082;19016;5981;26982
130410;201302;3945;15269;3660;14726;908;3770;2029;8486;2937;12256
130420;201302;9148;40578;8903;40006;1214;5215;6905;31894;8119;37109
130423;201302;2709;11194;2620;11076;166;792;2320;9875;2486;10667
130426;201302;1774;7978;1713;7879;293;1237;1238;6056;1531;7293
130430;201302;3224;12133;3063;11904;380;1544;2281;9129;2661;10673
130440;201302;3423;13012;3151;12715;239;787;2748;11532;2987;12319
140002;201302;1295;4747;1258;4680;282;955;831;3322;1113;4277
140005;201302;2340;7681;2206;7533;133;443;1968;6815;2101;7258
140010;201302;40033;135229;36950;129955;7778;29075;23406;83879;31184;112954
140015;201302;2473;9165;2401;9073;179;573;2086;8127;2265;8700
140017;201302;2772;9444;2698;9347;201;691;2368;8318;2569;9009
140020;201302;3841;13663;3629;13366;477;1754;2769;10471;3246;12225
140023;201302;1798;6803;1743;6725;184;684;1461;5766;1645;6450
140028;201302;1989;5879;1928;5807;117;297;1719;5315;1836;5612
140030;201302;3282;11155;3185;11030;306;699;2768;10109;3074;10808
140040;201302;1430;7047;1375;6871;140;765;991;5076;1131;5841
140045;201302;2037;8174;2024;8153;189;586;1761;7382;1950;7968
140047;201302;4749;15060;4682;14980;667;1618;3800;12934;4467;14552
140050;201302;1447;4660;1383;4567;145;446;1139;3848;1284;4294
140060;201302;1191;4022;1133;3948;141;456;927;3317;1068;3773
140070;201302;1444;7117;1441;7111;59;239;1368;6827;1427;7066
150010;201302;28382;102775;27369;101360;2046;7654;23539;88743;25585;96397
150013;201302;1455;4783;1415;4736;136;472;1181;3984;1317;4456
150020;201302;9041;33702;8925;33515;807;3110;7607;28885;8414;31995
150030;201302;5705;25845;5567;25599;621;2415;4597;22112;5218;24527
150034;201302;4498;12456;4284;12203;151;374;4071;11716;4222;12090
150040;201302;11258;41724;10037;40147;1950;7119;6904;29539;8854;36658
150050;201302;5639;22121;5542;21943;748;3151;4340;17342;5088;20493
150060;201302;13012;45110;12468;44296;3485;12040;7289;27301;10774;39341
150070;201302;4970;21702;4595;21241;592;2600;3667;17477;4259;20077
150080;201302;55800;156594;49900;149152;5299;14136;39417;121403;44716;135539
150085;201302;4242;16257;4105;16055;660;2189;3170;13032;3830;15221
150090;201302;8770;36511;8380;35993;986;4129;6825;29959;7811;34088
150095;201302;4599;16953;4356;16569;547;2007;3478;13577;4025;15584
150100;201302;3217;12706;3050;12469;327;1494;2469;10063;2796;11557
150110;201302;3138;15282;3130;15263;128;537;2950;14539;3078;15076
150120;201302;5467;22473;5386;22304;500;1976;4571;19246;5071;21222
150125;201302;761;2473;704;2378;156;552;421;1431;577;1983
150130;201302;16235;56789;15833;56140;1968;6974;12654;45573;14622;52547
150140;201302;128055;403105;124038;398002;19829;64128;94972;308968;114801;373096
150145;201302;4489;15056;4192;14679;581;2103;3170;11305;3751;13408
150150;201302;7766;27569;7430;26991;1639;6174;4939;18166;6578;24340
150157;201302;2454;8534;2305;8320;350;1354;1784;6459;2134;7813
150160;201302;2408;8800;2343;8704;591;2106;1515;5866;2106;7972
150170;201302;20957;79040;20053;77973;2817;10661;16065;63446;18882;74107
150172;201302;2771;9947;2534;9603;308;1181;2082;8023;2390;9204
150175;201302;1842;6154;1784;6083;189;566;1510;5317;1699;5883
150178;201302;10208;33387;8970;31938;593;1836;8059;29372;8652;31208
150180;201302;15438;65661;15061;65143;1467;6732;12792;55811;14259;62543
150190;201302;6645;22047;6290;21536;445;1181;5452;19413;5897;20594
150195;201302;3916;15042;3704;14643;467;1820;2896;11656;3363;13476
150200;201302;3782;13923;3751;13881;129;446;3534;13183;3663;13629
150210;201302;21230;81816;21017;81521;1416;5256;18924;74213;20340;79469
150215;201302;4666;15927;4347;15453;1135;4138;2602;9471;3737;13609
150220;201302;11367;39237;10912;38466;2373;8572;6990;25071;9363;33643
150230;201302;10235;37344;9596;36420;789;3685;8174;30629;8963;34314
150240;201302;28688;94028;27029;91126;7160;25408;15356;52253;22516;77661
150250;201302;3209;12948;3134;12829;568;2072;2295;9963;2863;12035
150260;201302;1780;7828;1764;7797;258;1266;1322;5834;1580;7100
150270;201302;8890;28324;7119;26116;1545;5958;4606;17201;6151;23159
150275;201302;5073;20057;4919;19787;735;2961;3736;15334;4471;18295
150276;201302;1929;6137;1856;6042;251;874;1501;4902;1752;5776
150277;201302;4777;15448;4258;14849;531;1857;3460;12325;3991;14182
150280;201302;5545;24566;5457;24367;525;2309;4528;20586;5053;22895
150285;201302;2510;10312;2490;10271;187;776;2238;9296;2425;10072
150290;201302;7175;24778;7052;24599;948;3171;5558;19942;6506;23113
150293;201302;8248;27571;7491;26422;2535;8970;3689;13778;6224;22748
150295;201302;5615;20549;5128;19882;1255;5043;3193;12646;4448;17689
150300;201302;1637;5969;1611;5928;79;265;1455;5410;1534;5675
150304;201302;3677;12154;3284;11653;531;1890;2452;8879;2983;10769
150307;201302;6254;22623;5896;22103;415;1436;5009;19379;5424;20815
150309;201302;5686;22066;5456;21690;1615;6316;3280;13644;4895;19960
150310;201302;4798;22692;4735;22584;541;2409;3907;19206;4448;21615
150320;201302;7176;23543;7081;23423;520;1741;6264;20871;6784;22612
150330;201302;11867;46274;11504;45645;1336;5295;9317;37684;10653;42979
150340;201302;1882;7146;1812;7044;527;2085;1018;4109;1545;6194
150345;201302;5867;22010;5600;21640;670;2653;4579;17926;5249;20579
150350;201302;6711;23658;6476;23285;889;3342;4873;17707;5762;21049
150360;201302;18851;62764;16776;60195;2541;9176;12579;46628;15120;55804
150370;201302;9073;35936;8817;35569;1208;4516;7054;29488;8262;34004
150375;201302;2519;10887;2478;10832;245;795;2099;9707;2344;10502
150380;201302;8945;28832;8187;27788;965;3528;6789;23018;7754;26546
150390;201302;7321;32759;7115;32301;1630;7022;4508;21606;6138;28628
150400;201302;4975;21606;4851;21306;634;2672;3596;16317;4230;18989
150405;201302;7725;25231;7083;24403;1580;4959;4697;17279;6277;22238
150410;201302;1570;6282;1551;6249;225;958;1116;4582;1341;5540
150420;201302;28206;106675;26027;103148;7182;29249;14548;60359;21730;89608
150430;201302;5825;22962;5733;22793;805;3528;4432;17609;5237;21137
150440;201302;4946;18190;4875;18073;665;2489;3784;14270;4449;16759
150442;201302;20375;59760;18775;57764;3095;9641;13427;42568;16522;52209
150445;201302;4593;17310;4292;16869;688;2528;3268;13306;3956;15834
150450;201302;3957;19374;3842;19214;371;1825;3259;16619;3630;18444
150460;201302;6083;23855;5239;22975;344;1594;4731;20902;5075;22496
150470;201302;13616;47801;13337;47407;1761;5382;10885;40175;12646;45557
150480;201302;13187;47067;12933;46725;884;2927;11445;42206;12329;45133
150490;201302;5648;22580;5562;22470;352;1399;5025;20465;5377;21864
150495;201302;3980;15711;3899;15541;552;2385;3022;12055;3574;14440
150497;201302;3170;11374;2942;11008;753;2768;1821;7157;2574;9925
150500;201302;2777;8861;2679;8687;414;1426;1995;6446;2409;7872
150503;201302;3729;12092;3220;11429;1250;4621;1387;5145;2637;9766
150506;201302;11263;42297;10828;41703;2521;8333;7575;31306;10096;39639
150510;201302;8892;36661;8443;35882;1434;6101;6008;26557;7442;32658
150520;201302;5343;23489;5283;23386;414;1515;4686;21282;5100;22797
150530;201302;10295;39099;9509;37967;1272;4621;7299;30331;8571;34952
150540;201302;4199;14236;3933;13832;306;1227;3332;11643;3638;12870
150543;201302;4163;14055;3871;13630;1098;3929;2346;8491;3444;12420
150548;201302;7278;24710;6908;24224;842;2678;5616;20382;6458;23060
150549;201302;2098;6957;2019;6860;108;313;1836;6353;1944;6666
150550;201302;19372;64661;18086;62667;5040;18024;10140;35954;15180;53978
150553;201302;19633;75230;18126;71137;7470;30882;3756;15060;11226;45942
150555;201302;1483;4961;1316;4708;266;1046;853;3071;1119;4117
150560;201302;1932;6404;1891;6311;204;763;1492;4942;1696;5705
150563;201302;2724;9578;2596;9346;619;2333;1656;6008;2275;8341
150565;201302;3164;11888;3022;11673;265;1161;2486;9635;2751;10796
150570;201302;4635;18822;4584;18733;428;1747;3878;16171;4306;17918
150580;201302;8142;34145;8020;33921;792;2933;6847;29976;7639;32909
150590;201302;4844;20318;4742;20193;190;888;4380;18757;4570;19645
150600;201302;6695;27938;6609;27786;718;2693;5526;24030;6244;26723
150610;201302;2388;8406;2242;8104;293;1170;1583;5690;1876;6860
150611;201302;2437;9570;2365;9390;311;1313;1761;7080;2072;8393
150613;201302;10437;34247;9395;32732;3223;11376;4724;17267;7947;28643
150616;201302;2877;8557;2354;8000;611;2014;1537;5434;2148;7448
150618;201302;7112;25640;6881;25238;2333;8855;3401;12793;5734;21648
150619;201302;4735;17354;4490;16986;921;3460;2977;11621;3898;15081
150620;201302;5834;21809;5387;21226;796;3160;4087;16701;4883;19861
150630;201302;4769;16221;4565;15947;447;1598;3759;13293;4206;14891
150635;201302;4058;14171;3882;13822;866;3169;2431;8905;3297;12074
150640;201302;1350;4557;1337;4536;34;100;1271;4352;1305;4452
150650;201302;11096;36055;10295;34607;2802;9845;5630;19174;8432;29019
150655;201302;4892;17496;4564;17039;860;3221;3298;12577;4158;15798
150658;201302;3771;13084;3658;12910;316;1347;2993;10464;3309;11811
150660;201302;5397;17799;4988;17279;1425;4834;2900;10490;4325;15324
150670;201302;5414;17186;4793;16424;1745;6024;2477;8991;4222;15015
150680;201302;45427;189517;43769;186313;15246;63899;21418;97327;36664;161226
150690;201302;1765;5996;1667;5824;283;966;1093;3965;1376;4931
150700;201302;5182;17184;5059;17003;1011;3378;3530;12132;4541;15510
150710;201302;3486;11744;3398;11625;348;891;2924;10382;3272;11273
150715;201302;4306;15594;4097;15340;502;1810;3378;12975;3880;14785
150720;201302;5682;25052;5490;24706;790;3309;4165;19564;4955;22873
150730;201302;8262;30059;7821;29458;1205;4446;6184;23822;7389;28268
150740;201302;3284;11267;3140;10991;484;1805;2223;7865;2707;9670
150745;201302;5811;18915;5475;18465;730;2477;4305;14752;5035;17229
150746;201302;1278;4556;1230;4465;188;785;871;3145;1059;3930
150747;201302;4730;16211;4498;15913;423;1470;3743;13528;4166;14998
150750;201302;2337;8821;2331;8814;139;319;2169;8450;2308;8769
150760;201302;10618;35369;10331;34970;2229;7389;7089;24693;9318;32082
150770;201302;4953;20056;4820;19847;746;2769;3710;15908;4456;18677
150775;201302;1003;3378;928;3242;220;909;538;1798;758;2707
150780;201302;2899;10051;2878;10028;95;247;2713;9602;2808;9849
150790;201302;4551;14988;4333;14740;335;994;3767;13199;4102;14193
150795;201302;12986;42838;12195;41839;1930;6437;9296;32841;11226;39278
150796;201302;2488;8180;2459;8144;380;1165;1928;6592;2308;7757
150797;201302;3528;12194;3398;11986;219;795;2958;10555;3177;11350
150800;201302;12763;45204;11852;44064;2615;9100;8105;31728;10720;40828
150803;201302;6061;23573;5905;23343;822;3535;4576;18251;5398;21786
150805;201302;2529;9217;2373;8995;399;1415;1688;6681;2087;8096
150808;201302;5466;19347;4769;18054;2093;8177;1436;5829;3529;14006
150810;201302;17533;58085;15151;55182;2596;9280;10791;41189;13387;50469
150812;201302;4561;15194;4316;14915;384;1553;3531;12168;3915;13721
150815;201302;7560;25730;6952;25005;513;1526;6152;22819;6665;24345
150820;201302;9868;30120;9048;29228;370;752;8371;27731;8741;28483
150830;201302;11737;46761;11286;45971;935;3764;9172;38648;10107;42412
150835;201302;1957;7428;1835;7128;523;2140;899;3499;1422;5639
150840;201302;6068;18880;4974;17508;1503;5781;2663;9133;4166;14914
160005;201302;693;2729;660;2660;116;539;408;1634;524;2173
160010;201302;1439;5243;1430;5233;201;561;1161;4497;1362;5058
160015;201302;1498;5800;1468;5748;270;1002;1044;4328;1314;5330
160020;201302;2199;7403;2058;7211;296;1054;1550;5581;1846;6635
160021;201302;733;3414;710;3366;119;619;506;2451;625;3070
160023;201302;882;3453;874;3441;103;370;737;2972;840;3342
160025;201302;1160;3175;1130;3143;27;87;1084;3009;1111;3096
160027;201302;7179;25186;6889;24841;1387;5226;4850;17757;6237;22983
160030;201302;35640;137571;35095;136485;7914;29626;24482;98260;32396;127886
160040;201302;3036;13230;2983;13135;209;979;2640;11703;2849;12682
160050;201302;2906;11556;2649;11139;1017;3887;1196;5824;2213;9711
160053;201302;1765;7707;1750;7674;517;2170;1106;5115;1623;7285
160055;201302;760;3070;744;3047;143;625;525;2179;668;2804
160060;201302;17187;57384;16237;56322;3619;11901;11183;40720;14802;52621
160070;201302;1933;8695;1920;8673;181;753;1681;7753;1862;8506
160080;201302;2428;9897;2410;9867;160;560;2198;9168;2358;9728
170025;201302;553;1934;511;1871;189;726;239;899;428;1625
170030;201302;1078;3735;1021;3639;295;1080;557;2010;852;3090
170035;201302;1503;4704;1254;4223;454;1623;408;1408;862;3031
170040;201302;1638;5734;1498;5514;373;1513;838;3111;1211;4624
170070;201302;1985;5622;1653;5207;423;1444;918;2954;1341;4398
170100;201302;2406;6622;2171;6210;227;761;1777;5003;2004;5764
170105;201302;663;2315;593;2167;133;594;339;1186;472;1780
170110;201302;1129;3603;1014;3406;169;516;701;2443;870;2959
170130;201302;1290;4256;1167;4096;160;574;871;3160;1031;3734
170190;201302;1520;4756;1336;4504;443;1487;555;2061;998;3548
170200;201302;1403;4563;1131;4068;311;1247;357;1268;668;2515
170210;201302;23263;79554;21114;75534;9746;36870;5630;20910;15376;57780
170215;201302;1064;3614;979;3471;158;580;699;2523;857;3103
170220;201302;6042;20866;5606;20211;793;3017;4072;15091;4865;18108
170230;201302;1402;4988;1275;4760;374;1549;592;2163;966;3712
170240;201302;2874;8181;2389;7622;334;1213;1736;5580;2070;6793
170255;201302;3357;11078;2895;10292;1040;3626;1178;4513;2218;8139
170270;201302;1018;2694;752;2338;214;693;425;1344;639;2037
170290;201302;2751;8815;2426;8415;293;995;1948;6963;2241;7958
170300;201302;1951;6506;1751;6180;325;1238;1160;4145;1485;5383
170305;201302;652;2202;568;2035;119;459;359;1275;478;1734
170307;201302;1065;3813;938;3591;307;1188;357;1550;664;2738
170310;201302;1548;4407;1270;3960;278;914;682;2231;960;3145
170320;201302;867;2741;745;2520;163;575;456;1555;619;2130
170330;201302;738;2324;623;2205;105;299;482;1834;587;2133
170360;201302;439;1571;419;1538;97;378;203;735;300;1113
170370;201302;1352;4138;1151;3849;202;805;689;2282;891;3087
170380;201302;2037;6722;1730;6275;387;1605;969;3507;1356;5112
170382;201302;537;1947;513;1909;52;186;430;1627;482;1813
170384;201302;1236;5679;1209;5628;268;1289;843;3999;1111;5288
170386;201302;793;2498;660;2292;208;788;226;837;434;1625
170388;201302;608;1886;535;1769;129;515;235;756;364;1271
170389;201302;959;3437;905;3354;116;518;692;2530;808;3048
170390;201302;1230;3868;1077;3671;205;693;759;2672;964;3365
170410;201302;430;1520;417;1496;78;314;263;948;341;1262
170460;201302;395;1250;359;1187;106;376;131;437;237;813
170510;201302;770;2713;675;2570;131;568;406;1536;537;2104
170550;201302;5046;16525;4320;15203;1745;6511;1336;4899;3081;11410
170555;201302;1254;3834;1073;3561;283;1036;580;1939;863;2975
170560;201302;987;3443;854;3290;182;692;598;2409;780;3101
170600;201302;1290;3743;1158;3586;63;210;981;3092;1044;3302
170610;201302;1546;4769;1239;4282;213;827;709;2480;922;3307
170625;201302;384;1293;314;1140;105;408;80;305;185;713
170650;201302;1208;4071;1152;3972;274;1005;646;2280;920;3285
170700;201302;3703;12921;3192;12072;836;3467;1604;6299;2440;9766
170710;201302;1620;5017;1398;4692;198;788;983;3323;1181;4111
170720;201302;1760;4847;1593;4581;218;626;1281;3729;1499;4355
170730;201302;1116;3281;936;3017;289;1017;437;1411;726;2428
170740;201302;2099;7977;1976;7787;280;1230;1454;5769;1734;6999
170755;201302;877;2827;757;2576;216;795;312;1052;528;1847
170765;201302;1510;4202;1250;3783;331;1078;539;1679;870;2757
170770;201302;1757;6326;1655;6126;395;1519;947;3627;1342;5146
170820;201302;3988;13170;3642;12627;1015;3709;1730;6104;2745;9813
170825;201302;683;2216;553;1985;168;678;261;915;429;1593
170830;201302;1189;3833;1162;3791;55;145;1054;3478;1109;3623
170900;201302;2701;9925;2606;9726;332;1203;1999;7693;2331;8896
170930;201302;4145;12893;3415;11878;1391;5057;1166;4106;2557;9163
170950;201302;9344;30457;7716;27790;3928;15174;1631;5529;5559;20703
170980;201302;426;1392;370;1290;116;405;148;516;264;921
171050;201302;1173;4344;1136;4278;65;293;1016;3793;1081;4086
171070;201302;1569;5406;1488;5285;362;1343;902;3253;1264;4596
171090;201302;755;2496;710;2418;168;575;424;1489;592;2064
171110;201302;610;1904;521;1766;165;612;296;962;461;1574
171150;201302;828;2546;631;2171;135;504;355;1224;490;1728
171180;201302;568;1881;476;1682;111;423;234;851;345;1274
171190;201302;1835;6709;1593;6222;392;1599;778;3187;1170;4786
171195;201302;829;3087;765;2977;110;480;509;2038;619;2518
171200;201302;617;2100;521;1913;153;638;228;780;381;1418
171215;201302;427;1339;357;1222;70;268;187;641;257;909
171240;201302;869;2987;846;2949;74;165;734;2680;808;2845
171245;201302;653;2201;554;1966;118;449;286;1017;404;1466
171250;201302;1066;3204;971;3094;94;315;798;2568;892;2883
171270;201302;384;1616;362;1567;77;313;225;1020;302;1333
171280;201302;799;2626;746;2536;170;575;406;1483;576;2058
171320;201302;3645;11775;3208;11150;1142;4146;1516;5307;2658;9453
171330;201302;2609;8388;2400;8085;624;2207;1367;4694;1991;6901
171360;201302;1466;4969;1263;4675;350;1376;668;2516;1018;3892
171370;201302;653;1928;593;1829;143;533;327;952;470;1485
171380;201302;1177;4305;1097;4162;233;874;704;2760;937;3634
171395;201302;859;2804;746;2595;146;590;440;1514;586;2104
171420;201302;2186;6789;1826;6177;349;1339;1051;3538;1400;4877
171430;201302;979;3243;914;3147;225;775;564;1981;789;2756
171488;201302;2267;7320;2122;7096;564;1903;1167;4034;1731;5937
171500;201302;797;2596;715;2421;164;554;343;1188;507;1742
171510;201302;874;3289;803;3178;164;642;513;2145;677;2787
171515;201302;594;1830;486;1686;117;429;244;871;361;1300
171525;201302;559;1971;484;1816;97;405;260;962;357;1367
171550;201302;298;1073;272;997;131;538;36;132;167;670
171570;201302;1071;3623;967;3473;171;616;668;2457;839;3073
171575;201302;1848;5512;1533;4955;506;1689;599;2055;1105;3744
171610;201302;5779;20532;5420;19851;2013;7639;1903;7115;3916;14754
171620;201302;2054;7037;1960;6877;221;853;1548;5465;1769;6318
171630;201302;838;2909;704;2669;178;755;302;1139;480;1894
171650;201302;2193;7237;1889;6731;527;2055;891;3098;1418;5153
171660;201302;2478;7176;2081;6495;531;1722;1065;3430;1596;5152
171665;201302;1278;4189;1175;4007;242;909;738;2537;980;3446
171670;201302;2214;6133;1874;5703;467;1510;1163;3540;1630;5050
171700;201302;1048;3696;963;3557;174;708;630;2338;804;3046
171720;201302;639;2118;570;1980;164;643;300;1026;464;1669
171750;201302;1181;4032;1066;3799;394;1454;406;1489;800;2943
171780;201302;1093;3290;836;2924;145;561;525;1833;670;2394
171790;201302;1687;5570;1380;5124;314;1187;789;3081;1103;4268
171800;201302;676;2268;629;2201;95;377;433;1519;528;1896
171820;201302;9031;29419;8461;28732;1885;6872;5403;18591;7288;25463
171830;201302;1584;5957;1470;5697;347;1435;747;2945;1094;4380
171840;201302;712;2271;655;2191;95;343;469;1589;564;1932
171845;201302;746;2117;590;1842;78;297;366;1120;444;1417
171850;201302;1003;3773;928;3614;119;556;622;2420;741;2976
171855;201302;1184;3959;1087;3797;118;500;830;2851;948;3351
171865;201302;462;1552;395;1450;99;400;202;742;301;1142
171870;201302;628;2148;539;1993;129;509;279;1074;408;1583
171875;201302;1338;4398;1140;4096;196;763;787;2827;983;3590
171880;201302;986;3644;964;3607;129;499;745;2855;874;3354
171884;201302;786;2396;619;2146;126;481;277;999;403;1480
171886;201302;1394;4914;1292;4701;450;1765;495;1802;945;3567
171888;201302;587;1935;518;1812;104;369;321;1175;425;1544
171889;201302;471;1648;463;1632;77;230;327;1242;404;1472
171890;201302;1057;3707;983;3598;144;647;673;2410;817;3057
171900;201302;402;1622;388;1594;105;453;209;856;314;1309
172000;201302;598;1984;513;1861;96;421;300;1053;396;1474
172010;201302;1095;3888;1045;3795;91;362;840;3101;931;3463
172015;201302;337;1285;297;1222;57;242;177;767;234;1009
172020;201302;2227;7496;2019;7196;301;1205;1450;5200;1751;6405
172025;201302;645;2050;559;1891;95;356;347;1166;442;1522
172030;201302;1037;3654;959;3511;178;730;603;2232;781;2962
172049;201302;1013;3283;966;3217;138;479;709;2410;847;2889
172065;201302;989;3274;852;3098;164;645;601;2200;765;2845
172080;201302;2620;8218;2288;7664;346;1358;1531;5046;1877;6404
172085;201302;481;1399;391;1252;127;479;92;272;219;751
172090;201302;3261;10069;2588;9217;544;2085;1579;5761;2123;7846
172093;201302;544;1855;452;1690;188;787;175;646;363;1433
172097;201302;651;1975;566;1832;195;689;190;609;385;1298
172100;201302;23103;82983;21385;79466;7790;31233;6813;25534;14603;56767
172110;201302;1568;5941;1481;5811;172;688;1135;4570;1307;5258
172120;201302;5376;16630;4586;15643;471;1681;3642;12713;4113;14394
172125;201302;300;934;244;860;58;211;120;454;178;665
172130;201302;477;1485;442;1434;92;331;283;934;375;1265
172208;201302;2094;6798;2009;6666;500;1735;1151;3952;1651;5687
172210;201302;2250;6908;2167;6808;156;526;1910;6006;2066;6532
210005;201302;19915;68213;18515;65913;4703;17818;10956;39409;15659;57227
210010;201302;1546;5614;1405;5438;140;501;1145;4576;1285;5077
210015;201302;3207;10097;3011;9828;184;432;2631;8972;2815;9404
210020;201302;6658;18213;6269;17736;489;1575;5083;14625;5572;16200
210030;201302;5600;19397;5441;19164;480;2081;4538;15784;5018;17865
210040;201302;1937;5798;1781;5611;180;566;1433;4585;1613;5151
210043;201302;5408;17633;5212;17316;325;1180;4547;15190;4872;16370
210047;201302;6521;25953;6177;25320;946;4163;4244;17551;5190;21714
210050;201302;2373;8255;1986;7849;161;641;1685;6762;1846;7403
210055;201302;1565;5666;1501;5577;194;686;1184;4480;1378;5166
210060;201302;7741;28870;7085;27881;823;3577;5337;21392;6160;24969
210070;201302;6318;21027;6153;20839;287;1073;5662;19265;5949;20338
210080;201302;3343;11904;3286;11811;116;468;3045;10976;3161;11444
210083;201302;3207;12002;3160;11944;229;789;2811;10817;3040;11606
210087;201302;2207;7463;2153;7393;145;546;1955;6696;2100;7242
210090;201302;8947;30697;8761;30408;646;2299;7535;26391;8181;28690
210095;201302;6033;24268;5946;24098;656;2720;4917;20194;5573;22914
210100;201302;7208;22006;6954;21715;227;918;6401;19953;6628;20871
210110;201302;3006;10832;2928;10714;218;862;2465;9180;2683;10042
210120;201302;21616;71370;19624;68663;2141;7982;15268;54209;17409;62191
210125;201302;3097;10679;2993;10547;249;850;2599;9298;2848;10148
210130;201302;3408;10747;3358;10693;212;711;2975;9515;3187;10226
210135;201302;1438;4656;1342;4510;102;367;1140;3878;1242;4245
210140;201302;15777;53497;13819;50992;2890;10912;9224;35078;12114;45990
210150;201302;4171;11713;3994;11510;174;476;3672;10646;3846;11122
210160;201302;17290;59087;16335;57685;1821;6414;13222;47654;15043;54068
210170;201302;13557;51444;13364;51162;1047;3651;11669;45595;12716;49246
210173;201302;1678;7499;1642;7421;175;772;1372;6306;1547;7078
210177;201302;2695;9441;2577;9280;299;1179;2065;7414;2364;8593
210180;201302;1367;4481;1305;4374;140;478;1048;3542;1188;4020
210190;201302;4936;16639;4725;16288;404;1838;3737;12619;4141;14457
210193;201302;1372;4557;1311;4461;89;346;1107;3795;1196;4141
210197;201302;1595;6055;1545;5996;108;487;1366;5277;1474;5764
210200;201302;8488;30399;7994;29708;1149;4105;5962;23029;7111;27134
210203;201302;5775;20338;5447;19920;407;1303;4759;17822;5166;19125
210207;201302;2876;10041;2760;9843;350;1279;2128;7691;2478;8970
210210;201302;8210;28975;8008;28630;372;1438;6961;25211;7333;26649
210215;201302;1765;7190;1733;7144;158;707;1476;6118;1634;6825
210220;201302;5994;23939;5837;23677;474;1986;4844;20076;5318;22062
210230;201302;5116;18255;4809;17735;516;1929;3769;14140;4285;16069
210232;201302;10755;41344;10336;40667;2128;8268;7362;29774;9490;38042
210235;201302;3123;10398;2920;10126;215;782;2553;8890;2768;9672
210237;201302;2434;8876;2411;8841;52;135;2317;8606;2369;8741
210240;201302;2482;8719;2428;8628;199;754;2020;7204;2219;7958
210250;201302;4482;15501;4349;15334;165;629;4016;14268;4181;14897
210255;201302;2490;8458;2298;8139;605;2318;1319;4723;1924;7041
210260;201302;4818;16001;4511;15534;586;1972;3537;12380;4123;14352
210270;201302;4779;14628;4524;14298;190;660;4067;12997;4257;13657
210275;201302;3130;8635;2941;8428;105;289;2778;8007;2883;8296
210280;201302;5596;16964;5003;16217;383;1397;4273;13947;4656;15344
210290;201302;5730;18614;5347;18126;552;1834;4361;15087;4913;16921
210300;201302;33192;109435;29664;104733;3253;12368;24243;86430;27496;98798
210310;201302;2434;7743;2398;7690;165;550;2138;6882;2303;7432
210312;201302;1763;6483;1746;6450;143;577;1492;5551;1635;6128
210315;201302;1958;7570;1909;7507;77;309;1755;6990;1832;7299
210317;201302;4086;12627;4007;12534;165;496;3751;11806;3916;12302
210320;201302;16978;58847;16537;58225;789;3155;15137;53340;15926;56495
210325;201302;3131;10735;2940;10480;377;1450;2364;8467;2741;9917
210330;201302;29126;85804;25452;81728;3443;10174;19391;65951;22834;76125
210340;201302;11240;37009;10512;36112;1259;3901;8282;29712;9541;33613
210350;201302;9610;32360;9190;31778;864;3045;7569;26686;8433;29731
210355;201302;3841;14010;3544;13644;126;336;3298;13005;3424;13341
210360;201302;16222;51651;15392;50398;1450;5015;12371;41165;13821;46180
210370;201302;7426;22084;6895;21510;263;867;6384;20017;6647;20884
210375;201302;3118;9982;2781;9585;520;1947;2013;7006;2533;8953
210380;201302;5715;17752;5271;17008;350;1241;4466;14442;4816;15683
210390;201302;2494;9653;2418;9532;92;386;2244;8922;2336;9308
210400;201302;4393;15588;4252;15407;396;1346;3628;13421;4024;14767
210405;201302;8088;23517;6835;21825;1953;6268;3435;11884;5388;18152
210407;201302;1992;7103;1814;6825;199;701;1407;5558;1606;6259
210408;201302;1936;8135;1877;8062;78;317;1736;7580;1814;7897
210409;201302;3625;13703;3489;13491;271;1162;2833;11168;3104;12330
210410;201302;3080;11011;2886;10760;308;1079;2426;9227;2734;10306
210420;201302;3811;13496;3645;13209;362;1291;2992;11031;3354;12322
210430;201302;1818;5993;1796;5960;132;450;1586;5302;1718;5752
210440;201302;3912;13041;3820;12895;238;845;3325;11365;3563;12210
210450;201302;2557;8740;2427;8523;219;869;1983;6968;2202;7837
210455;201302;4012;12391;3451;11495;625;2139;2317;7946;2942;10085
210460;201302;4068;13453;3896;13241;203;727;3467;11936;3670;12663
210462;201302;1725;6413;1686;6341;187;734;1304;5016;1491;5750
210465;201302;2686;9031;2564;8873;314;933;2071;7460;2385;8393
210467;201302;5525;19999;5193;19512;808;3175;3853;14743;4661;17918
210470;201302;1608;5227;1491;5070;111;420;1213;4171;1324;4591
210480;201302;12441;44892;11423;43486;2680;10513;7379;28876;10059;39389
210490;201302;3064;9963;2898;9710;399;1417;2212;7457;2611;8874
210500;201302;6505;26027;6255;25583;731;2912;4857;20586;5588;23498
210510;201302;6237;21991;6158;21901;158;553;5744;20806;5902;21359
210515;201302;3412;11359;3371;11290;303;937;2904;9926;3207;10863
210520;201302;2501;8351;2383;8184;280;1001;1879;6567;2159;7568
210530;201302;37270;130245;33639;124572;11349;44373;17057;64433;28406;108806
210535;201302;2948;10941;2903;10857;145;607;2569;9663;2714;10270
210540;201302;11173;41747;10278;40266;2106;8215;6479;26857;8585;35072
210542;201302;6205;19131;5559;18410;288;865;4996;16897;5284;17762
210545;201302;2101;7407;2022;7283;92;402;1760;6363;1852;6765
210547;201302;3279;12617;3150;12423;211;905;2738;10888;2949;11793
210550;201302;5962;18074;5182;17193;290;861;4657;15793;4947;16654
210560;201302;3359;11878;3200;11638;266;1062;2689;9809;2955;10871
210565;201302;1465;5204;1330;5008;74;338;1098;4177;1172;4515
210570;201302;11564;36287;10659;35209;1064;3350;8911;30190;9975;33540
210580;201302;2491;8723;2247;8399;282;1084;1750;6673;2032;7757
210590;201302;4274;13905;4089;13676;269;920;3596;12203;3865;13123
210592;201302;2382;7779;2338;7710;122;476;2090;6854;2212;7330
210594;201302;2525;7713;2211;7342;135;471;1928;6473;2063;6944
210596;201302;2752;10767;2643;10560;338;1388;2007;8148;2345;9536
210598;201302;1928;6140;1861;6063;114;489;1705;5450;1819;5939
210600;201302;3187;9638;3020;9413;253;884;2525;7826;2778;8710
210610;201302;2516;8301;2289;8025;255;901;1877;6649;2132;7550
210620;201302;1671;5367;1567;5233;54;195;1457;4889;1511;5084
210630;201302;3155;12093;2795;11361;550;2222;1622;6914;2172;9136
210632;201302;4509;16253;4187;15793;505;1952;3272;12485;3777;14437
210635;201302;1818;6914;1799;6883;61;203;1680;6526;1741;6729
210637;201302;2573;9118;2486;8995;152;572;2216;8104;2368;8676
210640;201302;4079;13844;4035;13783;37;126;3920;13461;3957;13587
210650;201302;5880;19684;5814;19585;462;1581;5136;17428;5598;19009
210660;201302;7044;23413;6717;22902;279;894;6145;21064;6424;21958
210663;201302;2603;8049;2531;7971;71;221;2401;7651;2472;7872
210667;201302;1541;5998;1502;5944;122;520;1269;5084;1391;5604
210670;201302;4546;17694;4439;17503;420;1717;3592;14482;4012;16199
210675;201302;4662;13684;4548;13543;326;990;3907;11848;4233;12838
210680;201302;4161;12988;3811;12563;211;763;3366;11116;3577;11879
210690;201302;6270;22747;6082;22547;346;1358;5518;20535;5864;21893
210700;201302;2434;7201;2178;6898;148;367;1850;6207;1998;6574
210710;201302;4519;15459;4416;15299;164;508;4103;14370;4267;14878
210720;201302;2186;8698;2143;8638;167;694;1854;7531;2021;8225
210725;201302;1133;4272;992;4030;148;661;608;2493;756;3154
210730;201302;1119;3725;1026;3626;70;222;910;3268;980;3490
210735;201302;3464;13477;3358;13274;614;2429;2457;9947;3071;12376
210740;201302;4326;12381;4072;12123;193;420;3731;11421;3924;11841
210745;201302;3190;10722;3118;10610;251;989;2646;8928;2897;9917
210750;201302;19349;55905;17920;54236;1798;5609;14832;45345;16630;50954
210760;201302;5226;15002;5034;14796;91;280;4883;14371;4974;14651
210770;201302;5818;16422;5087;15597;226;647;4652;14404;4878;15051
210780;201302;8238;29285;7876;28620;990;3967;5927;21681;6917;25648
210790;201302;4394;13784;3906;13252;180;620;3542;12190;3722;12810
210800;201302;4422;14306;4083;13945;237;872;3507;12403;3744;13275
210805;201302;3518;15644;3473;15551;213;952;3038;13878;3251;14830
210810;201302;5292;17142;4827;16612;472;1346;4116;14620;4588;15966
210820;201302;8575;25597;8250;25168;1282;3890;6152;19247;7434;23137
210825;201302;5143;17719;5064;17624;199;717;4646;16320;4845;17037
210830;201302;7582;25806;7350;25552;235;641;7015;24661;7250;25302
210840;201302;3445;10080;3239;9745;300;829;2566;7792;2866;8621
210845;201302;5174;17233;5042;17068;242;793;4539;15625;4781;16418
210850;201302;5380;21228;5148;20789;1026;4562;3404;13799;4430;18361
210860;201302;15814;52659;15449;52117;1500;5326;12845;43455;14345;48781
210870;201302;5942;20477;5487;19847;769;2838;4027;14835;4796;17673
210880;201302;3651;12286;3621;12252;204;618;3298;11339;3502;11957
210890;201302;5199;16235;4921;15867;384;1430;4144;13248;4528;14678
210900;201302;4281;14718;4068;14333;1403;5031;1929;7076;3332;12107
210905;201302;1748;5653;1697;5589;97;250;1551;5222;1648;5472
210910;201302;10074;33255;9634;32579;2046;7245;6314;21681;8360;28926
210920;201302;3316;11418;3242;11319;174;518;2910;10384;3084;10902
210923;201302;1417;5582;1387;5523;213;882;1038;4215;1251;5097
210927;201302;4482;14583;4408;14509;45;122;4329;14305;4374;14427
210930;201302;2321;9179;2277;9106;202;924;1914;7680;2116;8604
210940;201302;2775;11466;2743;11401;320;1228;2226;9516;2546;10744
210945;201302;5617;16893;5448;16721;140;209;5252;16407;5392;16616
210950;201302;5066;17059;4557;16301;664;2397;3226;11930;3890;14327
210955;201302;1744;6128;1623;5906;285;1159;1097;3966;1382;5125
210960;201302;8574;29924;8360;29566;1683;5832;5992;21791;7675;27623
210970;201302;1259;4919;1154;4756;211;902;803;3371;1014;4273
210975;201302;1616;5976;1553;5848;149;634;1254;4726;1403;5360
210980;201302;8082;22029;7930;21851;281;814;7383;20366;7664;21180
210990;201302;14011;40732;11945;38506;758;2112;10673;35083;11431;37195
211000;201302;14673;50253;13617;48834;1425;5307;11027;40243;12452;45550
211003;201302;4988;18055;4671;17568;872;3429;3167;12155;4039;15584
211010;201302;6375;21489;6242;21308;175;607;5783;19911;5958;20518
211020;201302;7124;22393;7065;22319;282;596;6683;21472;6965;22068
211023;201302;2360;8405;2286;8278;159;592;1950;7162;2109;7754
211027;201302;2934;11748;2811;11545;302;1213;2270;9652;2572;10865
211030;201302;4038;12943;3717;12566;848;2375;2653;9547;3501;11922
211040;201302;4014;15569;3957;15477;115;478;3623;14358;3738;14836
211050;201302;9597;27246;9493;27127;546;1413;8744;25225;9290;26638
211060;201302;5168;20276;5087;20103;464;1644;4313;17512;4777;19156
211065;201302;1587;5732;1472;5570;93;373;1321;5024;1414;5397
211070;201302;8315;28880;8056;28434;850;3126;6426;23013;7276;26139
211080;201302;1292;4227;1085;3950;97;472;897;3203;994;3675
211085;201302;1899;6620;1676;6342;303;1085;1275;5014;1578;6099
211090;201302;3243;11056;3104;10853;253;998;2578;9004;2831;10002
211100;201302;6086;17648;5971;17501;174;617;5513;16162;5687;16779
211102;201302;2915;11323;2839;11213;310;1274;2344;9357;2654;10631
211105;201302;2654;8729;2467;8491;174;641;2157;7451;2331;8092
211107;201302;4195;13515;4029;13302;126;414;3747;12459;3873;12873
211110;201302;6063;19109;5045;17836;820;2793;3562;13260;4382;16053
211120;201302;28025;82584;25610;79237;2972;9029;20116;63629;23088;72658
211125;201302;1961;7003;1902;6897;130;513;1635;5967;1765;6480
211130;201302;137379;424616;131805;417536;23181;73012;97699;316021;120880;389033
211140;201302;5524;18645;5384;18420;323;1202;4702;16121;5025;17323
211150;201302;9083;30751;8942;30559;616;2021;7953;27574;8569;29595
211153;201302;3074;9504;2837;9221;258;703;2395;8071;2653;8774
211157;201302;1134;3985;1004;3794;132;603;738;2812;870;3415
211160;201302;3910;14149;3531;13500;441;1915;2700;10354;3141;12269
211163;201302;1540;5286;1481;5211;72;298;1347;4729;1419;5027
211167;201302;1355;4894;1269;4738;72;311;1094;4094;1166;4405
211170;201302;6233;18080;6082;17890;179;668;5657;16569;5836;17237
211172;201302;2139;6623;1934;6319;165;680;1553;4981;1718;5661
211174;201302;2724;8401;2545;8166;145;579;2206;7029;2351;7608
211176;201302;5429;16286;4677;15404;494;1410;3838;13096;4332;14506
211178;201302;2828;9630;2768;9565;69;207;2644;9228;2713;9435
211180;201302;4064;15270;3837;14903;424;1813;2982;11653;3406;13466
211190;201302;2638;9507;2437;9230;162;706;2126;8090;2288;8796
211195;201302;1376;4567;1228;4402;102;370;1014;3708;1116;4078
211200;201302;1954;7249;1784;6998;298;1105;1245;5204;1543;6309
211210;201302;6747;23041;6590;22774;518;1855;5609;19561;6127;21416
211220;201302;32955;103531;29381;98742;6672;23274;18338;63446;25010;86720
211223;201302;5660;16638;5328;16101;724;2225;3713;11804;4437;14029
211227;201302;1434;5730;1409;5686;173;823;1080;4328;1253;5151
211230;201302;8205;29688;7887;29092;1372;5110;5500;20725;6872;25835
211240;201302;8321;28666;8140;28446;384;1436;7494;26296;7878;27732
211245;201302;4825;15781;4750;15686;239;699;4332;14544;4571;15243
211250;201302;11109;43762;10668;43236;1295;4468;8809;37162;10104;41630
211260;201302;6320;24634;6259;24526;366;1276;5688;22637;6054;23913
211270;201302;9457;35033;9115;34571;671;2806;7637;29328;8308;32134
211280;201302;10690;33215;10619;33119;1099;2854;9107;29301;10206;32155
211285;201302;1913;7105;1701;6733;417;1661;957;4010;1374;5671
211290;201302;7564;25633;7447;25494;558;1578;6600;23146;7158;24724
211300;201302;7866;25499;7139;24383;738;2733;5656;19405;6394;22138
211400;201302;11577;35408;10981;34767;1996;6112;7680;26242;9676;32354
220005;201302;1724;5194;1665;5089;73;320;1446;4308;1519;4628
220010;201302;1683;4597;1285;4099;154;571;979;3079;1133;3650
220020;201302;3542;11218;3432;11014;615;2115;2323;7400;2938;9515
220025;201302;2009;5318;1932;5217;89;292;1728;4595;1817;4887
220027;201302;1278;3806;1221;3728;94;275;1042;3237;1136;3512
220030;201302;3157;10067;3102;9975;253;907;2654;8538;2907;9445
220040;201302;8143;25905;7855;25428;1454;5040;5220;16984;6674;22024
220045;201302;1395;4606;1291;4449;162;627;977;3351;1139;3978
220050;201302;4545;13512;4153;13007;376;1345;3467;10767;3843;12112
220060;201302;1885;5148;1797;5045;114;345;1592;4464;1706;4809
220070;201302;2501;7771;2260;7443;198;656;1850;6208;2048;6864
220080;201302;803;2569;759;2490;102;412;534;1690;636;2102
220090;201302;1626;4829;1481;4606;153;557;1150;3509;1303;4066
220095;201302;632;1917;613;1864;41;126;550;1667;591;1793
220100;201302;1373;4279;1217;4036;164;501;885;3046;1049;3547
220105;201302;2087;7274;2006;7129;208;798;1486;5292;1694;6090
220110;201302;3382;10175;3002;9629;296;1143;2429;7655;2725;8798
220115;201302;2068;7969;1996;7846;323;1300;1503;6005;1826;7305
220117;201302;1361;3742;1143;3417;98;334;890;2620;988;2954
220120;201302;11526;35275;10869;34435;472;1774;9757;30979;10229;32753
220130;201302;768;2920;684;2808;77;221;574;2484;651;2705
220140;201302;1471;4147;1446;4116;58;137;1369;3928;1427;4065
220150;201302;6621;22507;6461;22269;550;2147;5436;18739;5986;20886
220155;201302;1020;3304;890;3046;90;391;628;2090;718;2481
220157;201302;1009;2814;941;2714;49;133;821;2404;870;2537
220160;201302;2753;8581;2500;8142;284;1067;1891;6126;2175;7193
220170;201302;1176;4032;1142;3960;103;412;923;3196;1026;3608
220173;201302;2067;6415;1764;5831;107;461;1433;4686;1540;5147
220177;201302;1473;4749;1454;4718;125;418;1243;4065;1368;4483
220180;201302;1117;3178;1020;3038;94;336;793;2321;887;2657
220190;201302;4499;15082;3937;14360;459;1781;3047;11185;3506;12966
220191;201302;1313;4692;1270;4617;215;802;934;3422;1149;4224
220192;201302;1724;5235;1457;4785;188;595;1089;3656;1277;4251
220194;201302;1583;4874;1528;4784;148;539;1273;3925;1421;4464
220196;201302;1937;6116;1861;5995;208;767;1461;4690;1669;5457
220198;201302;1308;3614;1138;3386;54;179;1027;3067;1081;3246
220200;201302;4527;16119;4304;15750;764;3084;2937;10677;3701;13761
220202;201302;1913;6440;1797;6233;103;422;1549;5344;1652;5766
220205;201302;2624;7936;2350;7561;132;541;2033;6480;2165;7021
220207;201302;902;2821;813;2672;103;381;605;1988;708;2369
220208;201302;1446;5536;1376;5384;289;1230;864;3414;1153;4644
220209;201302;1530;4957;1423;4766;108;428;1096;3671;1204;4099
220210;201302;1830;4981;1615;4698;106;356;1288;3781;1394;4137
220211;201302;1510;4895;1440;4794;117;518;1163;3867;1280;4385
220213;201302;1741;5267;1637;5078;127;437;1291;3969;1418;4406
220217;201302;1750;5586;1709;5528;94;290;1527;4992;1621;5282
220220;201302;10881;33211;10384;32388;1448;4484;7607;24248;9055;28732
220225;201302;884;2961;870;2935;38;154;782;2635;820;2789
220230;201302;5561;15464;4571;14112;275;873;3995;12431;4270;13304
220240;201302;2583;8499;2500;8350;221;864;1977;6524;2198;7388
220245;201302;1274;3752;1230;3692;64;167;1107;3369;1171;3536
220250;201302;3191;8841;2941;8528;63;166;2776;8140;2839;8306
220253;201302;1796;5568;1575;5158;121;479;1177;3898;1298;4377
220255;201302;1638;5012;1473;4738;128;510;1163;3644;1291;4154
220260;201302;5090;16851;4746;16227;530;2095;3593;12212;4123;14307
220265;201302;1141;4311;1107;4256;112;529;876;3315;988;3844
220270;201302;5908;21843;5804;21657;465;2066;4917;18162;5382;20228
220271;201302;1310;4000;1284;3963;107;349;1091;3394;1198;3743
220272;201302;1731;5471;1629;5317;123;510;1282;4133;1405;4643
220273;201302;1191;3583;1095;3447;96;357;878;2747;974;3104
220275;201302;1936;5506;1702;5199;100;323;1450;4464;1550;4787
220277;201302;2436;6926;2104;6437;197;657;1562;4824;1759;5481
220280;201302;1724;4613;1517;4325;107;397;1230;3439;1337;3836
220285;201302;1569;4363;1475;4237;107;290;1235;3662;1342;3952
220290;201302;6348;20984;5399;19774;412;1511;4574;17067;4986;18578
220300;201302;1886;6248;1698;5998;86;382;1491;5272;1577;5654
220310;201302;2429;8094;2002;7579;105;365;1831;7024;1936;7389
220320;201302;3242;9880;2777;9140;401;1303;2029;6814;2430;8117
220323;201302;1389;5334;1295;5199;226;959;930;3747;1156;4706
220325;201302;1188;3872;1121;3757;157;544;762;2688;919;3232
220327;201302;1287;4306;1181;4119;100;452;958;3306;1058;3758
220330;201302;3499;10588;3400;10441;335;1142;2806;8660;3141;9802
220335;201302;1941;5844;1766;5613;124;478;1510;4763;1634;5241
220340;201302;1651;4960;1519;4784;176;624;1180;3687;1356;4311
220342;201302;1203;4070;1144;3985;122;482;869;3127;991;3609
220345;201302;2691;8019;2354;7455;66;240;2077;6538;2143;6778
220350;201302;4365;12087;3888;11448;332;1066;3086;9069;3418;10135
220360;201302;1355;3977;1089;3556;110;437;797;2579;907;3016
220370;201302;8694;25935;8150;25258;412;1210;7455;23261;7867;24471
220375;201302;1387;4573;1318;4476;100;394;1127;3794;1227;4188
220380;201302;1239;3666;1107;3477;88;307;828;2617;916;2924
220385;201302;596;1785;571;1738;51;181;474;1403;525;1584
220390;201302;10059;32751;9534;31765;2140;7620;5681;19065;7821;26685
220400;201302;1390;3477;1284;3333;62;211;1121;2848;1183;3059
220410;201302;1361;4068;1188;3838;112;484;942;2949;1054;3433
220415;201302;815;2306;744;2207;88;267;553;1657;641;1924
220420;201302;2123;6452;2056;6337;151;477;1756;5430;1907;5907
220430;201302;2820;8667;2694;8491;468;1542;1901;6000;2369;7542
220435;201302;1509;4648;1441;4569;76;240;1255;4021;1331;4261
220440;201302;2742;8341;2286;7829;153;414;2041;7146;2194;7560
220450;201302;2684;8108;2364;7690;500;1658;1553;5160;2053;6818
220455;201302;1331;4320;1194;4120;72;249;1062;3710;1134;3959
220460;201302;962;2813;916;2748;60;200;797;2374;857;2574
220465;201302;2372;8034;2236;7859;321;1201;1727;6135;2048;7336
220470;201302;3881;12166;3577;11612;270;1016;2825;9065;3095;10081
220480;201302;2157;6881;2031;6696;171;590;1687;5560;1858;6150
220490;201302;2236;6930;2167;6836;149;545;1882;5912;2031;6457
220500;201302;3330;9366;2949;8750;239;913;2386;6905;2625;7818
220510;201302;2819;8108;2214;7262;132;576;1784;5782;1916;6358
220515;201302;1778;4903;1587;4660;93;292;1332;3946;1425;4238
220520;201302;4670;13835;4449;13514;263;744;3888;11982;4151;12726
220525;201302;1405;4211;1335;4111;101;359;1130;3454;1231;3813
220527;201302;1344;4518;1326;4487;126;416;1134;3874;1260;4290
220530;201302;954;3072;930;3033;145;510;720;2330;865;2840
220535;201302;862;2859;839;2822;74;309;681;2267;755;2576
220540;201302;3417;11908;3317;11725;299;1185;2692;9576;2991;10761
220545;201302;1345;4852;1303;4778;209;863;901;3261;1110;4124
220550;201302;8446;29606;8110;28952;1482;5600;5582;20002;7064;25602
220551;201302;1296;4797;1260;4728;147;632;976;3635;1123;4267
220552;201302;1519;5041;1341;4749;167;742;963;3294;1130;4036
220553;201302;1577;4802;1402;4545;67;213;1221;3987;1288;4200
220554;201302;889;2526;785;2387;144;434;529;1641;673;2075
220555;201302;2285;7027;2177;6867;117;409;1835;5893;1952;6302
220556;201302;1401;4610;1287;4395;117;506;967;3254;1084;3760
220557;201302;1566;5381;1466;5182;177;770;1059;3690;1236;4460
220558;201302;976;3181;937;3117;90;335;757;2510;847;2845
220559;201302;1510;4405;1407;4254;87;303;1206;3629;1293;3932
220560;201302;1699;4366;1464;4036;84;258;1238;3396;1322;3654
220570;201302;7233;23553;6870;23114;640;1784;5865;20378;6505;22162
220580;201302;6171;21111;6002;20901;440;1516;5250;18551;5690;20067
220585;201302;1674;6746;1644;6689;106;446;1445;5923;1551;6369
220590;201302;1354;4445;1236;4269;212;774;852;2981;1064;3755
220595;201302;2324;6982;2178;6784;100;342;1951;6116;2051;6458
220600;201302;1201;3323;1081;3179;121;353;825;2459;946;2812
220605;201302;1945;6045;1767;5762;143;483;1370;4510;1513;4993
220610;201302;2598;8766;2527;8658;193;764;2120;7236;2313;8000
220620;201302;7552;26483;7365;26192;368;1605;6520;23079;6888;24684
220630;201302;366;1194;331;1135;90;332;178;618;268;950
220635;201302;1797;6725;1677;6435;188;842;1104;4254;1292;5096
220640;201302;2624;8161;2576;8068;244;912;2060;6389;2304;7301
220650;201302;2429;6919;2217;6599;124;420;1890;5613;2014;6033
220660;201302;2489;8710;2066;8193;153;611;1855;7419;2008;8030
220665;201302;1163;4125;1125;4071;64;254;995;3623;1059;3877
220667;201302;1709;5959;1624;5834;101;421;1387;4957;1488;5378
220669;201302;1812;6156;1700;5925;227;912;1227;4253;1454;5165
220670;201302;2049;6466;1991;6399;163;433;1741;5799;1904;6232
220672;201302;1998;6084;1956;6023;266;801;1565;4884;1831;5685
220675;201302;1233;3842;1169;3731;130;394;879;2845;1009;3239
220680;201302;2181;7449;2108;7345;116;463;1853;6469;1969;6932
220690;201302;1682;5009;1556;4796;132;497;1278;3878;1410;4375
220695;201302;805;2639;784;2600;66;239;608;2024;674;2263
220700;201302;8785;26598;8126;25611;793;2757;6466;20481;7259;23238
220710;201302;732;2226;662;2124;86;278;483;1558;569;1836
220720;201302;2046;5715;1948;5572;105;240;1730;5049;1835;5289
220730;201302;1261;3764;1164;3611;71;261;956;2963;1027;3224
220735;201302;1008;2769;892;2586;105;331;655;1916;760;2247
220740;201302;1238;4322;1099;4133;78;243;952;3686;1030;3929
220750;201302;3673;11664;3573;11510;326;1055;2956;9669;3282;10724
220755;201302;1145;3550;1120;3515;75;209;1003;3189;1078;3398
220760;201302;2505;9154;2339;8891;122;517;2030;7767;2152;8284
220770;201302;22308;79518;21156;77406;7272;27440;9616;36330;16888;63770
220775;201302;1032;2721;1024;2713;18;27;999;2669;1017;2696
220777;201302;1637;4865;1573;4770;136;426;1313;3967;1449;4393
220779;201302;1111;3569;1091;3534;72;290;959;3084;1031;3374
220780;201302;6123;16337;5618;15684;480;1235;4749;13521;5229;14756
220785;201302;1286;3614;1243;3523;67;200;1113;3127;1180;3327
220790;201302;8285;30524;8154;30256;685;2881;6849;25429;7534;28310
220793;201302;796;2539;760;2473;83;300;595;1937;678;2237
220795;201302;1308;4223;1270;4158;81;314;1079;3537;1160;3851
220800;201302;15958;47844;15189;46573;2133;7523;11363;34160;13496;41683
220810;201302;3016;9391;2710;8847;255;1023;2095;6734;2350;7757
220820;201302;5301;15866;4907;15360;394;1309;4095;12955;4489;14264
220830;201302;7408;21942;7173;21548;870;2623;5590;17051;6460;19674
220840;201302;13011;44805;12260;43275;3285;11933;5890;21439;9175;33372
220850;201302;2424;9607;2345;9481;400;1694;1709;7023;2109;8717
220855;201302;582;1931;541;1856;80;324;386;1307;466;1631
220860;201302;900;2651;848;2569;53;220;698;2065;751;2285
220865;201302;2584;7582;2227;7019;137;604;1803;5586;1940;6190
220870;201302;2213;7644;1940;7294;165;680;1606;6040;1771;6720
220880;201302;5205;14136;4793;13625;279;975;4172;11823;4451;12798
220885;201302;1311;4708;1171;4457;125;586;866;3302;991;3888
220887;201302;1157;3396;1065;3267;61;204;918;2832;979;3036
220890;201302;1556;5742;1416;5513;128;478;1172;4689;1300;5167
220900;201302;1776;5687;1610;5290;142;451;1292;4333;1434;4784
220910;201302;1703;5055;1539;4796;90;317;1322;4145;1412;4462
220915;201302;1024;3055;929;2902;65;278;754;2276;819;2554
220920;201302;1286;4955;1231;4875;121;552;958;3793;1079;4345
220930;201302;1337;4620;1190;4426;111;489;969;3580;1080;4069
220935;201302;1096;3532;1042;3419;107;466;768;2419;875;2885
220937;201302;1463;4231;1294;3942;87;324;1037;3107;1124;3431
220940;201302;1469;4639;1382;4449;102;378;1120;3615;1222;3993
220945;201302;460;1740;435;1656;60;259;321;1216;381;1475
220950;201302;1230;3219;930;2699;60;231;699;1952;759;2183
220955;201302;1495;4385;1276;4041;142;515;976;3057;1118;3572
220960;201302;757;2266;685;2142;80;321;509;1531;589;1852
220965;201302;1573;5035;1496;4926;82;339;1274;4187;1356;4526
220970;201302;2063;5786;1599;5031;212;666;1112;3585;1324;4251
220975;201302;462;1927;460;1922;63;232;383;1640;446;1872
220980;201302;1435;4439;1294;4183;136;522;883;2907;1019;3429
220985;201302;1327;3948;1277;3878;125;421;1017;3088;1142;3509
220987;201302;1418;4938;1352;4811;136;601;1023;3568;1159;4169
220990;201302;1767;5404;1614;5147;111;470;1289;4049;1400;4519
220995;201302;1128;3588;967;3308;80;339;787;2663;867;3002
220997;201302;2043;6615;1985;6528;167;558;1727;5683;1894;6241
221000;201302;3940;12990;3673;12502;440;1662;2746;9308;3186;10970
221005;201302;1341;4441;1284;4340;350;1134;755;2641;1105;3775
221010;201302;1209;3446;1081;3284;82;278;917;2796;999;3074
221020;201302;1866;6025;1779;5868;144;640;1387;4460;1531;5100
221030;201302;1809;5075;1599;4776;89;358;1313;3879;1402;4237
221035;201302;1427;4129;1304;3975;78;253;1139;3509;1217;3762
221037;201302;596;1915;572;1874;37;162;463;1455;500;1617
221038;201302;572;1729;483;1582;47;164;348;1151;395;1315
221039;201302;861;2777;837;2739;72;249;730;2384;802;2633
221040;201302;4967;15844;4790;15560;438;1595;3783;12363;4221;13958
221050;201302;3446;11360;3216;11016;254;1072;2697;9134;2951;10206
221060;201302;8735;24481;7658;23145;915;2777;6070;18623;6985;21400
221062;201302;1216;4477;1173;4425;39;110;1109;4230;1148;4340
221063;201302;1051;3544;1011;3482;264;863;653;2347;917;3210
221065;201302;2456;7895;2385;7760;227;843;1917;6159;2144;7002
221070;201302;4367;13798;4047;13319;313;1188;3260;10713;3573;11901
221080;201302;3013;9295;2838;9059;265;913;2290;7385;2555;8298
221090;201302;1290;3679;1169;3505;80;322;984;2884;1064;3206
221093;201302;1712;5295;1653;5187;247;915;1144;3493;1391;4408
221095;201302;887;2575;765;2405;51;118;648;2112;699;2230
221097;201302;761;2318;703;2226;67;261;539;1695;606;1956
221100;201302;117960;375518;113177;367419;25813;92614;72856;231244;98669;323858
221110;201302;9099;32754;8987;32581;727;2891;7633;27751;8360;30642
221120;201302;3902;13674;3805;13496;1174;3920;2230;8401;3404;12321
221130;201302;4444;13729;4038;12892;978;3270;2303;7265;3281;10535
221135;201302;1339;4499;1273;4381;200;767;884;3040;1084;3807
221140;201302;1357;3569;1264;3442;184;396;956;2722;1140;3118
221150;201302;1178;3183;1067;3000;49;183;856;2386;905;2569
221160;201302;889;2502;855;2448;58;199;675;1932;733;2131
221170;201302;1074;3662;1042;3594;87;359;862;2934;949;3293
230010;201302;3217;9209;2794;8523;195;673;2226;6875;2421;7548
230015;201302;3175;11187;2981;10765;600;2418;1826;6541;2426;8959
230020;201302;13461;47322;13010;46397;1545;5963;9848;35389;11393;41352
230030;201302;11641;36710;11267;36049;1268;4418;8814;28210;10082;32628
230040;201302;4406;13152;3836;12133;382;1380;2987;9405;3369;10785
230050;201302;2523;8864;2242;8187;430;1723;1257;4611;1687;6334
230060;201302;1880;5977;1719;5654;197;742;1269;4161;1466;4903
230070;201302;4578;12992;4120;12352;403;1281;3170;9713;3573;10994
230075;201302;8402;33163;8069;32485;1131;5076;5904;23951;7035;29027
230080;201302;2234;6588;1974;6210;152;581;1576;4920;1728;5501
230090;201302;3057;10170;2821;9724;396;1526;2042;6986;2438;8512
230100;201302;16109;53035;15269;51534;4760;16982;7503;25720;12263;42702
230110;201302;13491;46577;12711;44888;2571;9823;7856;27763;10427;37586
230120;201302;7285;21631;6756;20921;809;2841;5136;15866;5945;18707
230125;201302;2804;8613;2399;7856;219;865;1825;5934;2044;6799
230130;201302;6203;20733;5021;18256;508;2245;3492;12611;4000;14856
230140;201302;3175;11111;2906;10654;491;1856;1887;7117;2378;8973
230150;201302;1676;5622;1514;5291;283;1155;1008;3367;1291;4522
230160;201302;5781;18821;5177;17917;558;2168;3988;13813;4546;15981
230170;201302;6253;20980;5547;19674;583;2347;4000;14120;4583;16467
230180;201302;1846;5617;1686;5337;172;682;1191;3756;1363;4438
230185;201302;4025;14063;3766;13544;752;2749;2320;8602;3072;11351
230190;201302;12145;41301;11256;39541;2055;8258;6932;24135;8987;32393
230195;201302;4619;15112;4238;14522;394;1701;3291;10940;3685;12641
230200;201302;5356;16684;5031;16049;783;2639;3491;11163;4274;13802
230205;201302;4256;14237;3868;13570;458;1823;2808;9998;3266;11821
230210;201302;8897;26945;8121;25767;1972;6407;4742;15584;6714;21991
230220;201302;12999;40957;12220;39638;2239;8148;8149;26057;10388;34205
230230;201302;6774;24189;6171;22838;1033;4151;3839;14349;4872;18500
230240;201302;12607;39176;11672;37388;899;3557;9095;28620;9994;32177
230250;201302;10105;31764;9880;31420;589;2180;8506;27051;9095;29231
230260;201302;14445;51710;13546;49778;3277;12865;7111;26759;10388;39624
230270;201302;6822;21725;6190;20636;705;2641;4623;15501;5328;18142
230280;201302;19535;61611;18368;59730;2517;8952;13790;44857;16307;53809
230290;201302;4853;15784;4355;14773;603;2252;3017;10215;3620;12467
230300;201302;4427;14874;4282;14653;600;2251;3174;10938;3774;13189
230310;201302;4721;14671;4240;13864;415;1667;3248;10437;3663;12104
230320;201302;6937;23692;6660;23205;943;3679;4863;17031;5806;20710
230330;201302;4512;14164;4164;13466;439;1707;3124;9884;3563;11591
230340;201302;3239;11908;3100;11590;516;2248;2003;7300;2519;9548
230350;201302;17318;55868;15744;53071;3272;11815;9601;32799;12873;44614
230360;201302;2535;8239;2457;8093;259;1017;1973;6398;2232;7415
230365;201302;2748;8640;2447;8124;224;885;1812;5991;2036;6876
230370;201302;51245;179165;48416;174349;14963;55870;24805;92496;39768;148366
230380;201302;6870;20670;6016;19237;657;2485;4242;13492;4899;15977
230390;201302;3541;11674;3211;11128;457;1810;2206;7664;2663;9474
230393;201302;3208;11253;2880;10553;325;1554;2039;7249;2364;8803
230395;201302;4732;15828;4476;15317;663;2702;3124;10544;3787;13246
230400;201302;4966;16231;4440;15517;429;1925;3596;12327;4025;14252
230410;201302;15816;51887;14456;49479;2338;8790;9493;32497;11831;41287
230420;201302;23107;79969;22045;77841;5871;22554;11481;40459;17352;63013
230423;201302;4638;15910;4323;15359;560;2149;3042;10999;3602;13148
230425;201302;5025;18043;4827;17584;741;2941;3426;12492;4167;15433
230426;201302;2719;7933;2362;7305;172;693;1817;5504;1989;6197
230427;201302;1634;5295;1315;4575;183;705;882;3052;1065;3757
230428;201302;8558;29648;8392;29350;1901;7405;5368;18516;7269;25921
230430;201302;4423;14981;4256;14648;443;1854;3168;10751;3611;12605
230435;201302;4288;15429;3988;14927;1177;4707;1877;7368;3054;12075
230440;201302;343633;1115012;328199;1086905;88175;315283;169959;564403;258134;879686
230445;201302;4515;13100;3992;12370;437;1350;2958;9449;3395;10799
230450;201302;3444;11758;2983;10913;498;1974;1876;6985;2374;8959
230460;201302;1822;6406;1716;6196;186;697;1349;4948;1535;5645
230465;201302;3941;12922;3357;11815;410;1748;2260;7899;2670;9647
230470;201302;10323;40147;10046;39603;1531;6413;7165;28881;8696;35294
230480;201302;1401;4730;1298;4541;187;715;936;3275;1123;3990
230490;201302;2852;8672;2566;8155;450;1631;1471;4681;1921;6312
230495;201302;5528;19279;5086;18590;952;4115;3153;11513;4105;15628
230500;201302;10409;36657;10010;36026;912;3341;8007;29568;8919;32909
230510;201302;1447;5413;1302;5058;391;1586;596;2409;987;3995
230520;201302;4900;15541;4311;14481;506;1968;3007;10054;3513;12022
230523;201302;12615;44066;11866;42353;3882;15309;3747;13652;7629;28961
230526;201302;3855;12863;3465;12123;516;1979;2351;8373;2867;10352
230530;201302;4772;17057;4494;16662;550;2256;3490;12934;4040;15190
230533;201302;3677;11378;3495;11019;324;1211;2696;8419;3020;9630
230535;201302;5069;16039;4539;15029;554;1985;3279;10978;3833;12963
230540;201302;17763;54462;16272;52279;1347;4951;13323;42674;14670;47625
230550;201302;19821;62171;18416;59508;4488;15579;10234;33169;14722;48748
230560;201302;6456;19614;6064;18868;364;1480;4847;14935;5211;16415
230565;201302;3550;10687;3155;9941;304;1160;2288;7129;2592;8289
230570;201302;3741;10747;3410;10322;284;1052;2773;8285;3057;9337
230580;201302;9755;31809;9512;31472;594;2091;8335;27813;8929;29904
230590;201302;9225;30945;8761;30108;891;3783;6632;22369;7523;26152
230600;201302;3502;10342;2932;9174;328;1150;2010;6236;2338;7386
230610;201302;5797;20151;5493;19655;729;2899;4090;14682;4819;17581
230620;201302;1890;5696;1665;5245;177;650;1161;3626;1338;4276
230625;201302;7039;24658;6574;23575;1876;7366;2759;9814;4635;17180
230630;201302;10513;36281;9836;34838;1709;6100;6261;22746;7970;28846
230640;201302;23896;87976;23431;87019;4097;16201;16181;60706;20278;76907
230650;201302;4728;15860;4430;15277;437;1907;3375;11422;3812;13329
230655;201302;7829;31583;7625;31241;886;3619;6191;25876;7077;29495
230660;201302;6073;20041;5453;18881;636;2576;3910;13638;4546;16214
230670;201302;5717;16430;4803;14864;353;1299;3782;11585;4135;12884
230680;201302;2803;8763;2459;8155;466;1696;1475;4904;1941;6600
230690;201302;6785;22750;6315;21935;651;2802;4498;15297;5149;18099
230700;201302;8620;26580;7747;24995;920;3639;5256;16563;6176;20202
230710;201302;6886;24074;6539;23342;915;3390;4645;16938;5560;20328
230720;201302;1896;6170;1643;5682;252;928;1093;3813;1345;4741
230725;201302;3689;12636;3578;12405;542;2191;2606;8884;3148;11075
230730;201302;55108;174106;47817;163035;11882;44111;26866;93372;38748;137483
230740;201302;4763;16364;4708;16240;382;1675;3897;13238;4279;14913
230750;201302;8520;26151;7440;24356;797;3164;5550;18016;6347;21180
230760;201302;9304;30209;9103;29736;1384;5635;6606;20482;7990;26117
230763;201302;4018;13340;3858;13033;359;1615;3007;9827;3366;11442
230765;201302;41589;142640;39571;138418;13711;50634;15332;54847;29043;105481
230770;201302;21382;64778;20624;63717;1929;7573;16668;50750;18597;58323
230780;201302;5800;23934;5612;23514;1264;5356;3249;14342;4513;19698
230790;201302;2353;8645;2270;8517;294;1199;1793;6770;2087;7969
230800;201302;7652;28950;7164;27843;1736;7442;3722;14522;5458;21964
230810;201302;12039;40770;11649;40123;1457;5403;8915;31024;10372;36427
230820;201302;3158;11430;2912;10918;607;2461;1756;6758;2363;9219
230830;201302;7494;23843;6917;22814;755;2994;5032;16460;5787;19454
230835;201302;3969;11351;3468;10707;340;1108;2707;8434;3047;9542
230837;201302;3102;11022;2721;10234;427;1784;1753;6644;2180;8428
230840;201302;8896;31152;8289;30061;1515;5779;5267;19548;6782;25327
230850;201302;10999;35034;10482;34383;1346;4870;8041;26437;9387;31307
230860;201302;4936;15425;4546;14623;445;1722;3377;10688;3822;12410
230870;201302;18313;53747;16726;51009;2022;7041;12427;37635;14449;44676
230880;201302;1902;6890;1794;6673;313;1310;1166;4347;1479;5657
230890;201302;3974;15072;3731;14563;503;2344;2709;10434;3212;12778
230900;201302;2981;10293;2662;9623;436;1741;1634;5903;2070;7644
230910;201302;2862;9053;2413;8171;309;1233;1677;5576;1986;6809
230920;201302;4409;13636;4121;13261;378;1286;3311;10840;3689;12126
230930;201302;7409;23735;6902;22789;932;3311;4921;16341;5853;19652
230940;201302;7449;21687;6784;20808;321;974;6057;18840;6378;19814
230945;201302;6187;19868;5675;19149;753;2675;4106;13984;4859;16659
230950;201302;6634;19113;5892;18160;416;1494;4690;14467;5106;15961
230960;201302;11269;38223;10606;36834;2714;10397;5091;17654;7805;28051
230970;201302;12600;42754;11724;40981;2669;10665;6228;21387;8897;32052
230980;201302;2628;9275;2496;8990;672;2515;1357;4990;2029;7505
230990;201302;1511;5062;1316;4636;170;699;834;2886;1004;3585
231000;201302;2756;7804;2297;6928;256;929;1596;4696;1852;5625
231010;201302;2797;8709;2523;8291;340;1373;1810;5830;2150;7203
231020;201302;7808;26716;7427;25933;1404;5236;4755;16884;6159;22120
231025;201302;7339;24471;6766;23534;554;1966;5462;19382;6016;21348
231030;201302;7577;26267;6607;24211;1284;4991;4056;15039;5340;20030
231040;201302;2860;10064;2639;9582;327;1439;1815;6490;2142;7929
231050;201302;11318;35137;10410;33443;1125;4128;7637;24529;8762;28657
231060;201302;2347;7621;2183;7339;228;1014;1645;5357;1873;6371
231070;201302;8744;29356;8369;28630;1424;5233;5658;19519;7082;24752
231080;201302;4025;13512;3820;13083;342;1583;2834;9349;3176;10932
231085;201302;4456;15064;4311;14794;674;2576;3145;10807;3819;13383
231090;201302;4172;11976;3620;10898;303;1136;2747;8135;3050;9271
231095;201302;2109;7279;1882;6831;225;887;1337;4893;1562;5780
231100;201302;3132;9996;2715;9184;286;1109;1967;6629;2253;7738
231110;201302;3608;12581;3528;12440;406;1590;2633;9310;3039;10900
231120;201302;2360;8110;2220;7866;387;1435;1489;5313;1876;6748
231123;201302;2156;6306;1916;5933;170;591;1526;4733;1696;5324
231126;201302;6504;18820;5484;17430;500;1840;4301;13531;4801;15371
231130;201302;19442;64047;18131;61717;4779;17154;9688;33972;14467;51126
231135;201302;4463;13725;3859;12783;403;1573;2833;9231;3236;10804
231140;201302;14958;50524;14340;49344;1760;7994;10350;34220;12110;42214
231150;201302;5658;17470;4885;15930;1080;3904;2492;7990;3572;11894
231160;201302;5561;20010;5430;19719;1645;6151;2968;10852;4613;17003
231170;201302;4519;15186;4292;14745;557;2291;3016;10290;3573;12581
231180;201302;13340;43938;12753;42740;2741;10205;7741;25451;10482;35656
231190;201302;4603;14053;4133;13356;418;1527;3158;10199;3576;11726
231195;201302;4650;16410;4115;15391;437;1879;3147;11893;3584;13772
231200;201302;7337;26772;6800;25765;838;3778;4976;18789;5814;22567
231210;201302;4655;15676;4100;14891;382;1625;3096;11464;3478;13089
231220;201302;13646;40972;11776;37811;1366;5231;7685;24758;9051;29989
231230;201302;9088;33932;8620;32984;1338;5558;5996;23056;7334;28614
231240;201302;11265;37136;10341;35506;1437;5542;7031;24415;8468;29957
231250;201302;2057;6186;1418;4570;268;917;598;1798;866;2715
231260;201302;3983;11596;3661;11163;485;1560;2602;8142;3087;9702
231270;201302;7292;21971;6800;21235;796;3133;4938;15062;5734;18195
231280;201302;1674;5815;1623;5726;166;600;1295;4647;1461;5247
231290;201302;31373;116400;29355;111281;8329;34395;12560;46946;20889;81341
231300;201302;4293;13287;3678;11998;399;1676;2666;8374;3065;10050
231310;201302;7090;21875;6376;20453;1474;4932;3481;11274;4955;16206
231320;201302;6990;22469;6360;21283;545;2167;4921;16435;5466;18602
231325;201302;2522;8090;2315;7733;206;741;1823;6187;2029;6928
231330;201302;13631;44011;11660;40191;2086;7385;7210;25188;9296;32573
231335;201302;4734;14368;4355;13687;386;1486;3526;10886;3912;12372
231340;201302;16874;57769;16109;56657;1599;5427;13067;47250;14666;52677
231350;201302;11689;41683;11541;41446;1332;4666;9492;34732;10824;39398
231355;201302;4223;14113;4117;13948;291;973;3517;12096;3808;13069
231360;201302;6641;23021;6333;22550;1452;5163;3974;14671;5426;19834
231370;201302;2239;6752;1861;6201;154;639;1407;4586;1561;5225
231375;201302;4013;14276;3840;13938;491;2126;2858;10223;3349;12349
231380;201302;5124;17288;4867;16918;891;3334;3363;11867;4254;15201
231390;201302;3192;10689;3066;10522;222;868;2627;9100;2849;9968
231395;201302;4132;13792;3749;13192;803;2991;2348;8417;3151;11408
231400;201302;10017;31090;9277;29809;1135;4208;6581;21184;7716;25392
231410;201302;14498;49422;13261;47699;1484;5492;9940;36803;11424;42295
240010;201302;2266;7478;2131;7174;646;2419;930;3039;1576;5458
240020;201302;11280;36812;10317;34977;2972;10833;4804;16579;7776;27412
240030;201302;2701;8231;2610;8082;288;1109;1998;6032;2286;7141
240040;201302;741;2335;659;2184;85;365;455;1430;540;1795
240050;201302;3369;9772;3082;9286;287;1067;2311;6792;2598;7859
240060;201302;1337;4259;1292;4185;152;612;971;3052;1123;3664
240070;201302;2623;7829;2526;7636;313;1106;1822;5326;2135;6432
240080;201302;2879;8091;2724;7852;196;639;2288;6592;2484;7231
240090;201302;2091;6059;1834;5543;92;381;1408;4154;1500;4535
240100;201302;9812;30063;9226;28883;1266;4750;5868;18355;7134;23105
240110;201302;4860;15191;4539;14717;992;3631;2844;8929;3836;12560
240120;201302;2861;9762;2795;9638;579;2194;1797;6259;2376;8453
240130;201302;2596;7614;2276;7097;189;728;1801;5493;1990;6221
240140;201302;2175;7084;2042;6844;489;1867;1077;3535;1566;5402
240145;201302;5978;19031;5516;18258;1364;5000;3221;10681;4585;15681
240150;201302;991;3159;863;2909;146;610;480;1569;626;2179
240160;201302;1411;4916;1346;4799;170;682;966;3447;1136;4129
240165;201302;851;2884;781;2749;97;383;530;1886;627;2269
240170;201302;2514;7956;2305;7566;623;2142;1248;4192;1871;6334
240180;201302;2785;9187;2659;8989;669;2335;1525;5377;2194;7712
240185;201302;1497;5151;1457;5092;178;662;1135;3994;1313;4656
240190;201302;824;2668;807;2645;128;506;537;1710;665;2216
240200;201302;12978;36010;11319;33922;2094;6292;7644;23771;9738;30063
240210;201302;2615;7731;2448;7507;246;894;1992;6013;2238;6907
240220;201302;7152;23351;6977;23150;258;1008;6504;21541;6762;22549
240230;201302;5105;15501;4846;15020;545;1960;3683;11256;4228;13216
240240;201302;1659;5457;1365;4693;448;1656;348;1109;796;2765
240250;201302;2731;8170;2619;7995;223;842;2138;6389;2361;7231
240260;201302;14045;49093;13508;48194;2437;9908;8934;31873;11371;41781
240270;201302;2264;7853;2169;7693;277;992;1616;5849;1893;6841
240280;201302;1555;4679;1401;4398;170;631;982;3036;1152;3667
240290;201302;1408;4546;1228;4203;136;632;829;2719;965;3351
240300;201302;1915;5389;1662;4977;333;1114;963;2809;1296;3923
240310;201302;9944;29271;9260;28205;2220;7478;5116;15494;7336;22972
240320;201302;1998;6163;1737;5625;142;639;1193;3712;1335;4351
240325;201302;34006;98924;27977;88527;8281;28914;10563;33697;18844;62611
240330;201302;1496;4673;1301;4279;182;751;826;2594;1008;3345
240340;201302;1542;4836;1404;4657;312;1126;867;2876;1179;4002
240350;201302;1911;6354;1826;6199;337;1335;1318;4351;1655;5686
240360;201302;6663;21393;6011;20357;1061;3880;4040;14006;5101;17886
240370;201302;1856;5289;1683;5027;129;482;1306;3898;1435;4380
240375;201302;856;2351;776;2240;181;590;422;1176;603;1766
240380;201302;2493;7740;2210;7160;350;1178;1413;4589;1763;5767
240390;201302;874;2603;732;2319;82;335;469;1457;551;1792
240400;201302;1391;3931;1236;3713;133;501;944;2781;1077;3282
240410;201302;512;1710;458;1592;89;354;267;914;356;1268
240420;201302;4685;18244;4553;17949;1342;5325;2426;10103;3768;15428
240430;201302;3241;9864;3029;9482;434;1549;2114;6544;2548;8093
240440;201302;2532;7378;2391;7099;621;1832;1241;3821;1862;5653
240450;201302;3391;10757;3224;10466;620;2317;1907;6196;2527;8513
240460;201302;2724;9481;2661;9365;325;1315;2021;7117;2346;8432
240470;201302;3749;11670;3252;10694;907;3114;1585;5402;2492;8516
240480;201302;293;829;286;821;29;93;230;666;259;759
240485;201302;2033;6296;1822;5884;259;964;1175;3803;1434;4767
240490;201302;1562;4244;1445;4080;104;399;1159;3179;1263;3578
240500;201302;1873;6109;1838;6048;194;707;1443;4791;1637;5498
240510;201302;1685;5407;1575;5190;257;917;1066;3524;1323;4441
240520;201302;1401;4249;1245;4026;217;821;840;2656;1057;3477
240530;201302;2010;6925;1845;6637;292;1154;1238;4467;1530;5621
240540;201302;1792;5561;1715;5432;146;553;1317;4094;1463;4647
240550;201302;688;2147;668;2113;57;213;545;1699;602;1912
240560;201302;3088;9315;2969;9136;259;903;2437;7471;2696;8374
240570;201302;3008;8871;2520;7791;552;1937;1147;3301;1699;5238
240580;201302;7807;25016;7477;24507;1340;4552;5358;17606;6698;22158
240590;201302;810;2400;748;2297;60;236;536;1608;596;1844
240600;201302;1406;4364;1196;3910;227;834;650;2003;877;2837
240610;201302;4957;14248;4431;13300;477;1606;3164;9378;3641;10984
240615;201302;988;2942;875;2733;142;455;539;1700;681;2155
240620;201302;1486;5224;1429;5109;311;1186;973;3483;1284;4669
240630;201302;1961;6236;1888;6116;172;577;1480;4924;1652;5501
240640;201302;809;2577;713;2427;125;496;448;1506;573;2002
240650;201302;3617;11549;3415;11273;317;1223;2773;9108;3090;10331
240660;201302;2306;7909;2237;7803;250;983;1735;6104;1985;7087
240670;201302;2645;8212;2334;7578;395;1524;1406;4415;1801;5939
240680;201302;1394;4261;1167;3854;140;517;757;2497;897;3014
240690;201302;1058;3091;943;2909;110;409;679;2072;789;2481
240700;201302;2596;8096;2235;7400;187;813;1668;5357;1855;6170
240710;201302;16738;44606;15288;42850;2814;8000;9964;28813;12778;36813
240720;201302;5305;15967;5092;15635;1310;4491;2899;8831;4209;13322
240725;201302;1068;3231;839;2725;98;327;467;1499;565;1826
240730;201302;2227;7055;2023;6669;208;792;1438;4661;1646;5453
240740;201302;2216;6874;2039;6560;248;886;1440;4618;1688;5504
240750;201302;2071;7984;1939;7722;401;1708;1208;4867;1609;6575
240760;201302;1171;3628;1120;3547;106;323;905;2939;1011;3262
240770;201302;3360;10321;3103;9923;474;1696;2106;6749;2580;8445
240780;201302;5174;16043;4493;14890;1009;3456;2435;8478;3444;11934
240790;201302;812;2714;695;2500;71;294;513;1845;584;2139
240800;201302;37818;113967;35384;109624;10512;34997;16017;50265;26529;85262
240810;201302;90476;281686;86020;273263;29467;97294;38832;125845;68299;223139
240820;201302;6499;20209;5739;18964;922;3419;3539;12005;4461;15424
240830;201302;8642;27845;8312;27329;841;2901;6672;22373;7513;25274
240840;201302;1233;3597;1098;3350;101;375;712;2148;813;2523
240850;201302;1093;3509;853;3002;179;718;428;1429;607;2147
240860;201302;1278;3733;1123;3491;99;373;825;2509;924;2882
240870;201302;1082;3153;972;2952;127;511;679;1936;806;2447
240880;201302;1026;3736;999;3688;155;673;672;2484;827;3157
240890;201302;5280;15305;4833;14581;811;2793;2958;8828;3769;11621
240895;201302;2635;9319;2444;8980;378;1523;1713;6342;2091;7865
240910;201302;2426;8231;2311;8016;265;1098;1770;6102;2035;7200
240920;201302;819;2727;771;2607;188;727;424;1390;612;2117
240930;201302;3429;9707;3160;9329;317;1042;2488;7368;2805;8410
240933;201302;1318;4352;1223;4189;345;1188;615;2298;960;3486
240940;201302;6332;18645;5543;17305;1134;3827;3196;9967;4330;13794
240950;201302;1108;3592;1055;3504;102;423;778;2593;880;3016
240960;201302;717;2431;665;2316;110;410;467;1625;577;2035
240970;201302;1926;5791;1728;5405;153;637;1231;3793;1384;4430
240980;201302;3303;11145;3105;10759;757;2816;1788;6226;2545;9042
240990;201302;2964;9202;2815;8898;657;2334;1728;5288;2385;7622
241000;201302;1017;2992;912;2807;103;401;657;1970;760;2371
241010;201302;2826;9951;2577;9496;466;1931;1682;6130;2148;8061
241020;201302;2015;5879;1735;5356;175;672;1121;3288;1296;3960
241025;201302;1436;4580;1364;4463;163;676;964;3091;1127;3767
241030;201302;2394;8148;2219;7844;179;700;1790;6375;1969;7075
241040;201302;1976;7168;1845;6908;213;938;1401;5205;1614;6143
241050;201302;1241;3886;1153;3739;125;518;863;2711;988;3229
241060;201302;976;2880;900;2758;131;418;667;2065;798;2483
241070;201302;909;2720;792;2492;105;424;555;1668;660;2092
241080;201302;1123;3510;1023;3334;89;376;741;2357;830;2733
241090;201302;1913;5884;1762;5641;140;582;1469;4610;1609;5192
241100;201302;1131;3533;1052;3353;114;426;734;2309;848;2735
241105;201302;1062;3335;1010;3236;133;488;704;2279;837;2767
241110;201302;834;2771;724;2541;159;585;379;1346;538;1931
241120;201302;7900;24042;7269;23073;1370;4454;5030;16274;6400;20728
241140;201302;3159;9522;2896;8988;381;1402;1967;5934;2348;7336
241142;201302;688;2157;527;1812;161;624;186;611;347;1235
241150;201302;5352;17029;5086;16594;727;2596;3681;12025;4408;14621
241160;201302;1029;3191;1001;3147;140;460;743;2372;883;2832
241170;201302;1262;3927;1170;3750;181;670;731;2456;912;3126
241180;201302;945;2612;783;2376;103;395;534;1558;637;1953
241190;201302;1015;2900;938;2769;101;390;645;1802;746;2192
241200;201302;19163;60608;18143;58892;5049;17569;9475;31356;14524;48925
241210;201302;1434;4437;1267;4110;249;909;723;2333;972;3242
241220;201302;7846;27286;7532;26670;1853;7028;4217;15286;6070;22314
241230;201302;2863;9282;2675;9006;255;1038;2141;7170;2396;8208
241240;201302;1070;3194;868;2796;138;483;505;1645;643;2128
241250;201302;6087;19618;5531;18567;597;2470;4196;13942;4793;16412
241255;201302;1861;7282;1796;7146;415;1723;986;4085;1401;5808
241260;201302;4049;12271;3469;11218;720;2332;2023;6707;2743;9039
241270;201302;1933;6073;1764;5754;310;1169;1027;3400;1337;4569
241280;201302;2068;6188;1942;5936;392;1262;1191;3688;1583;4950
241290;201302;3139;8976;2582;8107;474;1654;1526;4739;2000;6393
241300;201302;1254;3909;1197;3827;113;425;952;3044;1065;3469
241310;201302;1458;4842;1418;4769;202;681;1063;3666;1265;4347
241320;201302;777;2691;759;2654;153;569;475;1687;628;2256
241330;201302;1387;4685;1317;4587;169;684;1032;3567;1201;4251
241335;201302;2327;7665;2291;7604;217;704;1922;6448;2139;7152
241340;201302;1785;5917;1672;5689;471;1746;848;2819;1319;4565
241350;201302;1856;6170;1771;5999;193;817;1351;4456;1544;5273
241355;201302;1189;3372;1123;3270;24;105;1064;3065;1088;3170
241360;201302;1981;5791;1844;5509;193;752;1365;3903;1558;4655
241370;201302;1299;4168;1090;3733;183;767;688;2279;871;3046
241380;201302;690;2095;605;1920;88;359;330;1007;418;1366
241390;201302;2719;9601;2599;9365;658;2329;1542;5857;2200;8186
241400;201302;3351;10742;3231;10561;496;1819;2357;7653;2853;9472
241410;201302;2550;7821;2378;7569;435;1528;1626;5124;2061;6652
241415;201302;1471;4816;1375;4614;169;658;953;3146;1122;3804
241420;201302;1795;6861;1673;6659;572;2462;775;3071;1347;5533
241430;201302;406;1272;390;1224;67;267;261;760;328;1027
241440;201302;6313;23240;5995;22665;1030;4063;4219;16167;5249;20230
241445;201302;987;3225;949;3167;166;480;705;2496;871;2976
241450;201302;3034;9057;2916;8851;505;1722;2049;6125;2554;7847
241460;201302;3228;9963;2900;9297;284;1104;2112;6682;2396;7786
241470;201302;1293;3861;1178;3716;116;453;941;2919;1057;3372
241475;201302;1156;3917;1075;3780;107;493;791;2724;898;3217
241480;201302;3137;10485;2908;10132;958;3406;1140;4348;2098;7754
241490;201302;589;1664;496;1506;59;241;340;964;399;1205
241500;201302;725;2454;713;2437;21;80;670;2289;691;2369
250010;201302;2550;8542;2292;8102;293;1248;1598;5519;1891;6767
250020;201302;1634;4867;1297;4243;130;555;907;2884;1037;3439
250030;201302;7370;22179;6673;21181;864;3003;4911;15862;5775;18865
250040;201302;4292;15082;4025;14575;792;3046;2609;9525;3401;12571
250050;201302;3508;11518;3261;11169;547;2087;2213;7612;2760;9699
250053;201302;1239;3918;1197;3862;179;649;849;2736;1028;3385
250057;201302;776;2523;757;2497;82;301;601;1997;683;2298
250060;201302;4487;15159;4372;14967;615;2469;3321;11136;3936;13605
250070;201302;4108;13058;3884;12657;507;2086;2952;9282;3459;11368
250073;201302;745;2324;685;2207;95;343;480;1556;575;1899
250077;201302;2177;6553;1864;6051;287;1010;1124;3675;1411;4685
250080;201302;4505;13892;4364;13689;580;1988;3338;10521;3918;12509
250090;201302;2536;7895;2477;7810;163;676;2090;6416;2253;7092
250100;201302;3836;13356;3687;13088;436;1764;2840;10036;3276;11800
250110;201302;5594;17709;5368;17382;909;3254;3914;12607;4823;15861
250115;201302;556;1857;488;1703;75;336;276;894;351;1230
250120;201302;2031;6407;1784;5950;248;970;1224;4013;1472;4983
250130;201302;5447;17687;5189;17322;410;1542;4348;14626;4758;16168
250135;201302;1030;3297;954;3164;110;380;695;2366;805;2746
250140;201302;1940;6615;1796;6428;258;905;1349;4978;1607;5883
250150;201302;5021;17535;4760;17076;600;2401;3572;12837;4172;15238
250153;201302;1548;4132;1406;3929;135;454;1123;3132;1258;3586
250157;201302;1525;5558;1397;5275;348;1333;758;2958;1106;4291
250160;201302;3208;10395;3088;10209;221;840;2648;8738;2869;9578
250170;201302;1563;4685;1475;4538;315;1025;922;2873;1237;3898
250180;201302;15217;50406;14891;49775;3151;11611;9521;31387;12672;42998
250190;201302;4186;12811;3985;12463;698;2417;2644;8255;3342;10672
250200;201302;2137;5974;1763;5517;146;524;1518;4710;1664;5234
250205;201302;986;3357;865;3143;103;466;589;2135;692;2601
250210;201302;1606;5422;1498;5268;198;876;1089;3732;1287;4608
250215;201302;1348;4791;1313;4726;236;964;826;2974;1062;3938
250220;201302;780;2384;669;2250;52;188;582;1960;634;2148
250230;201302;1648;4359;1358;3891;174;618;1028;2824;1202;3442
250240;201302;2542;8521;2278;8134;282;1071;1692;6141;1974;7212
250250;201302;3948;12852;3680;12468;576;2023;2711;9349;3287;11372
250260;201302;1889;5992;1692;5664;146;554;1302;4355;1448;4909
250270;201302;1171;3915;1113;3847;141;517;864;3014;1005;3531
250280;201302;3570;11229;3339;10861;688;2330;2138;7246;2826;9576
250290;201302;2079;5615;1733;5160;76;275;1491;4422;1567;4697
250300;201302;5271;16061;4987;15690;702;2730;3811;11623;4513;14353
250310;201302;1126;3740;1039;3595;165;670;749;2561;914;3231
250320;201302;7418;24502;7089;23775;1419;5317;4369;14295;5788;19612
250330;201302;2412;7935;2122;7520;318;1269;1551;5449;1869;6718
250340;201302;1073;3287;1040;3247;84;292;839;2666;923;2958
250350;201302;4445;12478;4128;12070;195;700;3605;10626;3800;11326
250355;201302;2059;6599;1894;6342;152;636;1482;4947;1634;5583
250360;201302;1991;6069;1852;5863;129;492;1433;4549;1562;5041
250370;201302;12935;37962;11473;36152;821;2603;9933;31655;10754;34258
250375;201302;1042;3419;1005;3348;84;342;815;2706;899;3048
250380;201302;1565;4576;1503;4503;88;328;1326;3943;1414;4271
250390;201302;1916;5260;1598;4719;215;718;1074;3157;1289;3875
250400;201302;55219;169810;52737;165915;14991;48403;28304;92260;43295;140663
250403;201302;1238;4746;1213;4703;230;992;865;3329;1095;4321
250407;201302;1034;3230;948;3084;115;391;735;2399;850;2790
250410;201302;648;2153;573;2020;77;333;417;1443;494;1776
250415;201302;1744;5730;1646;5530;115;490;1261;4164;1376;4654
250420;201302;1256;4124;1205;4029;102;430;1014;3316;1116;3746
250430;201302;6378;18302;6072;17859;527;1904;5022;14446;5549;16350
250435;201302;1556;4895;1401;4588;217;819;797;2700;1014;3519
250440;201302;4168;13374;4063;13202;354;1275;3349;10939;3703;12214
250450;201302;2025;5842;1828;5579;79;276;1632;4976;1711;5252
250460;201302;5302;17653;5012;17222;924;3348;3368;11796;4292;15144
250470;201302;1519;4285;1402;4114;127;472;1094;3152;1221;3624
250480;201302;3653;11429;3308;10918;203;825;2829;9266;3032;10091
250485;201302;563;1565;475;1401;28;119;370;1040;398;1159
250490;201302;4025;13517;3927;13361;588;2236;2948;10002;3536;12238
250500;201302;1859;5827;1729;5618;363;1211;1018;3352;1381;4563
250510;201302;4897;14127;4350;13372;379;1425;3580;10884;3959;12309
250520;201302;1815;5878;1740;5748;385;1486;1083;3490;1468;4976
250523;201302;1765;5753;1689;5653;206;746;1340;4529;1546;5275
250527;201302;1354;4391;1280;4281;68;318;1124;3692;1192;4010
250530;201302;671;2106;595;2007;55;217;478;1607;533;1824
250535;201302;1195;4051;1171;4002;110;470;933;3134;1043;3604
250540;201302;2401;7353;2270;7205;106;363;2060;6560;2166;6923
250550;201302;895;3037;831;2935;74;334;625;2159;699;2493
250560;201302;1676;5642;1656;5611;148;574;1397;4728;1545;5302
250570;201302;2399;8416;2267;8168;250;1047;1752;6251;2002;7298
250580;201302;1029;3122;890;2889;129;494;591;1867;720;2361
250590;201302;1029;3214;931;3082;86;362;732;2372;818;2734
250600;201302;7456;23194;7100;22633;1219;3944;5002;16373;6221;20317
250610;201302;3212;10137;3057;9896;399;1424;2244;7285;2643;8709
250620;201302;870;2592;809;2473;143;472;545;1662;688;2134
250625;201302;1998;6947;1965;6898;97;332;1790;6342;1887;6674
250630;201302;9506;32324;9088;31529;2143;8194;5243;18036;7386;26230
250640;201302;3820;11469;3581;11183;272;1057;3083;9486;3355;10543
250650;201302;890;2723;842;2627;173;636;437;1407;610;2043
250660;201302;2144;5232;1644;4626;24;68;1579;4441;1603;4509
250670;201302;2472;8896;2374;8714;298;1287;1677;6169;1975;7456
250680;201302;4626;14146;4398;13799;345;1302;3626;11321;3971;12623
250690;201302;5880;17126;5709;16883;626;2204;4691;13573;5317;15777
250700;201302;5099;16131;4856;15746;643;2410;3607;11520;4250;13930
250710;201302;4310;14357;4026;13997;606;2268;2908;10258;3514;12526
250720;201302;2496;8322;2390;8127;238;909;1861;6383;2099;7292
250730;201302;3414;11259;3293;11067;480;1823;2430;8127;2910;9950
250740;201302;1993;6127;1765;5709;315;1133;1131;3594;1446;4727
250750;201302;95426;298203;91573;292092;18521;65157;60326;190422;78847;255579
250760;201302;2016;6480;1892;6263;314;1218;1222;4004;1536;5222
250770;201302;3659;13034;3520;12827;818;3093;2149;8004;2967;11097
250780;201302;1863;5756;1665;5387;185;751;1171;3688;1356;4439
250790;201302;2404;8020;2280;7831;585;2025;1423;4984;2008;7009
250800;201302;2629;8138;2350;7655;164;682;1812;5775;1976;6457
250810;201302;1312;4016;1152;3781;106;450;951;3053;1057;3503
250820;201302;1904;6257;1853;6176;111;409;1555;5281;1666;5690
250830;201302;5593;19560;5400;19178;893;3731;3736;13069;4629;16800
250840;201302;1019;3364;931;3186;156;605;586;2019;742;2624
250850;201302;2302;6968;2037;6534;260;1002;1315;4397;1575;5399
250855;201302;948;2942;897;2860;81;294;757;2400;838;2694
250860;201302;2759;9654;2606;9362;667;2666;1192;4304;1859;6970
250870;201302;1167;3482;1023;3238;98;387;739;2275;837;2662
250880;201302;1231;3846;1215;3822;123;441;977;3036;1100;3477
250890;201302;8508;29473;8006;28795;1636;6512;5338;19214;6974;25726
250900;201302;2992;10335;2709;9786;327;1279;1927;7064;2254;8343
250905;201302;2061;6554;1982;6444;303;1088;1503;4850;1806;5938
250910;201302;5065;15701;4760;15227;727;2399;3459;11226;4186;13625
250915;201302;1698;5211;1565;5012;134;438;1317;4263;1451;4701
250920;201302;3411;10153;3232;9903;415;1341;2428;7590;2843;8931
250930;201302;1814;6161;1753;6052;376;1493;1146;3857;1522;5350
250933;201302;1117;3907;1081;3843;199;751;710;2591;909;3342
250937;201302;853;2756;776;2596;139;555;464;1547;603;2102
250939;201302;1688;5489;1556;5281;322;1138;1030;3531;1352;4669
250940;201302;3845;11846;3587;11453;288;1050;2923;9365;3211;10415
250950;201302;1247;4090;1173;4002;77;259;994;3459;1071;3718
250960;201302;1334;4272;1189;4082;84;325;1009;3487;1093;3812
250970;201302;8410;23959;7727;23089;981;2952;5925;18027;6906;20979
250980;201302;2578;8156;2418;7896;355;1428;1651;5201;2006;6629
250990;201302;2058;7533;1968;7353;345;1455;1359;5038;1704;6493
251000;201302;2497;7261;2072;6668;141;549;1647;5272;1788;5821
251010;201302;2728;8155;2512;7861;183;687;2054;6438;2237;7125
251020;201302;1644;5362;1547;5247;179;666;1253;4287;1432;4953
251030;201302;1282;3714;1174;3531;147;521;746;2233;893;2754
251040;201302;1932;6395;1758;6123;227;1034;1283;4324;1510;5358
251050;201302;1112;3401;980;3157;195;691;538;1798;733;2489
251060;201302;948;2528;787;2326;133;476;540;1525;673;2001
251065;201302;547;1715;479;1611;78;296;276;906;354;1202
251070;201302;551;1648;527;1613;48;194;417;1213;465;1407
251080;201302;20619;58783;19687;57299;4987;15354;11723;34510;16710;49864
251090;201302;2980;9652;2715;9176;338;1319;1937;6467;2275;7786
251100;201302;926;3155;823;2962;127;528;511;1791;638;2319
251110;201302;2056;6123;1911;5920;239;840;1402;4358;1641;5198
251120;201302;5865;20097;5716;19841;812;3359;4469;15155;5281;18514
251130;201302;3748;10008;3415;9620;70;248;3253;9117;3323;9365
251140;201302;4298;13570;4067;13211;298;1195;3219;10408;3517;11603
251150;201302;2826;9332;2618;9049;317;1287;1989;6918;2306;8205
251160;201302;1840;6180;1770;6087;105;408;1550;5352;1655;5760
251170;201302;1417;4611;1387;4579;90;312;1238;4105;1328;4417
251180;201302;2879;8842;2662;8574;558;1871;1712;5671;2270;7542
251190;201302;4032;12367;3925;12225;313;1106;3401;10569;3714;11675
251200;201302;4069;12697;3884;12450;309;1112;3261;10469;3570;11581
251203;201302;1305;4280;1187;4028;131;552;711;2512;842;3064
251207;201302;1202;3929;1054;3633;107;452;742;2522;849;2974
251210;201302;7349;22642;6837;22023;901;2900;5415;17762;6316;20662
251220;201302;1247;3541;1125;3352;189;617;699;2139;888;2756
251230;201302;5041;15859;4480;15186;479;1809;3726;12586;4205;14395
251240;201302;3011;10214;2942;10098;344;1449;2281;7670;2625;9119
251250;201302;9563;30270;9037;29403;1737;6281;6151;19696;7888;25977
251260;201302;520;1665;474;1602;44;165;361;1229;405;1394
251270;201302;3938;12497;3726;12227;173;696;3400;11121;3573;11817
251272;201302;1292;4145;1205;4016;133;487;926;3128;1059;3615
251274;201302;914;3081;880;3012;140;607;474;1662;614;2269
251275;201302;1335;3911;1265;3802;162;597;942;2762;1104;3359
251276;201302;1353;4260;1297;4155;254;873;754;2556;1008;3429
251278;201302;582;1919;514;1756;89;348;285;1021;374;1369
251280;201302;2198;7269;2130;7143;321;1186;1521;5120;1842;6306
251290;201302;5892;17329;5603;16955;867;3152;4022;11754;4889;14906
251300;201302;741;2629;700;2565;84;391;501;1778;585;2169
251310;201302;3097;9486;2864;9143;258;960;2287;7239;2545;8199
251315;201302;1525;5761;1495;5697;329;1311;941;3671;1270;4982
251320;201302;2072;6004;1795;5575;140;504;1395;4396;1535;4900
251330;201302;2003;5334;1677;4908;152;642;1361;3774;1513;4416
251335;201302;952;3353;933;3318;104;436;754;2640;858;3076
251340;201302;3919;11165;3371;10353;410;1560;2385;7169;2795;8729
251350;201302;1615;5114;1466;4895;272;996;940;3164;1212;4160
251360;201302;1797;6084;1740;6008;127;500;1471;5112;1598;5612
251365;201302;901;2701;736;2351;90;367;468;1438;558;1805
251370;201302;20456;73482;20209;73001;4428;17473;13611;48667;18039;66140
251380;201302;1231;4053;1134;3887;156;614;800;2697;956;3311
251385;201302;836;2442;775;2340;84;314;543;1602;627;1916
251390;201302;5533;20161;5295;19812;1031;4209;3611;13403;4642;17612
251392;201302;989;3057;920;2936;163;569;566;1841;729;2410
251394;201302;609;1924;522;1751;51;215;365;1209;416;1424
251396;201302;870;2539;821;2463;48;164;704;2102;752;2266
251398;201302;1119;3306;937;2965;116;444;636;1984;752;2428
251400;201302;1327;3967;1248;3862;184;723;879;2636;1063;3359
251410;201302;1532;4257;1404;4049;198;638;925;2752;1123;3390
251420;201302;2188;6567;1902;6248;177;710;1547;5011;1724;5721
251430;201302;1649;6078;1507;5854;140;645;1212;4688;1352;5333
251440;201302;1447;4557;1270;4235;190;715;898;2970;1088;3685
251445;201302;1445;4782;1382;4686;155;627;1107;3689;1262;4316
251450;201302;4662;14997;4222;14447;166;663;3838;13172;4004;13835
251455;201302;1189;3768;1045;3548;93;398;805;2700;898;3098
251460;201302;869;2733;848;2691;164;533;617;1986;781;2519
251465;201302;512;1654;471;1570;61;256;314;1017;375;1273
251470;201302;1193;3577;1009;3247;165;626;607;1949;772;2575
251480;201302;1093;3094;1006;2957;78;296;803;2317;881;2613
251490;201302;2074;6332;1826;6009;361;1359;1135;3656;1496;5015
251500;201302;1593;5678;1545;5595;249;1053;1118;3973;1367;5026
251510;201302;2371;8369;2293;8200;538;2084;1356;4890;1894;6974
251520;201302;1075;3046;997;2928;142;454;628;1877;770;2331
251530;201302;10465;33958;10278;33674;1144;4292;8424;27311;9568;31603
251540;201302;2701;9303;2556;8981;326;1358;1836;6413;2162;7771
251550;201302;3904;10066;3359;9381;224;808;2802;7671;3026;8479
251560;201302;916;2849;846;2744;174;672;513;1591;687;2263
251570;201302;1015;3126;933;2986;139;531;595;1947;734;2478
251580;201302;2140;6049;2001;5864;171;501;1682;4970;1853;5471
251590;201302;1708;5772;1677;5736;120;436;1466;5062;1586;5498
251593;201302;960;3160;915;3084;131;504;618;2026;749;2530
251597;201302;1927;6108;1871;6018;249;941;1424;4505;1673;5446
251600;201302;6947;21730;6664;21269;1140;3710;4598;15187;5738;18897
251610;201302;3469;10806;3213;10464;402;1426;2385;7846;2787;9272
251615;201302;1196;3615;1062;3374;118;365;750;2528;868;2893
251620;201302;16006;48485;14778;46765;2274;7708;10741;34183;13015;41891
251630;201302;5161;13494;4544;12745;421;1303;3608;10184;4029;11487
251640;201302;2629;7891;2159;7035;289;1106;1447;4659;1736;5765
251650;201302;4256;12421;3843;11891;387;1370;3065;9583;3452;10953
251660;201302;3504;11981;3229;11551;284;1347;2599;9062;2883;10409
251670;201302;3516;10990;3178;10461;285;1079;2487;8152;2772;9231
251675;201302;729;2540;700;2490;138;578;443;1527;581;2105
251680;201302;2811;8006;2298;7234;160;686;1863;5733;2023;6419
251690;201302;3221;10792;3035;10463;468;1738;2032;7073;2500;8811
251700;201302;2039;7056;1966;6951;266;1017;1513;5358;1779;6375
251710;201302;831;2385;668;2074;100;395;378;1080;478;1475
251720;201302;1315;4193;1248;4093;125;497;956;3112;1081;3609
251740;201302;723;2075;587;1827;108;380;333;1048;441;1428
260005;201302;23560;59829;21201;56782;4241;11643;13845;37549;18086;49192
260010;201302;9149;25891;7617;23999;676;2424;6201;19467;6877;21891
260020;201302;5443;17090;4930;16308;668;2022;3546;12448;4214;14470
260030;201302;5304;16579;4973;16148;514;1812;4022;13096;4536;14908
260040;201302;9049;23799;8344;23027;500;1147;7434;21062;7934;22209
260050;201302;10148;34338;9666;33784;674;2563;8455;29719;9129;32282
260060;201302;3985;11345;3754;11006;331;1040;3078;9122;3409;10162
260070;201302;8834;28035;8549;27635;2329;8052;5068;16528;7397;24580
260080;201302;5053;15565;4572;14821;578;2236;3199;10229;3777;12465
260090;201302;5065;14001;4831;13691;744;1932;3765;11016;4509;12948
260100;201302;3335;9277;3093;8950;298;1084;2421;7036;2719;8120
260105;201302;4036;12950;3944;12792;687;2425;2800;9053;3487;11478
260110;201302;20413;63754;19181;62248;1665;5394;16260;53427;17925;58821
260120;201302;10822;34788;10590;34367;2922;9662;5816;19580;8738;29242
260130;201302;2942;8806;2818;8604;400;1190;2054;6469;2454;7659
260140;201302;11156;32725;10336;31597;1386;4715;7807;24000;9193;28715
260150;201302;2675;8905;2434;8516;182;758;1932;6873;2114;7631
260160;201302;5773;17995;5346;17507;533;1813;4390;14700;4923;16513
260170;201302;16850;48286;16228;47443;1475;4102;13436;39985;14911;44087
260180;201302;3312;10790;3077;10413;227;942;2571;8644;2798;9586
260190;201302;15236;38325;14587;37481;1285;3529;12118;31168;13403;34697
260200;201302;10517;32736;9359;30962;1243;4331;6615;22529;7858;26860
260210;201302;11015;35335;10343;34387;830;3146;8558;28705;9388;31851
260220;201302;8859;28867;8706;28632;748;3072;7457;24120;8205;27192
260230;201302;9413;28600;9103;28176;733;2421;7575;23733;8308;26154
260240;201302;2761;9110;2503;8702;385;1436;1682;5879;2067;7315
260250;201302;2715;7565;2516;7316;180;504;2135;6309;2315;6813
260260;201302;10888;33199;10722;32984;946;3141;8977;28279;9923;31420
260270;201302;3452;11064;3296;10843;440;1737;2540;8212;2980;9949
260280;201302;11825;42079;11046;40835;933;3765;9019;33811;9952;37576
260290;201302;32642;101458;31800;100119;5930;21233;22049;67975;27979;89208
260300;201302;8118;25760;7371;24710;843;3085;5636;19151;6479;22236
260310;201302;4999;15551;4723;15112;1357;4110;2526;8645;3883;12755
260320;201302;6263;22614;5906;22109;577;2174;4721;18109;5298;20283
260330;201302;3054;9866;2812;9442;324;1269;1871;6550;2195;7819
260340;201302;1781;5538;1710;5449;116;430;1503;4758;1619;5188
260345;201302;24640;84485;23895;83015;7789;29220;11123;37769;18912;66989
260350;201302;4086;12681;3938;12453;654;2207;2659;8528;3313;10735
260360;201302;2263;7463;2208;7372;605;2110;1261;4367;1866;6477
260370;201302;5888;18774;5528;18142;864;2860;3860;13026;4724;15886
260380;201302;4794;16392;4529;16049;418;1316;3838;13934;4256;15250
260390;201302;4673;15132;4111;14268;509;1991;3058;10509;3567;12500
260392;201302;2775;10495;2669;10330;215;854;2279;8946;2494;9800
260400;201302;12921;39909;12572;39368;2212;7923;8972;27497;11184;35420
260410;201302;58973;180417;56811;176908;17208;53723;30383;98238;47591;151961
260415;201302;3890;13301;3534;12644;562;2350;2291;8197;2853;10547
260420;201302;10650;27336;9835;26461;1064;3108;7741;20961;8805;24069
260430;201302;2626;9031;2435;8736;278;1194;1888;6668;2166;7862
260440;201302;3306;10530;3117;10169;537;1990;1976;6382;2513;8372
260450;201302;4709;15388;4489;15003;563;2031;3356;11328;3919;13359
260460;201302;5686;18401;5476;18101;776;2898;4108;13421;4884;16319
260470;201302;4858;14722;4609;14380;427;1479;3692;11699;4119;13178
260480;201302;3648;11082;3402;10730;648;2178;2346;7392;2994;9570
260490;201302;5983;16043;5329;15015;773;2560;3512;9911;4285;12471
260500;201302;6501;18431;6130;17908;622;1998;4755;14134;5377;16132
260510;201302;9622;27872;8915;26875;1083;3522;6563;20565;7646;24087
260515;201302;4702;15212;3963;13710;592;2218;2385;8540;2977;10758
260520;201302;14737;42044;14532;41775;2191;5963;11394;33364;13585;39327
260530;201302;9959;30190;8928;28838;548;1698;7804;25663;8352;27361
260540;201302;5461;15170;5290;14971;677;1663;4197;12314;4874;13977
260545;201302;40;156;28;115;4;19;6;23;10;42
260550;201302;2671;9347;2447;8967;728;2942;1197;4334;1925;7276
260560;201302;6433;17070;5875;16291;348;955;5173;14410;5521;15365
260570;201302;5757;21669;5533;21247;1110;4618;3676;14263;4786;18881
260580;201302;3808;10813;3654;10579;301;1034;3067;8698;3368;9732
260590;201302;5882;15899;5748;15731;508;1287;4878;13691;5386;14978
260600;201302;22566;75505;21824;74212;5986;20748;11867;42054;17853;62802
260610;201302;6917;21052;6640;20684;1330;4266;4611;14622;5941;18888
260620;201302;16576;53461;16087;52654;2892;10992;11194;35568;14086;46560
260630;201302;2196;6900;1937;6490;254;1026;1411;4668;1665;5694
260640;201302;16592;47056;15980;46159;1796;5464;12645;36690;14441;42154
260650;201302;5546;18227;5376;17951;875;2923;3528;12669;4403;15592
260660;201302;7568;23430;6899;22523;634;2209;5587;18524;6221;20733
260670;201302;2258;6805;1958;6397;311;1151;1286;4240;1597;5391
260680;201302;22480;61764;21557;60374;4448;13181;13762;38520;18210;51701
260690;201302;3346;9769;2964;9169;346;1245;2212;6786;2558;8031
260700;201302;4803;15667;4752;15613;116;294;4541;15136;4657;15430
260710;201302;1279;4098;1166;3929;156;625;858;2839;1014;3464
260720;201302;17181;57324;16385;55842;4801;16897;8676;30228;13477;47125
260730;201302;7258;24667;6591;23708;906;3391;4933;18048;5839;21439
260740;201302;1316;4115;1161;3835;213;809;686;2270;899;3079
260750;201302;6345;21944;6239;21765;527;1893;5288;18697;5815;20590
260760;201302;4307;12893;4108;12619;531;1800;3074;9406;3605;11206
260765;201302;7355;28527;7148;28199;1828;7503;4243;17266;6071;24769
260770;201302;4148;11270;3824;10837;243;912;3098;8604;3341;9516
260775;201302;5218;15773;5015;15460;572;2076;3822;11598;4394;13674
260780;201302;3797;13291;3686;13099;782;3112;2329;8227;3111;11339
260790;201302;114316;303388;110739;298275;27042;76268;67563;183104;94605;259372
260795;201302;2872;9896;2746;9702;415;1595;1984;7140;2399;8735
260800;201302;4444;12795;4183;12425;269;1060;3549;10306;3818;11366
260805;201302;3891;12070;3613;11633;602;2044;2454;8023;3056;10067
260810;201302;7325;22100;7146;21847;530;1948;6172;18674;6702;20622
260820;201302;4496;13793;4329;13546;1222;3928;2517;7995;3739;11923
260825;201302;2969;9870;2841;9683;266;881;2370;8209;2636;9090
260830;201302;3555;11973;3348;11618;883;2909;1982;7249;2865;10158
260840;201302;4030;12233;3808;11902;235;905;3339;10388;3574;11293
260845;201302;3940;12186;3680;11659;598;2070;2519;7999;3117;10069
260850;201302;4777;17342;4417;16554;1224;4998;2145;8073;3369;13071
260860;201302;2853;9872;2689;9612;353;1276;2014;7352;2367;8628
260870;201302;4130;11946;3834;11586;512;1422;2958;9258;3470;10680
260875;201302;7088;19051;6611;18326;709;1934;4934;14164;5643;16098
260880;201302;7520;25914;7216;25448;1076;3812;5435;19523;6511;23335
260890;201302;14474;42704;13976;41963;1647;5630;10592;31795;12239;37425
260900;201302;5873;18687;5154;17518;1062;3769;3114;10837;4176;14606
260910;201302;2807;9077;2602;8785;295;1114;2031;6842;2326;7956
260915;201302;4260;14728;4169;14599;122;383;3884;13841;4006;14224
260920;201302;3248;10559;3114;10354;622;2266;2038;6885;2660;9151
260930;201302;3982;13142;3629;12633;510;1843;2632;9278;3142;11121
260940;201302;13031;39664;12073;37947;2571;9430;6493;20029;9064;29459
260950;201302;6111;20480;5910;20093;1101;4615;3906;12493;5007;17108
260960;201302;65245;186727;62315;182204;13440;42007;37966;111984;51406;153991
260970;201302;5197;17654;4888;17150;667;2697;3557;12429;4224;15126
260980;201302;3875;12686;3737;12497;271;987;3117;10625;3388;11612
260990;201302;16462;55193;15353;53608;1800;5876;11689;42935;13489;48811
261000;201302;13249;41486;12080;39545;2950;10481;6764;22304;9714;32785
261010;201302;2630;7613;2499;7434;239;562;2094;6513;2333;7075
261020;201302;5967;18738;5677;18281;376;1631;4778;14983;5154;16614
261030;201302;3009;10888;2938;10782;367;1474;2296;8406;2663;9880
261040;201302;5049;17167;4436;16205;683;2777;3063;11166;3746;13943
261050;201302;8233;23985;7847;23446;509;1634;6754;20183;7263;21817
261060;201302;10130;33557;9904;33189;2107;7676;6601;21787;8708;29463
261070;201302;45004;122643;41680;118098;10130;30245;24120;69393;34250;99638
261080;201302;5451;17655;5218;17273;422;1371;4375;14761;4797;16132
261090;201302;15474;45497;14717;44479;1375;4512;12148;36849;13523;41361
261100;201302;6951;23077;6630;22624;496;2077;5556;18833;6052;20910
261110;201302;62642;185428;58461;179675;14110;43882;34433;112117;48543;155999
261120;201302;3152;9500;3038;9344;95;310;2811;8685;2906;8995
261130;201302;6553;18038;6337;17810;264;759;5844;16446;6108;17205
261140;201302;3080;9042;2953;8868;589;1969;1948;5800;2537;7769
261150;201302;5364;17015;4904;16389;495;1907;3887;13052;4382;14959
261153;201302;1925;5680;1660;5318;106;405;1415;4571;1521;4976
261160;201302;218412;584443;210394;573999;41464;114631;138569;389695;180033;504326
261170;201302;5708;16741;5383;16257;667;2140;4271;12942;4938;15082
261180;201302;8844;27652;8738;27519;1003;3037;7249;23345;8252;26382
261190;201302;5222;17057;5017;16777;847;3701;3556;11284;4403;14985
261200;201302;3775;10230;3675;10103;500;1332;2798;7870;3298;9202
261210;201302;1828;5274;1756;5174;134;385;1504;4519;1638;4904
261220;201302;11805;40446;10736;38071;2218;8517;6001;21307;8219;29824
261230;201302;4099;12763;3858;12488;186;596;3497;11461;3683;12057
261240;201302;4741;14404;4527;13998;798;2452;3192;10037;3990;12489
261245;201302;3760;12434;3312;11681;332;1395;2418;8670;2750;10065
261247;201302;3379;11036;3042;10402;477;1663;2041;7116;2518;8779
261250;201302;18299;50799;17929;50321;1107;3240;16074;45193;17181;48433
261255;201302;4256;13593;3868;12961;440;1661;2849;9690;3289;11351
261260;201302;11453;34963;10668;34051;676;2058;9422;30532;10098;32590
261270;201302;3589;10828;3399;10517;474;1535;2454;7693;2928;9228
261280;201302;2667;8568;2440;8222;283;1101;1808;6059;2091;7160
261290;201302;2714;8238;2474;7931;146;493;2122;6941;2268;7434
261300;201302;9703;34762;9029;33529;1484;5967;6368;23898;7852;29865
261310;201302;8147;25627;7874;25169;1518;4998;5316;17208;6834;22206
261320;201302;5548;17931;5331;17528;796;2553;3792;12869;4588;15422
261330;201302;5515;16741;5419;16616;375;1298;4685;14389;5060;15687
261340;201302;4493;15031;4305;14734;778;3020;2786;9566;3564;12586
261350;201302;7676;26933;7334;26321;728;3112;5760;20488;6488;23600
261360;201302;8903;24198;8268;23293;1300;3937;5624;16096;6924;20033
261370;201302;19957;61481;19153;60322;2765;9463;14327;45256;17092;54719
261380;201302;4033;14250;3797;13872;657;2430;2598;9791;3255;12221
261390;201302;16095;51829;14972;49863;2701;9988;9477;31336;12178;41324
261400;201302;4673;17067;4327;16392;707;3000;2894;11043;3601;14043
261410;201302;7920;24979;7679;24613;758;2494;6165;20204;6923;22698
261420;201302;7416;25799;7240;25542;1893;7291;4263;15278;6156;22569
261430;201302;3424;10908;2929;10258;435;1574;2085;7476;2520;9050
261440;201302;1617;5014;1544;4911;132;510;1267;3995;1399;4505
261450;201302;13133;41134;12902;40831;1195;3923;11116;35332;12311;39255
261460;201302;8304;24374;7793;23654;857;2506;5692;18640;6549;21146
261470;201302;3796;10697;3495;10338;262;928;2970;8696;3232;9624
261480;201302;3210;12236;3053;11953;357;1623;2390;9195;2747;10818
261485;201302;4715;15365;4516;15026;963;3486;2752;9220;3715;12706
261500;201302;5516;15954;5046;15330;813;2263;3775;11993;4588;14256
261510;201302;2007;6849;1944;6768;102;291;1736;6186;1838;6477
261520;201302;2493;8466;2294;8176;247;992;1704;6100;1951;7092
261530;201302;12195;40568;11010;38270;2540;9823;5514;19049;8054;28872
261540;201302;6849;22598;6730;22404;1699;5252;4462;15582;6161;20834
261550;201302;3086;10234;2999;10100;559;2321;2155;6900;2714;9221
261560;201302;5969;20675;5626;20248;1056;3280;4194;15980;5250;19260
261570;201302;3538;11466;3310;11097;482;1666;2375;8124;2857;9790
261580;201302;5584;18693;5072;17833;457;1804;4042;14468;4499;16272
261590;201302;2733;7958;2427;7520;247;843;1795;5645;2042;6488
261600;201302;4952;14465;4286;13478;557;1860;3105;9903;3662;11763
261610;201302;2131;6838;1944;6581;137;602;1642;5437;1779;6039
261618;201302;2465;7311;2357;7158;256;933;1847;5476;2103;6409
261620;201302;4382;13820;4186;13510;504;1759;3021;9947;3525;11706
261630;201302;7871;24079;7198;22916;1573;5773;4105;12761;5678;18534
261640;201302;32283;85828;30406;83721;1721;4940;26752;74818;28473;79758
261650;201302;3520;12249;3440;12134;440;1736;2755;9734;3195;11470
270010;201302;4441;17353;4118;16660;512;2429;2952;11924;3464;14353
270020;201302;3694;11852;3491;11515;561;2195;2506;8044;3067;10239
270030;201302;41731;131785;40408;129873;11056;36217;23858;78962;34914;115179
270040;201302;10279;32690;10055;32453;762;1994;8995;29730;9757;31724
270050;201302;3755;11399;3557;11140;410;1599;2696;8247;3106;9846
270060;201302;1469;5274;1420;5198;374;1473;838;3095;1212;4568
270070;201302;3893;12508;3702;12227;138;616;3339;10938;3477;11554
270080;201302;1259;4148;1150;4002;281;1088;683;2347;964;3435
270090;201302;1955;6402;1919;6356;59;224;1797;5966;1856;6190
270100;201302;6153;20613;5950;20348;1249;4597;4142;14158;5391;18755
270110;201302;3306;9946;3077;9665;676;2220;1876;6332;2552;8552
270120;201302;2973;8890;2704;8508;170;637;2278;7191;2448;7828
270130;201302;4887;15999;4688;15764;610;2081;3679;12587;4289;14668
270135;201302;1674;5056;1599;4967;85;205;1452;4618;1537;4823
270140;201302;8437;24119;7775;23277;1110;4471;5914;16769;7024;21240
270150;201302;2455;8942;2393;8854;292;1244;1925;7043;2217;8287
270160;201302;4693;16922;4430;16541;346;1202;3793;14413;4139;15615
270170;201302;3973;13596;3679;13134;822;3386;2104;7429;2926;10815
270180;201302;2083;7424;1888;7178;226;975;1474;5638;1700;6613
270190;201302;1815;6225;1741;6098;203;761;1329;4721;1532;5482
270200;201302;2571;9010;2487;8876;245;1135;2025;7040;2270;8175
270210;201302;3800;14060;3720;13949;551;2189;2901;11016;3452;13205
270220;201302;1645;5340;1560;5168;319;1243;839;2836;1158;4079
270230;201302;10452;36034;9584;34695;1383;5671;7055;25443;8438;31114
270235;201302;6362;21534;6090;21084;366;1683;5239;17995;5605;19678
270240;201302;9484;29213;8639;28066;1591;5467;5744;18768;7335;24235
270250;201302;3319;9100;3090;8850;147;445;2809;8051;2956;8496
270255;201302;5016;15949;4257;14635;477;2046;3047;10344;3524;12390
270260;201302;5999;20179;5846;19899;985;3857;4054;13865;5039;17722
270270;201302;1205;3652;1142;3556;190;647;824;2548;1014;3195
270280;201302;3563;11196;3412;10974;578;2114;2435;7799;3013;9913
270290;201302;8208;29920;7910;29404;750;3084;6458;24059;7208;27143
270300;201302;3007;10918;2872;10752;189;861;2537;9478;2726;10339
270310;201302;6803;22266;6307;21430;468;2105;5064;16851;5532;18956
270320;201302;6073;20824;5895;20492;1669;6418;2863;10176;4532;16594
270330;201302;4577;15848;4374;15572;386;1438;3639;13153;4025;14591
270340;201302;1694;5493;1561;5335;243;873;1149;4009;1392;4882
270350;201302;2052;6067;1923;5897;327;1062;1258;4103;1585;5165
270360;201302;1905;6323;1890;6305;137;509;1680;5627;1817;6136
270370;201302;1684;5716;1558;5485;207;834;1081;3888;1288;4722
270375;201302;2900;9392;2775;9196;530;2150;1828;5741;2358;7891
270380;201302;5977;18624;5775;18359;636;2143;4493;14542;5129;16685
270390;201302;1358;4039;1278;3939;180;667;934;2803;1114;3470
270400;201302;5924;18942;5591;18499;472;1774;4615;15289;5087;17063
270410;201302;4667;15108;4504;14795;621;2280;3376;11062;3997;13342
270420;201302;5051;17327;4928;17148;311;1392;4326;14904;4637;16296
270430;201302;136242;406281;132044;400441;35412;109319;78177;243643;113589;352962
270440;201302;4770;15419;4538;15048;392;1497;3700;12308;4092;13805
270450;201302;6173;20482;6052;20326;755;2861;4745;16012;5500;18873
270460;201302;3259;9736;2967;9312;293;1183;2310;7078;2603;8261
270470;201302;10354;34583;9990;33931;1334;4308;7513;26564;8847;30872
270480;201302;3027;10083;2872;9825;375;1572;2044;6812;2419;8384
270490;201302;943;3199;904;3146;118;453;723;2501;841;2954
270500;201302;5444;19854;5302;19652;389;1452;4567;17333;4956;18785
270510;201302;5786;18852;5357;18251;1067;4587;3755;12110;4822;16697
270520;201302;3613;12504;3438;12194;989;3751;1794;6501;2783;10252
270530;201302;1523;4663;1355;4442;248;771;909;3139;1157;3910
270540;201302;1908;7022;1771;6801;219;1014;1368;5182;1587;6196
270550;201302;6763;22143;6104;21227;1065;3831;4124;14845;5189;18676
270560;201302;2780;9487;2717;9410;383;1519;2136;7349;2519;8868
270570;201302;4243;14355;3958;13906;572;2417;2674;9327;3246;11744
270580;201302;1953;6881;1896;6782;291;1087;1440;5209;1731;6296
270590;201302;1254;4632;1186;4505;127;604;938;3530;1065;4134
270600;201302;2794;9782;2589;9497;219;1022;2123;7666;2342;8688
270610;201302;3116;10248;2962;10014;363;1307;2289;7725;2652;9032
270620;201302;1393;4914;1269;4728;166;799;943;3403;1109;4202
270630;201302;17661;50606;17076;49832;1980;5515;13932;41409;15912;46924
270640;201302;5605;18174;5168;17675;398;1691;4407;14915;4805;16606
270642;201302;2410;8509;2281;8309;380;1510;1554;5728;1934;7238
270644;201302;2216;6977;2096;6844;402;1235;1561;5273;1963;6508
270650;201302;3832;12872;3722;12714;965;3739;2167;7352;3132;11091
270660;201302;2455;6729;2017;6041;225;831;1418;4170;1643;5001
270670;201302;12696;39873;11973;38781;1552;5765;9133;29332;10685;35097
270680;201302;4018;12642;3920;12524;255;749;3500;11318;3755;12067
270690;201302;7963;24238;7684;23886;2414;7034;4219;14319;6633;21353
270700;201302;794;2616;763;2563;161;620;458;1529;619;2149
270710;201302;5342;18675;5183;18472;516;1800;4355;15802;4871;17602
270720;201302;3174;11473;2989;11152;302;1377;2378;8800;2680;10177
270730;201302;6303;20542;5999;20138;1322;4846;3949;13117;5271;17963
270740;201302;2343;7154;2219;6966;391;1398;1453;4518;1844;5916
270750;201302;4672;15725;4443;15399;473;1912;3486;12004;3959;13916
270760;201302;3190;10193;3028;9963;381;1306;2341;7768;2722;9074
270770;201302;16622;46701;14533;44171;2844;9397;9479;29162;12323;38559
270780;201302;1907;6179;1789;5993;157;542;1451;4931;1608;5473
270790;201302;1547;5062;1426;4856;382;1377;703;2467;1085;3844
270800;201302;10480;33281;9995;32626;1013;3727;8052;26237;9065;29964
270810;201302;3156;10337;2752;9615;439;1732;1737;6110;2176;7842
270820;201302;1853;6521;1724;6288;245;1070;1238;4452;1483;5522
270830;201302;4942;16852;4638;16423;1504;5961;2446;8581;3950;14542
270840;201302;6984;25625;6482;24973;568;2568;5323;20503;5891;23071
270850;201302;7315;25274;7199;25119;1602;6746;5041;16788;6643;23534
270860;201302;10336;33817;10025;33328;1973;7429;6934;22563;8907;29992
270870;201302;2125;6411;1870;5955;284;1006;1144;3672;1428;4678
270880;201302;7862;26476;7540;26007;668;2710;6303;21564;6971;24274
270890;201302;2497;7994;2359;7774;403;1563;1618;5187;2021;6750
270895;201302;2935;11309;2808;11144;288;1090;2358;9579;2646;10669
270900;201302;1810;5257;1541;4862;124;458;1182;3660;1306;4118
270910;201302;3188;11775;3153;11709;338;1524;2632;9581;2970;11105
270915;201302;9553;33923;8886;32721;2112;8637;4761;17556;6873;26193
270920;201302;5578;19569;5249;19083;473;2132;4294;15531;4767;17663
270930;201302;16221;46185;13668;42894;2977;10070;7890;25065;10867;35135
270940;201302;5734;20146;5593;19982;812;2917;4395;16023;5207;18940
280010;201302;695;2106;621;1989;76;304;401;1259;477;1563
280020;201302;4653;14814;4290;14167;854;2981;2728;9069;3582;12050
280030;201302;64896;180996;59761;173540;15732;47959;31875;94670;47607;142629
280040;201302;2989;9875;2759;9573;378;1329;2053;7385;2431;8714
280050;201302;3914;12981;3709;12690;1061;3662;2162;7694;3223;11356
280060;201302;4021;13951;3917;13785;935;3596;2352;8308;3287;11904
280067;201302;7189;21444;6203;20081;653;2481;4768;15320;5421;17801
280070;201302;1782;6512;1723;6423;306;1199;1197;4535;1503;5734
280100;201302;3785;12520;3511;12032;822;2874;2008;7043;2830;9917
280110;201302;1268;4135;1194;4011;131;545;904;2998;1035;3543
280120;201302;7200;24096;6780;23393;1485;4813;4442;16316;5927;21129
280130;201302;7451;22400;7135;21950;1113;4033;5095;15381;6208;19414
280140;201302;5237;15447;4840;14938;252;805;4272;13344;4524;14149
280150;201302;3166;10313;2935;9849;502;2031;1817;5797;2319;7828
280160;201302;1472;4370;1355;4179;202;692;954;2948;1156;3640
280170;201302;4229;13598;3909;13216;573;1967;2907;10156;3480;12123
280190;201302;1076;3269;987;3125;129;509;693;2129;822;2638
280200;201302;933;3204;907;3173;184;777;623;2091;807;2868
280210;201302;10971;38069;10613;37460;2535;9525;6486;23189;9021;32714
280220;201302;1468;4655;1421;4594;102;369;1251;4050;1353;4419
280230;201302;3692;11180;3377;10657;739;2467;1987;6435;2726;8902
280240;201302;3365;10603;3167;10303;258;870;2566;8451;2824;9321
280250;201302;700;1957;660;1897;45;157;544;1520;589;1677
280260;201302;1841;5312;1695;5126;144;457;1422;4310;1566;4767
280270;201302;2085;6810;1850;6398;136;582;1457;4934;1593;5516
280280;201302;3917;13449;3731;13130;809;2496;2259;8774;3068;11270
280290;201302;14651;50326;14054;49342;2480;9584;10229;35726;12709;45310
280300;201302;9427;29800;8903;29213;646;2346;7806;25624;8452;27970
280310;201302;1363;4022;1239;3835;120;468;911;2747;1031;3215
280320;201302;6958;25069;6692;24592;1209;4995;4440;16336;5649;21331
280330;201302;3992;12519;3812;12288;568;1942;2867;9364;3435;11306
280340;201302;3321;11066;3245;10962;283;1111;2701;9136;2984;10247
280350;201302;19810;62208;19078;61044;3046;10184;13514;44095;16560;54279
280360;201302;5586;18234;5309;17810;1188;4520;3288;10859;4476;15379
280370;201302;1811;5463;1699;5277;224;820;1250;3769;1474;4589
280380;201302;807;2898;757;2812;155;674;506;1819;661;2493
280390;201302;3069;9495;2835;9091;635;1867;1820;6028;2455;7895
280400;201302;4015;12223;3705;11813;700;2245;2537;8330;3237;10575
280410;201302;2242;7644;2090;7396;362;1466;1279;4436;1641;5902
280420;201302;3731;11639;3541;11367;265;877;3040;9865;3305;10742
280430;201302;1792;5537;1708;5426;278;976;1238;3897;1516;4873
280440;201302;4701;14782;4471;14480;396;1456;3783;12188;4179;13644
280445;201302;2409;7086;2270;6855;131;526;1886;5589;2017;6115
280450;201302;8296;23850;7771;23244;794;2071;6508;20106;7302;22177
280460;201302;6201;18446;5730;17806;1330;4168;3659;11725;4989;15893
280470;201302;1640;5259;1521;5074;191;731;1134;3735;1325;4466
280480;201302;28953;91747;28188;90664;4526;17537;20038;62441;24564;79978
280490;201302;3594;11426;3404;11092;359;1431;2695;8677;3054;10108
280500;201302;759;2211;745;2195;48;180;631;1818;679;1998
280510;201302;2577;7882;2231;7409;314;1186;1644;5489;1958;6675
280520;201302;1529;4793;1409;4628;224;810;937;3158;1161;3968
280530;201302;1906;6349;1837;6252;221;851;1450;4948;1671;5799
280540;201302;8391;24310;8035;23821;395;1427;7170;21114;7565;22541
280550;201302;6547;19135;6134;18462;579;2134;4650;13861;5229;15995
280560;201302;7456;23096;7121;22519;577;2060;5780;18233;6357;20293
280570;201302;6443;19128;6070;18654;822;2993;4608;14002;5430;16995
280580;201302;5480;17155;4893;16212;585;2092;3661;12291;4246;14383
280590;201302;2210;7036;2060;6863;260;1055;1586;5253;1846;6308
280600;201302;3887;12348;3667;11938;413;1640;2631;8370;3044;10010
280610;201302;2188;6779;2095;6636;351;1272;1362;4279;1713;5551
280620;201302;4449;14629;4243;14218;842;3030;2710;9106;3552;12136
280630;201302;3656;12649;3556;12500;493;1707;2732;9905;3225;11612
280640;201302;1952;6014;1855;5893;108;365;1647;5246;1755;5611
280650;201302;1026;3382;963;3266;202;730;590;2025;792;2755
280660;201302;2470;7636;2377;7480;175;712;2047;6301;2222;7013
280670;201302;14747;40419;14158;39709;1341;4025;11705;32895;13046;36920
280680;201302;2488;7292;2217;6953;181;619;1851;5839;2032;6458
280690;201302;891;2748;798;2599;120;472;525;1611;645;2083
280700;201302;1158;3520;1039;3354;78;253;821;2715;899;2968
280710;201302;9104;27318;8771;26880;557;1942;7562;23093;8119;25035
280720;201302;2353;6715;2125;6423;201;679;1692;5096;1893;5775
280730;201302;859;2734;844;2714;99;325;674;2218;773;2543
280740;201302;11884;34264;10729;32602;1702;5065;7637;23929;9339;28994
280750;201302;3396;11282;3223;10967;293;1245;2428;8166;2721;9411
280760;201302;5152;17059;4797;16605;554;1905;3824;13634;4378;15539
290010;201302;2845;6610;2136;5510;97;399;1707;4163;1804;4562
290020;201302;4795;15525;4367;15083;378;1222;3804;13392;4182;14614
290030;201302;2980;10158;2924;10044;330;1253;2293;7830;2623;9083
290035;201302;4315;12607;3962;12144;262;935;3372;10328;3634;11263
290040;201302;3509;11301;3331;11058;296;1184;2743;9025;3039;10209
290050;201302;2660;8925;2505;8687;245;970;1950;6812;2195;7782
290060;201302;1242;3351;1059;3136;84;237;915;2730;999;2967
290070;201302;27487;77812;25034;74711;5353;16667;14819;46087;20172;62754
290080;201302;5388;17510;4943;16941;632;2298;3851;13368;4483;15666
290090;201302;2263;5121;1821;4655;183;459;1520;3949;1703;4408
290100;201302;9680;28873;8524;26867;1940;6163;4594;15217;6534;21380
290110;201302;5040;15974;4908;15748;843;2950;3445;10987;4288;13937
290115;201302;4740;14987;4286;14388;369;1318;3300;11279;3669;12597
290120;201302;6411;18513;6086;18132;375;1153;5416;16258;5791;17411
290130;201302;4426;12070;4006;11569;333;806;3437;10211;3770;11017
290135;201302;4836;13354;4310;12473;451;1580;2986;8639;3437;10219
290140;201302;3459;12117;3149;11718;416;1635;2502;9369;2918;11004
290150;201302;2056;6274;2014;6201;170;561;1744;5354;1914;5915
290160;201302;3378;9783;3326;9722;384;795;2821;8629;3205;9424
290170;201302;2653;9283;2470;8971;283;1204;1910;6926;2193;8130
290180;201302;2824;8413;2610;8138;281;966;1996;6257;2277;7223
290190;201302;4104;13856;3977;13633;466;1651;3152;10958;3618;12609
290195;201302;2096;6134;1849;5763;128;432;1505;4750;1633;5182
290200;201302;3551;12199;3302;11739;496;1905;2316;8262;2812;10167
290205;201302;2619;8885;2488;8708;437;1810;1743;5954;2180;7764
290210;201302;14546;42582;14067;42003;2447;5795;10137;33260;12584;39055
290220;201302;2231;7230;2170;7138;371;1412;1527;4905;1898;6317
290225;201302;2924;8176;2772;8010;269;632;2355;7050;2624;7682
290230;201302;2178;7624;2148;7581;263;932;1741;6255;2004;7187
290240;201302;3721;10193;3407;9767;380;1246;2575;7309;2955;8555
290250;201302;3620;12027;3083;11156;329;1294;2300;8405;2629;9699
290260;201302;4434;14565;4241;14269;532;1892;3327;11238;3859;13130
290265;201302;3205;10891;3094;10699;331;1307;2391;8264;2722;9571
290270;201302;11166;43119;10610;42329;1257;5564;8314;33459;9571;39023
290280;201302;4803;16669;4619;16294;762;2811;3118;11308;3880;14119
290290;201302;9265;30915;8633;29901;1533;5616;5920;20814;7453;26430
290300;201302;4214;12349;3437;11079;340;1101;2542;8425;2882;9526
290310;201302;1452;4613;1410;4567;197;743;1092;3468;1289;4211
290320;201302;21475;74571;20749;73465;4864;18071;13311;47836;18175;65907
290323;201302;3530;10486;2969;9894;193;774;2560;8499;2753;9273
290327;201302;3668;12502;3519;12187;536;1961;2465;8605;3001;10566
290330;201302;1749;5007;1695;4948;267;882;1320;3783;1587;4665
290340;201302;5427;17985;5151;17556;1182;4119;3067;10813;4249;14932
290350;201302;4742;15048;3949;13961;510;1856;2887;10462;3397;12318
290360;201302;3830;12741;3630;12497;233;858;3206;11144;3439;12002
290370;201302;4308;13745;4026;13332;588;2009;3087;10337;3675;12346
290380;201302;5176;15934;4727;15393;341;1294;4139;13454;4480;14748
290390;201302;14155;48722;13726;48006;2752;9391;9296;33994;12048;43385
290395;201302;2687;9033;2457;8651;276;1171;1834;6467;2110;7638
290400;201302;3255;11309;2990;10929;365;1493;2272;8396;2637;9889
290405;201302;4033;13619;3620;12929;547;2033;2483;9162;3030;11195
290410;201302;5690;17947;4962;16884;598;2607;3662;12100;4260;14707
290420;201302;2987;9615;2620;9094;311;1281;1921;6621;2232;7902
290430;201302;3205;10771;2988;10487;578;1992;2046;7455;2624;9447
290440;201302;2636;7675;2253;7195;235;824;1818;5854;2053;6678
290450;201302;3301;10163;3050;9802;687;2133;1843;6217;2530;8350
290460;201302;12468;40862;11925;39946;3017;10838;6606;21958;9623;32796
290470;201302;4458;13362;3661;12374;886;3382;1980;6750;2866;10132
290475;201302;5047;18427;4648;17712;586;2375;3429;13282;4015;15657
290480;201302;2497;6732;2258;6416;437;1422;1489;4194;1926;5616
290485;201302;4228;14716;4010;14392;495;2183;3043;10875;3538;13058
290490;201302;7103;20930;6938;20722;913;2943;5506;16490;6419;19433
290500;201302;4440;14706;3914;13810;738;2802;2221;7891;2959;10693
290510;201302;3371;10162;2990;9595;258;995;2369;7576;2627;8571
290515;201302;2511;8388;2440;8244;125;413;2046;7085;2171;7498
290520;201302;11191;36387;9450;33131;1373;5595;6066;21118;7439;26713
290530;201302;5038;15165;4401;14271;364;1342;3595;11641;3959;12983
290540;201302;3841;11319;3694;11120;509;1514;2781;8585;3290;10099
290550;201302;3892;11057;3456;10490;346;949;2753;8572;3099;9521
290560;201302;6591;19895;5810;18858;1284;4430;3620;11977;4904;16407
290570;201302;36594;112951;34628;109934;4780;16427;25874;82073;30654;98500
290580;201302;7147;26289;6912;25929;1198;4546;5057;19486;6255;24032
290590;201302;6873;23284;5973;21882;456;2016;4873;17794;5329;19810
290600;201302;17422;56842;16634;55593;2235;7806;12008;41165;14243;48971
290610;201302;2224;8150;1952;7631;226;1082;1461;5612;1687;6694
290620;201302;7034;21746;6389;20840;540;1907;5370;17557;5910;19464
290630;201302;7882;22170;7113;21378;648;1930;6059;18469;6707;20399
290640;201302;2670;8061;2259;7342;280;992;1593;5184;1873;6176
290650;201302;11198;34527;10548;33517;3272;10453;5592;18605;8864;29058
290660;201302;3569;10419;3051;9677;234;872;2436;7733;2670;8605
290670;201302;6133;20466;5688;19772;760;2431;4495;16262;5255;18693
290680;201302;9776;30125;9351;29640;542;1554;8360;26962;8902;28516
290682;201302;3954;12745;3688;12369;246;1019;3113;10400;3359;11419
290685;201302;3062;8376;2455;7528;306;1059;1646;5091;1952;6150
290687;201302;8072;22473;6729;20907;1012;3475;4675;14726;5687;18201
290689;201302;3015;8913;2585;8210;289;1002;2008;6414;2297;7416
290690;201302;5011;15480;4676;15014;628;2230;3558;11426;4186;13656
290700;201302;2143;7020;2076;6915;258;936;1612;5397;1870;6333
290710;201302;7296;24635;6873;23981;423;1465;6077;21468;6500;22933
290720;201302;16761;52710;15273;50874;2143;6333;11984;41642;14127;47975
290730;201302;7073;20583;6598;19998;1298;3808;4346;13754;5644;17562
290740;201302;973;3051;853;2857;209;685;453;1618;662;2303
290750;201302;8605;27384;8110;26446;1718;6578;4888;14964;6606;21542
290755;201302;2346;6937;2042;6436;143;571;1675;5219;1818;5790
290760;201302;4298;13331;3678;12513;351;1247;2949;10134;3300;11381
290770;201302;2481;8868;2337;8679;157;648;1986;7426;2143;8074
290780;201302;8108;22869;7497;22052;997;2841;5646;16987;6643;19828
290790;201302;4164;13640;3956;13373;398;1322;3155;11095;3553;12417
290800;201302;6896;16301;5401;14716;1063;2686;3854;11008;4917;13694
290810;201302;4443;15304;4111;14796;370;1414;3246;11855;3616;13269
290820;201302;5164;15585;4678;14901;624;2224;3439;11025;4063;13249
290830;201302;4062;12816;3934;12576;587;2282;2728;8478;3315;10760
290840;201302;16381;48238;15520;47061;2244;6513;11501;36225;13745;42738
290850;201302;6431;20212;6308;20024;1767;5466;3818;12671;5585;18137
290860;201302;4467;17033;4360;16894;688;2630;3253;13006;3941;15636
290870;201302;4591;14742;3902;13847;373;1562;3104;11044;3477;12606
290880;201302;1325;3901;1098;3536;107;372;746;2458;853;2830
290890;201302;5988;17484;5821;17275;520;1692;4889;14473;5409;16165
290900;201302;2314;7001;1792;6184;317;1232;931;3161;1248;4393
290910;201302;4482;13446;3938;12662;394;1337;3097;10051;3491;11388
290920;201302;4631;14707;4291;14293;250;725;3802;12930;4052;13655
290930;201302;7038;23517;6632;22880;762;3018;4974;16949;5736;19967
290940;201302;3163;10774;3011;10569;288;1103;2530;8979;2818;10082
290950;201302;1511;4565;1450;4484;223;756;1079;3297;1302;4053
290960;201302;5433;16694;5102;16228;421;1383;4123;13322;4544;14705
290970;201302;3629;12181;3418;11819;524;1892;2282;8101;2806;9993
290980;201302;10115;32456;9317;30836;2712;9636;4322;14148;7034;23784
290990;201302;8802;27457;8238;26567;977;3330;6463;20963;7440;24293
291000;201302;2827;9587;2719;9443;422;1422;2066;7433;2488;8855
291005;201302;9614;32055;9272;31476;2042;7339;6092;20780;8134;28119
291010;201302;2808;9987;2444;9134;521;2056;1247;4735;1768;6791
291020;201302;1269;3610;1016;3123;130;501;585;1741;715;2242
291030;201302;1900;5708;1659;5199;200;705;1061;3303;1261;4008
291040;201302;4927;16783;4723;16478;613;2407;3504;12208;4117;14615
291050;201302;7822;27002;7303;26060;1911;7309;4045;14564;5956;21873
291060;201302;5979;22900;5758;22633;809;3565;4448;17481;5257;21046
291070;201302;15399;47405;14412;45941;2020;6002;10800;35616;12820;41618
291072;201302;16715;56684;15284;53962;6169;22849;4997;18944;11166;41793
291075;201302;4806;15030;4538;14616;304;1075;3622;11750;3926;12825
291077;201302;1440;4459;1264;4201;151;617;875;2844;1026;3461
291080;201302;78954;246430;73231;237669;18315;62926;39393;127740;57708;190666
291085;201302;5266;15078;4676;14289;583;1975;3615;11002;4198;12977
291090;201302;1113;3303;978;3096;177;794;588;1667;765;2461
291100;201302;2594;7334;2215;6933;124;523;1929;5989;2053;6512
291110;201302;4719;17676;4302;17011;556;2517;3158;12454;3714;14971
291120;201302;7227;20340;6906;19883;1005;3045;5280;15306;6285;18351
291125;201302;1600;3747;1332;3468;142;329;1053;2870;1195;3199
291130;201302;2907;9157;2592;8635;287;1094;1863;6205;2150;7299
291140;201302;3911;12244;3758;11971;579;1961;2753;8787;3332;10748
291150;201302;1888;5219;1838;5163;192;538;1545;4367;1737;4905
291160;201302;5213;16528;4737;15836;1084;3854;2973;9920;4057;13774
291165;201302;2150;7106;1933;6677;237;985;1371;4598;1608;5583
291170;201302;19343;51849;17171;49251;1454;4961;13928;39706;15382;44667
291180;201302;5938;16749;5035;15522;532;1923;3929;11959;4461;13882
291185;201302;3405;10224;3277;10057;240;869;2795;8509;3035;9378
291190;201302;7251;21290;6642;20597;929;2727;4981;16174;5910;18901
291200;201302;2982;9443;2660;8923;344;1370;1951;6475;2295;7845
291210;201302;7397;18531;6695;17784;733;2016;5252;14208;5985;16224
291220;201302;3807;12656;3636;12362;605;2357;2526;8480;3131;10837
291230;201302;3617;10026;3268;9589;237;745;2792;8228;3029;8973
291240;201302;4468;12892;3868;11859;338;1117;2970;9023;3308;10140
291250;201302;3621;11186;2935;10075;313;1115;2130;7422;2443;8537
291260;201302;1164;3572;1116;3512;107;377;906;2844;1013;3221
291270;201302;4587;15664;4391;15396;291;1176;3705;13017;3996;14193
291280;201302;2285;6025;1762;5439;565;1676;1014;3272;1579;4948
291290;201302;5645;17204;5281;16764;370;1154;4493;14546;4863;15700
291300;201302;4328;13430;3643;12276;473;1773;2529;8568;3002;10341
291310;201302;4992;15189;4517;14442;445;1561;3488;11172;3933;12733
291320;201302;5098;18069;4755;17371;1300;5133;2398;8675;3698;13808
291330;201302;1527;4901;1440;4743;220;851;910;2870;1130;3721
291340;201302;3649;11438;3000;10499;406;1611;2229;7755;2635;9366
291345;201302;3189;11206;3075;11081;253;958;2676;9750;2929;10708
291350;201302;5829;17946;5268;17099;719;2471;3455;11519;4174;13990
291360;201302;35154;106039;33275;103214;7506;23060;22078;70685;29584;93745
291370;201302;8565;27238;8282;26877;1452;4344;5952;20351;7404;24695
291380;201302;3488;11442;3212;11010;260;916;2522;8895;2782;9811
291390;201302;9652;28734;8899;27892;1093;3536;7119;22537;8212;26073
291400;201302;16234;44349;13419;40615;1881;5925;9131;28672;11012;34597
291410;201302;3104;8358;2324;7213;215;898;1730;5161;1945;6059
291420;201302;2136;5894;1972;5696;180;455;1724;5083;1904;5538
291430;201302;3213;9893;2880;9463;290;1136;2241;7308;2531;8444
291440;201302;5509;18602;4752;17145;600;2302;3509;12877;4109;15179
291450;201302;6857;22298;6613;21879;514;1688;5370;18120;5884;19808
291460;201302;11811;38206;10750;36669;2813;9899;6294;21982;9107;31881
291465;201302;7177;22662;6755;22180;1023;3540;5144;17151;6167;20691
291470;201302;14802;43456;13442;41779;1161;3667;10912;34802;12073;38469
291480;201302;33016;93609;29796;89072;5691;18539;19026;56791;24717;75330
291490;201302;3922;14218;3861;14119;560;2074;3040;11255;3600;13329
291500;201302;3986;12029;3536;11409;309;1091;2850;9233;3159;10324
291510;201302;3263;10575;3108;10354;196;691;2754;9246;2950;9937
291520;201302;3921;11472;3554;10968;626;1843;2376;7848;3002;9691
291530;201302;1975;6191;1734;5819;521;1861;849;2936;1370;4797
291535;201302;4165;12772;3826;12293;459;1541;2813;9462;3272;11003
291540;201302;2161;5601;1897;5324;164;436;1609;4609;1773;5045
291550;201302;5293;15146;4839;14502;1177;3847;2765;8322;3942;12169
291560;201302;15645;43598;12765;40254;1777;5787;9285;30083;11062;35870
291570;201302;2240;6367;2214;6337;53;113;2138;6187;2191;6300
291580;201302;5662;18133;5084;17186;878;3621;3183;10534;4061;14155
291590;201302;1825;6058;1675;5796;363;1422;984;3473;1347;4895
291600;201302;5231;15242;3939;13452;1026;3802;2013;6862;3039;10664
291610;201302;5085;14803;4959;14627;461;1709;4174;12035;4635;13744
291620;201302;2878;7170;2439;6697;206;566;1944;5522;2150;6088
291630;201302;3117;8156;2825;7826;240;634;2446;6915;2686;7549
291640;201302;16249;47215;14079;44485;4192;14516;6412;20396;10604;34912
291650;201302;7327;22973;6821;22385;522;1468;5890;19858;6412;21326
291660;201302;2387;6624;2172;6351;272;929;1626;4679;1898;5608
291670;201302;2432;7097;2263;6816;382;1192;1275;4180;1657;5372
291680;201302;4847;14362;4457;13760;1176;4064;2171;7019;3347;11083
291685;201302;3768;10975;3518;10687;163;560;3146;9657;3309;10217
291690;201302;3820;11014;3207;10044;353;1169;2199;6950;2552;8119
291700;201302;8908;29761;8452;28998;930;3391;6598;22948;7528;26339
291710;201302;5620;15924;4977;15042;1262;4345;2382;7433;3644;11778
291720;201302;3512;12962;3357;12636;417;1753;2497;9297;2914;11050
291730;201302;5525;18792;5212;18377;1381;4902;3138;11524;4519;16426
291733;201302;2354;7922;2106;7589;261;1009;1522;5643;1783;6652
291735;201302;1950;6094;1760;5797;89;358;1535;5005;1624;5363
291740;201302;3825;11506;3069;10344;341;1354;2189;7333;2530;8687
291750;201302;20495;57169;17106;52284;3775;11929;9919;30917;13694;42846
291760;201302;11585;38502;11106;37688;3615;13071;5672;19736;9287;32807
291770;201302;7644;22953;7208;22227;1120;3782;5051;15448;6171;19230
291780;201302;4144;13378;4050;13215;595;1859;3119;10390;3714;12249
291790;201302;2274;7726;2182;7609;231;885;1766;6197;1997;7082
291800;201302;29336;90732;27230;87702;6488;21602;16569;54881;23057;76483
291810;201302;9777;30299;8780;29138;702;2494;7271;24486;7973;26980
291820;201302;3420;10972;3221;10690;364;1228;2516;8479;2880;9707
291830;201302;4179;11821;3942;11468;536;1722;3014;8698;3550;10420
291835;201302;5887;18958;5100;17769;991;3749;3516;12221;4507;15970
291840;201302;44297;128450;38904;122826;4875;15475;31269;100652;36144;116127
291845;201302;2991;9151;2722;8864;173;483;2456;8167;2629;8650
291850;201302;4715;13778;4074;12910;415;1305;3253;10543;3668;11848
291855;201302;1820;5061;1614;4812;263;942;1153;3349;1416;4291
291860;201302;1846;5860;1715;5644;236;901;1156;3796;1392;4697
291870;201302;1293;3693;1055;3267;114;443;717;2191;831;2634
291875;201302;2675;9184;2513;8922;292;1218;1868;6533;2160;7751
291880;201302;4151;14050;4078;13949;326;1187;3539;12177;3865;13364
291890;201302;1357;3542;1164;3305;138;402;887;2558;1025;2960
291900;201302;1209;3708;1105;3551;111;412;832;2645;943;3057
291905;201302;2734;7805;2367;7217;278;915;1585;4983;1863;5898
291910;201302;2291;6875;2121;6674;190;699;1781;5540;1971;6239
291915;201302;6351;20667;5855;19624;510;1809;4925;16664;5435;18473
291920;201302;32147;95559;30024;92497;5822;18167;19470;62017;25292;80184
291930;201302;2338;7502;2179;7274;222;744;1748;5990;1970;6734
291940;201302;3476;10338;2762;9113;412;1606;1764;5696;2176;7302
291950;201302;8887;31494;8171;30333;1995;7620;4627;17608;6622;25228
291955;201302;7289;24861;7189;24723;1255;4401;5342;18679;6597;23080
291960;201302;3260;10139;2870;9635;375;1194;2055;7316;2430;8510
291970;201302;4263;13164;3832;12650;651;2172;2686;9119;3337;11291
291980;201302;10928;32987;8802;30021;973;3554;6482;22510;7455;26064
291990;201302;2053;7044;1922;6839;233;865;1388;5090;1621;5955
291992;201302;2653;8433;2603;8329;476;1597;1866;5946;2342;7543
291995;201302;2013;6267;1846;6048;242;852;1419;4680;1661;5532
292000;201302;2123;6725;1948;6450;629;2230;960;3146;1589;5376
292010;201302;5942;16083;4659;14127;344;1188;3650;11068;3994;12256
292020;201302;4393;15578;4079;15060;496;2035;3099;11589;3595;13624
292030;201302;2079;6921;1907;6686;259;977;1340;4804;1599;5781
292040;201302;4286;12692;3971;12349;331;1024;3366;10752;3697;11776
292045;201302;2194;8334;2169;8288;126;412;1974;7649;2100;8061
292050;201302;5812;19315;5441;18581;647;2675;3906;13148;4553;15823
292060;201302;10481;30559;10142;30097;938;2979;8486;25102;9424;28081
292070;201302;4033;13721;3941;13597;438;1329;3355;11874;3793;13203
292080;201302;3500;9721;3094;9170;316;989;2479;7394;2795;8383
292090;201302;4115;11551;3598;10953;395;1367;2855;8695;3250;10062
292100;201302;10280;30206;9177;28838;2305;7563;5631;18096;7936;25659
292105;201302;3062;9621;2711;9128;235;941;2155;7210;2390;8151
292110;201302;6862;18739;5326;16572;976;3341;3376;10628;4352;13969
292120;201302;8122;24384;7334;23179;1531;5106;4450;14354;5981;19460
292130;201302;3172;8688;2948;8405;385;919;2304;6857;2689;7776
292140;201302;5301;14458;4763;13736;536;1622;3453;10216;3989;11838
292145;201302;2640;8421;2451;8128;230;757;1829;6355;2059;7112
292150;201302;12925;40830;12163;39591;899;3547;9621;31373;10520;34920
292160;201302;2458;7404;2129;6952;217;693;1680;5667;1897;6360
292170;201302;8306;26131;7365;24530;1144;4262;4812;16226;5956;20488
292180;201302;3404;10511;2888;9744;348;1268;2077;7142;2425;8410
292190;201302;2924;8716;2633;8316;548;1903;1719;5423;2267;7326
292200;201302;4536;17030;4194;16216;1632;6550;1350;5506;2982;12056
292205;201302;3834;12424;3581;12078;331;1252;2780;9422;3111;10674
292210;201302;6261;19189;5611;18290;597;2073;4381;14584;4978;16657
292220;201302;1893;5702;1807;5579;280;919;1295;3951;1575;4870
292225;201302;2732;9116;2522;8784;255;930;1934;6875;2189;7805
292230;201302;5813;18294;5618;17977;696;2761;4357;13539;5053;16300
292240;201302;4193;14070;3964;13541;611;2195;2536;8750;3147;10945
292250;201302;5271;16506;5017;16033;1038;3487;2959;9542;3997;13029
292260;201302;2744;9387;2651;9235;363;1337;1955;6846;2318;8183
292265;201302;2894;10148;2731;9820;244;1033;2051;7347;2295;8380
292270;201302;3567;10457;2931;9709;312;1286;2386;7812;2698;9098
292273;201302;2629;6617;2027;5841;324;908;1386;4186;1710;5094
292275;201302;1892;5040;1784;4885;226;714;1355;3666;1581;4380
292280;201302;1976;6195;1859;6071;197;574;1471;5080;1668;5654
292285;201302;2412;7179;2172;6826;340;1132;1466;4782;1806;5914
292290;201302;7321;22763;6275;21432;245;930;5470;19103;5715;20033
292300;201302;7998;25719;7106;24757;2396;8388;3943;14331;6339;22719
292303;201302;2651;8840;2532;8653;90;333;2228;7677;2318;8010
292305;201302;2987;8660;2848;8470;134;430;2525;7549;2659;7979
292310;201302;5704;18480;5275;17910;365;1254;4537;15622;4902;16876
292320;201302;5384;17691;5089;17159;605;2400;3848;12842;4453;15242
292330;201302;1844;5668;1740;5545;314;1086;1206;3824;1520;4910
292335;201302;5024;13926;4666;13435;425;1240;3911;11345;4336;12585
292340;201302;5966;18485;5361;17554;517;1853;4041;13280;4558;15133
292350;201302;2010;6507;1902;6376;208;789;1516;5083;1724;5872
292360;201302;4591;14297;4470;13832;197;643;3918;12335;4115;12978
292370;201302;8019;26671;7392;25727;939;3195;5339;19604;6278;22799
292380;201302;7024;21256;6726;20839;544;1583;5708;17956;6252;19539
292390;201302;3476;8404;3114;8013;126;256;2887;7531;3013;7787
292400;201302;21392;64860;20602;63577;3106;10152;14704;46322;17810;56474
292405;201302;4241;11937;3774;11378;282;859;3207;9830;3489;10689
292410;201302;1591;4933;1560;4896;96;416;1384;4260;1480;4676
292420;201302;3356;11454;3261;11342;298;757;2817;10245;3115;11002
292430;201302;4975;16688;4375;15918;358;1450;3452;12631;3810;14081
292440;201302;8361;27880;7904;27233;314;1207;7060;24665;7374;25872
292450;201302;3874;12540;3313;11587;391;1512;2266;8063;2657;9575
292460;201302;5537;17269;5011;16302;791;2737;3350;10958;4141;13695
292465;201302;2226;7090;1962;6668;250;994;1441;4896;1691;5890
292467;201302;2145;7245;2049;7077;463;1700;1280;4479;1743;6179
292470;201302;3079;8581;2623;7852;245;889;1979;5820;2224;6709
292480;201302;5269;15848;4587;14856;431;1529;3677;12016;4108;13545
292490;201302;2003;6230;1833;5946;213;844;1349;4316;1562;5160
292500;201302;6135;19695;5458;18496;663;2627;3919;13330;4582;15957
292510;201302;12484;37467;11287;35760;1145;4075;8887;28410;10032;32485
292520;201302;5445;17603;5125;17022;1543;5253;2590;8698;4133;13951
292525;201302;5253;14430;4684;13761;477;1548;3710;10989;4187;12537
292530;201302;23884;73927;22202;72018;3663;12166;16441;54872;20104;67038
292540;201302;2471;8034;2298;7755;447;1785;1455;4849;1902;6634
292550;201302;5873;20535;5403;19777;1016;3950;3542;13225;4558;17175
292560;201302;4089;11704;3539;10983;333;1227;2855;8732;3188;9959
292570;201302;3765;11643;3705;11579;146;473;3222;10400;3368;10873
292575;201302;5504;19728;5386;19494;1308;4817;3354;12223;4662;17040
292580;201302;6708;21088;6298;20555;562;1886;5232;17263;5794;19149
292590;201302;6833;22953;6629;22583;1122;3814;4566;15943;5688;19757
292593;201302;3122;8607;2716;8007;277;868;2071;6107;2348;6975
292595;201302;5236;16185;4794;15586;472;1660;3696;12072;4168;13732
292600;201302;9817;29170;9452;28715;1375;3278;7539;24149;8914;27427
292610;201302;4227;12595;3624;11607;683;2275;2176;7122;2859;9397
292620;201302;5647;17916;5063;17244;273;1012;4615;15813;4888;16825
292630;201302;9644;25037;8599;23529;656;2000;6832;18821;7488;20821
292640;201302;8175;26965;7287;25811;713;2574;5721;20794;6434;23368
292650;201302;4451;13095;4311;12927;500;1199;3470;11045;3970;12244
292660;201302;10579;33658;10263;33174;1445;4676;7695;25485;9140;30161
292665;201302;2774;8637;2706;8532;103;285;2530;8059;2633;8344
292670;201302;3684;10918;2996;9756;375;1403;1993;6520;2368;7923
292680;201302;3440;10814;3315;10655;238;876;2852;9082;3090;9958
292690;201302;3230;9163;2437;7951;317;1167;1686;5560;2003;6727
292700;201302;8331;27013;7574;25991;884;2908;5933;21058;6817;23966
292710;201302;1750;6001;1690;5908;120;440;1459;5148;1579;5588
292720;201302;9197;25213;8278;24164;850;2549;6815;20167;7665;22716
292730;201302;3112;9923;3023;9770;593;1836;2002;6726;2595;8562
292740;201302;335868;990456;322605;970629;80100;253519;193599;585973;273699;839492
292750;201302;5520;15823;5092;15268;441;1282;4098;12637;4539;13919
292760;201302;4190;13815;3898;13291;573;2172;2691;9249;3264;11421
292770;201302;5590;18055;5336;17660;1422;4721;3074;10611;4496;15332
292780;201302;1704;4576;1387;4195;228;810;975;2886;1203;3696
292790;201302;2943;8547;2878;8469;270;684;2359;7286;2629;7970
292800;201302;8991;28312;8539;27577;981;3466;6594;21314;7575;24780
292805;201302;2941;9283;2761;9013;509;1789;1903;6328;2412;8117
292810;201302;9145;29957;8092;28572;1205;4409;6107;21975;7312;26384
292820;201302;6945;20973;5257;18603;451;1828;4312;15287;4763;17115
292830;201302;1810;5584;1662;5384;132;527;1356;4363;1488;4890
292840;201302;6190;22324;5796;21760;577;2154;4740;18152;5317;20306
292850;201302;2694;7849;2494;7559;390;1197;1723;5198;2113;6395
292860;201302;14404;41027;14002;40535;2063;5896;10833;31997;12896;37893
292870;201302;17320;50966;15764;48401;3024;10469;9499;28609;12523;39078
292880;201302;11416;35375;10470;33844;2029;6783;6664;21845;8693;28628
292890;201302;5208;18767;4780;17925;1077;4175;2683;10406;3760;14581
292895;201302;2580;6932;2221;6404;320;1003;1662;4752;1982;5755
292900;201302;3009;9653;2850;9388;490;1903;1861;5906;2351;7809
292905;201302;3784;12120;3195;11345;411;1363;2473;9119;2884;10482
292910;201302;4756;15507;4520;15073;832;2929;2954;9807;3786;12736
292920;201302;7163;22302;6845;21807;749;2722;5339;16816;6088;19538
292925;201302;4768;15955;4317;15361;345;1330;3537;12688;3882;14018
292930;201302;6040;20213;5835;19821;920;3728;4178;13858;5098;17586
292935;201302;2009;5898;1725;5576;204;631;1339;4508;1543;5139
292937;201302;3079;8381;2667;7845;374;1211;1938;5655;2312;6866
292940;201302;2935;8520;2390;7772;274;921;1670;5665;1944;6586
292950;201302;7817;24964;7547;24488;1180;4448;5311;16806;6491;21254
292960;201302;4348;12711;4149;12433;520;1676;3065;9149;3585;10825
292970;201302;4034;13183;3777;12858;223;888;3207;10954;3430;11842
292975;201302;2909;8871;2830;8739;345;1206;2214;6769;2559;7975
292980;201302;3450;10219;2887;9544;414;1641;2020;6611;2434;8252
292990;201302;11425;34138;10914;33420;798;2526;9477;29255;10275;31781
293000;201302;2748;7754;2376;7258;150;551;2042;6193;2192;6744
293010;201302;16189;50416;15195;48656;3156;11058;9429;29972;12585;41030
293015;201302;7601;26087;6236;24130;1077;4482;4230;16337;5307;20819
293020;201302;9185;31099;8650;30328;663;2604;7187;25475;7850;28079
293030;201302;5402;16351;4491;15012;529;1884;3148;10865;3677;12749
293040;201302;3533;11783;3429;11666;258;926;2973;10150;3231;11076
293050;201302;17747;53602;16181;51506;2197;7077;11718;38224;13915;45301
293060;201302;4190;11009;3633;10130;429;1307;2531;6995;2960;8302
293070;201302;18235;58433;17462;57082;4755;16280;9940;32867;14695;49147
293075;201302;3583;11401;3294;11078;184;602;2945;10041;3129;10643
293076;201302;3544;10617;3367;10341;303;859;2820;8891;3123;9750
293077;201302;5147;16200;4527;15436;678;2486;3299;11286;3977;13772
293080;201302;4615;15211;4280;14636;378;1630;3308;11089;3686;12719
293090;201302;3479;11233;2916;10458;271;1053;2355;8536;2626;9589
293100;201302;5423;17331;4796;16238;513;1908;3622;12439;4135;14347
293105;201302;3591;12661;3251;11995;457;1902;2320;8601;2777;10503
293110;201302;1876;5823;1805;5717;111;405;1534;4864;1645;5269
293120;201302;3827;13340;3598;13027;355;1303;2879;10604;3234;11907
293130;201302;3794;11489;3132;10746;207;804;2714;9469;2921;10273
293135;201302;22394;66651;19581;62842;3952;15188;11331;35494;15283;50682
293140;201302;1944;6170;1898;6096;202;825;1469;4587;1671;5412
293150;201302;5677;19053;5262;18271;952;3391;3377;12091;4329;15482
293160;201302;2888;9360;2781;9235;317;840;2267;7874;2584;8714
293170;201302;3294;10446;3124;10187;453;1574;2327;7725;2780;9299
293180;201302;5141;14966;4433;13916;464;1711;3448;10672;3912;12383
293190;201302;12787;40841;12419;40222;691;2983;10723;34108;11414;37091
293200;201302;5827;18256;5323;17441;365;1450;4570;14797;4935;16247
293210;201302;4530;14311;4317;13956;555;1929;3117;10211;3672;12140
293220;201302;4672;15270;4431;14935;1212;4213;2482;8593;3694;12806
293230;201302;3929;12723;3679;12382;385;1492;2983;9987;3368;11479
293240;201302;4326;11572;3497;10489;221;689;2807;8496;3028;9185
293245;201302;4230;12801;3919;12286;530;1731;2776;8953;3306;10684
293250;201302;5711;17139;5384;16686;888;2812;3835;12107;4723;14919
293260;201302;4522;14142;3856;13165;367;1398;2924;10133;3291;11531
293270;201302;5544;15806;5337;15581;508;1454;4593;13584;5101;15038
293280;201302;5402;16264;4850;15518;464;1424;3793;12580;4257;14004
293290;201302;15502;54744;15106;53920;2990;10765;10107;36979;13097;47744
293300;201302;5838;15732;5151;14971;557;1556;4034;12011;4591;13567
293305;201302;4331;11727;4034;11325;449;1380;3121;8828;3570;10208
293310;201302;2620;7033;2219;6384;334;1068;1470;4188;1804;5256
293315;201302;4626;12356;4223;11714;801;2209;2567;7512;3368;9721
293317;201302;2414;7500;2235;7158;332;1114;1460;4708;1792;5822
293320;201302;7952;26347;7762;26080;846;3154;6321;21142;7167;24296
293325;201302;1846;5639;1550;5171;266;958;1018;3457;1284;4415
293330;201302;50823;168055;46578;160888;10845;40599;26549;92985;37394;133584
293340;201302;2591;7706;2104;6871;267;1029;1488;4774;1755;5803
293345;201302;3171;10131;2679;9403;401;1464;1790;6497;2191;7961
293350;201302;6510;18652;6291;18389;341;943;5701;16903;6042;17846
293360;201302;13070;40992;12126;39738;855;2816;10232;34301;11087;37117
310010;201302;1210;3393;884;2866;260;989;391;1177;651;2166
310020;201302;3650;11931;3184;10911;1197;4403;683;2145;1880;6548
310030;201302;2325;8100;2118;7704;763;2904;824;3064;1587;5968
310040;201302;889;2590;757;2406;129;485;485;1490;614;1975
310050;201302;1924;7016;1716;6497;375;1626;852;3205;1227;4831
310060;201302;2880;10590;2812;10495;305;1217;2321;8722;2626;9939
310070;201302;295;908;220;758;44;189;87;264;131;453
310080;201302;705;2250;588;2022;173;679;200;652;373;1331
310090;201302;4212;13619;3799;12903;742;2803;2392;8134;3134;10937
310100;201302;2971;10062;2684;9657;502;1917;1789;6528;2291;8445
310110;201302;5635;16532;4802;15303;1221;4400;2590;8183;3811;12583
310120;201302;539;1824;518;1792;238;941;194;590;432;1531
310130;201302;450;1492;414;1434;118;463;209;695;327;1158
310140;201302;255;898;221;832;79;335;46;151;125;486
310150;201302;4400;14604;4061;13970;933;3715;2218;7552;3151;11267
310160;201302;6359;21285;5720;20250;1671;6615;2804;9778;4475;16393
310163;201302;559;2052;536;2013;152;646;270;1005;422;1651
310170;201302;9264;27869;8619;26872;1908;6346;5125;16556;7033;22902
310180;201302;1720;5271;1412;4888;345;1374;805;2730;1150;4104
310190;201302;2386;8316;2207;8035;710;2896;397;1506;1107;4402
310200;201302;1740;6109;1500;5611;529;2145;466;1721;995;3866
310205;201302;878;2931;810;2787;155;557;514;1806;669;2363
310210;201302;2235;7565;2095;7329;422;1594;1381;4845;1803;6439
310220;201302;1222;3575;991;3286;176;650;657;2165;833;2815
310230;201302;2668;9317;2414;8737;856;3519;814;2685;1670;6204
310240;201302;983;3596;840;3304;140;607;503;2077;643;2684
310250;201302;903;3302;884;3271;193;800;534;1915;727;2715
310260;201302;3148;10681;2805;9981;985;3845;998;3439;1983;7284
310270;201302;2153;7076;2001;6861;332;1248;1408;4914;1740;6162
310280;201302;1984;6117;1810;5830;639;2426;660;1937;1299;4363
310285;201302;2230;8158;2142;8046;284;1030;1630;6336;1914;7366
310290;201302;1287;4245;1202;4111;411;1650;544;1645;955;3295
310300;201302;1807;6464;1722;6278;515;2061;934;3354;1449;5415
310310;201302;356;1033;278;861;56;202;138;407;194;609
310320;201302;323;1195;296;1123;80;326;139;532;219;858
310330;201302;448;1212;355;1054;52;196;219;612;271;808
310340;201302;7892;26512;7180;25380;1291;4909;4598;16664;5889;21573
310350;201302;13074;40563;11152;37092;4220;15208;2937;9832;7157;25040
310360;201302;430;1455;422;1440;107;423;254;824;361;1247
310370;201302;1340;5070;1300;4986;488;1903;532;2097;1020;4000
310375;201302;1208;3337;952;2939;133;500;588;1789;721;2289
310380;201302;368;1110;319;1046;148;542;124;371;272;913
310390;201302;417;1564;367;1460;134;576;85;334;219;910
310400;201302;9290;29458;7735;26614;2866;10790;1957;6527;4823;17317
310410;201302;1014;3302;683;2828;304;1344;133;540;437;1884
310420;201302;5248;15768;3062;10469;890;3434;417;1277;1307;4711
310430;201302;1461;5223;1277;4813;482;1937;374;1397;856;3334
310440;201302;609;1840;535;1724;172;634;195;589;367;1223
310445;201302;1151;4053;996;3777;161;686;626;2415;787;3101
310450;201302;4200;13353;3564;12363;771;2884;2167;7703;2938;10587
310460;201302;1385;4716;1233;4445;525;2024;296;1130;821;3154
310470;201302;3627;9872;3106;9234;331;1198;2466;7260;2797;8458
310480;201302;957;3149;869;3003;246;967;383;1254;629;2221
310490;201302;3099;10900;2693;10092;933;3722;930;3577;1863;7299
310500;201302;1372;4997;1294;4848;469;1875;467;1759;936;3634
310510;201302;2413;8194;2139;7568;894;3438;495;1658;1389;5096
310520;201302;1211;3622;1101;3440;80;292;751;2345;831;2637
310530;201302;758;2550;525;1929;129;530;90;306;219;836
310540;201302;3548;12058;3322;11742;1227;4597;1214;4374;2441;8971
310550;201302;1022;3412;888;3182;349;1392;265;909;614;2301
310560;201302;15011;49077;13268;45704;4639;17669;4611;15221;9250;32890
310570;201302;1215;3949;1150;3859;188;731;828;2724;1016;3455
310590;201302;3839;11838;3146;10468;768;2943;1130;3547;1898;6490
310600;201302;1586;5462;1525;5317;533;2088;530;1733;1063;3821
310610;201302;518;1821;474;1722;175;739;158;519;333;1258
310620;201302;184418;611421;154158;548265;50110;195408;56747;194936;106857;390344
310630;201302;3835;13296;3653;12945;1073;4213;1996;6851;3069;11064
310640;201302;1327;4383;1138;4021;367;1417;407;1367;774;2784
310650;201302;2663;9410;2281;8782;505;2080;1316;5259;1821;7339
310660;201302;1244;4066;1122;3893;226;899;775;2615;1001;3514
310665;201302;1074;3575;1005;3483;209;773;643;2258;852;3031
310670;201302;52998;173420;50012;166563;16326;57647;22705;74228;39031;131875
310680;201302;782;2430;721;2333;161;575;410;1283;571;1858
310690;201302;1115;3947;947;3569;287;1272;243;856;530;2128
310700;201302;466;1352;406;1259;95;333;209;625;304;958
310710;201302;6831;23523;5809;22133;1482;5881;3136;12649;4618;18530
310720;201302;788;2538;736;2459;226;830;378;1209;604;2039
310730;201302;8877;29619;8342;28809;1883;7048;5256;18262;7139;25310
310740;201302;4630;16497;4097;15383;1761;7156;943;3349;2704;10505
310750;201302;1425;4039;1242;3774;281;926;738;2256;1019;3182
310760;201302;589;1934;522;1827;156;588;204;698;360;1286
310770;201302;664;2548;657;2537;237;984;320;1220;557;2204
310780;201302;3425;10479;3213;10163;274;800;2728;8790;3002;9590
310790;201302;1606;5455;1518;5325;489;1771;793;2873;1282;4644
310800;201302;3037;10297;2559;9328;1140;4516;470;1727;1610;6243
310810;201302;1488;4290;1405;4158;293;968;810;2362;1103;3330
310820;201302;1414;4248;1098;3719;346;1296;420;1374;766;2670
310825;201302;2128;7879;1840;7359;182;898;1362;5432;1544;6330
310830;201302;1463;5147;1254;4711;500;2010;472;1756;972;3766
310840;201302;2109;7364;1960;7063;755;2984;647;2223;1402;5207
310850;201302;1393;4541;1227;4307;273;1059;723;2529;996;3588
310855;201302;2903;9914;2665;9501;805;2983;1298;4849;2103;7832
310860;201302;7491;24577;6834;23478;1205;4453;4123;14498;5328;18951
310870;201302;933;2989;847;2827;184;696;453;1525;637;2221
310880;201302;1210;3892;927;3346;205;837;449;1632;654;2469
310890;201302;2530;8424;2056;7514;708;2865;378;1325;1086;4190
310900;201302;3919;13920;3570;13184;1164;4733;1483;5321;2647;10054
310910;201302;1724;5461;1419;4947;459;1784;494;1703;953;3487
310920;201302;1708;5664;1451;5295;442;1806;698;2491;1140;4297
310925;201302;882;3033;800;2886;334;1304;221;809;555;2113
310930;201302;4727;15559;4276;14841;1056;3744;2482;8827;3538;12571
310940;201302;6020;18734;5318;17641;969;3741;3204;10417;4173;14158
310945;201302;1267;3771;1037;3453;244;939;580;1885;824;2824
310950;201302;1691;6124;1497;5727;690;2832;397;1468;1087;4300
310960;201302;426;1502;385;1423;146;595;123;451;269;1046
310970;201302;1436;5192;1127;4328;467;1928;161;587;628;2515
310980;201302;432;1187;319;983;67;242;139;387;206;629
310990;201302;1068;3825;945;3578;229;1009;371;1306;600;2315
311000;201302;4612;16623;4173;15698;1400;5799;1508;5510;2908;11309
311010;201302;901;3029;800;2847;239;890;382;1344;621;2234
311020;201302;853;2781;740;2583;85;348;518;1794;603;2142
311030;201302;1630;5341;1396;4821;478;1808;532;1667;1010;3475
311040;201302;449;1604;411;1510;142;553;123;433;265;986
311050;201302;2412;8083;2030;7279;733;2845;696;2502;1429;5347
311060;201302;2058;6770;1753;6092;549;2053;426;1462;975;3515
311070;201302;1676;6149;1485;5741;491;2125;452;1730;943;3855
311080;201302;1193;3325;1082;3163;179;614;720;2109;899;2723
311090;201302;1549;6161;1372;5792;520;2457;329;1335;849;3792
311100;201302;2123;7771;1967;7461;964;3781;537;2080;1501;5861
311110;201302;3571;9106;2778;8058;658;2184;1497;4197;2155;6381
311115;201302;1058;3431;925;3226;131;546;629;2222;760;2768
311120;201302;7971;24584;6961;22767;2551;9391;2151;6576;4702;15967
311130;201302;2330;7353;1921;6842;712;2831;785;2729;1497;5560
311140;201302;1156;3564;1011;3397;200;773;685;2241;885;3014
311150;201302;2321;7840;2147;7564;523;1858;1208;4430;1731;6288
311160;201302;4693;16470;4059;15467;1563;6314;1424;5443;2987;11757
311170;201302;683;2275;588;2080;84;326;354;1304;438;1630
311180;201302;1493;4280;1087;3458;355;1231;216;605;571;1836
311190;201302;1070;3353;927;3059;230;855;459;1486;689;2341
311200;201302;2426;7721;2182;7247;1012;3640;513;1550;1525;5190
311205;201302;1122;3853;1022;3668;266;1085;401;1507;667;2592
311210;201302;900;3038;842;2940;128;452;630;2246;758;2698
311220;201302;854;2886;729;2607;205;760;241;854;446;1614
311230;201302;8439;26804;7438;25107;1605;5989;4138;14210;5743;20199
311240;201302;1269;4101;1120;3852;407;1575;360;1193;767;2768
311250;201302;1279;4431;1164;4230;386;1516;373;1262;759;2778
311260;201302;2808;7946;2161;6793;701;2419;676;2009;1377;4428
311265;201302;1219;3468;982;3157;152;615;687;2170;839;2785
311270;201302;3194;11177;2934;10831;637;2639;1913;7061;2550;9700
311280;201302;1307;3755;1036;3304;308;1114;344;1076;652;2190
311290;201302;2264;7606;2119;7301;403;1375;1265;4560;1668;5935
311300;201302;4946;17230;4580;16689;623;2579;3289;12093;3912;14672
311310;201302;485;1784;466;1750;108;501;203;705;311;1206
311320;201302;3878;13579;3409;12510;1115;4619;1198;4194;2313;8813
311330;201302;5241;16745;4622;15812;1646;6100;1860;6309;3506;12409
311340;201302;12041;40624;11301;39218;4657;17255;3129;10945;7786;28200
311350;201302;2098;6734;1860;6325;464;1882;855;2768;1319;4650
311360;201302;1285;3754;1025;3399;482;1695;285;976;767;2671
311370;201302;4308;13565;3929;12907;1095;4253;1709;5463;2804;9716
311380;201302;448;1531;385;1408;135;538;115;389;250;927
311390;201302;1889;7313;1813;7153;828;3531;643;2512;1471;6043
311400;201302;1634;5697;1525;5501;506;2050;640;2131;1146;4181
311410;201302;1930;7205;1819;7046;721;2992;787;3045;1508;6037
311420;201302;2132;7744;1980;7374;794;3130;429;1439;1223;4569
311430;201302;3509;11630;2836;10117;745;2910;612;2141;1357;5051
311440;201302;2007;7424;1748;7022;846;3682;413;1660;1259;5342
311450;201302;2374;8730;2138;8205;927;3800;615;2264;1542;6064
311455;201302;1448;4052;1288;3814;246;887;733;2088;979;2975
311460;201302;575;1974;464;1732;138;614;116;417;254;1031
311470;201302;544;1821;468;1669;152;625;164;569;316;1194
311480;201302;743;2265;725;2235;233;766;349;1019;582;1785
311490;201302;302;1252;293;1218;104;451;101;429;205;880
311500;201302;474;1506;386;1326;190;706;82;271;272;977
311510;201302;2935;9566;2508;8766;1054;4029;660;2205;1714;6234
311520;201302;657;2329;629;2271;255;992;259;907;514;1899
311530;201302;9360;26824;6774;22021;2279;8651;1744;5395;4023;14046
311535;201302;624;2040;490;1759;144;578;122;439;266;1017
311540;201302;667;2541;641;2502;231;934;310;1199;541;2133
311545;201302;1861;6485;1813;6406;386;1468;1171;4177;1557;5645
311547;201302;1622;4723;1425;4420;167;564;983;3083;1150;3647
311550;201302;3054;10713;2798;10221;1087;4423;878;3143;1965;7566
311560;201302;239;700;224;683;63;207;121;360;184;567
311570;201302;1815;4946;1601;4716;143;474;1373;4041;1516;4515
311580;201302;1944;4980;1819;4832;471;1257;1070;2903;1541;4160
311590;201302;332;1138;298;1090;105;439;99;344;204;783
311600;201302;1242;3933;1077;3724;247;834;633;2358;880;3192
311610;201302;3700;13124;3459;12752;919;3341;1885;7511;2804;10852
311615;201302;2316;8298;2141;8004;279;1111;1572;5996;1851;7107
311620;201302;407;1401;366;1339;92;403;192;673;284;1076
311630;201302;1440;4427;1259;4075;149;576;859;2743;1008;3319
311640;201302;724;2450;690;2397;103;399;526;1802;629;2201
311650;201302;2353;6987;1990;6378;338;1256;1148;3690;1486;4946
311660;201302;2350;8753;2227;8493;744;3205;681;2315;1425;5520
311670;201302;1220;4071;1094;3831;433;1672;390;1294;823;2966
311680;201302;2172;7170;1868;6773;307;1171;1310;4880;1617;6051
311690;201302;472;1432;416;1374;97;350;257;835;354;1185
311700;201302;2070;6351;1884;6082;224;895;1443;4587;1667;5482
311710;201302;1492;4945;1236;4475;510;1971;382;1419;892;3390
311720;201302;369;1303;355;1282;45;175;265;944;310;1119
311730;201302;2967;9799;2662;9320;908;3438;1195;4069;2103;7507
311740;201302;985;2943;863;2798;376;1196;394;1355;770;2551
311750;201302;3622;12807;3437;12563;620;2508;2342;8596;2962;11104
311760;201302;750;2712;703;2590;269;1133;196;591;465;1724
311770;201302;2544;8313;2166;7698;672;2707;748;2571;1420;5278
311780;201302;863;3425;755;3142;312;1429;87;351;399;1780
311783;201302;1970;6764;1796;6432;216;945;1168;4286;1384;5231
311787;201302;653;2305;519;1931;121;482;126;439;247;921
311790;201302;1030;3591;888;3279;302;1198;162;565;464;1763
311800;201302;4642;16710;4119;15287;1439;5653;756;2431;2195;8084
311810;201302;995;3426;975;3393;34;163;895;3083;929;3246
311820;201302;766;2609;684;2445;259;1061;291;936;550;1997
311830;201302;9838;36712;9314;35405;4099;16336;2489;9384;6588;25720
311840;201302;3256;10192;2782;9459;992;3687;997;3367;1989;7054
311850;201302;291;947;254;893;45;168;171;613;216;781
311860;201302;52664;176792;47642;166899;15382;58617;20017;68447;35399;127064
311870;201302;2180;6874;1876;6340;520;1984;783;2586;1303;4570
311880;201302;6366;21244;6016;20799;864;3160;4515;15920;5379;19080
311890;201302;1539;5079;1338;4674;444;1696;537;1825;981;3521
311900;201302;767;2479;696;2378;177;617;399;1432;576;2049
311910;201302;4509;13957;3725;12852;1229;4628;1502;5220;2731;9848
311920;201302;1875;6556;1670;6276;275;1181;1166;4303;1441;5484
311930;201302;4557;14320;4188;13724;1625;5769;1436;4718;3061;10487
311940;201302;13681;44129;12398;41546;4679;16921;3756;12541;8435;29462
311950;201302;2068;6663;1871;6405;161;599;1543;5305;1704;5904
311960;201302;323;1225;314;1211;113;452;153;589;266;1041
311970;201302;444;1672;398;1575;164;699;58;211;222;910
311980;201302;706;2076;566;1885;146;521;270;923;416;1444
311990;201302;443;1431;414;1379;184;626;149;497;333;1123
311995;201302;954;3026;775;2642;268;1042;258;762;526;1804
312000;201302;665;2171;639;2131;120;466;389;1286;509;1752
312010;201302;987;3332;922;3216;223;852;437;1521;660;2373
312015;201302;1525;5001;1346;4694;221;903;819;2880;1040;3783
312020;201302;848;2895;760;2768;242;978;358;1266;600;2244
312030;201302;1594;5387;1476;5226;243;1053;1047;3592;1290;4645
312040;201302;659;2615;612;2482;253;1098;170;683;423;1781
312050;201302;1467;5196;1293;4828;484;1996;363;1291;847;3287
312060;201302;752;2373;689;2296;229;834;371;1200;600;2034
312070;201302;766;2594;579;2167;197;805;204;739;401;1544
312080;201302;2492;7310;2017;6552;567;2265;888;2610;1455;4875
312083;201302;840;2617;728;2462;79;325;496;1667;575;1992
312087;201302;2216;7198;2007;6933;399;1425;1380;4877;1779;6302
312090;201302;9311;31458;8653;30312;2576;10222;3992;13416;6568;23638
312100;201302;1323;4672;1197;4480;258;1098;680;2595;938;3693
312110;201302;1172;4371;1075;4175;446;1888;233;852;679;2740
312120;201302;868;3091;790;2917;277;1183;226;734;503;1917
312125;201302;985;3360;883;3116;258;998;322;1082;580;2080
312130;201302;652;2164;556;1970;187;716;201;694;388;1410
312140;201302;1417;4578;1221;4118;330;1167;444;1431;774;2598
312150;201302;592;1757;529;1651;112;410;307;921;419;1331
312160;201302;7510;27312;7064;26423;2342;9403;2908;11237;5250;20640
312170;201302;990;3114;922;2981;169;588;568;1879;737;2467
312180;201302;1493;4937;1437;4854;551;1911;574;2006;1125;3917
312190;201302;550;1970;471;1815;209;836;135;528;344;1364
312200;201302;4185;13863;3731;12993;607;2271;2416;8519;3023;10790
312210;201302;1068;3143;892;2901;236;872;452;1420;688;2292
312220;201302;1697;5883;1569;5729;305;1113;1077;4159;1382;5272
312230;201302;16713;58197;14679;54018;7305;28447;2619;10008;9924;38455
312235;201302;1692;5008;1400;4541;174;717;966;3127;1140;3844
312240;201302;1075;3799;946;3532;301;1192;334;1262;635;2454
312245;201302;2276;6963;2025;6613;182;533;1674;5630;1856;6163
312247;201302;845;2658;687;2427;203;761;364;1332;567;2093
312250;201302;1055;3355;991;3255;203;799;596;1914;799;2713
312260;201302;868;2990;766;2857;120;547;545;1999;665;2546
312270;201302;760;2523;666;2333;197;825;204;602;401;1427
312280;201302;456;1619;419;1522;179;698;53;192;232;890
312290;201302;680;2492;638;2435;319;1338;115;432;434;1770
312300;201302;1029;3543;901;3252;328;1256;132;423;460;1679
312310;201302;881;3529;802;3319;283;1260;304;1247;587;2507
312320;201302;2302;6707;2046;6289;645;2307;797;2165;1442;4472
312330;201302;999;3322;966;3262;375;1390;370;1232;745;2622
312340;201302;285;787;272;770;38;139;215;586;253;725
312350;201302;352;952;339;934;48;154;276;734;324;888
312352;201302;1551;5364;1461;5230;551;2022;706;2588;1257;4610
312360;201302;3417;12122;3062;11385;1129;4495;703;2613;1832;7108
312370;201302;1539;5302;1431;5109;489;1971;576;1993;1065;3964
312380;201302;1830;5687;1742;5561;292;1022;1175;3813;1467;4835
312385;201302;1102;3771;1081;3740;151;635;816;2756;967;3391
312390;201302;1886;6725;1744;6429;648;2561;468;1679;1116;4240
312400;201302;3153;11049;2993;10731;1005;3728;1446;5296;2451;9024
312410;201302;9727;34179;8934;32544;3088;12255;2924;10376;6012;22631
312420;201302;3735;12703;3584;12526;683;2493;2535;9030;3218;11523
312430;201302;8135;25460;7226;24111;1539;5322;4430;15429;5969;20751
312440;201302;492;1719;437;1611;157;615;148;542;305;1157
312450;201302;1059;4133;1012;4011;494;1933;318;1300;812;3233
312460;201302;371;1208;334;1166;97;391;140;451;237;842
312470;201302;693;2068;494;1655;147;571;95;302;242;873
312480;201302;1201;3968;1062;3796;432;1614;413;1474;845;3088
312490;201302;2237;6080;1821;5552;339;1231;1065;3120;1404;4351
312500;201302;546;2061;516;2004;150;650;272;1046;422;1696
312510;201302;1672;6181;1503;5780;484;2089;428;1490;912;3579
312520;201302;355;1280;330;1228;128;504;105;392;233;896
312530;201302;531;1830;507;1778;120;486;255;849;375;1335
312540;201302;1438;4875;1225;4447;234;950;748;2691;982;3641
312550;201302;562;2026;539;1982;83;349;362;1323;445;1672
312560;201302;1736;5406;1642;5268;260;835;1169;3890;1429;4725
312570;201302;2582;8276;2303;7756;790;2881;669;2173;1459;5054
312580;201302;531;1847;431;1644;133;570;181;669;314;1239
312590;201302;1760;6282;1557;5823;563;2344;516;1806;1079;4150
312595;201302;1990;7039;1830;6674;345;1357;1152;4180;1497;5537
312600;201302;731;2796;695;2708;245;1056;235;856;480;1912
312610;201302;8081;26388;7103;24446;2794;10281;2037;6879;4831;17160
312620;201302;1759;5711;1458;5319;60;159;1301;4925;1361;5084
312630;201302;481;1678;451;1624;125;519;191;650;316;1169
312640;201302;535;1837;467;1707;120;511;230;802;350;1313
312650;201302;2225;6907;1632;5757;177;760;868;2991;1045;3751
312660;201302;1162;3443;1016;3244;227;827;580;1811;807;2638
312670;201302;5735;18947;5470;18534;821;3155;4019;13627;4840;16782
312675;201302;1420;4720;1302;4486;278;1034;753;2670;1031;3704
312680;201302;1619;5149;1469;4871;325;1207;831;2783;1156;3990
312690;201302;2269;6642;1962;6231;414;1577;1142;3453;1556;5030
312695;201302;846;3155;800;3080;142;570;534;2107;676;2677
312700;201302;1972;5998;1547;5208;358;1368;775;2556;1133;3924
312705;201302;1304;4094;1164;3905;230;780;763;2609;993;3389
312707;201302;1782;5729;1523;5284;391;1518;713;2484;1104;4002
312710;201302;7482;22300;5833;19349;2442;8939;1405;4380;3847;13319
312720;201302;722;2490;658;2372;199;789;261;883;460;1672
312730;201302;1740;4773;1396;4383;268;996;843;2619;1111;3615
312733;201302;1660;4686;1372;4155;143;543;946;2768;1089;3311
312735;201302;801;2652;720;2509;258;954;315;1073;573;2027
312737;201302;930;2375;691;2059;160;511;365;1126;525;1637
312738;201302;479;1585;396;1430;145;608;146;473;291;1081
312740;201302;468;1379;338;1236;142;561;124;453;266;1014
312750;201302;1251;4778;1206;4682;349;1478;574;2237;923;3715
312760;201302;2264;7719;1871;6968;681;2766;444;1701;1125;4467
312770;201302;40429;116378;32378;104740;10596;37137;10706;35066;21302;72203
312780;201302;2261;8942;2090;8656;439;1926;1280;5500;1719;7426
312790;201302;290;874;240;793;82;290;63;202;145;492
312800;201302;4717;17080;4276;16118;1488;5938;1390;5453;2878;11391
312810;201302;2126;6769;1696;6129;757;3000;526;1854;1283;4854
312820;201302;2001;6336;1920;6191;279;1064;1262;3959;1541;5023
312825;201302;1423;4095;1278;3915;145;510;1019;3079;1164;3589
312830;201302;2501;8353;1918;7197;661;2795;252;873;913;3668
312840;201302;1005;3603;891;3392;296;1251;271;966;567;2217
312850;201302;666;2303;598;2158;183;734;209;752;392;1486
312860;201302;1278;3817;1013;3452;367;1469;419;1277;786;2746
312870;201302;5281;17378;4250;15553;1547;6389;1330;4687;2877;11076
312880;201302;999;3200;871;2994;316;1211;350;1100;666;2311
312890;201302;1445;4707;1162;4195;456;1837;310;1068;766;2905
312900;201302;1261;4494;1230;4450;465;1707;566;2104;1031;3811
312910;201302;1389;3465;1190;3212;352;1158;582;1458;934;2616
312920;201302;861;3027;761;2873;271;1083;299;1164;570;2247
312930;201302;2067;6490;1884;6213;457;1613;995;3361;1452;4974
312940;201302;881;3112;794;2937;276;1161;243;853;519;2014
312950;201302;2952;9169;2617;8685;942;3351;1154;3849;2096;7200
312960;201302;1825;5818;1647;5577;217;737;1219;4247;1436;4984
312965;201302;1659;5657;1478;5333;365;1409;819;3027;1184;4436
312970;201302;1103;3878;991;3726;466;1946;159;601;625;2547
312980;201302;19434;71383;18893;70053;7803;30796;6900;25094;14703;55890
312990;201302;308;1011;252;924;105;425;70;250;175;675
313000;201302;465;1700;438;1651;163;711;116;404;279;1115
313005;201302;2421;8304;2175;7895;316;1341;1520;5475;1836;6816
313010;201302;3664;12818;3317;12221;1097;4459;1296;4489;2393;8948
313020;201302;1003;3440;930;3297;317;1290;356;1118;673;2408
313030;201302;1512;4446;1250;4067;350;1280;656;2041;1006;3321
313040;201302;915;3319;785;2934;200;833;203;709;403;1542
313050;201302;1731;6003;1488;5608;562;2304;420;1529;982;3833
313055;201302;1342;4760;1266;4646;121;443;981;3719;1102;4162
313060;201302;898;3255;856;3161;413;1574;159;592;572;2166
313065;201302;1807;6321;1706;6173;215;919;1330;4764;1545;5683
313070;201302;1104;3498;955;3227;259;1032;499;1583;758;2615
313080;201302;432;1463;364;1329;131;539;95;304;226;843
313090;201302;4541;15143;4396;14914;1125;3937;2649;9275;3774;13212
313100;201302;948;3267;898;3206;189;783;582;1985;771;2768
313110;201302;1595;4997;1295;4429;368;1470;507;1620;875;3090
313115;201302;2781;10287;2671;10066;977;4067;1112;3987;2089;8054
313120;201302;3594;10934;3154;10304;1160;3988;1419;4700;2579;8688
313130;201302;25021;83141;23181;79178;7303;27691;8600;27964;15903;55655
313140;201302;728;1972;539;1665;64;245;319;962;383;1207
313150;201302;1550;5061;1445;4862;691;2412;361;1249;1052;3661
313160;201302;1136;3575;1029;3412;284;1085;551;1750;835;2835
313170;201302;9076;34997;8680;33942;3806;15325;1893;7616;5699;22941
313180;201302;2546;7016;2016;6335;691;2437;685;2128;1376;4565
313190;201302;3175;12286;3097;12104;1069;4400;1222;4784;2291;9184
313200;201302;1396;4645;1264;4422;214;922;778;2706;992;3628
313210;201302;4424;14698;3816;13872;759;3146;2365;8535;3124;11681
313220;201302;1058;3494;928;3223;303;1205;223;676;526;1881
313230;201302;2304;8620;2221;8484;415;1651;1418;5678;1833;7329
313240;201302;6964;25691;6242;24258;2069;8702;2424;9453;4493;18155
313250;201302;7481;24634;7053;24110;806;2623;5477;19596;6283;22219
313260;201302;552;1846;490;1728;171;681;140;476;311;1157
313270;201302;5077;16157;4664;15530;1157;4085;2721;9274;3878;13359
313280;201302;504;1773;437;1612;119;507;165;593;284;1100
313290;201302;1014;3811;880;3545;347;1500;211;823;558;2323
313300;201302;1849;6592;1691;6224;559;2219;521;1827;1080;4046
313310;201302;1010;3686;928;3505;301;1278;230;822;531;2100
313320;201302;2289;7389;1989;6869;365;1337;1055;3723;1420;5060
313330;201302;3868;13481;3591;12972;848;3380;1835;6687;2683;10067
313340;201302;2071;5136;1634;4515;347;1062;952;2555;1299;3617
313350;201302;3200;10361;2572;8985;895;3440;581;1895;1476;5335
313360;201302;1115;3598;880;3113;322;1318;334;1058;656;2376
313370;201302;1367;4971;1321;4848;291;1249;633;2177;924;3426
313375;201302;1762;4914;1252;4233;290;1214;626;2060;916;3274
313380;201302;6238;22380;5535;20803;2399;9555;1361;4882;3760;14437
313390;201302;857;3288;821;3222;160;733;491;1898;651;2631
313400;201302;3531;11188;3295;10904;455;1594;2482;8326;2937;9920
313410;201302;1315;3960;1141;3732;244;876;715;2341;959;3217
313420;201302;17451;45906;11930;35740;3186;10868;3227;9289;6413;20157
313430;201302;1246;4274;1135;4076;384;1520;415;1467;799;2987
313440;201302;5890;15039;4657;13628;844;2678;3259;9550;4103;12228
313450;201302;665;2073;571;1896;178;708;184;547;362;1255
313460;201302;2572;9493;2362;9140;940;3894;749;2813;1689;6707
313470;201302;3303;9566;3160;9400;325;991;2624;7893;2949;8884
313480;201302;1082;3349;843;2912;204;795;333;1112;537;1907
313490;201302;1137;4446;1038;4171;471;1852;178;768;649;2620
313500;201302;417;1381;398;1350;106;408;225;747;331;1155
313505;201302;7617;24128;7230;23633;587;1608;6214;21097;6801;22705
313507;201302;1261;3995;1151;3826;272;1024;657;2204;929;3228
313510;201302;14942;46734;13526;44924;2698;9529;8874;29954;11572;39483
313520;201302;15159;48207;13430;45559;2007;7903;9202;31190;11209;39093
313530;201302;490;1783;437;1640;73;312;179;637;252;949
313535;201302;2370;7497;2161;7156;370;1354;1375;4593;1745;5947
313540;201302;1110;3593;937;3192;290;1062;267;859;557;1921
313545;201302;1331;5119;1204;4906;236;1146;765;3057;1001;4203
313550;201302;1820;6581;1779;6489;536;2131;948;3348;1484;5479
313560;201302;2168;5747;1965;5512;193;522;1605;4631;1798;5153
313570;201302;744;2918;675;2778;260;1145;280;1139;540;2284
313580;201302;5793;17534;5252;16836;558;1893;4219;13648;4777;15541
313590;201302;1032;3238;862;3041;313;1101;481;1777;794;2878
313600;201302;3747;11879;3359;11245;723;2675;1946;6562;2669;9237
313610;201302;1064;3537;948;3298;281;1060;362;1254;643;2314
313620;201302;7317;25173;6929;24330;2498;9358;2269;7830;4767;17188
313630;201302;7927;26254;7087;25033;2531;9758;2290;8439;4821;18197
313640;201302;817;2725;733;2615;269;1030;297;1067;566;2097
313650;201302;2246;7628;2032;7289;312;1154;1481;5462;1793;6616
313652;201302;944;3595;886;3459;188;775;513;2010;701;2785
313655;201302;898;3232;788;3060;186;818;498;1908;684;2726
313657;201302;1043;3748;1008;3685;190;896;660;2218;850;3114
313660;201302;839;3058;780;2956;226;989;390;1398;616;2387
313665;201302;3404;11816;3221;11446;972;3863;1382;4740;2354;8603
313670;201302;49141;149526;36619;128992;13188;50637;11323;38911;24511;89548
313680;201302;1045;3238;931;3074;111;390;687;2299;798;2689
313690;201302;822;3049;773;2968;253;978;317;1283;570;2261
313695;201302;1464;4994;1283;4711;216;937;894;3220;1110;4157
313700;201302;3647;12957;3183;12289;465;1932;2319;9017;2784;10949
313710;201302;1323;3940;1153;3698;321;1144;646;1999;967;3143
313720;201302;4835;17121;4368;16078;1333;5487;1347;4472;2680;9959
313730;201302;1200;3537;1009;3286;143;505;703;2333;846;2838
313740;201302;1937;7277;1622;6434;659;2906;258;996;917;3902
313750;201302;2805;8935;2521;8401;863;3160;692;2150;1555;5310
313753;201302;1730;5484;1529;5127;498;1798;678;2287;1176;4085
313760;201302;3994;14133;3670;13473;1384;5609;1216;4246;2600;9855
313770;201302;3619;12602;3472;12258;1297;4826;1046;3725;2343;8551
313780;201302;3609;11010;2992;10095;991;3737;1191;3954;2182;7691
313790;201302;550;1962;533;1934;108;428;316;1155;424;1583
313800;201302;1174;3529;1084;3392;181;667;744;2303;925;2970
313810;201302;1333;4455;1285;4379;370;1305;651;2279;1021;3584
313820;201302;12341;37708;10253;33895;3525;12959;3142;10277;6667;23236
313830;201302;448;1616;386;1482;154;668;101;362;255;1030
313835;201302;1040;3628;1004;3567;244;939;550;1959;794;2898
313840;201302;6667;21458;5904;20206;1907;7300;2204;7337;4111;14637
313850;201302;1211;3546;1117;3386;229;827;685;1977;914;2804
313860;201302;2441;7982;2188;7457;740;2844;537;1650;1277;4494
313862;201302;861;2609;645;2248;236;887;172;566;408;1453
313865;201302;2062;6979;1946;6775;359;1399;1286;4438;1645;5837
313867;201302;943;3432;827;3196;243;967;391;1555;634;2522
313868;201302;1373;5196;1274;4983;272;1150;763;3013;1035;4163
313870;201302;902;2872;801;2702;222;878;364;1150;586;2028
313880;201302;2209;7267;2029;7002;515;2092;1024;3258;1539;5350
313890;201302;1924;5586;1672;5285;196;649;1245;4021;1441;4670
313900;201302;4389;16727;4188;16319;1823;7759;1103;4328;2926;12087
313910;201302;724;2553;626;2340;297;1201;130;462;427;1663
313920;201302;3431;11683;3228;11333;556;1886;2129;7908;2685;9794
313925;201302;2071;5696;1578;4795;147;520;1053;3178;1200;3698
313930;201302;5043;17383;4399;16269;876;3568;2561;9676;3437;13244
313940;201302;7394;27147;6582;25815;2913;11984;2188;8973;5101;20957
313950;201302;4404;13715;3921;12935;1204;4385;1563;5148;2767;9533
313960;201302;5461;16110;4836;15208;1801;6251;1378;4443;3179;10694
313970;201302;1391;4323;1199;4104;281;1048;723;2480;1004;3528
313980;201302;1133;3930;977;3627;323;1325;237;855;560;2180
313990;201302;1978;7707;1803;7326;720;3151;528;2046;1248;5197
314000;201302;7355;26928;6919;26076;2200;8973;3328;12545;5528;21518
314010;201302;1013;3124;861;2936;188;704;454;1539;642;2243
314015;201302;1557;6024;1446;5765;612;2568;404;1641;1016;4209
314020;201302;475;1592;414;1453;165;637;136;456;301;1093
314030;201302;792;2650;638;2288;177;771;180;561;357;1332
314040;201302;671;2126;616;2037;75;284;463;1523;538;1807
314050;201302;1819;6169;1565;5646;523;2085;413;1371;936;3456
314053;201302;1223;4475;1177;4417;230;816;850;3284;1080;4100
314055;201302;2131;6690;1952;6454;238;810;1454;4924;1692;5734
314060;201302;1044;3498;921;3263;149;636;551;1903;700;2539
314070;201302;3527;11870;3003;10818;992;3952;951;3308;1943;7260
314080;201302;1707;5632;1358;4873;364;1510;354;1180;718;2690
314085;201302;1733;6584;1541;6320;558;2464;664;2767;1222;5231
314090;201302;3379;12007;3139;11540;1002;3860;1300;5001;2302;8861
314100;201302;3136;9309;2798;8822;370;1300;2085;6603;2455;7903
314110;201302;4269;14606;3805;13618;1043;4300;1500;4985;2543;9285
314120;201302;901;2255;537;1715;220;802;128;372;348;1174
314130;201302;546;1788;398;1431;143;573;83;274;226;847
314140;201302;4805;15822;4440;15151;1171;4352;2370;8156;3541;12508
314150;201302;1642;4580;1339;4133;224;756;830;2554;1054;3310
314160;201302;2071;6246;1839;5950;242;863;1427;4629;1669;5492
314170;201302;995;3303;887;3061;197;801;455;1484;652;2285
314180;201302;6224;21312;5775;20652;1758;6797;2693;9837;4451;16634
314190;201302;778;2574;700;2443;221;866;277;933;498;1799
314200;201302;2896;9926;2681;9535;470;1918;1788;6255;2258;8173
314210;201302;1853;6252;1709;5963;469;1781;867;2929;1336;4710
314220;201302;1581;5512;1415;5156;485;1940;511;1694;996;3634
314225;201302;1113;3602;1004;3447;61;182;902;3161;963;3343
314230;201302;679;2451;636;2365;224;902;220;786;444;1688
314240;201302;1055;3502;973;3366;173;586;653;2323;826;2909
314250;201302;469;1582;413;1477;155;626;155;514;310;1140
314260;201302;1245;4640;1203;4564;510;2042;432;1677;942;3719
314270;201302;2661;9623;2522;9365;403;1618;1623;6101;2026;7719
314280;201302;3059;9198;2332;7829;794;3047;628;1853;1422;4900
314290;201302;5162;15240;4523;14240;591;2061;3281;10352;3872;12413
314300;201302;1875;6605;1793;6418;613;2324;788;2807;1401;5131
314310;201302;6171;20773;5581;19455;2437;9027;1185;4017;3622;13044
314315;201302;939;3724;887;3616;180;816;499;2075;679;2891
314320;201302;3119;9976;2635;9301;1062;4048;791;2723;1853;6771
314330;201302;48896;167725;47145;164550;15716;59116;21949;76030;37665;135146
314340;201302;1859;5691;1279;4521;408;1629;175;453;583;2082
314345;201302;1260;4486;1142;4304;422;1621;519;2070;941;3691
314350;201302;1235;4063;1096;3821;491;1827;301;1070;792;2897
314360;201302;677;2275;541;2027;193;833;136;456;329;1289
314370;201302;526;1936;494;1894;165;690;252;949;417;1639
314380;201302;955;3159;797;2900;296;1118;307;1118;603;2236
314390;201302;14201;45408;12384;42022;4357;15959;3958;13333;8315;29292
314400;201302;5095;15145;4268;13967;989;3187;2805;9549;3794;12736
314410;201302;2419;8237;2204;7820;734;2940;900;3030;1634;5970
314420;201302;755;2314;640;2161;100;410;467;1543;567;1953
314430;201302;8108;25092;7350;23689;2592;9060;2373;7900;4965;16960
314435;201302;1087;3871;994;3665;245;1101;490;1694;735;2795
314437;201302;1110;2969;1010;2833;105;306;799;2253;904;2559
314440;201302;722;2044;502;1753;199;773;109;367;308;1140
314450;201302;1691;5250;1467;4930;490;1952;673;2103;1163;4055
314460;201302;4466;16069;4040;15138;1507;6119;791;3013;2298;9132
314465;201302;2321;7785;2141;7448;240;971;1642;5658;1882;6629
314467;201302;1033;3174;940;3020;439;1438;336;1112;775;2550
314470;201302;2284;7778;1816;6643;590;2462;398;1275;988;3737
314480;201302;6881;24609;5475;20812;1511;6199;598;2096;2109;8295
314490;201302;920;2947;807;2726;257;1007;322;1014;579;2021
314500;201302;2694;7955;2208;6994;716;2562;729;2260;1445;4822
314505;201302;1608;5431;1536;5290;388;1473;810;2751;1198;4224
314510;201302;1343;4537;1198;4258;536;1998;367;1290;903;3288
314520;201302;3442;14036;3030;12813;1252;5692;592;2374;1844;8066
314530;201302;6953;25913;6418;25024;1336;5424;3751;15245;5087;20669
314535;201302;2595;7839;2346;7512;379;1407;1572;5036;1951;6443
314537;201302;1403;4485;1212;4151;273;1027;638;2289;911;3316
314540;201302;453;1436;399;1310;130;489;119;362;249;851
314545;201302;1233;4235;1154;4105;249;965;673;2427;922;3392
314550;201302;494;1628;426;1534;167;702;118;400;285;1102
314560;201302;5065;18727;4420;16989;1427;5937;863;3314;2290;9251
314570;201302;371;1208;336;1138;101;369;158;507;259;876
314580;201302;445;1602;385;1484;167;705;88;323;255;1028
314585;201302;567;2199;512;2096;185;826;128;518;313;1344
314587;201302;1626;5554;1541;5362;270;1032;941;3258;1211;4290
314590;201302;3758;13676;3030;11691;869;3580;408;1455;1277;5035
314600;201302;1941;6936;1632;6383;660;2865;261;947;921;3812
314610;201302;7761;29072;7369;28140;2739;11246;2179;8153;4918;19399
314620;201302;1602;5105;1505;4985;241;775;1107;3790;1348;4565
314625;201302;1309;4513;1283;4459;273;917;848;3139;1121;4056
314630;201302;4867;15105;4298;14148;578;2182;3025;10087;3603;12269
314640;201302;790;2395;713;2259;263;908;219;653;482;1561
314650;201302;1202;3872;1006;3479;297;1200;408;1275;705;2475
314655;201302;1657;5259;1375;4759;251;997;781;2677;1032;3674
314660;201302;127;410;121;398;20;72;84;280;104;352
314670;201302;1318;3929;1114;3576;271;979;532;1674;803;2653
314675;201302;1848;5880;1681;5585;227;825;1119;3793;1346;4618
314690;201302;2687;8832;2320;8185;781;3123;718;2390;1499;5513
314700;201302;9662;37907;8839;36199;4326;18378;2044;8936;6370;27314
314710;201302;6968;24238;5497;20845;1633;6910;757;2694;2390;9604
314720;201302;2518;8812;2162;8118;771;3168;895;3306;1666;6474
314730;201302;2307;7659;2030;7248;710;2819;632;2166;1342;4985
314740;201302;2861;10138;2674;9781;935;3673;1032;3701;1967;7374
314750;201302;307;1064;291;1030;63;272;160;539;223;811
314760;201302;1893;6976;1516;5937;383;1719;263;880;646;2599
314770;201302;1185;3882;847;2957;181;728;109;301;290;1029
314780;201302;280;823;218;744;79;299;87;298;166;597
314790;201302;12962;41192;10118;36081;4261;17066;2381;8023;6642;25089
314795;201302;1415;4650;1282;4443;176;780;941;3136;1117;3916
314800;201302;16433;52037;14084;47391;6071;21463;2915;10120;8986;31583
314810;201302;12293;39111;9940;34725;3521;13794;2526;8723;6047;22517
314820;201302;1024;3008;753;2651;330;1271;246;785;576;2056
314830;201302;1588;5676;1398;5294;543;2234;453;1725;996;3959
314840;201302;1126;4059;905;3728;195;905;531;2212;726;3117
314850;201302;2164;6573;1906;6179;401;1508;1070;3465;1471;4973
314860;201302;3150;11497;2982;11244;609;2475;1911;7301;2520;9776
314870;201302;5458;18576;4941;17841;920;3675;3198;11825;4118;15500
314875;201302;1646;5817;1619;5778;307;1031;1245;4570;1552;5601
314880;201302;710;2301;657;2188;177;605;329;1112;506;1717
314890;201302;550;1762;414;1488;181;723;99;303;280;1026
314900;201302;332;1120;287;1044;88;342;138;488;226;830
314910;201302;1653;5986;1490;5723;708;2936;356;1294;1064;4230
314915;201302;2333;7610;2109;7310;209;894;1725;5919;1934;6813
314920;201302;580;1837;501;1742;108;436;255;845;363;1281
314930;201302;4820;17103;4288;15933;1645;6678;855;3189;2500;9867
314940;201302;395;1221;377;1187;84;266;210;657;294;923
314950;201302;338;1275;296;1180;92;425;52;191;144;616
314960;201302;737;2519;642;2338;219;876;204;721;423;1597
314970;201302;780;2969;742;2912;342;1426;233;909;575;2335
314980;201302;2161;6818;1996;6557;900;3192;330;1047;1230;4239
314990;201302;2850;9646;2412;8660;1058;4124;362;1177;1420;5301
314995;201302;1424;4839;1330;4695;306;1290;815;2736;1121;4026
315000;201302;947;3076;851;2952;183;750;523;1752;706;2502
315010;201302;454;1554;391;1414;147;619;134;422;281;1041
315015;201302;1690;5516;1611;5425;351;1249;1113;3846;1464;5095
315020;201302;719;2509;655;2384;212;878;241;789;453;1667
315030;201302;989;3137;859;2893;357;1302;170;568;527;1870
315040;201302;898;2880;830;2766;118;449;584;1911;702;2360
315050;201302;1476;4676;1288;4350;518;1922;358;1152;876;3074
315053;201302;1044;3309;921;3108;278;1117;356;1123;634;2240
315057;201302;1846;6685;1538;6225;256;1065;1020;4305;1276;5370
315060;201302;927;3241;795;2891;265;1047;206;770;471;1817
315070;201302;589;1824;549;1765;146;512;335;1054;481;1566
315080;201302;3330;12014;3106;11575;951;3784;1387;5198;2338;8982
315090;201302;739;2735;667;2591;212;897;252;1019;464;1916
315100;201302;1128;4065;932;3618;286;1267;280;1050;566;2317
315110;201302;1493;4739;1339;4495;407;1463;564;1884;971;3347
315120;201302;11421;30719;9305;28040;1852;6156;5415;17025;7267;23181
315130;201302;1690;5831;1556;5570;619;2430;433;1513;1052;3943
315140;201302;2134;7505;1817;6804;586;2469;466;1529;1052;3998
315150;201302;4195;12214;3406;10840;929;3426;1306;3929;2235;7355
315160;201302;1291;3794;1183;3664;226;794;785;2375;1011;3169
315170;201302;1290;4038;1150;3853;303;1132;676;2297;979;3429
315180;201302;11952;39500;9999;35344;3242;13058;2629;8923;5871;21981
315190;201302;2278;6401;1867;5807;587;1973;841;2617;1428;4590
315200;201302;3987;14129;3536;13187;1200;4893;1022;3698;2222;8591
315210;201302;7977;26006;7140;24523;2927;10816;2120;7174;5047;17990
315213;201302;1007;3483;970;3424;147;528;704;2552;851;3080
315217;201302;2559;9156;2253;8606;420;1795;1369;5233;1789;7028
315220;201302;9695;30008;8786;28827;1189;4394;6375;21058;7564;25452
315230;201302;2209;6327;2082;6178;104;303;1843;5545;1947;5848
315240;201302;2965;10492;2838;10270;678;2622;1656;6018;2334;8640
315250;201302;7539;26272;6249;23944;2341;10009;2008;7629;4349;17638
315260;201302;1029;3585;906;3319;378;1517;156;527;534;2044
315270;201302;845;3090;739;2854;263;1086;154;552;417;1638
315280;201302;3660;11827;3141;10663;1203;4348;819;2663;2022;7011
315290;201302;1262;3756;1006;3354;430;1593;156;501;586;2094
315300;201302;441;1350;359;1247;198;733;77;248;275;981
315310;201302;1144;4024;1084;3935;149;631;751;2694;900;3325
315320;201302;755;2805;675;2677;259;1061;273;1143;532;2204
315330;201302;809;3042;683;2770;279;1240;167;693;446;1933
315340;201302;3969;11960;3469;11188;644;2233;2122;6938;2766;9171
315350;201302;1754;5257;1538;4963;185;557;1220;4087;1405;4644
315360;201302;1559;5528;1378;5056;383;1490;486;1724;869;3214
315370;201302;603;1863;537;1766;147;542;281;893;428;1435
315380;201302;271;995;254;945;97;375;47;175;144;550
315390;201302;1896;6914;1651;6299;607;2473;341;1287;948;3760
315400;201302;4248;14031;3982;13519;1189;4262;1961;6867;3150;11129
315410;201302;1533;4579;1302;4168;263;1027;734;2261;997;3288
315415;201302;1022;3651;965;3541;486;1829;302;1150;788;2979
315420;201302;1496;4828;1163;4256;404;1593;283;1003;687;2596
315430;201302;3846;11203;3092;9963;838;2921;1243;4085;2081;7006
315440;201302;937;2964;865;2869;120;454;605;2038;725;2492
315445;201302;1999;6214;1768;5908;310;1141;1213;4120;1523;5261
315450;201302;2428;8109;2332;7974;404;1414;1685;5906;2089;7320
315460;201302;36906;128054;33442;120609;11479;45074;10162;35390;21641;80464
315470;201302;459;1537;429;1488;109;414;230;772;339;1186
315480;201302;1398;4892;1124;4263;325;1336;246;913;571;2249
315490;201302;3150;9319;2832;8903;528;2040;1884;5700;2412;7740
315500;201302;452;1522;317;1167;78;337;128;413;206;750
315510;201302;1463;4456;1275;4137;196;775;797;2515;993;3290
315520;201302;1097;3647;946;3450;197;795;613;2191;810;2986
315530;201302;473;1713;451;1680;217;863;141;492;358;1355
315540;201302;1241;3912;1031;3598;216;936;481;1645;697;2581
315550;201302;1518;4764;1371;4565;465;1688;615;2025;1080;3713
315560;201302;6506;23444;6226;23055;947;3759;4527;16954;5474;20713
315570;201302;2300;7459;2188;7313;369;1372;1526;5116;1895;6488
315580;201302;2535;8270;2107;7444;644;2617;754;2555;1398;5172
315590;201302;851;2574;800;2497;113;428;588;1807;701;2235
315600;201302;2489;9455;2123;8902;330;1503;1416;6191;1746;7694
315610;201302;915;2878;810;2658;246;948;255;701;501;1649
315620;201302;323;1177;319;1169;114;439;140;515;254;954
315630;201302;969;3203;841;2990;254;932;253;907;507;1839
315640;201302;736;2417;650;2235;252;991;200;632;452;1623
315645;201302;738;2554;656;2326;259;1000;136;474;395;1474
315650;201302;1781;5644;1680;5511;162;695;1318;4223;1480;4918
315660;201302;2540;7388;2354;7147;325;1139;1753;5261;2078;6400
315670;201302;11003;40628;10216;39040;3921;16140;3332;12449;7253;28589
315680;201302;2746;10018;2334;9227;932;3857;619;2574;1551;6431
315690;201302;2758;9476;2436;8874;968;3844;619;2232;1587;6076
315700;201302;6717;22760;6080;21437;1470;5877;3068;10411;4538;16288
315710;201302;1794;5523;1487;5033;292;1194;796;2617;1088;3811
315720;201302;2641;9527;2468;9141;783;3276;835;2925;1618;6201
315725;201302;1520;4907;1261;4592;273;965;877;3274;1150;4239
315727;201302;620;2076;577;1976;149;547;306;1042;455;1589
315730;201302;963;3167;878;2990;248;892;422;1480;670;2372
315733;201302;1048;3550;981;3407;468;1710;307;1041;775;2751
315737;201302;1321;4272;1150;3984;166;646;742;2598;908;3244
315740;201302;980;3312;852;3060;285;1160;331;1117;616;2277
315750;201302;1033;3498;928;3359;140;582;655;2337;795;2919
315760;201302;746;2541;737;2525;54;184;654;2268;708;2452
315765;201302;1407;4663;1340;4538;194;686;990;3406;1184;4092
315770;201302;1552;5082;1467;4929;448;1623;716;2392;1164;4015
315780;201302;25925;88530;24638;85868;9436;34711;8597;30664;18033;65375
315790;201302;2935;10596;2787;10288;376;1343;1916;7305;2292;8648
315800;201302;1488;6023;1268;5362;442;2041;211;845;653;2886
315810;201302;1408;4353;1232;4070;220;895;794;2488;1014;3383
315820;201302;2942;10150;2614;9661;643;2554;1482;5554;2125;8108
315830;201302;1445;5033;1336;4799;379;1519;480;1685;859;3204
315840;201302;649;1884;524;1621;108;376;177;536;285;912
315850;201302;1336;4869;1292;4767;408;1569;498;1814;906;3383
315860;201302;379;1441;329;1338;100;447;115;486;215;933
315870;201302;451;1408;398;1324;94;355;188;610;282;965
315880;201302;977;2886;847;2726;265;926;450;1442;715;2368
315890;201302;1525;5496;1398;5313;364;1410;826;3280;1190;4690
315895;201302;4764;15549;4487;15010;1637;5958;1690;5552;3327;11510
315900;201302;713;2434;664;2350;217;869;298;983;515;1852
315910;201302;597;2189;550;2092;250;985;182;679;432;1664
315920;201302;1095;3661;993;3466;378;1411;425;1437;803;2848
315930;201302;1007;3051;898;2852;314;1089;331;1055;645;2144
315935;201302;1089;3855;1025;3714;374;1471;311;1117;685;2588
315940;201302;605;2022;573;1975;158;601;325;1090;483;1691
315950;201302;1159;3748;1096;3624;330;1113;591;2000;921;3113
315960;201302;2706;10007;2339;9193;1103;4825;302;1169;1405;5994
315970;201302;749;2227;628;2039;96;319;445;1482;541;1801
315980;201302;3760;9915;2839;8385;824;2820;953;2500;1777;5320
315990;201302;4167;13019;3719;12284;860;3304;2054;6684;2914;9988
316000;201302;552;1926;487;1797;253;981;105;395;358;1376
316010;201302;405;1541;364;1447;127;569;48;158;175;727
316020;201302;1159;3867;935;3480;203;823;510;1937;713;2760
316030;201302;3542;10467;2636;9036;397;1502;1453;5147;1850;6649
316040;201302;3233;10426;2478;8725;550;2213;582;1818;1132;4031
316045;201302;1987;6814;1894;6684;345;1056;1310;5056;1655;6112
316050;201302;319;1133;304;1103;63;256;180;648;243;904
316060;201302;762;2390;648;2238;136;577;409;1335;545;1912
316070;201302;5663;19791;5357;19185;1868;7329;2345;8076;4213;15405
316080;201302;685;2662;627;2499;185;821;158;617;343;1438
316090;201302;569;1762;453;1542;143;547;117;354;260;901
316095;201302;1108;3918;1055;3796;228;844;651;2435;879;3279
316100;201302;2795;9840;2360;8730;778;3201;551;1951;1329;5152
316105;201302;842;2498;681;2271;157;572;394;1334;551;1906
316110;201302;11571;43354;10733;41761;1510;6605;7863;30910;9373;37515
316120;201302;1254;4530;1229;4494;440;1642;605;2290;1045;3932
316130;201302;903;2378;712;2080;227;800;265;697;492;1497
316140;201302;969;3080;773;2755;183;706;373;1382;556;2088
316150;201302;1179;3884;1132;3810;329;1254;598;1931;927;3185
316160;201302;1168;3681;996;3341;138;514;604;2049;742;2563
316165;201302;825;2498;727;2331;129;469;430;1361;559;1830
316170;201302;1290;3981;1048;3520;252;997;466;1446;718;2443
316180;201302;1147;3818;997;3566;312;1340;379;1222;691;2562
316190;201302;2474;7823;1617;5750;393;1541;332;1035;725;2576
316200;201302;3972;13310;3244;11887;953;4117;1010;3479;1963;7596
316210;201302;4689;15830;4453;15396;2416;8846;1067;3781;3483;12627
316220;201302;605;1939;459;1686;146;604;74;297;220;901
316225;201302;943;3064;863;2945;178;683;508;1707;686;2390
316230;201302;409;1319;353;1220;66;252;199;693;265;945
316240;201302;5912;20282;5300;19559;614;2124;4266;16177;4880;18301
316245;201302;2639;10326;2527;10150;230;968;2078;8514;2308;9482
316250;201302;8001;26702;7399;25479;3524;12955;2084;6798;5608;19753
316255;201302;2219;7371;2016;7135;322;1090;1505;5464;1827;6554
316257;201302;1218;3632;981;3215;312;1146;312;962;624;2108
316260;201302;1652;4872;1257;4310;488;1817;554;1868;1042;3685
316265;201302;1121;3383;1016;3172;91;338;725;2219;816;2557
316270;201302;5155;17083;4848;16462;1550;5722;2024;6946;3574;12668
316280;201302;3144;10982;2860;10412;700;2864;1377;4978;2077;7842
316290;201302;2873;10100;2748;9858;853;3392;1177;4021;2030;7413
316292;201302;3552;12336;3319;11884;1023;4091;1416;4802;2439;8893
316294;201302;830;2893;571;2252;148;672;80;322;228;994
316295;201302;1799;6681;1682;6430;495;2139;766;2760;1261;4899
316300;201302;884;3099;815;2969;101;384;569;2140;670;2524
316310;201302;556;1978;506;1847;150;613;191;678;341;1291
316320;201302;518;1833;471;1768;174;723;183;653;357;1376
316330;201302;888;2795;791;2632;186;620;434;1505;620;2125
316340;201302;1065;3686;998;3560;385;1513;239;773;624;2286
316350;201302;1437;4925;1316;4718;264;977;751;2877;1015;3854
316360;201302;711;1970;582;1801;71;234;452;1401;523;1635
316370;201302;4718;16399;4352;15650;1534;5882;1171;4344;2705;10226
316380;201302;1286;3898;1116;3617;159;559;750;2443;909;3002
316390;201302;829;2664;720;2484;263;958;289;1033;552;1991
316400;201302;1419;4987;1284;4760;392;1547;580;2222;972;3769
316410;201302;1182;4177;1111;4065;222;893;704;2571;926;3464
316420;201302;1864;6707;1771;6568;309;1244;1152;4406;1461;5650
316430;201302;814;2626;724;2496;264;981;279;938;543;1919
316440;201302;555;1930;498;1855;182;804;246;829;428;1633
316443;201302;639;2072;564;1910;169;633;212;702;381;1335
316447;201302;1239;4334;1183;4228;213;822;845;3034;1058;3856
316450;201302;2091;7834;1897;7449;432;1636;1118;4662;1550;6298
316460;201302;761;2518;715;2445;207;808;409;1327;616;2135
316470;201302;6210;22865;5819;22066;2350;9920;1832;6561;4182;16481
316480;201302;249;906;224;854;74;304;73;266;147;570
316490;201302;338;1128;325;1102;133;467;131;449;264;916
316500;201302;1059;3966;772;3094;221;939;64;245;285;1184
316510;201302;880;3383;827;3260;380;1537;284;1154;664;2691
316520;201302;1080;3612;930;3383;331;1339;332;1151;663;2490
316530;201302;1172;3918;993;3523;289;1232;396;1218;685;2450
316540;201302;990;3355;897;3197;303;1274;302;978;605;2252
316550;201302;1193;4256;1098;4104;244;1019;693;2594;937;3613
316553;201302;2081;7964;1785;7180;689;2959;364;1461;1053;4420
316555;201302;2543;9569;2377;9374;196;742;1974;8023;2170;8765
316556;201302;579;1756;487;1568;67;271;306;926;373;1197
316557;201302;858;3197;836;3157;311;1200;430;1636;741;2836
316560;201302;340;1192;303;1123;86;380;100;344;186;724
316570;201302;1319;4452;1236;4276;246;938;755;2613;1001;3551
316580;201302;228;773;213;740;87;315;75;248;162;563
316590;201302;1242;4013;1093;3748;191;794;704;2385;895;3179
316600;201302;1093;3886;997;3668;273;1073;466;1669;739;2742
316610;201302;574;2280;547;2238;193;870;261;1047;454;1917
316620;201302;1946;6826;1838;6602;584;2226;762;2806;1346;5032
316630;201302;1333;4875;1256;4684;542;2156;345;1244;887;3400
316640;201302;248;850;227;810;76;319;86;282;162;601
316650;201302;899;3680;809;3522;201;860;437;2029;638;2889
316660;201302;119;398;109;379;31;137;49;153;80;290
316670;201302;1524;4831;1308;4402;496;1864;400;1251;896;3115
316680;201302;1741;5653;1640;5477;252;890;1231;4162;1483;5052
316690;201302;1001;3591;930;3490;410;1698;300;1091;710;2789
316695;201302;1229;3935;1115;3738;129;428;783;2744;912;3172
316700;201302;347;1222;326;1174;96;414;153;509;249;923
316710;201302;3301;13293;2928;12428;982;4361;946;4210;1928;8571
316720;201302;18939;66699;16893;62140;6493;25117;4711;17321;11204;42438
316730;201302;403;1353;357;1250;100;386;177;566;277;952
316740;201302;696;2568;657;2506;287;1160;170;615;457;1775
316750;201302;390;1451;365;1398;128;538;124;454;252;992
316760;201302;3446;12070;2976;11544;1766;6781;935;3891;2701;10672
316770;201302;1389;4372;1233;4151;263;983;749;2583;1012;3566
316780;201302;659;2373;626;2307;305;1185;161;580;466;1765
316790;201302;797;2436;600;2092;164;662;276;939;440;1601
316800;201302;5844;20189;5399;19333;1201;4988;2980;10355;4181;15343
316805;201302;872;2392;828;2334;151;419;600;1742;751;2161
316810;201302;469;1534;451;1508;139;518;232;753;371;1271
316820;201302;298;966;251;881;109;412;59;197;168;609
316830;201302;572;2143;553;2098;209;826;221;841;430;1667
316840;201302;3259;9947;2853;9305;902;3328;1177;3680;2079;7008
316850;201302;1994;6641;1860;6403;470;1797;930;3175;1400;4972
316860;201302;22697;73696;21326;71234;6356;23459;9797;32845;16153;56304
316870;201302;6672;23264;6076;21842;2482;9574;1380;4835;3862;14409
316880;201302;802;2879;781;2850;358;1398;204;731;562;2129
316890;201302;1307;3610;1062;3273;523;1765;300;883;823;2648
316900;201302;2427;8167;2270;7839;770;2952;671;2102;1441;5054
316905;201302;376;1406;359;1367;158;623;97;375;255;998
316910;201302;586;2174;532;2073;141;580;265;1042;406;1622
316920;201302;1364;4440;1094;3966;170;689;492;1803;662;2492
316930;201302;9048;32382;8291;30934;2824;11962;2839;10257;5663;22219
316935;201302;4638;14320;3490;12318;1290;5115;968;3257;2258;8372
316940;201302;6274;22355;5551;20842;1621;6937;1648;5865;3269;12802
316950;201302;1382;4367;1244;4184;246;946;791;2616;1037;3562
316960;201302;4943;13633;4288;12828;873;2877;2727;8230;3600;11107
316970;201302;3268;11463;3108;11153;1295;5180;954;3171;2249;8351
316980;201302;895;2943;747;2704;364;1406;212;769;576;2175
316990;201302;9151;32027;8543;30665;3727;14534;1448;4994;5175;19528
317000;201302;2364;9038;2301;8957;314;969;1884;7708;2198;8677
317005;201302;2054;7312;1990;7219;457;1762;1351;4852;1808;6614
317010;201302;25419;75627;18705;63505;5829;21925;4768;16797;10597;38722
317020;201302;36798;117714;27536;97686;8496;33163;5758;19288;14254;52451
317030;201302;861;2508;729;2308;137;526;417;1315;554;1841
317040;201302;11865;37996;10842;36143;4313;14928;3932;13556;8245;28484
317043;201302;704;2101;584;1936;252;879;186;630;438;1509
317047;201302;1113;3165;916;2854;176;610;438;1378;614;1988
317050;201302;1667;6363;1538;6073;545;2327;440;1656;985;3983
317052;201302;2209;7720;1991;7402;421;1617;1331;5091;1752;6708
317057;201302;1641;5063;1316;4511;228;929;700;2405;928;3334
317060;201302;375;1161;299;999;93;346;112;356;205;702
317065;201302;1185;4131;1102;4007;131;528;883;3234;1014;3762
317070;201302;8071;28534;6835;25817;2422;10066;1649;6212;4071;16278
317075;201302;1155;3906;1067;3761;428;1635;411;1408;839;3043
317080;201302;6641;20457;6287;19904;2152;7371;2700;8638;4852;16009
317090;201302;4500;16498;4277;16063;765;3025;2872;10960;3637;13985
317100;201302;3044;9431;2725;8921;922;3429;1238;3852;2160;7281
317103;201302;1946;7083;1684;6504;409;1868;833;3185;1242;5053
317107;201302;1187;4011;1081;3787;279;1162;522;1710;801;2872
317110;201302;580;1698;489;1570;161;604;204;588;365;1192
317115;201302;961;3228;884;3061;131;468;604;2102;735;2570
317120;201302;12241;43162;11084;40587;4153;16132;4179;15196;8332;31328
317130;201302;8454;28273;7817;27090;2303;8958;3446;11592;5749;20550
317140;201302;614;2265;575;2175;101;418;349;1317;450;1735
317150;201302;991;2844;849;2682;143;545;592;1836;735;2381
317160;201302;3612;10308;2892;9392;459;1742;1935;6180;2394;7922
317170;201302;1896;5941;1808;5764;285;1062;1107;3406;1392;4468
317180;201302;1626;5933;1364;5317;456;1914;357;1363;813;3277
317190;201302;1310;4162;1239;4063;123;470;1014;3313;1137;3783
317200;201302;4026;14308;3899;14033;1564;6043;980;3429;2544;9472
317210;201302;1023;3358;876;3112;303;1211;327;1110;630;2321
317220;201302;337;1262;332;1256;149;568;144;561;293;1129
320010;201302;5883;19023;5332;17741;849;3087;3126;10420;3975;13507
320013;201302;1754;5475;1432;4991;214;804;939;3333;1153;4137
320016;201302;3368;9735;2938;9133;498;1616;2033;6389;2531;8005
320020;201302;3972;13492;3727;12974;1411;5198;1355;4749;2766;9947
320030;201302;1678;5690;1573;5478;429;1631;773;2639;1202;4270
320035;201302;1514;5128;1399;4906;521;1956;415;1460;936;3416
320040;201302;2905;10246;2555;9430;814;3192;810;2974;1624;6166
320050;201302;1796;5414;1556;4905;377;1316;724;2254;1101;3570
320060;201302;9887;33214;8595;30369;2781;10627;2978;10177;5759;20804
320070;201302;1726;6042;1582;5699;587;2265;414;1409;1001;3674
320080;201302;4829;15338;4244;14211;1401;5100;1666;5453;3067;10553
320090;201302;7934;24040;6891;22255;1817;6404;3857;12238;5674;18642
320100;201302;3165;9802;2681;8868;706;2559;1262;4082;1968;6641
320110;201302;1499;4752;1393;4534;393;1393;502;1607;895;3000
320115;201302;1962;7444;1924;7352;592;2312;1113;4310;1705;6622
320120;201302;15896;56718;14506;53936;5757;22701;4225;15744;9982;38445
320130;201302;36371;127044;34751;123583;11744;44697;15669;55076;27413;99773
320140;201302;3888;13228;2946;10807;892;3567;382;1389;1274;4956
320150;201302;16902;50227;13037;42673;4734;16611;2047;6657;6781;23268
320160;201302;5301;16896;4720;15999;1237;4640;2406;7939;3643;12579
320170;201302;1891;6396;1758;6111;723;2593;513;1855;1236;4448
320180;201302;881;3037;812;2928;261;988;420;1522;681;2510
320190;201302;4010;15055;3757;14409;1520;6030;1093;4214;2613;10244
320200;201302;1049;3634;965;3468;313;1209;407;1492;720;2701
320210;201302;5964;17119;5248;15921;1463;4858;2545;7656;4008;12514
320220;201302;2639;8520;2103;7527;721;2807;688;2500;1409;5307
320225;201302;1341;4950;1232;4647;485;1944;252;961;737;2905
320230;201302;4044;14091;3819;13655;1335;5067;1465;5435;2800;10502
320240;201302;10143;34962;9128;33005;3619;13617;2326;8950;5945;22567
320245;201302;4022;14229;3852;13849;1250;4631;1859;6775;3109;11406
320250;201302;1592;5160;1270;4414;387;1508;288;906;675;2414
320255;201302;1887;6586;1682;6230;706;2752;588;2258;1294;5010
320260;201302;1312;4368;1151;3933;353;1332;438;1367;791;2699
320265;201302;2311;7448;1993;7054;279;1032;1467;5326;1746;6358
320270;201302;2060;7164;1970;6956;452;1644;1150;4130;1602;5774
320280;201302;7136;22017;6743;21536;1144;3794;4759;15714;5903;19508
320290;201302;1493;5310;1433;5145;572;2121;506;1798;1078;3919
320300;201302;4535;15730;4271;15271;1222;4542;2328;8448;3550;12990
320305;201302;4349;15011;4024;14214;1255;4868;1697;5830;2952;10698
320310;201302;1876;5920;1754;5746;403;1442;1058;3407;1461;4849
320313;201302;2050;6617;1644;5686;524;2104;263;818;787;2922
320316;201302;2187;7186;2103;6990;571;1994;1063;3546;1634;5540
320320;201302;16962;58004;15476;55142;4955;19761;6792;23460;11747;43221
320330;201302;2637;8729;2417;8277;678;2337;1215;4309;1893;6646
320332;201302;4871;17206;4593;16700;1446;5394;2178;8234;3624;13628
320334;201302;1929;6997;1698;6413;788;3149;340;1182;1128;4331
320335;201302;1785;5840;1560;5350;632;2323;296;979;928;3302
320340;201302;5191;15508;4407;14214;1009;3719;2332;7381;3341;11100
320350;201302;5224;13965;4042;12101;839;2911;2090;6093;2929;9004
320360;201302;1675;4686;1361;4131;305;1047;669;1941;974;2988
320370;201302;3383;11666;2977;10852;872;3328;1358;4978;2230;8306
320380;201302;2545;8379;2298;7849;773;2759;878;3011;1651;5770
320390;201302;7889;24907;6817;22838;1760;6627;3240;10638;5000;17265
320400;201302;4222;12601;3708;11916;648;2264;2516;8077;3164;10341
320405;201302;4133;12734;3878;12403;1016;3655;2339;7347;3355;11002
320410;201302;5565;14933;4353;13575;498;1485;3505;11201;4003;12686
320420;201302;2340;7646;1900;6967;919;3597;362;1311;1281;4908
320425;201302;2411;6355;2040;5859;320;1130;1351;3843;1671;4973
320430;201302;2159;6735;2022;6492;298;1119;1276;3997;1574;5116
320435;201302;1933;7131;1778;6743;502;1939;877;3448;1379;5387
320440;201302;1425;4991;1365;4835;437;1657;540;1860;977;3517
320450;201302;2231;7758;2072;7409;631;2443;950;3355;1581;5798
320455;201302;4181;15647;3573;14094;1214;4939;710;2809;1924;7748
320460;201302;2719;9490;2340;8688;877;3462;639;2280;1516;5742
320465;201302;1459;4896;1322;4562;236;854;708;2439;944;3293
320470;201302;3934;12826;3040;10807;1109;4253;473;1662;1582;5915
320480;201302;1945;6107;1656;5552;408;1613;775;2464;1183;4077
320490;201302;15986;54060;14227;50578;5210;19604;5219;19107;10429;38711
320495;201302;1485;5089;1371;4830;620;2313;390;1322;1010;3635
320500;201302;39022;130217;35713;123892;12819;47875;15282;51972;28101;99847
320501;201302;4073;13922;3857;13515;1479;5640;1557;5405;3036;11045
320503;201302;2155;8177;1927;7539;743;3041;545;2035;1288;5076
320506;201302;2970;9766;2229;7849;673;2518;425;1502;1098;4020
320510;201302;7634;25461;7074;24399;2623;9611;2581;8909;5204;18520
320515;201302;2005;5880;1837;5553;446;1404;927;2858;1373;4262
320517;201302;1949;6991;1790;6606;580;2245;719;2678;1299;4923
320520;201302;28111;95974;25173;90277;8988;35082;10716;38355;19704;73437
320530;201302;24876;81690;22075;76000;6844;26475;9439;31259;16283;57734
330010;201302;13305;45347;12618;43888;3424;13240;6576;22086;10000;35326
330015;201302;1867;5459;1656;5050;582;1967;515;1505;1097;3472
330020;201302;14960;47434;13894;45692;4099;14327;7118;23417;11217;37744
330022;201302;1293;4425;1208;4280;322;1328;634;2140;956;3468
330023;201302;3034;10300;2923;10080;873;3300;1285;4323;2158;7623
330025;201302;3033;9708;2853;9443;670;2404;1867;6149;2537;8553
330030;201302;6796;24501;6302;23446;2200;8892;2525;9014;4725;17906
330040;201302;13759;40194;11869;37269;3185;10865;6409;19797;9594;30662
330045;201302;56069;172101;52941;167623;8919;29979;36928;117848;45847;147827
330050;201302;2789;9365;2518;8804;1001;3888;731;2439;1732;6327
330060;201302;4953;16287;4565;15715;1230;4654;2619;9085;3849;13739
330070;201302;23932;77142;22177;73987;6893;24766;9568;31947;16461;56713
330080;201302;8650;26237;8340;25815;2237;6928;4993;16003;7230;22931
330090;201302;2951;8754;2836;8543;1001;3210;1238;3678;2239;6888
330093;201302;1812;5445;1638;5179;389;1340;896;2845;1285;4185
330095;201302;1143;4088;1071;3903;419;1706;221;701;640;2407
330100;201302;49114;173197;46977;169350;13017;51249;23655;85891;36672;137140
330110;201302;2556;8281;2354;7903;850;3066;713;2380;1563;5446
330115;201302;2386;7531;2243;7272;795;2826;893;2797;1688;5623
330120;201302;2297;7176;2140;6951;484;1724;1298;4165;1782;5889
330130;201302;3643;12540;3361;11971;1244;4701;1133;4088;2377;8789
330140;201302;3163;9990;2895;9619;737;2726;1466;4842;2203;7568
330150;201302;2799;8832;2309;7810;888;3245;498;1662;1386;4907
330160;201302;1272;4625;1208;4477;501;1992;343;1256;844;3248
330170;201302;92623;294767;87849;287434;13750;48778;63896;209162;77646;257940
330180;201302;1537;4946;1425;4739;294;1247;900;2750;1194;3997
330185;201302;7172;23857;6839;23296;2029;7185;3520;12426;5549;19611
330187;201302;3754;11289;3454;10784;871;3128;1858;5694;2729;8822
330190;201302;26512;83453;25537;81768;7162;24406;14443;45467;21605;69873
330200;201302;11744;38733;11146;37541;2486;8586;6602;22729;9088;31315
330205;201302;2471;6948;2264;6607;517;1757;1214;3427;1731;5184
330210;201302;4532;12280;3485;10350;1106;3626;1068;3141;2174;6767
330220;201302;10618;35007;10113;34028;3826;13907;3486;11370;7312;25277
330225;201302;3766;12397;3587;12117;692;2661;2405;8112;3097;10773
330227;201302;16956;48782;15641;47126;3111;10228;10456;30901;13567;41129
330230;201302;1470;4416;1371;4259;426;1502;637;1875;1063;3377
330240;201302;19268;61390;17392;58238;7486;27099;3400;11501;10886;38600
330245;201302;1109;3738;966;3457;325;1249;251;915;576;2164
330250;201302;34473;104822;33156;102817;7689;23959;21482;67941;29171;91900
330260;201302;3096;10199;2992;9998;855;3156;1501;4890;2356;8046
330270;201302;12622;39600;11532;37817;3619;12498;5050;16774;8669;29272
330280;201302;1806;6066;1600;5652;414;1687;813;2732;1227;4419
330285;201302;17010;52634;15787;50937;3671;12531;9891;32101;13562;44632
330290;201302;3328;9420;3019;9072;450;1563;2246;6621;2696;8184
330300;201302;4016;13725;3860;13461;1112;4086;1971;7088;3083;11174
330310;201302;2606;8064;2436;7764;676;2272;1200;3803;1876;6075
330320;201302;14679;44712;14026;43699;3915;12296;8101;26045;12016;38341
330330;201302;28673;86329;27062;83800;7426;24419;15714;48442;23140;72861
330340;201302;12952;41954;11033;38030;3568;13404;3577;12119;7145;25523
330350;201302;87476;292589;85596;289981;17262;58297;59779;207269;77041;265566
330360;201302;5052;16773;4942;16587;942;3409;3361;11215;4303;14624
330370;201302;3572;13768;3414;13344;1419;5787;1162;4558;2581;10345
330380;201302;3401;11833;3126;11385;1141;4247;1263;4902;2404;9149
330385;201302;3818;13744;3543;13172;1022;4083;1520;5660;2542;9743
330390;201302;21698;76181;20378;73630;5221;21020;10782;38272;16003;59292
330395;201302;3173;9996;3002;9706;538;1871;1935;6336;2473;8207
330400;201302;2364;8222;2160;7830;564;2317;992;3332;1556;5649
330410;201302;2795;9354;2503;8743;614;2305;1218;4240;1832;6545
330411;201302;2289;7540;2094;7167;524;2078;1023;3282;1547;5360
330412;201302;1304;4636;1074;4199;247;1119;477;1793;724;2912
330414;201302;24462;72095;21059;67529;4159;14442;13429;43243;17588;57685
330415;201302;3584;11549;3198;10843;857;3268;1385;4656;2242;7924
330420;201302;6035;21338;5333;19880;1917;7814;966;3726;2883;11540
330430;201302;7786;23991;7062;22706;1894;6769;3348;10447;5242;17216
330440;201302;2030;7004;1746;6427;590;2408;473;1682;1063;4090
330450;201302;1532;5561;1455;5388;503;2087;490;1759;993;3846
330452;201302;10167;32299;8628;29231;2526;9527;3653;11822;6179;21349
330455;201302;418854;1291021;370210;1211111;103663;361607;192212;629701;295875;991308
330460;201302;1366;4774;1287;4618;392;1589;602;2114;994;3703
330470;201302;3927;13753;3791;13475;1598;6036;1007;3523;2605;9559
330475;201302;7609;25639;7067;24800;1776;6722;4080;14511;5856;21233
330480;201302;6291;19507;5912;18809;1765;6076;2265;7155;4030;13231
330490;201302;91220;267643;85897;259952;13849;44289;63284;192167;77133;236456
330500;201302;6370;20007;5980;19228;1561;5356;2860;9525;4421;14881
330510;201302;38852;130764;37149;127902;13891;48503;17123;60911;31014;109414
330513;201302;1521;4743;1417;4543;434;1441;716;2339;1150;3780
330515;201302;2700;9099;2582;8893;818;3015;1203;4102;2021;7117
330520;201302;12390;38520;11757;37636;2538;8637;7716;24944;10254;33581
330530;201302;1532;4696;1428;4512;386;1348;768;2352;1154;3700
330540;201302;2995;9579;2671;9085;924;3370;995;3327;1919;6697
330550;201302;8476;28817;7666;27386;3016;11345;2315;8484;5331;19829
330555;201302;9575;30596;8848;29408;1984;6839;5479;18466;7463;25305
330560;201302;3892;12460;3674;12108;855;3268;2125;6817;2980;10085
330570;201302;3492;10482;3144;9936;824;2716;1735;5608;2559;8324
330575;201302;5026;15995;4742;15475;1099;3840;2876;9215;3975;13055
330580;201302;15074;51091;13687;48424;5204;19180;4595;16967;9799;36147
330590;201302;1878;5962;1780;5799;493;1686;945;3135;1438;4821
330600;201302;8625;27063;7570;25442;1284;5427;4919;15637;6203;21064
330610;201302;8340;28139;7753;27019;2444;9346;3493;12012;5937;21358
330615;201302;1641;5993;1531;5678;594;2285;637;2452;1231;4737
330620;201302;3789;13827;3563;13420;1287;4969;1478;5946;2765;10915
330630;201302;19111;65845;17815;62985;5489;21449;8184;27726;13673;49175
350010;201302;2804;9177;2313;8041;780;2915;457;1560;1237;4475
350020;201302;533;1620;439;1426;133;486;148;449;281;935
350030;201302;4086;13735;3814;13273;1515;5681;1461;5158;2976;10839
350040;201302;552;2096;497;1983;185;812;102;365;287;1177
350050;201302;1342;4584;1131;4185;335;1407;378;1331;713;2738
350055;201302;559;1986;539;1953;184;702;229;838;413;1540
350060;201302;72;253;68;247;23;104;23;72;46;176
350070;201302;2818;9717;2448;8921;697;2795;669;2247;1366;5042
350075;201302;447;1694;416;1624;177;730;114;400;291;1130
350080;201302;555;1714;478;1564;142;539;184;594;326;1133
350090;201302;573;1712;456;1514;133;467;154;506;287;973
350100;201302;1740;6296;1630;6070;637;2543;585;2142;1222;4685
350110;201302;433;1360;350;1171;110;417;109;321;219;738
350115;201302;1215;4189;1088;3858;271;1096;483;1585;754;2681
350120;201302;712;2067;559;1779;159;569;143;457;302;1026
350130;201302;3554;11331;3277;10789;955;3528;1325;4061;2280;7589
350140;201302;676;2189;620;2076;164;631;247;788;411;1419
350150;201302;355;1279;342;1251;172;632;70;280;242;912
350160;201302;6114;21046;5135;18844;1838;7359;1604;5449;3442;12808
350170;201302;2126;7846;1918;7313;766;3011;452;1681;1218;4692
350180;201302;1433;3842;1204;3442;295;876;547;1566;842;2442
350190;201302;2692;9947;2428;9391;878;3788;930;3278;1808;7066
350200;201302;384;1380;362;1356;149;612;140;509;289;1121
350210;201302;7268;21261;5991;18974;2487;8421;1914;5809;4401;14230
350220;201302;2991;9945;2714;9427;1076;4166;715;2231;1791;6397
350230;201302;704;2481;648;2387;255;1025;185;680;440;1705
350240;201302;587;1837;517;1720;132;509;268;860;400;1369
350250;201302;2613;9983;2511;9774;1136;4684;766;2974;1902;7658
350260;201302;931;2630;865;2536;234;709;394;1223;628;1932
350270;201302;5040;16332;4615;15469;1331;4863;2066;6895;3397;11758
350275;201302;1834;6259;1663;6030;515;2076;739;2544;1254;4620
350280;201302;20873;57781;14014;44574;3993;13625;3002;9685;6995;23310
350290;201302;1449;5174;1352;4943;496;1908;458;1727;954;3635
350300;201302;466;1527;431;1446;161;599;121;397;282;996
350310;201302;983;3405;929;3287;276;1132;363;1230;639;2362
350315;201302;537;1767;446;1567;90;393;156;501;246;894
350320;201302;10890;37185;10114;35350;3548;13163;1896;6472;5444;19635
350330;201302;8949;27439;8203;25873;1733;6307;4792;14184;6525;20491
350335;201302;531;1602;494;1528;141;457;189;642;330;1099
350340;201302;967;3192;786;2856;287;1123;171;592;458;1715
350350;201302;704;2354;629;2244;219;888;229;816;448;1704
350360;201302;652;2387;582;2237;194;807;211;811;405;1618
350370;201302;674;2159;513;1761;113;434;128;401;241;835
350380;201302;3367;11338;2882;10608;1404;5483;548;1983;1952;7466
350390;201302;7966;27055;7338;25956;1699;6732;4182;14248;5881;20980
350395;201302;292;975;236;846;79;300;38;132;117;432
350400;201302;7417;23048;6297;20956;2154;7718;2155;6953;4309;14671
350410;201302;6769;26087;6168;24720;2453;10502;1647;6479;4100;16981
350420;201302;1017;3340;850;2996;416;1545;75;264;491;1809
350430;201302;890;2877;786;2702;234;935;397;1311;631;2246
350440;201302;1330;4475;1268;4363;483;1742;559;1895;1042;3637
350450;201302;7835;24824;6806;22838;2493;9067;1959;6405;4452;15472
350460;201302;1354;4145;1016;3413;342;1266;268;766;610;2032
350470;201302;202;646;185;621;57;212;78;243;135;455
350480;201302;753;2418;530;1856;119;481;89;266;208;747
350490;201302;2021;6000;1797;5753;415;1519;1212;3814;1627;5333
350500;201302;597;1846;529;1742;160;586;248;780;408;1366
350510;201302;1079;3578;971;3371;337;1317;365;1170;702;2487
350520;201302;1247;4976;1161;4794;485;2089;293;1200;778;3289
350530;201302;2364;7331;1995;6508;782;2773;546;1628;1328;4401
350535;201302;1449;4337;1417;4293;92;286;1241;3802;1333;4088
350540;201302;1921;5852;1700;5482;490;1773;738;2337;1228;4110
350550;201302;10446;31820;8550;28517;2779;10362;2953;9197;5732;19559
350560;201302;3225;11020;3025;10721;593;2230;1903;6956;2496;9186
350570;201302;19523;69992;18133;66737;6460;25303;6379;22655;12839;47958
350580;201302;1878;6420;1659;5962;554;2192;287;903;841;3095
350590;201302;3847;13134;3134;11509;1038;4199;1115;3789;2153;7988
350600;201302;25709;78396;21418;70392;5247;19111;10408;33120;15655;52231
350610;201302;8714;26440;7316;24247;2113;7867;3560;11445;5673;19312
350620;201302;411;1386;368;1304;103;402;145;491;248;893
350630;201302;1543;5091;1265;4548;443;1810;134;440;577;2250
350635;201302;3525;13122;3357;12779;1237;4855;1389;5398;2626;10253
350640;201302;654;2154;626;2107;225;807;256;840;481;1647
350650;201302;4217;14435;3497;12813;1652;6475;417;1472;2069;7947
350660;201302;3527;11840;3153;11167;920;3489;1490;5224;2410;8713
350670;201302;1807;5902;1704;5716;367;1444;1087;3464;1454;4908
350680;201302;1101;3530;909;3155;280;1138;367;1212;647;2350
350690;201302;1013;3519;878;3225;302;1236;205;688;507;1924
350700;201302;2663;9589;2387;8953;944;3878;855;2886;1799;6764
350710;201302;1891;6221;1725;5962;400;1570;1029;3492;1429;5062
350715;201302;1095;3497;997;3300;252;969;421;1323;673;2292
350720;201302;121;398;115;382;47;160;42;131;89;291
350730;201302;376;1501;368;1475;133;583;87;325;220;908
350740;201302;2209;6843;2028;6426;634;2185;769;2433;1403;4618
350745;201302;339;1119;298;1020;76;300;135;422;211;722
350750;201302;8613;28012;7017;24703;2279;8793;1908;6317;4187;15110
350760;201302;10737;35888;9882;34373;3735;14242;3903;13014;7638;27256
350770;201302;817;2567;636;2192;164;644;207;708;371;1352
350775;201302;596;1831;539;1718;148;534;218;697;366;1231
350780;201302;1928;6112;1518;5255;355;1344;366;1257;721;2601
350790;201302;1993;6763;1673;6126;598;2322;416;1422;1014;3744
350800;201302;2784;10017;2671;9806;799;3272;1374;4885;2173;8157
350810;201302;2538;7594;2235;7031;781;2645;774;2521;1555;5166
350820;201302;490;1416;387;1203;90;337;144;387;234;724
350830;201302;832;2737;633;2240;132;502;134;435;266;937
350840;201302;2968;11382;2609;10403;1043;4492;563;2060;1606;6552
350850;201302;6234;21734;5481;20011;1954;7618;1716;6028;3670;13646
350860;201302;3066;10547;2971;10411;564;2210;2106;7309;2670;9519
350870;201302;2194;7989;2034;7740;796;3179;948;3646;1744;6825
350880;201302;1609;5621;1382;5095;475;1870;254;957;729;2827
350890;201302;596;1824;480;1574;104;372;144;386;248;758
350900;201302;4445;15299;3882;14124;1142;4523;1389;4786;2531;9309
350910;201302;842;2707;809;2636;346;1148;304;1015;650;2163
350920;201302;8760;27588;8247;26796;1541;5665;5385;16889;6926;22554
350925;201302;5140;16625;4715;15806;1484;5454;2070;6808;3554;12262
350930;201302;1394;4098;1188;3751;189;701;773;2350;962;3051
350940;201302;2241;7696;2065;7409;419;1772;1327;4564;1746;6336
350945;201302;900;3115;808;2914;247;973;308;1076;555;2049
350950;201302;64549;217214;57467;202853;18192;69761;23687;81554;41879;151315
350960;201302;4399;16042;3956;15089;889;3858;2110;7774;2999;11632
350970;201302;3965;15074;3689;14392;1544;6448;1150;4422;2694;10870
350980;201302;617;2095;591;2054;279;1055;132;466;411;1521
350990;201302;1673;6165;1527;5878;545;2249;600;2332;1145;4581
350995;201302;791;2978;753;2901;252;1085;332;1219;584;2304
351000;201302;3359;10788;2996;10070;555;2199;1717;5524;2272;7723
351010;201302;396;1264;302;1061;132;507;49;172;181;679
351015;201302;921;3193;816;2995;304;1263;246;837;550;2100
351020;201302;7278;25081;6568;23948;1819;7220;3614;13246;5433;20466
351030;201302;1270;4944;1195;4770;403;1747;408;1610;811;3357
351040;201302;3379;11346;3152;10952;863;3508;1784;5763;2647;9271
351050;201302;7566;26610;6790;25058;2725;10762;2234;8195;4959;18957
351060;201302;29404;95952;25192;88302;9262;34220;8431;30251;17693;64471
351070;201302;1686;5059;1306;4372;519;1913;272;812;791;2725
351080;201302;2581;8204;2104;7601;694;2711;813;2874;1507;5585
351090;201302;361;1306;301;1183;103;463;62;238;165;701
351100;201302;1734;5884;1649;5751;641;2284;683;2456;1324;4740
351110;201302;6893;21540;5692;19267;2103;7757;1753;5675;3856;13432
351120;201302;600;1935;527;1766;83;338;243;719;326;1057
351130;201302;970;2796;635;2150;187;740;185;539;372;1279
351140;201302;1930;6932;1784;6625;727;2938;572;2090;1299;5028
351150;201302;2009;7125;1713;6378;515;2111;452;1561;967;3672
351160;201302;1433;5222;1302;4904;475;1974;423;1553;898;3527
351170;201302;1383;4867;1214;4452;385;1519;461;1583;846;3102
351190;201302;1063;3507;985;3307;288;1051;253;803;541;1854
351200;201302;2151;6706;1899;6209;377;1464;975;2927;1352;4391
351210;201302;877;3076;811;2930;297;1145;257;896;554;2041
351220;201302;3353;11649;2923;10713;962;3810;998;3617;1960;7427
351230;201302;1774;6228;1617;5910;589;2333;681;2466;1270;4799
351240;201302;962;3276;715;2646;224;927;200;662;424;1589
351250;201302;782;2327;606;1977;145;513;266;835;411;1348
351260;201302;1187;3640;1067;3384;284;1000;428;1291;712;2291
351270;201302;374;1393;342;1323;133;582;109;384;242;966
351280;201302;4128;13563;3601;12288;1163;4243;1128;3510;2291;7753
351290;201302;940;2942;836;2726;297;1017;217;655;514;1672
351300;201302;9448;35904;8433;33510;2548;10954;3325;13178;5873;24132
351310;201302;3185;10347;2692;9429;796;3153;1180;3843;1976;6996
351320;201302;928;3450;853;3260;351;1443;180;601;531;2044
351330;201302;267;820;245;775;101;325;68;210;169;535
351340;201302;6127;22409;5739;21634;1648;6583;3105;11740;4753;18323
351350;201302;8852;30402;8110;28760;2663;9883;3173;10970;5836;20853
351360;201302;4792;15067;4546;14671;1232;4358;2419;7820;3651;12178
351370;201302;1820;6166;1495;5438;523;2111;361;1171;884;3282
351380;201302;35150;114792;33095;110536;9410;34472;15792;50651;25202;85123
351385;201302;228;762;226;758;101;341;64;235;165;576
351390;201302;1161;4088;1057;3867;445;1716;373;1326;818;3042
351400;201302;1153;3892;1088;3747;349;1298;461;1618;810;2916
351410;201302;2715;8769;2475;8329;655;2344;1167;3914;1822;6258
351420;201302;443;1329;308;1023;76;275;42;126;118;401
351430;201302;826;2722;746;2576;230;876;371;1232;601;2108
351440;201302;4524;14347;4062;13386;1673;5774;1108;3480;2781;9254
351450;201302;1771;5195;1579;4948;482;1515;881;2872;1363;4387
351460;201302;776;2515;650;2260;321;1197;180;571;501;1768
351470;201302;1026;3324;930;3147;414;1504;284;940;698;2444
351480;201302;2851;9690;2628;9311;731;3102;1263;4323;1994;7425
351490;201302;1850;6584;1691;6242;419;1793;884;3108;1303;4901
351492;201302;272;980;215;810;55;237;53;162;108;399
351495;201302;142;513;125;467;48;190;46;170;94;360
351500;201302;17136;58797;15568;55755;5215;19581;6553;23313;11768;42894
351510;201302;6930;23372;6149;22110;1547;6072;3392;12093;4939;18165
351512;201302;304;990;278;934;84;301;90;289;174;590
351515;201302;1738;6142;1553;5714;571;2274;453;1594;1024;3868
351518;201302;2153;7822;1751;7102;621;2749;312;1254;933;4003
351519;201302;695;2406;627;2251;212;856;262;929;474;1785
351520;201302;732;2201;383;1419;69;292;49;171;118;463
351530;201302;428;1388;386;1283;97;356;108;306;205;662
351535;201302;2466;6663;2095;6176;193;613;1657;4935;1850;5548
351540;201302;2004;6682;1831;6379;959;3484;377;1348;1336;4832
351550;201302;5632;17878;4576;15629;1788;6416;1092;3698;2880;10114
351560;201302;414;1397;369;1289;156;593;61;200;217;793
351565;201302;226;791;209;745;72;302;78;248;150;550
351570;201302;12318;41988;10959;39121;3830;14093;4502;16221;8332;30314
351580;201302;379;1140;308;973;62;225;110;316;172;541
351590;201302;431;1240;381;1121;145;463;107;295;252;758
351600;201302;1747;5359;1593;5056;453;1673;695;1987;1148;3660
351610;201302;613;1781;532;1633;125;440;275;799;400;1239
351620;201302;22243;76769;18816;69141;6777;26914;4750;16362;11527;43276
351630;201302;13877;48178;12786;46355;3487;13065;7238;26675;10725;39740
351640;201302;7735;26754;6741;24992;1957;7803;3406;12624;5363;20427
351650;201302;333;1041;249;841;61;224;60;197;121;421
351660;201302;914;3050;763;2690;199;798;232;741;431;1539
351670;201302;3991;13205;3466;12130;933;3662;1535;5098;2468;8760
351680;201302;660;2154;556;1912;167;605;164;559;331;1164
351685;201302;414;1281;328;1130;102;373;108;381;210;754
351690;201302;1263;3769;1024;3266;492;1585;254;774;746;2359
351700;201302;1372;4320;1261;4116;452;1550;400;1268;852;2818
351710;201302;762;2460;652;2218;187;665;175;542;362;1207
351720;201302;1466;4872;1202;4174;308;1199;406;1334;714;2533
351730;201302;977;3281;950;3232;314;1145;468;1626;782;2771
351740;201302;4368;13000;3846;11898;1167;3849;1303;3804;2470;7653
351750;201302;1462;5017;1279;4610;415;1614;310;1054;725;2668
351760;201302;3694;12412;3302;11519;900;3371;1501;5135;2401;8506
351770;201302;2059;7013;1794;6530;739;2766;736;2724;1475;5490
351780;201302;1532;4578;1169;3837;375;1332;322;1046;697;2378
351790;201302;1104;3440;951;3228;291;1081;471;1567;762;2648
351800;201302;297;753;264;689;41;145;160;361;201;506
351810;201302;1166;3701;1112;3633;292;1114;687;2112;979;3226
351820;201302;2379;7172;1675;5875;738;2760;193;660;931;3420
351830;201302;3773;12933;3478;12286;1020;3926;1472;5069;2492;8995
351840;201302;8545;30530;7751;28812;2704;10718;2701;9870;5405;20588
351850;201302;1118;4057;997;3785;323;1373;172;599;495;1972
351860;201302;3376;11267;3155;10841;798;3121;1805;5915;2603;9036
351870;201302;34021;109181;31630;105038;7256;26051;19528;64564;26784;90615
351880;201302;110493;372354;98894;348675;34005;125753;30987;109567;64992;235320
351885;201302;590;2274;551;2186;168;713;246;948;414;1661
351890;201302;801;2427;666;2133;249;848;156;493;405;1341
351900;201302;1426;4530;1286;4307;468;1662;542;1827;1010;3489
351905;201302;349;1308;303;1218;117;521;90;324;207;845
351907;201302;13323;44194;11704;40888;3061;11972;5260;17602;8321;29574
351910;201302;1087;3631;996;3450;273;1053;271;876;544;1929
351920;201302;1151;3452;1099;3375;281;989;659;1947;940;2936
351925;201302;957;2815;912;2742;101;403;711;2054;812;2457
351930;201302;3002;10699;2771;10182;920;3720;1053;3561;1973;7281
351940;201302;950;3038;900;2936;292;1046;508;1583;800;2629
351950;201302;965;3095;872;2916;245;911;353;1085;598;1996
351960;201302;3526;11840;3066;10895;1264;4728;978;3388;2242;8116
351970;201302;6503;25697;6179;24971;2506;10638;2083;8333;4589;18971
351980;201302;881;2834;759;2605;181;722;317;1024;498;1746
351990;201302;1461;4412;1244;3997;379;1367;397;1186;776;2553
352000;201302;2292;7651;2116;7280;549;2016;1004;3364;1553;5380
352010;201302;2239;7839;2067;7422;827;3079;465;1743;1292;4822
352020;201302;1415;4759;1304;4547;436;1602;424;1523;860;3125
352030;201302;4203;13844;3865;13410;878;3264;2329;8262;3207;11526
352040;201302;1571;5765;1382;5278;462;1870;324;1162;786;3032
352042;201302;1699;5201;1475;4789;390;1414;777;2504;1167;3918
352044;201302;1336;4835;1169;4377;378;1484;277;998;655;2482
352050;201302;6883;24040;5236;20280;1680;7256;1219;4266;2899;11522
352060;201302;768;2379;693;2263;225;837;257;759;482;1596
352070;201302;670;1906;629;1837;310;973;162;509;472;1482
352080;201302;521;1659;454;1539;129;496;162;501;291;997
352090;201302;1614;5387;1356;4860;378;1554;471;1535;849;3089
352100;201302;1665;5974;1505;5650;555;2327;537;1836;1092;4163
352110;201302;374;1470;346;1411;121;542;95;363;216;905
352115;201302;302;1023;257;929;85;361;118;379;203;740
352120;201302;1034;3079;905;2901;212;701;537;1798;749;2499
352130;201302;1591;4597;1269;4074;335;1218;613;1816;948;3034
352140;201302;1102;3813;967;3509;355;1357;351;1260;706;2617
352150;201302;615;1866;513;1685;208;739;169;530;377;1269
352160;201302;1127;3452;1058;3339;302;1047;536;1698;838;2745
352170;201302;2875;9353;2677;9024;722;2669;1356;4427;2078;7096
352180;201302;3303;9873;2934;9214;912;3133;1294;3869;2206;7002
352190;201302;938;3005;858;2865;253;1011;407;1204;660;2215
352200;201302;336;1209;286;1106;82;348;95;366;177;714
352210;201302;14225;40793;11753;37102;2422;8307;7220;23167;9642;31474
352215;201302;547;1834;499;1758;91;352;311;1106;402;1458
352220;201302;14450;49751;13660;48173;4755;17665;5845;20736;10600;38401
352230;201302;12999;46239;11670;43793;3934;16053;4544;16802;8478;32855
352240;201302;13453;43791;12589;42290;4298;15997;5218;17049;9516;33046
352250;201302;23049;78474;20658;74008;5783;22286;10039;35619;15822;57905
352260;201302;4520;14819;3561;13042;1122;4581;991;3288;2113;7869
352265;201302;910;3030;821;2898;155;604;546;1925;701;2529
352270;201302;2473;8636;2196;7958;916;3469;515;1803;1431;5272
352280;201302;2371;7650;2067;7139;608;2335;733;2468;1341;4803
352290;201302;1459;4920;1313;4607;377;1476;340;1137;717;2613
352300;201302;878;2756;763;2551;255;888;321;1086;576;1974
352310;201302;28279;102314;26338;98804;7964;31849;14578;53655;22542;85504
352320;201302;6672;21675;6000;20513;2320;8637;1946;6169;4266;14806
352330;201302;2112;7215;1867;6927;745;2981;686;2574;1431;5555
352340;201302;5472;19312;4658;17328;1720;6881;1046;3636;2766;10517
352350;201302;1575;6083;1442;5780;440;1887;465;1823;905;3710
352360;201302;1116;3874;995;3620;312;1319;491;1658;803;2977
352370;201302;864;2969;802;2837;219;884;378;1291;597;2175
352380;201302;971;3200;856;3002;360;1393;243;819;603;2212
352390;201302;11517;36628;9403;32664;2578;10226;4087;13219;6665;23445
352400;201302;2684;8339;1873;6768;538;2152;841;2995;1379;5147
352410;201302;4278;13269;3456;11881;1465;5379;993;3308;2458;8687
352420;201302;1266;3815;1184;3688;466;1595;431;1333;897;2928
352430;201302;5885;19313;5219;18161;2152;7979;1631;5631;3783;13610
352440;201302;14430;47343;12274;43051;3448;13175;5024;17068;8472;30243
352450;201302;586;1821;407;1480;114;436;80;278;194;714
352460;201302;2497;8826;2292;8463;915;3728;885;3085;1800;6813
352470;201302;4643;13427;2874;9741;649;2381;1264;4198;1913;6579
352480;201302;5268;15456;4472;13966;1330;4711;1856;5377;3186;10088
352490;201302;682;2513;588;2293;167;718;118;440;285;1158
352500;201302;9401;32237;8990;31523;3712;14092;3551;11641;7263;25733
352510;201302;3169;11459;2650;10309;1020;4253;650;2459;1670;6712
352520;201302;2291;8352;2106;7952;538;2208;1287;4792;1825;7000
352530;201302;6793;23208;5541;20435;1711;6890;1513;5271;3224;12161
352540;201302;497;1660;426;1514;113;454;178;628;291;1082
352550;201302;999;3464;829;3102;320;1300;199;719;519;2019
352560;201302;517;1640;452;1522;95;383;247;775;342;1158
352570;201302;1773;5774;1317;4712;352;1428;355;1094;707;2522
352580;201302;908;2818;797;2626;288;1078;325;994;613;2072
352585;201302;136;525;126;499;38;157;44;156;82;313
352590;201302;12956;43382;11681;40936;2873;11340;6337;21610;9210;32950
352600;201302;1769;5908;1660;5659;628;2250;580;1920;1208;4170
352610;201302;3474;11694;3146;11142;1299;4918;1059;3755;2358;8673
352620;201302;5117;17392;4910;17083;1305;4837;2982;10367;4287;15204
352630;201302;813;2809;777;2723;243;934;361;1241;604;2175
352640;201302;2874;9539;2341;8289;608;2408;841;2853;1449;5261
352650;201302;811;2483;620;2095;174;635;146;448;320;1083
352660;201302;1061;3839;887;3428;302;1261;288;1094;590;2355
352670;201302;7586;26359;6721;24761;2571;9771;2186;8220;4757;17991
352680;201302;3053;11454;2619;10258;740;3184;780;2800;1520;5984
352690;201302;22541;70121;18492;62594;5447;20132;7648;25362;13095;45494
352700;201302;721;2250;578;2028;164;672;262;880;426;1552
352710;201302;4677;14682;3693;12720;1124;4305;1371;4436;2495;8741
352720;201302;8152;29062;7766;28299;2706;10490;3125;11416;5831;21906
352725;201302;382;1177;268;906;57;227;56;180;113;407
352730;201302;2366;8464;2065;7629;609;2494;614;1982;1223;4476
352740;201302;2109;6560;1868;6081;516;1999;851;2496;1367;4495
352750;201302;339;1134;307;1076;121;453;56;158;177;611
352760;201302;827;3058;773;2955;223;952;410;1514;633;2466
352770;201302;866;2780;821;2690;258;915;277;925;535;1840
352780;201302;587;2095;524;1949;177;727;154;503;331;1230
352790;201302;607;1853;510;1694;168;635;122;403;290;1038
352800;201302;1033;4071;872;3589;310;1310;142;556;452;1866
352810;201302;951;2597;723;2175;143;494;303;888;446;1382
352820;201302;478;1541;422;1420;204;735;65;219;269;954
352830;201302;390;1197;310;1013;100;346;52;167;152;513
352840;201302;3180;11570;2821;10766;909;3709;1004;3833;1913;7542
352850;201302;9361;31632;8326;29763;2806;10561;2750;10142;5556;20703
352860;201302;1005;3449;929;3276;409;1535;234;752;643;2287
352870;201302;897;2563;756;2289;157;578;374;1038;531;1616
352880;201302;2055;6512;1720;5743;458;1660;431;1321;889;2981
352885;201302;290;1010;275;976;98;375;88;288;186;663
352890;201302;680;2043;600;1878;157;542;187;550;344;1092
352900;201302;17018;54383;13740;47570;4103;15417;5598;18676;9701;34093
352910;201302;282;927;250;854;80;284;40;117;120;401
352920;201302;3337;10556;2933;9732;982;3618;1038;3196;2020;6814
352930;201302;6603;21857;5372;19106;1796;6851;942;3229;2738;10080
352940;201302;26497;93515;23581;86438;8778;33749;5258;19193;14036;52942
352950;201302;309;1011;225;822;68;293;60;196;128;489
352960;201302;462;1544;387;1377;97;387;92;312;189;699
352965;201302;337;982;286;883;76;236;52;173;128;409
352970;201302;3285;8846;2929;8386;337;1023;2211;6468;2548;7491
352980;201302;1343;4203;1190;3947;408;1426;490;1654;898;3080
352990;201302;3416;12011;3238;11692;1128;4287;1483;5409;2611;9696
353000;201302;523;1517;411;1282;94;329;123;348;217;677
353010;201302;2598;8054;2141;7107;750;2700;730;2270;1480;4970
353020;201302;4132;12107;3281;10306;692;2409;1346;3928;2038;6337
353030;201302;4867;15037;4342;14001;1600;5552;1189;3659;2789;9211
353040;201302;648;1919;562;1783;220;754;186;580;406;1334
353050;201302;5134;18766;4657;17785;1966;8023;1456;5310;3422;13333
353060;201302;31459;106501;29416;103166;5935;24182;18869;63274;24804;87456
353070;201302;7982;28437;6471;24859;2503;10141;1498;5850;4001;15991
353080;201302;4519;16119;3849;14526;1368;5521;1090;3898;2458;9419
353090;201302;574;1988;515;1875;103;438;240;813;343;1251
353100;201302;257;792;217;705;103;332;42;143;145;475
353110;201302;7451;24217;6703;22801;1480;5312;3869;13474;5349;18786
353120;201302;458;1627;402;1490;156;650;99;323;255;973
353130;201302;2892;9246;2569;8677;993;3687;960;3041;1953;6728
353140;201302;2412;7064;1967;6138;719;2437;509;1408;1228;3845
353150;201302;1774;5927;1524;5432;679;2519;310;1166;989;3685
353160;201302;555;1775;482;1612;158;554;106;320;264;874
353170;201302;515;1890;472;1807;206;872;154;556;360;1428
353180;201302;4372;14679;3868;13710;861;3548;2115;7137;2976;10685
353190;201302;3352;11139;2958;10209;840;3217;1254;3955;2094;7172
353200;201302;766;2769;701;2619;212;912;279;980;491;1892
353205;201302;534;1766;431;1527;113;415;131;481;244;896
353210;201302;883;2545;744;2280;155;527;395;1180;550;1707
353215;201302;522;1702;466;1583;112;456;179;603;291;1059
353220;201302;878;2775;811;2651;231;837;305;968;536;1805
353230;201302;1159;3736;1094;3626;334;1237;422;1325;756;2562
353240;201302;2030;7129;1879;6816;662;2653;742;2484;1404;5137
353250;201302;1092;3214;946;2958;294;991;321;948;615;1939
353260;201302;1133;3463;1013;3265;348;1167;364;1162;712;2329
353270;201302;573;1821;500;1682;170;630;145;462;315;1092
353280;201302;507;1726;447;1625;167;647;100;348;267;995
353282;201302;1674;5829;1636;5770;331;1276;1129;3932;1460;5208
353284;201302;323;971;267;871;85;294;85;272;170;566
353286;201302;140;430;97;328;27;89;19;66;46;155
353290;201302;410;1535;376;1460;162;658;128;487;290;1145
353300;201302;1893;6197;1721;5821;665;2433;534;1637;1199;4070
353310;201302;344;1110;327;1069;144;494;92;284;236;778
353320;201302;410;1250;361;1174;109;415;151;452;260;867
353325;201302;451;1652;387;1522;142;618;50;193;192;811
353330;201302;475;1534;405;1379;103;394;164;517;267;911
353340;201302;2964;9983;2578;9166;965;3671;806;2774;1771;6445
353350;201302;3124;9799;2769;9148;1027;3641;1167;3721;2194;7362
353360;201302;394;1439;345;1323;107;465;166;594;273;1059
353370;201302;680;2263;619;2126;204;749;276;941;480;1690
353380;201302;382;1316;344;1246;117;467;149;525;266;992
353390;201302;4485;13047;3654;11487;1134;3891;1363;3982;2497;7873
353400;201302;558;1777;475;1599;123;456;164;489;287;945
353410;201302;634;2045;545;1903;189;718;263;888;452;1606
353420;201302;588;1873;519;1673;196;667;147;442;343;1109
353430;201302;2384;8417;1894;7038;723;2760;146;488;869;3248
353440;201302;56695;190669;52594;181049;17260;62988;18148;60993;35408;123981
353450;201302;440;1391;397;1313;116;458;136;412;252;870
353460;201302;3745;11133;3336;10367;972;3284;1546;4740;2518;8024
353470;201302;10560;34823;8541;30473;2924;11366;2001;6986;4925;18352
353475;201302;1554;4694;1203;3919;350;1246;314;936;664;2182
353480;201302;1475;4589;1355;4367;327;1205;714;2183;1041;3388
353490;201302;1646;4853;1414;4389;402;1389;402;1139;804;2528
353500;201302;1136;3418;1059;3279;487;1593;333;977;820;2570
353510;201302;1345;4468;1192;4070;331;1261;437;1338;768;2599
353520;201302;1093;3501;942;3221;424;1543;218;730;642;2273
353530;201302;2576;8143;2321;7655;739;2697;956;3028;1695;5725
353540;201302;1772;5735;1647;5514;705;2457;541;1875;1246;4332
353550;201302;6283;19074;5686;18089;1371;5096;2914;8522;4285;13618
353560;201302;2329;7940;2038;7430;567;2380;841;2919;1408;5299
353570;201302;464;1526;390;1367;99;406;197;613;296;1019
353580;201302;2227;7679;2114;7465;836;3262;1004;3338;1840;6600
353590;201302;767;2268;660;2083;271;939;173;570;444;1509
353600;201302;1737;5279;1611;5054;403;1413;820;2576;1223;3989
353610;201302;550;2039;497;1940;185;802;174;669;359;1471
353620;201302;2253;8140;2088;7840;745;3084;778;2742;1523;5826
353625;201302;351;999;261;839;112;407;58;159;170;566
353630;201302;1783;6220;1518;5638;471;1959;381;1314;852;3273
353640;201302;1521;4460;1444;4334;442;1429;722;2221;1164;3650
353650;201302;4167;14103;3685;12998;1020;3914;1857;6260;2877;10174
353657;201302;275;963;256;922;77;318;89;305;166;623
353660;201302;1310;3435;1004;3009;478;1567;151;327;629;1894
353670;201302;4614;15672;4094;14530;1286;4943;1445;4966;2731;9909
353680;201302;615;2286;585;2227;338;1323;122;477;460;1800
353690;201302;466;1312;331;1094;121;443;98;292;219;735
353700;201302;2223;7467;2006;6986;532;2148;673;2156;1205;4304
353710;201302;1713;6411;1560;6074;643;2740;556;2089;1199;4829
353715;201302;449;1393;403;1314;65;237;240;792;305;1029
353720;201302;2012;6522;1789;6192;382;1280;1102;4062;1484;5342
353730;201302;4280;13798;3486;11922;971;3578;889;2840;1860;6418
353740;201302;2195;6931;1801;6096;665;2329;487;1599;1152;3928
353750;201302;574;2159;514;2024;193;821;122;480;315;1301
353760;201302;5972;20858;5062;18943;1706;6691;1861;7114;3567;13805
353770;201302;776;2484;542;1911;127;489;81;222;208;711
353780;201302;5397;20131;4962;19254;2531;9979;1137;4750;3668;14729
353790;201302;3039;11155;2749;10552;1057;4432;533;2131;1590;6563
353800;201302;13656;46753;11549;42457;3414;13735;4903;17630;8317;31365
353810;201302;1123;3825;1019;3585;333;1216;426;1526;759;2742
353820;201302;1115;4158;1069;4066;428;1793;361;1304;789;3097
353830;201302;757;2148;593;1826;139;462;239;735;378;1197
353850;201302;1723;5986;1614;5777;473;1801;736;2580;1209;4381
353860;201302;2247;7932;1977;7336;756;3028;732;2646;1488;5674
353870;201302;22141;72515;17411;62779;4509;18299;6200;20456;10709;38755
353880;201302;2616;8951;2409;8620;555;2274;1374;4782;1929;7056
353890;201302;2175;5965;1652;5131;552;1887;675;1981;1227;3868
353900;201302;1083;3498;833;2913;248;972;187;583;435;1555
353910;201302;2063;7467;1964;7190;660;2565;833;3069;1493;5634
353920;201302;2636;8117;2097;6981;543;1867;424;1333;967;3200
353930;201302;3493;12941;3108;12133;1251;5188;762;2839;2013;8027
353940;201302;1466;4835;1312;4520;358;1433;508;1601;866;3034
353950;201302;3526;11908;3266;11431;630;2533;2062;7027;2692;9560
353960;201302;567;1885;472;1656;127;509;131;391;258;900
353970;201302;515;1569;457;1498;50;204;340;1087;390;1291
353980;201302;13422;40773;11465;37781;3014;10731;5946;19366;8960;30097
353990;201302;518;1680;472;1561;148;546;175;516;323;1062
354000;201302;1629;5093;1193;4211;302;1183;120;364;422;1547
354010;201302;365;1187;331;1128;178;631;76;250;254;881
354020;201302;4525;14316;4167;13581;1455;5140;1728;5334;3183;10474
354025;201302;1006;3001;833;2708;252;912;224;713;476;1625
354030;201302;576;1568;424;1354;153;552;129;369;282;921
354040;201302;756;2123;610;1862;101;386;372;1065;473;1451
354050;201302;850;3003;795;2872;347;1313;216;786;563;2099
354060;201302;3955;13523;3363;12295;1087;4345;1352;4740;2439;9085
354070;201302;3412;11704;3014;10816;1229;4701;719;2566;1948;7267
354075;201302;2234;8701;2143;8537;791;3371;902;3535;1693;6906
354080;201302;1805;5715;1498;4958;432;1501;549;1730;981;3231
354085;201302;286;845;256;790;35;142;170;479;205;621
354090;201302;1055;3303;1018;3246;169;609;740;2297;909;2906
354100;201302;16110;56822;14095;53177;3659;14760;7115;26899;10774;41659
354105;201302;778;2626;655;2383;214;897;181;598;395;1495
354110;201302;641;2161;598;2070;162;622;210;675;372;1297
354120;201302;2021;6103;1838;5801;636;2234;578;1702;1214;3936
354130;201302;5886;18882;5334;17770;1841;6531;1977;6466;3818;12997
354140;201302;16430;47375;12283;38894;2862;10319;5499;16336;8361;26655
354150;201302;4088;12162;3444;11050;1187;4186;1296;4036;2483;8222
354160;201302;3716;12722;3346;11936;1041;3993;1322;4539;2363;8532
354165;201302;369;1392;338;1313;123;489;84;346;207;835
354170;201302;1575;5329;1311;4680;320;1275;457;1478;777;2753
354180;201302;477;1504;455;1458;52;198;335;1030;387;1228
354190;201302;1589;5554;1392;5085;489;1890;405;1439;894;3329
354200;201302;1110;3333;930;3006;243;937;348;969;591;1906
354210;201302;837;3031;758;2850;204;880;302;1063;506;1943
354220;201302;2853;9451;2636;9002;1018;3687;964;3188;1982;6875
354230;201302;747;2590;718;2540;252;947;326;1160;578;2107
354240;201302;1177;4185;1007;3830;350;1458;273;995;623;2453
354250;201302;450;1537;401;1478;187;756;111;383;298;1139
354260;201302;9141;28735;8356;27463;2680;9577;3499;11559;6179;21136
354270;201302;1080;3990;1008;3829;336;1370;408;1571;744;2941
354280;201302;838;2617;799;2549;168;593;421;1357;589;1950
354290;201302;1290;4708;1195;4497;418;1675;302;1126;720;2801
354300;201302;3737;13596;3678;13474;1041;4020;2053;7470;3094;11490
354310;201302;751;2582;590;2172;183;744;128;462;311;1206
354320;201302;784;2454;699;2289;207;752;255;787;462;1539
354323;201302;309;969;259;885;86;326;104;321;190;647
354325;201302;1292;4580;1186;4346;363;1502;423;1409;786;2911
354330;201302;7780;24992;7191;23886;1994;7073;3960;12982;5954;20055
354340;201302;28386;95724;24630;88759;9679;37430;8637;30267;18316;67697
354350;201302;1121;3512;1068;3416;332;1112;556;1722;888;2834
354360;201302;421;1427;358;1318;107;431;81;300;188;731
354370;201302;1131;3909;1030;3716;200;843;718;2527;918;3370
354380;201302;1289;3960;1083;3583;430;1561;193;567;623;2128
354390;201302;10282;35209;8298;30496;2395;9714;2688;9347;5083;19061
354400;201302;2051;7457;1824;6908;490;2040;587;2094;1077;4134
354410;201302;6021;19088;5173;17831;1272;4731;2905;10048;4177;14779
354420;201302;1629;4934;1420;4491;478;1631;459;1396;937;3027
354425;201302;3408;10247;2999;9511;1116;3723;975;3188;2091;6911
354430;201302;1275;4350;1192;4233;302;1210;608;2092;910;3302
354440;201302;476;1525;411;1399;119;434;142;479;261;913
354450;201302;416;1243;324;1044;56;230;94;274;150;504
354460;201302;680;2211;656;2166;269;914;333;1103;602;2017
354470;201302;413;1266;367;1180;74;294;174;522;248;816
354480;201302;706;2225;638;2101;161;624;261;742;422;1366
354490;201302;705;2483;544;2062;171;700;139;459;310;1159
354500;201302;2490;8679;2299;8331;881;3482;776;2862;1657;6344
354510;201302;645;2269;575;2104;217;851;191;686;408;1537
354515;201302;329;1181;276;1061;76;327;83;292;159;619
354520;201302;4693;17569;4227;16514;1527;6580;1525;5762;3052;12342
354530;201302;2372;9100;2219;8792;631;2675;1238;4908;1869;7583
354540;201302;1284;4159;1137;3898;403;1458;395;1400;798;2858
354550;201302;504;1772;445;1612;105;409;153;522;258;931
354560;201302;1279;4064;1039;3493;347;1193;268;867;615;2060
354570;201302;577;1864;491;1647;191;704;126;387;317;1091
354580;201302;8570;26471;7384;24114;1821;6748;3535;10888;5356;17636
354600;201302;1638;5904;1468;5566;525;2237;573;2057;1098;4294
354610;201302;467;1326;345;1094;89;303;106;292;195;595
354620;201302;395;1415;332;1293;104;476;102;360;206;836
354625;201302;247;860;217;811;57;233;60;227;117;460
354630;201302;1654;6059;1485;5636;589;2287;478;1717;1067;4004
354640;201302;4031;13902;3516;12789;1171;4770;865;2943;2036;7713
354650;201302;955;3029;867;2839;202;772;451;1405;653;2177
354660;201302;1857;5854;1477;5086;555;2139;448;1441;1003;3580
354670;201302;1696;5762;1396;5008;449;1787;378;1185;827;2972
354680;201302;4913;17304;4602;16649;1425;5438;1806;6465;3231;11903
354690;201302;608;2331;506;2028;131;559;170;609;301;1168
354700;201302;1113;3358;810;2698;146;610;320;941;466;1551
354710;201302;598;1855;528;1721;163;625;169;498;332;1123
354720;201302;173;516;137;440;51;167;39;128;90;295
354730;201302;7915;29229;7241;27789;2559;10287;2695;10172;5254;20459
354740;201302;216;730;183;656;48;184;46;169;94;353
354750;201302;2216;7301;1890;6850;682;2562;800;3024;1482;5586
354760;201302;2086;7194;1834;6634;661;2548;511;1789;1172;4337
354765;201302;239;676;184;585;37;145;58;173;95;318
354770;201302;2644;8069;2146;7231;1015;3662;343;1078;1358;4740
354780;201302;29573;101207;27980;97462;7760;29692;13900;46139;21660;75831
354790;201302;846;2810;766;2695;241;953;384;1257;625;2210
354800;201302;1847;6053;1694;5835;659;2375;793;2772;1452;5147
354805;201302;826;2653;658;2289;142;565;128;413;270;978
354810;201302;627;2124;512;1910;219;883;87;313;306;1196
354820;201302;968;3606;884;3427;313;1367;210;740;523;2107
354830;201302;412;1335;372;1257;105;396;140;462;245;858
354840;201302;759;2410;721;2328;251;897;240;751;491;1648
354850;201302;14263;48131;11416;42091;3512;14389;3950;13605;7462;27994
354860;201302;1221;4095;1119;3915;348;1457;487;1563;835;3020
354870;201302;40832;135821;38899;131878;11746;42972;20468;67401;32214;110373
354880;201302;3745;12287;2840;10252;1004;3949;667;2221;1671;6170
354890;201302;13800;44231;12097;40827;3649;13577;4530;14670;8179;28247
354900;201302;593;1711;481;1549;177;620;170;548;347;1168
354910;201302;4616;15710;3763;13899;1185;4792;647;2333;1832;7125
354920;201302;480;1444;370;1237;116;426;85;273;201;699
354925;201302;365;1097;218;774;41;164;47;157;88;321
354930;201302;237;747;218;701;73;268;56;174;129;442
354940;201302;2490;8982;1982;7588;869;3498;361;1326;1230;4824
354950;201302;1402;4845;1283;4672;275;1169;771;2713;1046;3882
354960;201302;763;2489;686;2367;190;740;364;1216;554;1956
354970;201302;3695;13034;3322;12255;973;4024;1507;5287;2480;9311
354980;201302;31775;80896;17796;56307;4224;14793;5727;16933;9951;31726
354990;201302;31286;111270;29786;108049;7418;30040;16384;57595;23802;87635
354995;201302;1890;6125;1788;5968;518;1835;872;2927;1390;4762
355000;201302;1616;5620;1433;5295;570;2225;394;1457;964;3682
355010;201302;3343;10996;2986;10318;718;2788;1567;5284;2285;8072
355020;201302;3074;11513;2718;10816;1394;5839;777;3156;2171;8995
355030;201302;691682;2159765;647114;2072194;204166;705441;252586;796866;456752;1502307
355040;201302;2690;9335;2413;8802;954;3783;995;3489;1949;7272
355050;201302;1135;3833;960;3453;348;1370;252;881;600;2251
355060;201302;4544;16275;3738;14344;1162;4941;793;2766;1955;7707
355070;201302;5902;19478;5352;18555;1400;5557;2820;9222;4220;14779
355080;201302;1249;4787;1083;4332;444;1966;159;538;603;2504
355090;201302;1011;3794;880;3474;212;912;388;1474;600;2386
355100;201302;28837;96488;26071;91472;9651;35284;8752;31860;18403;67144
355110;201302;1234;4458;1138;4255;412;1670;422;1549;834;3219
355120;201302;628;2093;562;1966;181;695;251;869;432;1564
355130;201302;413;1216;325;1031;97;333;93;242;190;575
355140;201302;970;3641;936;3558;300;1259;438;1601;738;2860
355150;201302;3124;11173;2848;10584;1011;3915;1054;3778;2065;7693
355160;201302;1422;5170;1264;4908;571;2452;361;1257;932;3709
355170;201302;8362;25832;6514;22354;2332;8679;1900;6316;4232;14995
355180;201302;2686;8728;2397;8196;758;2967;904;2970;1662;5937
355190;201302;1219;4439;1137;4253;499;1920;317;1159;816;3079
355200;201302;866;3349;834;3284;417;1739;205;779;622;2518
355210;201302;2573;9259;2343;8742;812;3372;816;2808;1628;6180
355220;201302;27203;96625;25417;93147;11904;44938;7412;28091;19316;73029
355230;201302;868;2790;598;2150;135;551;140;459;275;1010
355240;201302;20530;65547;16098;55425;4101;15855;6356;20248;10457;36103
355250;201302;22692;79842;20877;76435;6395;24923;10093;36696;16488;61619
355255;201302;854;2451;639;1995;125;434;183;539;308;973
355260;201302;1548;4527;1407;4272;409;1427;633;1792;1042;3219
355270;201302;1567;5044;1489;4917;258;1034;1014;3171;1272;4205
355280;201302;18930;61950;17062;58431;5157;19261;7805;25870;12962;45131
355290;201302;828;2780;770;2672;180;696;352;1157;532;1853
355300;201302;809;2790;649;2422;180;749;149;495;329;1244
355310;201302;982;3142;884;2957;270;935;358;1243;628;2178
355320;201302;707;2349;636;2186;202;761;219;674;421;1435
355330;201302;1467;5537;1271;5146;527;2353;304;1120;831;3473
355340;201302;2790;8086;2679;7912;671;2229;1601;4524;2272;6753
355350;201302;1268;4768;1184;4570;456;1894;297;1192;753;3086
355360;201302;1048;3906;990;3788;295;1256;588;2187;883;3443
355365;201302;309;1004;267;918;86;336;64;213;150;549
355370;201302;6361;17478;4805;15744;2041;7248;1785;5891;3826;13139
355380;201302;3586;11283;2845;9549;893;3265;622;1859;1515;5124
355385;201302;917;3183;890;3138;363;1391;284;1001;647;2392
355390;201302;1369;3970;1199;3627;325;1066;411;1241;736;2307
355395;201302;1437;4680;1210;4109;231;918;570;1779;801;2697
355400;201302;8217;29544;7661;28420;2306;9478;4130;14837;6436;24315
355410;201302;11861;45490;11307;44352;4738;19523;3412;13615;8150;33138
355420;201302;774;2927;748;2872;334;1327;233;928;567;2255
355430;201302;3466;10695;3050;9935;968;3452;1171;3668;2139;7120
355440;201302;819;2841;701;2542;226;860;215;717;441;1577
355450;201302;2391;8306;2036;7567;697;2807;573;2021;1270;4828
355460;201302;538;1614;424;1399;133;506;118;358;251;864
355465;201302;413;1276;357;1172;122;422;92;303;214;725
355470;201302;880;2839;719;2554;304;1184;175;573;479;1757
355475;201302;140;542;120;477;31;129;37;161;68;290
355480;201302;3108;11756;2936;11359;1009;4197;1212;4591;2221;8788
355490;201302;758;2306;620;2032;190;679;141;470;331;1149
355495;201302;643;2239;617;2193;218;857;233;782;451;1639
355500;201302;7501;24137;5542;19644;1513;5913;1051;3429;2564;9342
355510;201302;1578;4936;1365;4468;374;1382;351;1100;725;2482
355520;201302;360;994;261;798;68;237;72;189;140;426
355530;201302;148;429;101;333;25;91;19;64;44;155
355535;201302;735;2304;617;2081;184;738;199;577;383;1315
355540;201302;9759;32838;9301;32062;2712;10061;4782;16247;7494;26308
355550;201302;693;2253;662;2199;201;745;317;1025;518;1770
355560;201302;1394;4218;1101;3651;271;1017;287;858;558;1875
355570;201302;174;610;157;568;50;189;28;95;78;284
355580;201302;1147;3632;1033;3401;452;1618;310;984;762;2602
355590;201302;228;676;209;647;48;176;111;339;159;515
355600;201302;931;3226;817;2975;413;1537;194;715;607;2252
355610;201302;1405;4230;1204;3915;381;1342;503;1578;884;2920
355620;201302;3631;12199;2994;10767;785;3242;1266;4177;2051;7419
355630;201302;3167;9457;2050;7068;452;1774;770;2491;1222;4265
355635;201302;853;3042;801;2932;235;937;378;1346;613;2283
355640;201302;3638;12532;3163;11449;1253;4708;668;2459;1921;7167
355645;201302;3243;12106;3112;11852;710;2978;1913;7196;2623;10174
355650;201302;6096;19985;5401;18621;1425;5835;2949;9349;4374;15184
355660;201302;1213;4107;1019;3704;383;1555;292;973;675;2528
355670;201302;1950;6551;1368;5121;399;1679;409;1352;808;3031
355680;201302;1660;5911;1405;5278;596;2336;275;1004;871;3340
355690;201302;329;1183;300;1129;193;765;26;74;219;839
355695;201302;322;992;244;808;51;194;36;97;87;291
355700;201302;6026;22351;5653;21427;1776;7391;2572;9286;4348;16677
355710;201302;11211;30520;7828;24412;2896;9606;1950;5941;4846;15547
355715;201302;169;553;134;483;46;170;19;63;65;233
355720;201302;1450;4995;1257;4613;492;1978;349;1165;841;3143
355730;201302;739;2668;680;2554;304;1203;175;679;479;1882
410010;201302;1582;5218;1478;5020;429;1538;659;2281;1088;3819
410020;201302;1148;4128;1096;4042;393;1516;392;1424;785;2940
410030;201302;1106;4095;1019;3860;397;1560;228;890;625;2450
410040;201302;11645;40741;10922;39292;4351;16671;3040;10890;7391;27561
410045;201302;1074;3245;866;2893;278;978;372;1228;650;2206
410050;201302;2745;8362;2037;7028;764;2884;619;2089;1383;4973
410060;201302;1714;5813;1583;5529;515;1986;525;1793;1040;3779
410070;201302;2021;6029;1767;5534;758;2648;342;904;1100;3552
410080;201302;1310;4189;1159;3950;325;1165;675;2295;1000;3460
410090;201302;1100;3628;1003;3413;392;1450;289;916;681;2366
410100;201302;2533;8126;2167;7369;724;2805;547;1815;1271;4620
410105;201302;484;1615;405;1423;110;451;84;260;194;711
410110;201302;2077;6908;1958;6663;575;2188;807;2732;1382;4920
410115;201302;515;1495;452;1364;119;437;136;342;255;779
410120;201302;2750;9812;2618;9604;1063;4101;1022;3843;2085;7944
410130;201302;1285;4571;1207;4414;282;985;758;2858;1040;3843
410140;201302;11833;36602;9602;32341;3594;13300;3315;10980;6909;24280
410150;201302;16499;44053;8700;27563;1997;7268;1651;4735;3648;12003
410160;201302;3188;10667;2935;10222;1042;3954;1086;3822;2128;7776
410165;201302;712;2299;650;2162;143;515;328;1065;471;1580
410170;201302;1509;4879;1334;4504;548;1999;375;1224;923;3223
410180;201302;8295;27809;7417;25931;2042;8248;3549;11530;5591;19778
410185;201302;633;1836;593;1770;124;386;389;1180;513;1566
410190;201302;2053;6369;1924;6113;701;2413;612;1855;1313;4268
410200;201302;4883;14547;4169;13200;1561;5438;824;2551;2385;7989
410210;201302;2460;7701;2031;6793;591;2242;443;1314;1034;3556
410220;201302;564;1711;486;1557;115;412;170;526;285;938
410230;201302;1748;5842;1643;5674;675;2509;559;1896;1234;4405
410240;201302;4835;15799;4566;15250;1604;5720;1668;5601;3272;11321
410250;201302;2270;6769;1772;5793;635;2335;399;1162;1034;3497
410260;201302;1555;5023;1403;4763;457;1639;497;1701;954;3340
410270;201302;511;1573;450;1457;160;562;172;568;332;1130
410275;201302;847;2603;671;2301;117;444;397;1387;514;1831
410280;201302;2667;8268;1929;6620;505;1983;293;975;798;2958
410290;201302;2939;9798;2702;9355;739;2831;1242;4276;1981;7107
410300;201302;539;1599;505;1548;92;353;297;841;389;1194
410302;201302;535;1645;477;1558;55;171;307;1039;362;1210
410304;201302;1357;4694;1262;4504;400;1456;559;2078;959;3534
410305;201302;1904;5499;1674;5156;555;1783;862;2721;1417;4504
410310;201302;2176;7680;2033;7398;714;2786;676;2565;1390;5351
410315;201302;576;1906;501;1759;136;524;233;783;369;1307
410320;201302;1136;3460;843;2894;228;905;92;271;320;1176
410322;201302;453;1519;415;1436;139;526;145;500;284;1026
410330;201302;1367;4103;1201;3770;407;1409;361;1075;768;2484
410335;201302;990;3075;863;2844;262;968;294;925;556;1893
410337;201302;735;2079;649;1932;146;509;279;792;425;1301
410340;201302;564;1764;446;1471;96;366;105;295;201;661
410345;201302;1568;4978;1398;4661;535;1947;291;900;826;2847
410347;201302;805;2400;615;2035;220;792;120;364;340;1156
410350;201302;896;2991;739;2694;258;1045;98;328;356;1373
410360;201302;3137;10128;2900;9735;1074;3893;781;2664;1855;6557
410370;201302;11619;35679;9361;31039;2856;10690;2713;8426;5569;19116
410380;201302;1251;4172;1180;4026;351;1260;575;1980;926;3240
410390;201302;2695;8205;2253;7453;835;2987;691;2111;1526;5098
410395;201302;793;2921;744;2826;199;804;427;1646;626;2450
410400;201302;4743;15936;4273;15014;1465;5690;1257;4347;2722;10037
410405;201302;890;2751;754;2472;183;702;360;1104;543;1806
410410;201302;1281;4561;1236;4473;429;1709;372;1311;801;3020
410420;201302;9388;31764;8547;29895;3109;11875;2539;8444;5648;20319
410425;201302;3527;11723;2764;9990;848;3400;472;1699;1320;5099
410430;201302;13724;40231;10994;35216;3603;12590;3333;10766;6936;23356
410440;201302;3411;11375;3188;10978;799;2883;1678;5926;2477;8809
410442;201302;2772;10012;2626;9690;951;3648;964;3580;1915;7228
410445;201302;2163;7782;1944;7400;647;2589;841;3354;1488;5943
410450;201302;2364;7133;2031;6514;675;2358;557;1659;1232;4017
410460;201302;2275;7114;1935;6394;507;1789;810;2617;1317;4406
410465;201302;1511;6042;1428;5827;607;2538;393;1552;1000;4090
410470;201302;1725;5768;1595;5494;485;1755;628;2184;1113;3939
410480;201302;25664;80111;22517;74212;9252;33396;6361;20128;15613;53524
410490;201302;9867;34761;9122;33129;3249;12702;3183;11614;6432;24316
410500;201302;1305;4427;1186;4181;449;1714;335;1211;784;2925
410510;201302;2067;5931;1667;5214;524;1752;607;1836;1131;3588
410520;201302;3117;11226;2984;10953;1202;4623;1017;3783;2219;8406
410530;201302;1468;4476;1305;4137;363;1317;523;1576;886;2893
410540;201302;3653;10965;2757;9360;782;2852;1048;3618;1830;6470
410550;201302;5819;18949;4792;16615;1742;6691;641;2006;2383;8697
410560;201302;1093;3764;905;3245;248;952;208;641;456;1593
410570;201302;2544;8975;2381;8684;756;2852;1024;3939;1780;6791
410580;201302;23270;77191;21412;73752;7960;29826;6903;23076;14863;52902
410590;201302;1180;3963;875;3110;183;738;227;741;410;1479
410600;201302;1716;5512;1542;5162;479;1672;719;2452;1198;4124
410610;201302;778;2548;709;2416;222;811;309;1026;531;1837
410620;201302;1626;6066;1505;5762;516;2124;432;1620;948;3744
410630;201302;2329;7157;2094;6761;599;2214;969;3062;1568;5276
410640;201302;4274;13497;3742;12561;1386;5221;938;3001;2324;8222
410645;201302;1185;4441;1156;4370;475;1918;401;1554;876;3472
410650;201302;2321;7440;2022;6876;769;2763;666;2252;1435;5015
410655;201302;843;2733;756;2558;242;879;232;770;474;1649
410657;201302;522;1702;490;1636;152;598;202;616;354;1214
410660;201302;3653;10951;2975;9499;1161;3965;616;1843;1777;5808
410670;201302;960;2849;755;2438;221;809;229;705;450;1514
410680;201302;2105;7856;1859;7195;560;2248;741;2967;1301;5215
410685;201302;618;1945;586;1887;145;470;354;1151;499;1621
410690;201302;110904;333814;82472;276026;23441;87650;23417;71847;46858;159497
410700;201302;2135;7378;2032;7163;759;2897;736;2480;1495;5377
410710;201302;1020;3371;864;3000;235;921;242;810;477;1731
410712;201302;663;2173;609;2060;279;1026;179;638;458;1664
410715;201302;1088;3545;998;3368;283;1028;387;1286;670;2314
410720;201302;3538;11859;3158;11049;985;3596;996;3446;1981;7042
410725;201302;988;2930;797;2598;228;808;275;809;503;1617
410730;201302;686;2158;635;2052;295;1018;167;514;462;1532
410740;201302;840;2651;626;2211;168;676;252;865;420;1541
410750;201302;1627;5151;1492;4842;572;2044;432;1320;1004;3364
410752;201302;216;710;209;701;54;218;110;348;164;566
410753;201302;424;1396;388;1319;108;423;137;423;245;846
410754;201302;922;3126;829;2956;163;633;526;1906;689;2539
410755;201302;568;1758;510;1654;135;500;210;637;345;1137
410760;201302;2297;7841;2211;7663;892;3225;822;2869;1714;6094
410765;201302;13891;43617;11373;38572;3262;12300;2482;8412;5744;20712
410770;201302;792;2376;705;2220;203;714;307;933;510;1647
410773;201302;1161;3856;1057;3655;290;1145;464;1473;754;2618
410775;201302;1773;5456;1750;5424;398;1148;1230;4002;1628;5150
410780;201302;549;1783;484;1653;138;493;132;479;270;972
410785;201302;877;2980;725;2510;258;923;268;937;526;1860
410790;201302;706;2272;620;2074;224;839;144;430;368;1269
410800;201302;2024;6216;1805;5874;868;3002;520;1655;1388;4657
410810;201302;295;926;240;798;34;134;106;336;140;470
410820;201302;999;3159;911;2964;307;1101;281;889;588;1990
410830;201302;27830;89193;24189;82566;7591;28087;8855;30198;16446;58285
410832;201302;1094;3412;1023;3281;253;968;521;1553;774;2521
410840;201302;7503;24855;6827;23387;2483;9307;1775;5648;4258;14955
410845;201302;1470;4696;1321;4396;326;1178;688;2304;1014;3482
410850;201302;2520;7788;2322;7521;467;1829;1363;4337;1830;6166
410855;201302;670;2010;616;1905;184;602;223;711;407;1313
410860;201302;2639;8334;2433;8042;774;2667;1112;3835;1886;6502
410865;201302;1587;5768;1454;5500;246;972;934;3648;1180;4620
410870;201302;1331;4360;1280;4278;526;1909;454;1494;980;3403
410880;201302;4852;14786;4100;13482;1395;5111;1289;4057;2684;9168
410890;201302;1039;3322;822;2911;305;1163;133;431;438;1594
410895;201302;1165;4303;1090;4123;401;1606;402;1489;803;3095
410900;201302;790;2338;629;2081;141;520;173;560;314;1080
410910;201302;292;943;259;881;67;251;109;347;176;598
410920;201302;770;2476;635;2222;200;754;165;528;365;1282
410930;201302;1933;6438;1759;6158;552;2186;691;2360;1243;4546
410940;201302;18838;67470;17568;65255;6040;24177;8016;30044;14056;54221
410950;201302;1846;6391;1703;6128;385;1424;1031;3805;1416;5229
410960;201302;5354;16150;4141;14168;1545;5568;1423;5096;2968;10664
410965;201302;985;3463;931;3355;206;800;579;2130;785;2930
410970;201302;4787;15305;4166;14025;1555;5825;959;3284;2514;9109
410975;201302;1205;3869;1076;3633;217;845;571;1932;788;2777
410980;201302;4467;13998;3297;11475;991;3830;824;2694;1815;6524
410990;201302;961;3102;771;2675;280;1077;172;506;452;1583
411000;201302;353;1154;286;1003;76;298;52;167;128;465
411005;201302;419;1283;359;1142;106;342;85;260;191;602
411007;201302;2061;6980;1993;6880;636;2328;1033;3660;1669;5988
411010;201302;3603;12838;3431;12481;1532;5997;984;3418;2516;9415
411020;201302;2470;8342;2309;8057;799;3021;913;3230;1712;6251
411030;201302;777;2270;686;2111;248;844;178;510;426;1354
411040;201302;340;1159;294;1049;116;426;62;229;178;655
411050;201302;2067;7785;1911;7428;805;3338;434;1715;1239;5053
411060;201302;2010;6566;1797;6145;645;2462;335;1024;980;3486
411065;201302;352;1112;296;990;53;207;109;323;162;530
411070;201302;3293;11442;2690;10270;997;4161;311;1115;1308;5276
411080;201302;1757;5848;1673;5669;380;1446;952;3194;1332;4640
411090;201302;1017;2982;900;2816;274;989;269;796;543;1785
411095;201302;1446;4347;1182;3858;369;1312;328;1050;697;2362
411100;201302;1455;4328;1121;3687;305;1109;286;965;591;2074
411110;201302;879;2735;709;2380;228;821;124;356;352;1177
411120;201302;1563;5149;1425;4844;474;1729;468;1573;942;3302
411125;201302;4515;15065;4426;14905;1637;5818;2136;7119;3773;12937
411130;201302;717;2270;621;2073;213;744;228;777;441;1521
411140;201302;2149;8017;1934;7459;775;3110;487;2054;1262;5164
411150;201302;5563;16556;5034;15597;1653;5558;1523;4408;3176;9966
411155;201302;1055;3327;986;3171;395;1369;289;861;684;2230
411160;201302;282;889;261;845;115;404;88;273;203;677
411170;201302;753;2670;695;2524;227;882;215;759;442;1641
411180;201302;5692;18309;5148;17341;1775;6487;1626;5507;3401;11994
411190;201302;1711;5263;1474;4827;484;1737;428;1347;912;3084
411200;201302;3553;11938;3212;11380;1334;5096;1054;3706;2388;8802
411210;201302;2678;7971;2243;7193;901;3142;299;893;1200;4035
411220;201302;1117;3425;923;3066;265;995;371;1145;636;2140
411230;201302;923;2975;811;2744;282;1022;272;890;554;1912
411240;201302;788;2563;718;2410;339;1229;169;492;508;1721
411250;201302;3013;8676;2542;7818;789;2514;892;2783;1681;5297
411260;201302;243;722;194;638;56;214;94;290;150;504
411270;201302;1910;6315;1797;6132;650;2461;741;2466;1391;4927
411275;201302;1477;4607;1371;4399;438;1502;535;1703;973;3205
411280;201302;1642;5234;1352;4632;455;1774;210;653;665;2427
411290;201302;993;2937;862;2693;252;839;326;1058;578;1897
411295;201302;1031;3250;966;3150;225;813;447;1417;672;2230
411300;201302;1301;3465;919;2730;82;287;397;1081;479;1368
411310;201302;791;2403;658;2179;173;661;305;976;478;1637
411320;201302;5421;17369;4615;15767;1357;4923;1380;4576;2737;9499
411325;201302;1456;5047;1346;4848;148;623;976;3553;1124;4176
411330;201302;3332;11507;3108;11132;1196;4597;1044;3725;2240;8322
411340;201302;896;2697;636;2097;136;494;267;895;403;1389
411342;201302;853;2552;740;2306;218;775;258;716;476;1491
411345;201302;1020;3459;963;3351;287;1086;495;1709;782;2795
411350;201302;2392;7841;1930;6919;700;2678;318;1087;1018;3765
411360;201302;481;1285;330;1008;47;180;150;389;197;569
411370;201302;39756;120229;30686;102805;7752;30465;10128;31121;17880;61586
411373;201302;1280;4301;1127;3979;359;1436;253;825;612;2261
411375;201302;1258;3612;1032;3165;323;1050;329;972;652;2022
411380;201302;1226;3341;792;2449;177;616;226;683;403;1299
411390;201302;1643;5445;1548;5302;248;987;1143;3771;1391;4758
411400;201302;1472;4616;1277;4203;353;1311;494;1621;847;2932
411410;201302;2291;7410;2076;6945;738;2845;624;1793;1362;4638
411420;201302;4203;12539;3469;11053;1150;4108;795;2300;1945;6408
411430;201302;2377;8370;2209;8031;657;2592;1005;3526;1662;6118
411435;201302;492;1694;455;1614;137;522;156;542;293;1064
411440;201302;2383;8281;2231;7980;867;3342;691;2482;1558;5824
411450;201302;1692;5494;1559;5270;442;1533;792;2768;1234;4301
411460;201302;3667;12492;3338;11774;1521;5644;612;2125;2133;7769
411470;201302;904;2900;736;2516;248;908;158;504;406;1412
411480;201302;4167;13526;3609;12481;1701;6300;819;2751;2520;9051
411490;201302;1569;5193;1413;4897;643;2467;326;1029;969;3496
411500;201302;1159;3891;1024;3544;424;1569;251;849;675;2418
411510;201302;2340;7135;1950;6424;691;2459;463;1422;1154;3881
411520;201302;25476;75942;18326;60908;6528;24067;3806;11943;10334;36010
411530;201302;801;2444;589;2039;274;1041;105;338;379;1379
411535;201302;447;1424;292;1056;66;260;22;66;88;326
411540;201302;2516;7277;2090;6547;506;1713;1017;3268;1523;4981
411545;201302;921;3495;903;3456;208;874;595;2260;803;3134
411550;201302;627;1863;528;1703;244;847;121;374;365;1221
411560;201302;2425;7588;2133;6937;613;2208;557;1658;1170;3866
411570;201302;4494;13763;3884;12797;1414;5041;1108;3884;2522;8925
411573;201302;944;3070;906;3009;242;868;476;1607;718;2475
411575;201302;1296;4415;1185;4139;349;1299;465;1638;814;2937
411580;201302;3445;10904;2843;9718;786;3046;549;1714;1335;4760
411585;201302;402;1484;330;1263;102;416;35;113;137;529
411590;201302;552;1714;501;1606;150;550;128;383;278;933
411600;201302;309;1003;274;919;77;317;49;160;126;477
411605;201302;2060;6209;1691;5520;503;1799;659;2105;1162;3904
411610;201302;2023;6198;1953;6095;491;1628;1283;3964;1774;5592
411620;201302;2510;8732;2386;8511;845;3269;964;3501;1809;6770
411630;201302;653;1843;416;1454;145;581;74;239;219;820
411640;201302;537;1746;460;1589;150;571;160;520;310;1091
411650;201302;256;863;219;770;80;321;65;210;145;531
411660;201302;667;2128;621;2047;154;516;281;956;435;1472
411670;201302;1547;4810;1432;4611;538;1918;458;1388;996;3306
411680;201302;1600;5198;1443;4954;418;1402;764;2826;1182;4228
411690;201302;3181;10101;2872;9559;1063;3841;942;3155;2005;6996
411695;201302;775;2557;676;2363;146;527;356;1248;502;1775
411700;201302;1700;5281;1363;4645;435;1628;396;1299;831;2927
411705;201302;2114;7634;1885;7211;477;1877;1099;4311;1576;6188
411710;201302;2113;6753;1711;5804;579;2157;325;970;904;3127
411720;201302;789;2491;653;2166;181;668;186;577;367;1245
411721;201302;640;2042;581;1944;149;544;277;918;426;1462
411722;201302;640;2003;552;1846;155;611;208;664;363;1275
411725;201302;1169;3958;930;3424;270;1084;297;1103;567;2187
411727;201302;2273;6809;1980;6258;484;1694;992;3058;1476;4752
411729;201302;468;1411;397;1284;62;219;197;605;259;824
411730;201302;4792;15473;4380;14708;1259;4608;1947;6486;3206;11094
411740;201302;492;1535;426;1391;132;503;167;506;299;1009
411745;201302;787;2579;689;2363;204;771;184;581;388;1352
411750;201302;3539;11480;3073;10492;1086;4105;534;1649;1620;5754
411760;201302;7864;25322;7368;24460;3068;10729;2232;7884;5300;18613
411770;201302;3545;13253;3326;12728;1445;5796;795;3108;2240;8904
411780;201302;2764;9743;2699;9656;439;1522;1917;7243;2356;8765
411790;201302;2404;7757;2136;7307;785;3007;602;2002;1387;5009
411800;201302;1129;3523;760;2597;158;602;114;296;272;898
411810;201302;1371;4477;1229;4162;354;1390;327;952;681;2342
411820;201302;15302;49634;13084;45673;4732;16898;4389;16381;9121;33279
411830;201302;419;1220;355;1132;111;374;149;494;260;868
411840;201302;7752;24140;6587;21963;2191;8057;2155;7030;4346;15087
411845;201302;450;1523;367;1345;120;474;77;272;197;746
411850;201302;5614;18220;5001;17038;1582;5921;1811;6165;3393;12086
411860;201302;763;2631;690;2452;247;937;174;582;421;1519
411870;201302;867;3314;801;3148;146;616;215;792;361;1408
411880;201302;2340;6937;2012;6402;501;1757;1023;3308;1524;5065
411885;201302;1287;3741;1101;3484;414;1472;314;889;728;2361
411890;201302;1160;3697;919;3166;302;1176;234;695;536;1871
411900;201302;797;2730;689;2478;266;1034;177;618;443;1652
411910;201302;1082;3917;1005;3721;323;1297;370;1315;693;2612
411915;201302;9689;30094;7451;25316;2223;8474;1941;6035;4164;14509
411920;201302;946;3512;877;3330;318;1289;206;792;524;2081
411925;201302;540;1675;459;1535;137;473;205;708;342;1181
411930;201302;5775;20149;5186;18888;1535;5879;2321;8698;3856;14577
411940;201302;3330;11757;3101;11280;1097;4244;994;3585;2091;7829
411950;201302;10815;36191;9808;34609;3549;13365;4223;14885;7772;28250
411960;201302;5363;17130;5083;16623;1564;5686;2368;7506;3932;13192
411965;201302;369;1338;332;1251;102;414;92;353;194;767
411970;201302;709;2188;580;1967;179;622;213;729;392;1351
411980;201302;1962;5593;1427;4783;208;774;868;2917;1076;3691
411990;201302;25574;92765;22973;87197;9320;37502;6172;24088;15492;61590
411995;201302;2797;9222;2610;8870;1111;3956;795;2787;1906;6743
412000;201302;1893;5743;1584;5168;374;1394;621;1788;995;3182
412010;201302;689;2408;628;2274;236;919;212;749;448;1668
412015;201302;536;1863;502;1791;100;403;301;1053;401;1456
412020;201302;388;1227;317;1083;123;453;131;430;254;883
412030;201302;394;1325;321;1190;77;351;111;376;188;727
412033;201302;642;2094;524;1817;152;583;87;276;239;859
412035;201302;837;2633;755;2478;210;782;321;994;531;1776
412040;201302;675;2317;630;2205;267;986;183;643;450;1629
412050;201302;1515;4750;1260;4211;363;1344;286;912;649;2256
412060;201302;7279;26703;6811;25575;2223;8803;2969;11331;5192;20134
412065;201302;876;2848;813;2730;308;1173;234;733;542;1906
412070;201302;1015;3024;916;2812;218;730;364;1100;582;1830
412080;201302;1731;5704;1405;5040;461;1831;165;542;626;2373
412085;201302;171;540;142;491;47;193;38;109;85;302
412090;201302;4645;16140;4516;15915;1075;4013;2916;10476;3991;14489
412100;201302;2143;7013;1917;6612;654;2400;687;2347;1341;4747
412110;201302;736;2481;694;2404;291;1050;258;869;549;1919
412120;201302;2273;8003;2138;7683;540;2124;1109;3864;1649;5988
412125;201302;938;3005;850;2864;273;978;337;1176;610;2154
412130;201302;756;2217;563;1859;142;523;165;550;307;1073
412135;201302;526;1584;409;1333;89;319;189;571;278;890
412140;201302;1700;5405;1466;4949;477;1709;424;1445;901;3154
412150;201302;2584;8217;2347;7745;432;1628;1364;4328;1796;5956
412160;201302;984;3274;879;3071;254;999;408;1404;662;2403
412170;201302;3810;13813;3507;13218;1504;5953;1140;4269;2644;10222
412175;201302;1394;5147;1336;5027;411;1675;570;2178;981;3853
412180;201302;1592;5316;1272;4729;559;2251;298;1082;857;3333
412190;201302;2745;8763;2394;8203;960;3436;746;2736;1706;6172
412200;201302;2066;7404;1642;6162;409;1650;521;1912;930;3562
412210;201302;614;1899;458;1544;146;562;95;295;241;857
412215;201302;2925;10276;2712;9863;603;2261;1619;6072;2222;8333
412217;201302;1081;3455;1046;3389;252;916;604;1872;856;2788
412220;201302;6376;21412;6133;20949;2387;8540;2711;9384;5098;17924
412230;201302;2690;9779;2471;9299;919;3726;715;2658;1634;6384
412240;201302;6951;21076;4636;15753;1183;4449;654;2032;1837;6481
412250;201302;1993;6496;1839;6185;655;2378;604;1976;1259;4354
412260;201302;1147;3617;826;2899;214;849;220;684;434;1533
412265;201302;1073;3590;1017;3495;319;1272;466;1537;785;2809
412270;201302;692;2397;560;2049;143;604;90;298;233;902
412280;201302;821;2719;757;2613;122;451;453;1579;575;2030
412290;201302;1150;3358;999;3085;240;854;429;1266;669;2120
412300;201302;1498;4637;1265;4165;372;1435;411;1263;783;2698
412310;201302;1160;3386;1034;3230;225;573;685;2407;910;2980
412320;201302;829;2289;618;1948;154;562;287;897;441;1459
412330;201302;1909;5473;1499;4785;420;1439;661;2104;1081;3543
412340;201302;794;2642;628;2233;161;640;113;377;274;1017
412350;201302;2296;7711;1977;6975;675;2553;354;1149;1029;3702
412360;201302;301;1033;286;999;79;306;70;226;149;532
412370;201302;1067;3438;859;3029;325;1206;246;861;571;2067
412380;201302;1861;5880;1711;5613;372;1257;892;3103;1264;4360
412382;201302;649;1905;541;1697;160;578;172;494;332;1072
412385;201302;2316;7831;2236;7680;518;1694;1268;4735;1786;6429
412390;201302;2310;7242;2149;6973;820;2885;797;2579;1617;5464
412395;201302;932;2688;766;2426;113;358;512;1669;625;2027
412400;201302;1183;3709;1079;3533;340;1211;466;1545;806;2756
412402;201302;1818;5932;1623;5547;534;1952;435;1434;969;3386
412405;201302;3467;10848;2624;9062;791;3117;221;683;1012;3800
412410;201302;5907;20119;5487;19289;2572;9771;1081;3770;3653;13541
412420;201302;501;1557;432;1460;144;548;138;418;282;966
412430;201302;423;1339;371;1241;146;538;145;453;291;991
412440;201302;3833;11972;3456;11321;674;2412;1609;5521;2283;7933
412450;201302;515;1698;461;1558;132;494;150;451;282;945
412460;201302;941;2678;651;2136;153;598;186;589;339;1187
412470;201302;1883;6719;1799;6536;534;2062;879;3212;1413;5274
412480;201302;1236;3753;964;3197;267;994;257;747;524;1741
412490;201302;1233;3778;1119;3525;340;1125;327;1033;667;2158
412500;201302;1856;5807;1611;5340;557;2000;456;1439;1013;3439
412510;201302;2992;10305;2763;9724;966;3648;769;2762;1735;6410
412520;201302;1723;5084;1382;4546;379;1316;634;2117;1013;3433
412530;201302;723;2204;633;2035;235;823;166;509;401;1332
412535;201302;525;1571;490;1512;182;598;219;644;401;1242
412540;201302;1149;3597;1000;3296;242;931;397;1273;639;2204
412545;201302;847;2553;749;2353;152;535;279;797;431;1332
412550;201302;20949;66474;15888;55326;5100;19314;3340;10910;8440;30224
412555;201302;287;942;223;775;67;250;41;126;108;376
412560;201302;4182;14976;3769;14033;1284;5126;874;3067;2158;8193
412570;201302;3819;12368;3194;10998;1162;4287;726;2573;1888;6860
412575;201302;957;3170;833;2868;216;839;294;940;510;1779
412580;201302;1374;3946;1063;3431;301;1047;351;1086;652;2133
412590;201302;397;1320;348;1230;162;604;76;268;238;872
412600;201302;1380;4586;1235;4298;450;1714;382;1299;832;3013
412610;201302;693;2348;590;2103;217;841;145;463;362;1304
412620;201302;1285;4394;1186;4204;487;1828;365;1319;852;3147
412625;201302;13124;38334;11301;34959;4444;14795;2606;8085;7050;22880
412627;201302;872;2832;681;2431;244;933;154;548;398;1481
412630;201302;3306;11041;3001;10357;919;3438;919;3089;1838;6527
412635;201302;467;1489;397;1341;122;427;78;242;200;669
412640;201302;880;2811;715;2458;224;882;210;677;434;1559
412650;201302;2218;6419;1829;5736;509;1725;760;2241;1269;3966
412660;201302;2886;9030;2445;8117;671;2525;666;2118;1337;4643
412665;201302;659;1847;436;1491;148;555;149;487;297;1042
412667;201302;1465;4629;1224;4151;360;1408;359;1125;719;2533
412670;201302;621;2033;427;1538;107;443;63;193;170;636
412680;201302;1238;4317;1101;3985;369;1416;291;967;660;2383
412690;201302;573;1878;459;1612;183;697;60;196;243;893
412700;201302;1701;5940;1545;5648;580;2311;585;2114;1165;4425
412710;201302;8643;27928;7262;25041;2221;8354;1858;6249;4079;14603
412720;201302;1488;4874;1168;4082;312;1176;129;367;441;1543
412730;201302;2675;8334;1946;6796;651;2453;249;815;900;3268
412740;201302;1962;6622;1850;6390;834;3070;225;803;1059;3873
412750;201302;2919;10770;2853;10664;675;2736;1920;7096;2595;9832
412760;201302;1999;7084;1943;6979;733;2869;680;2346;1413;5215
412770;201302;10744;33061;7668;26220;2041;7789;1566;4886;3607;12675
412780;201302;1419;4874;1284;4533;403;1501;405;1373;808;2874
412785;201302;2207;6834;1774;6000;605;2195;743;2490;1348;4685
412788;201302;1195;4244;1153;4176;309;1287;618;2183;927;3470
412790;201302;1055;3464;919;3156;240;922;320;978;560;1900
412795;201302;951;2954;853;2775;311;1099;295;919;606;2018
412796;201302;3085;9920;2940;9671;846;3021;1392;4558;2238;7579
412800;201302;3207;10029;2671;9071;829;3051;829;2715;1658;5766
412810;201302;7704;22778;5743;18755;1910;6817;1426;4344;3336;11161
412820;201302;4968;16608;4095;14871;1374;5456;1063;3887;2437;9343
412830;201302;353;1244;325;1185;104;440;73;224;177;664
412840;201302;2200;6583;1901;6020;644;2287;550;1724;1194;4011
412850;201302;2669;8422;2411;8085;507;1916;1353;4495;1860;6411
412853;201302;1703;5406;1535;5124;406;1609;734;2277;1140;3886
412855;201302;1582;4777;1319;4272;460;1690;404;1202;864;2892
412860;201302;1129;3705;1045;3560;337;1272;451;1459;788;2731
412862;201302;685;2035;604;1877;190;639;195;593;385;1232
412863;201302;1183;4198;1149;4133;175;670;821;2950;996;3620
412865;201302;587;1946;440;1548;96;371;168;586;264;957
412870;201302;951;2913;853;2778;328;1117;345;1178;673;2295
412880;201302;1562;4368;1331;4023;414;1386;427;1250;841;2636
420005;201302;408;1412;367;1308;94;369;163;549;257;918
420010;201302;3018;10022;2641;9350;448;1696;1788;6402;2236;8098
420020;201302;644;2318;503;1913;127;549;91;304;218;853
420030;201302;355;1230;259;996;80;360;52;179;132;539
420040;201302;938;3025;664;2521;233;973;189;676;422;1649
420050;201302;651;2210;602;2104;199;739;228;774;427;1513
420055;201302;232;832;198;738;54;203;43;143;97;346
420060;201302;356;1307;280;1097;77;323;40;150;117;473
420070;201302;1847;6213;1678;5798;288;1113;793;2870;1081;3983
420075;201302;136;467;107;384;33;129;27;91;60;220
420080;201302;515;1893;478;1797;203;820;90;332;293;1152
420090;201302;642;2403;514;2059;148;612;107;439;255;1051
420100;201302;1437;4910;1356;4803;287;1022;923;3353;1210;4375
420110;201302;411;1463;379;1386;127;455;158;613;285;1068
420120;201302;285;1030;242;934;111;459;35;119;146;578
420125;201302;344;1475;331;1444;140;642;84;348;224;990
420127;201302;469;1571;277;1057;100;404;33;137;133;541
420130;201302;2630;9283;2425;8888;719;2986;1029;3505;1748;6491
420140;201302;6115;18916;4818;16684;1802;6899;1325;4461;3127;11360
420150;201302;637;2032;527;1772;197;725;151;472;348;1197
420160;201302;245;812;168;609;53;231;33;99;86;330
420165;201302;143;524;125;479;43;176;26;103;69;279
420170;201302;179;651;151;595;69;322;18;46;87;368
420180;201302;331;1190;259;977;88;342;67;239;155;581
420190;201302;428;1496;328;1291;145;626;68;270;213;896
420195;201302;1292;3770;1032;3430;292;1097;495;1641;787;2738
420200;201302;2656;8941;1806;6996;672;2875;319;1115;991;3990
420205;201302;1001;3481;909;3301;305;1204;393;1440;698;2644
420207;201302;1068;3373;859;2951;296;1136;252;828;548;1964
420208;201302;449;1564;410;1470;177;656;125;458;302;1114
420209;201302;265;948;200;750;48;198;44;158;92;356
420210;201302;1637;5613;1135;4481;336;1508;136;491;472;1999
420213;201302;817;3201;795;3153;193;794;480;1922;673;2716
420215;201302;445;1617;374;1383;109;421;65;225;174;646
420220;201302;410;1653;390;1600;174;762;76;266;250;1028
420230;201302;3804;12604;3282;11718;837;3356;1886;6594;2723;9950
420240;201302;11494;36875;8036;29508;2081;8955;3035;10008;5116;18963
420243;201302;446;1587;420;1518;146;576;137;491;283;1067
420245;201302;844;2868;678;2560;210;914;133;465;343;1379
420250;201302;850;2797;802;2718;308;1120;325;1129;633;2249
420253;201302;588;1654;514;1548;118;385;260;845;378;1230
420257;201302;396;1307;336;1192;97;340;157;566;254;906
420260;201302;1217;4356;1135;4200;362;1427;544;2047;906;3474
420270;201302;325;1211;280;1083;31;129;33;129;64;258
420280;201302;2446;7521;1809;6411;586;2336;542;1718;1128;4054
420285;201302;118;371;63;238;14;62;3;10;17;72
420287;201302;611;1997;551;1883;147;533;236;808;383;1341
420290;201302;4888;15316;3581;12453;1002;3865;1251;4130;2253;7995
420300;201302;5243;17390;3788;14226;1220;5201;767;2829;1987;8030
420310;201302;695;2333;667;2280;193;675;351;1207;544;1882
420315;201302;758;2872;683;2705;186;826;317;1257;503;2083
420320;201302;4185;14470;3726;13620;1256;5207;1457;5071;2713;10278
420325;201302;483;1616;466;1568;163;614;143;468;306;1082
420330;201302;1141;4193;1002;3792;381;1552;174;575;555;2127
420340;201302;1390;4484;1225;4137;330;1245;493;1587;823;2832
420350;201302;1496;5111;1388;4915;381;1423;712;2571;1093;3994
420360;201302;3170;10967;2765;10031;1192;4693;529;1822;1721;6515
420370;201302;1746;5059;1600;4879;213;711;1295;3881;1508;4592
420380;201302;5019;17894;4395;16351;1529;6181;1136;4218;2665;10399
420390;201302;1880;5954;1253;4580;472;1862;249;835;721;2697
420395;201302;2122;6827;1750;6020;550;2136;413;1346;963;3482
420400;201302;1378;4363;1114;3854;358;1445;371;1188;729;2633
420410;201302;670;2073;557;1877;137;515;279;923;416;1438
420415;201302;417;1435;396;1386;111;417;186;649;297;1066
420417;201302;763;2593;700;2457;146;516;374;1328;520;1844
420419;201302;375;1319;310;1196;161;636;90;360;251;996
420420;201302;13645;44241;11057;38631;3912;14685;3198;11172;7110;25857
420425;201302;1006;3148;769;2598;130;530;283;890;413;1420
420430;201302;3830;12525;2734;9881;913;3572;712;2532;1625;6104
420435;201302;191;673;146;549;71;293;22;80;93;373
420440;201302;1365;4115;918;3250;317;1205;171;557;488;1762
420445;201302;405;1275;322;1132;91;337;149;525;240;862
420450;201302;1157;3506;703;2582;175;753;142;419;317;1172
420455;201302;2062;6822;1905;6536;626;2392;822;2784;1448;5176
420460;201302;9252;30651;7910;28069;2484;9876;3062;10458;5546;20334
420470;201302;928;2868;770;2601;272;985;223;742;495;1727
420475;201302;144;525;120;448;45;176;32;128;77;304
420480;201302;5533;17330;4812;16286;2094;7749;907;3104;3001;10853
420490;201302;646;2394;572;2195;196;790;138;505;334;1295
420500;201302;2042;6608;1789;6163;539;1946;951;3350;1490;5296
420510;201302;182;805;178;786;81;359;35;149;116;508
420515;201302;150;576;127;511;42;174;20;80;62;254
420517;201302;874;2866;798;2692;123;422;528;1826;651;2248
420519;201302;307;983;271;902;59;197;138;478;197;675
420520;201302;604;2026;548;1913;133;517;242;810;375;1327
420530;201302;1261;4607;1118;4225;418;1718;267;940;685;2658
420535;201302;232;791;221;767;72;278;68;225;140;503
420540;201302;18586;59761;14684;51300;5356;20261;4463;15383;9819;35644
420543;201302;414;1251;322;1099;57;207;218;738;275;945
420545;201302;1241;4218;1088;3885;363;1442;351;1182;714;2624
420550;201302;4252;14970;3843;14018;1379;5578;1176;4267;2555;9845
420555;201302;421;1464;374;1358;156;598;99;367;255;965
420560;201302;547;1674;473;1538;64;234;252;831;316;1065
420570;201302;1688;5855;1416;5184;469;1842;356;1252;825;3094
420580;201302;816;2991;729;2819;251;1075;293;1126;544;2201
420590;201302;2865;9506;2220;7979;588;2310;444;1514;1032;3824
420600;201302;609;2324;574;2237;227;985;183;678;410;1663
420610;201302;541;1872;418;1578;155;637;65;223;220;860
420620;201302;1158;3795;1042;3571;419;1568;245;825;664;2393
420630;201302;915;3147;778;2785;256;1003;221;683;477;1686
420640;201302;459;1696;329;1333;97;410;82;344;179;754
420650;201302;1980;6583;1322;4932;381;1631;281;874;662;2505
420660;201302;623;1984;546;1839;111;411;316;1055;427;1466
420665;201302;673;2120;522;1796;105;402;217;690;322;1092
420670;201302;1531;5245;1251;4565;379;1541;206;705;585;2246
420675;201302;214;702;158;569;35;137;71;235;106;372
420680;201302;448;1344;359;1202;96;353;153;503;249;856
420690;201302;751;2761;605;2352;178;772;191;701;369;1473
420700;201302;6065;19359;5180;17478;1963;7209;1214;3984;3177;11193
420710;201302;672;2547;601;2393;249;1048;140;538;389;1586
420720;201302;1761;5880;1610;5666;481;1763;898;3159;1379;4922
420730;201302;4263;13853;3827;13096;1576;5688;1267;4357;2843;10045
420740;201302;570;2162;562;2146;174;675;311;1214;485;1889
420750;201302;2254;7659;1703;6312;476;2013;519;1713;995;3726
420757;201302;100;361;89;342;26;110;19;62;45;172
420760;201302;407;1407;339;1222;80;321;116;412;196;733
420765;201302;521;1915;400;1559;132;532;81;310;213;842
420768;201302;1137;4312;1072;4164;348;1377;463;1892;811;3269
420770;201302;795;2701;579;2163;206;824;162;569;368;1393
420775;201302;568;1913;526;1833;124;438;300;1055;424;1493
420780;201302;1580;5123;1213;4204;402;1490;376;1257;778;2747
420785;201302;380;1292;320;1135;85;329;128;448;213;777
420790;201302;1204;4638;1073;4257;308;1295;482;1860;790;3155
420800;201302;785;2415;536;1873;169;643;115;384;284;1027
420810;201302;2290;8640;1968;7793;739;3194;535;2055;1274;5249
420820;201302;7276;26489;6361;24789;2367;10232;2309;8890;4676;19122
420830;201302;2450;8651;2175;8110;861;3440;752;2722;1613;6162
420840;201302;911;3248;763;2947;272;1166;235;830;507;1996
420845;201302;960;3528;839;3263;332;1398;144;540;476;1938
420850;201302;1506;5502;1216;4865;476;2044;265;1081;741;3125
420860;201302;609;1933;448;1594;197;761;148;524;345;1285
420870;201302;1255;3911;1053;3637;451;1687;324;1123;775;2810
420880;201302;1411;4911;1208;4387;367;1387;276;992;643;2379
420890;201302;11483;27961;5580;18037;1214;4714;2161;6309;3375;11023
420895;201302;156;447;93;306;25;89;37;115;62;204
420900;201302;2043;6250;1477;5152;494;1890;365;1212;859;3102
420910;201302;20128;65363;14205;52450;4231;17664;3416;12114;7647;29778
420915;201302;641;2598;606;2487;165;676;294;1272;459;1948
420917;201302;244;817;221;757;63;248;83;235;146;483
420920;201302;147;457;103;372;46;177;16;59;62;236
420930;201302;18809;60561;16672;56545;5974;22032;5728;19486;11702;41518
420940;201302;4390;14162;3916;13084;1225;4540;1352;4231;2577;8771
420945;201302;160;556;140;502;54;209;29;95;83;304
420950;201302;429;1475;280;1093;87;387;47;166;134;553
420960;201302;1319;4387;1147;4046;447;1713;309;990;756;2703
420970;201302;2503;8380;2250;7984;704;2600;1142;4193;1846;6793
420980;201302;340;1295;318;1235;104;399;170;691;274;1090
420985;201302;419;1435;330;1221;110;427;82;288;192;715
420990;201302;769;2477;568;2110;150;628;173;567;323;1195
421000;201302;628;2318;464;1872;164;713;55;178;219;891
421003;201302;473;1496;264;974;77;306;37;123;114;429
421005;201302;223;792;211;769;66;260;103;370;169;630
421010;201302;5937;20095;5145;18359;1908;7283;1611;5581;3519;12864
421020;201302;495;1763;444;1647;107;405;222;879;329;1284
421030;201302;1050;3903;960;3662;351;1395;299;1173;650;2568
421040;201302;779;2624;734;2540;226;843;320;1073;546;1916
421050;201302;1768;5088;1179;4141;328;1317;475;1594;803;2911
421055;201302;226;857;194;754;58;251;56;189;114;440
421060;201302;498;1955;424;1738;137;615;84;314;221;929
421070;201302;727;2463;548;2021;126;541;246;939;372;1480
421080;201302;591;2048;564;1979;203;746;222;770;425;1516
421085;201302;477;1407;289;1060;75;285;66;274;141;559
421090;201302;401;1234;319;1047;92;323;140;457;232;780
421100;201302;863;2938;724;2597;229;847;178;586;407;1433
421105;201302;1227;4334;1139;4172;350;1343;518;2016;868;3359
421110;201302;1597;5433;1390;5092;537;2164;465;1641;1002;3805
421120;201302;1412;4908;1202;4421;337;1443;390;1330;727;2773
421125;201302;322;1153;305;1100;113;431;103;346;216;777
421130;201302;4582;15832;4050;14894;1761;6884;1164;4462;2925;11346
421140;201302;376;1274;326;1155;106;416;115;386;221;802
421145;201302;449;1617;415;1517;81;337;210;739;291;1076
421150;201302;362;1423;329;1335;99;414;154;628;253;1042
421160;201302;667;2232;496;1878;141;596;136;492;277;1088
421165;201302;302;1121;249;939;62;244;103;397;165;641
421170;201302;1760;5960;1512;5273;507;1846;677;2336;1184;4182
421175;201302;1144;3734;977;3463;385;1494;323;1089;708;2583
421180;201302;429;1378;305;1117;103;433;115;375;218;808
421185;201302;370;1196;326;1107;72;234;160;569;232;803
421187;201302;297;981;258;903;72;259;102;349;174;608
421189;201302;527;1657;476;1549;134;474;191;614;325;1088
421190;201302;8224;28595;7074;26119;2545;9971;2385;8809;4930;18780
421200;201302;994;3511;904;3310;285;1162;415;1480;700;2642
421205;201302;192;658;149;557;34;149;35;111;69;260
421210;201302;1884;6184;1773;5895;608;2143;637;2123;1245;4266
421220;201302;2284;8312;2077;7907;720;2916;750;2904;1470;5820
421223;201302;769;2342;536;1942;178;673;270;972;448;1645
421225;201302;1042;3388;942;3188;272;982;377;1257;649;2239
421227;201302;902;3288;859;3217;243;899;499;1962;742;2861
421230;201302;746;2634;687;2480;205;780;257;922;462;1702
421240;201302;512;1806;415;1532;147;587;62;212;209;799
421250;201302;1768;5732;1297;4874;487;1978;389;1431;876;3409
421260;201302;220;742;161;630;39;157;38;141;77;298
421270;201302;580;1813;399;1487;159;611;99;392;258;1003
421280;201302;1427;4839;1216;4498;477;2014;274;1037;751;3051
421290;201302;1839;5533;1318;4508;470;1713;317;1005;787;2718
421300;201302;234;855;221;828;128;525;44;143;172;668
421310;201302;501;1789;437;1604;161;592;101;368;262;960
421315;201302;333;1064;225;810;54;203;91;326;145;529
421320;201302;486;1711;337;1278;74;327;65;182;139;509
421330;201302;590;2153;529;2026;240;1034;64;229;304;1263
421335;201302;531;1859;443;1683;154;639;97;372;251;1011
421340;201302;1498;5330;1452;5245;549;2145;573;2042;1122;4187
421350;201302;878;3164;766;2930;301;1280;223;820;524;2100
421360;201302;2841;9474;2204;8117;620;2576;774;2766;1394;5342
421370;201302;1051;3905;922;3605;352;1511;239;920;591;2431
421380;201302;934;2877;804;2631;184;640;385;1260;569;1900
421390;201302;178;602;152;541;24;93;45;164;69;257
421400;201302;357;1467;302;1320;139;621;68;291;207;912
421410;201302;294;1053;264;989;63;234;136;530;199;764
421415;201302;306;1025;203;808;73;303;58;224;131;527
421420;201302;1356;4447;1107;3817;272;1009;269;906;541;1915
421430;201302;252;880;194;752;75;324;34;135;109;459
421440;201302;705;2291;544;1993;194;750;203;752;397;1502
421450;201302;583;2167;525;2015;234;956;153;578;387;1534
421460;201302;543;1960;452;1756;140;593;97;346;237;939
421470;201302;461;1845;432;1760;143;621;173;671;316;1292
421480;201302;2069;7349;1719;6562;604;2539;547;1952;1151;4491
421490;201302;217;850;197;801;97;409;41;165;138;574
421500;201302;2496;9410;2275;8948;1037;4368;560;2214;1597;6582
421505;201302;374;1347;348;1278;135;498;126;469;261;967
421507;201302;544;2011;510;1914;140;538;194;727;334;1265
421510;201302;251;1006;234;964;84;382;83;305;167;687
421520;201302;661;2026;538;1787;81;307;336;1093;417;1400
421530;201302;399;1456;306;1247;98;450;112;439;210;889
421535;201302;524;1857;443;1708;103;436;214;828;317;1264
421540;201302;361;1158;317;1069;76;286;114;364;190;650
421545;201302;1117;4098;978;3809;344;1478;195;723;539;2201
421550;201302;1830;6725;1726;6525;731;2949;572;2174;1303;5123
421555;201302;213;739;133;495;34;141;32;112;66;253
421560;201302;207;765;147;590;58;234;24;95;82;329
421565;201302;1015;3397;946;3271;453;1653;296;1016;749;2669
421567;201302;932;3670;823;3360;419;1732;153;660;572;2392
421568;201302;397;1514;380;1471;131;533;131;496;262;1029
421569;201302;145;541;129;493;33;142;43;147;76;289
421570;201302;851;3070;726;2777;288;1222;190;663;478;1885
421575;201302;609;2125;546;1991;117;443;284;1061;401;1504
421580;201302;3856;13598;3252;12242;1333;5555;751;2647;2084;8202
421590;201302;245;856;219;780;65;253;99;335;164;588
421600;201302;712;2362;607;2141;210;790;176;606;386;1396
421605;201302;596;1956;437;1632;158;663;101;373;259;1036
421610;201302;1768;4757;1396;4211;229;767;853;2578;1082;3345
421620;201302;4388;14064;3359;11974;1246;4765;1104;3991;2350;8756
421625;201302;312;1168;265;1020;95;390;90;320;185;710
421630;201302;2161;7078;1567;5630;464;1823;402;1427;866;3250
421635;201302;262;986;231;932;65;277;95;367;160;644
421640;201302;1003;3440;910;3281;218;785;527;1955;745;2740
421650;201302;2233;7947;2062;7566;908;3621;348;1240;1256;4861
421660;201302;8162;29175;6863;26579;2620;11069;2028;7538;4648;18607
421670;201302;987;3542;873;3275;273;1115;274;1007;547;2122
421680;201302;1337;4661;1252;4447;552;2120;231;735;783;2855
421690;201302;1902;6644;1559;5783;525;2073;332;1223;857;3296
421700;201302;696;2273;515;1924;191;774;147;503;338;1277
421710;201302;322;1193;278;1075;113;442;68;263;181;705
421715;201302;214;724;180;639;48;182;56;201;104;383
421720;201302;2127;6422;1513;5499;652;2604;445;1549;1097;4153
421725;201302;119;452;114;438;39;156;48;178;87;334
421730;201302;429;1607;321;1247;107;465;78;264;185;729
421740;201302;588;1971;492;1750;160;653;128;385;288;1038
421750;201302;1266;4177;1070;3746;368;1385;321;1043;689;2428
421755;201302;400;1427;340;1245;91;354;105;378;196;732
421760;201302;326;1138;272;1032;101;437;114;398;215;835
421770;201302;3357;10732;2915;9951;1454;5129;706;2571;2160;7700
421775;201302;498;1642;386;1415;96;365;127;469;223;834
421780;201302;1651;5968;1382;5377;596;2470;366;1366;962;3836
421790;201302;806;2607;581;2163;203;859;128;435;331;1294
421795;201302;287;988;263;913;57;221;83;277;140;498
421800;201302;2110;7518;1797;6847;594;2544;551;1842;1145;4386
421810;201302;680;2418;594;2191;201;786;131;468;332;1254
421820;201302;900;3143;815;2965;199;863;333;1141;532;2004
421825;201302;1107;4035;1070;3927;190;766;629;2295;819;3061
421830;201302;2888;10448;2756;10196;651;2423;1633;6417;2284;8840
421835;201302;155;543;134;502;55;232;46;153;101;385
421840;201302;495;1826;451;1701;176;733;167;600;343;1333
421850;201302;516;1596;424;1455;158;558;156;582;314;1140
421860;201302;401;1407;314;1198;87;379;87;314;174;693
421870;201302;4839;14954;3613;12403;1201;4424;665;2225;1866;6649
421875;201302;235;835;172;659;47;207;40;124;87;331
421880;201302;843;3069;747;2840;300;1277;136;459;436;1736
421885;201302;351;1281;329;1218;98;377;156;579;254;956
421890;201302;1029;3673;899;3386;335;1349;275;1010;610;2359
421895;201302;393;1429;388;1421;118;428;204;775;322;1203
421900;201302;808;2759;680;2427;185;705;252;845;437;1550
421910;201302;427;1534;359;1362;110;479;87;284;197;763
421915;201302;577;1875;512;1749;80;310;338;1153;418;1463
421917;201302;465;1629;404;1510;150;638;109;363;259;1001
421920;201302;671;2257;601;2161;290;1106;190;630;480;1736
421930;201302;3277;10574;2664;9212;888;3400;431;1469;1319;4869
421935;201302;770;2977;690;2784;210;897;260;1060;470;1957
421940;201302;284;1142;257;1061;92;412;86;335;178;747
421950;201302;3775;11274;2506;8856;863;3230;542;1975;1405;5205
421960;201302;231;802;200;727;71;273;63;220;134;493
421970;201302;1791;5932;1519;5295;568;2160;341;1066;909;3226
421985;201302;376;1148;268;920;46;193;95;338;141;531
430003;201302;883;2632;721;2363;229;826;270;901;499;1727
430005;201302;274;983;257;944;66;273;131;439;197;712
430010;201302;1846;5867;1517;5133;510;1787;564;1943;1074;3730
430020;201302;1034;2983;927;2820;261;884;472;1365;733;2249
430030;201302;1401;4212;1294;3983;409;1297;539;1652;948;2949
430040;201302;12313;32853;11161;31389;3501;9828;5899;17473;9400;27301
430045;201302;631;1912;568;1787;82;305;398;1210;480;1515
430047;201302;182;551;163;512;41;135;86;275;127;410
430050;201302;809;2493;593;2058;100;409;313;1051;413;1460
430055;201302;232;743;199;656;46;167;113;363;159;530
430057;201302;70;190;31;105;8;32;12;32;20;64
430060;201302;12826;44532;11909;42966;4340;16141;5272;19574;9612;35715
430063;201302;908;2940;827;2723;284;940;354;1227;638;2167
430064;201302;1569;4943;1381;4605;330;1103;830;2869;1160;3972
430066;201302;123;355;104;324;39;123;45;139;84;262
430070;201302;473;1670;417;1537;112;439;146;517;258;956
430080;201302;532;1863;451;1660;122;502;104;355;226;857
430085;201302;440;1542;405;1483;149;596;188;665;337;1261
430087;201302;912;2792;899;2766;79;250;797;2463;876;2713
430090;201302;612;1694;260;866;35;134;98;314;133;448
430100;201302;879;3074;809;2914;332;1312;212;644;544;1956
430105;201302;613;2164;556;2047;221;861;140;498;361;1359
430107;201302;253;859;211;739;47;179;112;379;159;558
430110;201302;2076;6403;1961;6228;643;2209;965;3068;1608;5277
430120;201302;1456;4792;1366;4615;190;657;1060;3582;1250;4239
430130;201302;4383;11462;4097;11102;691;1983;2810;7786;3501;9769
430140;201302;1048;3593;900;3224;325;1168;340;1252;665;2420
430150;201302;805;2345;625;1999;148;503;245;781;393;1284
430155;201302;482;1575;374;1330;95;328;158;570;253;898
430160;201302;17096;52630;16105;51028;4029;13874;8625;28168;12654;42042
430163;201302;1701;5379;1490;4971;376;1423;668;2223;1044;3646
430165;201302;254;958;233;915;109;431;44;174;153;605
430170;201302;659;2048;401;1453;115;473;129;417;244;890
430175;201302;851;3064;792;2927;223;809;445;1717;668;2526
430180;201302;1124;3232;1013;3072;200;639;604;1888;804;2527
430185;201302;691;1805;398;1225;55;212;150;400;205;612
430187;201302;720;2362;677;2302;183;716;342;1146;525;1862
430190;201302;2164;6676;1924;6247;517;1930;910;2979;1427;4909
430192;201302;197;648;163;548;34;129;95;309;129;438
430195;201302;180;594;85;330;15;63;13;39;28;102
430200;201302;1712;5886;1540;5578;674;2525;341;1321;1015;3846
430205;201302;421;1366;362;1258;42;182;245;841;287;1023
430210;201302;5496;16765;3551;12408;1057;3960;717;2326;1774;6286
430215;201302;287;932;244;844;66;253;119;399;185;652
430220;201302;566;1551;317;1094;75;295;58;195;133;490
430222;201302;297;939;236;809;79;299;92;299;171;598
430223;201302;245;847;240;834;70;246;132;467;202;713
430225;201302;39;135;35;119;4;9;7;21;11;30
430230;201302;2102;6837;1982;6703;409;1290;1430;5043;1839;6333
430235;201302;212;747;176;658;71;287;35;107;106;394
430237;201302;350;1060;317;997;39;166;225;665;264;831
430240;201302;945;3036;789;2715;303;1153;205;630;508;1783
430245;201302;751;2763;672;2563;194;756;285;1121;479;1877
430250;201302;1591;4573;1468;4346;498;1544;619;1905;1117;3449
430258;201302;170;533;135;451;29;96;68;226;97;322
430260;201302;759;2247;537;1777;78;305;299;987;377;1292
430265;201302;317;1055;276;959;141;515;41;107;182;622
430270;201302;3249;9690;3028;9346;866;3023;1540;4700;2406;7723
430280;201302;4861;14879;4461;14113;1513;5155;1919;5976;3432;11131
430290;201302;2313;6825;2197;6699;351;1092;1732;5375;2083;6467
430300;201302;9188;29709;8180;27819;3494;12375;2999;10605;6493;22980
430310;201302;7793;25709;7237;24654;2585;9404;3020;10178;5605;19582
430320;201302;747;2412;591;2099;95;330;311;1153;406;1483
430330;201302;913;2624;834;2483;217;714;393;1096;610;1810
430340;201302;600;1749;449;1524;126;474;212;711;338;1185
430350;201302;5846;19709;5233;18316;1873;7003;2072;7171;3945;14174
430355;201302;148;492;118;421;28;128;26;78;54;206
430360;201302;972;2739;901;2630;143;471;579;1684;722;2155
430367;201302;327;950;234;773;34;132;92;286;126;418
430370;201302;537;1682;486;1570;178;616;131;393;309;1009
430380;201302;844;2239;472;1558;144;478;157;554;301;1032
430390;201302;3587;11665;3140;10664;893;3328;1065;3455;1958;6783
430400;201302;1176;2988;875;2560;197;695;491;1341;688;2036
430410;201302;657;1873;532;1669;113;396;290;914;403;1310
430420;201302;4121;12727;3589;11504;1161;3813;1500;4852;2661;8665
430430;201302;620;1883;480;1610;168;614;116;352;284;966
430435;201302;1676;4918;1605;4808;306;927;1098;3351;1404;4278
430440;201302;3968;12982;3491;12205;909;3565;1379;4884;2288;8449
430450;201302;8726;26613;7549;24063;2601;8604;2954;9483;5555;18087
430460;201302;22021;70353;18894;64836;7069;25810;6783;23669;13852;49479
430461;201302;454;1302;148;496;35;120;32;110;67;230
430462;201302;304;976;267;913;108;378;84;289;192;667
430463;201302;3488;12018;3163;11332;888;3489;1512;5405;2400;8894
430465;201302;552;1643;474;1496;129;439;264;838;393;1277
430466;201302;3988;12310;3808;11988;1321;4472;1690;5346;3011;9818
430467;201302;519;1683;461;1581;139;516;206;707;345;1223
430468;201302;1298;4049;1191;3880;500;1786;266;851;766;2637
430469;201302;116;338;42;175;15;64;6;28;21;92
430470;201302;5866;17197;5041;15840;1821;6217;2007;6258;3828;12475
430471;201302;901;3161;827;2993;320;1222;193;710;513;1932
430480;201302;766;2268;510;1708;111;413;129;386;240;799
430485;201302;207;673;130;485;24;84;51;210;75;294
430490;201302;468;1456;348;1224;123;458;102;367;225;825
430495;201302;387;1223;289;1013;85;326;77;268;162;594
430500;201302;1563;4562;1406;4285;390;1333;727;2165;1117;3498
430510;201302;24983;80979;19665;67420;6918;25800;5558;18377;12476;44177
430511;201302;454;1443;299;1048;88;303;62;215;150;518
430512;201302;1232;3428;1114;3230;329;977;501;1533;830;2510
430513;201302;576;1784;446;1491;102;361;190;629;292;990
430515;201302;546;1751;493;1619;106;369;217;740;323;1109
430517;201302;1260;4471;1206;4345;246;939;750;2680;996;3619
430520;201302;1616;5039;1438;4680;516;1786;618;1988;1134;3774
430530;201302;854;2570;617;2059;164;619;201;614;365;1233
430535;201302;2142;7347;1916;6786;573;2229;654;2303;1227;4532
430537;201302;554;1655;404;1415;62;209;309;1117;371;1326
430540;201302;670;1805;553;1644;133;444;312;886;445;1330
430543;201302;569;1578;521;1529;136;429;313;935;449;1364
430544;201302;649;2279;577;2072;140;534;299;1038;439;1572
430545;201302;1173;4118;1090;4017;351;1146;637;2624;988;3770
430550;201302;534;1810;457;1620;135;526;166;588;301;1114
430558;201302;113;335;86;282;36;132;15;37;51;169
430560;201302;319;913;259;802;57;221;113;334;170;555
430570;201302;1051;2955;845;2597;200;682;466;1382;666;2064
430580;201302;892;2796;667;2319;246;884;182;663;428;1547
430583;201302;114;326;54;181;8;35;12;36;20;71
430585;201302;295;886;246;773;86;311;114;331;200;642
430587;201302;297;958;265;893;137;475;74;242;211;717
430590;201302;1568;4522;1493;4401;320;1077;900;2564;1220;3641
430593;201302;36;143;34;136;14;58;10;37;24;95
430595;201302;133;444;94;369;43;171;4;13;47;184
430597;201302;361;1163;315;1059;57;205;151;486;208;691
430600;201302;1760;5327;1411;4539;359;1219;585;1886;944;3105
430605;201302;1171;3940;1037;3640;281;1076;416;1510;697;2586
430607;201302;656;1878;588;1753;111;380;376;1066;487;1446
430610;201302;7548;21698;6354;19809;1449;5066;3339;10379;4788;15445
430613;201302;184;515;140;426;38;134;64;174;102;308
430620;201302;901;2963;777;2675;245;949;307;972;552;1921
430630;201302;414;1345;272;966;91;321;60;207;151;528
430632;201302;692;2015;487;1593;74;289;299;942;373;1231
430635;201302;605;1819;475;1555;85;309;277;904;362;1213
430637;201302;465;1367;439;1323;59;206;325;944;384;1150
430640;201302;1493;4614;1144;3819;302;1099;249;711;551;1810
430642;201302;398;1195;335;1093;68;229;202;673;270;902
430645;201302;161;514;103;371;30;116;21;72;51;188
430650;201302;1795;6485;1621;6015;427;1617;817;3133;1244;4750
430655;201302;293;930;273;878;62;234;107;284;169;518
430660;201302;5389;17305;4582;15729;1674;6227;1727;5880;3401;12107
430670;201302;465;1398;427;1329;48;140;328;1056;376;1196
430673;201302;663;1743;454;1419;138;441;204;647;342;1088
430675;201302;134;435;110;389;22;86;58;208;80;294
430676;201302;4273;13634;4063;13285;1233;4348;2038;6833;3271;11181
430680;201302;1102;3471;908;3041;220;853;360;1119;580;1972
430690;201302;4156;12638;3594;11588;1226;4027;1575;5332;2801;9359
430692;201302;266;967;208;835;41;175;124;503;165;678
430693;201302;1688;4992;1402;4327;335;1134;487;1466;822;2600
430695;201302;492;1476;417;1324;97;344;195;583;292;927
430697;201302;364;1104;316;1031;104;351;143;489;247;840
430700;201302;9335;26387;5807;19239;1383;5104;1036;3316;2419;8420
430705;201302;394;1260;367;1212;96;334;202;683;298;1017
430710;201302;1706;4725;1453;4320;333;1053;833;2603;1166;3656
430720;201302;706;2024;521;1754;152;537;236;814;388;1351
430730;201302;1561;4735;1448;4546;335;1035;911;2984;1246;4019
430740;201302;527;1656;409;1395;150;530;92;320;242;850
430745;201302;492;1484;402;1300;66;231;242;756;308;987
430750;201302;1672;5042;1526;4780;515;1807;729;2138;1244;3945
430755;201302;590;1778;466;1510;133;496;189;549;322;1045
430760;201302;2977;8738;2774;8419;589;1916;1617;5077;2206;6993
430770;201302;6208;19874;5372;18310;1461;5381;2394;8093;3855;13474
430780;201302;1682;5395;1523;5116;552;2015;573;1765;1125;3780
430781;201302;603;1950;485;1709;150;546;215;770;365;1316
430783;201302;521;1455;446;1328;96;317;219;607;315;924
430786;201302;115;419;106;391;43;176;11;37;54;213
430790;201302;2643;7883;1997;6611;487;1878;871;2753;1358;4631
430800;201302;686;2270;641;2175;204;734;239;798;443;1532
430805;201302;391;1247;349;1160;25;102;259;858;284;960
430807;201302;252;830;240;802;54;197;125;415;179;612
430810;201302;468;1472;295;1059;62;262;48;156;110;418
430820;201302;1073;3752;968;3485;334;1314;314;1066;648;2380
430825;201302;442;1302;258;848;52;191;76;227;128;418
430830;201302;2633;8205;2468;7903;457;1483;1532;5251;1989;6734
430840;201302;880;2937;857;2892;229;698;522;1851;751;2549
430843;201302;95;319;75;249;14;43;32;104;46;147
430845;201302;461;1442;404;1334;140;482;89;301;229;783
430850;201302;3176;10157;2918;9678;970;3374;1165;3924;2135;7298
430860;201302;616;2224;555;2069;203;864;121;399;324;1263
430865;201302;707;2057;664;1974;198;617;366;1082;564;1699
430870;201302;411;1372;339;1217;114;427;132;461;246;888
430880;201302;1292;3974;1103;3575;476;1660;268;893;744;2553
430885;201302;159;574;139;531;54;205;33;135;87;340
430890;201302;1772;5041;1590;4756;204;681;1148;3493;1352;4174
430900;201302;3168;8941;3012;8734;598;1792;2037;6068;2635;7860
430905;201302;836;2770;726;2508;272;1028;221;726;493;1754
430910;201302;1639;5536;1483;5277;606;2331;547;1903;1153;4234
430912;201302;546;1656;439;1467;90;355;218;691;308;1046
430915;201302;341;1263;284;1120;91;399;100;374;191;773
430920;201302;15823;52890;15152;51810;5543;19544;8325;28469;13868;48013
430925;201302;86;253;70;223;21;72;34;108;55;180
430930;201302;8275;27439;7442;25814;2245;8227;3386;12076;5631;20303
430940;201302;1011;3297;873;3052;230;915;303;1022;533;1937
430950;201302;1541;4557;1251;3924;400;1320;404;1258;804;2578
430955;201302;90;310;73;266;28;110;15;51;43;161
430957;201302;281;1048;253;974;68;270;118;457;186;727
430960;201302;1575;4847;1366;4467;548;1874;493;1635;1041;3509
430965;201302;1079;3721;944;3418;254;990;485;1711;739;2701
430970;201302;456;1417;345;1158;99;371;103;338;202;709
430975;201302;582;1989;523;1843;96;342;359;1271;455;1613
430980;201302;536;1377;345;1091;103;371;123;338;226;709
430990;201302;594;2043;475;1721;179;659;133;497;312;1156
430995;201302;675;2118;627;2026;210;685;273;918;483;1603
431000;201302;1530;4371;1026;3347;297;1089;163;475;460;1564
431010;201302;2112;6975;1735;6161;574;2220;571;1937;1145;4157
431020;201302;13341;34886;9785;28428;2995;9210;3144;9411;6139;18621
431030;201302;368;1187;256;897;54;200;77;282;131;482
431033;201302;2501;7826;2370;7640;591;1942;1414;4817;2005;6759
431036;201302;117;389;96;338;23;87;28;86;51;173
431040;201302;946;2908;833;2713;271;952;393;1258;664;2210
431041;201302;552;1590;497;1508;183;593;163;518;346;1111
431043;201302;353;1227;290;1076;149;605;84;264;233;869
431046;201302;103;330;84;286;28;99;33;112;61;211
431050;201302;1675;4462;1510;4264;315;868;996;2957;1311;3825
431053;201302;545;1884;497;1795;180;711;183;631;363;1342
431055;201302;609;1857;591;1826;80;249;447;1413;527;1662
431057;201302;243;768;168;607;45;178;81;281;126;459
431060;201302;5856;17922;5617;17648;1003;2844;4213;13857;5216;16701
431065;201302;420;1364;412;1353;36;110;341;1147;377;1257
431070;201302;730;2207;579;1882;138;450;250;807;388;1257
431075;201302;244;774;170;601;36;141;50;180;86;321
431080;201302;597;2014;503;1810;149;570;89;312;238;882
431085;201302;899;2493;736;2217;145;471;402;1206;547;1677
431087;201302;578;1747;534;1666;33;87;456;1449;489;1536
431090;201302;423;1194;289;945;94;328;85;257;179;585
431100;201302;4534;13151;3952;12151;1110;3633;1873;5891;2983;9524
431110;201302;1431;4161;1263;3818;343;1081;710;2101;1053;3182
431112;201302;720;2366;694;2320;230;791;345;1186;575;1977
431113;201302;614;1924;485;1621;163;535;136;479;299;1014
431115;201302;1387;4377;1307;4233;330;1116;755;2436;1085;3552
431120;201302;2520;8504;2332;8148;771;2960;1010;3422;1781;6382
431123;201302;493;1663;433;1541;103;367;230;858;333;1225
431125;201302;1207;4075;1086;3827;341;1224;527;1936;868;3160
431127;201302;107;316;79;257;15;49;23;70;38;119
431130;201302;3543;10780;3126;10107;969;3408;1452;4748;2421;8156
431140;201302;2949;8969;2156;7425;514;2053;744;2349;1258;4402
431142;201302;528;1624;492;1568;74;254;336;1093;410;1347
431150;201302;1283;4055;1074;3654;323;1124;387;1356;710;2480
431160;201302;831;2638;718;2379;158;521;395;1337;553;1858
431162;201302;465;1384;329;1107;69;272;98;306;167;578
431164;201302;59;182;30;117;10;40;1;4;11;44
431170;201302;873;2719;745;2459;242;855;239;775;481;1630
431171;201302;835;2633;769;2506;284;1014;220;661;504;1675
431173;201302;458;1450;437;1409;95;324;280;897;375;1221
431175;201302;1298;3753;1159;3537;390;1250;520;1590;910;2840
431177;201302;967;3305;888;3142;300;1119;398;1442;698;2561
431179;201302;111;319;91;284;18;69;43;116;61;185
431180;201302;2922;9364;2551;8439;758;2777;829;2579;1587;5356
431190;201302;730;2104;492;1647;149;545;183;609;332;1154
431198;201302;315;1076;293;1032;137;549;61;193;198;742
431200;201302;216;675;118;414;26;104;24;81;50;185
431205;201302;284;961;233;816;63;220;81;283;144;503
431210;201302;743;2233;656;2046;161;533;355;1090;516;1623
431213;201302;288;974;267;941;89;340;104;350;193;690
431215;201302;303;931;184;642;55;218;35;104;90;322
431217;201302;215;709;196;667;73;271;48;164;121;435
431220;201302;1195;3155;1007;2848;160;510;598;1677;758;2187
431225;201302;1267;4020;1174;3870;308;1083;682;2294;990;3377
431230;201302;887;2813;745;2518;146;548;408;1382;554;1930
431235;201302;38;111;34;101;14;44;13;38;27;82
431237;201302;391;1364;351;1299;157;660;126;433;283;1093
431238;201302;50;170;44;158;11;46;15;50;26;96
431240;201302;2684;8990;2368;8393;881;3330;810;2827;1691;6157
431242;201302;420;1407;403;1378;198;731;34;123;232;854
431244;201302;404;1039;327;920;61;213;169;442;230;655
431245;201302;729;2304;694;2238;170;588;423;1362;593;1950
431247;201302;184;594;163;556;60;216;63;208;123;424
431250;201302;1852;6078;1671;5807;590;2183;690;2498;1280;4681
431260;201302;303;977;269;913;75;288;53;163;128;451
431261;201302;217;828;203;800;63;271;75;282;138;553
431262;201302;264;835;161;598;30;135;68;252;98;387
431265;201302;1113;3223;818;2560;218;784;296;782;514;1566
431267;201302;172;566;155;534;45;164;62;202;107;366
431270;201302;2186;6605;2019;6348;703;2341;969;3081;1672;5422
431275;201302;210;716;157;569;57;207;36;124;93;331
431280;201302;119;413;97;363;35;149;19;56;54;205
431290;201302;283;954;229;806;62;242;61;213;123;455
431295;201302;203;675;125;431;26;103;26;72;52;175
431300;201302;121;449;95;371;35;142;10;44;45;186
431301;201302;225;806;180;665;64;231;33;115;97;346
431303;201302;573;1694;511;1596;145;503;235;719;380;1222
431306;201302;1895;5537;1504;4820;343;1316;559;1602;902;2918
431308;201302;50;180;48;175;36;136;9;28;45;164
431310;201302;723;2433;565;2051;105;420;238;879;343;1299
431320;201302;746;2294;495;1779;161;632;101;349;262;981
431330;201302;1403;3961;875;2971;271;1007;199;663;470;1670
431333;201302;287;848;226;724;63;213;83;249;146;462
431335;201302;100;323;86;295;21;70;28;93;49;163
431337;201302;2242;7430;2060;7058;711;2561;773;2701;1484;5262
431339;201302;651;1982;534;1704;116;388;289;937;405;1325
431340;201302;24990;70863;19690;61851;5100;17997;8914;27385;14014;45382
431342;201302;569;1612;537;1553;121;362;340;972;461;1334
431344;201302;349;1040;287;931;29;108;181;595;210;703
431346;201302;234;695;185;575;59;198;55;165;114;363
431349;201302;489;1521;427;1363;82;269;216;697;298;966
431350;201302;3442;10903;3225;10559;539;2032;2178;6942;2717;8974
431360;201302;706;2051;587;1851;200;669;210;655;410;1324
431365;201302;1240;4035;1102;3798;460;1716;389;1321;849;3037
431370;201302;5221;16054;4674;15209;1136;3925;2655;8890;3791;12815
431380;201302;1120;3435;1077;3342;166;578;787;2398;953;2976
431390;201302;3433;10705;2836;9495;1070;3849;814;2615;1884;6464
431395;201302;1551;4848;1415;4632;365;1288;632;2123;997;3411
431400;201302;130;485;105;424;36;165;11;33;47;198
431402;201302;1080;2905;760;2341;161;545;355;1069;516;1614
431403;201302;309;923;234;785;78;291;51;165;129;456
431405;201302;3877;11687;3232;10728;734;2984;1639;5117;2373;8101
431406;201302;693;2359;571;2035;204;748;204;719;408;1467
431407;201302;609;1973;490;1664;161;557;162;549;323;1106
431410;201302;15506;50589;13380;46438;5742;20977;3425;12642;9167;33619
431413;201302;157;441;106;334;14;50;54;166;68;216
431415;201302;844;2535;767;2394;198;687;428;1307;626;1994
431417;201302;661;1775;535;1571;106;336;288;875;394;1211
431420;201302;1562;4499;1422;4281;367;1184;782;2382;1149;3566
431430;201302;491;1501;414;1379;144;525;161;511;305;1036
431440;201302;31294;95339;29039;91485;9917;32619;13342;43581;23259;76200
431442;201302;198;657;154;540;49;194;18;47;67;241
431445;201302;427;1265;350;1088;68;222;153;479;221;701
431446;201302;471;1422;374;1239;73;245;229;766;302;1011
431447;201302;790;2382;603;1942;106;348;287;969;393;1317
431449;201302;817;2505;719;2334;128;452;398;1308;526;1760
431450;201302;2128;5869;2000;5683;546;1565;1175;3367;1721;4932
431455;201302;569;1529;438;1282;74;262;261;732;335;994
431460;201302;3600;10555;3227;9846;908;2946;1474;4549;2382;7495
431470;201302;2050;6406;1915;6089;564;1802;918;3064;1482;4866
431475;201302;92;314;61;243;20;80;3;10;23;90
431477;201302;548;1714;480;1583;129;417;246;836;375;1253
431478;201302;167;450;92;284;24;78;36;109;60;187
431480;201302;2241;7115;1874;6405;648;2387;474;1632;1122;4019
431490;201302;96232;289741;86984;276154;17970;64232;55412;173415;73382;237647
431500;201302;1178;3163;950;2738;292;870;320;914;612;1784
431505;201302;342;1035;331;1020;40;118;259;810;299;928
431507;201302;422;1116;393;1068;118;329;219;608;337;937
431510;201302;2152;6156;1893;5758;298;972;1270;3847;1568;4819
431513;201302;204;655;186;606;47;165;81;268;128;433
431514;201302;108;273;66;206;13;44;38;124;51;168
431515;201302;743;2338;596;1984;142;516;299;938;441;1454
431517;201302;86;306;84;298;42;153;19;60;61;213
431520;201302;389;1296;328;1141;111;401;88;302;199;703
431530;201302;4306;11204;3584;10426;797;2278;2311;7236;3108;9514
431531;201302;267;783;200;655;55;204;84;289;139;493
431532;201302;516;1550;490;1495;100;333;288;868;388;1201
431535;201302;361;1086;262;826;61;220;64;178;125;398
431540;201302;2025;6959;1893;6782;186;520;1500;5754;1686;6274
431545;201302;130;404;70;253;7;30;13;44;20;74
431550;201302;2375;7485;2237;7215;583;2119;1059;3389;1642;5508
431555;201302;731;2034;673;1945;144;425;364;1046;508;1471
431560;201302;22215;72503;20577;69365;9098;30924;6908;24819;16006;55743
431570;201302;5298;15978;5048;15577;577;1817;3999;12473;4576;14290
431575;201302;400;1232;355;1163;68;241;189;604;257;845
431580;201302;674;2250;590;2055;158;610;221;719;379;1329
431590;201302;839;2631;720;2341;87;313;403;1300;490;1613
431595;201302;588;1761;541;1665;140;455;235;745;375;1200
431600;201302;2045;6532;1723;5830;534;2028;392;1153;926;3181
431610;201302;1525;4541;1199;3975;320;1163;597;1965;917;3128
431620;201302;274;898;228;760;81;288;94;292;175;580
431630;201302;1275;3649;1090;3258;257;787;581;1758;838;2545
431640;201302;5323;17360;5023;16836;1660;5967;2387;7892;4047;13859
431642;201302;469;1505;442;1440;61;236;276;877;337;1113
431643;201302;174;541;164;522;49;169;83;245;132;414
431645;201302;1738;5553;1624;5353;418;1400;936;3188;1354;4588
431647;201302;164;473;138;419;47;149;44;115;91;264
431650;201302;168;575;119;474;30;143;30;104;60;247
431660;201302;1418;4395;1162;3853;403;1407;448;1433;851;2840
431670;201302;1241;3729;1073;3425;350;1256;421;1276;771;2532
431673;201302;149;519;130;471;43;168;35;134;78;302
431675;201302;278;955;226;793;59;214;63;197;122;411
431680;201302;9228;27910;7664;25075;2607;9131;2871;9488;5478;18619
431690;201302;23673;71289;20164;66120;6669;23219;8595;28766;15264;51985
431695;201302;133;494;109;419;25;92;26;76;51;168
431697;201302;457;1362;438;1330;135;437;199;605;334;1042
431700;201302;1608;4723;1435;4387;282;968;798;2374;1080;3342
431710;201302;12172;37300;10612;34581;3007;10227;5181;17539;8188;27766
431720;201302;6528;19581;5866;18477;1459;5237;3357;10296;4816;15533
431725;201302;41;150;40;147;22;82;6;22;28;104
431730;201302;3426;11171;2974;10317;918;3518;1258;4317;2176;7835
431740;201302;5897;18028;5399;17092;1839;6248;2036;6372;3875;12620
431750;201302;9997;29800;8743;27709;1745;5988;4909;15867;6654;21855
431755;201302;206;584;80;289;27;110;19;57;46;167
431760;201302;3524;11403;3116;10619;1007;3704;929;3129;1936;6833
431770;201302;2215;6451;1948;6007;495;1680;1041;3147;1536;4827
431775;201302;231;686;193;615;81;276;63;183;144;459
431780;201302;2375;6749;2002;6050;651;2109;592;1721;1243;3830
431790;201302;1052;3540;987;3423;299;1106;508;1746;807;2852
431795;201302;408;1360;356;1195;47;174;238;790;285;964
431800;201302;9009;27940;7972;26035;2498;8906;3155;10182;5653;19088
431805;201302;206;510;70;245;22;91;18;60;40;151
431810;201302;3617;10730;3195;9831;879;2873;1483;4544;2362;7417
431820;201302;2574;8531;2363;8119;871;3242;593;1981;1464;5223
431830;201302;9847;27982;8716;26128;3290;10628;3196;9629;6486;20257
431840;201302;3444;10829;3096;10113;1009;3378;1355;4521;2364;7899
431842;201302;691;1883;440;1382;95;337;157;471;252;808
431843;201302;267;896;255;870;78;272;127;444;205;716
431844;201302;158;494;127;432;37;141;38;133;75;274
431845;201302;538;1709;512;1659;51;165;373;1240;424;1405
431846;201302;502;1605;452;1495;88;330;258;849;346;1179
431848;201302;195;536;97;335;19;80;24;75;43;155
431849;201302;292;770;140;438;31;106;38;107;69;213
431850;201302;4869;14600;4416;13759;1122;3904;2346;7070;3468;10974
431860;201302;880;2701;789;2537;205;741;379;1157;584;1898
431861;201302;77;250;57;187;15;58;16;46;31;104
431862;201302;468;1667;421;1561;155;610;145;544;300;1154
431870;201302;25915;75357;22220;68722;6386;21720;9870;29880;16256;51600
431880;201302;4454;14873;3857;13434;1265;4846;1574;5296;2839;10142
431890;201302;5691;17174;5165;16169;2103;6853;1659;5372;3762;12225
431900;201302;927;3112;830;2928;281;1101;310;1007;591;2108
431910;201302;686;1827;450;1378;96;340;197;551;293;891
431912;201302;587;1748;476;1517;144;455;167;554;311;1009
431915;201302;1195;3528;996;3138;308;997;333;1067;641;2064
431920;201302;1451;4367;1404;4299;203;603;1087;3415;1290;4018
431930;201302;1181;3496;990;3158;136;445;568;1933;704;2378
431935;201302;93;372;88;359;40;167;17;58;57;225
431936;201302;474;1398;436;1330;76;227;283;931;359;1158
431937;201302;281;813;206;660;54;186;66;201;120;387
431940;201302;2613;7516;1934;6256;601;2073;551;1754;1152;3827
431950;201302;1778;5902;1605;5565;501;1919;616;2038;1117;3957
431960;201302;3667;11292;3383;10721;1109;3751;1246;3997;2355;7748
431970;201302;498;1418;292;999;58;214;98;319;156;533
431971;201302;126;393;112;372;23;86;68;214;91;300
431973;201302;442;1663;397;1568;72;286;226;975;298;1261
431975;201302;12;51;9;43;2;12;4;17;6;29
431980;201302;1508;4490;1435;4389;360;1277;803;2403;1163;3680
431990;201302;8287;24379;7110;22586;1427;5177;3882;12232;5309;17409
432000;201302;9465;29540;8219;27335;2955;10135;3460;11768;6415;21903
432010;201302;2401;7386;2147;6893;547;2010;1026;3142;1573;5152
432020;201302;1867;5493;1737;5310;365;1195;1071;3252;1436;4447
432023;201302;504;1531;401;1302;123;443;158;485;281;928
432026;201302;1239;3965;1120;3731;197;666;725;2469;922;3135
432030;201302;385;1206;336;1094;102;357;141;434;243;791
432032;201302;437;1223;345;1090;51;182;240;749;291;931
432035;201302;843;2810;780;2673;213;798;436;1452;649;2250
432040;201302;586;1889;472;1627;136;513;97;264;233;777
432045;201302;183;638;168;604;48;185;75;268;123;453
432050;201302;739;2225;684;2119;148;479;402;1272;550;1751
432055;201302;707;2364;659;2258;155;568;415;1409;570;1977
432057;201302;470;1329;418;1224;70;227;238;658;308;885
432060;201302;364;1101;190;686;61;236;48;166;109;402
432065;201302;186;614;164;573;46;187;69;219;115;406
432067;201302;845;3003;675;2576;211;825;271;1012;482;1837
432070;201302;2149;6497;1962;6117;716;2427;751;2351;1467;4778
432080;201302;3954;12056;3641;11514;1150;3820;1659;5239;2809;9059
432085;201302;245;824;217;773;84;348;61;203;145;551
432090;201302;1570;5193;1401;4805;568;2065;357;1074;925;3139
432100;201302;1000;3170;686;2431;220;823;157;504;377;1327
432110;201302;2884;9059;2481;8268;948;3379;565;1906;1513;5285
432120;201302;4885;15627;4283;14441;1578;5812;1164;3814;2742;9626
432130;201302;1869;6111;1775;5946;546;1961;975;3283;1521;5244
432132;201302;386;1259;270;976;57;210;91;310;148;520
432135;201302;772;2353;731;2275;135;448;479;1488;614;1936
432140;201302;2835;8626;2449;7947;689;2262;1040;3793;1729;6055
432143;201302;1226;4038;1156;3920;262;903;767;2679;1029;3582
432145;201302;697;2332;560;2037;232;924;116;393;348;1317
432146;201302;231;775;193;678;69;253;57;202;126;455
432147;201302;803;2687;697;2469;219;798;334;1239;553;2037
432149;201302;381;1214;291;979;71;255;120;397;191;652
432150;201302;2823;9121;2451;8558;1067;3890;734;2709;1801;6599
432160;201302;4231;14456;3844;13792;1488;5637;1378;5227;2866;10864
432162;201302;309;783;97;327;25;95;25;68;50;163
432163;201302;319;841;108;344;22;68;26;83;48;151
432166;201302;719;2260;615;2047;155;575;252;772;407;1347
432170;201302;724;2535;543;2117;149;657;114;377;263;1034
432180;201302;2589;7159;2004;6278;637;2175;685;2078;1322;4253
432183;201302;380;1327;359;1289;158;579;107;397;265;976
432185;201302;729;2201;496;1687;137;513;155;514;292;1027
432190;201302;3241;9431;2619;8051;768;2554;852;2472;1620;5026
432195;201302;1218;3617;1104;3446;202;681;689;2148;891;2829
432200;201302;2950;9496;2471;8681;850;3130;1039;3787;1889;6917
432210;201302;411;1270;375;1223;111;421;177;534;288;955
432215;201302;821;2738;772;2649;151;495;502;1813;653;2308
432218;201302;286;868;250;788;43;156;136;410;179;566
432220;201302;3590;10187;3079;9345;639;2203;1749;5195;2388;7398
432225;201302;54;196;48;188;29;117;5;27;34;144
432230;201302;919;2793;848;2693;293;1020;401;1214;694;2234
432232;201302;518;1595;421;1405;98;370;224;743;322;1113
432234;201302;568;1652;519;1565;127;379;290;899;417;1278
432235;201302;67;222;42;159;21;92;9;31;30;123
432237;201302;476;1380;445;1328;39;150;368;1080;407;1230
432240;201302;14508;51065;12967;48974;3419;13794;7553;29302;10972;43096
432250;201302;5275;19276;5087;18885;2547;10015;1259;4886;3806;14901
432252;201302;384;1247;373;1225;119;393;196;677;315;1070
432253;201302;1149;4110;1013;3748;349;1353;349;1301;698;2654
432254;201302;294;832;167;565;55;189;23;86;78;275
432255;201302;162;424;92;314;24;92;38;131;62;223
432260;201302;5548;16169;4786;14916;1170;3907;2547;7958;3717;11865
432270;201302;2439;8092;2269;7789;617;2158;1261;4422;1878;6580
432280;201302;942;3041;712;2509;195;791;191;577;386;1368
432285;201302;111;359;79;269;24;92;19;51;43;143
432290;201302;543;1756;411;1425;86;345;167;547;253;892
432300;201302;21563;69090;20253;66873;5724;19973;10759;35717;16483;55690
432310;201302;956;3210;866;3042;218;822;443;1527;661;2349
432320;201302;253;757;198;651;61;201;67;235;128;436
432330;201302;165;523;97;354;26;105;11;34;37;139
432335;201302;198;595;108;372;38;136;15;40;53;176
432340;201302;260;704;145;453;45;145;41;121;86;266
432345;201302;721;2180;686;2128;191;695;363;1056;554;1751
432350;201302;400;1226;322;1083;91;328;92;293;183;621
432360;201302;51;176;44;157;15;56;19;65;34;121
432370;201302;445;1306;401;1229;35;106;272;836;307;942
432375;201302;772;2120;700;2005;121;355;451;1311;572;1666
432377;201302;54;193;29;108;5;21;7;19;12;40
432380;201302;821;3026;761;2877;354;1458;235;832;589;2290
500020;201302;1503;5535;1333;5142;536;2280;325;1157;861;3437
500025;201302;675;2030;597;1912;161;531;288;903;449;1434
500060;201302;4910;15675;4444;15127;348;1192;3854;13404;4202;14596
500070;201302;3172;10423;2782;9776;801;3134;1202;4163;2003;7297
500080;201302;1544;4952;1294;4535;456;1710;456;1667;912;3377
500085;201302;2072;5921;1603;5178;259;934;952;2979;1211;3913
500090;201302;1922;6110;1682;5695;397;1353;893;3133;1290;4486
500100;201302;2221;7074;2127;6967;845;3034;903;2895;1748;5929
500110;201302;7007;21743;6019;20297;998;3820;3727;12872;4725;16692
500124;201302;1290;4800;1175;4593;236;912;692;2905;928;3817
500150;201302;1233;3517;1059;3272;304;990;513;1589;817;2579
500190;201302;4233;12008;3395;11012;951;3358;1690;5710;2641;9068
500200;201302;2380;6597;1789;5748;488;1785;850;2609;1338;4394
500210;201302;4388;13984;3918;13303;886;3192;2191;7754;3077;10946
500215;201302;1607;5277;1409;4851;363;1420;640;2086;1003;3506
500220;201302;2265;7797;1999;7309;567;2217;833;3091;1400;5308
500230;201302;1451;4832;1346;4674;661;2460;423;1442;1084;3902
500240;201302;3767;12893;3127;11557;823;3328;1291;4989;2114;8317
500260;201302;2289;6652;1957;6127;511;1758;902;2676;1413;4434
500270;201302;87622;245210;65747;207981;22289;76636;18209;58842;40498;135478
500280;201302;1188;3736;1055;3552;259;931;562;1952;821;2883
500290;201302;3211;9084;2423;7672;779;2809;856;2506;1635;5315
500295;201302;2051;6786;1670;5832;468;1854;488;1529;956;3383
500310;201302;763;2195;695;2104;182;597;372;1090;554;1687
500315;201302;2671;8726;2359;8305;557;1918;1427;5344;1984;7262
500320;201302;11222;40302;10309;38804;3741;14544;4109;16637;7850;31181
500325;201302;3112;9365;2600;8526;884;3200;873;2692;1757;5892
500330;201302;4691;13999;4241;13273;1359;4649;1971;6056;3330;10705
500345;201302;2085;6981;1985;6765;572;2132;942;3139;1514;5271
500348;201302;2258;7184;2167;7024;285;989;1682;5465;1967;6454
500350;201302;1067;3432;742;2707;162;606;221;880;383;1486
500370;201302;19821;66014;17064;60715;4700;18520;7396;26273;12096;44793
500375;201302;1995;6118;1736;5667;483;1691;842;2801;1325;4492
500380;201302;2665;8119;2398;7585;764;2587;964;3058;1728;5645
500390;201302;496;1188;377;1020;65;224;248;604;313;828
500400;201302;1085;3682;1002;3490;355;1338;296;962;651;2300
500410;201302;1900;5560;1667;5261;496;1705;751;2383;1247;4088
500430;201302;2223;7380;1946;6969;633;2366;866;3225;1499;5591
500440;201302;1232;3780;1090;3555;305;1145;593;1832;898;2977
500450;201302;2046;6620;1668;5835;480;1895;334;1049;814;2944
500460;201302;3315;10827;2835;10147;754;2891;1426;5112;2180;8003
500470;201302;3061;10202;2812;9591;1025;3717;802;2631;1827;6348
500480;201302;1928;6568;1797;6355;195;737;1384;4996;1579;5733
500490;201302;829;2691;773;2590;276;986;327;1108;603;2094
500500;201302;2824;9361;2463;8883;909;3656;996;3460;1905;7116
500510;201302;746;2166;581;1918;176;698;247;710;423;1408
500515;201302;1577;4729;1347;4388;307;990;789;2727;1096;3717
500520;201302;2400;8963;2179;8683;610;2507;1292;5391;1902;7898
500525;201302;1012;3607;939;3489;272;1068;447;1744;719;2812
500540;201302;2978;10580;2663;9990;949;3821;954;3548;1903;7369
500560;201302;4223;15118;3883;14634;935;3737;2431;9289;3366;13026
500568;201302;3370;9526;2680;8561;672;2325;1374;4550;2046;6875
500570;201302;6793;19464;5193;16819;1597;5492;2175;7128;3772;12620
500580;201302;2664;8928;2339;8312;562;2145;1271;4487;1833;6632
500600;201302;2094;6756;1848;6381;677;2474;728;2457;1405;4931
500620;201302;7144;20958;5426;18282;1468;5523;2606;8678;4074;14201
500625;201302;760;2434;589;2077;185;722;188;615;373;1337
500630;201302;5655;16608;4689;15239;1818;6498;1252;4100;3070;10598
500635;201302;2037;8713;1868;8433;318;1371;1194;5826;1512;7197
500640;201302;1185;3346;1006;3077;172;602;658;1950;830;2552
500660;201302;12802;41401;11356;38885;2311;8442;7003;24203;9314;32645
500690;201302;2887;8665;2421;8085;462;1591;1554;5451;2016;7042
500710;201302;3031;10178;2915;9998;915;3230;1516;5315;2431;8545
500720;201302;3354;11052;3010;10463;1131;4262;1063;3676;2194;7938
500730;201302;734;2350;659;2207;196;714;267;873;463;1587
500740;201302;3141;9331;2454;8140;646;2467;1033;3214;1679;5681
500750;201302;679;2223;648;2175;157;604;394;1267;551;1871
500755;201302;1070;3436;882;3090;238;893;366;1262;604;2155
500769;201302;3959;11407;2977;9484;809;2879;1029;3065;1838;5944
500770;201302;1453;4630;1255;4272;373;1345;527;1841;900;3186
500780;201302;872;3047;844;2980;312;1172;368;1252;680;2424
500790;201302;6792;21459;6042;20119;1499;5714;3094;9869;4593;15583
500793;201302;2237;6800;1867;6176;382;1482;890;2801;1272;4283
500795;201302;2049;6558;1866;6289;196;633;1451;5074;1647;5707
500797;201302;825;2434;682;2206;179;634;315;1044;494;1678
500800;201302;1898;6182;1702;5911;543;2044;847;2959;1390;5003
500830;201302;12098;39636;10198;35494;3653;13568;2799;9750;6452;23318
500840;201302;1144;3719;1015;3470;214;802;541;1827;755;2629
510010;201302;1197;3946;1136;3839;383;1384;510;1751;893;3135
510020;201302;2203;6840;1791;6177;629;2288;486;1594;1115;3882
510025;201302;8489;26960;7641;25558;2650;9666;3009;9923;5659;19589
510030;201302;2054;5731;1776;5340;549;1718;886;2722;1435;4440
510035;201302;860;2721;746;2549;188;664;409;1464;597;2128
510040;201302;1465;4237;1188;3838;322;1187;565;1771;887;2958
510050;201302;1475;4698;1260;4374;409;1542;520;1844;929;3386
510060;201302;1061;3267;855;2892;273;1018;260;847;533;1865
510080;201302;1259;4027;1079;3729;304;1220;458;1466;762;2686
510100;201302;523;1482;384;1223;117;439;152;442;269;881
510120;201302;245;525;178;451;16;38;154;397;170;435
510125;201302;2557;7221;2206;6679;432;1585;1214;3576;1646;5161
510130;201302;1835;5459;1673;5242;518;1686;759;2442;1277;4128
510140;201302;2708;9343;2359;8837;806;3114;1023;3953;1829;7067
510160;201302;1254;4375;1204;4317;88;354;1062;3810;1150;4164
510170;201302;5181;17011;4642;16026;1322;5044;2105;7086;3427;12130
510180;201302;8365;25602;6897;23076;2292;8100;2701;9712;4993;17812
510185;201302;990;3278;935;3199;270;894;546;1998;816;2892
510190;201302;1341;5008;1218;4803;336;1426;553;2272;889;3698
510250;201302;13061;43626;11586;41657;3663;13819;5934;21891;9597;35710
510260;201302;2459;9166;2362;9008;626;2213;1475;6037;2101;8250
510263;201302;3643;10724;2980;9661;894;3128;1172;3767;2066;6895
510267;201302;3913;12157;3387;11109;906;3305;1511;4787;2417;8092
510268;201302;794;2374;697;2242;224;776;328;1062;552;1838
510269;201302;767;2621;695;2500;255;949;228;862;483;1811
510270;201302;1930;6438;1772;6217;500;1852;875;3254;1375;5106
510279;201302;1983;6694;1845;6460;690;2650;738;2481;1428;5131
510285;201302;1360;4436;1189;4098;393;1463;366;1187;759;2650
510300;201302;2866;9329;2667;9071;378;1420;2020;6885;2398;8305
510305;201302;1496;5065;1295;4705;378;1476;499;1922;877;3398
510310;201302;1059;3162;854;2838;323;1182;269;895;592;2077
510320;201302;3631;11347;3085;10261;1034;3994;637;1795;1671;5789
510325;201302;5143;17124;4547;16205;590;2071;3451;12752;4041;14823
510330;201302;2527;8670;2248;8148;631;2518;871;3260;1502;5778
510335;201302;4120;13807;3709;13240;693;2491;2631;9748;3324;12239
510336;201302;423;1424;397;1379;96;366;200;696;296;1062
510337;201302;2280;7949;2104;7629;877;3261;786;3028;1663;6289
510340;201302;52510;166295;44604;154440;18653;69637;11139;40860;29792;110497
510343;201302;1018;3260;971;3201;139;442;761;2592;900;3034
510345;201302;1512;4684;1375;4502;439;1492;576;1944;1015;3436
510350;201302;2923;9422;2573;8954;797;2946;1327;4708;2124;7654
510360;201302;1414;4430;1290;4261;303;1045;856;2837;1159;3882
510370;201302;748;2803;669;2666;229;959;290;1184;519;2143
510380;201302;450;1547;387;1412;149;602;70;230;219;832
510385;201302;839;3317;765;3137;145;610;390;1743;535;2353
510390;201302;995;3406;921;3315;261;953;498;1904;759;2857
510395;201302;807;2203;647;1994;140;470;391;1239;531;1709
510410;201302;3554;12422;3395;12152;1131;4336;1635;5828;2766;10164
510420;201302;1900;5314;1610;4920;273;988;962;2930;1235;3918
510450;201302;519;1549;415;1402;140;525;126;422;266;947
510452;201302;506;1648;416;1452;123;497;139;433;262;930
510454;201302;662;2262;590;2154;182;676;307;1171;489;1847
510455;201302;856;2801;717;2565;204;852;289;1009;493;1861
510460;201302;1575;4946;1475;4811;390;1458;876;2731;1266;4189
510480;201302;3690;10602;3024;9383;809;2716;1308;4032;2117;6748
510490;201302;1371;4806;1265;4651;408;1551;684;2550;1092;4101
510500;201302;1138;3811;983;3587;290;1185;532;1895;822;3080
510510;201302;2781;10159;2522;9741;1032;4125;986;3904;2018;8029
510515;201302;4915;15957;4200;14536;1232;4764;1313;4356;2545;9120
510517;201302;1446;4819;1326;4637;370;1301;820;2948;1190;4249
510520;201302;2055;5573;1688;5067;149;539;1291;3815;1440;4354
510523;201302;933;3033;792;2794;248;950;358;1232;606;2182
510525;201302;7147;18511;4485;14263;1187;4104;1488;4681;2675;8785
510530;201302;513;1593;463;1519;94;339;274;918;368;1257
510550;201302;2434;8425;2222;8115;660;2446;1151;4424;1811;6870
510558;201302;1865;5626;1479;5053;534;1946;473;1609;1007;3555
510560;201302;1353;4768;1111;4359;447;1784;286;1198;733;2982
510562;201302;4326;14051;4039;13501;1543;5591;1427;4780;2970;10371
510590;201302;2398;7446;1958;6887;593;2283;894;3154;1487;5437
510600;201302;1306;3512;989;3058;180;633;574;1746;754;2379
510610;201302;2322;7620;2235;7520;314;1205;1793;5963;2107;7168
510615;201302;1968;6931;1779;6589;601;2402;788;2882;1389;5284
510617;201302;461;1606;439;1572;77;313;327;1157;404;1470
510618;201302;1122;3514;875;3030;244;948;371;1276;615;2224
510619;201302;685;1994;474;1608;114;436;159;536;273;972
510620;201302;1056;3036;798;2667;269;1003;182;582;451;1585
510621;201302;1109;3991;987;3709;316;1293;384;1409;700;2702
510622;201302;2882;9568;2283;8150;682;2736;493;1559;1175;4295
510623;201302;3179;9835;2862;9391;1258;4216;878;3010;2136;7226
510624;201302;916;3235;839;3065;212;835;384;1354;596;2189
510625;201302;1871;6042;1632;5558;542;2030;541;1716;1083;3746
510626;201302;1128;3860;978;3621;296;1161;516;1952;812;3113
510627;201302;594;2008;501;1823;198;768;171;629;369;1397
510628;201302;1385;3890;1172;3632;189;655;818;2525;1007;3180
510629;201302;1580;5539;1428;5225;583;2235;325;1219;908;3454
510630;201302;2716;9288;2362;8707;853;3395;798;3039;1651;6434
510631;201302;379;1177;343;1118;81;263;221;733;302;996
510637;201302;2292;7380;2188;7200;743;2716;1028;3257;1771;5973
510642;201302;4243;14416;3677;13691;1240;4714;1872;7352;3112;12066
510645;201302;628;1666;529;1544;190;592;190;604;380;1196
510650;201302;5432;19529;5218;19235;1305;5074;3173;12070;4478;17144
510665;201302;1083;2981;844;2696;219;794;467;1488;686;2282
510670;201302;343;881;213;692;64;233;83;247;147;480
510675;201302;5768;19755;5105;18555;1942;7687;1575;5668;3517;13355
510677;201302;2278;6047;1725;5358;242;787;1276;4025;1518;4812
510680;201302;736;2433;649;2306;181;711;263;868;444;1579
510682;201302;2072;7089;1794;6567;504;1917;821;3190;1325;5107
510685;201302;685;2295;661;2254;197;704;352;1240;549;1944
510700;201302;2654;8482;2347;8040;520;1987;1470;4954;1990;6941
510704;201302;6467;19890;5791;18751;1887;6800;2655;8294;4542;15094
510706;201302;1266;4437;1192;4293;414;1560;561;1968;975;3528
510710;201302;3200;9682;2810;8965;856;3131;1159;3374;2015;6505
510715;201302;665;1819;461;1481;139;489;151;436;290;925
510718;201302;1495;4957;1401;4803;329;1195;898;3086;1227;4281
510719;201302;424;1014;260;784;45;177;123;335;168;512
510720;201302;1206;3017;913;2671;103;340;677;1991;780;2331
510724;201302;756;2469;686;2342;152;540;421;1442;573;1982
510726;201302;631;1767;566;1665;172;555;244;681;416;1236
510729;201302;554;1704;487;1593;138;490;229;740;367;1230
510730;201302;1949;6544;1838;6347;488;1962;1096;3593;1584;5555
510735;201302;1030;3700;919;3546;313;1198;467;1890;780;3088
510740;201302;921;2478;795;2322;119;365;575;1717;694;2082
510757;201302;575;2185;569;2171;156;626;345;1299;501;1925
510760;201302;22412;70152;19733;65402;7646;27107;6692;22192;14338;49299
510770;201302;3345;10739;3222;10571;647;2133;2121;7306;2768;9439
510774;201302;369;1052;311;973;40;149;215;669;255;818
510775;201302;805;2353;677;2173;265;935;286;943;551;1878
510776;201302;313;1049;287;999;81;313;132;425;213;738
510777;201302;1310;4321;1061;4008;244;1086;646;2377;890;3463
510779;201302;580;1816;472;1623;102;383;198;698;300;1081
510780;201302;3329;10631;3088;10295;732;2546;1857;6310;2589;8856
510785;201302;1765;5458;1511;5050;522;1797;612;2122;1134;3919
510787;201302;1800;5955;1642;5673;532;1993;559;1916;1091;3909
510788;201302;325;1031;298;1001;84;253;158;562;242;815
510790;201302;11826;37411;8878;31752;3006;12140;1453;5133;4459;17273
510792;201302;4528;15948;3720;14170;1148;4991;701;2484;1849;7475
510794;201302;1243;4083;1039;3786;561;2150;202;694;763;2844
510795;201302;7228;25628;6391;23823;2344;9222;1808;6997;4152;16219
510800;201302;1573;4839;1389;4605;402;1484;714;2289;1116;3773
510805;201302;1522;4623;1273;4261;311;1185;773;2526;1084;3711
510810;201302;579;1525;478;1387;143;470;249;683;392;1153
510820;201302;819;2128;640;1854;174;604;254;672;428;1276
510830;201302;518;1902;474;1831;175;702;206;847;381;1549
510835;201302;634;2084;515;1851;211;818;199;675;410;1493
510840;201302;41041;111956;34806;104270;9461;29875;18703;57940;28164;87815
510850;201302;1588;4883;1339;4490;619;2295;219;598;838;2893
510860;201302;2159;7705;1927;7220;727;2870;477;1834;1204;4704
510880;201302;776;2747;697;2596;281;1091;245;912;526;2003
510885;201302;475;1429;365;1259;90;365;165;552;255;917
510890;201302;827;2935;726;2728;244;1026;187;663;431;1689
510895;201302;977;3327;910;3215;299;1178;390;1309;689;2487
520005;201302;976;3369;924;3285;317;1210;371;1307;688;2517
520010;201302;1689;6169;1539;5836;705;2943;224;724;929;3667
520013;201302;3393;10102;2874;9279;812;2784;1432;4646;2244;7430
520015;201302;562;1572;455;1420;123;390;225;743;348;1133
520017;201302;1085;3695;986;3522;284;1078;447;1607;731;2685
520020;201302;326;947;283;891;94;311;145;468;239;779
520025;201302;18080;62803;17755;62361;3516;13019;12865;45234;16381;58253
520030;201302;4028;13870;3696;13343;1508;5754;1262;4830;2770;10584
520050;201302;299;943;286;915;68;245;178;547;246;792
520055;201302;597;1869;514;1739;146;497;244;866;390;1363
520060;201302;1549;5116;1403;4839;370;1410;580;2077;950;3487
520080;201302;1411;4956;1364;4865;319;1188;843;3046;1162;4234
520082;201302;596;2126;569;2067;179;654;314;1187;493;1841
520085;201302;956;3110;847;2844;225;818;339;1151;564;1969
520090;201302;736;2086;677;1984;104;309;448;1335;552;1644
520110;201302;31279;102862;25933;94942;11310;44578;7154;26591;18464;71169
520120;201302;259;686;154;508;48;172;54;200;102;372
520130;201302;3207;10094;3083;9909;913;3172;1617;5190;2530;8362
520140;201302;39530;138115;36727;132376;14034;54220;11842;42809;25876;97029
520145;201302;530;1413;395;1233;92;317;170;511;262;828
520150;201302;623;1711;535;1597;168;538;254;754;422;1292
520160;201302;743;2349;678;2256;250;878;303;1018;553;1896
520170;201302;3395;8910;2787;8266;714;2152;1716;5346;2430;7498
520180;201302;1350;4582;1269;4442;439;1639;526;1831;965;3470
520215;201302;1357;3871;1214;3667;244;852;753;2275;997;3127
520235;201302;747;2108;611;1914;197;686;263;796;460;1482
520250;201302;1028;3628;970;3520;338;1277;529;1918;867;3195
520260;201302;643;1811;527;1601;95;334;275;802;370;1136
520280;201302;536;1642;489;1563;226;743;141;503;367;1246
520310;201302;797;2212;661;2056;116;355;504;1605;620;1960
520320;201302;1175;3996;1022;3723;281;1082;461;1714;742;2796
520330;201302;2513;8211;2096;7527;704;2749;707;2522;1411;5271
520340;201302;1778;4807;1485;4460;298;862;1080;3361;1378;4223
520350;201302;2613;8522;2381;8069;969;3466;980;3264;1949;6730
520355;201302;1029;3732;1017;3705;403;1548;476;1732;879;3280
520357;201302;871;2477;760;2318;78;270;532;1618;610;1888
520360;201302;489;1373;447;1324;116;343;292;889;408;1232
520380;201302;941;2658;756;2389;189;657;404;1299;593;1956
520390;201302;1146;3175;815;2726;295;1127;286;880;581;2007
520393;201302;549;1547;510;1489;103;303;345;1026;448;1329
520396;201302;650;2180;628;2143;70;274;498;1701;568;1975
520400;201302;1746;5107;1514;4786;284;974;1041;3328;1325;4302
520410;201302;1329;3949;1105;3615;369;1326;495;1571;864;2897
520420;201302;307;906;254;821;66;251;128;399;194;650
520425;201302;1377;3984;1310;3859;433;1373;649;1873;1082;3246
520430;201302;1712;4822;1339;4227;343;1241;602;1884;945;3125
520440;201302;2250;6886;1941;6412;765;2732;630;2025;1395;4757
520450;201302;8144;24734;6962;22738;2317;8458;2175;6760;4492;15218
520455;201302;638;1988;546;1855;247;881;144;511;391;1392
520460;201302;670;2105;583;1964;223;806;213;733;436;1539
520465;201302;814;2301;721;2174;189;676;325;911;514;1587
520470;201302;1546;5278;1434;5107;370;1358;877;3223;1247;4581
520480;201302;798;2487;739;2411;175;585;490;1614;665;2199
520485;201302;1053;3715;990;3610;378;1461;446;1630;824;3091
520490;201302;4214;13669;3518;12585;818;3230;1959;7166;2777;10396
520495;201302;1356;3775;1142;3518;72;181;1032;3264;1104;3445
520500;201302;1931;5334;1770;5130;551;1648;857;2763;1408;4411
520505;201302;826;2473;719;2308;97;288;541;1786;638;2074
520510;201302;10323;29887;6929;23948;2234;8485;1689;5832;3923;14317
520520;201302;893;2829;808;2720;344;1224;309;1052;653;2276
520530;201302;2238;7288;2022;6951;473;1600;1113;4280;1586;5880
520540;201302;2630;8636;2453;8337;875;3096;1085;3658;1960;6754
520545;201302;1270;4070;1106;3721;369;1344;331;1064;700;2408
520547;201302;748;2402;599;2138;215;858;182;602;397;1460
520549;201302;7226;23307;6490;22478;1413;5381;4510;15456;5923;20837
520551;201302;3314;10516;3192;10369;961;3189;1748;6050;2709;9239
520552;201302;659;2306;645;2282;146;574;424;1477;570;2051
520570;201302;561;1718;429;1495;186;672;97;351;283;1023
520580;201302;1848;5625;1517;5103;501;1900;361;1122;862;3022
520590;201302;1389;4132;1248;3900;322;1129;608;1761;930;2890
520620;201302;6252;21480;5796;20767;1473;5630;3246;11839;4719;17469
520630;201302;561;1591;481;1497;143;416;300;986;443;1402
520640;201302;2047;6716;1976;6606;708;2424;963;3335;1671;5759
520650;201302;722;2226;677;2139;297;1004;263;812;560;1816
520660;201302;347;1150;311;1076;110;410;95;327;205;737
520670;201302;696;2211;688;2200;77;192;588;1946;665;2138
520680;201302;457;1561;438;1534;177;665;150;509;327;1174
520690;201302;302;800;214;679;28;95;121;402;149;497
520710;201302;290;835;269;806;8;28;225;665;233;693
520725;201302;1523;4320;1285;4006;342;1162;723;2255;1065;3417
520735;201302;572;1845;500;1727;202;724;162;551;364;1275
520740;201302;1497;4595;1308;4344;394;1375;624;2117;1018;3492
520750;201302;649;1800;497;1606;148;519;291;947;439;1466
520753;201302;1031;3182;1018;3163;155;441;823;2613;978;3054
520760;201302;1087;3165;978;3030;332;1104;537;1616;869;2720
520780;201302;1756;4727;1573;4488;182;527;1264;3660;1446;4187
520790;201302;2351;7188;2149;6887;277;937;1578;5171;1855;6108
520800;201302;15888;49458;14296;47545;3028;10385;9039;31753;12067;42138
520810;201302;772;2419;757;2390;87;300;607;1941;694;2241
520815;201302;273;1052;246;992;152;649;46;174;198;823
520830;201302;1619;4360;1277;4003;72;207;1142;3663;1214;3870
520840;201302;1576;5501;1453;5244;489;1859;564;2094;1053;3953
520850;201302;773;2288;615;2073;191;688;280;920;471;1608
520860;201302;6675;20068;5254;18214;1632;6162;2599;9109;4231;15271
520870;201302;111797;328749;82399;274129;27957;100295;24848;83115;52805;183410
520880;201302;5424;16949;4202;14884;1336;5230;532;1699;1868;6929
520890;201302;3267;10284;3038;9922;771;2667;1661;5383;2432;8050
520910;201302;3605;12027;3251;11315;1128;4247;1140;3822;2268;8069
520915;201302;853;2510;628;2056;131;467;254;784;385;1251
520920;201302;2288;6945;1964;6512;507;1840;976;3296;1483;5136
520929;201302;421;1322;394;1288;110;385;208;672;318;1057
520940;201302;875;2876;838;2829;104;399;675;2261;779;2660
520945;201302;621;1604;581;1551;77;224;416;1090;493;1314
520960;201302;834;2555;713;2389;121;435;465;1568;586;2003
520970;201302;3172;9526;2609;8507;561;2084;1165;3768;1726;5852
520980;201302;978;2742;916;2657;78;225;795;2326;873;2551
520990;201302;3567;11449;3174;10752;685;2397;1732;6448;2417;8845
520993;201302;940;2882;770;2529;188;677;364;1158;552;1835
520995;201302;2349;6688;2152;6425;375;1135;1576;4775;1951;5910
521000;201302;7162;22427;6267;21012;1550;5572;3634;12375;5184;17947
521010;201302;3101;10339;2836;9840;805;2954;1388;4903;2193;7857
521015;201302;626;1896;558;1796;122;405;317;1028;439;1433
521020;201302;4088;12607;3463;11356;1372;4839;781;2315;2153;7154
521030;201302;779;2178;698;2065;116;367;509;1517;625;1884
521040;201302;4826;14902;4418;14235;1069;3410;2755;9229;3824;12639
521056;201302;948;3010;833;2831;276;973;382;1323;658;2296
521060;201302;1073;3130;932;2880;252;851;328;971;580;1822
521080;201302;1049;2816;738;2280;209;778;267;732;476;1510
521090;201302;2957;9207;2604;8697;916;3275;1065;3565;1981;6840
521100;201302;1371;3681;1275;3573;248;701;916;2628;1164;3329
521120;201302;4381;13343;4032;12745;886;2694;2489;8215;3375;10909
521130;201302;959;2936;841;2745;177;645;451;1513;628;2158
521140;201302;845;2941;773;2772;332;1252;158;547;490;1799
521150;201302;9869;27791;8323;25402;2664;8870;4152;12672;6816;21542
521160;201302;588;1657;518;1522;95;307;319;906;414;1213
521170;201302;1277;3179;1117;2987;315;811;660;1787;975;2598
521180;201302;5644;20350;5304;19644;2149;8368;1639;6173;3788;14541
521190;201302;7681;24129;6087;21429;2238;8232;2154;7697;4392;15929
521200;201302;755;2083;718;2038;112;320;524;1515;636;1835
521205;201302;440;1499;421;1467;77;297;261;916;338;1213
521210;201302;682;2144;548;1920;236;919;197;607;433;1526
521220;201302;3267;9893;2893;9357;1127;3899;1033;3292;2160;7191
521225;201302;320;925;259;843;48;171;162;547;210;718
521230;201302;1154;3864;1130;3815;373;1335;590;1982;963;3317
521250;201302;23840;82774;23016;81402;9561;35832;8996;32383;18557;68215
521260;201302;561;1509;448;1274;101;365;195;519;296;884
521270;201302;1640;5488;1555;5339;156;469;1234;4426;1390;4895
521280;201302;1465;4856;1299;4601;459;1720;638;2250;1097;3970
521290;201302;477;1440;370;1257;99;409;157;500;256;909
521295;201302;1010;3007;952;2922;216;708;634;1946;850;2654
521300;201302;1604;4864;1458;4598;550;1909;381;1198;931;3107
521305;201302;791;2149;680;1999;131;371;455;1409;586;1780
521308;201302;4617;14428;3859;13204;746;2843;2390;8078;3136;10921
521310;201302;6241;20023;5482;18818;2322;8424;1671;5717;3993;14141
521340;201302;237;789;219;757;75;286;93;308;168;594
521350;201302;1948;5354;1635;4967;218;762;1088;3460;1306;4222
521370;201302;970;3195;911;3076;327;1170;371;1223;698;2393
521375;201302;1375;4073;1248;3887;343;1108;689;2203;1032;3311
521377;201302;957;3072;935;3040;111;339;774;2582;885;2921
521380;201302;3553;10857;3028;10077;722;2617;1581;5226;2303;7843
521385;201302;573;1693;521;1622;156;515;287;899;443;1414
521390;201302;1072;2946;834;2613;328;1128;288;916;616;2044
521400;201302;2303;6367;2007;6035;294;947;1560;4667;1854;5614
521405;201302;996;3219;982;3200;158;492;743;2487;901;2979
521410;201302;689;2321;648;2251;301;1031;235;858;536;1889
521440;201302;1369;3930;1346;3906;155;406;1143;3394;1298;3800
521450;201302;4599;14163;3907;12891;1372;4904;952;2955;2324;7859
521460;201302;6379;21261;5950;20560;1852;6793;3008;10571;4860;17364
521470;201302;606;1798;485;1582;135;493;123;402;258;895
521480;201302;511;1505;385;1290;135;476;97;319;232;795
521483;201302;2621;7421;2412;7108;546;1717;1459;4260;2005;5977
521486;201302;1441;4322;1320;4076;399;1367;736;2159;1135;3526
521487;201302;561;1537;445;1380;66;211;303;955;369;1166
521490;201302;759;2309;648;2166;138;501;388;1321;526;1822
521500;201302;1086;3722;1033;3644;83;285;905;3209;988;3494
521520;201302;820;2029;746;1948;154;292;500;1508;654;1800
521523;201302;10709;40652;10112;39647;2624;11014;5717;22717;8341;33731
521525;201302;902;2465;812;2349;112;352;544;1538;656;1890
521530;201302;1785;5598;1323;4680;608;2266;227;759;835;3025
521540;201302;823;2532;682;2253;230;860;176;507;406;1367
521550;201302;617;1774;558;1684;193;645;255;746;448;1391
521560;201302;4873;15209;3908;13944;1675;6507;952;3283;2627;9790
521565;201302;580;1778;535;1721;91;317;397;1284;488;1601
521570;201302;3446;10603;3060;10015;1265;4331;1091;3657;2356;7988
521580;201302;560;1523;453;1374;164;524;178;571;342;1095
521590;201302;699;2053;612;1913;264;890;144;487;408;1377
521600;201302;610;1582;457;1338;111;358;201;564;312;922
521630;201302;1706;4785;1469;4407;619;2170;276;662;895;2832
521640;201302;1415;4488;1328;4363;546;2020;355;1177;901;3197
521645;201302;589;1932;530;1806;181;674;227;726;408;1400
521680;201302;1303;4442;1246;4313;811;2891;280;973;1091;3864
521690;201302;492;1563;460;1498;93;336;271;874;364;1210
521710;201302;1919;6219;1733;5859;374;1357;1045;3492;1419;4849
521720;201302;1953;6021;1802;5810;445;1478;1101;3624;1546;5102
521730;201302;3494;12245;3361;11982;1487;5747;1130;3813;2617;9560
521740;201302;3135;9079;2580;8370;1321;4399;836;2833;2157;7232
521760;201302;11116;39717;10621;38964;1738;7174;7560;27859;9298;35033
521770;201302;2631;8214;2295;7567;995;3511;570;1782;1565;5293
521800;201302;8062;25089;7132;23745;2709;9371;3316;11430;6025;20801
521805;201302;635;1696;634;1695;225;546;349;1067;574;1613
521810;201302;777;2393;705;2288;202;694;369;1228;571;1922
521830;201302;5255;18306;5007;17909;1102;4278;3393;12076;4495;16354
521839;201302;609;1935;521;1744;140;515;230;740;370;1255
521850;201302;6016;17869;5717;17520;1277;3782;3958;12627;5235;16409
521860;201302;1633;5183;1445;4781;445;1614;528;1661;973;3275
521870;201302;543;1946;515;1875;161;654;191;653;352;1307
521878;201302;377;1352;358;1320;155;631;89;296;244;927
521880;201302;21459;59728;15323;49563;6002;20730;4321;14205;10323;34935
521890;201302;3340;10793;2928;9986;1195;4315;708;2424;1903;6739
521900;201302;1583;4311;1328;3959;372;1244;593;1700;965;2944
521910;201302;1119;3316;997;3175;270;936;572;1842;842;2778
521920;201302;393;1292;385;1275;160;563;184;601;344;1164
521925;201302;541;1763;536;1753;76;264;445;1457;521;1721
521930;201302;4282;14344;3972;13703;1687;6183;1106;3755;2793;9938
521935;201302;659;2025;634;1976;166;557;387;1168;553;1725
521940;201302;1138;3128;956;2856;374;1185;325;983;699;2168
521945;201302;622;2236;586;2192;125;435;427;1664;552;2099
521950;201302;430;1497;406;1445;160;607;147;513;307;1120
521960;201302;898;2718;782;2519;202;703;404;1308;606;2011
521970;201302;2180;6590;2099;6469;382;1246;1497;4690;1879;5936
521971;201302;958;2788;824;2575;236;817;396;1192;632;2009
521973;201302;711;2555;668;2465;256;990;208;763;464;1753
521975;201302;12092;36915;11483;36123;2441;8372;7377;23310;9818;31682
521980;201302;1647;5528;1617;5489;299;952;1229;4342;1528;5294
521990;201302;977;3216;934;3135;201;732;561;1842;762;2574
522000;201302;1990;6072;1792;5819;399;1364;1092;3711;1491;5075
522005;201302;304;892;246;797;67;234;128;399;195;633
522010;201302;2706;8423;2405;7939;902;3272;730;2323;1632;5595
522015;201302;945;2920;810;2718;236;885;428;1426;664;2311
522020;201302;3947;11799;3571;11316;1034;3425;1927;6116;2961;9541
522026;201302;491;1625;423;1554;236;906;145;525;381;1431
522028;201302;506;1567;461;1493;127;445;258;814;385;1259
522040;201302;2821;7470;2045;6456;753;2570;787;2464;1540;5034
522045;201302;11844;40822;10571;38046;3622;14200;2476;8670;6098;22870
522050;201302;996;3036;849;2786;266;952;382;1220;648;2172
522060;201302;2483;8676;2411;8565;766;2889;1428;5021;2194;7910
522068;201302;1322;4596;1257;4519;124;395;1061;3941;1185;4336
522070;201302;800;2526;741;2431;144;566;461;1486;605;2052
522100;201302;795;2226;706;2087;264;891;328;896;592;1787
522108;201302;862;2591;795;2496;78;279;610;1951;688;2230
522119;201302;1388;4366;1231;4174;129;427;1023;3531;1152;3958
522130;201302;488;1433;421;1358;128;458;215;691;343;1149
522140;201302;15785;46644;14228;44695;4207;14057;7802;24646;12009;38703
522145;201302;911;2678;865;2604;490;1553;199;590;689;2143
522150;201302;1231;3310;1020;3045;345;1094;484;1519;829;2613
522155;201302;697;2162;641;2083;148;545;392;1269;540;1814
522157;201302;609;1911;567;1843;76;270;424;1383;500;1653
522160;201302;5237;15703;4159;14043;1958;7244;912;2909;2870;10153
522170;201302;3069;8665;2647;8114;642;1965;1479;4770;2121;6735
522180;201302;432;1328;350;1227;181;688;117;399;298;1087
522185;201302;13257;44271;12713;43534;2707;10100;8173;28153;10880;38253
522190;201302;645;1939;583;1798;121;398;352;1090;473;1488
522200;201302;1515;5223;1426;5035;552;2080;457;1588;1009;3668
522205;201302;1403;4104;1211;3804;373;1176;568;1840;941;3016
522220;201302;942;3116;868;3015;225;826;478;1756;703;2582
522230;201302;690;2553;683;2540;145;539;488;1862;633;2401
530010;201302;240266;805307;217768;758354;69275;264396;69258;243384;138533;507780
110001;201301;4114;14068;3585;13231;1108;4211;1961;7372;3069;11583
110002;201301;10875;37801;10063;36313;3815;14466;4142;15214;7957;29680
110003;201301;997;3325;936;3229;280;1016;498;1703;778;2719
110004;201301;8567;29587;7881;28192;2538;9872;3307;11852;5845;21724
110005;201301;2271;7949;2188;7793;794;2892;1032;3718;1826;6610
110006;201301;3420;9335;2218;7767;795;2936;848;2963;1643;5899
110007;201301;1386;4663;1281;4512;363;1304;748;2698;1111;4002
110008;201301;2359;8544;2228;8354;605;2202;1444;5632;2049;7834
110009;201301;4694;14225;3907;13209;803;2773;2718;9336;3521;12109
110010;201301;7790;22865;7062;22086;1084;2748;5405;18280;6489;21028
110011;201301;10229;32822;8650;30174;3557;13059;2975;10510;6532;23569
110012;201301;14812;48479;13682;46424;5263;18722;5700;19443;10963;38165
110013;201301;5019;16578;4273;15542;1264;4829;2231;8242;3495;13071
110014;201301;4072;12751;3484;11939;739;2597;2331;8126;3070;10723
110015;201301;4707;15854;4029;14716;1654;6349;1452;5311;3106;11660
110018;201301;4725;14573;3927;13551;1365;5125;1684;5626;3049;10751
110020;201301;45347;146769;41831;142195;9730;33897;26107;91221;35837;125118
110025;201301;4034;12539;3464;11463;610;2230;2479;8124;3089;10354
110026;201301;694;2210;591;2095;136;480;405;1465;541;1945
110028;201301;7172;21949;5593;19504;1674;6351;2235;7784;3909;14135
110029;201301;1582;4908;1286;4400;420;1469;620;2169;1040;3638
110030;201301;10719;31835;8888;29519;2759;9698;4467;15475;7226;25173
110032;201301;3938;13365;3642;12732;972;3591;1913;6696;2885;10287
110033;201301;4848;16053;4608;15719;1359;4570;2716;9759;4075;14329
110034;201301;3718;9859;3219;9299;411;1063;2672;7912;3083;8975
110037;201301;1990;6969;1801;6634;283;1037;1345;5033;1628;6070
110040;201301;3335;11489;3226;11291;1088;4030;1582;5568;2670;9598
110045;201301;4925;18063;4720;17796;1270;4964;2991;11403;4261;16367
110050;201301;1728;5835;1468;5506;503;1902;797;3066;1300;4968
110060;201301;984;3525;884;3337;205;769;546;2112;751;2881
110070;201301;1837;6553;1816;6504;292;1106;1380;4938;1672;6044
110080;201301;2635;9330;2588;9267;452;1535;2023;7438;2475;8973
110090;201301;933;2895;767;2629;245;929;300;971;545;1900
110092;201301;1608;5462;1467;5264;363;1297;865;3287;1228;4584
110094;201301;2535;8878;2393;8686;678;2553;1416;5189;2094;7742
110100;201301;2615;8710;2303;8220;605;2171;1420;5198;2025;7369
110110;201301;1593;5595;1502;5482;604;2274;714;2668;1318;4942
110120;201301;1545;5393;1405;5073;384;1444;627;2282;1011;3726
110130;201301;2688;8037;2163;7309;587;2107;1134;3842;1721;5949
110140;201301;2216;8033;2178;7960;562;2115;1347;4954;1909;7069
110143;201301;1473;5147;1242;4754;346;1378;698;2692;1044;4070
110145;201301;868;2869;801;2757;199;703;450;1572;649;2275
110146;201301;429;1434;385;1361;110;402;208;746;318;1148
110147;201301;857;2706;724;2523;215;818;347;1168;562;1986
110148;201301;1346;4157;1183;3882;303;1096;550;1774;853;2870
110149;201301;3332;10442;2818;9733;519;1872;2039;7159;2558;9031
110150;201301;2555;8140;2166;7584;486;1751;1416;5027;1902;6778
110155;201301;854;2980;830;2928;304;1112;374;1320;678;2432
110160;201301;2098;7025;1842;6664;332;1211;1348;4980;1680;6191
110170;201301;2716;8578;2366;8045;551;2007;1569;5310;2120;7317
110175;201301;1552;5287;1254;4919;113;473;991;3890;1104;4363
110180;201301;1650;5432;1469;5115;340;1230;916;3197;1256;4427
120001;201301;2567;9793;2515;9670;708;2842;1431;5617;2139;8459
120005;201301;1455;6329;1420;6267;165;639;1127;5215;1292;5854
120010;201301;3669;13923;3526;13657;716;2738;2293;9245;3009;11983
120013;201301;1583;6429;1561;6392;301;1184;1103;4720;1404;5904
120017;201301;1864;6957;1806;6857;490;1910;940;3860;1430;5770
120020;201301;13131;58498;12979;58143;2576;10901;9305;43572;11881;54473
120025;201301;2473;9028;2423;8949;664;2504;1415;5406;2079;7910
120030;201301;4915;21841;4891;21778;741;3004;3823;17673;4564;20677
120032;201301;1251;6247;1222;6187;170;976;919;4709;1089;5685
120033;201301;3472;13527;3445;13477;174;690;3116;12334;3290;13024
120034;201301;1749;6995;1747;6993;73;276;1626;6567;1699;6843
120035;201301;2247;11616;2232;11572;353;1651;1679;9249;2032;10900
120038;201301;3009;11530;2951;11410;811;3222;1718;6800;2529;10022
120039;201301;1332;7595;1313;7550;190;1102;1023;6023;1213;7125
120040;201301;39833;151067;37802;146468;12028;47905;19068;76277;31096;124182
120042;201301;2423;11176;2373;11051;220;1043;1984;9417;2204;10460
120043;201301;718;3602;710;3580;78;396;580;2985;658;3381
120045;201301;4136;15181;4115;15143;888;3180;2978;11280;3866;14460
120050;201301;7720;32940;7557;32562;1890;7943;4539;20933;6429;28876
120060;201301;4759;24923;4729;24861;765;3597;3637;20184;4402;23781
120070;201301;2467;9718;2435;9640;578;2155;1539;6459;2117;8614
120080;201301;3343;12965;3230;12790;615;2475;2265;9247;2880;11722
130002;201301;2492;11225;2355;10991;350;1660;1752;8345;2102;10005
130006;201301;1643;7433;1512;7198;160;839;1184;5697;1344;6536
130008;201301;1791;7628;1734;7522;223;1003;1292;5787;1515;6790
130010;201301;2713;9332;2365;8920;252;884;1951;7563;2203;8447
130014;201301;3109;10565;2736;10031;404;1619;1910;7049;2314;8668
130020;201301;2290;8354;2270;8329;76;292;2165;7947;2241;8239
130030;201301;5762;24140;5590;23902;578;2126;4675;20750;5253;22876
130040;201301;3222;10517;3087;10303;187;666;2705;9072;2892;9738
130050;201301;5337;22964;4759;21984;851;3781;3202;15840;4053;19621
130060;201301;5323;23053;5025;22645;588;2553;4064;18821;4652;21374
130063;201301;2742;12657;2723;12612;344;1594;2241;10554;2585;12148
130068;201301;2650;11793;2534;11544;357;1814;1891;8615;2248;10429
130070;201301;5869;21138;5596;20766;362;1444;4831;18172;5193;19616
130080;201301;4563;20812;4449;20629;803;3814;3178;15190;3981;19004
130083;201301;1634;7006;1577;6912;286;1272;1136;5058;1422;6330
130090;201301;2196;8367;2097;8229;190;838;1765;6935;1955;7773
130100;201301;4931;20008;4749;19752;522;2301;3843;16236;4365;18537
130110;201301;5861;19659;5497;19204;1198;3936;3712;13760;4910;17696
130115;201301;3375;13192;3245;13012;195;652;2954;12037;3149;12689
130120;201301;12163;47846;11929;47513;1185;4375;10116;41528;11301;45903
130130;201301;3203;14321;3114;14164;492;2190;2387;11148;2879;13338
130140;201301;5695;23069;5652;23013;151;459;5450;22447;5601;22906
130150;201301;3221;12711;3160;12628;338;1611;2589;10279;2927;11890
130160;201301;3711;15619;3662;15537;214;789;3356;14434;3570;15223
130165;201301;2686;11195;2654;11136;590;2517;1944;8239;2534;10756
130170;201301;7324;29332;6580;28405;1338;5575;4493;20496;5831;26071
130180;201301;3094;9939;3040;9850;173;498;2739;8981;2912;9479
130185;201301;7425;28561;7245;28284;1699;6364;4813;19726;6512;26090
130190;201301;15904;57804;14329;55783;3052;11342;9420;39035;12472;50377
130195;201301;1701;7074;1647;6995;113;522;1448;6186;1561;6708
130200;201301;1804;6831;1705;6656;246;988;1231;4876;1477;5864
130210;201301;1040;4175;985;4072;193;743;694;3019;887;3762
130220;201301;1913;8045;1804;7889;237;1079;1378;6202;1615;7281
130230;201301;3279;15107;3148;14884;215;964;2747;13320;2962;14284
130240;201301;7663;30858;7137;30076;599;2815;5934;25414;6533;28229
130250;201301;16613;63459;16438;63186;2342;8322;13072;52095;15414;60417
130255;201301;3625;13843;3443;13528;261;1088;2972;11831;3233;12919
130260;201301;214592;713404;198309;689906;53477;185666;115759;420796;169236;606462
130270;201301;7179;30445;6560;29482;1070;4693;4737;22284;5807;26977
130280;201301;2741;11205;2685;11119;196;724;2356;10024;2552;10748
130290;201301;10067;38377;10024;38312;262;817;9481;36873;9743;37690
130300;201301;4071;16571;3883;16303;386;1705;3177;13555;3563;15260
130310;201301;4321;17700;4018;17311;603;2568;2999;13384;3602;15952
130320;201301;2441;8679;2246;8418;303;1137;1661;6418;1964;7555
130330;201301;3183;12514;2873;12074;293;1361;2356;10017;2649;11378
130340;201301;16656;65967;16291;65393;2617;9886;11921;50487;14538;60373
130350;201301;3135;12723;3006;12577;141;347;2812;12121;2953;12468
130353;201301;4318;15371;3972;14908;1206;4442;2144;8595;3350;13037
130356;201301;3198;12408;3117;12260;611;2384;2224;9084;2835;11468
130360;201301;2550;8190;2286;7876;74;241;2094;7393;2168;7634
130370;201301;4449;17794;3812;16960;346;1942;3051;13473;3397;15415
130380;201301;5778;25213;5645;24987;512;2442;4584;20551;5096;22993
130390;201301;4363;19374;4131;18993;481;2018;3392;16136;3873;18154
130395;201301;1842;7323;1739;7148;243;1175;1233;5001;1476;6176
130400;201301;1979;7418;1916;7321;110;444;1683;6524;1793;6968
130406;201301;8006;32650;7232;31295;1902;7981;4085;19025;5987;27006
130410;201301;3929;15223;3647;14690;908;3769;2018;8444;2926;12213
130420;201301;9143;40813;8923;40320;1059;4456;7220;33524;8279;37980
130423;201301;2678;11122;2593;11009;166;796;2292;9800;2458;10596
130426;201301;1777;7998;1716;7899;294;1240;1240;6072;1534;7312
130430;201301;3227;12154;3067;11926;380;1545;2283;9144;2663;10689
130440;201301;3410;12950;3138;12653;240;791;2735;11468;2975;12259
140002;201301;1297;4755;1260;4688;283;959;832;3326;1115;4285
140005;201301;2344;7694;2210;7546;133;443;1972;6828;2105;7271
140010;201301;39870;134895;36876;129796;7726;28850;23455;84180;31181;113030
140015;201301;2475;9171;2403;9079;179;573;2087;8129;2266;8702
140017;201301;2738;9392;2670;9302;201;697;2343;8268;2544;8965
140020;201301;3825;13620;3621;13345;485;1772;2759;10444;3244;12216
140023;201301;1799;6806;1744;6728;184;684;1463;5770;1647;6454
140028;201301;1972;5855;1910;5782;118;302;1700;5285;1818;5587
140030;201301;3286;11173;3189;11048;305;697;2773;10129;3078;10826
140040;201301;1430;7047;1375;6871;140;765;991;5076;1131;5841
140045;201301;2038;8177;2025;8156;189;586;1762;7385;1951;7971
140047;201301;4691;14957;4627;14880;640;1570;3790;12926;4430;14496
140050;201301;1446;4658;1383;4566;145;446;1139;3847;1284;4293
140060;201301;1182;4000;1123;3925;134;420;930;3346;1064;3766
140070;201301;1444;7117;1441;7111;59;239;1368;6827;1427;7066
150010;201301;27931;102247;26991;100948;1989;7499;23327;88763;25316;96262
150013;201301;1455;4784;1415;4737;136;472;1181;3985;1317;4457
150020;201301;8825;33054;8712;32874;801;3105;7406;28255;8207;31360
150030;201301;5706;25887;5604;25704;646;2483;4598;22125;5244;24608
150034;201301;4503;12469;4288;12215;152;377;4075;11729;4227;12106
150040;201301;11098;41499;9908;39969;1895;6979;6855;29568;8750;36547
150050;201301;5591;21962;5496;21788;741;3117;4303;17218;5044;20335
150060;201301;13014;45132;12476;44330;3495;12082;7289;27299;10784;39381
150070;201301;4973;21713;4598;21252;592;2600;3670;17488;4262;20088
150080;201301;55706;156387;49840;149001;5235;13942;39453;121534;44688;135476
150085;201301;4207;16186;4070;15984;648;2162;3159;13021;3807;15183
150090;201301;8581;36190;8200;35688;938;4026;6728;29867;7666;33893
150095;201301;4599;16966;4359;16587;553;2032;3477;13576;4030;15608
150100;201301;3167;12574;3002;12341;329;1499;2417;9913;2746;11412
150110;201301;3138;15284;3130;15265;128;537;2950;14541;3078;15078
150120;201301;5458;22422;5381;22263;507;2000;4565;19202;5072;21202
150125;201301;759;2467;706;2383;158;560;422;1430;580;1990
150130;201301;16134;56552;15747;55927;1955;6931;12584;45415;14539;52346
150140;201301;127832;402996;123837;397930;19757;64014;94921;309218;114678;373232
150145;201301;4465;15014;4177;14654;573;2078;3159;11281;3732;13359
150150;201301;7670;27321;7349;26764;1621;6106;4912;18105;6533;24211
150157;201301;2459;8554;2309;8339;350;1355;1789;6482;2139;7837
150160;201301;2414;8830;2349;8734;592;2111;1520;5891;2112;8002
150170;201301;20837;78720;19946;77679;2730;10313;16091;63654;18821;73967
150172;201301;2770;9956;2533;9612;313;1208;2077;8007;2390;9215
150175;201301;1813;6061;1755;5990;190;565;1480;5226;1670;5791
150178;201301;10173;33354;8938;31908;588;1824;8034;29359;8622;31183
150180;201301;15398;65563;15025;65052;1470;6753;12759;55721;14229;62474
150190;201301;6619;21956;6263;21444;445;1186;5423;19304;5868;20490
150195;201301;3794;14750;3648;14474;458;1814;2875;11607;3333;13421
150200;201301;3640;13550;3611;13510;133;459;3392;12801;3525;13260
150210;201301;21202;81765;20993;81478;1402;5214;18934;74287;20336;79501
150215;201301;4639;15857;4318;15377;1126;4110;2582;9417;3708;13527
150220;201301;11307;39139;10878;38412;2313;8406;7064;25331;9377;33737
150230;201301;10226;37356;9592;36439;804;3727;8166;30642;8970;34369
150240;201301;28466;93554;26893;90833;7061;25117;15429;52583;22490;77700
150250;201301;3182;12843;3108;12725;562;2045;2279;9896;2841;11941
150260;201301;1781;7838;1765;7807;258;1267;1323;5843;1581;7110
150270;201301;8819;28135;7074;25968;1523;5892;4585;17123;6108;23015
150275;201301;5058;20040;4909;19779;724;2913;3747;15409;4471;18322
150276;201301;1934;6160;1861;6065;252;878;1504;4916;1756;5794
150277;201301;4945;15866;4418;15257;579;1968;3544;12545;4123;14513
150280;201301;5542;24527;5454;24328;524;2300;4525;20549;5049;22849
150285;201301;2493;10244;2473;10203;184;759;2225;9250;2409;10009
150290;201301;7180;24808;7061;24636;948;3173;5567;19975;6515;23148
150293;201301;8232;27545;7477;26404;2522;8939;3695;13825;6217;22764
150295;201301;5595;20498;5110;19832;1256;5055;3171;12578;4427;17633
150300;201301;1601;5847;1579;5812;65;205;1465;5461;1530;5666
150304;201301;3664;12128;3282;11641;527;1874;2451;8879;2978;10753
150307;201301;6251;22608;5895;22094;407;1393;5028;19455;5435;20848
150309;201301;5676;22064;5447;21689;1634;6403;3256;13567;4890;19970
150310;201301;4738;22477;4677;22376;524;2357;3878;19088;4402;21445
150320;201301;7194;23606;7099;23486;517;1737;6284;20937;6801;22674
150330;201301;11786;46047;11431;45436;1299;5148;9319;37757;10618;42905
150340;201301;1871;7127;1808;7033;531;2095;1009;4083;1540;6178
150345;201301;5866;21976;5599;21606;675;2662;4575;17891;5250;20553
150350;201301;6712;23673;6481;23309;888;3340;4879;17732;5767;21072
150360;201301;18865;62844;16794;60285;2540;9175;12598;46716;15138;55891
150370;201301;8993;35774;8738;35408;1213;4555;6968;29268;8181;33823
150375;201301;2491;10752;2452;10702;240;784;2079;9587;2319;10371
150380;201301;8956;28885;8203;27844;974;3556;6800;23058;7774;26614
150390;201301;7299;32702;7102;32267;1619;6965;4525;21700;6144;28665
150400;201301;4931;21471;4813;21190;639;2674;3557;16201;4196;18875
150405;201301;7681;25214;7045;24392;1533;4876;4724;17391;6257;22267
150410;201301;1572;6311;1553;6278;225;955;1125;4634;1350;5589
150420;201301;27191;103475;25183;100246;6953;28411;14108;58844;21061;87255
150430;201301;5749;22791;5659;22623;800;3517;4396;17564;5196;21081
150440;201301;4894;18064;4827;17953;643;2440;3771;14240;4414;16680
150442;201301;20337;59670;18740;57682;3101;9646;13385;42470;16486;52116
150445;201301;4567;17247;4269;16816;674;2500;3276;13344;3950;15844
150450;201301;3963;19407;3847;19244;372;1832;3264;16646;3636;18478
150460;201301;6021;23768;5180;22891;342;1592;4677;20829;5019;22421
150470;201301;13514;47606;13238;47215;1759;5407;10782;39921;12541;45328
150480;201301;13081;46864;12831;46527;902;3016;11329;41916;12231;44932
150490;201301;5568;22303;5485;22200;354;1410;4953;20204;5307;21614
150495;201301;3992;15758;3912;15590;553;2389;3033;12096;3586;14485
150497;201301;3159;11339;2933;10979;745;2730;1820;7171;2565;9901
150500;201301;2781;8895;2684;8723;408;1411;2000;6477;2408;7888
150503;201301;3735;12127;3227;11465;1255;4640;1386;5154;2641;9794
150506;201301;11248;42135;10828;41582;2451;7954;7700;31766;10151;39720
150510;201301;8846;36518;8403;35751;1432;6089;5994;26523;7426;32612
150520;201301;5294;23356;5237;23260;401;1482;4654;21191;5055;22673
150530;201301;10273;39058;9499;37954;1274;4609;7293;30349;8567;34958
150540;201301;4168;14165;3902;13762;290;1203;3316;11590;3606;12793
150543;201301;4143;14001;3853;13580;1094;3918;2337;8466;3431;12384
150548;201301;7296;24768;6926;24281;844;2681;5631;20433;6475;23114
150549;201301;2096;6954;2016;6856;108;313;1832;6346;1940;6659
150550;201301;19239;64343;17997;62434;4967;17800;10218;36278;15185;54078
150553;201301;19572;75030;18094;71025;7453;30780;3774;15169;11227;45949
150555;201301;1486;4974;1319;4721;268;1052;854;3078;1122;4130
150560;201301;1923;6374;1886;6291;203;760;1489;4935;1692;5695
150563;201301;2707;9543;2586;9324;622;2353;1644;5970;2266;8323
150565;201301;3116;11722;2976;11510;262;1154;2446;9484;2708;10638
150570;201301;4621;18734;4571;18646;423;1730;3875;16118;4298;17848
150580;201301;8144;33803;8049;33678;717;2614;6998;30207;7715;32821
150590;201301;4847;20332;4745;20207;190;889;4383;18770;4573;19659
150600;201301;6685;27955;6601;27807;730;2739;5512;24019;6242;26758
150610;201301;2372;8369;2236;8088;293;1170;1596;5737;1889;6907
150611;201301;2418;9527;2347;9349;312;1318;1748;7052;2060;8370
150613;201301;10448;34311;9412;32805;3232;11411;4736;17319;7968;28730
150616;201301;2878;8582;2357;8027;626;2061;1523;5404;2149;7465
150618;201301;7092;25574;6872;25197;2351;8898;3379;12725;5730;21623
150619;201301;4668;17223;4429;16865;942;3537;2890;11400;3832;14937
150620;201301;5787;21724;5355;21154;798;3177;4066;16635;4864;19812
150630;201301;4769;16235;4568;15964;447;1600;3762;13307;4209;14907
150635;201301;3932;13842;3764;13510;856;3167;2373;8728;3229;11895
150640;201301;1331;4515;1318;4494;36;106;1248;4300;1284;4406
150650;201301;10915;35625;10134;34207;2786;9793;5522;18940;8308;28733
150655;201301;4893;17516;4566;17060;866;3240;3297;12585;4163;15825
150658;201301;3746;13027;3637;12864;312;1331;2982;10451;3294;11782
150660;201301;5362;17714;4971;17227;1434;4874;2892;10448;4326;15322
150670;201301;5345;17055;4737;16312;1731;5997;2441;8920;4172;14917
150680;201301;45218;188940;43616;185867;15067;63257;21528;97863;36595;161120
150690;201301;1727;5917;1641;5768;282;964;1078;3931;1360;4895
150700;201301;5177;17155;5056;16979;1010;3372;3530;12123;4540;15495
150710;201301;3481;11737;3393;11618;348;891;2918;10373;3266;11264
150715;201301;4301;15603;4097;15358;501;1802;3383;13011;3884;14813
150720;201301;5689;25080;5497;24734;790;3309;4172;19592;4962;22901
150730;201301;8217;29942;7777;29343;1212;4469;6134;23685;7346;28154
150740;201301;3277;11264;3137;10999;491;1846;2216;7839;2707;9685
150745;201301;5807;18912;5473;18463;727;2469;4321;14809;5048;17278
150746;201301;1260;4502;1216;4420;193;819;850;3059;1043;3878
150747;201301;4716;16160;4500;15890;427;1495;3747;13489;4174;14984
150750;201301;2276;8631;2270;8624;140;327;2110;8257;2250;8584
150760;201301;10581;35265;10309;34893;2188;7265;7168;24910;9356;32175
150770;201301;4938;20010;4804;19794;750;2778;3693;15852;4443;18630
150775;201301;1003;3384;929;3249;220;908;539;1805;759;2713
150780;201301;2890;10041;2869;10018;97;254;2699;9579;2796;9833
150790;201301;4434;14685;4220;14442;328;982;3662;12908;3990;13890
150795;201301;12790;42267;12003;41272;1959;6557;9080;32168;11039;38725
150796;201301;2470;8143;2441;8107;377;1169;1921;6572;2298;7741
150797;201301;3495;12155;3364;11946;260;957;2879;10346;3139;11303
150800;201301;12646;44953;11744;43825;2586;9014;8040;31622;10626;40636
150803;201301;6050;23537;5898;23312;829;3550;4570;18233;5399;21783
150805;201301;2502;9152;2351;8943;414;1486;1653;6562;2067;8048
150808;201301;5454;19304;4758;18017;2098;8178;1442;5861;3540;14039
150810;201301;17459;57883;15099;55011;2590;9260;10752;41050;13342;50310
150812;201301;4570;15245;4333;14983;389;1560;3547;12240;3936;13800
150815;201301;7492;25606;6890;24889;515;1536;6083;22682;6598;24218
150820;201301;9877;30151;9057;29259;370;752;8380;27762;8750;28514
150830;201301;11675;46419;11233;45656;919;3691;9163;38513;10082;42204
150835;201301;1958;7432;1837;7135;522;2134;901;3509;1423;5643
150840;201301;6054;18855;4961;17486;1513;5825;2645;9087;4158;14912
160005;201301;682;2716;654;2658;118;556;405;1634;523;2190
160010;201301;1420;5197;1412;5188;213;606;1131;4407;1344;5013
160015;201301;1496;5797;1468;5747;270;1002;1044;4327;1314;5329
160020;201301;2194;7387;2053;7195;297;1058;1543;5555;1840;6613
160021;201301;732;3410;710;3366;119;615;506;2456;625;3071
160023;201301;873;3419;866;3409;103;370;728;2938;831;3308
160025;201301;1155;3147;1126;3116;27;87;1079;2980;1106;3067
160027;201301;7088;25027;6820;24703;1383;5228;4798;17649;6181;22877
160030;201301;35619;137502;35087;136442;7871;29450;24540;98459;32411;127909
160040;201301;3034;13232;2984;13147;210;980;2643;11723;2853;12703
160050;201301;2911;11572;2653;11154;1017;3887;1200;5839;2217;9726
160053;201301;1764;7707;1750;7676;517;2170;1106;5117;1623;7287
160055;201301;762;3086;746;3063;139;604;531;2216;670;2820
160060;201301;17193;57357;16247;56302;3597;11834;11214;40767;14811;52601
160070;201301;1932;8690;1919;8668;182;759;1679;7742;1861;8501
160080;201301;2431;9910;2413;9880;161;565;2200;9176;2361;9741
170025;201301;551;1936;510;1877;187;726;241;907;428;1633
170030;201301;1079;3751;1025;3659;296;1085;560;2027;856;3112
170035;201301;1498;4697;1254;4231;461;1651;407;1406;868;3057
170040;201301;1624;5700;1491;5491;375;1520;835;3099;1210;4619
170070;201301;1990;5643;1658;5228;426;1454;921;2966;1347;4420
170100;201301;2414;6635;2179;6224;230;777;1784;4998;2014;5775
170105;201301;658;2308;591;2169;134;601;338;1185;472;1786
170110;201301;1121;3588;1017;3417;169;516;704;2454;873;2970
170130;201301;1299;4294;1176;4134;160;577;880;3194;1040;3771
170190;201301;1512;4744;1334;4504;438;1471;553;2058;991;3529
170200;201301;1398;4551;1124;4048;312;1245;346;1237;658;2482
170210;201301;22837;78551;20755;74658;9903;37607;5240;19665;15143;57272
170215;201301;1063;3612;979;3470;157;575;700;2527;857;3102
170220;201301;6048;20894;5614;20241;794;3025;4078;15109;4872;18134
170230;201301;1394;4959;1268;4734;372;1531;590;2167;962;3698
170240;201301;2863;8149;2379;7591;340;1232;1717;5518;2057;6750
170255;201301;3363;11110;2900;10320;1040;3626;1183;4541;2223;8167
170270;201301;1016;2686;749;2329;217;707;419;1324;636;2031
170290;201301;2747;8799;2422;8399;301;1021;1941;6940;2242;7961
170300;201301;1943;6500;1746;6181;323;1227;1153;4140;1476;5367
170305;201301;645;2176;562;2011;118;451;358;1270;476;1721
170307;201301;1061;3802;939;3596;307;1188;359;1555;666;2743
170310;201301;1549;4410;1272;3965;278;914;684;2236;962;3150
170320;201301;863;2742;747;2530;162;573;456;1560;618;2133
170330;201301;743;2339;627;2219;103;295;488;1852;591;2147
170360;201301;436;1561;417;1530;97;379;202;726;299;1105
170370;201301;1348;4129;1148;3842;201;805;691;2285;892;3090
170380;201301;2032;6713;1731;6277;383;1589;977;3533;1360;5122
170382;201301;538;1948;517;1919;54;191;430;1626;484;1817
170384;201301;1233;5654;1207;5608;259;1232;850;4042;1109;5274
170386;201301;788;2478;656;2272;207;784;236;860;443;1644
170388;201301;609;1891;536;1774;130;519;235;758;365;1277
170389;201301;961;3445;907;3362;116;518;694;2538;810;3056
170390;201301;1230;3874;1080;3683;207;697;759;2677;966;3374
170410;201301;431;1521;418;1497;78;314;264;949;342;1263
170460;201301;391;1241;355;1178;105;375;129;433;234;808
170510;201301;766;2705;675;2570;131;568;406;1536;537;2104
170550;201301;5020;16468;4302;15158;1744;6497;1346;4948;3090;11445
170555;201301;1248;3814;1068;3540;282;1033;575;1917;857;2950
170560;201301;988;3447;855;3294;183;697;598;2408;781;3105
170600;201301;1281;3704;1151;3550;62;200;975;3063;1037;3263
170610;201301;1552;4779;1246;4293;212;822;714;2487;926;3309
170625;201301;377;1276;312;1139;106;418;79;298;185;716
170650;201301;1210;4070;1157;3980;269;973;670;2365;939;3338
170700;201301;3682;12873;3174;12032;837;3470;1591;6270;2428;9740
170710;201301;1614;5004;1394;4681;207;829;971;3274;1178;4103
170720;201301;1759;4857;1601;4610;206;601;1311;3804;1517;4405
170730;201301;1115;3289;935;3025;292;1036;434;1403;726;2439
170740;201301;2098;7965;1976;7775;279;1228;1452;5753;1731;6981
170755;201301;876;2835;757;2586;218;815;313;1049;531;1864
170765;201301;1495;4170;1270;3819;341;1112;547;1691;888;2803
170770;201301;1749;6305;1649;6111;394;1511;946;3632;1340;5143
170820;201301;3962;13100;3623;12569;1026;3744;1721;6072;2747;9816
170825;201301;676;2196;546;1965;166;672;256;901;422;1573
170830;201301;1184;3815;1157;3773;55;145;1048;3456;1103;3601
170900;201301;2671;9824;2576;9623;327;1196;1969;7579;2296;8775
170930;201301;4144;12891;3417;11888;1391;5059;1168;4121;2559;9180
170950;201301;9263;30251;7677;27696;3917;15145;1620;5501;5537;20646
170980;201301;426;1392;370;1290;116;405;148;516;264;921
171050;201301;1168;4327;1133;4269;66;304;1016;3789;1082;4093
171070;201301;1576;5431;1496;5313;363;1345;909;3279;1272;4624
171090;201301;754;2493;709;2415;168;575;423;1486;591;2061
171110;201301;610;1908;522;1771;165;612;296;965;461;1577
171150;201301;817;2517;624;2144;141;524;343;1180;484;1704
171180;201301;569;1883;477;1685;110;420;237;861;347;1281
171190;201301;1833;6728;1613;6300;401;1640;780;3193;1181;4833
171195;201301;826;3076;763;2967;112;492;504;2011;616;2503
171200;201301;620;2108;524;1921;153;638;230;784;383;1422
171215;201301;422;1331;353;1216;73;279;188;652;261;931
171240;201301;872;3003;849;2965;74;165;737;2696;811;2861
171245;201301;649;2188;554;1966;118;449;286;1017;404;1466
171250;201301;1044;3214;955;3111;67;251;815;2665;882;2916
171270;201301;386;1629;364;1580;77;313;227;1033;304;1346
171280;201301;788;2615;739;2531;165;563;404;1488;569;2051
171320;201301;3632;11749;3201;11131;1139;4131;1517;5313;2656;9444
171330;201301;2612;8403;2404;8101;626;2213;1369;4704;1995;6917
171360;201301;1443;4942;1244;4651;345;1357;650;2497;995;3854
171370;201301;652;1927;593;1829;143;533;327;952;470;1485
171380;201301;1150;4236;1082;4122;204;761;740;2901;944;3662
171395;201301;860;2807;747;2598;146;590;441;1517;587;2107
171420;201301;2181;6778;1823;6174;347;1331;1052;3550;1399;4881
171430;201301;972;3233;910;3141;223;769;563;1984;786;2753
171488;201301;2269;7340;2129;7129;567;1912;1172;4059;1739;5971
171500;201301;798;2601;717;2429;161;545;347;1201;508;1746
171510;201301;868;3276;798;3168;165;639;512;2159;677;2798
171515;201301;586;1811;480;1669;113;418;252;901;365;1319
171525;201301;547;1942;476;1801;99;421;250;931;349;1352
171550;201301;278;1001;257;935;111;449;48;170;159;619
171570;201301;1069;3630;970;3490;171;616;671;2474;842;3090
171575;201301;1852;5527;1547;4993;515;1717;599;2051;1114;3768
171610;201301;5787;20567;5428;19886;2019;7666;1904;7119;3923;14785
171620;201301;2049;7024;1956;6867;221;854;1540;5441;1761;6295
171630;201301;837;2912;704;2674;180;764;302;1142;482;1906
171650;201301;2181;7199;1880;6701;528;2050;891;3101;1419;5151
171660;201301;2482;7213;2090;6544;531;1733;1064;3433;1595;5166
171665;201301;1269;4171;1171;3996;249;929;730;2517;979;3446
171670;201301;2217;6144;1877;5714;467;1510;1165;3550;1632;5060
171700;201301;1047;3695;963;3557;177;720;626;2323;803;3043
171720;201301;645;2144;576;2006;165;648;305;1047;470;1695
171750;201301;1172;4011;1057;3779;387;1429;402;1484;789;2913
171780;201301;1093;3284;839;2924;144;557;529;1838;673;2395
171790;201301;1688;5577;1382;5134;315;1191;790;3087;1105;4278
171800;201301;675;2265;628;2198;96;380;430;1513;526;1893
171820;201301;9042;29480;8473;28795;1888;6889;5414;18638;7302;25527
171830;201301;1582;5954;1472;5703;350;1451;747;2939;1097;4390
171840;201301;710;2266;655;2188;98;350;466;1578;564;1928
171845;201301;737;2107;583;1834;76;287;367;1143;443;1430
171850;201301;1000;3772;926;3623;118;556;623;2431;741;2987
171855;201301;1153;3896;1060;3745;123;525;808;2812;931;3337
171865;201301;462;1553;396;1454;100;405;203;745;303;1150
171870;201301;629;2159;541;2005;130;513;280;1082;410;1595
171875;201301;1328;4388;1134;4097;194;756;785;2842;979;3598
171880;201301;983;3636;960;3596;130;501;742;2848;872;3349
171884;201301;785;2393;619;2147;126;481;277;998;403;1479
171886;201301;1389;4918;1289;4709;449;1768;494;1809;943;3577
171888;201301;585;1936;521;1825;104;369;324;1188;428;1557
171889;201301;468;1647;461;1634;76;229;325;1242;401;1471
171890;201301;1057;3708;983;3599;144;647;673;2411;817;3058
171900;201301;397;1605;384;1580;105;449;206;852;311;1301
172000;201301;598;1986;513;1863;97;413;310;1100;407;1513
172010;201301;1098;3898;1048;3805;91;362;843;3111;934;3473
172015;201301;336;1284;297;1222;57;242;177;767;234;1009
172020;201301;2179;7455;1992;7183;293;1207;1437;5189;1730;6396
172025;201301;643;2049;560;1895;95;356;347;1167;442;1523
172030;201301;1032;3647;956;3506;179;737;603;2227;782;2964
172049;201301;1014;3281;968;3217;135;473;716;2425;851;2898
172065;201301;987;3273;850;3097;163;645;601;2204;764;2849
172080;201301;2613;8208;2285;7662;359;1410;1523;5014;1882;6424
172085;201301;482;1408;392;1261;127;479;93;281;220;760
172090;201301;3258;10069;2589;9231;548;2096;1577;5761;2125;7857
172093;201301;539;1846;448;1683;191;796;171;639;362;1435
172097;201301;639;1939;555;1796;190;676;183;582;373;1258
172100;201301;23062;82962;21396;79565;7820;31358;6845;25675;14665;57033
172110;201301;1562;5902;1477;5775;196;771;1101;4434;1297;5205
172120;201301;5359;16592;4575;15611;474;1707;3632;12665;4106;14372
172125;201301;299;929;244;860;58;211;120;454;178;665
172130;201301;478;1491;443;1440;92;331;284;940;376;1271
172208;201301;2095;6798;2011;6671;503;1748;1151;3946;1654;5694
172210;201301;2250;6901;2167;6801;160;541;1907;5986;2067;6527
210005;201301;19843;68087;18498;65883;4704;17809;10963;39462;15667;57271
210010;201301;1547;5621;1408;5449;141;503;1147;4586;1288;5089
210015;201301;3209;10105;3013;9836;185;433;2631;8976;2816;9409
210020;201301;6656;18218;6270;17744;489;1575;5084;14633;5573;16208
210030;201301;5583;19358;5431;19135;477;2055;4532;15774;5009;17829
210040;201301;1937;5803;1781;5616;180;566;1433;4590;1613;5156
210043;201301;5250;17308;5070;17015;336;1223;4401;14869;4737;16092
210047;201301;6498;25887;6175;25307;923;4091;4337;17902;5260;21993
210050;201301;2362;8247;1983;7849;159;643;1686;6768;1845;7411
210055;201301;1546;5646;1492;5569;194;691;1176;4471;1370;5162
210060;201301;7721;28794;7073;27833;831;3605;5327;21353;6158;24958
210070;201301;6317;21042;6157;20861;286;1068;5674;19316;5960;20384
210080;201301;3332;11868;3275;11775;120;482;3031;10928;3151;11410
210083;201301;3200;11944;3153;11886;228;768;2808;10791;3036;11559
210087;201301;2205;7466;2154;7400;139;529;1964;6726;2103;7255
210090;201301;8928;30635;8750;30360;645;2296;7530;26362;8175;28658
210095;201301;6044;24270;5957;24098;656;2705;4933;20214;5589;22919
210100;201301;7144;21896;6912;21626;226;913;6360;19870;6586;20783
210110;201301;2987;10775;2909;10657;220;871;2445;9116;2665;9987
210120;201301;21522;71208;19551;68545;2140;8005;15178;54004;17318;62009
210125;201301;3076;10634;2972;10502;252;857;2574;9240;2826;10097
210130;201301;3410;10750;3362;10698;212;711;2982;9528;3194;10239
210135;201301;1438;4656;1342;4510;102;367;1140;3878;1242;4245
210140;201301;15693;53355;13768;50906;2791;10596;9384;35689;12175;46285
210150;201301;4173;11718;3995;11514;174;476;3673;10649;3847;11125
210160;201301;17215;58972;16275;57593;1798;6392;13207;47638;15005;54030
210170;201301;13563;51477;13370;51195;1048;3655;11674;45623;12722;49278
210173;201301;1663;7456;1628;7380;175;776;1358;6261;1533;7037
210177;201301;2650;9344;2542;9200;275;1096;2084;7500;2359;8596
210180;201301;1370;4498;1309;4393;140;478;1052;3561;1192;4039
210190;201301;4937;16637;4727;16291;406;1848;3737;12615;4143;14463
210193;201301;1354;4527;1303;4447;90;353;1101;3780;1191;4133
210197;201301;1564;6003;1535;5967;114;527;1354;5218;1468;5745
210200;201301;8489;30449;7998;29763;1144;4087;5971;23098;7115;27185
210203;201301;5732;20250;5409;19839;397;1273;4739;17785;5136;19058
210207;201301;2851;9961;2739;9766;350;1280;2110;7616;2460;8896
210210;201301;8180;28910;7982;28572;373;1453;6930;25124;7303;26577
210215;201301;1769;7233;1738;7189;158;707;1482;6168;1640;6875
210220;201301;5954;23844;5813;23603;471;1981;4832;20036;5303;22017
210230;201301;5109;18296;4807;17783;516;1936;3766;14173;4282;16109
210232;201301;10774;41453;10355;40776;2130;8283;7379;29867;9509;38150
210235;201301;3084;10335;2881;10063;226;825;2503;8780;2729;9605
210237;201301;2422;8838;2399;8803;53;136;2300;8558;2353;8694
210240;201301;2411;8602;2360;8516;197;754;1970;7142;2167;7896
210250;201301;4467;15490;4343;15336;165;632;4009;14263;4174;14895
210255;201301;2489;8450;2300;8136;609;2327;1320;4714;1929;7041
210260;201301;4765;15886;4479;15461;571;1946;3527;12349;4098;14295
210270;201301;4772;14614;4521;14290;189;661;4065;12988;4254;13649
210275;201301;3104;8613;2922;8413;104;290;2761;7992;2865;8282
210280;201301;5593;16934;5004;16192;385;1408;4274;13920;4659;15328
210290;201301;5681;18530;5317;18060;549;1836;4348;15050;4897;16886
210300;201301;32948;109057;29506;104461;3251;12428;24150;86250;27401;98678
210310;201301;2354;7504;2321;7457;157;520;2075;6698;2232;7218
210312;201301;1764;6487;1747;6454;143;577;1493;5555;1636;6132
210315;201301;1933;7499;1889;7442;77;305;1736;6929;1813;7234
210317;201301;4076;12610;4001;12522;164;497;3747;11794;3911;12291
210320;201301;16936;58836;16519;58243;759;3065;15177;53522;15936;56587
210325;201301;3136;10765;2945;10510;378;1450;2368;8497;2746;9947
210330;201301;29042;85780;25436;81793;3408;10060;19427;66172;22835;76232
210340;201301;11125;36869;10442;36025;1245;3897;8253;29661;9498;33558
210350;201301;9578;32287;9166;31719;865;3044;7562;26692;8427;29736
210355;201301;3830;13986;3532;13621;126;338;3289;12989;3415;13327
210360;201301;16237;51728;15412;50481;1449;5016;12391;41243;13840;46259
210370;201301;7418;22088;6900;21531;263;867;6389;20038;6652;20905
210375;201301;3096;9990;2763;9599;531;2003;2004;7008;2535;9011
210380;201301;5720;17767;5276;17023;350;1241;4471;14457;4821;15698
210390;201301;2471;9616;2404;9516;87;362;2241;8946;2328;9308
210400;201301;4381;15638;4240;15457;395;1342;3619;13481;4014;14823
210405;201301;8049;23449;6820;21788;1951;6268;3445;11905;5396;18173
210407;201301;1991;7096;1814;6819;198;698;1413;5575;1611;6273
210408;201301;1922;8098;1868;8033;81;331;1727;7541;1808;7872
210409;201301;3622;13701;3489;13493;270;1158;2836;11177;3106;12335
210410;201301;3038;10974;2847;10726;324;1147;2370;9123;2694;10270
210420;201301;3794;13492;3636;13221;341;1221;3029;11194;3370;12415
210430;201301;1815;5985;1795;5956;130;440;1589;5313;1719;5753
210440;201301;3913;13055;3824;12915;238;845;3329;11385;3567;12230
210450;201301;2539;8702;2412;8489;220;884;1968;6919;2188;7803
210455;201301;4021;12424;3462;11530;627;2146;2325;7972;2952;10118
210460;201301;4063;13440;3894;13232;205;733;3465;11930;3670;12663
210462;201301;1724;6411;1686;6341;188;737;1305;5019;1493;5756
210465;201301;2691;9060;2569;8902;314;933;2076;7489;2390;8422
210467;201301;5477;19851;5157;19377;820;3250;3790;14485;4610;17735
210470;201301;1610;5233;1493;5076;111;420;1215;4176;1326;4596
210480;201301;12357;44625;11345;43227;2670;10486;7325;28686;9995;39172
210490;201301;3048;9946;2887;9698;398;1412;2200;7445;2598;8857
210500;201301;6490;26014;6245;25575;735;2941;4858;20614;5593;23555
210510;201301;6201;21923;6122;21833;154;564;5712;20727;5866;21291
210515;201301;3410;11359;3368;11288;294;914;2911;9951;3205;10865
210520;201301;2496;8346;2378;8179;280;1002;1872;6556;2152;7558
210530;201301;36853;129476;33416;124111;11394;44572;17047;64576;28441;109148
210535;201301;2933;10887;2888;10803;146;614;2554;9600;2700;10214
210540;201301;11155;41705;10264;40229;2095;8174;6490;26911;8585;35085
210542;201301;6155;19077;5525;18372;281;861;4978;16878;5259;17739
210545;201301;2095;7380;2016;7256;92;402;1753;6333;1845;6735
210547;201301;3275;12643;3146;12449;211;919;2743;10932;2954;11851
210550;201301;5875;18031;5113;17169;296;892;4589;15759;4885;16651
210560;201301;3367;11904;3208;11664;266;1062;2697;9835;2963;10897
210565;201301;1477;5256;1348;5078;75;346;1117;4247;1192;4593
210570;201301;11459;36230;10576;35178;1065;3392;8833;30116;9898;33508
210580;201301;2492;8732;2249;8409;282;1084;1752;6683;2034;7767
210590;201301;4254;13860;4071;13633;271;940;3575;12135;3846;13075
210592;201301;2376;7766;2333;7699;122;476;2085;6842;2207;7318
210594;201301;2506;7684;2205;7331;135;474;1920;6453;2055;6927
210596;201301;2741;10759;2635;10559;335;1372;2014;8215;2349;9587
210598;201301;1904;6079;1841;6006;117;507;1683;5379;1800;5886
210600;201301;3179;9626;3019;9410;248;863;2534;7859;2782;8722
210610;201301;2508;8287;2281;8011;252;887;1873;6652;2125;7539
210620;201301;1651;5332;1552;5206;54;201;1439;4843;1493;5044
210630;201301;3138;12065;2787;11351;548;2216;1625;6931;2173;9147
210632;201301;4467;16131;4148;15672;501;1922;3242;12415;3743;14337
210635;201301;1816;6938;1797;6907;61;204;1681;6557;1742;6761
210637;201301;2549;9090;2477;8985;152;579;2208;8085;2360;8664
210640;201301;4050;13745;4011;13689;40;134;3892;13357;3932;13491
210650;201301;5809;19588;5751;19497;480;1656;5042;17227;5522;18883
210660;201301;7053;23455;6728;22947;280;897;6156;21107;6436;22004
210663;201301;2585;8022;2515;7948;74;227;2381;7618;2455;7845
210667;201301;1538;5989;1502;5939;123;518;1274;5100;1397;5618
210670;201301;4539;17694;4436;17510;417;1711;3593;14502;4010;16213
210675;201301;4663;13693;4551;13556;326;990;3909;11859;4235;12849
210680;201301;4163;12998;3813;12573;211;763;3368;11126;3579;11889
210690;201301;6261;22721;6077;22525;345;1360;5515;20514;5860;21874
210700;201301;2407;7171;2150;6866;139;358;1848;6203;1987;6561
210710;201301;4500;15435;4405;15295;166;513;4098;14384;4264;14897
210720;201301;2158;8591;2133;8551;163;664;1853;7497;2016;8161
210725;201301;1130;4269;990;4029;154;694;603;2471;757;3165
210730;201301;1121;3739;1029;3642;68;210;915;3296;983;3506
210735;201301;3429;13444;3352;13300;615;2442;2473;10040;3088;12482
210740;201301;4326;12385;4072;12127;193;420;3731;11425;3924;11845
210745;201301;3191;10721;3119;10609;250;983;2648;8932;2898;9915
210750;201301;19360;55967;17932;54300;1790;5591;14853;45430;16643;51021
210760;201301;5221;15004;5031;14800;91;280;4880;14378;4971;14658
210770;201301;5812;16391;5082;15567;228;651;4644;14367;4872;15018
210780;201301;8198;29253;7858;28628;972;3900;5961;21872;6933;25772
210790;201301;4350;13740;3899;13250;175;607;3555;12236;3730;12843
210800;201301;4421;14315;4083;13955;238;877;3506;12408;3744;13285
210805;201301;3478;15540;3441;15472;200;866;3057;14029;3257;14895
210810;201301;5279;17146;4819;16622;465;1348;4118;14629;4583;15977
210820;201301;8543;25551;8226;25133;1284;3893;6133;19230;7417;23123
210825;201301;5119;17656;5050;17573;196;707;4645;16311;4841;17018
210830;201301;7587;25826;7357;25574;231;626;7033;24717;7264;25343
210840;201301;3429;10068;3231;9753;301;837;2560;7797;2861;8634
210845;201301;5153;17105;5025;16946;242;800;4522;15496;4764;16296
210850;201301;5248;20808;5039;20414;1016;4479;3341;13626;4357;18105
210860;201301;15796;52615;15441;52083;1500;5316;12845;43450;14345;48766
210870;201301;5944;20490;5490;19862;769;2839;4028;14841;4797;17680
210880;201301;3653;12297;3623;12263;203;617;3300;11348;3503;11965
210890;201301;5210;16287;4932;15919;383;1428;4156;13301;4539;14729
210900;201301;4246;14632;4043;14258;1377;4927;1931;7107;3308;12034
210905;201301;1794;5823;1745;5761;96;247;1600;5397;1696;5644
210910;201301;10029;33150;9602;32493;2051;7238;6279;21613;8330;28851
210920;201301;3295;11364;3221;11265;183;557;2876;10285;3059;10842
210923;201301;1397;5522;1371;5469;214;895;1028;4179;1242;5074
210927;201301;4458;14560;4395;14497;45;122;4317;14297;4362;14419
210930;201301;2315;9173;2271;9100;200;912;1910;7686;2110;8598
210940;201301;2767;11445;2737;11385;320;1225;2220;9500;2540;10725
210945;201301;5623;16915;5455;16744;140;208;5259;16431;5399;16639
210950;201301;5059;17253;4574;16546;626;2257;3334;12473;3960;14730
210955;201301;1749;6150;1628;5928;287;1168;1099;3978;1386;5146
210960;201301;8542;29850;8333;29498;1671;5809;5981;21772;7652;27581
210970;201301;1249;4894;1148;4739;212;906;802;3372;1014;4278
210975;201301;1616;5983;1554;5856;150;640;1255;4735;1405;5375
210980;201301;8070;22019;7918;21841;278;815;7378;20360;7656;21175
210990;201301;14031;40813;11965;38589;760;2117;10692;35163;11452;37280
211000;201301;14603;49869;13560;48465;1435;5306;10977;39941;12412;45247
211003;201301;4946;17958;4639;17488;878;3459;3162;12143;4040;15602
211010;201301;6318;21400;6197;21233;181;631;5731;19806;5912;20437
211020;201301;7095;22307;7037;22236;285;605;6652;21382;6937;21987
211023;201301;2361;8415;2287;8288;157;581;1952;7178;2109;7759
211027;201301;2870;11652;2748;11451;298;1210;2209;9553;2507;10763
211030;201301;4021;12926;3705;12555;836;2361;2653;9550;3489;11911
211040;201301;4003;15504;3955;15425;113;453;3629;14359;3742;14812
211050;201301;9601;27261;9499;27144;544;1405;8753;25254;9297;26659
211060;201301;5082;20024;5003;19858;461;1639;4239;17287;4700;18926
211065;201301;1587;5735;1472;5573;92;371;1322;5029;1414;5400
211070;201301;8266;28768;8025;28346;845;3106;6402;22948;7247;26054
211080;201301;1284;4226;1078;3953;99;485;892;3211;991;3696
211085;201301;1876;6594;1662;6328;294;1060;1270;5024;1564;6084
211090;201301;3227;11024;3091;10826;255;1002;2561;8970;2816;9972
211100;201301;6082;17647;5968;17502;174;617;5509;16160;5683;16777
211102;201301;2861;11190;2791;11086;303;1256;2306;9257;2609;10513
211105;201301;2651;8727;2466;8492;173;639;2156;7450;2329;8089
211107;201301;4166;13450;4023;13265;121;404;3777;12521;3898;12925
211110;201301;6038;19059;5032;17802;811;2765;3565;13278;4376;16043
211120;201301;27729;82027;25369;78752;2923;8910;19961;63328;22884;72238
211125;201301;1957;7020;1899;6915;130;519;1630;5971;1760;6490
211130;201301;136462;423469;131300;416978;22850;72201;97928;317283;120778;389484
211140;201301;5513;18655;5380;18435;326;1209;4702;16151;5028;17360
211150;201301;9085;30777;8945;30586;615;2019;7957;27603;8572;29622
211153;201301;3060;9487;2827;9208;255;695;2387;8063;2642;8758
211157;201301;1133;3979;1003;3788;134;607;735;2802;869;3409
211160;201301;3890;14098;3519;13465;442;1917;2699;10352;3141;12269
211163;201301;1536;5267;1478;5193;72;298;1343;4709;1415;5007
211167;201301;1335;4843;1250;4690;79;337;1068;4015;1147;4352
211170;201301;6193;18056;6047;17872;170;658;5630;16561;5800;17219
211172;201301;2136;6617;1932;6316;165;680;1551;4978;1716;5658
211174;201301;2706;8365;2536;8139;145;574;2196;7004;2341;7578
211176;201301;5407;16264;4667;15394;494;1411;3830;13091;4324;14502
211178;201301;2829;9635;2769;9570;69;207;2645;9233;2714;9440
211180;201301;4040;15217;3817;14857;423;1820;2963;11596;3386;13416
211190;201301;2640;9520;2439;9242;162;706;2128;8102;2290;8808
211195;201301;1377;4575;1229;4410;103;377;1014;3709;1117;4086
211200;201301;1947;7227;1778;6978;301;1117;1237;5173;1538;6290
211210;201301;6746;23065;6590;22798;516;1847;5613;19601;6129;21448
211220;201301;32864;103380;29337;98646;6664;23247;18329;63468;24993;86715
211223;201301;5607;16549;5291;16036;714;2207;3705;11800;4419;14007
211227;201301;1437;5753;1412;5709;173;823;1083;4351;1256;5174
211230;201301;8208;29698;7895;29119;1372;5102;5511;20766;6883;25868
211240;201301;8307;28644;8129;28427;384;1438;7483;26276;7867;27714
211245;201301;4824;15777;4749;15682;239;699;4331;14540;4570;15239
211250;201301;11050;43697;10628;43196;1309;4528;8752;37027;10061;41555
211260;201301;6282;24583;6225;24481;366;1277;5653;22591;6019;23868
211270;201301;9379;34961;9072;34554;651;2707;7660;29578;8311;32285
211280;201301;10700;33254;10632;33163;1099;2854;9120;29345;10219;32199
211285;201301;1893;7024;1696;6701;415;1649;960;4008;1375;5657
211290;201301;7315;25286;7212;25156;530;1564;6394;22823;6924;24387
211300;201301;7829;25452;7111;24348;734;2736;5633;19366;6367;22102
211400;201301;11499;35284;10969;34721;1982;6055;7727;26389;9709;32444
220005;201301;1712;5176;1654;5073;76;334;1435;4287;1511;4621
220010;201301;1682;4597;1286;4105;154;571;980;3085;1134;3656
220020;201301;3518;11191;3412;10994;629;2166;2287;7325;2916;9491
220025;201301;2002;5316;1926;5216;85;272;1726;4615;1811;4887
220027;201301;1266;3852;1210;3776;103;313;1016;3227;1119;3540
220030;201301;3142;10046;3088;9956;250;896;2644;8531;2894;9427
220040;201301;8138;25901;7858;25438;1443;5016;5244;17056;6687;22072
220045;201301;1390;4598;1288;4445;162;627;975;3351;1137;3978
220050;201301;4490;13401;4115;12924;385;1374;3436;10703;3821;12077
220060;201301;1885;5154;1798;5052;114;345;1593;4471;1707;4816
220070;201301;2497;7779;2260;7460;194;645;1855;6244;2049;6889
220080;201301;803;2568;759;2489;104;421;532;1680;636;2101
220090;201301;1601;4807;1457;4585;152;570;1134;3500;1286;4070
220095;201301;630;1918;613;1868;40;125;551;1672;591;1797
220100;201301;1373;4276;1217;4033;164;501;885;3043;1049;3544
220105;201301;2074;7244;1994;7102;205;794;1479;5266;1684;6060
220110;201301;3335;10107;2961;9574;301;1179;2387;7579;2688;8758
220115;201301;2055;7928;1983;7805;325;1313;1485;5943;1810;7256
220117;201301;1361;3743;1144;3419;98;334;891;2622;989;2956
220120;201301;11490;35329;10842;34503;487;1843;9716;30986;10203;32829
220130;201301;766;2905;685;2804;82;240;572;2470;654;2710
220140;201301;1452;4125;1440;4113;50;122;1370;3938;1420;4060
220150;201301;6620;22524;6462;22289;550;2150;5437;18756;5987;20906
220155;201301;1012;3278;884;3025;90;389;629;2093;719;2482
220157;201301;1001;2801;933;2701;50;136;813;2390;863;2526
220160;201301;2744;8575;2496;8144;280;1057;1891;6135;2171;7192
220170;201301;1170;4013;1139;3947;93;372;930;3221;1023;3593
220173;201301;2063;6403;1760;5819;109;468;1430;4676;1539;5144
220177;201301;1462;4728;1443;4697;131;436;1221;4001;1352;4437
220180;201301;1116;3178;1020;3041;93;322;800;2363;893;2685
220190;201301;4495;15073;3935;14355;464;1794;3039;11166;3503;12960
220191;201301;1311;4695;1269;4622;216;814;934;3429;1150;4243
220192;201301;1708;5222;1447;4778;184;587;1088;3669;1272;4256
220194;201301;1571;4859;1516;4769;148;538;1261;3910;1409;4448
220196;201301;1936;6116;1864;6004;210;775;1459;4683;1669;5458
220198;201301;1308;3615;1138;3387;57;191;1025;3059;1082;3250
220200;201301;4523;16117;4305;15762;764;3084;2938;10688;3702;13772
220202;201301;1905;6438;1790;6232;100;412;1543;5345;1643;5757
220205;201301;2625;7946;2351;7571;132;541;2034;6490;2166;7031
220207;201301;900;2833;814;2690;105;390;604;1995;709;2385
220208;201301;1443;5544;1373;5392;290;1241;857;3400;1147;4641
220209;201301;1530;4954;1424;4766;106;418;1098;3680;1204;4098
220210;201301;1818;4964;1609;4687;105;354;1284;3774;1389;4128
220211;201301;1507;4901;1436;4799;117;519;1159;3871;1276;4390
220213;201301;1733;5251;1630;5064;130;449;1281;3942;1411;4391
220217;201301;1744;5578;1707;5526;94;292;1525;4992;1619;5284
220220;201301;10848;33183;10362;32378;1461;4532;7587;24229;9048;28761
220225;201301;886;2971;872;2945;37;152;786;2651;823;2803
220230;201301;5509;15414;4527;14074;269;858;3970;12445;4239;13303
220240;201301;2575;8489;2491;8338;219;858;1972;6523;2191;7381
220245;201301;1259;3718;1216;3660;63;162;1096;3348;1159;3510
220250;201301;3126;8751;2888;8457;65;171;2722;8066;2787;8237
220253;201301;1784;5552;1567;5143;116;460;1171;3889;1287;4349
220255;201301;1627;4991;1486;4767;131;528;1178;3689;1309;4217
220260;201301;5076;16857;4744;16262;540;2141;3595;12243;4135;14384
220265;201301;1135;4295;1103;4243;114;532;867;3290;981;3822
220270;201301;5910;21859;5807;21675;466;2071;4919;18176;5385;20247
220271;201301;1307;4012;1281;3975;116;381;1079;3374;1195;3755
220272;201301;1721;5459;1621;5307;129;533;1274;4122;1403;4655
220273;201301;1174;3545;1080;3413;95;352;870;2739;965;3091
220275;201301;1918;5477;1685;5171;102;329;1434;4437;1536;4766
220277;201301;2433;6925;2104;6440;195;650;1566;4840;1761;5490
220280;201301;1712;4597;1507;4314;107;398;1218;3418;1325;3816
220285;201301;1537;4319;1456;4212;106;286;1227;3673;1333;3959
220290;201301;6320;20927;5375;19727;410;1510;4555;17027;4965;18537
220300;201301;1887;6252;1699;6002;86;382;1492;5275;1578;5657
220310;201301;2430;8102;2004;7589;103;359;1835;7040;1938;7399
220320;201301;3231;9869;2770;9136;400;1298;2027;6826;2427;8124
220323;201301;1385;5327;1294;5196;231;979;926;3734;1157;4713
220325;201301;1184;3873;1124;3774;168;576;764;2708;932;3284
220327;201301;1282;4289;1178;4105;103;460;952;3286;1055;3746
220330;201301;3502;10621;3403;10474;343;1170;2803;8673;3146;9843
220335;201301;1927;5807;1758;5582;124;481;1502;4731;1626;5212
220340;201301;1637;4933;1505;4755;179;643;1163;3640;1342;4283
220342;201301;1205;4075;1146;3990;122;482;871;3132;993;3614
220345;201301;2664;7970;2335;7418;67;246;2056;6492;2123;6738
220350;201301;4334;12032;3861;11399;329;1056;3071;9059;3400;10115
220360;201301;1315;3921;1073;3549;114;465;777;2535;891;3000
220370;201301;8658;25874;8117;25201;424;1242;7413;23183;7837;24425
220375;201301;1380;4558;1311;4461;103;413;1117;3761;1220;4174
220380;201301;1235;3663;1108;3483;88;307;827;2617;915;2924
220385;201301;599;1794;574;1747;51;181;477;1412;528;1593
220390;201301;10038;32765;9517;31791;2110;7525;5753;19364;7863;26889
220400;201301;1385;3467;1281;3325;60;196;1119;2851;1179;3047
220410;201301;1361;4068;1188;3838;112;484;942;2949;1054;3433
220415;201301;817;2321;746;2221;88;269;556;1672;644;1941
220420;201301;2109;6418;2045;6308;152;480;1747;5405;1899;5885
220430;201301;2803;8632;2678;8459;476;1574;1876;5930;2352;7504
220435;201301;1490;4621;1423;4543;76;241;1240;4001;1316;4242
220440;201301;2710;8279;2255;7768;156;423;2007;7077;2163;7500
220450;201301;2670;8075;2356;7667;476;1583;1575;5229;2051;6812
220455;201301;1328;4325;1193;4131;76;268;1056;3699;1132;3967
220460;201301;952;2793;905;2727;58;194;788;2360;846;2554
220465;201301;2375;8046;2239;7871;322;1204;1729;6143;2051;7347
220470;201301;3863;12127;3563;11577;270;1015;2814;9039;3084;10054
220480;201301;2139;6836;2020;6662;168;570;1684;5560;1852;6130
220490;201301;2225;6924;2156;6830;151;558;1871;5896;2022;6454
220500;201301;3298;9335;2939;8761;245;935;2369;6892;2614;7827
220510;201301;2801;8066;2201;7237;136;595;1764;5725;1900;6320
220515;201301;1775;4908;1584;4665;93;290;1326;3941;1419;4231
220520;201301;4647;13780;4428;13464;268;763;3871;11941;4139;12704
220525;201301;1394;4201;1325;4103;96;346;1129;3469;1225;3815
220527;201301;1341;4497;1324;4467;126;416;1134;3859;1260;4275
220530;201301;918;2990;897;2955;152;534;683;2240;835;2774
220535;201301;867;2873;844;2836;72;300;690;2293;762;2593
220540;201301;3382;11861;3283;11680;299;1187;2665;9549;2964;10736
220545;201301;1342;4853;1301;4780;207;853;902;3281;1109;4134
220550;201301;8409;29609;8079;28965;1469;5597;5554;19983;7023;25580
220551;201301;1277;4776;1245;4716;145;642;966;3619;1111;4261
220552;201301;1519;5044;1341;4752;167;742;963;3297;1130;4039
220553;201301;1567;4781;1398;4534;68;218;1217;3973;1285;4191
220554;201301;880;2517;778;2382;142;437;521;1625;663;2062
220555;201301;2281;7025;2175;6867;115;398;1834;5898;1949;6296
220556;201301;1395;4590;1288;4391;119;515;969;3252;1088;3767
220557;201301;1562;5375;1464;5181;176;766;1058;3691;1234;4457
220558;201301;968;3181;933;3123;93;350;758;2529;851;2879
220559;201301;1495;4363;1392;4213;93;323;1184;3564;1277;3887
220560;201301;1696;4362;1464;4038;84;258;1238;3398;1322;3656
220570;201301;7235;23561;6874;23126;640;1784;5868;20387;6508;22171
220580;201301;6130;21015;5962;20806;440;1524;5205;18440;5645;19964
220585;201301;1674;6749;1645;6694;106;446;1446;5928;1552;6374
220590;201301;1351;4432;1233;4255;208;759;854;2982;1062;3741
220595;201301;2323;6974;2177;6777;99;338;1949;6106;2048;6444
220600;201301;1190;3313;1074;3173;111;334;831;2480;942;2814
220605;201301;1945;6060;1772;5785;156;521;1362;4496;1518;5017
220610;201301;2597;8781;2527;8674;194;769;2119;7246;2313;8015
220620;201301;7507;26329;7324;26042;373;1632;6473;22900;6846;24532
220630;201301;362;1180;327;1121;86;309;180;631;266;940
220635;201301;1785;6719;1667;6432;190;847;1096;4254;1286;5101
220640;201301;2616;8150;2566;8053;251;944;2041;6338;2292;7282
220650;201301;2412;6890;2203;6576;121;414;1881;5602;2002;6016
220660;201301;2490;8717;2067;8200;153;611;1856;7426;2009;8037
220665;201301;1159;4135;1125;4087;67;264;991;3627;1058;3891
220667;201301;1698;5953;1616;5834;103;427;1375;4948;1478;5375
220669;201301;1776;6118;1663;5885;204;871;1239;4327;1443;5198
220670;201301;2047;6465;1990;6399;162;431;1741;5801;1903;6232
220672;201301;1999;6094;1956;6031;267;809;1564;4884;1831;5693
220675;201301;1221;3827;1165;3728;130;397;879;2845;1009;3242
220680;201301;2176;7439;2104;7336;116;463;1850;6462;1966;6925
220690;201301;1681;5012;1558;4806;131;502;1282;3887;1413;4389
220695;201301;800;2625;779;2583;68;248;603;2006;671;2254
220700;201301;8781;26608;8126;25628;795;2766;6465;20492;7260;23258
220710;201301;731;2228;663;2130;85;271;487;1575;572;1846
220720;201301;2047;5721;1949;5578;107;242;1729;5053;1836;5295
220730;201301;1259;3762;1162;3609;71;263;954;2959;1025;3222
220735;201301;1004;2763;888;2580;103;327;653;1916;756;2243
220740;201301;1235;4314;1096;4125;79;245;948;3677;1027;3922
220750;201301;3634;11666;3547;11540;226;769;3088;10142;3314;10911
220755;201301;1146;3558;1122;3525;81;224;1005;3201;1086;3425
220760;201301;2506;9161;2340;8898;122;517;2031;7774;2153;8291
220770;201301;22250;79398;21105;77290;7241;27336;9628;36400;16869;63736
220775;201301;1034;2725;1026;2717;18;27;1001;2673;1019;2700
220777;201301;1630;4860;1567;4766;131;415;1314;3981;1445;4396
220779;201301;1103;3558;1086;3528;72;291;954;3076;1026;3367
220780;201301;6083;16265;5581;15612;465;1205;4738;13502;5203;14707
220785;201301;1286;3614;1243;3523;67;200;1113;3127;1180;3327
220790;201301;8270;30572;8141;30306;670;2815;6875;25626;7545;28441
220793;201301;786;2513;750;2447;86;313;587;1914;673;2227
220795;201301;1259;4143;1222;4081;95;382;1023;3406;1118;3788
220800;201301;15906;47798;15159;46551;2147;7589;11327;34101;13474;41690
220810;201301;2944;9237;2664;8742;250;1007;2073;6697;2323;7704
220820;201301;5305;15891;4912;15388;394;1309;4101;12986;4495;14295
220830;201301;7272;21746;7051;21374;861;2637;5498;16903;6359;19540
220840;201301;12878;44492;12177;43078;3186;11655;6000;21863;9186;33518
220850;201301;2422;9608;2343;9482;408;1720;1697;6989;2105;8709
220855;201301;582;1929;541;1854;81;327;386;1304;467;1631
220860;201301;890;2624;844;2551;58;236;692;2038;750;2274
220865;201301;2566;7557;2226;7022;139;603;1800;5587;1939;6190
220870;201301;2214;7649;1941;7299;166;685;1607;6044;1773;6729
220880;201301;5198;14116;4786;13605;284;992;4159;11784;4443;12776
220885;201301;1303;4693;1166;4448;127;596;861;3288;988;3884
220887;201301;1127;3399;1038;3275;69;229;887;2826;956;3055
220890;201301;1556;5750;1416;5521;128;478;1172;4697;1300;5175
220900;201301;1781;5711;1615;5314;142;452;1297;4356;1439;4808
220910;201301;1695;5047;1531;4788;89;310;1318;4146;1407;4456
220915;201301;1024;3049;929;2897;69;294;753;2269;822;2563
220920;201301;1279;4948;1227;4873;127;577;949;3768;1076;4345
220930;201301;1337;4622;1190;4428;111;489;969;3582;1080;4071
220935;201301;1096;3534;1042;3421;106;461;768;2423;874;2884
220937;201301;1454;4208;1297;3946;89;326;1039;3114;1128;3440
220940;201301;1469;4653;1384;4468;104;393;1122;3623;1226;4016
220945;201301;460;1738;435;1654;59;251;321;1219;380;1470
220950;201301;1232;3224;931;2702;63;242;699;1952;762;2194
220955;201301;1492;4378;1274;4035;143;517;974;3053;1117;3570
220960;201301;758;2269;686;2145;80;321;510;1534;590;1855
220965;201301;1566;5030;1489;4921;81;331;1270;4192;1351;4523
220970;201301;2059;5782;1595;5026;210;670;1108;3572;1318;4242
220975;201301;462;1927;460;1922;63;232;383;1640;446;1872
220980;201301;1432;4447;1295;4199;135;523;884;2914;1019;3437
220985;201301;1328;3956;1278;3886;125;421;1018;3096;1143;3517
220987;201301;1416;4937;1352;4813;136;602;1023;3567;1159;4169
220990;201301;1757;5379;1612;5136;113;478;1281;4020;1394;4498
220995;201301;1135;3600;970;3314;79;331;791;2680;870;3011
220997;201301;2036;6594;1980;6510;166;541;1724;5687;1890;6228
221000;201301;3924;12937;3659;12455;445;1686;2741;9277;3186;10963
221005;201301;1341;4441;1284;4340;350;1134;755;2641;1105;3775
221010;201301;1207;3442;1079;3280;83;282;914;2788;997;3070
221020;201301;1860;6024;1774;5870;143;635;1390;4492;1533;5127
221030;201301;1798;5054;1589;4756;88;354;1306;3867;1394;4221
221035;201301;1426;4143;1304;3991;79;261;1139;3518;1218;3779
221037;201301;595;1916;571;1875;37;162;461;1452;498;1614
221038;201301;567;1720;481;1582;50;176;344;1146;394;1322
221039;201301;862;2781;839;2744;72;249;732;2389;804;2638
221040;201301;4930;15818;4754;15536;439;1606;3763;12378;4202;13984
221050;201301;3450;11379;3221;11038;252;1067;2704;9161;2956;10228
221060;201301;8729;24684;7654;23354;943;2884;6043;18748;6986;21632
221062;201301;1203;4452;1159;4398;40;116;1095;4198;1135;4314
221063;201301;1049;3543;1009;3481;262;859;653;2349;915;3208
221065;201301;2457;7950;2399;7844;201;780;1958;6302;2159;7082
221070;201301;4360;13795;4044;13326;313;1185;3257;10725;3570;11910
221080;201301;3014;9300;2840;9067;261;904;2299;7410;2560;8314
221090;201301;1291;3681;1170;3507;80;322;985;2886;1065;3208
221093;201301;1696;5255;1641;5155;245;905;1136;3477;1381;4382
221095;201301;881;2591;765;2433;59;142;640;2118;699;2260
221097;201301;758;2315;703;2226;67;261;539;1695;606;1956
221100;201301;117116;374126;112390;366113;25910;93229;72080;229583;97990;322812
221110;201301;9098;32793;8989;32627;726;2885;7641;27816;8367;30701
221120;201301;3871;13584;3781;13422;1112;3696;2304;8682;3416;12378
221130;201301;4443;13735;4039;12901;979;3273;2305;7277;3284;10550
221135;201301;1344;4517;1278;4399;203;779;887;3049;1090;3828
221140;201301;1347;3566;1257;3445;188;408;945;2716;1133;3124
221150;201301;1168;3172;1066;3007;56;208;860;2396;916;2604
221160;201301;889;2509;855;2455;58;199;675;1939;733;2138
221170;201301;1069;3651;1038;3585;88;365;858;2923;946;3288
230010;201301;3198;9187;2777;8502;195;673;2205;6836;2400;7509
230015;201301;3171;11238;2978;10816;612;2459;1841;6656;2453;9115
230020;201301;13403;47271;12953;46346;1575;6075;9729;35122;11304;41197
230030;201301;11624;36720;11252;36061;1269;4438;8803;28206;10072;32644
230040;201301;4414;13187;3846;12172;385;1395;2996;9434;3381;10829
230050;201301;2511;8838;2234;8170;424;1713;1252;4599;1676;6312
230060;201301;1859;5936;1703;5623;199;753;1248;4104;1447;4857
230070;201301;4577;12999;4124;12366;403;1283;3173;9723;3576;11006
230075;201301;8398;33182;8079;32537;1136;5100;5918;24028;7054;29128
230080;201301;2216;6567;1966;6201;154;586;1565;4900;1719;5486
230090;201301;3049;10154;2815;9711;402;1543;2027;6941;2429;8484
230100;201301;16077;52971;15258;51527;4772;17026;7510;25763;12282;42789
230110;201301;13454;46528;12696;44895;2556;9796;7884;27903;10440;37699
230120;201301;7232;21537;6715;20847;804;2843;5102;15800;5906;18643
230125;201301;2805;8611;2407;7863;222;877;1830;5932;2052;6809
230130;201301;6206;20760;5030;18293;509;2252;3502;12643;4011;14895
230140;201301;3179;11131;2910;10674;490;1852;1892;7141;2382;8993
230150;201301;1673;5630;1513;5302;283;1150;1007;3381;1290;4531
230160;201301;5763;18802;5178;17937;556;2151;3999;13867;4555;16018
230170;201301;6230;20931;5537;19651;588;2381;3998;14124;4586;16505
230180;201301;1847;5621;1687;5341;172;682;1192;3760;1364;4442
230185;201301;4014;14023;3757;13507;755;2758;2309;8566;3064;11324
230190;201301;12110;41239;11236;39512;2027;8162;6972;24305;8999;32467
230195;201301;4606;15098;4229;14512;405;1755;3277;10899;3682;12654
230200;201301;5316;16652;4996;16029;793;2680;3458;11137;4251;13817
230205;201301;4237;14207;3848;13546;460;1844;2785;9943;3245;11787
230210;201301;9069;27347;8265;26138;2019;6526;4793;15737;6812;22263
230220;201301;12986;40969;12216;39669;2255;8202;8131;26044;10386;34246
230230;201301;6721;24098;6125;22765;1044;4205;3773;14181;4817;18386
230240;201301;12557;39138;11709;37490;901;3562;9135;28729;10036;32291
230250;201301;10080;31708;9854;31363;590;2189;8485;27003;9075;29192
230260;201301;14441;51716;13549;49804;3288;12918;7107;26732;10395;39650
230270;201301;6791;21663;6173;20604;714;2688;4608;15456;5322;18144
230280;201301;19470;61511;18310;59647;2508;8969;13765;44804;16273;53773
230290;201301;4851;15793;4356;14791;605;2263;3016;10221;3621;12484
230300;201301;4435;14895;4291;14676;603;2261;3180;10949;3783;13210
230310;201301;4683;14605;4208;13807;424;1706;3203;10338;3627;12044
230320;201301;6937;23703;6664;23223;944;3684;4866;17044;5810;20728
230330;201301;4474;14112;4130;13416;429;1680;3108;9876;3537;11556
230340;201301;3236;11908;3100;11599;517;2252;2001;7301;2518;9553
230350;201301;17209;55644;15672;52911;3282;11883;9553;32676;12835;44559
230360;201301;2528;8230;2461;8113;261;1031;1974;6403;2235;7434
230365;201301;2736;8627;2438;8115;225;891;1806;5992;2031;6883
230370;201301;51101;178901;48327;174180;14910;55657;24884;92904;39794;148561
230380;201301;6863;20641;6018;19230;668;2517;4245;13504;4913;16021
230390;201301;3537;11649;3210;11112;457;1800;2211;7678;2668;9478
230393;201301;3195;11242;2879;10563;324;1546;2042;7282;2366;8828
230395;201301;4721;15877;4473;15385;666;2713;3127;10634;3793;13347
230400;201301;4969;16245;4443;15531;429;1925;3599;12341;4028;14266
230410;201301;15788;51858;14460;49520;2333;8799;9522;32594;11855;41393
230420;201301;23026;79771;21997;77736;5864;22537;11476;40507;17340;63044
230423;201301;4574;15767;4265;15226;556;2132;2994;10896;3550;13028
230425;201301;5001;17990;4808;17543;745;2965;3406;12434;4151;15399
230426;201301;2704;7919;2352;7299;174;697;1806;5496;1980;6193
230427;201301;1656;5362;1331;4634;188;725;881;3056;1069;3781
230428;201301;8523;29584;8360;29294;1902;7431;5341;18451;7243;25882
230430;201301;4386;14912;4220;14585;451;1893;3132;10672;3583;12565
230435;201301;4269;15381;3972;14888;1182;4727;1863;7327;3045;12054
230440;201301;341422;1111744;326866;1085349;88434;317106;169813;565567;258247;882673
230445;201301;4519;13116;3995;12385;436;1346;2961;9463;3397;10809
230450;201301;3432;11719;2974;10883;485;1935;1878;6985;2363;8920
230460;201301;1824;6413;1720;6210;183;683;1360;4997;1543;5680
230465;201301;3942;12924;3359;11820;411;1752;2261;7900;2672;9652
230470;201301;10332;40196;10056;39653;1534;6423;7174;28929;8708;35352
230480;201301;1401;4730;1298;4541;187;715;936;3275;1123;3990
230490;201301;2845;8660;2560;8146;449;1629;1466;4672;1915;6301
230495;201301;5523;19284;5084;18605;949;4095;3159;11574;4108;15669
230500;201301;10392;36558;9999;35939;916;3352;7992;29477;8908;32829
230510;201301;1441;5386;1294;5029;394;1588;594;2405;988;3993
230520;201301;4881;15513;4295;14459;509;1981;2992;10035;3501;12016
230523;201301;12599;44050;11860;42365;3888;15344;3750;13675;7638;29019
230526;201301;3847;12868;3463;12137;523;2005;2345;8365;2868;10370
230530;201301;4747;17041;4468;16644;553;2286;3460;12887;4013;15173
230533;201301;3669;11369;3487;11010;325;1217;2688;8404;3013;9621
230535;201301;5059;16035;4529;15023;558;2006;3265;10949;3823;12955
230540;201301;17757;54523;16274;52352;1359;4974;13310;42711;14669;47685
230550;201301;19707;61856;18338;59266;4474;15547;10218;33110;14692;48657
230560;201301;6439;19591;6051;18850;368;1496;4826;14884;5194;16380
230565;201301;3547;10701;3158;9966;305;1156;2289;7148;2594;8304
230570;201301;3696;10639;3368;10217;289;1077;2725;8152;3014;9229
230580;201301;9696;31753;9466;31431;593;2085;8288;27774;8881;29859
230590;201301;9232;30981;8771;30152;887;3763;6648;22441;7535;26204
230600;201301;3494;10325;2930;9170;332;1162;2012;6245;2344;7407
230610;201301;5759;20082;5458;19593;721;2859;4083;14724;4804;17583
230620;201301;1891;5698;1668;5251;178;653;1163;3629;1341;4282
230625;201301;7039;24664;6579;23599;1877;7372;2762;9828;4639;17200
230630;201301;10516;36303;9843;34868;1711;6114;6266;22762;7977;28876
230640;201301;23891;87995;23430;87047;4096;16200;16185;60743;20281;76943
230650;201301;4714;15828;4418;15252;437;1917;3372;11412;3809;13329
230655;201301;7797;31549;7595;31209;881;3600;6169;25868;7050;29468
230660;201301;6055;20005;5438;18849;639;2587;3897;13609;4536;16196
230670;201301;5719;16444;4805;14878;349;1288;3788;11610;4137;12898
230680;201301;2804;8765;2465;8174;470;1701;1485;4940;1955;6641
230690;201301;6781;22810;6300;21973;669;2879;4480;15304;5149;18183
230700;201301;8611;26598;7759;25051;918;3648;5296;16693;6214;20341
230710;201301;6826;23967;6488;23254;916;3425;4598;16828;5514;20253
230720;201301;1889;6151;1639;5668;250;926;1090;3801;1340;4727
230725;201301;3675;12547;3566;12323;530;2141;2610;8863;3140;11004
230730;201301;55134;174256;47859;163214;11886;44133;26895;93498;38781;137631
230740;201301;4775;16413;4720;16289;385;1692;3908;13280;4293;14972
230750;201301;8502;26123;7428;24335;804;3187;5535;17980;6339;21167
230760;201301;9314;30263;9115;29793;1386;5642;6617;20531;8003;26173
230763;201301;4021;13345;3867;13051;361;1628;3014;9834;3375;11462
230765;201301;41285;142009;39360;137983;13651;50475;15366;55125;29017;105600
230770;201301;21318;64709;20570;63663;1942;7633;16615;50665;18557;58298
230780;201301;5799;23917;5615;23505;1268;5382;3249;14312;4517;19694
230790;201301;2354;8648;2271;8520;294;1199;1794;6773;2088;7972
230800;201301;7665;29000;7177;27896;1743;7469;3728;14549;5471;22018
230810;201301;11979;40681;11599;40048;1447;5395;8881;30967;10328;36362
230820;201301;3143;11412;2904;10918;603;2451;1771;6836;2374;9287
230830;201301;7477;23804;6908;22791;758;3008;5020;16424;5778;19432
230835;201301;3946;11368;3461;10754;342;1120;2720;8537;3062;9657
230837;201301;3109;11044;2726;10254;433;1813;1751;6639;2184;8452
230840;201301;8774;30907;8218;29939;1399;5319;5459;20437;6858;25756
230850;201301;10974;35069;10462;34432;1328;4797;8086;26734;9414;31531
230860;201301;4874;15226;4491;14437;452;1745;3317;10488;3769;12233
230870;201301;18284;53952;16719;51261;1987;6964;12511;38143;14498;45107
230880;201301;1902;6893;1794;6676;314;1313;1166;4347;1480;5660
230890;201301;3972;15087;3737;14597;507;2362;2717;10474;3224;12836
230900;201301;2981;10290;2663;9622;438;1746;1634;5905;2072;7651
230910;201301;2851;9029;2405;8153;312;1247;1666;5544;1978;6791
230920;201301;4384;13599;4101;13228;379;1295;3289;10800;3668;12095
230930;201301;7396;23689;6897;22757;932;3322;4925;16327;5857;19649
230940;201301;7407;21591;6754;20736;319;972;6048;18822;6367;19794
230945;201301;6181;19888;5685;19192;748;2670;4129;14064;4877;16734
230950;201301;6639;19122;5900;18175;422;1499;4694;14480;5116;15979
230960;201301;10992;37472;10365;36172;2688;10318;4961;17339;7649;27657
230970;201301;12614;42805;11744;41045;2674;10690;6243;21426;8917;32116
230980;201301;2628;9277;2496;8992;673;2521;1357;4988;2030;7509
230990;201301;1510;5088;1314;4661;172;710;832;2901;1004;3611
231000;201301;2751;7790;2294;6919;256;932;1588;4668;1844;5600
231010;201301;2787;8713;2518;8306;346;1408;1812;5861;2158;7269
231020;201301;7809;26765;7438;25999;1408;5261;4771;16953;6179;22214
231025;201301;7317;24426;6755;23506;549;1945;5466;19411;6015;21356
231030;201301;7563;26226;6602;24188;1277;4963;4057;15047;5334;20010
231040;201301;2833;10003;2622;9539;322;1420;1804;6466;2126;7886
231050;201301;11272;35038;10394;33401;1125;4123;7646;24576;8771;28699
231060;201301;2337;7588;2174;7308;230;1016;1638;5336;1868;6352
231070;201301;8707;29257;8344;28553;1372;5004;5714;19744;7086;24748
231080;201301;4001;13511;3811;13111;345;1608;2820;9337;3165;10945
231085;201301;4418;14971;4275;14703;679;2607;3099;10657;3778;13264
231090;201301;4150;11928;3611;10870;302;1123;2757;8187;3059;9310
231095;201301;2100;7249;1879;6816;221;865;1338;4902;1559;5767
231100;201301;3124;10001;2718;9221;287;1112;1982;6699;2269;7811
231110;201301;3596;12558;3515;12413;405;1593;2628;9299;3033;10892
231120;201301;2351;8109;2216;7880;383;1417;1498;5372;1881;6789
231123;201301;2155;6300;1914;5923;173;598;1521;4716;1694;5314
231126;201301;6471;18738;5464;17377;497;1835;4285;13482;4782;15317
231130;201301;19411;63991;18130;61727;4762;17098;9721;34096;14483;51194
231135;201301;4459;13724;3859;12791;404;1584;2832;9227;3236;10811
231140;201301;14928;50440;14326;49287;1775;8044;10324;34130;12099;42174
231150;201301;5623;17380;4865;15874;1084;3908;2478;7960;3562;11868
231160;201301;5556;20024;5430;19746;1619;6060;3013;11033;4632;17093
231170;201301;4523;15205;4297;14765;558;2297;3020;10305;3578;12602
231180;201301;13308;43900;12723;42706;2756;10266;7702;25366;10458;35632
231190;201301;4587;14040;4122;13350;421;1541;3148;10186;3569;11727
231195;201301;4655;16429;4120;15410;436;1872;3153;11919;3589;13791
231200;201301;7339;26807;6804;25803;839;3779;4978;18819;5817;22598
231210;201301;4652;15679;4100;14898;385;1636;3092;11449;3477;13085
231220;201301;13636;41026;11780;37890;1371;5256;7690;24824;9061;30080
231230;201301;9068;33913;8601;32965;1341;5578;5976;23017;7317;28595
231240;201301;11273;37175;10348;35544;1435;5541;7041;24455;8476;29996
231250;201301;2048;6154;1413;4551;268;915;601;1810;869;2725
231260;201301;3976;11588;3656;11156;490;1574;2598;8139;3088;9713
231270;201301;7282;22006;6798;21285;799;3141;4933;15098;5732;18239
231280;201301;1667;5799;1619;5717;165;594;1293;4652;1458;5246
231290;201301;31042;115569;29112;110681;8334;34508;12449;46672;20783;81180
231300;201301;4297;13309;3682;12020;401;1686;2669;8389;3070;10075
231310;201301;7061;21816;6355;20418;1470;4924;3480;11302;4950;16226
231320;201301;6993;22503;6371;21327;547;2182;4933;16481;5480;18663
231325;201301;2518;8095;2330;7762;224;784;1807;6157;2031;6941
231330;201301;13598;43936;11648;40163;2093;7404;7201;25172;9294;32576
231335;201301;4706;14313;4343;13682;373;1436;3549;11008;3922;12444
231340;201301;16787;57615;16032;56521;1604;5459;12995;47102;14599;52561
231350;201301;11650;41728;11508;41503;1284;4526;9537;35015;10821;39541
231355;201301;4205;14088;4106;13928;297;1004;3502;12053;3799;13057
231360;201301;6610;22949;6306;22486;1441;5142;3963;14641;5404;19783
231370;201301;2242;6764;1866;6215;154;642;1411;4594;1565;5236
231375;201301;4032;14338;3861;14004;500;2149;2859;10231;3359;12380
231380;201301;5118;17310;4859;16934;894;3366;3356;11858;4250;15224
231390;201301;3188;10684;3063;10519;221;866;2625;9098;2846;9964
231395;201301;4121;13766;3742;13172;800;2981;2345;8407;3145;11388
231400;201301;9973;30997;9244;29738;1141;4228;6546;21106;7687;25334
231410;201301;14463;49386;13234;47684;1460;5397;9939;36878;11399;42275
240010;201301;2269;7487;2135;7185;647;2420;934;3050;1581;5470
240020;201301;11196;36636;10274;34874;2974;10848;4794;16551;7768;27399
240030;201301;2699;8236;2608;8087;288;1117;1996;6030;2284;7147
240040;201301;735;2329;653;2180;86;370;444;1411;530;1781
240050;201301;3352;9753;3069;9274;292;1088;2292;6758;2584;7846
240060;201301;1334;4259;1291;4190;152;612;973;3065;1125;3677
240070;201301;2629;7852;2531;7657;313;1106;1827;5347;2140;6453
240080;201301;2851;8020;2703;7790;188;629;2291;6585;2479;7214
240090;201301;2091;6061;1836;5547;93;385;1407;4148;1500;4533
240100;201301;9821;30095;9235;28915;1266;4749;5875;18379;7141;23128
240110;201301;4831;15108;4517;14655;990;3621;2824;8875;3814;12496
240120;201301;2859;9758;2795;9638;576;2174;1805;6293;2381;8467
240130;201301;2599;7621;2279;7104;189;728;1804;5500;1993;6228
240140;201301;2176;7090;2044;6851;491;1875;1077;3534;1568;5409
240145;201301;5965;19005;5518;18268;1345;4925;3262;10824;4607;15749
240150;201301;981;3135;856;2890;145;609;474;1551;619;2160
240160;201301;1396;4888;1338;4780;169;679;970;3466;1139;4145
240165;201301;851;2886;782;2752;97;383;530;1887;627;2270
240170;201301;2501;7938;2298;7564;623;2143;1251;4212;1874;6355
240180;201301;2774;9161;2651;8969;666;2329;1525;5381;2191;7710
240185;201301;1495;5157;1455;5097;178;663;1133;3998;1311;4661
240190;201301;824;2669;806;2641;130;513;531;1692;661;2205
240200;201301;12891;35868;11271;33840;2057;6226;7677;23857;9734;30083
240210;201301;2600;7726;2434;7504;238;882;1994;6043;2232;6925
240220;201301;7101;23341;6934;23149;241;928;6488;21655;6729;22583
240230;201301;5092;15524;4840;15057;561;2020;3667;11255;4228;13275
240240;201301;1659;5453;1371;4708;451;1670;357;1141;808;2811
240250;201301;2716;8142;2609;7974;227;853;2135;6392;2362;7245
240260;201301;14021;49174;13498;48297;2441;9872;9007;32328;11448;42200
240270;201301;2250;7826;2157;7671;272;976;1613;5852;1885;6828
240280;201301;1548;4672;1393;4387;176;645;972;3022;1148;3667
240290;201301;1399;4534;1220;4192;138;642;820;2701;958;3343
240300;201301;1908;5373;1658;4970;334;1121;957;2792;1291;3913
240310;201301;9952;29311;9269;28247;2222;7484;5124;15531;7346;23015
240320;201301;1999;6163;1738;5625;143;645;1193;3704;1336;4349
240325;201301;33956;98876;27984;88577;8294;28957;10569;33733;18863;62690
240330;201301;1487;4648;1292;4254;183;756;816;2562;999;3318
240340;201301;1528;4817;1392;4642;312;1124;853;2856;1165;3980
240350;201301;1897;6321;1812;6166;338;1360;1304;4298;1642;5658
240360;201301;6621;21310;5975;20284;1076;3933;3991;13865;5067;17798
240370;201301;1832;5250;1665;4998;122;466;1293;3879;1415;4345
240375;201301;852;2338;774;2228;182;593;419;1158;601;1751
240380;201301;2479;7707;2204;7139;348;1183;1431;4638;1779;5821
240390;201301;876;2609;735;2326;82;335;471;1462;553;1797
240400;201301;1382;3914;1231;3700;134;505;941;2774;1075;3279
240410;201301;513;1712;459;1594;89;354;268;916;357;1270
240420;201301;4610;18062;4491;17801;1325;5270;2391;10033;3716;15303
240430;201301;3157;9717;2970;9376;464;1655;2072;6502;2536;8157
240440;201301;2533;7379;2392;7100;621;1832;1242;3822;1863;5654
240450;201301;3333;10635;3175;10360;631;2377;1857;6067;2488;8444
240460;201301;2723;9497;2663;9387;327;1322;2022;7132;2349;8454
240470;201301;3747;11667;3257;10704;908;3115;1589;5411;2497;8526
240480;201301;294;831;287;823;29;93;231;668;260;761
240485;201301;2027;6282;1818;5875;254;947;1176;3811;1430;4758
240490;201301;1561;4255;1445;4092;107;406;1165;3219;1272;3625
240500;201301;1858;6095;1824;6037;198;721;1427;4767;1625;5488
240510;201301;1685;5404;1577;5195;257;917;1068;3529;1325;4446
240520;201301;1391;4231;1236;4009;219;830;827;2623;1046;3453
240530;201301;2008;6928;1846;6645;292;1155;1239;4474;1531;5629
240540;201301;1762;5512;1686;5385;151;570;1291;4050;1442;4620
240550;201301;679;2128;659;2094;55;209;542;1698;597;1907
240560;201301;3087;9314;2969;9136;259;903;2437;7471;2696;8374
240570;201301;2988;8835;2509;7772;548;1921;1152;3326;1700;5247
240580;201301;7779;24979;7463;24493;1338;4563;5358;17621;6696;22184
240590;201301;799;2390;739;2294;60;237;528;1602;588;1839
240600;201301;1403;4362;1192;3903;224;819;649;2009;873;2828
240610;201301;4944;14243;4425;13312;483;1642;3171;9426;3654;11068
240615;201301;984;2933;874;2731;146;470;534;1683;680;2153
240620;201301;1489;5246;1432;5131;312;1200;974;3487;1286;4687
240630;201301;1943;6196;1870;6076;168;565;1469;4904;1637;5469
240640;201301;809;2580;713;2430;127;503;447;1506;574;2009
240650;201301;3598;11522;3403;11257;319;1235;2764;9092;3083;10327
240660;201301;2306;7911;2238;7807;249;978;1736;6109;1985;7087
240670;201301;2645;8211;2336;7581;395;1525;1408;4423;1803;5948
240680;201301;1373;4216;1156;3831;134;497;763;2539;897;3036
240690;201301;1055;3082;940;2900;108;398;678;2074;786;2472
240700;201301;2592;8089;2236;7399;190;823;1666;5341;1856;6164
240710;201301;16432;44475;15102;42851;2748;7879;9953;29125;12701;37004
240720;201301;5162;15664;4955;15340;1282;4449;2808;8628;4090;13077
240725;201301;1069;3233;841;2729;98;330;469;1502;567;1832
240730;201301;2217;7039;2016;6657;208;798;1433;4648;1641;5446
240740;201301;2215;6868;2044;6566;247;883;1450;4638;1697;5521
240750;201301;2058;7949;1935;7718;399;1696;1203;4875;1602;6571
240760;201301;1171;3627;1120;3546;108;329;904;2935;1012;3264
240770;201301;3360;10315;3105;9923;477;1710;2104;6731;2581;8441
240780;201301;5171;16059;4491;14906;1021;3498;2430;8490;3451;11988
240790;201301;803;2701;690;2492;77;318;501;1810;578;2128
240800;201301;37599;113496;35244;109297;10494;34994;16020;50287;26514;85281
240810;201301;89905;280411;85544;272181;29420;97336;38642;125482;68062;222818
240820;201301;6477;20170;5728;18946;925;3435;3535;12001;4460;15436
240830;201301;8590;27767;8262;27252;847;2931;6623;22281;7470;25212
240840;201301;1230;3592;1095;3345;106;392;709;2145;815;2537
240850;201301;1093;3510;853;3003;179;718;427;1428;606;2146
240860;201301;1277;3732;1123;3491;99;373;825;2509;924;2882
240870;201301;1077;3152;968;2950;128;518;681;1948;809;2466
240880;201301;1017;3726;991;3681;158;688;661;2460;819;3148
240890;201301;5267;15270;4831;14570;802;2767;2976;8875;3778;11642
240895;201301;2629;9321;2438;8982;377;1522;1710;6351;2087;7873
240910;201301;2407;8200;2298;8000;270;1123;1754;6071;2024;7194
240920;201301;810;2700;768;2595;186;721;424;1389;610;2110
240930;201301;3427;9705;3159;9328;318;1048;2485;7357;2803;8405
240933;201301;1319;4365;1225;4205;332;1150;637;2372;969;3522
240940;201301;6303;18600;5534;17303;1116;3790;3208;10010;4324;13800
240950;201301;1105;3593;1053;3506;103;427;775;2590;878;3017
240960;201301;717;2434;665;2319;110;410;467;1628;577;2038
240970;201301;1926;5795;1729;5410;154;642;1233;3801;1387;4443
240980;201301;3304;11152;3108;10771;760;2826;1788;6227;2548;9053
240990;201301;2955;9200;2811;8905;658;2337;1726;5293;2384;7630
241000;201301;1008;2978;906;2799;104;404;652;1966;756;2370
241010;201301;2822;9942;2575;9492;469;1944;1676;6111;2145;8055
241020;201301;2007;5871;1730;5353;184;713;1105;3247;1289;3960
241025;201301;1421;4547;1353;4435;162;672;949;3049;1111;3721
241030;201301;2394;8150;2219;7846;179;700;1790;6377;1969;7077
241040;201301;1974;7171;1843;6908;215;948;1398;5198;1613;6146
241050;201301;1227;3883;1153;3770;130;539;867;2744;997;3283
241060;201301;969;2868;894;2750;134;431;658;2044;792;2475
241070;201301;908;2715;792;2489;106;425;555;1667;661;2092
241080;201301;1118;3511;1020;3340;91;391;737;2352;828;2743
241090;201301;1819;5779;1770;5695;152;626;1458;4601;1610;5227
241100;201301;1127;3521;1048;3341;114;426;732;2303;846;2729
241105;201301;1063;3340;1011;3241;133;488;705;2284;838;2772
241110;201301;832;2771;725;2548;171;615;366;1315;537;1930
241120;201301;7838;23950;7233;23035;1340;4372;5044;16367;6384;20739
241140;201301;3157;9517;2898;8991;383;1406;1967;5931;2350;7337
241142;201301;686;2144;525;1801;162;630;186;609;348;1239
241150;201301;5335;16998;5068;16561;727;2590;3675;12025;4402;14615
241160;201301;1032;3200;1004;3156;141;463;745;2377;886;2840
241170;201301;1262;3927;1170;3750;181;670;731;2456;912;3126
241180;201301;938;2594;777;2360;103;399;526;1533;629;1932
241190;201301;1014;2904;940;2777;102;394;648;1814;750;2208
241200;201301;19113;60576;18143;58941;5084;17684;9466;31362;14550;49046
241210;201301;1436;4451;1275;4134;252;916;727;2348;979;3264
241220;201301;7844;27313;7537;26711;1859;7053;4230;15343;6089;22396
241230;201301;2857;9286;2673;9017;253;1040;2142;7182;2395;8222
241240;201301;1061;3185;864;2794;147;517;491;1606;638;2123
241250;201301;6063;19581;5521;18553;597;2463;4185;13934;4782;16397
241255;201301;1861;7289;1799;7158;415;1724;991;4105;1406;5829
241260;201301;4040;12240;3463;11191;743;2395;1992;6611;2735;9006
241270;201301;1928;6058;1762;5745;316;1192;1020;3367;1336;4559
241280;201301;2057;6161;1934;5916;389;1267;1185;3658;1574;4925
241290;201301;3120;8947;2575;8100;473;1657;1520;4722;1993;6379
241300;201301;1246;3890;1191;3812;113;425;945;3026;1058;3451
241310;201301;1453;4816;1415;4747;200;677;1064;3656;1264;4333
241320;201301;765;2634;749;2601;146;548;481;1696;627;2244
241330;201301;1386;4683;1316;4585;169;684;1031;3564;1200;4248
241335;201301;2316;7637;2281;7577;217;706;1919;6441;2136;7147
241340;201301;1780;5909;1668;5682;470;1747;849;2824;1319;4571
241350;201301;1852;6167;1770;6004;192;807;1352;4466;1544;5273
241355;201301;1178;3368;1115;3270;25;107;1066;3102;1091;3209
241360;201301;1963;5765;1832;5498;187;735;1364;3923;1551;4658
241370;201301;1290;4153;1087;3730;183;770;689;2285;872;3055
241380;201301;688;2084;602;1906;90;363;326;994;416;1357
241390;201301;2711;9583;2592;9350;637;2261;1564;5952;2201;8213
241400;201301;3356;10760;3236;10579;499;1832;2355;7648;2854;9480
241410;201301;2540;7788;2378;7563;443;1567;1632;5130;2075;6697
241415;201301;1456;4789;1366;4596;170;661;946;3132;1116;3793
241420;201301;1786;6837;1666;6640;584;2510;759;3012;1343;5522
241430;201301;406;1272;390;1224;67;267;261;760;328;1027
241440;201301;6298;23322;5995;22777;996;3949;4315;16621;5311;20570
241445;201301;984;3215;946;3157;161;469;709;2508;870;2977
241450;201301;3024;9025;2909;8824;505;1717;2038;6090;2543;7807
241460;201301;3232;9974;2904;9308;286;1108;2114;6689;2400;7797
241470;201301;1289;3853;1176;3713;117;462;941;2919;1058;3381
241475;201301;1157;3924;1076;3787;109;502;790;2722;899;3224
241480;201301;3119;10450;2894;10105;954;3399;1143;4370;2097;7769
241490;201301;583;1660;490;1501;59;241;334;959;393;1200
241500;201301;723;2460;712;2445;17;60;674;2322;691;2382
250010;201301;2550;8570;2294;8135;301;1283;1601;5550;1902;6833
250020;201301;1633;4861;1304;4256;131;558;906;2875;1037;3433
250030;201301;7304;22047;6613;21050;850;2985;4863;15726;5713;18711
250040;201301;4264;15037;4003;14546;798;3078;2582;9451;3380;12529
250050;201301;3512;11549;3267;11204;549;2092;2219;7641;2768;9733
250053;201301;1240;3927;1199;3872;180;653;850;2742;1030;3395
250057;201301;770;2515;752;2490;88;329;579;1929;667;2258
250060;201301;4474;15144;4360;14955;615;2475;3318;11144;3933;13619
250070;201301;4098;13031;3874;12630;509;2097;2938;9235;3447;11332
250073;201301;747;2331;687;2214;95;343;482;1563;577;1906
250077;201301;2170;6539;1857;6037;284;1007;1122;3668;1406;4675
250080;201301;4509;13904;4368;13701;580;1988;3342;10532;3922;12520
250090;201301;2521;7916;2467;7838;166;685;2087;6469;2253;7154
250100;201301;3818;13326;3673;13066;434;1739;2825;10030;3259;11769
250110;201301;5577;17686;5352;17361;908;3257;3896;12574;4804;15831
250115;201301;597;1975;513;1792;77;340;275;897;352;1237
250120;201301;2027;6399;1781;5944;252;991;1218;3991;1470;4982
250130;201301;5444;17704;5188;17342;414;1550;4344;14638;4758;16188
250135;201301;1033;3303;957;3169;110;380;699;2374;809;2754
250140;201301;1931;6598;1791;6419;259;909;1346;4974;1605;5883
250150;201301;4993;17505;4740;17055;597;2400;3576;12883;4173;15283
250153;201301;1538;4124;1395;3919;134;449;1112;3119;1246;3568
250157;201301;1495;5494;1371;5225;342;1327;745;2927;1087;4254
250160;201301;3202;10388;3082;10202;220;838;2643;8730;2863;9568
250170;201301;1548;4674;1466;4540;289;962;952;2984;1241;3946
250180;201301;15028;49928;14710;49323;3131;11544;9419;31167;12550;42711
250190;201301;4168;12801;3979;12470;694;2403;2633;8249;3327;10652
250200;201301;2130;5956;1756;5501;147;530;1511;4690;1658;5220
250205;201301;982;3358;862;3145;109;502;585;2127;694;2629
250210;201301;1601;5414;1497;5267;197;877;1091;3732;1288;4609
250215;201301;1339;4760;1305;4696;240;981;817;2935;1057;3916
250220;201301;782;2391;671;2257;53;193;584;1965;637;2158
250230;201301;1642;4356;1355;3891;174;618;1025;2824;1199;3442
250240;201301;2539;8515;2275;8128;279;1064;1695;6150;1974;7214
250250;201301;3908;12759;3657;12409;586;2054;2690;9297;3276;11351
250260;201301;1879;5974;1685;5653;148;563;1302;4364;1450;4927
250270;201301;1166;3913;1108;3845;137;510;865;3027;1002;3537
250280;201301;3515;11129;3297;10780;668;2274;2115;7219;2783;9493
250290;201301;2048;5576;1722;5145;73;269;1480;4398;1553;4667
250300;201301;5256;16025;4973;15656;706;2736;3799;11603;4505;14339
250310;201301;1123;3747;1034;3596;166;677;745;2560;911;3237
250320;201301;7401;24529;7075;23810;1432;5373;4370;14366;5802;19739
250330;201301;2400;7929;2112;7520;322;1276;1537;5440;1859;6716
250340;201301;1074;3289;1041;3249;84;292;839;2665;923;2957
250350;201301;4438;12475;4125;12070;197;708;3603;10628;3800;11336
250355;201301;2054;6607;1891;6353;155;646;1480;4963;1635;5609
250360;201301;1977;6058;1842;5862;135;512;1416;4521;1551;5033
250370;201301;12929;37980;11468;36173;825;2618;9919;31655;10744;34273
250375;201301;1038;3426;1003;3358;85;348;812;2707;897;3055
250380;201301;1542;4530;1484;4464;86;320;1323;3951;1409;4271
250390;201301;1913;5245;1598;4710;219;728;1072;3146;1291;3874
250400;201301;55219;169898;52782;166086;14999;48440;28333;92370;43332;140810
250403;201301;1223;4708;1198;4665;240;1043;838;3231;1078;4274
250407;201301;1033;3224;947;3078;119;403;732;2389;851;2792
250410;201301;646;2147;571;2014;77;333;415;1437;492;1770
250415;201301;1737;5718;1642;5525;115;493;1261;4165;1376;4658
250420;201301;1253;4120;1208;4038;103;433;1021;3332;1124;3765
250430;201301;6361;18261;6057;17820;522;1883;5012;14426;5534;16309
250435;201301;1553;4882;1398;4575;224;844;781;2635;1005;3479
250440;201301;4141;13333;4037;13162;360;1305;3317;10868;3677;12173
250450;201301;2017;5816;1822;5556;78;274;1627;4955;1705;5229
250460;201301;5285;17655;4995;17224;953;3460;3315;11668;4268;15128
250470;201301;1522;4296;1405;4125;127;472;1097;3163;1224;3635
250480;201301;3651;11423;3307;10915;203;820;2826;9260;3029;10080
250485;201301;553;1551;466;1389;30;129;358;1013;388;1142
250490;201301;4020;13498;3923;13343;592;2246;2942;9978;3534;12224
250500;201301;1862;5828;1731;5613;355;1172;1026;3379;1381;4551
250510;201301;4891;14109;4347;13360;382;1436;3576;10867;3958;12303
250520;201301;1818;5898;1743;5768;386;1489;1086;3510;1472;4999
250523;201301;1766;5756;1691;5659;204;735;1345;4550;1549;5285
250527;201301;1355;4395;1281;4285;68;318;1125;3696;1193;4014
250530;201301;673;2118;598;2020;56;223;480;1614;536;1837
250535;201301;1177;4031;1153;3982;113;484;914;3104;1027;3588
250540;201301;2400;7345;2270;7198;107;367;2060;6555;2167;6922
250550;201301;895;3035;831;2933;74;331;624;2154;698;2485
250560;201301;1672;5648;1652;5617;150;588;1393;4728;1543;5316
250570;201301;2399;8434;2269;8188;255;1067;1756;6276;2011;7343
250580;201301;1025;3105;886;2872;131;499;584;1844;715;2343
250590;201301;1029;3215;931;3083;86;362;732;2373;818;2735
250600;201301;7455;23213;7104;22660;1219;3947;5002;16382;6221;20329
250610;201301;3215;10129;3061;9890;402;1433;2245;7270;2647;8703
250620;201301;868;2594;806;2474;144;478;546;1676;690;2154
250625;201301;1983;6912;1950;6863;99;342;1772;6293;1871;6635
250630;201301;9451;32368;9061;31615;2139;8203;5305;18376;7444;26579
250640;201301;3810;11425;3571;11139;271;1046;3072;9446;3343;10492
250650;201301;891;2726;843;2630;173;636;438;1410;611;2046
250660;201301;2141;5230;1642;4624;24;68;1578;4441;1602;4509
250670;201301;2473;8911;2377;8733;298;1287;1680;6188;1978;7475
250680;201301;4600;14131;4374;13784;354;1346;3587;11244;3941;12590
250690;201301;5880;17137;5712;16897;625;2203;4695;13588;5320;15791
250700;201301;5097;16138;4854;15752;645;2420;3604;11520;4249;13940
250710;201301;4306;14339;4025;13981;611;2284;2907;10242;3518;12526
250720;201301;2471;8339;2366;8147;253;959;1834;6392;2087;7351
250730;201301;3417;11270;3297;11081;479;1815;2434;8146;2913;9961
250740;201301;1985;6103;1763;5697;313;1127;1138;3617;1451;4744
250750;201301;94897;297317;91184;291448;18462;65036;60160;190325;78622;255361
250760;201301;2009;6475;1885;6258;311;1211;1214;3997;1525;5208
250770;201301;3657;13038;3519;12832;827;3129;2140;7973;2967;11102
250780;201301;1856;5742;1661;5379;184;746;1168;3684;1352;4430
250790;201301;2395;8000;2273;7814;578;2010;1425;4984;2003;6994
250800;201301;2629;8140;2350;7657;164;682;1812;5777;1976;6459
250810;201301;1306;4001;1146;3765;106;447;946;3043;1052;3490
250820;201301;1896;6243;1845;6163;113;419;1544;5254;1657;5673
250830;201301;5568;19491;5376;19110;891;3727;3721;13026;4612;16753
250840;201301;1019;3362;931;3184;156;608;585;2010;741;2618
250850;201301;2305;6983;2040;6549;260;1002;1318;4412;1578;5414
250855;201301;941;2933;891;2852;81;294;751;2392;832;2686
250860;201301;2756;9658;2605;9370;668;2669;1184;4293;1852;6962
250870;201301;1163;3484;1021;3243;100;395;732;2266;832;2661
250880;201301;1230;3850;1214;3826;122;441;977;3041;1099;3482
250890;201301;8474;29397;7984;28739;1646;6542;5322;19185;6968;25727
250900;201301;2986;10322;2711;9793;323;1276;1934;7073;2257;8349
250905;201301;2033;6514;1956;6406;286;1058;1498;4849;1784;5907
250910;201301;5066;15702;4763;15231;734;2421;3453;11202;4187;13623
250915;201301;1697;5207;1564;5008;135;439;1314;4257;1449;4696
250920;201301;3389;10116;3212;9870;410;1342;2418;7565;2828;8907
250930;201301;1806;6146;1745;6035;376;1495;1137;3831;1513;5326
250933;201301;1117;3912;1081;3848;198;750;711;2597;909;3347
250937;201301;851;2750;774;2590;139;553;462;1543;601;2096
250939;201301;1689;5491;1557;5283;323;1142;1031;3532;1354;4674
250940;201301;3830;11835;3570;11437;281;1028;2913;9366;3194;10394
250950;201301;1229;4057;1156;3971;81;274;976;3418;1057;3692
250960;201301;1329;4262;1183;4067;84;327;1003;3469;1087;3796
250970;201301;8374;23903;7700;23041;958;2878;5942;18107;6900;20985
250980;201301;2578;8168;2423;7918;354;1423;1653;5213;2007;6636
250990;201301;2055;7531;1965;7351;343;1452;1357;5035;1700;6487
251000;201301;2495;7252;2072;6663;142;552;1644;5257;1786;5809
251010;201301;2711;8117;2497;7826;184;686;2035;6394;2219;7080
251020;201301;1640;5364;1544;5249;182;678;1247;4277;1429;4955
251030;201301;1282;3718;1174;3535;146;526;750;2242;896;2768
251040;201301;1925;6380;1751;6108;230;1047;1275;4301;1505;5348
251050;201301;1110;3398;978;3154;195;692;537;1794;732;2486
251060;201301;949;2532;788;2330;134;480;540;1525;674;2005
251065;201301;548;1716;480;1612;78;296;277;907;355;1203
251070;201301;552;1649;528;1614;49;198;417;1211;466;1409
251080;201301;20558;58682;19639;57217;4956;15286;11736;34579;16692;49865
251090;201301;2970;9630;2706;9155;338;1319;1927;6445;2265;7764
251100;201301;920;3147;817;2954;125;522;496;1747;621;2269
251110;201301;2037;6097;1894;5896;234;832;1392;4350;1626;5182
251120;201301;5865;20086;5718;19834;806;3335;4483;15188;5289;18523
251130;201301;3724;9963;3391;9575;69;243;3230;9078;3299;9321
251140;201301;4277;13526;4052;13171;299;1198;3209;10384;3508;11582
251150;201301;2819;9302;2611;9019;319;1293;1981;6883;2300;8176
251160;201301;1835;6168;1765;6075;107;413;1543;5335;1650;5748
251170;201301;1418;4624;1388;4592;87;295;1246;4146;1333;4441
251180;201301;2868;8814;2652;8548;556;1867;1711;5667;2267;7534
251190;201301;3997;12333;3897;12198;304;1103;3383;10545;3687;11648
251200;201301;4074;12709;3889;12462;309;1112;3266;10481;3575;11593
251203;201301;1306;4281;1188;4029;132;556;711;2510;843;3066
251207;201301;1193;3900;1048;3609;106;456;733;2480;839;2936
251210;201301;7312;22581;6804;21966;901;2900;5393;17727;6294;20627
251220;201301;1240;3533;1119;3344;187;616;694;2129;881;2745
251230;201301;5016;15837;4459;15168;482;1814;3712;12593;4194;14407
251240;201301;3012;10219;2943;10103;343;1443;2282;7674;2625;9117
251250;201301;9467;30103;8959;29267;1697;6225;6107;19584;7804;25809
251260;201301;516;1656;470;1593;43;164;356;1215;399;1379
251270;201301;3901;12409;3694;12149;162;645;3388;11121;3550;11766
251272;201301;1283;4152;1197;4026;128;470;924;3152;1052;3622
251274;201301;900;3063;867;2996;156;663;447;1596;603;2259
251275;201301;1334;3918;1264;3809;162;599;945;2780;1107;3379
251276;201301;1324;4224;1270;4125;247;854;733;2528;980;3382
251278;201301;584;1930;516;1767;89;348;286;1028;375;1376
251280;201301;2194;7280;2128;7158;328;1211;1511;5108;1839;6319
251290;201301;5892;17346;5605;16974;868;3154;4022;11768;4890;14922
251300;201301;739;2619;698;2556;85;395;499;1767;584;2162
251310;201301;3095;9493;2864;9151;255;942;2290;7268;2545;8210
251315;201301;1507;5727;1479;5666;333;1334;930;3648;1263;4982
251320;201301;2067;5993;1793;5571;142;510;1394;4395;1536;4905
251330;201301;1990;5319;1666;4894;153;646;1351;3761;1504;4407
251335;201301;956;3367;937;3332;104;436;758;2654;862;3090
251340;201301;3912;11146;3366;10340;414;1577;2376;7139;2790;8716
251350;201301;1612;5120;1464;4902;277;1010;934;3161;1211;4171
251360;201301;1798;6159;1741;6083;132;528;1470;5166;1602;5694
251365;201301;898;2694;733;2344;92;381;465;1428;557;1809
251370;201301;20436;73549;20197;73082;4452;17609;13596;48679;18048;66288
251380;201301;1233;4067;1136;3901;158;622;795;2686;953;3308
251385;201301;828;2414;767;2312;86;319;536;1581;622;1900
251390;201301;5525;20136;5292;19798;1029;4206;3612;13410;4641;17616
251392;201301;970;3023;903;2902;173;603;534;1752;707;2355
251394;201301;607;1918;522;1749;51;215;365;1207;416;1422
251396;201301;866;2525;819;2454;41;141;711;2122;752;2263
251398;201301;1112;3296;931;2957;116;446;630;1972;746;2418
251400;201301;1321;3954;1245;3852;185;728;874;2619;1059;3347
251410;201301;1530;4250;1402;4042;197;633;922;2744;1119;3377
251420;201301;2178;6556;1896;6243;175;705;1540;4999;1715;5704
251430;201301;1647;6079;1506;5856;139;646;1211;4685;1350;5331
251440;201301;1446;4559;1272;4243;191;720;899;2973;1090;3693
251445;201301;1435;4777;1373;4682;159;647;1091;3656;1250;4303
251450;201301;4628;14920;4192;14376;169;680;3808;13103;3977;13783
251455;201301;1181;3754;1042;3546;89;380;814;2732;903;3112
251460;201301;863;2720;843;2682;165;537;609;1965;774;2502
251465;201301;513;1660;472;1577;61;256;313;1016;374;1272
251470;201301;1192;3588;1010;3262;167;635;609;1960;776;2595
251480;201301;1088;3082;1007;2964;78;296;804;2324;882;2620
251490;201301;2077;6342;1835;6025;355;1336;1148;3692;1503;5028
251500;201301;1594;5682;1546;5599;249;1053;1119;3977;1368;5030
251510;201301;2362;8353;2286;8188;544;2114;1349;4875;1893;6989
251520;201301;1074;3048;997;2932;141;466;637;1900;778;2366
251530;201301;10418;34038;10246;33775;1169;4396;8402;27421;9571;31817
251540;201301;2672;9245;2541;8949;317;1316;1830;6435;2147;7751
251550;201301;3888;10032;3346;9350;224;807;2791;7646;3015;8453
251560;201301;919;2857;849;2752;174;675;519;1611;693;2286
251570;201301;1008;3109;926;2966;139;533;589;1925;728;2458
251580;201301;2129;6022;1992;5838;172;503;1674;4950;1846;5453
251590;201301;1708;5774;1677;5738;120;436;1466;5064;1586;5500
251593;201301;959;3170;915;3095;132;510;616;2024;748;2534
251597;201301;1926;6107;1870;6017;250;944;1423;4501;1673;5445
251600;201301;6946;21744;6663;21283;1149;3732;4589;15167;5738;18899
251610;201301;3459;10818;3210;10489;382;1367;2414;7965;2796;9332
251615;201301;1192;3621;1060;3385;114;355;750;2542;864;2897
251620;201301;15978;48455;14775;46788;2263;7685;10754;34244;13017;41929
251630;201301;5113;13442;4511;12712;428;1315;3585;10183;4013;11498
251640;201301;2624;7906;2154;7049;289;1107;1441;4674;1730;5781
251650;201301;4209;12350;3799;11823;387;1385;3022;9503;3409;10888
251660;201301;3496;11981;3223;11553;289;1369;2588;9044;2877;10413
251670;201301;3487;10960;3150;10428;289;1100;2447;8064;2736;9164
251675;201301;725;2534;696;2484;138;581;437;1511;575;2092
251680;201301;2794;7981;2285;7215;163;700;1847;5701;2010;6401
251690;201301;3225;10805;3040;10477;468;1738;2037;7086;2505;8824
251700;201301;2041;7071;1968;6966;266;1017;1514;5371;1780;6388
251710;201301;830;2385;669;2079;101;400;378;1080;479;1480
251720;201301;1316;4187;1249;4087;124;490;955;3104;1079;3594
251740;201301;759;2150;625;1903;125;412;336;1066;461;1478
260005;201301;23434;59601;21108;56601;4202;11563;13835;37557;18037;49120
260010;201301;9125;25861;7604;23980;675;2433;6195;19457;6870;21890
260020;201301;5448;17104;4935;16322;669;2023;3549;12459;4218;14482
260030;201301;5279;16537;4955;16118;507;1799;4013;13077;4520;14876
260040;201301;8983;23817;8320;23097;485;1135;7449;21196;7934;22331
260050;201301;10133;34338;9671;33807;672;2557;8463;29752;9135;32309
260060;201301;3967;11325;3744;11003;327;1040;3076;9124;3403;10164
260070;201301;8825;28031;8546;27638;2335;8076;5074;16548;7409;24624
260080;201301;5024;15563;4551;14832;583;2257;3170;10211;3753;12468
260090;201301;5046;13969;4818;13668;727;1893;3778;11045;4505;12938
260100;201301;3303;9206;3069;8889;298;1092;2401;6982;2699;8074
260105;201301;4024;12934;3943;12798;686;2421;2801;9065;3487;11486
260110;201301;20322;63693;19110;62210;1664;5431;16187;53340;17851;58771
260120;201301;10770;34665;10545;34257;2879;9513;5847;19710;8726;29223
260130;201301;2934;8769;2817;8581;399;1178;2054;6471;2453;7649
260140;201301;11046;32591;10248;31488;1394;4749;7731;23904;9125;28653
260150;201301;2659;8889;2426;8510;178;745;1926;6869;2104;7614
260160;201301;5763;17928;5337;17441;536;1818;4385;14655;4921;16473
260170;201301;16869;48367;16251;47533;1475;4102;13458;40072;14933;44174
260180;201301;3315;10800;3081;10426;227;942;2574;8656;2801;9598
260190;201301;15234;38358;14599;37534;1289;3542;12125;31204;13414;34746
260200;201301;10525;32786;9369;31013;1245;4342;6614;22549;7859;26891
260210;201301;10917;35164;10264;34243;829;3168;8488;28557;9317;31725
260220;201301;8842;28826;8696;28599;749;3069;7458;24127;8207;27196
260230;201301;9390;28539;9089;28130;737;2426;7568;23707;8305;26133
260240;201301;2757;9114;2500;8710;388;1450;1674;5864;2062;7314
260250;201301;2699;7540;2501;7291;174;494;2128;6293;2302;6787
260260;201301;10877;33168;10713;32955;942;3132;8974;28258;9916;31390
260270;201301;3437;11035;3282;10815;437;1734;2530;8188;2967;9922
260280;201301;11733;42020;10971;40800;931;3755;8951;33798;9882;37553
260290;201301;32531;101285;31704;99969;5973;21394;21916;67675;27889;89069
260300;201301;7999;25647;7293;24657;846;3106;5604;19227;6450;22333
260310;201301;4990;15552;4722;15129;1356;4107;2521;8645;3877;12752
260320;201301;6251;22605;5894;22098;593;2229;4681;18006;5274;20235
260330;201301;3040;9862;2802;9441;321;1263;1862;6546;2183;7809
260340;201301;1779;5536;1708;5447;106;400;1511;4786;1617;5186
260345;201301;24568;84381;23849;82974;7810;29346;11120;37822;18930;67168
260350;201301;4089;12693;3940;12464;657;2216;2657;8525;3314;10741
260360;201301;2266;7469;2211;7378;607;2115;1262;4368;1869;6483
260370;201301;5887;18766;5532;18143;866;2854;3863;13038;4729;15892
260380;201301;4799;16431;4535;16089;419;1321;3843;13968;4262;15289
260390;201301;4658;15103;4108;14259;513;2005;3060;10523;3573;12528
260392;201301;2777;10511;2672;10348;215;854;2282;8963;2497;9817
260400;201301;12908;39919;12564;39393;2180;7838;9015;27656;11195;35494
260410;201301;58579;179544;56486;176152;17085;53364;30350;98264;47435;151628
260415;201301;3886;13303;3537;12659;564;2356;2293;8211;2857;10567
260420;201301;10500;27390;9707;26538;1126;3326;7526;20760;8652;24086
260430;201301;2623;9028;2435;8740;279;1196;1888;6672;2167;7868
260440;201301;3283;10491;3097;10137;531;1966;1970;6396;2501;8362
260450;201301;4702;15408;4484;15027;557;1991;3361;11398;3918;13389
260460;201301;5677;18389;5469;18093;773;2883;4118;13478;4891;16361
260470;201301;4870;14760;4622;14419;427;1482;3706;11737;4133;13219
260480;201301;3619;11022;3394;10703;648;2178;2331;7346;2979;9524
260490;201301;5966;16041;5317;15019;772;2567;3506;9921;4278;12488
260500;201301;6500;18425;6136;17909;619;1987;4767;14154;5386;16141
260510;201301;9635;27913;8928;26916;1083;3522;6575;20604;7658;24126
260515;201301;4712;15244;3995;13785;599;2240;2390;8558;2989;10798
260520;201301;14745;42084;14540;41815;2191;5964;11401;33398;13592;39362
260530;201301;9884;30010;8879;28705;548;1698;7771;25569;8319;27267
260540;201301;5436;15146;5271;14953;676;1673;4179;12284;4855;13957
260545;201301;40;156;28;115;4;19;6;23;10;42
260550;201301;2669;9349;2446;8970;728;2935;1202;4361;1930;7296
260560;201301;6440;17093;5883;16315;348;955;5180;14431;5528;15386
260570;201301;5742;21625;5526;21212;1106;4606;3672;14237;4778;18843
260580;201301;3784;10784;3641;10569;294;1015;3078;8749;3372;9764
260590;201301;5878;15895;5744;15727;510;1293;4871;13677;5381;14970
260600;201301;22241;74888;21545;73689;6132;21228;11461;41110;17593;62338
260610;201301;6923;21073;6647;20706;1328;4263;4619;14646;5947;18909
260620;201301;16543;53426;16065;52634;2895;11004;11194;35615;14089;46619
260630;201301;2182;6877;1924;6469;256;1028;1398;4648;1654;5676
260640;201301;16487;46877;15906;46020;1739;5281;12690;36902;14429;42183
260650;201301;5521;18201;5361;17943;826;2726;3604;12999;4430;15725
260660;201301;7568;23458;6904;22563;634;2222;5595;18562;6229;20784
260670;201301;2238;6784;1948;6389;316;1163;1264;4198;1580;5361
260680;201301;22443;61691;21565;60394;4385;13001;13941;39049;18326;52050
260690;201301;3313;9713;2936;9120;350;1259;2182;6721;2532;7980
260700;201301;4798;15695;4747;15641;117;297;4536;15163;4653;15460
260710;201301;1276;4098;1165;3934;159;638;854;2831;1013;3469
260720;201301;17187;57346;16392;55867;4805;16912;8685;30258;13490;47170
260730;201301;7232;24566;6576;23623;903;3370;4927;18002;5830;21372
260740;201301;1316;4114;1161;3831;214;813;682;2251;896;3064
260750;201301;6211;21696;6121;21549;487;1796;5263;18735;5750;20531
260760;201301;4300;12894;4104;12624;535;1822;3068;9396;3603;11218
260765;201301;7352;28541;7145;28213;1832;7527;4233;17248;6065;24775
260770;201301;4145;11276;3825;10847;243;916;3103;8623;3346;9539
260775;201301;5185;15693;4989;15395;580;2118;3791;11511;4371;13629
260780;201301;3799;13297;3688;13105;786;3126;2329;8229;3115;11355
260790;201301;113816;302479;110373;297587;27063;76357;67371;182879;94434;259236
260795;201301;2842;9867;2727;9693;397;1514;1996;7258;2393;8772
260800;201301;4429;12780;4176;12422;270;1061;3539;10299;3809;11360
260805;201301;3889;12075;3612;11640;607;2061;2461;8050;3068;10111
260810;201301;7333;22140;7154;21887;529;1946;6180;18710;6709;20656
260820;201301;4497;13800;4335;13559;1219;3917;2527;8026;3746;11943
260825;201301;2960;9836;2833;9650;268;892;2362;8172;2630;9064
260830;201301;3523;11915;3322;11578;874;2898;1976;7254;2850;10152
260840;201301;4006;12188;3791;11866;232;885;3330;10386;3562;11271
260845;201301;3940;12184;3683;11665;600;2079;2522;8004;3122;10083
260850;201301;4763;17335;4409;16559;1215;4964;2157;8158;3372;13122
260860;201301;2826;9810;2665;9557;352;1276;2003;7333;2355;8609
260870;201301;4126;11944;3837;11593;512;1423;2960;9262;3472;10685
260875;201301;7074;19083;6605;18365;715;1941;4921;14192;5636;16133
260880;201301;7464;25806;7164;25347;1082;3851;5385;19401;6467;23252
260890;201301;14459;42705;13970;41981;1649;5645;10594;31832;12243;37477
260900;201301;5844;18613;5136;17480;1054;3739;3123;10864;4177;14603
260910;201301;2796;9053;2594;8770;294;1112;2028;6842;2322;7954
260915;201301;4251;14755;4166;14639;121;378;3885;13894;4006;14272
260920;201301;3226;10503;3097;10309;626;2289;2014;6813;2640;9102
260930;201301;3972;13079;3624;12584;501;1800;2640;9289;3141;11089
260940;201301;13002;39630;12058;37937;2571;9442;6478;20006;9049;29448
260950;201301;6108;20488;5907;20104;1108;4646;3901;12489;5009;17135
260960;201301;64925;186123;62116;181831;13405;41908;37982;112192;51387;154100
260970;201301;5193;17671;4888;17179;673;2713;3564;12480;4237;15193
260980;201301;3853;12661;3716;12473;271;985;3099;10611;3370;11596
260990;201301;16471;55239;15366;53664;1796;5858;11710;43023;13506;48881
261000;201301;13165;41378;12027;39490;2951;10522;6763;22380;9714;32902
261010;201301;2612;7582;2482;7407;231;543;2089;6510;2320;7053
261020;201301;5873;18604;5604;18183;363;1615;4724;14924;5087;16539
261030;201301;3013;10911;2943;10807;371;1477;2299;8432;2670;9909
261040;201301;5033;17119;4425;16166;687;2781;3044;11106;3731;13887
261050;201301;8177;23893;7817;23410;420;1307;6909;20759;7329;22066
261060;201301;10083;33502;9865;33150;2123;7738;6571;21757;8694;29495
261070;201301;44703;122218;41445;117792;9988;29943;24299;70114;34287;100057
261080;201301;5399;17604;5170;17232;393;1296;4379;14855;4772;16151
261090;201301;15436;45444;14686;44440;1379;4524;12136;36871;13515;41395
261100;201301;6889;22946;6570;22497;491;2076;5505;18716;5996;20792
261110;201301;62273;184641;58154;178989;14020;43587;34275;111870;48295;155457
261120;201301;3113;9448;3010;9304;90;296;2792;8662;2882;8958
261130;201301;6534;17999;6323;17777;258;744;5838;16431;6096;17175
261140;201301;3079;9052;2954;8880;587;1970;1952;5815;2539;7785
261150;201301;5359;17005;4900;16384;500;1931;3885;13054;4385;14985
261153;201301;1918;5671;1662;5325;108;418;1418;4577;1526;4995
261160;201301;217562;582982;209836;573014;41272;114162;138506;389985;179778;504147
261170;201301;5710;16745;5385;16261;663;2135;4281;12963;4944;15098
261180;201301;8810;27680;8723;27578;957;2902;7333;23687;8290;26589
261190;201301;5222;17051;5020;16776;856;3737;3548;11243;4404;14980
261200;201301;3769;10248;3669;10121;499;1338;2793;7882;3292;9220
261210;201301;1821;5268;1751;5172;132;384;1506;4527;1638;4911
261220;201301;11790;40455;10740;38121;2196;8435;6043;21505;8239;29940
261230;201301;4063;12677;3826;12407;186;592;3473;11412;3659;12004
261240;201301;4731;14372;4524;13980;792;2438;3198;10049;3990;12487
261245;201301;3745;12392;3301;11648;334;1408;2405;8628;2739;10036
261247;201301;3360;11014;3031;10390;479;1685;2032;7095;2511;8780
261250;201301;18170;50600;17863;50226;966;2829;16287;45869;17253;48698
261255;201301;4265;13629;3878;12998;442;1666;2858;9724;3300;11390
261260;201301;11349;34793;10581;33904;680;2067;9329;30364;10009;32431
261270;201301;3559;10937;3389;10659;434;1406;2523;8073;2957;9479
261280;201301;2663;8571;2438;8227;283;1101;1805;6065;2088;7166
261290;201301;2705;8218;2466;7911;146;485;2117;6937;2263;7422
261300;201301;9691;34729;9028;33518;1462;5866;6399;24025;7861;29891
261310;201301;8147;25673;7881;25228;1484;4853;5373;17473;6857;22326
261320;201301;5496;17845;5283;17447;790;2536;3755;12814;4545;15350
261330;201301;5514;16739;5418;16614;375;1297;4685;14390;5060;15687
261340;201301;4487;15025;4302;14736;775;2995;2779;9563;3554;12558
261350;201301;7658;26864;7320;26261;727;3106;5754;20456;6481;23562
261360;201301;8784;24134;8156;23240;1273;3925;5530;15988;6803;19913
261370;201301;19920;61372;19129;60235;2752;9439;14343;45268;17095;54707
261380;201301;4007;14184;3774;13811;647;2401;2604;9820;3251;12221
261390;201301;16066;51774;14968;49864;2683;9904;9541;31572;12224;41476
261400;201301;4642;17100;4314;16477;721;3062;2890;11128;3611;14190
261410;201301;7908;25000;7675;24647;751;2469;6174;20279;6925;22748
261420;201301;7413;25802;7238;25544;1886;7256;4274;15335;6160;22591
261430;201301;3424;10907;2931;10261;436;1575;2086;7478;2522;9053
261440;201301;1611;5008;1544;4915;134;508;1292;4092;1426;4600
261450;201301;12957;40910;12733;40615;1218;4013;10919;35011;12137;39024
261460;201301;8313;24409;7803;23690;856;2504;5702;18676;6558;21180
261470;201301;3797;10705;3497;10347;262;928;2972;8705;3234;9633
261480;201301;3210;12238;3054;11956;357;1623;2391;9198;2748;10821
261485;201301;4693;15334;4499;15003;946;3430;2770;9297;3716;12727
261500;201301;5489;15871;5020;15247;808;2256;3755;11918;4563;14174
261510;201301;1997;6832;1940;6758;102;291;1733;6177;1835;6468
261520;201301;2474;8430;2283;8154;252;1005;1702;6110;1954;7115
261530;201301;12163;40468;10989;38191;2534;9819;5520;19050;8054;28869
261540;201301;6705;22224;6597;22045;1600;4966;4491;15664;6091;20630
261550;201301;3070;10221;2984;10088;573;2391;2128;6827;2701;9218
261560;201301;5935;20598;5594;20176;1034;3168;4186;16035;5220;19203
261570;201301;3522;11437;3298;11075;480;1684;2372;8112;2852;9796
261580;201301;5556;18669;5054;17826;456;1804;4025;14460;4481;16264
261590;201301;2736;7972;2430;7534;246;842;1798;5656;2044;6498
261600;201301;4932;14424;4275;13446;565;1889;3085;9846;3650;11735
261610;201301;2108;6781;1920;6524;128;573;1622;5384;1750;5957
261618;201301;2462;7324;2356;7173;259;943;1844;5483;2103;6426
261620;201301;4366;13776;4171;13469;504;1758;3008;9911;3512;11669
261630;201301;7855;24055;7194;22914;1574;5777;4103;12760;5677;18537
261640;201301;32230;85784;30373;83697;1710;4939;26751;74814;28461;79753
261650;201301;3519;12254;3442;12150;439;1735;2761;9767;3200;11502
270010;201301;4432;17327;4112;16638;512;2423;2956;11945;3468;14368
270020;201301;3687;11831;3487;11498;563;2199;2498;8017;3061;10216
270030;201301;41297;130969;40014;129115;10807;35536;23873;79279;34680;114815
270040;201301;10251;32650;10043;32433;701;1812;9063;29947;9764;31759
270050;201301;3754;11404;3558;11147;410;1599;2697;8254;3107;9853
270060;201301;1470;5278;1421;5202;374;1474;839;3098;1213;4572
270070;201301;3876;12487;3689;12212;142;640;3322;10893;3464;11533
270080;201301;1258;4149;1150;4005;283;1092;683;2351;966;3443
270090;201301;1937;6371;1907;6333;61;230;1782;5932;1843;6162
270100;201301;6156;20640;5956;20378;1250;4602;4147;14183;5397;18785
270110;201301;3309;9961;3083;9683;678;2227;1878;6336;2556;8563
270120;201301;2968;8894;2704;8519;171;641;2280;7204;2451;7845
270130;201301;4897;16036;4699;15802;608;2076;3691;12627;4299;14703
270135;201301;1667;5038;1592;4949;88;210;1444;4596;1532;4806
270140;201301;8379;24071;7723;23236;1106;4476;5872;16734;6978;21210
270150;201301;2448;8936;2386;8848;294;1255;1913;7015;2207;8270
270160;201301;4702;16962;4439;16581;347;1204;3801;14450;4148;15654
270170;201301;3969;13587;3677;13128;833;3416;2090;7386;2923;10802
270180;201301;2067;7370;1871;7120;226;978;1456;5573;1682;6551
270190;201301;1817;6235;1743;6108;203;761;1331;4731;1534;5492
270200;201301;2573;9017;2489;8883;246;1141;2026;7041;2272;8182
270210;201301;3803;14089;3723;13978;555;2206;2896;11014;3451;13220
270220;201301;1649;5357;1565;5186;323;1257;842;2846;1165;4103
270230;201301;10263;35719;9527;34606;1376;5663;7064;25525;8440;31188
270235;201301;6372;21569;6100;21119;367;1686;5248;18026;5615;19712
270240;201301;9474;29198;8649;28083;1599;5479;5763;18816;7362;24295
270250;201301;3302;9078;3080;8835;147;440;2799;8044;2946;8484
270255;201301;5010;15934;4252;14622;472;2033;3046;10336;3518;12369
270260;201301;5997;20186;5844;19906;984;3848;4052;13872;5036;17720
270270;201301;1200;3641;1137;3545;189;646;821;2540;1010;3186
270280;201301;3549;11149;3400;10930;580;2116;2420;7754;3000;9870
270290;201301;8210;29930;7916;29419;751;3084;6465;24078;7216;27162
270300;201301;3008;10930;2874;10767;189;861;2540;9495;2729;10356
270310;201301;6784;22262;6305;21455;487;2168;5070;16906;5557;19074
270320;201301;6067;20821;5890;20490;1657;6373;2859;10171;4516;16544
270330;201301;4526;15750;4327;15481;390;1451;3586;13043;3976;14494
270340;201301;1687;5474;1555;5317;244;877;1143;3991;1387;4868
270350;201301;1995;5994;1883;5841;315;1047;1246;4070;1561;5117
270360;201301;1906;6328;1891;6310;137;509;1681;5632;1818;6141
270370;201301;1681;5697;1556;5469;208;833;1081;3880;1289;4713
270375;201301;2902;9409;2784;9225;532;2166;1832;5743;2364;7909
270380;201301;5962;18574;5772;18322;638;2156;4488;14486;5126;16642
270390;201301;1346;4032;1274;3943;174;650;943;2842;1117;3492
270400;201301;5918;18918;5589;18480;476;1791;4613;15268;5089;17059
270410;201301;4570;14855;4410;14546;620;2280;3287;10819;3907;13099
270420;201301;5022;17257;4903;17085;311;1397;4303;14841;4614;16238
270430;201301;135637;405367;131649;399823;35446;109446;77874;243149;113320;352595
270440;201301;4776;15456;4546;15087;392;1503;3707;12339;4099;13842
270450;201301;6164;20489;6050;20341;749;2858;4757;16056;5506;18914
270460;201301;3262;9749;2971;9326;294;1187;2314;7091;2608;8278
270470;201301;10261;34315;9906;33676;1336;4313;7441;26343;8777;30656
270480;201301;3007;10048;2854;9794;377;1575;2029;6794;2406;8369
270490;201301;944;3203;905;3150;118;453;724;2505;842;2958
270500;201301;5454;19900;5312;19698;392;1459;4574;17370;4966;18829
270510;201301;5785;18864;5357;18265;1075;4609;3746;12101;4821;16710
270520;201301;3615;12525;3441;12216;988;3752;1796;6511;2784;10263
270530;201301;1522;4658;1354;4437;251;779;908;3135;1159;3914
270540;201301;1907;7020;1771;6801;219;1014;1368;5182;1587;6196
270550;201301;6686;22053;6047;21156;1030;3737;4135;14961;5165;18698
270560;201301;2783;9495;2720;9418;383;1519;2139;7357;2522;8876
270570;201301;4246;14379;3964;13933;578;2434;2682;9369;3260;11803
270580;201301;1954;6897;1898;6800;290;1085;1446;5237;1736;6322
270590;201301;1248;4612;1180;4485;128;608;931;3504;1059;4112
270600;201301;2792;9793;2587;9508;217;1011;2128;7701;2345;8712
270610;201301;3100;10232;2954;10012;376;1367;2277;7701;2653;9068
270620;201301;1392;4913;1269;4728;166;799;943;3403;1109;4202
270630;201301;17610;50472;17048;49740;1934;5376;14000;41599;15934;46975
270640;201301;5607;18188;5171;17692;400;1697;4413;14948;4813;16645
270642;201301;2404;8502;2278;8306;376;1487;1566;5785;1942;7272
270644;201301;2207;6972;2091;6842;398;1236;1554;5260;1952;6496
270650;201301;3827;12876;3723;12725;962;3729;2169;7362;3131;11091
270660;201301;2451;6747;2017;6061;225;843;1419;4180;1644;5023
270670;201301;12710;39930;11990;38842;1554;5771;9146;29380;10700;35151
270680;201301;4020;12645;3922;12527;255;745;3503;11329;3758;12074
270690;201301;7946;24223;7674;23881;2402;7005;4235;14380;6637;21385
270700;201301;794;2618;763;2565;162;626;457;1525;619;2151
270710;201301;5348;18720;5191;18519;517;1802;4362;15847;4879;17649
270720;201301;3164;11435;2979;11113;306;1397;2366;8756;2672;10153
270730;201301;6310;20561;6006;20157;1324;4849;3953;13132;5277;17981
270740;201301;2329;7128;2211;6951;389;1385;1449;4519;1838;5904
270750;201301;4650;15667;4427;15352;447;1836;3524;12134;3971;13970
270760;201301;3189;10198;3028;9969;381;1309;2341;7770;2722;9079
270770;201301;16414;46248;14366;43778;2791;9261;9408;29010;12199;38271
270780;201301;1907;6184;1791;6000;157;542;1453;4938;1610;5480
270790;201301;1548;5069;1428;4864;383;1382;704;2470;1087;3852
270800;201301;10436;33203;9962;32566;1015;3748;8020;26160;9035;29908
270810;201301;3113;10306;2750;9653;447;1757;1740;6148;2187;7905
270820;201301;1855;6533;1727;6301;245;1066;1243;4476;1488;5542
270830;201301;4932;16813;4630;16393;1510;5979;2431;8527;3941;14506
270840;201301;6965;25588;6471;24949;573;2586;5306;20459;5879;23045
270850;201301;7297;25232;7181;25077;1622;6817;5016;16725;6638;23542
270860;201301;10182;33571;9945;33170;1991;7506;6859;22389;8850;29895
270870;201301;2108;6362;1857;5917;281;1003;1137;3646;1418;4649
270880;201301;7841;26437;7540;25992;671;2718;6317;21597;6988;24315
270890;201301;2473;7939;2342;7735;405;1578;1609;5157;2014;6735
270895;201301;2934;11318;2808;11154;294;1110;2356;9579;2650;10689
270900;201301;1788;5201;1527;4816;128;473;1168;3615;1296;4088
270910;201301;3179;11769;3145;11705;339;1531;2631;9593;2970;11124
270915;201301;9474;33718;8827;32564;2101;8625;4726;17452;6827;26077
270920;201301;5560;19560;5233;19077;475;2155;4280;15519;4755;17674
270930;201301;15982;45789;13531;42614;2918;9919;7886;25108;10804;35027
270940;201301;5678;20029;5539;19868;784;2840;4375;16001;5159;18841
280010;201301;692;2100;621;1990;77;307;399;1252;476;1559
280020;201301;4637;14779;4280;14142;856;2989;2721;9048;3577;12037
280030;201301;64306;179782;59331;172616;15662;47754;31638;94253;47300;142007
280040;201301;2982;9868;2753;9567;382;1337;2042;7374;2424;8711
280050;201301;3898;12958;3696;12674;1052;3631;2165;7735;3217;11366
280060;201301;4008;13921;3908;13761;922;3542;2357;8344;3279;11886
280067;201301;7153;21406;6184;20072;657;2511;4743;15269;5400;17780
280070;201301;1780;6512;1722;6426;304;1193;1199;4548;1503;5741
280100;201301;3754;12455;3499;12011;803;2801;2019;7094;2822;9895
280110;201301;1265;4137;1192;4014;133;552;903;3004;1036;3556
280120;201301;7182;24050;6767;23355;1486;4827;4424;16258;5910;21085
280130;201301;7445;22403;7154;21995;1107;4011;5133;15472;6240;19483
280140;201301;5237;15451;4843;14947;251;804;4278;13363;4529;14167
280150;201301;3150;10275;2921;9812;507;2062;1800;5739;2307;7801
280160;201301;1461;4347;1344;4156;202;697;942;2918;1144;3615
280170;201301;4221;13586;3902;13203;575;1968;2900;10149;3475;12117
280190;201301;1077;3275;988;3131;128;500;697;2150;825;2650
280200;201301;922;3182;897;3152;190;803;604;2032;794;2835
280210;201301;10980;38135;10621;37521;2540;9551;6491;23239;9031;32790
280220;201301;1452;4577;1408;4519;103;382;1237;3963;1340;4345
280230;201301;3675;11120;3369;10618;739;2470;1987;6417;2726;8887
280240;201301;3364;10618;3169;10321;260;880;2565;8456;2825;9336
280250;201301;699;1961;657;1895;45;154;543;1522;588;1676
280260;201301;1837;5309;1692;5124;140;446;1423;4320;1563;4766
280270;201301;2089;6829;1854;6417;136;583;1461;4952;1597;5535
280280;201301;3901;13424;3734;13148;808;2487;2269;8814;3077;11301
280290;201301;14584;50154;13997;49188;2487;9604;10195;35631;12682;45235
280300;201301;9418;29757;8898;29174;647;2348;7801;25584;8448;27932
280310;201301;1362;4024;1239;3838;120;471;911;2746;1031;3217
280320;201301;6923;24993;6666;24531;1211;4990;4426;16310;5637;21300
280330;201301;3990;12519;3813;12292;569;1946;2867;9364;3436;11310
280340;201301;3321;11071;3245;10967;282;1108;2701;9138;2983;10246
280350;201301;19734;61997;19025;60877;3025;10141;13476;43964;16501;54105
280360;201301;5572;18212;5305;17801;1183;4491;3293;10893;4476;15384
280370;201301;1813;5472;1701;5286;224;820;1253;3780;1477;4600
280380;201301;794;2880;744;2794;162;705;482;1761;644;2466
280390;201301;3061;9492;2829;9093;618;1808;1838;6110;2456;7918
280400;201301;3992;12174;3690;11779;697;2260;2534;8302;3231;10562
280410;201301;2243;7645;2092;7399;363;1461;1281;4445;1644;5906
280420;201301;3692;11557;3512;11297;265;861;3009;9811;3274;10672
280430;201301;1792;5538;1709;5428;278;976;1239;3899;1517;4875
280440;201301;4705;14802;4476;14501;396;1456;3789;12213;4185;13669
280445;201301;2410;7095;2271;6864;131;526;1885;5591;2016;6117
280450;201301;8239;23741;7724;23148;786;2062;6469;20021;7255;22083
280460;201301;6174;18434;5718;17815;1323;4140;3653;11762;4976;15902
280470;201301;1615;5224;1495;5038;190;738;1111;3699;1301;4437
280480;201301;28693;91302;27967;90285;4448;17411;20000;62441;24448;79852
280490;201301;3592;11410;3403;11079;359;1434;2695;8663;3054;10097
280500;201301;761;2215;747;2199;48;180;633;1822;681;2002
280510;201301;2561;7853;2220;7386;312;1179;1634;5472;1946;6651
280520;201301;1530;4798;1410;4633;223;806;938;3164;1161;3970
280530;201301;1899;6346;1834;6253;220;849;1449;4952;1669;5801
280540;201301;8361;24257;8013;23777;395;1434;7153;21074;7548;22508
280550;201301;6490;19044;6091;18395;585;2156;4613;13796;5198;15952
280560;201301;7381;22986;7055;22423;590;2108;5696;18068;6286;20176
280570;201301;6427;19091;6055;18618;828;3024;4588;13936;5416;16960
280580;201301;5434;17078;4881;16200;576;2079;3673;12350;4249;14429
280590;201301;2199;7031;2054;6863;255;1042;1585;5267;1840;6309
280600;201301;3869;12329;3655;11929;418;1660;2614;8340;3032;10000
280610;201301;2189;6783;2096;6640;351;1272;1362;4281;1713;5553
280620;201301;4433;14599;4235;14203;839;3023;2708;9107;3547;12130
280630;201301;3626;12675;3538;12547;493;1695;2728;10021;3221;11716
280640;201301;1954;6019;1856;5897;108;365;1648;5250;1756;5615
280650;201301;1020;3368;956;3251;202;730;584;2012;786;2742
280660;201301;2472;7649;2379;7493;176;717;2048;6309;2224;7026
280670;201301;14639;40207;14071;39525;1336;4012;11623;32720;12959;36732
280680;201301;2476;7312;2206;6975;177;623;1843;5845;2020;6468
280690;201301;868;2707;778;2561;130;504;480;1491;610;1995
280700;201301;1156;3512;1039;3351;77;257;824;2715;901;2972
280710;201301;9095;27340;8770;26920;553;1936;7564;23127;8117;25063
280720;201301;2343;6692;2117;6402;200;678;1692;5102;1892;5780
280730;201301;848;2717;833;2697;117;371;640;2142;757;2513
280740;201301;11789;34073;10679;32487;1688;5032;7633;23930;9321;28962
280750;201301;3368;11221;3203;10921;295;1267;2411;8113;2706;9380
280760;201301;4957;16632;4625;16201;523;1815;3704;13367;4227;15182
290010;201301;2813;6576;2128;5521;100;420;1707;4180;1807;4600
290020;201301;4785;15499;4360;15062;376;1224;3800;13369;4176;14593
290030;201301;2983;10167;2927;10053;330;1253;2296;7839;2626;9092
290035;201301;4327;12641;3974;12178;262;935;3383;10360;3645;11295
290040;201301;3507;11318;3331;11078;296;1182;2741;9040;3037;10222
290050;201301;2647;8906;2494;8670;236;953;1955;6836;2191;7789
290060;201301;1243;3359;1062;3149;84;237;918;2743;1002;2980
290070;201301;27159;77211;24816;74263;5298;16585;14744;45956;20042;62541
290080;201301;5352;17434;4920;16886;634;2307;3837;13338;4471;15645
290090;201301;2253;5102;1812;4637;180;450;1515;3945;1695;4395
290100;201301;9605;28716;8479;26762;1932;6171;4541;15041;6473;21212
290110;201301;5018;15946;4886;15720;837;2946;3438;11000;4275;13946
290115;201301;4729;14984;4280;14394;403;1472;3306;11307;3709;12779
290120;201301;6419;18544;6095;18164;370;1148;5432;16303;5802;17451
290130;201301;4400;12047;3987;11558;345;835;3412;10187;3757;11022
290135;201301;4826;13339;4302;12461;449;1583;2972;8604;3421;10187
290140;201301;3396;11995;3093;11606;416;1656;2459;9263;2875;10919
290150;201301;2056;6270;2014;6197;169;559;1741;5344;1910;5903
290160;201301;3373;9777;3321;9716;389;804;2811;8614;3200;9418
290170;201301;2653;9289;2472;8981;283;1204;1912;6936;2195;8140
290180;201301;2813;8370;2599;8095;281;965;1985;6216;2266;7181
290190;201301;4077;13796;3952;13575;465;1645;3129;10909;3594;12554
290195;201301;2090;6129;1844;5761;129;440;1501;4744;1630;5184
290200;201301;3545;12187;3296;11730;496;1905;2307;8243;2803;10148
290205;201301;2609;8872;2478;8695;445;1840;1727;5917;2172;7757
290210;201301;13898;41776;13474;41258;2266;5545;9974;33064;12240;38609
290220;201301;2231;7231;2172;7142;376;1434;1527;4899;1903;6333
290225;201301;2898;8140;2748;7976;264;620;2337;7030;2601;7650
290230;201301;2177;7637;2147;7594;263;937;1743;6273;2006;7210
290240;201301;3702;10161;3389;9736;376;1246;2564;7287;2940;8533
290250;201301;3622;12033;3085;11162;329;1294;2302;8411;2631;9705
290260;201301;4421;14562;4241;14288;541;1917;3322;11244;3863;13161
290265;201301;3195;10955;3094;10781;332;1306;2415;8432;2747;9738
290270;201301;11058;42922;10521;42158;1266;5601;8231;33281;9497;38882
290280;201301;4784;16621;4605;16258;757;2788;3109;11297;3866;14085
290290;201301;9243;30887;8625;29898;1507;5576;5953;20909;7460;26485
290300;201301;4191;12289;3433;11062;340;1090;2540;8416;2880;9506
290310;201301;1448;4604;1408;4562;181;675;1120;3573;1301;4248
290320;201301;21334;74349;20666;73332;4837;18016;13292;47844;18129;65860
290323;201301;3484;10454;2930;9871;188;755;2532;8508;2720;9263
290327;201301;3617;12411;3476;12114;535;1963;2429;8548;2964;10511
290330;201301;1733;4983;1679;4924;220;743;1358;3910;1578;4653
290340;201301;5409;17961;5134;17533;1167;4075;3078;10878;4245;14953
290350;201301;4747;15060;3953;13973;509;1851;2892;10477;3401;12328
290360;201301;3818;12725;3624;12489;232;855;3203;11146;3435;12001
290370;201301;4313;13765;4031;13352;588;2009;3092;10357;3680;12366
290380;201301;5166;15940;4722;15405;337;1290;4138;13469;4475;14759
290390;201301;14108;48655;13688;47951;2714;9296;9310;34069;12024;43365
290395;201301;2685;9021;2456;8642;278;1176;1831;6450;2109;7626
290400;201301;3255;11315;2991;10938;365;1493;2273;8401;2638;9894
290405;201301;3973;13551;3580;12898;555;2089;2465;9183;3020;11272
290410;201301;5648;17900;4932;16854;602;2621;3634;12063;4236;14684
290420;201301;2991;9630;2624;9109;311;1282;1925;6635;2236;7917
290430;201301;3201;10769;2990;10494;574;1976;2055;7486;2629;9462
290440;201301;2637;7680;2255;7202;235;824;1820;5861;2055;6685
290450;201301;3289;10153;3038;9792;683;2132;1827;6186;2510;8318
290460;201301;12410;40791;11895;39911;3010;10812;6603;22015;9613;32827
290470;201301;4446;13334;3651;12350;890;3402;1967;6711;2857;10113
290475;201301;5051;18431;4655;17719;586;2372;3436;13295;4022;15667
290480;201301;2489;6711;2249;6392;469;1530;1430;4010;1899;5540
290485;201301;4187;14647;3971;14326;497;2184;3004;10803;3501;12987
290490;201301;6996;20822;6842;20626;881;2880;5455;16474;6336;19354
290500;201301;4388;14603;3900;13781;737;2801;2219;7885;2956;10686
290510;201301;3359;10130;2984;9576;255;987;2369;7576;2624;8563
290515;201301;2430;8204;2361;8062;120;413;1987;6933;2107;7346
290520;201301;11099;36202;9404;33049;1395;5701;6020;21012;7415;26713
290530;201301;5012;15138;4380;14253;370;1359;3566;11598;3936;12957
290540;201301;3701;11028;3564;10841;494;1477;2674;8365;3168;9842
290550;201301;3903;11091;3468;10525;347;952;2763;8602;3110;9554
290560;201301;6582;19950;5808;18922;1302;4495;3611;12016;4913;16511
290570;201301;36422;112630;34494;109674;4758;16362;25840;82095;30598;98457
290580;201301;7121;26250;6886;25890;1186;4520;5049;19491;6235;24011
290590;201301;6861;23274;5965;21881;455;2017;4868;17801;5323;19818
290600;201301;17363;56794;16586;55562;2226;7799;11971;41129;14197;48928
290610;201301;2206;8108;1937;7594;226;1092;1447;5573;1673;6665
290620;201301;7031;21746;6392;20858;543;1921;5368;17558;5911;19479
290630;201301;7890;22184;7122;21393;644;1923;6074;18496;6718;20419
290640;201301;2663;8080;2289;7437;303;1062;1603;5226;1906;6288
290650;201301;11152;34500;10533;33526;3285;10499;5568;18559;8853;29058
290660;201301;3567;10418;3050;9678;236;880;2433;7726;2669;8606
290670;201301;6079;20422;5643;19743;732;2341;4508;16402;5240;18743
290680;201301;9761;30073;9351;29610;548;1573;8358;26922;8906;28495
290682;201301;3864;12545;3611;12181;248;1037;3033;10199;3281;11236
290685;201301;3058;8369;2458;7527;306;1067;1654;5091;1960;6158
290687;201301;8021;22310;6719;20803;974;3320;4738;14888;5712;18208
290689;201301;3006;8884;2580;8189;298;1032;1992;6358;2290;7390
290690;201301;4986;15416;4656;14957;625;2228;3538;11358;4163;13586
290700;201301;2137;7031;2074;6930;238;884;1641;5495;1879;6379
290710;201301;7292;24610;6870;23958;426;1480;6073;21438;6499;22918
290720;201301;16746;52718;15266;50893;2151;6367;11978;41656;14129;48023
290730;201301;7062;20572;6596;19998;1305;3825;4340;13747;5645;17572
290740;201301;972;3045;852;2851;209;682;451;1611;660;2293
290750;201301;8587;27345;8102;26429;1705;6537;4888;14971;6593;21508
290755;201301;2349;6948;2046;6448;142;568;1679;5233;1821;5801
290760;201301;4269;13303;3663;12512;350;1247;2970;10262;3320;11509
290770;201301;2475;8849;2332;8661;156;655;1987;7416;2143;8071
290780;201301;8080;22828;7475;22023;992;2838;5632;16972;6624;19810
290790;201301;4158;13666;3951;13399;395;1326;3155;11121;3550;12447
290800;201301;6901;16404;5421;14842;1058;2668;3908;11235;4966;13903
290810;201301;4394;15225;4074;14735;365;1414;3225;11822;3590;13236
290820;201301;5162;15599;4683;14925;625;2228;3444;11048;4069;13276
290830;201301;4060;12813;3934;12580;595;2308;2715;8442;3310;10750
290840;201301;16224;47929;15433;46859;2207;6420;11497;36241;13704;42661
290850;201301;6439;20235;6316;20047;1787;5511;3802;12640;5589;18151
290860;201301;4442;16974;4337;16837;684;2629;3238;12967;3922;15596
290870;201301;4588;14765;3907;13890;375;1579;3118;11099;3493;12678
290880;201301;1325;3901;1098;3536;107;372;746;2458;853;2830
290890;201301;5936;17407;5778;17211;496;1616;4879;14501;5375;16117
290900;201301;2297;6961;1784;6162;314;1222;926;3147;1240;4369
290910;201301;4451;13429;3913;12652;393;1340;3078;10057;3471;11397
290920;201301;4637;14722;4297;14308;251;726;3807;12944;4058;13670
290930;201301;7004;23462;6614;22858;767;3055;4966;16945;5733;20000
290940;201301;3157;10764;3005;10559;293;1123;2520;8951;2813;10074
290950;201301;1513;4577;1452;4496;224;759;1080;3306;1304;4065
290960;201301;5403;16624;5077;16164;427;1404;4094;13246;4521;14650
290970;201301;3624;12169;3418;11818;522;1878;2285;8117;2807;9995
290980;201301;10103;32466;9321;30878;2714;9673;4360;14260;7074;23933
290990;201301;8774;27432;8221;26560;1006;3452;6428;20871;7434;24323
291000;201301;2829;9624;2722;9484;420;1418;2071;7476;2491;8894
291005;201301;9599;32050;9259;31473;2067;7443;6060;20679;8127;28122
291010;201301;2811;10007;2447;9154;522;2062;1251;4755;1773;6817
291020;201301;1255;3586;1007;3106;130;503;572;1709;702;2212
291030;201301;1897;5703;1658;5198;205;730;1047;3255;1252;3985
291040;201301;4917;16778;4719;16483;617;2409;3501;12217;4118;14626
291050;201301;7938;27377;7421;26439;1958;7459;4097;14767;6055;22226
291060;201301;5971;22891;5750;22624;810;3574;4441;17468;5251;21042
291070;201301;15406;47464;14431;46020;2022;6012;10817;35686;12839;41698
291072;201301;16724;56732;15299;54026;6181;22898;5002;18960;11183;41858
291075;201301;4804;15028;4537;14615;307;1079;3618;11743;3925;12822
291077;201301;1434;4446;1261;4192;152;620;875;2844;1027;3464
291080;201301;78694;245805;73174;237496;18178;62497;39754;128904;57932;191401
291085;201301;5268;15094;4679;14306;584;1977;3619;11019;4203;12996
291090;201301;1115;3307;980;3100;177;794;589;1667;766;2461
291100;201301;2587;7336;2209;6936;123;521;1925;5996;2048;6517
291110;201301;4680;17590;4268;16928;561;2523;3128;12388;3689;14911
291120;201301;7193;20282;6884;19844;1001;3043;5269;15284;6270;18327
291125;201301;1597;3745;1333;3471;143;330;1056;2878;1199;3208
291130;201301;2886;9122;2587;8629;290;1102;1863;6218;2153;7320
291140;201301;3902;12220;3751;11950;589;1996;2745;8759;3334;10755
291150;201301;1855;5176;1814;5132;196;550;1517;4325;1713;4875
291160;201301;5190;16503;4721;15818;1076;3841;2975;9942;4051;13783
291165;201301;2106;7133;1899;6721;256;1055;1332;4610;1588;5665
291170;201301;19116;51466;17007;48947;1455;4974;13781;39448;15236;44422
291180;201301;5917;16714;5029;15512;543;1954;3909;11917;4452;13871
291185;201301;3397;10214;3270;10048;241;871;2787;8498;3028;9369
291190;201301;7243;21270;6639;20584;932;2740;4976;16153;5908;18893
291200;201301;2955;9422;2660;8933;340;1367;1958;6499;2298;7866
291210;201301;7384;18611;6710;17898;726;1982;5310;14465;6036;16447
291220;201301;3810;12668;3639;12374;605;2357;2529;8492;3134;10849
291230;201301;3578;9993;3229;9557;236;755;2756;8181;2992;8936
291240;201301;4441;12817;3858;11827;341;1113;2961;9018;3302;10131
291250;201301;3594;11137;2931;10066;317;1125;2130;7432;2447;8557
291260;201301;1165;3575;1117;3515;107;377;907;2847;1014;3224
291270;201301;4716;16018;4521;15753;322;1280;3773;13193;4095;14473
291280;201301;2285;6027;1762;5441;565;1676;1014;3274;1579;4950
291290;201301;5639;17177;5276;16738;367;1154;4496;14535;4863;15689
291300;201301;4298;13375;3619;12231;475;1782;2505;8509;2980;10291
291310;201301;4901;15035;4436;14308;439;1564;3431;11078;3870;12642
291320;201301;5082;18014;4748;17335;1295;5116;2405;8697;3700;13813
291330;201301;1525;4899;1441;4745;219;847;915;2887;1134;3734
291340;201301;3652;11471;3002;10528;408;1619;2228;7773;2636;9392
291345;201301;3193;11219;3079;11094;252;956;2681;9765;2933;10721
291350;201301;5763;17837;5219;17009;722;2498;3423;11452;4145;13950
291360;201301;34989;105729;33172;103005;7476;22949;22028;70617;29504;93566
291370;201301;8499;27107;8226;26758;1455;4364;5890;20207;7345;24571
291380;201301;3482;11482;3222;11084;255;926;2560;9037;2815;9963
291390;201301;9624;28711;8874;27872;1108;3591;7081;22466;8189;26057
291400;201301;16230;44364;13427;40654;1886;5956;9134;28689;11020;34645
291410;201301;3086;8335;2315;7208;217;907;1726;5176;1943;6083
291420;201301;2129;5877;1967;5682;181;458;1718;5066;1899;5524
291430;201301;3206;9888;2878;9465;290;1141;2241;7308;2531;8449
291440;201301;5509;18606;4753;17152;607;2332;3507;12872;4114;15204
291450;201301;6818;22323;6587;21929;484;1573;5400;18366;5884;19939
291460;201301;11755;38071;10707;36554;2833;9966;6235;21803;9068;31769
291465;201301;7180;22692;6760;22216;1025;3541;5147;17183;6172;20724
291470;201301;14749;43362;13408;41707;1165;3692;10895;34748;12060;38440
291480;201301;33006;93640;29820;89171;5698;18561;19046;56873;24744;75434
291490;201301;3919;14201;3857;14101;561;2078;3034;11227;3595;13305
291500;201301;3962;12007;3515;11390;313;1106;2824;9195;3137;10301
291510;201301;3238;10525;3088;10309;206;727;2722;9156;2928;9883
291520;201301;3905;11437;3544;10945;632;1854;2369;7830;3001;9684
291530;201301;1972;6196;1736;5831;523;1876;849;2934;1372;4810
291535;201301;4140;12731;3806;12258;461;1545;2795;9431;3256;10976
291540;201301;2151;5587;1889;5312;164;433;1602;4601;1766;5034
291550;201301;5246;15014;4799;14384;1177;3863;2726;8196;3903;12059
291560;201301;15514;43402;12709;40150;1770;5793;9245;29989;11015;35782
291570;201301;2242;6373;2216;6343;53;113;2140;6193;2193;6306
291580;201301;5676;18197;5098;17248;878;3631;3194;10575;4072;14206
291590;201301;1817;6047;1668;5790;361;1419;983;3482;1344;4901
291600;201301;5193;15171;3926;13428;1025;3812;2001;6835;3026;10647
291610;201301;5083;14793;4956;14615;464;1719;4165;12000;4629;13719
291620;201301;2875;7187;2439;6717;205;562;1945;5542;2150;6104
291630;201301;3103;8129;2818;7808;235;631;2443;6898;2678;7529
291640;201301;16195;47139;14062;44469;4202;14554;6416;20419;10618;34973
291650;201301;7280;22879;6780;22301;510;1451;5872;19814;6382;21265
291660;201301;2383;6628;2169;6359;271;935;1632;4706;1903;5641
291670;201301;2429;7091;2262;6812;381;1191;1275;4177;1656;5368
291680;201301;4825;14336;4437;13737;1179;4086;2167;7020;3346;11106
291685;201301;3751;10945;3508;10664;158;543;3150;9668;3308;10211
291690;201301;3817;11022;3211;10063;357;1181;2200;6964;2557;8145
291700;201301;8829;29638;8401;28937;927;3400;6561;22903;7488;26303
291710;201301;5581;15834;4943;14967;1258;4350;2364;7384;3622;11734
291720;201301;3494;12913;3341;12589;418;1763;2484;9256;2902;11019
291730;201301;5493;18755;5185;18352;1371;4893;3128;11530;4499;16423
291733;201301;2351;7927;2105;7596;256;1000;1526;5658;1782;6658
291735;201301;1949;6094;1762;5804;89;364;1537;5006;1626;5370
291740;201301;3819;11492;3063;10330;343;1360;2185;7321;2528;8681
291750;201301;20386;56992;17051;52202;3762;11916;9908;30915;13670;42831
291760;201301;11531;38418;11072;37647;3585;12980;5694;19859;9279;32839
291770;201301;7603;22906;7200;22235;1128;3827;5051;15454;6179;19281
291780;201301;4142;13380;4053;13224;595;1855;3128;10426;3723;12281
291790;201301;2261;7702;2169;7585;230;888;1752;6163;1982;7051
291800;201301;29314;90820;27227;87815;6519;21738;16542;54848;23061;76586
291810;201301;9667;30153;8719;29057;696;2489;7244;24473;7940;26962
291820;201301;3407;10957;3213;10678;357;1213;2513;8475;2870;9688
291830;201301;4169;11809;3937;11471;499;1622;3055;8822;3554;10444
291835;201301;5876;18913;5093;17730;976;3692;3534;12278;4510;15970
291840;201301;43877;127618;38551;122085;4841;15395;31005;100112;35846;115507
291845;201301;2995;9167;2726;8880;172;481;2461;8185;2633;8666
291850;201301;4719;13795;4078;12927;416;1312;3259;10560;3675;11872
291855;201301;1819;5072;1616;4826;264;948;1155;3360;1419;4308
291860;201301;1840;5863;1713;5652;239;916;1152;3795;1391;4711
291870;201301;1291;3692;1054;3267;114;443;717;2196;831;2639
291875;201301;2658;9142;2500;8888;297;1246;1856;6493;2153;7739
291880;201301;4104;14213;4030;14111;393;1456;3431;12090;3824;13546
291890;201301;1357;3544;1165;3308;138;402;888;2561;1026;2963
291900;201301;1203;3692;1100;3542;115;423;825;2632;940;3055
291905;201301;2726;7804;2363;7221;281;933;1577;4966;1858;5899
291910;201301;2258;6832;2098;6648;198;728;1754;5498;1952;6226
291915;201301;6366;20731;5872;19690;509;1809;4943;16730;5452;18539
291920;201301;32145;95552;30031;92513;5855;18266;19434;61902;25289;80168
291930;201301;2328;7498;2172;7277;205;672;1762;6075;1967;6747
291940;201301;3460;10331;2756;9125;413;1613;1771;5748;2184;7361
291950;201301;8881;31490;8167;30337;1979;7549;4636;17659;6615;25208
291955;201301;7285;24871;7189;24739;1225;4293;5401;18901;6626;23194
291960;201301;3258;10145;2873;9647;376;1198;2057;7324;2433;8522
291970;201301;4155;12967;3742;12479;638;2171;2632;9007;3270;11178
291980;201301;10865;32878;8771;29956;970;3572;6468;22484;7438;26056
291990;201301;2052;7044;1924;6842;234;874;1390;5089;1624;5963
291992;201301;2644;8418;2595;8315;475;1598;1863;5945;2338;7543
291995;201301;2005;6250;1838;6031;248;878;1402;4626;1650;5504
292000;201301;2125;6735;1951;6461;629;2224;964;3165;1593;5389
292010;201301;5946;16095;4662;14137;345;1189;3652;11077;3997;12266
292020;201301;4397;15595;4085;15079;485;1997;3115;11643;3600;13640
292030;201301;2077;6915;1908;6686;266;1000;1342;4812;1608;5812
292040;201301;4265;12677;3965;12349;333;1037;3360;10745;3693;11782
292045;201301;2176;8291;2153;8249;122;403;1965;7627;2087;8030
292050;201301;5782;19229;5423;18536;647;2683;3889;13101;4536;15784
292060;201301;10474;30558;10145;30106;938;2980;8489;25110;9427;28090
292070;201301;4004;13747;3915;13628;423;1311;3348;11931;3771;13242
292080;201301;3502;9734;3098;9184;317;992;2483;7409;2800;8401
292090;201301;4104;11519;3592;10926;400;1379;2843;8653;3243;10032
292100;201301;10270;30172;9164;28796;2307;7554;5606;18032;7913;25586
292105;201301;3038;9575;2696;9097;236;943;2142;7184;2378;8127
292110;201301;6837;18715;5319;16573;975;3342;3373;10631;4348;13973
292120;201301;8106;24400;7326;23216;1544;5168;4446;14373;5990;19541
292130;201301;3162;8682;2940;8404;380;914;2301;6861;2681;7775
292140;201301;5302;14472;4765;13751;538;1630;3454;10225;3992;11855
292145;201301;2632;8415;2446;8129;234;761;1824;6360;2058;7121
292150;201301;12893;40805;12156;39608;896;3552;9628;31397;10524;34949
292160;201301;2462;7418;2133;6966;214;685;1686;5685;1900;6370
292170;201301;8301;26138;7386;24595;1148;4270;4822;16270;5970;20540
292180;201301;3390;10497;2879;9739;356;1306;2072;7141;2428;8447
292190;201301;2922;8715;2633;8319;547;1906;1720;5423;2267;7329
292200;201301;4525;17030;4194;16233;1643;6600;1347;5508;2990;12108
292205;201301;3813;12399;3564;12055;331;1252;2763;9396;3094;10648
292210;201301;6233;19144;5597;18263;596;2071;4366;14544;4962;16615
292220;201301;1894;5705;1808;5582;281;924;1296;3952;1577;4876
292225;201301;2729;9117;2521;8787;253;922;1936;6887;2189;7809
292230;201301;5820;18331;5628;18018;698;2769;4364;13575;5062;16344
292240;201301;4183;14030;3971;13553;575;2089;2629;9058;3204;11147
292250;201301;5273;16523;5026;16060;1034;3487;2982;9603;4016;13090
292260;201301;2699;9290;2610;9146;343;1271;1942;6832;2285;8103
292265;201301;2886;10144;2727;9822;243;1032;2048;7350;2291;8382
292270;201301;3549;10444;2914;9699;321;1321;2363;7781;2684;9102
292273;201301;2581;6590;1985;5820;357;1021;1290;4002;1647;5023
292275;201301;1892;5030;1786;4879;223;707;1359;3663;1582;4370
292280;201301;1968;6184;1855;6064;197;574;1470;5074;1667;5648
292285;201301;2409;7179;2174;6836;340;1132;1468;4792;1808;5924
292290;201301;7310;22758;6281;21454;246;934;5480;19143;5726;20077
292300;201301;7960;25635;7076;24688;2398;8405;3916;14263;6314;22668
292303;201301;2643;8824;2525;8639;89;325;2223;7672;2312;7997
292305;201301;2989;8666;2850;8476;135;434;2526;7551;2661;7985
292310;201301;5692;18490;5268;17933;363;1251;4537;15653;4900;16904
292320;201301;5342;17622;5058;17110;601;2393;3820;12791;4421;15184
292330;201301;1845;5674;1743;5555;315;1087;1205;3826;1520;4913
292335;201301;4965;13862;4618;13383;434;1264;3860;11282;4294;12546
292340;201301;5907;18440;5326;17537;535;1929;4005;13230;4540;15159
292350;201301;2012;6511;1905;6382;209;793;1520;5092;1729;5885
292360;201301;4576;14300;4460;13842;200;654;3912;12338;4112;12992
292370;201301;8025;26694;7397;25749;941;3203;5344;19621;6285;22824
292380;201301;6991;21176;6699;20769;539;1566;5694;17918;6233;19484
292390;201301;3441;8308;3079;7917;128;270;2850;7422;2978;7692
292400;201301;21263;64517;20484;63250;3078;10089;14666;46225;17744;56314
292405;201301;4228;11912;3767;11359;278;847;3209;9834;3487;10681
292410;201301;1586;4934;1559;4902;95;412;1384;4270;1479;4682
292420;201301;3343;11435;3251;11326;297;756;2807;10226;3104;10982
292430;201301;4905;16552;4346;15861;371;1509;3420;12568;3791;14077
292440;201301;8345;27839;7899;27209;308;1189;7072;24697;7380;25886
292450;201301;3866;12513;3304;11559;402;1548;2246;7993;2648;9541
292460;201301;5531;17256;5013;16307;782;2706;3364;10995;4146;13701
292465;201301;2216;7068;1958;6653;252;1002;1439;4887;1691;5889
292467;201301;2136;7235;2044;7078;465;1704;1279;4494;1744;6198
292470;201301;3031;8479;2576;7752;240;879;1935;5721;2175;6600
292480;201301;5220;15770;4552;14802;425;1494;3673;12087;4098;13581
292490;201301;2004;6241;1837;5962;213;844;1353;4332;1566;5176
292500;201301;6121;19715;5457;18543;677;2705;3910;13320;4587;16025
292510;201301;12449;37435;11259;35736;1132;4039;8883;28440;10015;32479
292520;201301;5402;17508;5090;16952;1530;5222;2577;8685;4107;13907
292525;201301;5215;14353;4658;13700;486;1578;3673;10896;4159;12474
292530;201301;23915;74045;22237;72140;3673;12198;16466;54962;20139;67160
292540;201301;2447;8010;2279;7737;444;1791;1444;4831;1888;6622
292550;201301;5884;20556;5413;19796;1020;3953;3545;13234;4565;17187
292560;201301;4071;11696;3525;10978;338;1253;2845;8729;3183;9982
292570;201301;3753;11643;3695;11582;144;471;3214;10402;3358;10873
292575;201301;5495;19683;5377;19449;1363;5002;3279;11958;4642;16960
292580;201301;6657;21018;6251;20490;556;1879;5199;17217;5755;19096
292590;201301;6805;22927;6614;22577;1123;3832;4550;15925;5673;19757
292593;201301;3092;8571;2699;7986;267;869;2068;6098;2335;6967
292595;201301;5211;16148;4773;15557;469;1659;3681;12050;4150;13709
292600;201301;9796;29173;9450;28740;1367;3272;7542;24175;8909;27447
292610;201301;4221;12584;3628;11616;684;2279;2182;7136;2866;9415
292620;201301;5641;17977;5058;17306;271;1005;4619;15899;4890;16904
292630;201301;9632;25019;8599;23528;657;2004;6837;18835;7494;20839
292640;201301;8162;26904;7275;25751;715;2577;5713;20754;6428;23331
292650;201301;4439;13072;4299;12904;493;1190;3465;11033;3958;12223
292660;201301;10477;33469;10178;33012;1356;4424;7731;25662;9087;30086
292665;201301;2760;8616;2693;8512;100;272;2519;8049;2619;8321
292670;201301;3676;10913;2996;9767;373;1401;2000;6542;2373;7943
292680;201301;3420;10790;3300;10639;247;907;2840;9080;3087;9987
292690;201301;3226;9170;2436;7960;318;1171;1689;5578;2007;6749
292700;201301;8331;27017;7578;26001;884;2930;5941;21062;6825;23992
292710;201301;1737;5968;1686;5892;121;445;1451;5116;1572;5561
292720;201301;9145;25147;8239;24112;852;2567;6776;20100;7628;22667
292730;201301;3113;9930;3025;9778;593;1836;2004;6734;2597;8570
292740;201301;334363;988130;321386;968775;79852;253088;193174;585829;273026;838917
292750;201301;5490;15761;5066;15207;438;1280;4075;12583;4513;13863
292760;201301;4179;13797;3890;13279;563;2137;2699;9288;3262;11425
292770;201301;5571;18030;5324;17647;1432;4764;3060;10573;4492;15337
292780;201301;1686;4538;1370;4158;220;796;962;2851;1182;3647
292790;201301;2926;8497;2864;8422;272;692;2338;7216;2610;7908
292800;201301;8908;28214;8465;27495;972;3464;6546;21271;7518;24735
292805;201301;2939;9287;2759;9017;509;1789;1901;6329;2410;8118
292810;201301;9121;29934;8082;28572;1192;4356;6138;22116;7330;26472
292820;201301;6888;20906;5242;18584;451;1833;4311;15292;4762;17125
292830;201301;1805;5572;1662;5379;132;523;1357;4364;1489;4887
292840;201301;6188;22302;5795;21739;580;2159;4744;18156;5324;20315
292850;201301;2659;7796;2464;7520;377;1170;1710;5194;2087;6364
292860;201301;14386;41003;13987;40515;2066;5912;10815;31960;12881;37872
292870;201301;17231;50824;15703;48303;3038;10535;9455;28530;12493;39065
292880;201301;11409;35377;10479;33875;2031;6786;6669;21869;8700;28655
292890;201301;5207;18767;4781;17932;1072;4159;2687;10424;3759;14583
292895;201301;2557;6893;2217;6391;320;1005;1659;4738;1979;5743
292900;201301;2999;9646;2845;9392;493;1910;1862;5924;2355;7834
292905;201301;3745;12089;3178;11346;410;1368;2471;9155;2881;10523
292910;201301;4716;15450;4500;15045;844;2963;2938;9787;3782;12750
292920;201301;7141;22266;6820;21763;757;2756;5293;16691;6050;19447
292925;201301;4771;15972;4321;15379;339;1300;3552;12746;3891;14046
292930;201301;6000;20097;5801;19719;916;3724;4179;13872;5095;17596
292935;201301;2010;5903;1728;5583;204;632;1341;4513;1545;5145
292937;201301;3059;8350;2653;7820;379;1227;1919;5608;2298;6835
292940;201301;2916;8492;2382;7763;270;912;1671;5673;1941;6585
292950;201301;7789;24903;7542;24471;1183;4477;5298;16735;6481;21212
292960;201301;4300;12600;4133;12375;492;1596;3130;9325;3622;10921
292970;201301;4036;13193;3780;12869;224;891;3209;10962;3433;11853
292975;201301;2911;8881;2832;8749;345;1206;2216;6779;2561;7985
292980;201301;3438;10223;2889;9563;417;1651;2024;6636;2441;8287
292990;201301;11401;34070;10898;33365;804;2540;9459;29194;10263;31734
293000;201301;2729;7730;2361;7239;148;551;2028;6171;2176;6722
293010;201301;16198;50467;15212;48720;3159;11072;9443;30018;12602;41090
293015;201301;7598;26104;6243;24183;1082;4517;4230;16339;5312;20856
293020;201301;9180;31096;8649;30330;664;2626;7187;25464;7851;28090
293030;201301;5399;16370;4496;15044;532;1884;3156;10914;3688;12798
293040;201301;3522;11769;3420;11656;255;923;2966;10139;3221;11062
293050;201301;17148;52591;15709;50655;2100;6823;11457;37853;13557;44676
293060;201301;4174;10978;3622;10103;429;1313;2526;6975;2955;8288
293070;201301;18191;58370;17464;57111;4768;16333;9953;32914;14721;49247
293075;201301;3568;11349;3297;11052;171;534;2994;10202;3165;10736
293076;201301;3513;10582;3342;10313;292;841;2808;8885;3100;9726
293077;201301;5136;16138;4521;15389;681;2498;3292;11234;3973;13732
293080;201301;4610;15199;4276;14624;380;1637;3303;11071;3683;12708
293090;201301;3472;11218;2915;10453;273;1065;2354;8526;2627;9591
293100;201301;5391;17269;4790;16221;518;1929;3616;12417;4134;14346
293105;201301;3533;12561;3232;11968;455;1894;2318;8618;2773;10512
293110;201301;1864;5787;1796;5686;111;406;1525;4832;1636;5238
293120;201301;3817;13337;3589;13026;356;1306;2872;10609;3228;11915
293130;201301;3786;11473;3129;10735;207;804;2709;9445;2916;10249
293135;201301;22279;66529;19540;62827;3960;15229;11321;35539;15281;50768
293140;201301;1937;6159;1891;6085;206;840;1458;4561;1664;5401
293150;201301;5639;19033;5242;18289;921;3325;3413;12235;4334;15560
293160;201301;2872;9363;2767;9243;306;813;2272;7937;2578;8750
293170;201301;3288;10428;3121;10176;452;1566;2326;7727;2778;9293
293180;201301;5079;14895;4390;13875;482;1781;3384;10558;3866;12339
293190;201301;12710;40774;12362;40177;677;2949;10679;34080;11356;37029
293200;201301;5798;18195;5312;17401;362;1442;4565;14782;4927;16224
293210;201301;4529;14348;4321;13999;551;1912;3129;10281;3680;12193
293220;201301;4636;15211;4406;14896;1212;4207;2470;8585;3682;12792
293230;201301;3934;12742;3684;12401;382;1479;2993;10021;3375;11500
293240;201301;4311;11543;3489;10471;225;701;2806;8498;3031;9199
293245;201301;4227;12805;3917;12293;529;1728;2778;8967;3307;10695
293250;201301;5659;17038;5344;16608;873;2758;3824;12124;4697;14882
293260;201301;4514;14122;3859;13165;373;1417;2927;10134;3300;11551
293270;201301;5552;15844;5345;15619;506;1451;4603;13625;5109;15076
293280;201301;5374;16256;4844;15534;468;1433;3786;12589;4254;14022
293290;201301;15434;54598;15066;53849;2961;10658;10155;37216;13116;47874
293300;201301;5791;15672;5127;14936;563;1569;4000;11952;4563;13521
293305;201301;4320;11717;4038;11341;449;1380;3124;8841;3573;10221
293310;201301;2616;7031;2220;6392;333;1065;1479;4217;1812;5282
293315;201301;4619;12375;4218;11735;798;2208;2566;7534;3364;9742
293317;201301;2410;7495;2233;7157;332;1115;1459;4706;1791;5821
293320;201301;7923;26303;7741;26050;849;3176;6292;21067;7141;24243
293325;201301;1838;5625;1548;5168;266;958;1017;3457;1283;4415
293330;201301;49155;164377;45382;157982;10660;40135;26068;91998;36728;132133
293340;201301;2583;7697;2097;6864;269;1035;1477;4750;1746;5785
293345;201301;3174;10144;2682;9416;400;1463;1794;6511;2194;7974
293350;201301;6518;18678;6301;18417;341;944;5712;16931;6053;17875
293360;201301;12975;40788;12042;39548;867;2866;10134;34053;11001;36919
310010;201301;1206;3388;882;2864;261;992;388;1172;649;2164
310020;201301;3629;11888;3197;10961;1220;4489;689;2159;1909;6648
310030;201301;2327;8107;2120;7711;764;2907;825;3067;1589;5974
310040;201301;884;2583;753;2399;131;491;479;1478;610;1969
310050;201301;1918;7001;1712;6485;375;1630;848;3191;1223;4821
310060;201301;2878;10601;2811;10511;298;1185;2332;8782;2630;9967
310070;201301;297;914;223;767;44;189;90;274;134;463
310080;201301;694;2221;583;2008;173;681;198;643;371;1324
310090;201301;4207;13610;3797;12899;741;2807;2392;8139;3133;10946
310100;201301;2952;10037;2670;9639;519;1968;1751;6433;2270;8401
310110;201301;5617;16491;4788;15266;1215;4382;2582;8163;3797;12545
310120;201301;538;1819;517;1787;238;939;193;587;431;1526
310130;201301;447;1482;413;1429;122;475;209;695;331;1170
310140;201301;257;907;223;841;79;335;47;156;126;491
310150;201301;4376;14554;4046;13934;936;3725;2221;7561;3157;11286
310160;201301;6340;21202;5703;20177;1671;6607;2803;9765;4474;16372
310163;201301;525;1968;504;1938;141;619;280;1063;421;1682
310170;201301;9203;27738;8576;26768;1899;6331;5094;16488;6993;22819
310180;201301;1703;5240;1406;4890;352;1421;814;2756;1166;4177
310190;201301;2378;8296;2200;8017;714;2918;391;1484;1105;4402
310200;201301;1732;6089;1494;5595;524;2131;466;1718;990;3849
310205;201301;872;2915;809;2788;157;568;513;1801;670;2369
310210;201301;2236;7570;2097;7337;423;1596;1382;4851;1805;6447
310220;201301;1220;3566;989;3277;178;657;655;2158;833;2815
310230;201301;2655;9280;2403;8708;855;3519;812;2682;1667;6201
310240;201301;975;3572;837;3293;143;626;503;2075;646;2701
310250;201301;897;3296;879;3268;190;794;532;1912;722;2706
310260;201301;3131;10634;2795;9955;984;3850;991;3417;1975;7267
310270;201301;2137;7080;1992;6878;327;1224;1409;4969;1736;6193
310280;201301;1985;6122;1811;5835;639;2426;660;1939;1299;4365
310285;201301;2210;8117;2120;8003;285;1046;1608;6288;1893;7334
310290;201301;1284;4234;1199;4100;412;1651;542;1640;954;3291
310300;201301;1801;6450;1714;6259;513;2048;930;3349;1443;5397
310310;201301;356;1034;278;862;55;199;139;411;194;610
310320;201301;324;1205;296;1131;84;345;141;544;225;889
310330;201301;440;1187;354;1048;51;193;220;611;271;804
310340;201301;7894;26528;7185;25401;1290;4909;4605;16686;5895;21595
310350;201301;13043;40523;11145;37103;4228;15258;2931;9815;7159;25073
310360;201301;431;1458;423;1443;107;423;255;827;362;1250
310370;201301;1338;5067;1300;4989;487;1901;532;2097;1019;3998
310375;201301;1197;3304;947;2920;127;472;597;1815;724;2287
310380;201301;369;1113;320;1049;149;545;124;371;273;916
310390;201301;414;1554;364;1450;133;573;84;331;217;904
310400;201301;9184;29268;7672;26485;2869;10817;1919;6436;4788;17253
310410;201301;1014;3305;684;2832;304;1344;134;544;438;1888
310420;201301;5205;15665;3052;10448;895;3456;412;1261;1307;4717
310430;201301;1457;5211;1274;4804;480;1933;373;1389;853;3322
310440;201301;606;1829;533;1714;171;627;194;586;365;1213
310445;201301;1151;4055;996;3779;161;686;625;2412;786;3098
310450;201301;4186;13323;3552;12338;770;2876;2146;7645;2916;10521
310460;201301;1385;4718;1234;4450;528;2033;295;1129;823;3162
310470;201301;3612;9878;3098;9247;335;1213;2459;7275;2794;8488
310480;201301;951;3139;863;2993;248;984;376;1230;624;2214
310490;201301;3096;10898;2690;10090;933;3725;929;3574;1862;7299
310500;201301;1367;4987;1291;4842;469;1878;465;1755;934;3633
310510;201301;2405;8162;2144;7582;899;3459;498;1654;1397;5113
310520;201301;1219;3647;1114;3475;81;292;760;2370;841;2662
310530;201301;747;2517;524;1926;131;539;88;300;219;839
310540;201301;3547;12063;3323;11750;1227;4598;1214;4378;2441;8976
310550;201301;1015;3406;883;3180;349;1401;264;908;613;2309
310560;201301;14982;49015;13248;45662;4622;17609;4611;15242;9233;32851
310570;201301;1206;3935;1142;3848;193;749;820;2713;1013;3462
310590;201301;3815;11781;3138;10452;781;2993;1134;3576;1915;6569
310600;201301;1581;5443;1521;5300;537;2095;524;1712;1061;3807
310610;201301;516;1812;474;1719;175;737;159;523;334;1260
310620;201301;183150;608564;153402;546519;49999;195219;56686;195285;106685;390504
310630;201301;3805;13256;3626;12908;1104;4318;1940;6711;3044;11029
310640;201301;1267;4293;1132;4019;374;1446;407;1370;781;2816
310650;201301;2629;9417;2263;8823;501;2087;1320;5347;1821;7434
310660;201301;1238;4052;1117;3881;230;912;763;2582;993;3494
310665;201301;1074;3575;1005;3483;209;773;643;2258;852;3031
310670;201301;52967;173390;50001;166576;16327;57667;22701;74238;39028;131905
310680;201301;780;2436;720;2340;168;601;405;1276;573;1877
310690;201301;1108;3936;943;3569;287;1281;242;845;529;2126
310700;201301;464;1345;404;1252;93;325;208;624;301;949
310710;201301;6796;23418;5794;22063;1488;5904;3120;12571;4608;18475
310720;201301;781;2528;729;2449;233;861;367;1177;600;2038
310730;201301;8801;29495;8274;28699;1859;6973;5237;18288;7096;25261
310740;201301;4614;16478;4093;15395;1785;7254;921;3282;2706;10536
310750;201301;1421;4041;1240;3778;280;924;734;2254;1014;3178
310760;201301;591;1935;524;1828;167;629;200;678;367;1307
310770;201301;662;2560;656;2550;236;984;322;1239;558;2223
310780;201301;3418;10463;3208;10149;271;787;2729;8798;3000;9585
310790;201301;1590;5414;1504;5290;486;1760;784;2850;1270;4610
310800;201301;3019;10247;2557;9320;1151;4555;478;1766;1629;6321
310810;201301;1489;4292;1406;4160;293;968;811;2364;1104;3332
310820;201301;1396;4211;1090;3710;354;1335;415;1363;769;2698
310825;201301;2107;7835;1827;7329;186;913;1349;5407;1535;6320
310830;201301;1461;5142;1251;4704;499;2008;471;1755;970;3763
310840;201301;2106;7363;1961;7072;758;2992;645;2220;1403;5212
310850;201301;1392;4544;1229;4315;273;1059;724;2533;997;3592
310855;201301;2880;9886;2646;9479;812;3021;1274;4802;2086;7823
310860;201301;7461;24522;6818;23450;1212;4478;4118;14494;5330;18972
310870;201301;932;2986;847;2826;186;702;453;1526;639;2228
310880;201301;1203;3875;921;3332;205;840;443;1613;648;2453
310890;201301;2525;8421;2058;7525;710;2870;376;1319;1086;4189
310900;201301;3903;13916;3557;13186;1156;4723;1477;5327;2633;10050
310910;201301;1714;5453;1412;4944;459;1789;499;1730;958;3519
310920;201301;1697;5636;1445;5278;439;1792;694;2487;1133;4279
310925;201301;877;3023;798;2882;332;1292;220;813;552;2105
310930;201301;4677;15491;4266;14850;1066;3789;2472;8823;3538;12612
310940;201301;6004;18697;5309;17622;971;3749;3194;10391;4165;14140
310945;201301;1270;3777;1040;3459;245;941;582;1889;827;2830
310950;201301;1678;6096;1486;5705;696;2864;391;1453;1087;4317
310960;201301;424;1499;383;1420;146;595;121;448;267;1043
310970;201301;1433;5184;1125;4323;466;1920;163;603;629;2523
310980;201301;429;1175;316;971;67;242;138;385;205;627
310990;201301;1065;3815;943;3570;231;1017;368;1295;599;2312
311000;201301;4616;16665;4181;15749;1396;5781;1523;5573;2919;11354
311010;201301;890;2999;789;2817;230;873;383;1346;613;2219
311020;201301;849;2774;736;2575;87;359;511;1774;598;2133
311030;201301;1629;5344;1396;4828;477;1809;535;1679;1012;3488
311040;201301;448;1615;420;1545;154;600;128;453;282;1053
311050;201301;2403;8070;2025;7272;735;2862;684;2462;1419;5324
311060;201301;2035;6728;1740;6074;559;2094;419;1451;978;3545
311070;201301;1678;6156;1486;5743;487;2108;456;1746;943;3854
311080;201301;1197;3351;1086;3189;173;596;731;2154;904;2750
311090;201301;1548;6159;1372;5793;521;2461;328;1332;849;3793
311100;201301;2115;7752;1961;7447;966;3788;536;2083;1502;5871
311110;201301;3536;9057;2761;8034;663;2211;1491;4190;2154;6401
311115;201301;1057;3433;922;3224;131;549;626;2215;757;2764
311120;201301;8002;24720;7020;22960;2591;9523;2194;6704;4785;16227
311130;201301;2324;7341;1919;6838;711;2823;787;2739;1498;5562
311140;201301;1148;3541;1006;3381;200;774;681;2226;881;3000
311150;201301;2307;7799;2135;7527;527;1874;1185;4349;1712;6223
311160;201301;4656;16376;4030;15385;1572;6360;1418;5417;2990;11777
311170;201301;683;2277;589;2084;84;330;352;1293;436;1623
311180;201301;1497;4295;1090;3476;363;1266;218;607;581;1873
311190;201301;1061;3335;922;3048;229;849;462;1506;691;2355
311200;201301;2415;7697;2178;7238;1015;3648;513;1551;1528;5199
311205;201301;1125;3866;1025;3681;267;1092;402;1510;669;2602
311210;201301;902;3047;844;2949;128;452;632;2255;760;2707
311220;201301;851;2880;726;2601;205;766;239;847;444;1613
311230;201301;8395;26733;7414;25071;1606;6034;4135;14204;5741;20238
311240;201301;1267;4096;1121;3857;408;1577;360;1196;768;2773
311250;201301;1271;4411;1158;4214;381;1499;375;1277;756;2776
311260;201301;2795;7932;2154;6787;694;2404;686;2049;1380;4453
311265;201301;1205;3439;971;3132;155;625;675;2143;830;2768
311270;201301;3180;11156;2921;10813;643;2656;1901;7049;2544;9705
311280;201301;1308;3763;1037;3312;310;1122;345;1078;655;2200
311290;201301;2250;7566;2116;7290;381;1309;1301;4683;1682;5992
311300;201301;4951;17251;4587;16714;626;2598;3296;12108;3922;14706
311310;201301;486;1786;467;1752;108;501;204;707;312;1208
311320;201301;3869;13542;3402;12481;1126;4661;1197;4183;2323;8844
311330;201301;5196;16672;4598;15774;1634;6060;1870;6360;3504;12420
311340;201301;12041;40701;11316;39331;4678;17347;3137;10996;7815;28343
311350;201301;2098;6737;1861;6329;464;1882;855;2769;1319;4651
311360;201301;1291;3769;1030;3413;485;1703;287;982;772;2685
311370;201301;4275;13491;3918;12870;1106;4303;1710;5473;2816;9776
311380;201301;447;1528;384;1405;135;537;116;397;251;934
311390;201301;1876;7272;1804;7119;825;3522;634;2475;1459;5997
311400;201301;1631;5698;1522;5502;506;2052;636;2123;1142;4175
311410;201301;1922;7184;1810;7020;729;3031;775;2991;1504;6022
311420;201301;2110;7679;1962;7320;785;3095;426;1441;1211;4536
311430;201301;3498;11627;2839;10152;759;2971;612;2137;1371;5108
311440;201301;2001;7411;1744;7015;845;3675;409;1654;1254;5329
311450;201301;2362;8716;2132;8199;932;3831;607;2241;1539;6072
311455;201301;1451;4064;1291;3826;246;887;735;2097;981;2984
311460;201301;571;1962;464;1730;138;613;116;418;254;1031
311470;201301;537;1791;463;1649;154;631;164;564;318;1195
311480;201301;736;2248;719;2220;225;742;356;1045;581;1787
311490;201301;298;1242;289;1208;103;448;100;428;203;876
311500;201301;467;1492;382;1316;194;723;75;248;269;971
311510;201301;2915;9508;2491;8718;1052;4025;650;2182;1702;6207
311520;201301;657;2327;630;2272;256;992;259;906;515;1898
311530;201301;9240;26598;6696;21861;2271;8634;1712;5331;3983;13965
311535;201301;620;2028;488;1750;146;588;121;432;267;1020
311540;201301;668;2546;642;2507;232;939;310;1199;542;2138
311545;201301;1862;6492;1814;6413;386;1468;1172;4184;1558;5652
311547;201301;1620;4720;1424;4420;167;564;986;3099;1153;3663
311550;201301;3038;10693;2787;10217;1086;4426;877;3161;1963;7587
311560;201301;239;700;224;683;63;207;121;360;184;567
311570;201301;1819;4971;1606;4744;145;480;1376;4063;1521;4543
311580;201301;1935;4960;1810;4812;480;1284;1050;2851;1530;4135
311590;201301;333;1142;299;1094;108;451;98;342;206;793
311600;201301;1242;3934;1077;3725;247;834;633;2359;880;3193
311610;201301;3692;13135;3463;12782;899;3270;1917;7640;2816;10910
311615;201301;2303;8287;2132;7998;286;1153;1566;5981;1852;7134
311620;201301;403;1394;364;1334;87;390;197;691;284;1081
311630;201301;1438;4425;1263;4082;126;499;890;2845;1016;3344
311640;201301;708;2415;675;2364;102;394;521;1804;623;2198
311650;201301;2334;6938;1999;6401;341;1267;1157;3709;1498;4976
311660;201301;2342;8734;2222;8483;746;3213;682;2319;1428;5532
311670;201301;1210;4041;1087;3809;429;1659;388;1287;817;2946
311680;201301;2167;7168;1864;6774;294;1120;1334;4983;1628;6103
311690;201301;472;1434;415;1375;96;349;257;837;353;1186
311700;201301;2060;6333;1876;6068;224;894;1434;4567;1658;5461
311710;201301;1480;4925;1227;4457;505;1950;380;1424;885;3374
311720;201301;368;1295;354;1274;42;162;269;956;311;1118
311730;201301;2955;9759;2652;9287;909;3442;1199;4089;2108;7531
311740;201301;985;2945;863;2800;374;1195;398;1365;772;2560
311750;201301;3604;12769;3426;12541;619;2514;2337;8580;2956;11094
311760;201301;744;2692;698;2575;268;1133;197;600;465;1733
311770;201301;2532;8287;2160;7683;673;2692;762;2647;1435;5339
311780;201301;861;3423;755;3147;317;1460;86;345;403;1805
311783;201301;1951;6735;1784;6414;220;967;1154;4248;1374;5215
311787;201301;677;2374;543;2009;128;506;140;486;268;992
311790;201301;1027;3588;886;3278;301;1197;162;568;463;1765
311800;201301;4595;16584;4137;15369;1478;5828;770;2484;2248;8312
311810;201301;988;3401;968;3368;36;171;891;3065;927;3236
311820;201301;761;2597;679;2433;259;1061;285;920;544;1981
311830;201301;9814;36651;9300;35374;4092;16305;2514;9480;6606;25785
311840;201301;3250;10196;2781;9473;979;3640;1015;3448;1994;7088
311850;201301;291;949;254;895;47;176;171;615;218;791
311860;201301;52398;176257;47483;166578;15344;58572;20072;68683;35416;127255
311870;201301;2179;6880;1882;6360;524;1996;785;2596;1309;4592
311880;201301;6365;21246;6016;20802;867;3173;4513;15915;5380;19088
311890;201301;1532;5069;1330;4661;443;1696;535;1824;978;3520
311900;201301;765;2478;695;2379;178;619;396;1428;574;2047
311910;201301;4500;13939;3721;12841;1225;4608;1505;5242;2730;9850
311920;201301;1881;6580;1676;6300;275;1182;1172;4326;1447;5508
311930;201301;4543;14300;4181;13713;1625;5778;1443;4743;3068;10521
311940;201301;13654;44087;12389;41542;4682;16933;3757;12551;8439;29484
311950;201301;2052;6643;1857;6387;166;615;1524;5270;1690;5885
311960;201301;322;1218;313;1204;117;466;148;568;265;1034
311970;201301;442;1665;396;1568;167;714;57;203;224;917
311980;201301;708;2089;567;1895;145;514;275;948;420;1462
311990;201301;443;1432;414;1380;184;627;149;497;333;1124
311995;201301;954;3027;775;2643;268;1043;258;762;526;1805
312000;201301;664;2168;639;2130;120;466;390;1288;510;1754
312010;201301;975;3301;912;3187;221;847;435;1517;656;2364
312015;201301;1525;5011;1346;4703;240;985;809;2847;1049;3832
312020;201301;848;2898;761;2772;243;982;358;1266;601;2248
312030;201301;1595;5391;1477;5230;243;1053;1048;3596;1291;4649
312040;201301;657;2614;611;2483;252;1097;170;685;422;1782
312050;201301;1460;5173;1288;4815;483;1995;361;1287;844;3282
312060;201301;752;2374;689;2297;229;837;371;1197;600;2034
312070;201301;764;2590;579;2169;195;797;206;749;401;1546
312080;201301;2481;7290;2017;6554;573;2290;885;2599;1458;4889
312083;201301;840;2625;727;2469;81;333;493;1666;574;1999
312087;201301;2202;7174;1997;6915;387;1375;1389;4933;1776;6308
312090;201301;9295;31439;8645;30315;2575;10219;3987;13417;6562;23636
312100;201301;1313;4652;1191;4470;255;1089;674;2581;929;3670
312110;201301;1171;4370;1073;4173;444;1878;234;863;678;2741
312120;201301;868;3091;790;2917;277;1183;226;734;503;1917
312125;201301;978;3343;884;3121;260;1002;323;1090;583;2092
312130;201301;646;2140;552;1953;191;728;196;677;387;1405
312140;201301;1416;4580;1221;4121;334;1182;441;1425;775;2607
312150;201301;594;1758;530;1651;112;410;308;921;420;1331
312160;201301;7481;27263;7046;26408;2337;9412;2920;11310;5257;20722
312170;201301;989;3114;921;2981;172;598;564;1866;736;2464
312180;201301;1486;4926;1433;4847;560;1944;567;1987;1127;3931
312190;201301;545;1957;469;1808;209;836;135;528;344;1364
312200;201301;4161;13819;3713;12951;615;2298;2381;8421;2996;10719
312210;201301;1060;3134;884;2892;231;852;455;1450;686;2302
312220;201301;1700;5894;1572;5740;305;1113;1080;4170;1385;5283
312230;201301;16647;58051;14635;53906;7294;28418;2610;9986;9904;38404
312235;201301;1675;5006;1385;4543;173;729;959;3144;1132;3873
312240;201301;1067;3775;942;3519;303;1202;332;1254;635;2456
312245;201301;2276;6956;2025;6607;181;531;1678;5633;1859;6164
312247;201301;844;2658;687;2429;203;764;366;1339;569;2103
312250;201301;1057;3365;993;3265;204;802;598;1923;802;2725
312260;201301;866;2994;765;2863;118;533;546;2017;664;2550
312270;201301;757;2512;664;2324;197;824;204;602;401;1426
312280;201301;455;1617;418;1520;179;698;52;190;231;888
312290;201301;675;2470;633;2413;317;1328;114;428;431;1756
312300;201301;1028;3542;899;3246;330;1264;138;450;468;1714
312310;201301;880;3525;802;3320;283;1260;304;1248;587;2508
312320;201301;2288;6664;2035;6252;645;2306;811;2209;1456;4515
312330;201301;975;3274;953;3234;370;1375;365;1227;735;2602
312340;201301;284;790;270;772;38;139;213;588;251;727
312350;201301;341;955;329;938;50;168;266;728;316;896
312352;201301;1549;5354;1459;5218;556;2055;692;2527;1248;4582
312360;201301;3404;12093;3060;11383;1128;4497;709;2638;1837;7135
312370;201301;1531;5302;1422;5105;486;1964;571;2002;1057;3966
312380;201301;1830;5691;1743;5566;292;1022;1176;3818;1468;4840
312385;201301;1103;3774;1082;3743;151;635;817;2759;968;3394
312390;201301;1864;6675;1729;6401;657;2606;468;1687;1125;4293
312400;201301;3133;11011;2980;10699;1004;3729;1445;5292;2449;9021
312410;201301;9683;34086;8911;32498;3096;12307;2920;10367;6016;22674
312420;201301;3709;12652;3563;12480;683;2494;2521;8996;3204;11490
312430;201301;8119;25455;7216;24121;1541;5340;4427;15440;5968;20780
312440;201301;477;1683;421;1571;162;639;132;486;294;1125
312450;201301;1062;4147;1015;4025;499;1950;316;1297;815;3247
312460;201301;372;1212;335;1170;98;395;140;451;238;846
312470;201301;689;2062;496;1665;146;568;94;298;240;866
312480;201301;1197;3968;1064;3804;430;1610;412;1468;842;3078
312490;201301;2229;6057;1813;5529;340;1228;1059;3116;1399;4344
312500;201301;546;2063;516;2006;150;646;272;1047;422;1693
312510;201301;1674;6193;1505;5792;484;2093;430;1498;914;3591
312520;201301;354;1277;330;1229;125;490;109;411;234;901
312530;201301;526;1822;503;1773;120;486;248;832;368;1318
312540;201301;1429;4849;1223;4437;236;959;740;2662;976;3621
312550;201301;564;2037;540;1988;80;340;372;1362;452;1702
312560;201301;1731;5422;1640;5290;260;837;1168;3914;1428;4751
312570;201301;2583;8283;2306;7766;792;2892;669;2168;1461;5060
312580;201301;528;1839;428;1639;137;582;176;657;313;1239
312590;201301;1756;6283;1555;5830;562;2342;512;1805;1074;4147
312595;201301;1996;7057;1838;6700;348;1370;1158;4198;1506;5568
312600;201301;725;2777;690;2691;244;1050;232;846;476;1896
312610;201301;8025;26283;7085;24426;2803;10317;2032;6881;4835;17198
312620;201301;1715;5605;1423;5224;51;139;1279;4860;1330;4999
312630;201301;478;1674;448;1620;124;516;191;655;315;1171
312640;201301;531;1830;464;1702;125;534;224;781;349;1315
312650;201301;2209;6897;1637;5797;173;744;866;2995;1039;3739
312660;201301;1151;3402;1005;3202;233;845;558;1735;791;2580
312670;201301;5716;18928;5457;18521;823;3171;4004;13593;4827;16764
312675;201301;1418;4724;1301;4495;278;1033;757;2696;1035;3729
312680;201301;1613;5146;1466;4873;326;1209;825;2776;1151;3985
312690;201301;2240;6581;1941;6182;397;1530;1150;3490;1547;5020
312695;201301;846;3155;800;3080;142;570;534;2107;676;2677
312700;201301;2012;6154;1599;5392;389;1466;781;2589;1170;4055
312705;201301;1298;4095;1161;3910;231;791;760;2608;991;3399
312707;201301;1773;5718;1524;5289;394;1536;716;2482;1110;4018
312710;201301;7430;22195;5824;19329;2452;8969;1407;4387;3859;13356
312720;201301;725;2503;661;2385;200;792;259;875;459;1667
312730;201301;1689;4722;1390;4378;275;1033;832;2588;1107;3621
312733;201301;1660;4687;1375;4160;145;546;945;2765;1090;3311
312735;201301;797;2660;716;2517;269;998;306;1054;575;2052
312737;201301;929;2372;693;2063;158;504;374;1148;532;1652
312738;201301;477;1580;395;1428;144;603;145;472;289;1075
312740;201301;464;1368;336;1227;141;560;124;448;265;1008
312750;201301;1243;4757;1198;4661;346;1465;573;2240;919;3705
312760;201301;2256;7706;1864;6957;681;2776;442;1695;1123;4471
312770;201301;40159;115859;32270;104606;10667;37462;10751;35296;21418;72758
312780;201301;2212;8824;2056;8564;429;1882;1281;5531;1710;7413
312790;201301;287;869;239;791;82;290;63;202;145;492
312800;201301;4692;17037;4267;16105;1479;5911;1398;5481;2877;11392
312810;201301;2126;6766;1696;6125;756;2995;530;1866;1286;4861
312820;201301;1987;6309;1910;6176;279;1071;1252;3931;1531;5002
312825;201301;1416;4085;1274;3908;141;503;1018;3076;1159;3579
312830;201301;2474;8279;1895;7135;654;2774;266;929;920;3703
312840;201301;1006;3605;892;3397;297;1256;271;966;568;2222
312850;201301;666;2304;598;2159;183;734;208;750;391;1484
312860;201301;1276;3817;1013;3456;370;1482;416;1270;786;2752
312870;201301;5236;17237;4230;15477;1572;6494;1317;4645;2889;11139
312880;201301;976;3142;856;2953;317;1218;342;1085;659;2303
312890;201301;1442;4698;1157;4178;448;1804;313;1082;761;2886
312900;201301;1256;4474;1225;4430;467;1716;561;2083;1028;3799
312910;201301;1377;3433;1186;3191;355;1164;585;1464;940;2628
312920;201301;861;3027;761;2873;271;1083;299;1164;570;2247
312930;201301;2043;6453;1863;6180;452;1607;990;3360;1442;4967
312940;201301;879;3111;793;2936;278;1166;241;851;519;2017
312950;201301;2937;9139;2605;8660;937;3341;1147;3833;2084;7174
312960;201301;1827;5828;1649;5587;219;743;1219;4251;1438;4994
312965;201301;1650;5628;1468;5303;361;1398;816;3019;1177;4417
312970;201301;1092;3846;982;3698;464;1938;152;581;616;2519
312980;201301;19417;71346;18886;70038;7809;30817;6884;25049;14693;55866
312990;201301;304;1003;250;918;103;418;70;251;173;669
313000;201301;463;1709;437;1663;168;734;116;415;284;1149
313005;201301;2407;8285;2163;7878;317;1341;1509;5457;1826;6798
313010;201301;3650;12810;3303;12209;1099;4500;1280;4433;2379;8933
313020;201301;1005;3458;934;3319;321;1315;357;1112;678;2427
313030;201301;1513;4444;1249;4065;347;1289;663;2054;1010;3343
313040;201301;908;3301;778;2916;198;830;200;699;398;1529
313050;201301;1717;5968;1477;5578;563;2323;407;1477;970;3800
313055;201301;1344;4766;1268;4652;121;443;981;3719;1102;4162
313060;201301;880;3196;841;3110;412;1575;161;604;573;2179
313065;201301;1805;6323;1705;6176;214;917;1334;4784;1548;5701
313070;201301;1093;3471;944;3201;260;1041;490;1561;750;2602
313080;201301;432;1465;364;1330;129;534;96;304;225;838
313090;201301;4511;15103;4371;14880;1134;3970;2640;9286;3774;13256
313100;201301;949;3271;899;3210;189;783;583;1989;772;2772
313110;201301;1589;4990;1299;4443;370;1473;506;1623;876;3096
313115;201301;2768;10262;2661;10047;981;4079;1095;3942;2076;8021
313120;201301;3576;10884;3154;10302;1151;3957;1436;4766;2587;8723
313130;201301;24953;83041;23162;79199;7322;27795;8625;28061;15947;55856
313140;201301;728;1982;540;1676;66;252;317;962;383;1214
313150;201301;1539;5032;1436;4838;685;2394;359;1247;1044;3641
313160;201301;1107;3518;1003;3358;295;1120;523;1691;818;2811
313170;201301;9037;34889;8654;33876;3826;15410;1883;7592;5709;23002
313180;201301;2535;6997;2009;6324;689;2432;677;2115;1366;4547
313190;201301;3150;12219;3073;12038;1125;4657;1151;4504;2276;9161
313200;201301;1396;4645;1265;4424;216;937;777;2699;993;3636
313210;201301;4405;14657;3804;13847;749;3123;2365;8545;3114;11668
313220;201301;1048;3472;919;3204;301;1200;215;658;516;1858
313230;201301;2305;8628;2222;8492;417;1661;1417;5677;1834;7338
313240;201301;6921;25605;6217;24208;2070;8723;2421;9454;4491;18177
313250;201301;7482;24644;7054;24120;806;2625;5478;19604;6284;22229
313260;201301;545;1836;488;1727;173;685;142;492;315;1177
313270;201301;5076;16158;4664;15536;1152;4072;2724;9291;3876;13363
313280;201301;504;1773;437;1612;118;500;164;591;282;1091
313290;201301;1006;3791;872;3525;343;1485;214;836;557;2321
313300;201301;1829;6540;1682;6198;557;2208;529;1857;1086;4065
313310;201301;1340;5014;1259;4836;524;2169;295;1100;819;3269
313320;201301;2280;7381;1991;6881;347;1269;1089;3850;1436;5119
313330;201301;3876;13523;3599;13014;848;3380;1843;6728;2691;10108
313340;201301;2055;5101;1621;4483;348;1071;942;2530;1290;3601
313350;201301;3192;10352;2565;8976;892;3432;579;1894;1471;5326
313360;201301;1107;3585;879;3116;328;1339;333;1062;661;2401
313370;201301;1362;4978;1321;4868;291;1249;640;2225;931;3474
313375;201301;1729;4842;1231;4179;294;1232;610;2015;904;3247
313380;201301;6192;22267;5508;20742;2401;9582;1347;4841;3748;14423
313390;201301;845;3276;808;3207;165;761;468;1834;633;2595
313400;201301;3515;11181;3279;10894;450;1582;2469;8325;2919;9907
313410;201301;1310;3957;1139;3732;244;878;712;2335;956;3213
313420;201301;17397;45808;11916;35723;3176;10843;3236;9317;6412;20160
313430;201301;1237;4263;1127;4066;379;1492;421;1517;800;3009
313440;201301;5814;14880;4603;13500;852;2682;3232;9511;4084;12193
313450;201301;664;2072;571;1897;177;705;184;545;361;1250
313460;201301;2564;9468;2358;9129;940;3891;761;2868;1701;6759
313470;201301;3309;9593;3165;9426;326;999;2628;7910;2954;8909
313480;201301;1081;3349;843;2913;204;795;333;1112;537;1907
313490;201301;1114;4368;1027;4139;473;1862;169;736;642;2598
313500;201301;411;1368;392;1337;102;392;223;749;325;1141
313505;201301;7622;24148;7235;23653;588;1613;6218;21112;6806;22725
313507;201301;1257;3996;1148;3829;279;1055;652;2190;931;3245
313510;201301;14875;46663;13458;44853;2750;9733;8727;29576;11477;39309
313520;201301;15073;48097;13397;45569;2007;7913;9214;31325;11221;39238
313530;201301;488;1775;436;1636;74;317;173;609;247;926
313535;201301;2370;7500;2163;7162;370;1354;1377;4599;1747;5953
313540;201301;1109;3602;939;3204;286;1049;271;880;557;1929
313545;201301;1320;5095;1200;4898;235;1144;766;3059;1001;4203
313550;201301;1820;6584;1780;6496;536;2130;948;3346;1484;5476
313560;201301;2169;5754;1969;5522;193;525;1610;4643;1803;5168
313570;201301;731;2872;662;2732;256;1128;275;1122;531;2250
313580;201301;5770;17577;5238;16887;527;1799;4244;13816;4771;15615
313590;201301;1024;3242;861;3053;294;1028;501;1868;795;2896
313600;201301;3727;11846;3349;11227;727;2704;1936;6520;2663;9224
313610;201301;1057;3511;939;3266;275;1033;362;1256;637;2289
313620;201301;7304;25155;6921;24319;2501;9362;2261;7815;4762;17177
313630;201301;7850;26135;7022;24935;2551;9852;2258;8334;4809;18186
313640;201301;812;2717;732;2614;270;1032;296;1066;566;2098
313650;201301;2246;7630;2032;7292;313;1161;1484;5478;1797;6639
313652;201301;926;3580;875;3459;201;834;493;1954;694;2788
313655;201301;898;3232;788;3060;187;820;498;1908;685;2728
313657;201301;1044;3751;1009;3688;189;890;662;2227;851;3117
313660;201301;826;3019;770;2924;222;979;386;1382;608;2361
313665;201301;3396;11813;3220;11460;969;3856;1379;4747;2348;8603
313670;201301;48944;149107;36509;128767;13226;50817;11241;38688;24467;89505
313680;201301;1046;3242;932;3078;111;390;688;2303;799;2693
313690;201301;816;3037;768;2957;257;995;310;1261;567;2256
313695;201301;1461;4996;1281;4715;213;927;898;3242;1111;4169
313700;201301;3642;12953;3182;12289;469;1941;2314;9007;2783;10948
313710;201301;1324;3945;1154;3703;321;1144;647;2004;968;3148
313720;201301;4783;16988;4329;15980;1341;5547;1308;4327;2649;9874
313730;201301;1202;3543;1011;3292;143;505;705;2339;848;2844
313740;201301;1931;7265;1614;6412;658;2899;259;1000;917;3899
313750;201301;2793;8898;2517;8388;864;3164;693;2153;1557;5317
313753;201301;1731;5493;1532;5141;496;1791;691;2332;1187;4123
313760;201301;3967;14108;3660;13486;1401;5681;1220;4269;2621;9950
313770;201301;3613;12577;3463;12224;1295;4815;1041;3712;2336;8527
313780;201301;3561;10884;2955;9995;984;3707;1183;3952;2167;7659
313790;201301;551;1972;534;1944;108;428;317;1165;425;1593
313800;201301;1174;3529;1084;3392;181;667;743;2299;924;2966
313810;201301;1333;4463;1285;4387;383;1364;639;2232;1022;3596
313820;201301;12246;37506;10183;33740;3538;13024;3093;10147;6631;23171
313830;201301;446;1612;385;1480;154;668;100;360;254;1028
313835;201301;1040;3635;1003;3571;255;966;541;1955;796;2921
313840;201301;6558;21238;5821;20035;1903;7297;2209;7439;4112;14736
313850;201301;1199;3542;1108;3386;197;720;719;2113;916;2833
313860;201301;2436;7976;2183;7450;740;2850;532;1636;1272;4486
313862;201301;861;2611;645;2250;236;887;172;568;408;1455
313865;201301;2053;6980;1938;6777;366;1433;1271;4395;1637;5828
313867;201301;934;3403;819;3170;241;963;389;1548;630;2511
313868;201301;1373;5199;1275;4987;272;1151;764;3016;1036;4167
313870;201301;895;2855;795;2690;221;877;362;1146;583;2023
313880;201301;2203;7264;2022;6998;519;2111;1014;3237;1533;5348
313890;201301;1927;5601;1676;5301;195;647;1251;4041;1446;4688
313900;201301;4388;16733;4189;16329;1824;7763;1103;4334;2927;12097
313910;201301;717;2534;622;2325;294;1192;130;460;424;1652
313920;201301;3455;11813;3264;11490;566;1922;2176;8100;2742;10022
313925;201301;2071;5696;1578;4795;147;520;1053;3178;1200;3698
313930;201301;5005;17269;4368;16169;876;3574;2538;9597;3414;13171
313940;201301;7342;27026;6545;25727;2939;12091;2153;8848;5092;20939
313950;201301;4364;13659;3906;12916;1207;4395;1553;5141;2760;9536
313960;201301;5417;16065;4832;15228;1808;6276;1380;4453;3188;10729
313970;201301;1390;4332;1200;4117;284;1060;723;2479;1007;3539
313980;201301;1134;3933;978;3630;323;1325;237;854;560;2179
313990;201301;1974;7689;1805;7329;719;3145;527;2040;1246;5185
314000;201301;7268;26701;6845;25876;2194;8967;3297;12465;5491;21432
314010;201301;1008;3120;860;2936;187;704;453;1535;640;2239
314015;201301;1554;6023;1443;5764;622;2614;391;1593;1013;4207
314020;201301;473;1591;413;1458;164;636;139;467;303;1103
314030;201301;792;2651;638;2289;177;771;180;562;357;1333
314040;201301;665;2109;610;2020;74;281;462;1520;536;1801
314050;201301;1817;6174;1565;5652;528;2105;407;1347;935;3452
314053;201301;1221;4475;1175;4417;232;825;846;3275;1078;4100
314055;201301;2116;6661;1939;6429;233;793;1442;4907;1675;5700
314060;201301;1023;3444;910;3231;146;625;547;1885;693;2510
314070;201301;3627;12212;3105;11164;1045;4131;970;3369;2015;7500
314080;201301;1686;5576;1346;4833;365;1517;353;1174;718;2691
314085;201301;1726;6584;1542;6337;552;2444;673;2810;1225;5254
314090;201301;3356;11983;3128;11537;989;3820;1311;5071;2300;8891
314100;201301;3138;9313;2800;8826;369;1295;2089;6616;2458;7911
314110;201301;4248;14554;3793;13595;1034;4277;1509;5037;2543;9314
314120;201301;895;2242;534;1711;222;808;124;363;346;1171
314130;201301;545;1785;398;1431;142;570;82;272;224;842
314140;201301;4781;15763;4418;15097;1176;4379;2357;8104;3533;12483
314150;201301;1631;4557;1329;4113;221;748;828;2561;1049;3309
314160;201301;2036;6197;1819;5925;250;894;1404;4575;1654;5469
314170;201301;988;3291;882;3053;199;811;447;1464;646;2275
314180;201301;6190;21266;5751;20626;1758;6791;2678;9837;4436;16628
314190;201301;772;2557;696;2428;222;867;276;930;498;1797
314200;201301;2895;9931;2680;9540;468;1916;1789;6263;2257;8179
314210;201301;1848;6247;1708;5963;468;1773;868;2938;1336;4711
314220;201301;1578;5500;1412;5144;485;1942;510;1686;995;3628
314225;201301;1098;3582;990;3429;60;190;891;3141;951;3331
314230;201301;672;2445;631;2362;220;885;221;795;441;1680
314240;201301;1055;3503;973;3367;171;579;653;2325;824;2904
314250;201301;469;1580;417;1484;146;596;170;568;316;1164
314260;201301;1247;4648;1205;4572;512;2050;432;1677;944;3727
314270;201301;2667;9653;2528;9395;403;1622;1627;6120;2030;7742
314280;201301;3034;9138;2315;7785;790;3037;618;1828;1408;4865
314290;201301;5138;15197;4507;14213;590;2056;3277;10363;3867;12419
314300;201301;1872;6604;1791;6418;602;2292;801;2854;1403;5146
314310;201301;6131;20676;5582;19444;2431;9000;1196;4049;3627;13049
314315;201301;937;3719;886;3614;178;806;494;2058;672;2864
314320;201301;3105;9946;2621;9271;1072;4087;767;2648;1839;6735
314330;201301;48657;167222;46978;164202;15710;59095;21946;76288;37656;135383
314340;201301;1833;5639;1270;4499;411;1648;178;463;589;2111
314345;201301;1261;4490;1143;4308;423;1623;520;2076;943;3699
314350;201301;1239;4079;1100;3837;493;1835;302;1074;795;2909
314360;201301;678;2283;541;2032;188;813;141;484;329;1297
314370;201301;525;1935;493;1893;165;691;251;947;416;1638
314380;201301;952;3153;796;2899;294;1114;311;1132;605;2246
314390;201301;14104;45206;12360;41997;4334;15894;4026;13604;8360;29498
314400;201301;5080;15136;4260;13965;999;3234;2791;9509;3790;12743
314410;201301;2419;8241;2206;7834;721;2898;927;3132;1648;6030
314420;201301;748;2306;637;2159;105;432;460;1521;565;1953
314430;201301;8071;25037;7337;23688;2599;9082;2399;8018;4998;17100
314435;201301;1066;3822;976;3626;258;1162;465;1618;723;2780
314437;201301;1111;2971;1011;2835;105;306;799;2252;904;2558
314440;201301;719;2033;499;1742;194;755;108;365;302;1120
314450;201301;1680;5223;1459;4905;487;1942;672;2104;1159;4046
314460;201301;4460;16040;4033;15109;1508;6121;792;3015;2300;9136
314465;201301;2317;7784;2140;7453;239;965;1649;5692;1888;6657
314467;201301;1026;3160;938;3013;436;1427;339;1118;775;2545
314470;201301;2280;7777;1817;6653;593;2475;399;1287;992;3762
314480;201301;6652;24049;5445;20745;1513;6221;595;2077;2108;8298
314490;201301;921;2958;809;2738;257;1008;325;1027;582;2035
314500;201301;2678;7928;2194;6972;711;2541;718;2248;1429;4789
314505;201301;1580;5375;1512;5241;392;1487;808;2762;1200;4249
314510;201301;1337;4528;1196;4261;541;2021;364;1283;905;3304
314520;201301;3438;14037;3030;12827;1251;5687;593;2391;1844;8078
314530;201301;6940;25939;6410;25059;1348;5473;3739;15253;5087;20726
314535;201301;2589;7828;2342;7504;381;1410;1566;5024;1947;6434
314537;201301;1404;4491;1214;4158;274;1031;639;2292;913;3323
314540;201301;450;1426;397;1303;129;486;116;351;245;837
314545;201301;1234;4242;1155;4111;247;958;677;2441;924;3399
314550;201301;497;1638;429;1544;168;706;119;402;287;1108
314560;201301;5061;18722;4422;17002;1429;5952;865;3316;2294;9268
314570;201301;373;1210;338;1140;103;373;157;504;260;877
314580;201301;443;1594;385;1479;167;703;89;323;256;1026
314585;201301;558;2190;507;2094;184;824;126;522;310;1346
314587;201301;1616;5537;1532;5349;273;1039;935;3250;1208;4289
314590;201301;3718;13554;3029;11690;875;3614;406;1448;1281;5062
314600;201301;1917;6870;1612;6326;650;2827;255;933;905;3760
314610;201301;7745;29036;7363;28138;2743;11264;2181;8177;4924;19441
314620;201301;1593;5089;1495;4967;240;780;1099;3767;1339;4547
314625;201301;1304;4525;1288;4499;270;887;883;3298;1153;4185
314630;201301;4846;15075;4276;14117;574;2176;3015;10077;3589;12253
314640;201301;790;2397;713;2261;264;913;219;653;483;1566
314650;201301;1197;3850;1002;3460;293;1185;407;1265;700;2450
314655;201301;1645;5255;1368;4763;250;1005;782;2692;1032;3697
314660;201301;128;413;122;401;20;72;85;283;105;355
314670;201301;1311;3922;1107;3567;269;977;518;1632;787;2609
314675;201301;1843;5877;1676;5582;227;825;1117;3796;1344;4621
314690;201301;2675;8813;2313;8177;782;3134;726;2429;1508;5563
314700;201301;9638;37863;8837;36224;4374;18558;2081;9097;6455;27655
314710;201301;6876;24038;5477;20801;1643;6962;762;2705;2405;9667
314720;201301;2509;8796;2157;8110;771;3165;898;3317;1669;6482
314730;201301;2290;7623;2018;7220;709;2814;621;2138;1330;4952
314740;201301;2857;10149;2670;9792;928;3655;1036;3727;1964;7382
314750;201301;307;1063;291;1029;63;272;160;538;223;810
314760;201301;1925;7093;1560;6098;397;1781;265;885;662;2666
314770;201301;1178;3883;861;3022;185;742;108;303;293;1045
314780;201301;278;822;217;745;78;298;87;300;165;598
314790;201301;12907;41059;10088;36006;4269;17111;2377;8022;6646;25133
314795;201301;1417;4657;1284;4450;176;780;942;3139;1118;3919
314800;201301;16392;51959;14085;47404;6073;21486;2937;10187;9010;31673
314810;201301;12231;39007;9926;34737;3535;13866;2538;8789;6073;22655
314820;201301;1025;3012;754;2655;331;1275;246;785;577;2060
314830;201301;1585;5683;1403;5317;542;2236;453;1725;995;3961
314840;201301;1116;4039;898;3711;192;888;526;2201;718;3089
314850;201301;2149;6542;1893;6150;402;1511;1068;3467;1470;4978
314860;201301;3151;11504;2983;11251;610;2485;1911;7298;2521;9783
314870;201301;5445;18548;4932;17818;923;3691;3191;11801;4114;15492
314875;201301;1645;5827;1620;5790;309;1045;1248;4580;1557;5625
314880;201301;710;2301;657;2188;177;605;329;1112;506;1717
314890;201301;550;1770;416;1498;182;726;101;314;283;1040
314900;201301;322;1095;279;1021;90;349;128;459;218;808
314910;201301;1652;5983;1490;5723;708;2936;356;1294;1064;4230
314915;201301;2332;7606;2109;7308;209;894;1726;5919;1935;6813
314920;201301;552;1789;491;1717;106;430;247;827;353;1257
314930;201301;4790;17014;4260;15847;1639;6650;843;3154;2482;9804
314940;201301;394;1214;376;1180;83;260;210;656;293;916
314950;201301;338;1275;296;1180;92;425;52;191;144;616
314960;201301;725;2481;632;2307;222;887;204;723;426;1610
314970;201301;781;2974;743;2917;345;1436;233;909;578;2345
314980;201301;2157;6807;1996;6554;910;3222;330;1053;1240;4275
314990;201301;2845;9637;2407;8650;1060;4133;360;1178;1420;5311
314995;201301;1411;4801;1318;4658;304;1289;805;2697;1109;3986
315000;201301;946;3072;850;2948;183;746;523;1754;706;2500
315010;201301;449;1545;393;1422;141;599;140;443;281;1042
315015;201301;1664;5468;1597;5393;353;1257;1097;3802;1450;5059
315020;201301;717;2503;656;2385;213;879;241;789;454;1668
315030;201301;988;3139;859;2896;359;1311;169;566;528;1877
315040;201301;898;2880;830;2766;118;449;584;1910;702;2359
315050;201301;1476;4676;1289;4353;517;1922;359;1151;876;3073
315053;201301;1045;3315;922;3114;278;1120;357;1127;635;2247
315057;201301;1843;6689;1540;6240;245;1006;1038;4404;1283;5410
315060;201301;927;3241;795;2891;265;1047;206;770;471;1817
315070;201301;582;1805;542;1746;144;506;329;1038;473;1544
315080;201301;3330;12038;3110;11606;959;3830;1385;5194;2344;9024
315090;201301;735;2720;664;2579;211;890;249;1009;460;1899
315100;201301;1116;4041;922;3596;287;1275;274;1037;561;2312
315110;201301;1495;4749;1341;4505;407;1463;566;1894;973;3357
315120;201301;11342;30648;9277;28035;1869;6216;5402;17033;7271;23249
315130;201301;1686;5823;1553;5564;619;2435;433;1512;1052;3947
315140;201301;2115;7449;1808;6773;592;2488;458;1501;1050;3989
315150;201301;4165;12139;3385;10785;908;3365;1306;3919;2214;7284
315160;201301;1294;3806;1186;3676;226;794;788;2387;1014;3181
315170;201301;1290;4040;1151;3858;303;1132;677;2302;980;3434
315180;201301;11830;39199;9924;35149;3244;13074;2609;8866;5853;21940
315190;201301;2266;6379;1862;5794;587;1973;835;2601;1422;4574
315200;201301;3976;14087;3538;13189;1200;4891;1028;3720;2228;8611
315210;201301;7935;25907;7121;24481;2936;10864;2111;7138;5047;18002
315213;201301;1007;3484;970;3425;147;528;704;2552;851;3080
315217;201301;2544;9120;2244;8580;420;1786;1357;5201;1777;6987
315220;201301;9697;30020;8790;28844;1190;4397;6378;21071;7568;25468
315230;201301;2208;6336;2082;6188;94;264;1858;5610;1952;5874
315240;201301;2966;10517;2840;10298;677;2630;1671;6069;2348;8699
315250;201301;7447;26013;6190;23763;2347;10035;1990;7588;4337;17623
315260;201301;1026;3595;907;3340;384;1552;159;545;543;2097
315270;201301;840;3077;734;2841;264;1089;153;550;417;1639
315280;201301;3649;11815;3139;10673;1212;4394;820;2663;2032;7057
315290;201301;1251;3737;997;3336;435;1617;150;484;585;2101
315300;201301;434;1331;353;1229;196;723;74;242;270;965
315310;201301;1141;4030;1083;3943;150;642;751;2695;901;3337
315320;201301;749;2791;672;2667;263;1075;270;1140;533;2215
315330;201301;805;3030;679;2757;278;1237;168;697;446;1934
315340;201301;3959;11945;3466;11184;641;2223;2123;6946;2764;9169
315350;201301;1736;5222;1529;4944;187;567;1212;4065;1399;4632
315360;201301;1547;5504;1373;5047;381;1477;489;1747;870;3224
315370;201301;604;1867;538;1770;147;542;282;897;429;1439
315380;201301;270;994;253;944;97;375;46;174;143;549
315390;201301;1894;6915;1653;6312;608;2476;342;1296;950;3772
315400;201301;4253;14050;3987;13538;1190;4266;1965;6882;3155;11148
315410;201301;1526;4576;1313;4217;272;1075;761;2365;1033;3440
315415;201301;1024;3666;967;3556;488;1844;302;1150;790;2994
315420;201301;1496;4832;1164;4261;403;1584;289;1023;692;2607
315430;201301;3830;11121;3084;9912;849;2956;1238;4069;2087;7025
315440;201301;940;2976;868;2881;120;454;608;2050;728;2504
315445;201301;1998;6218;1768;5913;310;1141;1214;4126;1524;5267
315450;201301;2433;8129;2337;7994;404;1415;1690;5925;2094;7340
315460;201301;36781;127723;33460;120612;11460;45041;10321;35957;21781;80998
315470;201301;456;1528;427;1480;111;424;227;759;338;1183
315480;201301;1397;4909;1126;4287;328;1352;244;916;572;2268
315490;201301;3116;9265;2819;8873;524;2037;1887;5706;2411;7743
315500;201301;450;1515;317;1166;78;337;127;409;205;746
315510;201301;1458;4454;1269;4133;197;783;794;2514;991;3297
315520;201301;1096;3643;946;3447;199;799;611;2185;810;2984
315530;201301;473;1711;451;1678;217;863;141;489;358;1352
315540;201301;1235;3898;1029;3594;218;942;480;1641;698;2583
315550;201301;1495;4731;1362;4549;465;1703;610;2001;1075;3704
315560;201301;6470;23414;6195;23032;950;3782;4513;16979;5463;20761
315570;201301;2298;7457;2187;7313;368;1370;1526;5118;1894;6488
315580;201301;2520;8236;2096;7415;635;2570;761;2599;1396;5169
315590;201301;852;2576;801;2499;113;428;588;1807;701;2235
315600;201301;2484;9448;2119;8895;330;1501;1413;6189;1743;7690
315610;201301;910;2869;807;2655;248;956;252;695;500;1651
315620;201301;317;1156;313;1148;110;421;137;511;247;932
315630;201301;969;3203;840;2989;253;929;249;897;502;1826
315640;201301;737;2421;651;2239;252;991;201;636;453;1627
315645;201301;738;2554;656;2326;259;1000;136;474;395;1474
315650;201301;1785;5657;1684;5524;164;704;1321;4233;1485;4937
315660;201301;2534;7384;2353;7149;327;1128;1756;5295;2083;6423
315670;201301;10967;40566;10194;39011;3914;16127;3339;12506;7253;28633
315680;201301;2743;10025;2338;9257;935;3879;619;2580;1554;6459
315690;201301;2751;9468;2432;8869;971;3859;617;2228;1588;6087
315700;201301;6688;22698;6066;21407;1474;5896;3060;10398;4534;16294
315710;201301;1784;5499;1483;5022;288;1180;792;2603;1080;3783
315720;201301;2618;9482;2447;9094;781;3266;820;2893;1601;6159
315725;201301;1523;4917;1264;4602;274;967;880;3283;1154;4250
315727;201301;621;2081;578;1981;149;547;307;1047;456;1594
315730;201301;963;3166;877;2988;248;884;423;1493;671;2377
315733;201301;1045;3542;980;3403;468;1712;308;1042;776;2754
315737;201301;1320;4270;1150;3984;165;644;740;2591;905;3235
315740;201301;976;3309;850;3062;280;1141;333;1131;613;2272
315750;201301;1036;3506;932;3370;141;584;658;2346;799;2930
315760;201301;740;2533;731;2517;55;188;647;2256;702;2444
315765;201301;1403;4640;1337;4516;195;690;987;3383;1182;4073
315770;201301;1540;5029;1457;4882;441;1588;717;2395;1158;3983
315780;201301;25837;88339;24588;85773;9418;34670;8625;30800;18043;65470
315790;201301;2918;10556;2778;10262;376;1333;1912;7302;2288;8635
315800;201301;1478;5984;1265;5355;443;2054;210;838;653;2892
315810;201301;1411;4362;1235;4079;220;895;797;2497;1017;3392
315820;201301;2945;10155;2619;9679;643;2557;1491;5581;2134;8138
315830;201301;1451;5065;1342;4831;382;1534;482;1698;864;3232
315840;201301;643;1867;528;1633;110;396;196;589;306;985
315850;201301;1332;4856;1289;4757;409;1570;495;1801;904;3371
315860;201301;379;1441;329;1338;100;447;115;486;215;933
315870;201301;450;1405;396;1320;93;350;189;616;282;966
315880;201301;975;2886;848;2731;231;799;492;1594;723;2393
315890;201301;1526;5505;1399;5322;364;1410;827;3289;1191;4699
315895;201301;4750;15505;4478;14979;1652;6010;1664;5471;3316;11481
315900;201301;713;2434;665;2354;218;873;298;983;516;1856
315910;201301;597;2189;550;2092;250;985;182;679;432;1664
315920;201301;1091;3654;992;3465;380;1413;425;1441;805;2854
315930;201301;1000;3032;898;2850;316;1098;339;1082;655;2180
315935;201301;1091;3869;1027;3728;376;1479;312;1126;688;2605
315940;201301;603;2015;571;1968;157;598;326;1092;483;1690
315950;201301;1152;3739;1092;3618;328;1111;589;1998;917;3109
315960;201301;2734;10101;2371;9297;1100;4812;339;1293;1439;6105
315970;201301;748;2233;627;2045;98;328;442;1481;540;1809
315980;201301;3749;9910;2846;8422;832;2850;960;2527;1792;5377
315990;201301;4153;13007;3709;12281;858;3290;2053;6711;2911;10001
316000;201301;552;1924;487;1795;255;987;102;383;357;1370
316010;201301;403;1539;364;1447;127;569;48;158;175;727
316020;201301;1165;3868;941;3486;206;837;507;1913;713;2750
316030;201301;3538;10448;2634;9020;391;1508;1457;5137;1848;6645
316040;201301;3215;10385;2474;8721;552;2230;594;1864;1146;4094
316045;201301;1953;6749;1865;6625;340;1042;1288;5009;1628;6051
316050;201301;319;1133;304;1103;63;256;180;648;243;904
316060;201301;762;2394;650;2245;138;587;408;1329;546;1916
316070;201301;5641;19772;5340;19176;1863;7321;2345;8096;4208;15417
316080;201301;684;2664;631;2516;185;816;164;641;349;1457
316090;201301;567;1767;454;1552;148;566;113;344;261;910
316095;201301;1107;3915;1055;3796;228;844;651;2435;879;3279
316100;201301;2789;9832;2359;8739;777;3208;555;1976;1332;5184
316105;201301;839;2478;679;2252;156;569;392;1316;548;1885
316110;201301;11530;43277;10718;41731;1510;6613;7858;30900;9368;37513
316120;201301;1254;4530;1229;4494;440;1642;605;2290;1045;3932
316130;201301;906;2387;715;2089;227;800;268;706;495;1506
316140;201301;949;3029;751;2700;185;727;351;1306;536;2033
316150;201301;1179;3886;1132;3812;332;1271;597;1923;929;3194
316160;201301;1091;3586;952;3291;151;579;574;2016;725;2595
316165;201301;811;2478;714;2311;127;477;419;1339;546;1816
316170;201301;1326;4082;1086;3631;269;1041;470;1469;739;2510
316180;201301;1147;3820;998;3570;312;1341;380;1225;692;2566
316190;201301;2452;7777;1615;5752;392;1543;332;1036;724;2579
316200;201301;3933;13223;3228;11854;941;4072;1017;3511;1958;7583
316210;201301;4664;15786;4431;15351;2418;8871;1055;3751;3473;12622
316220;201301;599;1927;458;1683;144;598;76;303;220;901
316225;201301;944;3070;865;2954;178;683;510;1716;688;2399
316230;201301;396;1296;346;1200;66;254;196;684;262;938
316240;201301;5920;20336;5308;19613;616;2144;4274;16225;4890;18369
316245;201301;2615;10268;2505;10098;230;954;2058;8482;2288;9436
316250;201301;7862;26348;7326;25284;3545;13094;2139;6996;5684;20090
316255;201301;2190;7312;1991;7081;311;1052;1493;5449;1804;6501
316257;201301;1219;3639;983;3223;315;1157;312;963;627;2120
316260;201301;1651;4871;1259;4314;489;1819;554;1868;1043;3687
316265;201301;1106;3359;1014;3176;101;377;719;2201;820;2578
316270;201301;5135;17050;4831;16434;1557;5760;1996;6873;3553;12633
316280;201301;3123;10944;2842;10382;708;2892;1366;4972;2074;7864
316290;201301;2845;10047;2727;9821;852;3399;1168;4008;2020;7407
316292;201301;3523;12263;3303;11847;1013;4059;1420;4818;2433;8877
316294;201301;830;2900;572;2257;149;676;81;325;230;1001
316295;201301;1770;6618;1653;6366;508;2198;754;2736;1262;4934
316300;201301;861;3053;800;2935;99;377;562;2125;661;2502
316310;201301;553;1975;504;1848;153;621;185;668;338;1289
316320;201301;517;1829;470;1764;177;735;183;651;360;1386
316330;201301;883;2787;788;2629;182;614;434;1504;616;2118
316340;201301;1064;3687;998;3562;385;1514;239;773;624;2287
316350;201301;1438;4931;1318;4725;265;979;752;2882;1017;3861
316360;201301;713;1978;585;1810;71;234;455;1410;526;1644
316370;201301;4701;16389;4348;15670;1547;5934;1174;4379;2721;10313
316380;201301;1282;3887;1112;3606;160;558;746;2439;906;2997
316390;201301;809;2616;707;2454;266;968;280;1009;546;1977
316400;201301;1421;4993;1285;4765;392;1547;581;2227;973;3774
316410;201301;1183;4180;1112;4068;222;893;705;2574;927;3467
316420;201301;1773;6496;1687;6369;292;1207;1094;4262;1386;5469
316430;201301;802;2595;715;2470;266;990;280;943;546;1933
316440;201301;556;1934;499;1859;183;808;246;829;429;1637
316443;201301;636;2066;562;1906;169;633;210;699;379;1332
316447;201301;1239;4338;1184;4233;213;822;846;3039;1059;3861
316450;201301;2091;7840;1898;7458;432;1638;1119;4671;1551;6309
316460;201301;763;2527;717;2454;208;812;410;1332;618;2144
316470;201301;6188;22808;5806;22038;2341;9865;1862;6714;4203;16579
316480;201301;248;904;223;852;76;310;69;254;145;564
316490;201301;333;1104;321;1080;135;463;128;440;263;903
316500;201301;1054;3952;776;3106;222;945;66;255;288;1200
316510;201301;875;3375;825;3266;383;1549;281;1151;664;2700
316520;201301;1076;3615;925;3385;333;1340;330;1167;663;2507
316530;201301;1176;3930;1000;3543;290;1228;400;1231;690;2459
316540;201301;983;3344;890;3183;301;1264;299;985;600;2249
316550;201301;1182;4242;1088;4094;253;1024;683;2615;936;3639
316553;201301;2078;7962;1782;7175;691;2969;357;1439;1048;4408
316555;201301;2543;9575;2378;9381;196;743;1975;8029;2171;8772
316556;201301;574;1744;481;1554;66;267;298;908;364;1175
316557;201301;860;3200;838;3160;313;1204;432;1643;745;2847
316560;201301;340;1192;303;1123;88;388;98;336;186;724
316570;201301;1317;4454;1236;4282;249;949;756;2618;1005;3567
316580;201301;229;776;214;743;88;319;75;248;163;567
316590;201301;1238;4017;1094;3758;187;789;705;2391;892;3180
316600;201301;1093;3886;997;3668;273;1073;466;1669;739;2742
316610;201301;574;2286;547;2244;193;870;261;1053;454;1923
316620;201301;1943;6831;1836;6609;586;2235;756;2789;1342;5024
316630;201301;1333;4877;1257;4690;539;2145;346;1253;885;3398
316640;201301;246;845;225;805;78;327;87;287;165;614
316650;201301;900;3686;810;3528;200;859;439;2036;639;2895
316660;201301;119;399;109;380;31;137;48;150;79;287
316670;201301;1728;5379;1509;4951;569;2084;480;1481;1049;3565
316680;201301;1682;5568;1597;5414;263;931;1183;4068;1446;4999
316690;201301;996;3580;925;3479;415;1721;299;1089;714;2810
316695;201301;1220;3928;1109;3737;126;419;779;2744;905;3163
316700;201301;346;1218;326;1174;96;414;153;509;249;923
316710;201301;3292;13294;2924;12433;985;4399;942;4187;1927;8586
316720;201301;18832;66436;16841;62012;6498;25169;4721;17375;11219;42544
316730;201301;404;1355;358;1252;100;386;178;568;278;954
316740;201301;679;2553;652;2505;290;1175;168;619;458;1794
316750;201301;390;1451;365;1398;128;538;124;454;252;992
316760;201301;3446;12071;2976;11545;1766;6781;935;3892;2701;10673
316770;201301;1387;4366;1231;4145;264;987;746;2573;1010;3560
316780;201301;656;2371;624;2307;309;1213;160;573;469;1786
316790;201301;797;2437;601;2095;169;682;278;945;447;1627
316800;201301;5802;20093;5364;19247;1195;4981;2969;10341;4164;15322
316805;201301;872;2393;828;2335;151;419;600;1743;751;2162
316810;201301;469;1533;451;1507;137;507;234;763;371;1270
316820;201301;298;967;251;882;108;409;60;201;168;610
316830;201301;570;2139;551;2094;211;833;218;834;429;1667
316840;201301;3249;9923;2850;9297;901;3326;1173;3670;2074;6996
316850;201301;1995;6657;1861;6419;475;1817;925;3164;1400;4981
316860;201301;22704;73739;21337;71282;6358;23466;9805;32883;16163;56349
316870;201301;6644;23183;6061;21786;2469;9523;1386;4863;3855;14386
316880;201301;799;2880;779;2854;362;1413;200;722;562;2135
316890;201301;1308;3616;1063;3278;524;1768;300;885;824;2653
316900;201301;2407;8129;2260;7822;772;2959;667;2097;1439;5056
316905;201301;378;1413;361;1374;158;623;99;382;257;1005
316910;201301;574;2144;522;2047;136;562;264;1042;400;1604
316920;201301;1335;4360;1059;3879;162;673;459;1703;621;2376
316930;201301;9006;32293;8274;30901;2832;11980;2848;10310;5680;22290
316935;201301;4615;14240;3477;12266;1292;5115;981;3301;2273;8416
316940;201301;6211;22193;5503;20723;1634;7009;1627;5805;3261;12814
316950;201301;1368;4326;1234;4149;244;937;787;2600;1031;3537
316960;201301;4931;13613;4277;12809;877;2898;2721;8217;3598;11115
316970;201301;3270;11473;3111;11165;1297;5187;954;3171;2251;8358
316980;201301;879;2900;739;2674;358;1384;213;773;571;2157
316990;201301;9139;32034;8559;30729;3746;14606;1473;5084;5219;19690
317000;201301;2347;8992;2283;8909;315;976;1864;7654;2179;8630
317005;201301;2019;7240;1957;7152;454;1768;1325;4787;1779;6555
317010;201301;25466;75934;18807;63924;5914;22265;4797;16920;10711;39185
317020;201301;36506;116986;27427;97386;8505;33215;5732;19201;14237;52416
317030;201301;860;2507;728;2309;141;541;415;1306;556;1847
317040;201301;11809;37883;10804;36064;4316;14942;3924;13556;8240;28498
317043;201301;707;2111;587;1946;253;883;187;633;440;1516
317047;201301;1115;3174;918;2863;176;609;441;1390;617;1999
317050;201301;1657;6329;1530;6048;553;2363;424;1596;977;3959
317052;201301;2188;7673;1971;7357;425;1644;1295;4977;1720;6621
317057;201301;1638;5058;1317;4513;229;932;701;2407;930;3339
317060;201301;375;1162;300;1001;93;346;112;356;205;702
317065;201301;1179;4121;1103;4009;131;520;891;3261;1022;3781
317070;201301;7997;28344;6790;25689;2418;10053;1633;6183;4051;16236
317075;201301;1154;3906;1069;3767;431;1642;410;1407;841;3049
317080;201301;6636;20488;6288;19948;2162;7413;2703;8671;4865;16084
317090;201301;4441;16409;4246;16030;769;3053;2868;11015;3637;14068
317100;201301;3043;9432;2725;8923;922;3427;1241;3865;2163;7292
317103;201301;1941;7089;1683;6524;408;1863;838;3223;1246;5086
317107;201301;1186;4013;1081;3792;280;1166;521;1711;801;2877
317110;201301;580;1701;490;1574;159;598;208;599;367;1197
317115;201301;951;3213;878;3056;131;464;598;2103;729;2567
317120;201301;12126;42862;11057;40527;4174;16225;4177;15206;8351;31431
317130;201301;8410;28168;7790;27017;2307;8993;3426;11516;5733;20509
317140;201301;611;2260;572;2170;105;437;344;1299;449;1736
317150;201301;984;2826;843;2667;145;552;582;1806;727;2358
317160;201301;3608;10309;2899;9415;461;1760;1940;6192;2401;7952
317170;201301;1896;5945;1809;5769;286;1069;1110;3415;1396;4484
317180;201301;1582;5834;1341;5262;447;1885;352;1354;799;3239
317190;201301;1301;4136;1231;4038;124;477;1005;3281;1129;3758
317200;201301;4005;14247;3879;13975;1565;6049;977;3425;2542;9474
317210;201301;1020;3355;873;3109;305;1220;323;1100;628;2320
317220;201301;338;1262;333;1256;150;569;144;562;294;1131
320010;201301;5858;18984;5323;17740;852;3098;3131;10463;3983;13561
320013;201301;1754;5471;1435;4992;214;805;943;3341;1157;4146
320016;201301;3358;9718;2934;9127;499;1629;2024;6360;2523;7989
320020;201301;3957;13469;3716;12959;1413;5207;1348;4738;2761;9945
320030;201301;1671;5673;1572;5474;427;1622;779;2659;1206;4281
320035;201301;1515;5132;1400;4910;521;1956;416;1464;937;3420
320040;201301;2888;10206;2544;9403;811;3189;811;2976;1622;6165
320050;201301;1789;5404;1547;4890;381;1331;706;2208;1087;3539
320060;201301;9745;32874;8518;30204;2776;10625;2952;10135;5728;20760
320070;201301;1717;6021;1577;5684;587;2271;415;1415;1002;3686
320080;201301;4802;15307;4233;14213;1400;5107;1684;5525;3084;10632
320090;201301;7917;24014;6884;22247;1812;6391;3874;12307;5686;18698
320100;201301;3168;9832;2696;8927;709;2567;1298;4221;2007;6788
320110;201301;1500;4757;1395;4540;393;1393;504;1613;897;3006
320115;201301;1942;7387;1906;7300;580;2254;1118;4347;1698;6601
320120;201301;15825;56598;14460;53865;5761;22745;4201;15695;9962;38440
320130;201301;35927;125819;34415;122596;11733;44677;15553;54796;27286;99473
320140;201301;3850;13127;2947;10811;905;3626;383;1397;1288;5023
320150;201301;16785;49992;13007;42627;4744;16666;2044;6652;6788;23318
320160;201301;5295;16868;4726;16005;1221;4576;2439;8051;3660;12627
320170;201301;1885;6386;1756;6111;719;2579;514;1862;1233;4441
320180;201301;871;3018;804;2913;257;978;420;1531;677;2509
320190;201301;3990;15009;3741;14377;1512;6004;1093;4231;2605;10235
320200;201301;1044;3614;961;3450;312;1204;408;1492;720;2696
320210;201301;5962;17134;5254;15953;1465;4862;2549;7682;4014;12544
320220;201301;2644;8544;2109;7552;727;2831;687;2499;1414;5330
320225;201301;1340;4950;1235;4660;484;1940;263;1000;747;2940
320230;201301;4042;14087;3819;13658;1337;5076;1463;5429;2800;10505
320240;201301;10042;34735;9061;32854;3615;13636;2315;8944;5930;22580
320245;201301;4028;14260;3862;13893;1253;4648;1866;6802;3119;11450
320250;201301;1579;5139;1271;4426;393;1535;286;903;679;2438
320255;201301;1882;6581;1681;6231;702;2740;589;2264;1291;5004
320260;201301;1306;4355;1149;3931;342;1289;449;1414;791;2703
320265;201301;2296;7415;1982;7026;281;1039;1459;5305;1740;6344
320270;201301;2039;7111;1952;6913;436;1583;1170;4220;1606;5803
320280;201301;7144;22047;6762;21585;1144;3781;4806;15872;5950;19653
320290;201301;1483;5271;1434;5143;566;2088;525;1876;1091;3964
320300;201301;4521;15697;4262;15254;1217;4524;2341;8510;3558;13034
320305;201301;4349;15013;4030;14239;1258;4876;1699;5844;2957;10720
320310;201301;1865;5880;1746;5713;405;1443;1049;3380;1454;4823
320313;201301;2022;6553;1623;5644;524;2107;257;817;781;2924
320316;201301;2179;7167;2100;6985;570;1993;1065;3555;1635;5548
320320;201301;16859;57758;15418;54983;4937;19721;6818;23564;11755;43285
320330;201301;2614;8677;2402;8238;678;2340;1206;4287;1884;6627
320332;201301;4841;17151;4578;16673;1428;5349;2210;8338;3638;13687
320334;201301;2034;7361;1804;6779;788;3150;342;1185;1130;4335
320335;201301;1788;5848;1563;5358;633;2326;296;979;929;3305
320340;201301;5137;15409;4385;14159;996;3679;2342;7414;3338;11093
320350;201301;5196;13865;4021;12020;827;2876;2087;6061;2914;8937
320360;201301;1668;4673;1357;4128;305;1047;665;1940;970;2987
320370;201301;3379;11658;2975;10845;863;3295;1367;5014;2230;8309
320380;201301;2546;8389;2300;7861;773;2761;880;3021;1653;5782
320390;201301;7863;24858;6809;22823;1747;6589;3263;10718;5010;17307
320400;201301;4215;12587;3709;11920;643;2241;2524;8106;3167;10347
320405;201301;4119;12713;3870;12389;984;3555;2367;7442;3351;10997
320410;201301;5534;14898;4333;13551;487;1485;3500;11187;3987;12672
320420;201301;2343;7656;1903;6977;920;3600;363;1313;1283;4913
320425;201301;2387;6309;2026;5837;319;1142;1353;3855;1672;4997
320430;201301;2156;6723;2021;6488;294;1104;1286;4028;1580;5132
320435;201301;1928;7122;1776;6741;500;1930;877;3454;1377;5384
320440;201301;1408;4947;1350;4798;426;1620;554;1929;980;3549
320450;201301;2209;7719;2060;7396;629;2445;946;3360;1575;5805
320455;201301;4177;15644;3574;14103;1215;4945;711;2813;1926;7758
320460;201301;2718;9506;2341;8712;881;3499;648;2309;1529;5808
320465;201301;1450;4887;1325;4582;219;776;747;2598;966;3374
320470;201301;3910;12791;3032;10808;1106;4250;469;1648;1575;5898
320480;201301;1924;6060;1644;5520;407;1610;768;2448;1175;4058
320490;201301;15898;53869;14198;50507;5205;19586;5227;19157;10432;38743
320495;201301;1480;5083;1372;4835;622;2318;391;1327;1013;3645
320500;201301;38572;129145;35415;123134;12708;47514;15233;51977;27941;99491
320501;201301;4010;13766;3799;13364;1476;5652;1522;5293;2998;10945
320503;201301;2138;8125;1916;7501;745;3055;541;2020;1286;5075
320506;201301;2959;9738;2249;7938;690;2593;445;1564;1135;4157
320510;201301;7542;25216;7016;24232;2608;9571;2564;8857;5172;18428
320515;201301;1993;5864;1834;5557;445;1405;933;2875;1378;4280
320517;201301;1946;6989;1791;6610;580;2245;720;2684;1300;4929
320520;201301;27772;95126;24968;89712;8936;34910;10675;38287;19611;73197
320530;201301;24691;81321;22000;75877;6881;26691;9422;31259;16303;57950
330010;201301;13015;44498;12375;43164;3408;13172;6440;21715;9848;34887
330015;201301;1863;5454;1652;5045;585;1979;509;1488;1094;3467
330020;201301;14890;47301;13849;45606;4113;14382;7103;23419;11216;37801
330022;201301;1245;4287;1165;4149;309;1300;628;2125;937;3425
330023;201301;3012;10244;2910;10043;870;3278;1296;4366;2166;7644
330025;201301;3026;9696;2849;9441;671;2411;1862;6144;2533;8555
330030;201301;6739;24358;6261;23341;2205;8918;2503;8965;4708;17883
330040;201301;13754;40201;11879;37302;3185;10865;6414;19815;9599;30680
330045;201301;55026;169411;52028;165159;8685;29332;36459;116628;45144;145960
330050;201301;2779;9339;2511;8786;999;3875;737;2464;1736;6339
330060;201301;4941;16255;4557;15692;1232;4652;2599;9026;3831;13678
330070;201301;23889;77073;22167;73995;6903;24827;9570;31967;16473;56794
330080;201301;8610;26168;8315;25765;2237;6930;4974;15966;7211;22896
330090;201301;2951;8755;2837;8547;1003;3215;1238;3679;2241;6894
330093;201301;1808;5444;1636;5182;380;1312;927;2955;1307;4267
330095;201301;1142;4084;1070;3899;416;1696;223;704;639;2400
330100;201301;48691;172075;46659;168440;13032;51296;23460;85383;36492;136679
330110;201301;2554;8285;2355;7913;853;3074;709;2369;1562;5443
330115;201301;2387;7537;2245;7281;796;2830;894;2801;1690;5631
330120;201301;2298;7183;2141;6958;485;1729;1298;4167;1783;5896
330130;201301;3637;12525;3355;11956;1243;4706;1129;4072;2372;8778
330140;201301;3140;9940;2886;9594;724;2675;1480;4903;2204;7578
330150;201301;2799;8835;2310;7814;888;3245;498;1663;1386;4908
330160;201301;1265;4611;1203;4467;503;1998;339;1251;842;3249
330170;201301;92232;293849;87566;286723;13830;49005;63660;208653;77490;257658
330180;201301;1487;4834;1381;4636;298;1255;869;2695;1167;3950
330185;201301;7145;23799;6819;23253;2024;7165;3517;12436;5541;19601
330187;201301;3756;11299;3457;10797;873;3141;1859;5699;2732;8840
330190;201301;26369;83089;25433;81494;7147;24367;14384;45330;21531;69697
330200;201301;11504;38067;11038;37181;2455;8469;6590;22703;9045;31172
330205;201301;2460;6932;2254;6592;519;1767;1212;3430;1731;5197
330210;201301;4524;12265;3484;10345;1109;3634;1073;3150;2182;6784
330220;201301;10605;34978;10117;34041;3849;13981;3505;11444;7354;25425
330225;201301;3744;12353;3570;12083;698;2689;2389;8071;3087;10760
330227;201301;16819;48432;15555;46879;3038;10022;10489;30979;13527;41001
330230;201301;1467;4413;1371;4263;423;1493;640;1888;1063;3381
330240;201301;19166;61170;17310;58055;7459;27029;3406;11538;10865;38567
330245;201301;1093;3694;959;3432;323;1240;256;935;579;2175
330250;201301;34061;103926;32862;102128;7371;23031;21709;68742;29080;91773
330260;201301;3059;10083;2972;9933;853;3146;1489;4859;2342;8005
330270;201301;12550;39480;11520;37798;3616;12491;5062;16838;8678;29329
330280;201301;1792;6029;1594;5638;415;1685;811;2729;1226;4414
330285;201301;16985;52604;15769;50916;3688;12596;9870;32055;13558;44651
330290;201301;3330;9423;3021;9075;451;1564;2247;6623;2698;8187
330300;201301;4016;13733;3861;13470;1113;4089;1973;7099;3086;11188
330310;201301;2595;8048;2429;7754;685;2315;1205;3829;1890;6144
330320;201301;14629;44637;13985;43636;3940;12381;8029;25878;11969;38259
330330;201301;28397;85747;26850;83313;7391;24340;15617;48268;23008;72608
330340;201301;12688;41358;10918;37764;3549;13385;3560;12077;7109;25462
330350;201301;87332;292288;85473;289708;17318;58536;59598;206764;76916;265300
330360;201301;4984;16609;4876;16427;955;3467;3278;10991;4233;14458
330370;201301;3567;13759;3410;13339;1421;5803;1161;4557;2582;10360
330380;201301;3334;11668;3067;11232;1144;4249;1215;4784;2359;9033
330385;201301;3798;13709;3530;13146;1012;4044;1526;5698;2538;9742
330390;201301;21686;76161;20378;73642;5227;21041;10792;38316;16019;59357
330395;201301;3170;9984;3004;9705;538;1876;1936;6330;2474;8206
330400;201301;2352;8195;2156;7818;565;2321;988;3318;1553;5639
330410;201301;2798;9370;2508;8764;612;2298;1224;4262;1836;6560
330411;201301;2256;7469;2064;7098;531;2111;996;3213;1527;5324
330412;201301;1303;4635;1074;4201;246;1112;477;1797;723;2909
330414;201301;24352;71851;21006;67410;4089;14228;13500;43496;17589;57724
330415;201301;3581;11546;3199;10848;857;3267;1386;4662;2243;7929
330420;201301;5954;21109;5279;19718;1912;7808;944;3655;2856;11463
330430;201301;7756;23922;7033;22637;1894;6757;3299;10330;5193;17087
330440;201301;2006;6936;1732;6388;588;2407;475;1687;1063;4094
330450;201301;1526;5542;1450;5369;502;2084;485;1741;987;3825
330452;201301;10107;32168;8601;29162;2526;9533;3647;11811;6173;21344
330455;201301;415106;1283532;368150;1206577;103362;360819;191420;628585;294782;989404
330460;201301;1366;4776;1288;4622;392;1589;601;2109;993;3698
330470;201301;3925;13750;3791;13478;1598;6039;1007;3523;2605;9562
330475;201301;7605;25659;7069;24838;1753;6634;4122;14694;5875;21328
330480;201301;6257;19441;5891;18774;1776;6120;2264;7178;4040;13298
330490;201301;90356;265824;85094;258223;13945;44667;62435;190157;76380;234824
330500;201301;6274;19772;5898;19027;1570;5396;2775;9296;4345;14692
330510;201301;38555;130102;36927;127394;13856;48408;17022;60748;30878;109156
330513;201301;1514;4724;1411;4525;434;1442;716;2338;1150;3780
330515;201301;2663;8990;2550;8800;809;2988;1194;4078;2003;7066
330520;201301;12374;38503;11748;37628;2540;8649;7707;24923;10247;33572
330530;201301;1530;4694;1428;4512;386;1348;768;2352;1154;3700
330540;201301;2994;9586;2673;9099;924;3373;999;3344;1923;6717
330550;201301;8443;28744;7641;27328;3008;11351;2320;8510;5328;19861
330555;201301;9461;30316;8774;29212;1975;6815;5443;18377;7418;25192
330560;201301;3874;12433;3661;12088;837;3211;2141;6894;2978;10105
330570;201301;3481;10469;3145;9937;823;2725;1735;5600;2558;8325
330575;201301;5027;16006;4748;15499;1106;3863;2879;9231;3985;13094
330580;201301;14986;50865;13628;48272;5200;19186;4584;16950;9784;36136
330590;201301;1872;5958;1778;5805;486;1664;951;3161;1437;4825
330600;201301;8513;26860;7522;25351;1291;5465;4877;15543;6168;21008
330610;201301;8312;28067;7736;26974;2446;9356;3478;11962;5924;21318
330615;201301;1634;5968;1526;5654;596;2286;629;2427;1225;4713
330620;201301;3787;13825;3563;13425;1284;4961;1485;5972;2769;10933
330630;201301;18991;65579;17756;62861;5492;21475;8148;27661;13640;49136
350010;201301;2804;9180;2316;8051;781;2921;457;1561;1238;4482
350020;201301;532;1621;439;1429;134;490;146;445;280;935
350030;201301;4083;13718;3814;13264;1522;5706;1465;5160;2987;10866
350040;201301;553;2101;498;1988;186;816;102;366;288;1182
350050;201301;1339;4582;1132;4195;337;1418;380;1339;717;2757
350055;201301;561;1995;541;1962;186;708;229;841;415;1549
350060;201301;69;245;66;240;22;100;23;72;45;172
350070;201301;2801;9660;2446;8911;700;2807;676;2274;1376;5081
350075;201301;449;1705;418;1635;177;730;116;411;293;1141
350080;201301;555;1719;478;1569;143;544;183;593;326;1137
350090;201301;574;1721;458;1525;133;467;156;517;289;984
350100;201301;1740;6296;1633;6081;638;2545;594;2183;1232;4728
350110;201301;425;1339;345;1158;104;396;108;320;212;716
350115;201301;1209;4179;1088;3866;270;1090;496;1630;766;2720
350120;201301;706;2053;554;1766;156;562;141;451;297;1013
350130;201301;3548;11330;3275;10794;959;3549;1319;4047;2278;7596
350140;201301;667;2157;612;2046;170;646;243;778;413;1424
350150;201301;355;1281;342;1253;174;639;70;283;244;922
350160;201301;6096;21023;5141;18877;1841;7389;1606;5475;3447;12864
350170;201301;2109;7806;1906;7294;762;2999;454;1696;1216;4695
350180;201301;1427;3824;1204;3440;294;874;548;1566;842;2440
350190;201301;2679;9918;2421;9379;878;3802;933;3287;1811;7089
350200;201301;384;1380;362;1356;149;612;141;513;290;1125
350210;201301;7248;21220;5984;18960;2494;8448;1898;5757;4392;14205
350220;201301;2968;9882;2695;9369;1082;4194;696;2176;1778;6370
350230;201301;705;2485;649;2391;252;1011;186;688;438;1699
350240;201301;589;1844;519;1727;135;517;265;854;400;1371
350250;201301;2602;9954;2501;9746;1135;4672;766;2976;1901;7648
350260;201301;919;2600;856;2512;234;712;387;1201;621;1913
350270;201301;4982;16199;4572;15372;1322;4847;2050;6856;3372;11703
350275;201301;1839;6286;1668;6057;517;2088;742;2559;1259;4647
350280;201301;20674;57338;13964;44432;3960;13496;3082;9970;7042;23466
350290;201301;1449;5176;1352;4945;496;1908;459;1732;955;3640
350300;201301;465;1525;431;1447;161;600;120;394;281;994
350310;201301;976;3382;923;3268;274;1124;360;1221;634;2345
350315;201301;532;1745;443;1551;91;401;156;498;247;899
350320;201301;10826;37022;10066;35227;3578;13322;1885;6429;5463;19751
350330;201301;8894;27318;8185;25831;1701;6221;4811;14246;6512;20467
350335;201301;531;1603;494;1529;142;463;188;637;330;1100
350340;201301;961;3174;782;2840;283;1109;171;592;454;1701
350350;201301;682;2328;625;2239;219;891;225;807;444;1698
350360;201301;649;2386;581;2241;195;811;206;800;401;1611
350370;201301;672;2153;511;1755;113;434;127;399;240;833
350380;201301;3325;11210;2856;10523;1409;5504;537;1961;1946;7465
350390;201301;7865;26810;7268;25783;1653;6583;4184;14310;5837;20893
350395;201301;290;968;235;841;78;296;38;131;116;427
350400;201301;7365;22929;6258;20865;2155;7736;2121;6846;4276;14582
350410;201301;6714;25898;6125;24565;2445;10456;1641;6484;4086;16940
350420;201301;1016;3340;850;2998;418;1550;74;262;492;1812
350430;201301;888;2873;783;2696;236;942;393;1301;629;2243
350440;201301;1328;4482;1268;4372;481;1738;559;1900;1040;3638
350450;201301;7823;24827;6833;22921;2524;9160;1952;6399;4476;15559
350460;201301;1331;4106;1001;3391;344;1280;260;748;604;2028
350470;201301;201;647;185;624;56;207;78;248;134;455
350480;201301;751;2410;536;1877;119;479;93;284;212;763
350490;201301;2005;5993;1788;5754;413;1525;1204;3808;1617;5333
350500;201301;588;1823;520;1719;159;581;240;759;399;1340
350510;201301;1067;3548;962;3343;332;1307;367;1178;699;2485
350520;201301;1246;4979;1162;4802;486;2099;292;1191;778;3290
350530;201301;2352;7305;1992;6504;782;2771;553;1659;1335;4430
350535;201301;1457;4351;1426;4309;94;291;1246;3808;1340;4099
350540;201301;1908;5836;1692;5477;481;1753;743;2370;1224;4123
350550;201301;10373;31650;8502;28414;2794;10443;2896;9019;5690;19462
350560;201301;3224;11006;3029;10716;591;2195;1935;7071;2526;9266
350570;201301;19397;69616;18046;66454;6466;25323;6293;22357;12759;47680
350580;201301;1851;6358;1654;5962;551;2183;289;914;840;3097
350590;201301;3827;13079;3128;11490;1035;4183;1114;3792;2149;7975
350600;201301;25409;77732;21247;69990;5239;19114;10296;32867;15535;51981
350610;201301;8706;26443;7313;24255;2110;7850;3581;11540;5691;19390
350620;201301;404;1362;362;1285;103;401;140;477;243;878
350630;201301;1533;5067;1261;4539;437;1781;134;449;571;2230
350635;201301;3490;13011;3334;12706;1228;4835;1386;5398;2614;10233
350640;201301;654;2157;626;2110;225;810;256;840;481;1650
350650;201301;4185;14346;3506;12846;1684;6598;427;1507;2111;8105
350660;201301;3526;11838;3155;11169;924;3496;1490;5224;2414;8720
350670;201301;1806;5899;1706;5720;368;1446;1090;3474;1458;4920
350680;201301;1094;3517;907;3154;284;1155;363;1196;647;2351
350690;201301;1005;3506;877;3233;301;1232;207;695;508;1927
350700;201301;2661;9585;2389;8961;947;3888;854;2884;1801;6772
350710;201301;1872;6181;1712;5932;404;1585;1016;3457;1420;5042
350715;201301;1095;3498;998;3303;253;972;421;1323;674;2295
350720;201301;120;397;114;381;47;160;40;122;87;282
350730;201301;373;1491;367;1472;138;605;83;305;221;910
350740;201301;2184;6776;2012;6380;638;2194;747;2374;1385;4568
350745;201301;339;1119;298;1020;77;304;136;426;213;730
350750;201301;8524;27814;7007;24702;2296;8857;1976;6560;4272;15417
350760;201301;10610;35565;9780;34101;3720;14199;3855;12895;7575;27094
350770;201301;808;2547;630;2173;164;644;203;700;367;1344
350775;201301;598;1842;542;1730;148;534;220;705;368;1239
350780;201301;1908;6067;1524;5272;350;1332;391;1330;741;2662
350790;201301;1986;6743;1672;6123;596;2310;419;1432;1015;3742
350800;201301;2743;9907;2652;9749;803;3281;1354;4821;2157;8102
350810;201301;2524;7549;2226;6996;777;2630;774;2517;1551;5147
350820;201301;483;1388;382;1181;90;337;143;384;233;721
350830;201301;817;2709;628;2234;133;515;134;441;267;956
350840;201301;2948;11329;2602;10395;1045;4509;564;2077;1609;6586
350850;201301;6176;21561;5454;19931;1953;7616;1742;6140;3695;13756
350860;201301;3045;10504;2952;10375;566;2224;2086;7261;2652;9485
350870;201301;2193;7999;2034;7751;796;3179;949;3662;1745;6841
350880;201301;1601;5599;1377;5077;476;1874;249;940;725;2814
350890;201301;597;1829;481;1579;105;376;144;387;249;763
350900;201301;4406;15181;3880;14104;1144;4523;1401;4826;2545;9349
350910;201301;832;2687;801;2622;339;1123;305;1026;644;2149
350920;201301;8648;27297;8153;26543;1531;5629;5312;16700;6843;22329
350925;201301;5118;16554;4699;15752;1483;5451;2057;6769;3540;12220
350930;201301;1375;4059;1177;3728;192;717;759;2311;951;3028
350940;201301;2236;7688;2066;7415;416;1758;1331;4583;1747;6341
350945;201301;887;3083;797;2888;249;987;300;1054;549;2041
350950;201301;63937;215531;57178;201940;18150;69653;23694;81612;41844;151265
350960;201301;4377;16004;3944;15072;897;3888;2110;7804;3007;11692
350970;201301;3927;14985;3661;14330;1544;6446;1152;4446;2696;10892
350980;201301;605;2058;579;2017;274;1030;130;465;404;1495
350990;201301;1663;6150;1525;5880;547;2260;598;2328;1145;4588
350995;201301;780;2946;742;2869;253;1089;324;1194;577;2283
351000;201301;3332;10728;2971;10014;560;2232;1688;5429;2248;7661
351010;201301;387;1237;299;1050;131;510;46;153;177;663
351015;201301;916;3182;814;2989;305;1257;242;826;547;2083
351020;201301;7240;24992;6542;23884;1819;7229;3631;13306;5450;20535
351030;201301;1268;4939;1194;4767;404;1750;408;1609;812;3359
351040;201301;3359;11310;3134;10923;870;3538;1756;5694;2626;9232
351050;201301;7494;26426;6743;24926;2711;10737;2229;8174;4940;18911
351060;201301;28928;94692;24798;87250;9220;34102;8395;30211;17615;64313
351070;201301;1682;5058;1309;4396;529;1960;286;859;815;2819
351080;201301;2535;8073;2062;7477;670;2638;801;2835;1471;5473
351090;201301;358;1295;299;1175;103;463;61;233;164;696
351100;201301;1724;5858;1641;5730;640;2283;681;2444;1321;4727
351110;201301;6844;21449;5688;19264;2106;7763;1755;5692;3861;13455
351120;201301;590;1912;519;1752;86;350;237;701;323;1051
351130;201301;903;2656;634;2152;186;736;184;539;370;1275
351140;201301;1917;6898;1777;6608;725;2935;574;2096;1299;5031
351150;201301;2007;7121;1718;6400;522;2151;458;1588;980;3739
351160;201301;1416;5171;1291;4873;475;1982;415;1525;890;3507
351170;201301;1353;4788;1192;4396;387;1530;446;1553;833;3083
351190;201301;1060;3499;983;3302;286;1044;253;804;539;1848
351200;201301;2138;6690;1889;6198;384;1490;970;2920;1354;4410
351210;201301;875;3070;813;2933;297;1139;259;906;556;2045
351220;201301;3320;11577;2902;10678;963;3829;985;3595;1948;7424
351230;201301;1757;6180;1610;5887;587;2326;677;2453;1264;4779
351240;201301;956;3271;711;2644;220;918;203;679;423;1597
351250;201301;767;2286;598;1955;144;510;266;836;410;1346
351260;201301;1183;3630;1067;3387;289;1027;429;1295;718;2322
351270;201301;373;1397;342;1329;135;591;108;383;243;974
351280;201301;4093;13491;3589;12283;1169;4296;1134;3538;2303;7834
351290;201301;934;2927;832;2717;298;1025;211;634;509;1659
351300;201301;9377;35682;8397;33390;2538;10914;3338;13219;5876;24133
351310;201301;3160;10289;2670;9381;796;3156;1162;3813;1958;6969
351320;201301;928;3448;854;3261;353;1446;180;601;533;2047
351330;201301;264;813;243;771;100;323;67;207;167;530
351340;201301;6061;22290;5718;21615;1644;6582;3113;11795;4757;18377
351350;201301;8757;30128;8060;28613;2670;9911;3160;10958;5830;20869
351360;201301;4787;15053;4545;14668;1232;4356;2417;7814;3649;12170
351370;201301;1803;6130;1483;5417;524;2117;355;1159;879;3276
351380;201301;35051;114595;33092;110560;9407;34462;15828;50784;25235;85246
351385;201301;228;762;226;758;101;341;64;235;165;576
351390;201301;1158;4082;1053;3858;442;1706;375;1336;817;3042
351400;201301;1142;3867;1079;3727;351;1309;461;1615;812;2924
351410;201301;2718;8798;2486;8374;654;2345;1173;3938;1827;6283
351420;201301;440;1323;308;1025;77;279;43;129;120;408
351430;201301;821;2714;741;2568;231;880;361;1207;592;2087
351440;201301;4507;14314;4062;13390;1676;5784;1111;3494;2787;9278
351450;201301;1769;5207;1580;4967;472;1492;893;2920;1365;4412
351460;201301;773;2512;648;2259;323;1207;179;569;502;1776
351470;201301;1009;3285;915;3112;409;1499;285;946;694;2445
351480;201301;2849;9696;2633;9335;733;3111;1267;4340;2000;7451
351490;201301;1826;6513;1676;6189;419;1790;867;3046;1286;4836
351492;201301;268;963;211;793;54;232;51;153;105;385
351495;201301;139;504;125;468;50;196;46;169;96;365
351500;201301;16987;58426;15477;55530;5196;19531;6506;23207;11702;42738
351510;201301;6897;23290;6136;22070;1547;6090;3401;12095;4948;18185
351512;201301;305;992;279;936;84;301;91;291;175;592
351515;201301;1726;6117;1549;5704;572;2277;449;1581;1021;3858
351518;201301;2131;7781;1736;7074;622;2759;321;1307;943;4066
351519;201301;690;2388;624;2238;212;853;259;917;471;1770
351520;201301;733;2208;385;1427;71;300;49;171;120;471
351530;201301;428;1389;386;1284;98;360;108;306;206;666
351535;201301;2459;6646;2096;6181;195;620;1659;4944;1854;5564
351540;201301;1992;6655;1822;6361;956;3473;377;1354;1333;4827
351550;201301;5619;17840;4574;15620;1786;6405;1088;3685;2874;10090
351560;201301;411;1387;369;1287;156;589;61;202;217;791
351565;201301;227;795;210;749;75;314;76;240;151;554
351570;201301;12687;43505;11330;40630;4010;14825;4617;16720;8627;31545
351580;201301;378;1133;312;983;67;245;112;312;179;557
351590;201301;431;1240;381;1121;145;463;107;295;252;758
351600;201301;1748;5361;1595;5059;460;1694;693;1979;1153;3673
351610;201301;604;1762;525;1619;122;433;269;785;391;1218
351620;201301;22100;76362;18747;68925;6819;27106;4772;16423;11591;43529
351630;201301;13815;48002;12761;46269;3461;12997;7257;26721;10718;39718
351640;201301;7687;26648;6708;24908;1972;7855;3373;12545;5345;20400
351650;201301;331;1034;249;841;61;224;60;197;121;421
351660;201301;909;3043;758;2681;198;799;229;734;427;1533
351670;201301;3934;13072;3419;12013;937;3696;1508;5021;2445;8717
351680;201301;653;2131;553;1902;164;589;179;609;343;1198
351685;201301;407;1268;323;1119;101;370;108;385;209;755
351690;201301;1252;3735;1017;3244;491;1587;255;777;746;2364
351700;201301;1373;4331;1264;4131;449;1547;405;1284;854;2831
351710;201301;766;2470;660;2241;191;676;177;551;368;1227
351720;201301;1434;4781;1186;4129;306;1195;392;1293;698;2488
351730;201301;965;3251;940;3205;309;1123;465;1618;774;2741
351740;201301;4356;12969;3855;11912;1165;3837;1321;3857;2486;7694
351750;201301;1456;4997;1277;4595;413;1599;306;1038;719;2637
351760;201301;3653;12336;3290;11493;908;3408;1490;5105;2398;8513
351770;201301;2028;6928;1765;6448;751;2817;710;2641;1461;5458
351780;201301;1527;4574;1166;3838;376;1338;325;1059;701;2397
351790;201301;1101;3434;948;3222;288;1069;474;1581;762;2650
351800;201301;293;744;260;680;40;139;160;365;200;504
351810;201301;1160;3695;1107;3628;290;1119;688;2117;978;3236
351820;201301;2358;7101;1657;5812;734;2753;197;672;931;3425
351830;201301;3767;12924;3476;12288;1019;3917;1473;5079;2492;8996
351840;201301;8527;30487;7744;28789;2703;10715;2713;9903;5416;20618
351850;201301;1118;4063;999;3794;326;1378;169;592;495;1970
351860;201301;3326;11150;3110;10735;811;3186;1758;5774;2569;8960
351870;201301;33955;109090;31598;105006;7248;26028;19507;64558;26755;90586
351880;201301;109338;369143;98086;346342;33786;125038;30785;109131;64571;234169
351885;201301;590;2275;551;2187;167;709;246;950;413;1659
351890;201301;795;2412;665;2132;249;851;155;490;404;1341
351900;201301;1424;4526;1287;4311;471;1674;540;1819;1011;3493
351905;201301;349;1308;303;1218;117;521;91;327;208;848
351907;201301;13158;43728;11618;40605;3061;11983;5225;17489;8286;29472
351910;201301;1087;3629;996;3449;276;1066;268;863;544;1929
351920;201301;1145;3455;1096;3384;283;998;654;1947;937;2945
351925;201301;958;2820;913;2747;101;403;712;2059;813;2462
351930;201301;2990;10680;2764;10175;923;3731;1042;3535;1965;7266
351940;201301;942;3019;893;2918;295;1055;499;1559;794;2614
351950;201301;969;3112;876;2933;247;919;355;1094;602;2013
351960;201301;3489;11751;3033;10810;1255;4693;944;3294;2199;7987
351970;201301;6499;25703;6182;24994;2512;10655;2093;8387;4605;19042
351980;201301;872;2815;751;2587;178;712;314;1025;492;1737
351990;201301;1449;4375;1239;3979;387;1394;394;1182;781;2576
352000;201301;2294;7662;2119;7292;550;2019;1007;3374;1557;5393
352010;201301;2230;7819;2061;7412;829;3087;464;1741;1293;4828
352020;201301;1407;4746;1298;4539;437;1608;424;1528;861;3136
352030;201301;4184;13788;3849;13358;873;3225;2325;8271;3198;11496
352040;201301;1558;5721;1374;5251;460;1858;330;1195;790;3053
352042;201301;1638;5038;1441;4698;381;1385;769;2500;1150;3885
352044;201301;1325;4800;1174;4394;386;1514;284;1031;670;2545
352050;201301;6808;23805;5213;20189;1674;7256;1235;4329;2909;11585
352060;201301;763;2371;691;2259;222;824;257;765;479;1589
352070;201301;666;1896;625;1827;306;960;163;516;469;1476
352080;201301;519;1655;454;1538;130;499;162;500;292;999
352090;201301;1599;5352;1351;4848;383;1571;469;1531;852;3102
352100;201301;1657;5958;1499;5638;555;2323;534;1835;1089;4158
352110;201301;375;1474;347;1415;122;546;95;363;217;909
352115;201301;300;1021;256;929;89;383;116;372;205;755
352120;201301;1032;3071;904;2896;213;703;540;1811;753;2514
352130;201301;1577;4566;1267;4063;333;1206;629;1872;962;3078
352140;201301;1096;3795;964;3501;353;1352;351;1260;704;2612
352150;201301;614;1867;513;1688;206;734;171;539;377;1273
352160;201301;1117;3427;1050;3316;310;1077;525;1663;835;2740
352170;201301;2880;9374;2684;9052;725;2684;1359;4438;2084;7122
352180;201301;3285;9818;2919;9165;915;3152;1285;3831;2200;6983
352190;201301;939;3008;859;2868;252;1008;409;1210;661;2218
352200;201301;336;1216;286;1113;83;356;93;358;176;714
352210;201301;13851;40198;11526;36713;2451;8445;7025;22766;9476;31211
352215;201301;543;1829;499;1760;92;360;313;1109;405;1469
352220;201301;14392;49637;13627;48126;4773;17728;5841;20785;10614;38513
352230;201301;12889;45947;11602;43608;3932;16054;4518;16752;8450;32806
352240;201301;13411;43764;12566;42313;4274;15922;5241;17203;9515;33125
352250;201301;22788;77665;20497;73491;5644;21804;10214;36243;15858;58047
352260;201301;4496;14778;3562;13064;1120;4574;997;3315;2117;7889
352265;201301;887;2996;805;2880;152;595;536;1927;688;2522
352270;201301;2465;8598;2200;7966;925;3508;520;1816;1445;5324
352280;201301;2369;7640;2067;7134;608;2340;733;2460;1341;4800
352290;201301;1463;4932;1320;4626;374;1469;349;1156;723;2625
352300;201301;874;2742;763;2545;253;878;329;1113;582;1991
352310;201301;28116;102008;26275;98698;7983;31948;14560;53654;22543;85602
352320;201301;6640;21632;5996;20530;2344;8731;1950;6208;4294;14939
352330;201301;2098;7181;1855;6895;746;2983;691;2601;1437;5584
352340;201301;5401;19115;4629;17254;1726;6913;1062;3717;2788;10630
352350;201301;1546;6021;1435;5775;441;1901;466;1830;907;3731
352360;201301;1104;3839;987;3597;312;1317;481;1628;793;2945
352370;201301;863;2970;802;2839;218;882;379;1297;597;2179
352380;201301;970;3205;854;3003;362;1400;238;807;600;2207
352390;201301;11612;37016;9490;33064;2642;10512;4083;13219;6725;23731
352400;201301;2614;8187;1863;6745;525;2077;866;3117;1391;5194
352410;201301;4265;13246;3452;11880;1465;5383;998;3329;2463;8712
352420;201301;1263;3816;1184;3694;468;1601;428;1331;896;2932
352430;201301;5839;19205;5183;18073;2137;7951;1633;5632;3770;13583
352440;201301;14175;46729;12140;42681;3413;13054;5019;17090;8432;30144
352450;201301;577;1786;400;1455;114;435;77;269;191;704
352460;201301;2473;8771;2274;8421;916;3750;877;3059;1793;6809
352470;201301;4646;13476;2865;9739;650;2386;1264;4214;1914;6600
352480;201301;5255;15430;4470;13960;1340;4752;1847;5339;3187;10091
352490;201301;674;2501;585;2291;167;720;115;431;282;1151
352500;201301;9299;32010;8905;31324;3720;14141;3475;11424;7195;25565
352510;201301;3149;11409;2645;10295;1021;4258;643;2435;1664;6693
352520;201301;2288;8346;2107;7957;538;2208;1290;4802;1828;7010
352530;201301;7634;26274;6393;23512;2123;8377;1826;6367;3949;14744
352540;201301;498;1662;427;1516;112;450;180;634;292;1084
352550;201301;997;3463;828;3104;323;1312;200;729;523;2041
352560;201301;517;1640;452;1522;95;383;247;775;342;1158
352570;201301;1776;5795;1324;4746;357;1445;350;1079;707;2524
352580;201301;902;2801;793;2611;287;1077;325;989;612;2066
352585;201301;135;522;125;496;39;163;42;147;81;310
352590;201301;12918;43306;11656;40884;2893;11420;6314;21549;9207;32969
352600;201301;1761;5871;1657;5637;634;2260;578;1914;1212;4174
352610;201301;3468;11701;3150;11166;1299;4922;1062;3778;2361;8700
352620;201301;5124;17432;4918;17125;1307;4849;2989;10399;4296;15248
352630;201301;810;2809;776;2726;243;934;360;1244;603;2178
352640;201301;2841;9438;2313;8199;608;2403;813;2766;1421;5169
352650;201301;806;2483;622;2119;176;642;141;450;317;1092
352660;201301;1063;3847;888;3431;303;1262;293;1116;596;2378
352670;201301;7572;26333;6720;24779;2569;9767;2198;8277;4767;18044
352680;201301;3069;11536;2646;10359;756;3245;787;2831;1543;6076
352690;201301;22314;69529;18335;62169;5462;20236;7581;25153;13043;45389
352700;201301;707;2203;567;1988;163;664;259;871;422;1535
352710;201301;4632;14872;3842;13361;1193;4563;1480;4849;2673;9412
352720;201301;8093;28943;7719;28198;2712;10522;3096;11362;5808;21884
352725;201301;377;1160;262;887;54;216;55;178;109;394
352730;201301;2357;8436;2061;7612;603;2469;619;2011;1222;4480
352740;201301;2100;6542;1860;6065;511;1985;847;2490;1358;4475
352750;201301;339;1133;308;1076;118;437;56;159;174;596
352760;201301;811;3018;757;2915;215;926;400;1487;615;2413
352770;201301;846;2729;802;2642;258;917;269;897;527;1814
352780;201301;585;2093;525;1956;177;727;154;504;331;1231
352790;201301;604;1859;510;1705;166;628;124;414;290;1042
352800;201301;1029;4064;872;3593;307;1297;145;571;452;1868
352810;201301;947;2587;721;2168;142;492;303;888;445;1380
352820;201301;477;1543;421;1422;209;751;65;220;274;971
352830;201301;390;1202;312;1021;101;351;52;167;153;518
352840;201301;3122;11484;2798;10743;918;3761;976;3728;1894;7489
352850;201301;9345;31616;8326;29785;2830;10658;2747;10148;5577;20806
352860;201301;1003;3460;928;3290;411;1548;232;755;643;2303
352870;201301;887;2550;748;2276;159;583;362;1013;521;1596
352880;201301;2017;6409;1699;5685;461;1687;424;1298;885;2985
352885;201301;291;1019;276;985;99;380;88;292;187;672
352890;201301;669;2028;589;1861;156;543;176;530;332;1073
352900;201301;16894;54065;13670;47397;4093;15416;5572;18614;9665;34030
352910;201301;283;932;251;859;81;289;40;117;121;406
352920;201301;3326;10534;2930;9724;990;3648;1040;3209;2030;6857
352930;201301;6466;21515;5329;18985;1809;6911;945;3265;2754;10176
352940;201301;26316;92996;23515;86272;8745;33624;5299;19397;14044;53021
352950;201301;309;1011;225;822;68;293;60;196;128;489
352960;201301;460;1532;388;1375;97;387;95;317;192;704
352965;201301;337;985;287;887;76;236;53;177;129;413
352970;201301;3281;8857;2929;8409;330;997;2237;6569;2567;7566
352980;201301;1336;4197;1183;3941;408;1429;491;1664;899;3093
352990;201301;3387;11964;3218;11665;1122;4284;1468;5380;2590;9664
353000;201301;518;1507;421;1312;99;345;127;361;226;706
353010;201301;2578;8013;2135;7097;757;2719;721;2258;1478;4977
353020;201301;4096;12085;3292;10394;705;2461;1344;3949;2049;6410
353030;201301;4853;15004;4350;14028;1599;5545;1210;3735;2809;9280
353040;201301;649;1920;563;1784;220;754;187;581;407;1335
353050;201301;5100;18686;4639;17751;1965;8026;1448;5306;3413;13332
353060;201301;31259;106096;29245;102832;5978;24384;18683;62803;24661;87187
353070;201301;7878;28090;6417;24661;2503;10148;1469;5728;3972;15876
353080;201301;4503;16071;3857;14551;1378;5559;1099;3930;2477;9489
353090;201301;571;1986;513;1876;107;453;237;808;344;1261
353100;201301;254;783;215;698;101;325;42;143;143;468
353110;201301;7427;24158;6687;22752;1467;5261;3879;13519;5346;18780
353120;201301;455;1618;400;1485;156;650;98;322;254;972
353130;201301;2873;9185;2557;8636;979;3636;973;3086;1952;6722
353140;201301;2401;7053;1962;6140;728;2464;497;1377;1225;3841
353150;201301;1768;5918;1522;5427;678;2516;311;1169;989;3685
353160;201301;541;1728;474;1584;155;540;105;319;260;859
353170;201301;517;1900;474;1817;209;886;153;552;362;1438
353180;201301;4348;14631;3849;13671;870;3586;2083;7039;2953;10625
353190;201301;3319;11052;2931;10138;840;3218;1218;3842;2058;7060
353200;201301;718;2637;671;2526;199;857;274;970;473;1827
353205;201301;532;1769;431;1534;114;420;128;468;242;888
353210;201301;865;2516;731;2261;157;537;378;1143;535;1680
353215;201301;522;1704;466;1585;112;456;179;605;291;1061
353220;201301;878;2775;811;2651;231;837;308;979;539;1816
353230;201301;1159;3736;1096;3630;334;1236;424;1330;758;2566
353240;201301;2018;7102;1871;6798;661;2651;739;2480;1400;5131
353250;201301;1075;3177;936;2934;296;997;316;940;612;1937
353260;201301;1129;3455;1011;3261;352;1185;358;1141;710;2326
353270;201301;567;1801;494;1663;167;619;145;465;312;1084
353280;201301;499;1699;440;1601;166;640;98;345;264;985
353282;201301;1675;5837;1637;5778;332;1282;1129;3934;1461;5216
353284;201301;327;989;274;895;87;305;86;278;173;583
353286;201301;136;419;95;322;28;93;18;63;46;156
353290;201301;406;1526;376;1460;162;655;127;485;289;1140
353300;201301;1950;6397;1777;6016;705;2562;540;1661;1245;4223
353310;201301;341;1102;325;1064;144;493;91;284;235;777
353320;201301;407;1240;358;1164;109;412;150;449;259;861
353325;201301;452;1655;388;1525;143;621;50;193;193;814
353330;201301;465;1502;403;1366;103;390;167;525;270;915
353340;201301;2859;9797;2557;9139;967;3686;795;2761;1762;6447
353350;201301;3101;9718;2746;9070;1017;3603;1154;3682;2171;7285
353360;201301;393;1433;344;1317;106;461;165;589;271;1050
353370;201301;680;2262;619;2125;203;746;277;943;480;1689
353380;201301;380;1310;343;1242;119;473;150;531;269;1004
353390;201301;4384;12834;3620;11421;1141;3930;1349;3962;2490;7892
353400;201301;542;1744;467;1588;123;460;163;491;286;951
353410;201301;632;2045;544;1905;189;720;262;888;451;1608
353420;201301;581;1855;518;1678;197;670;144;437;341;1107
353430;201301;2364;8351;1887;7014;728;2776;148;500;876;3276
353440;201301;56283;189448;52444;180565;17226;62958;18212;61160;35438;124118
353450;201301;437;1381;395;1304;116;461;141;427;257;888
353460;201301;3697;11010;3305;10282;964;3268;1538;4714;2502;7982
353470;201301;10530;34748;8524;30429;2928;11378;1999;6988;4927;18366
353475;201301;1544;4661;1196;3892;353;1254;310;921;663;2175
353480;201301;1461;4541;1342;4323;325;1207;702;2135;1027;3342
353490;201301;1642;4853;1413;4397;399;1381;401;1144;800;2525
353500;201301;1127;3394;1050;3255;491;1607;321;943;812;2550
353510;201301;1352;4493;1202;4106;332;1271;459;1406;791;2677
353520;201301;1083;3482;937;3214;434;1589;206;687;640;2276
353530;201301;2569;8132;2317;7656;741;2710;950;3013;1691;5723
353540;201301;1773;5738;1649;5521;710;2482;539;1862;1249;4344
353550;201301;6252;19044;5670;18082;1389;5163;2870;8412;4259;13575
353560;201301;2316;7920;2034;7430;572;2401;857;2979;1429;5380
353570;201301;456;1506;385;1355;99;412;194;602;293;1014
353580;201301;2213;7655;2104;7447;845;3294;987;3296;1832;6590
353590;201301;765;2259;659;2078;272;939;171;563;443;1502
353600;201301;1713;5230;1592;5015;401;1409;807;2550;1208;3959
353610;201301;551;2048;499;1950;187;810;174;669;361;1479
353620;201301;2238;8108;2079;7824;743;3082;772;2727;1515;5809
353625;201301;351;999;261;839;112;407;58;159;170;566
353630;201301;1777;6194;1515;5620;472;1969;386;1332;858;3301
353640;201301;1525;4471;1448;4345;442;1429;725;2231;1167;3660
353650;201301;4128;13992;3667;12944;1026;3935;1850;6240;2876;10175
353657;201301;274;960;255;919;78;324;86;292;164;616
353660;201301;1292;3375;997;2976;475;1547;170;395;645;1942
353670;201301;4577;15569;4081;14484;1279;4905;1447;4975;2726;9880
353680;201301;615;2286;585;2227;338;1323;122;477;460;1800
353690;201301;462;1300;329;1089;125;461;98;289;223;750
353700;201301;2211;7429;2005;6984;534;2152;677;2175;1211;4327
353710;201301;1714;6414;1561;6077;643;2740;557;2092;1200;4832
353715;201301;449;1396;403;1317;66;240;240;796;306;1036
353720;201301;1994;6462;1778;6145;379;1262;1095;4039;1474;5301
353730;201301;4251;13727;3472;11895;975;3588;876;2810;1851;6398
353740;201301;2176;6900;1792;6088;662;2319;484;1604;1146;3923
353750;201301;578;2174;518;2039;195;829;124;487;319;1316
353760;201301;5916;20691;5017;18790;1694;6649;1846;7056;3540;13705
353770;201301;757;2421;537;1894;125;482;78;211;203;693
353780;201301;5400;20143;4965;19266;2534;9992;1135;4745;3669;14737
353790;201301;3031;11133;2742;10531;1055;4422;529;2122;1584;6544
353800;201301;13560;46532;11498;42336;3385;13642;4916;17709;8301;31351
353810;201301;1110;3794;1015;3578;333;1216;430;1547;763;2763
353820;201301;1106;4129;1059;4034;427;1787;350;1269;777;3056
353830;201301;755;2147;591;1825;143;476;234;725;377;1201
353850;201301;1717;5986;1612;5787;476;1825;726;2551;1202;4376
353860;201301;2214;7833;1959;7277;756;3032;731;2642;1487;5674
353870;201301;21959;72152;17361;62684;4532;18407;6206;20529;10738;38936
353880;201301;2603;8915;2399;8590;556;2268;1377;4796;1933;7064
353890;201301;2159;5933;1640;5105;546;1868;672;1983;1218;3851
353900;201301;1067;3448;833;2903;253;982;191;590;444;1572
353910;201301;2066;7482;1967;7205;662;2571;834;3078;1496;5649
353920;201301;2658;8210;2124;7084;566;1946;426;1350;992;3296
353930;201301;3488;12923;3109;12130;1258;5219;762;2841;2020;8060
353940;201301;1455;4800;1306;4498;360;1444;506;1593;866;3037
353950;201301;3520;11899;3263;11428;640;2570;2055;7003;2695;9573
353960;201301;559;1863;467;1643;126;510;131;395;257;905
353970;201301;516;1566;459;1497;49;199;344;1094;393;1293
353980;201301;13334;40546;11417;37647;2999;10690;5939;19353;8938;30043
353990;201301;509;1655;466;1546;150;559;174;514;324;1073
354000;201301;1557;4922;1168;4151;307;1212;120;366;427;1578
354010;201301;366;1192;332;1133;178;631;76;251;254;882
354020;201301;4490;14231;4141;13517;1446;5105;1727;5347;3173;10452
354025;201301;1005;3003;831;2709;249;901;230;734;479;1635
354030;201301;577;1567;425;1353;154;554;129;366;283;920
354040;201301;748;2106;608;1854;102;389;370;1062;472;1451
354050;201301;846;2987;792;2858;350;1320;211;767;561;2087
354060;201301;3938;13472;3354;12268;1074;4305;1368;4802;2442;9107
354070;201301;3386;11627;3005;10786;1239;4747;714;2555;1953;7302
354075;201301;2228;8702;2138;8539;793;3397;901;3535;1694;6932
354080;201301;1779;5632;1490;4937;430;1497;560;1769;990;3266
354085;201301;286;846;256;791;35;142;170;479;205;621
354090;201301;1056;3308;1020;3252;169;609;742;2303;911;2912
354100;201301;16039;56630;14074;53111;3614;14592;7207;27267;10821;41859
354105;201301;758;2553;639;2319;216;906;170;554;386;1460
354110;201301;636;2148;593;2057;159;614;207;668;366;1282
354120;201301;1997;6062;1825;5784;660;2327;550;1622;1210;3949
354130;201301;5818;18737;5281;17651;1826;6503;1984;6504;3810;13007
354140;201301;16053;46566;12158;38593;2862;10349;5507;16444;8369;26793
354150;201301;4033;12042;3407;10964;1189;4210;1269;3970;2458;8180
354160;201301;3691;12645;3326;11871;1038;3979;1312;4503;2350;8482
354165;201301;366;1384;337;1312;128;509;82;339;210;848
354170;201301;1564;5301;1298;4644;318;1272;448;1445;766;2717
354180;201301;472;1484;450;1438;52;198;331;1015;383;1213
354190;201301;1586;5550;1390;5083;484;1867;411;1462;895;3329
354200;201301;1094;3314;920;3000;238;921;342;974;580;1895
354210;201301;829;3008;751;2828;207;897;294;1031;501;1928
354220;201301;2850;9445;2636;9005;1018;3684;964;3190;1982;6874
354230;201301;746;2582;717;2532;253;951;324;1148;577;2099
354240;201301;1172;4169;1004;3818;349;1449;276;1010;625;2459
354250;201301;446;1523;397;1464;188;762;111;381;299;1143
354260;201301;9103;28658;8335;27420;2674;9532;3501;11608;6175;21140
354270;201301;1071;3960;1001;3806;330;1347;408;1576;738;2923
354280;201301;838;2627;801;2562;170;604;422;1361;592;1965
354290;201301;1284;4694;1191;4486;419;1684;297;1107;716;2791
354300;201301;3737;13598;3679;13479;1037;3996;2060;7505;3097;11501
354310;201301;731;2534;592;2186;185;753;127;459;312;1212
354320;201301;781;2444;699;2289;206;747;259;806;465;1553
354323;201301;310;972;260;888;87;328;105;323;192;651
354325;201301;1261;4496;1164;4288;389;1616;414;1395;803;3011
354330;201301;7750;24947;7195;23921;1979;7013;3996;13133;5975;20146
354340;201301;28226;95305;24568;88583;9664;37397;8613;30192;18277;67589
354350;201301;1119;3502;1071;3412;335;1122;559;1726;894;2848
354360;201301;417;1409;355;1301;106;423;84;307;190;730
354370;201301;1123;3900;1026;3716;197;834;717;2537;914;3371
354380;201301;1290;3975;1086;3600;431;1561;193;571;624;2132
354390;201301;10158;34871;8236;30301;2374;9636;2684;9356;5058;18992
354400;201301;2040;7434;1816;6898;496;2074;583;2084;1079;4158
354410;201301;5998;19043;5170;17828;1271;4725;2915;10095;4186;14820
354420;201301;1624;4918;1418;4485;479;1630;455;1387;934;3017
354425;201301;3407;10245;3002;9521;1118;3728;976;3192;2094;6920
354430;201301;1269;4337;1187;4221;302;1216;608;2092;910;3308
354440;201301;466;1494;404;1379;120;438;134;450;254;888
354450;201301;413;1240;322;1042;57;233;92;270;149;503
354460;201301;677;2203;654;2160;269;914;334;1105;603;2019
354470;201301;410;1262;366;1181;74;294;175;527;249;821
354480;201301;703;2223;635;2099;160;619;256;732;416;1351
354490;201301;702;2485;542;2065;169;699;136;450;305;1149
354500;201301;2481;8662;2294;8324;880;3478;779;2878;1659;6356
354510;201301;645;2269;575;2104;217;851;191;686;408;1537
354515;201301;329;1183;277;1065;76;327;83;292;159;619
354520;201301;4666;17491;4206;16454;1528;6589;1507;5706;3035;12295
354530;201301;2329;9005;2180;8704;611;2602;1236;4953;1847;7555
354540;201301;1264;4108;1122;3854;411;1487;376;1337;787;2824
354550;201301;502;1763;444;1607;105;408;152;517;257;925
354560;201301;1260;4005;1030;3470;348;1200;257;826;605;2026
354570;201301;575;1859;490;1646;192;709;126;387;318;1096
354580;201301;8782;27296;7625;24936;1908;7107;3602;11090;5510;18197
354600;201301;1629;5881;1460;5544;526;2243;571;2053;1097;4296
354610;201301;464;1313;348;1097;90;305;110;297;200;602
354620;201301;393;1413;332;1297;103;473;103;367;206;840
354625;201301;244;845;215;797;57;235;61;227;118;462
354630;201301;1641;6023;1473;5601;578;2256;476;1710;1054;3966
354640;201301;3997;13812;3500;12738;1179;4802;863;2938;2042;7740
354650;201301;952;3028;865;2840;204;776;447;1401;651;2177
354660;201301;1840;5812;1467;5059;554;2137;440;1420;994;3557
354670;201301;1676;5703;1399;5015;445;1775;383;1204;828;2979
354680;201301;4882;17236;4585;16620;1425;5430;1811;6517;3236;11947
354690;201301;601;2308;500;2007;129;553;169;607;298;1160
354700;201301;1099;3314;801;2667;142;586;325;968;467;1554
354710;201301;586;1822;521;1697;165;638;164;480;329;1118
354720;201301;173;514;137;438;49;157;40;132;89;289
354730;201301;7974;29527;7332;28158;2626;10560;2718;10274;5344;20834
354740;201301;217;733;184;659;48;184;47;172;95;356
354750;201301;2210;7286;1888;6843;679;2551;806;3049;1485;5600
354760;201301;2097;7244;1853;6710;676;2594;517;1815;1193;4409
354765;201301;239;677;186;598;40;160;62;190;102;350
354770;201301;2631;8037;2140;7213;1019;3672;337;1059;1356;4731
354780;201301;29411;100875;27907;97318;7763;29732;13858;46066;21621;75798
354790;201301;843;2805;763;2690;248;985;375;1224;623;2209
354800;201301;1848;6063;1697;5847;652;2349;803;2812;1455;5161
354805;201301;819;2636;657;2293;150;602;131;426;281;1028
354810;201301;629;2135;514;1921;219;884;88;317;307;1201
354820;201301;952;3560;870;3386;312;1361;209;740;521;2101
354830;201301;409;1327;370;1251;104;393;139;458;243;851
354840;201301;761;2416;723;2334;252;897;241;757;493;1654
354850;201301;14234;48114;11461;42294;3554;14565;3956;13633;7510;28198
354860;201301;1222;4098;1121;3920;349;1460;488;1565;837;3025
354870;201301;40502;134878;38706;131260;11654;42715;20602;67754;32256;110469
354880;201301;3722;12244;2840;10271;1019;4014;678;2271;1697;6285
354890;201301;13667;43913;12007;40589;3620;13513;4496;14593;8116;28106
354900;201301;591;1707;482;1548;178;618;171;549;349;1167
354910;201301;4589;15634;3766;13925;1208;4899;696;2518;1904;7417
354920;201301;475;1428;367;1226;112;411;84;270;196;681
354925;201301;361;1091;216;775;43;175;44;146;87;321
354930;201301;235;745;216;699;72;263;56;179;128;442
354940;201301;2477;8941;1979;7573;873;3512;363;1335;1236;4847
354950;201301;1393;4819;1277;4652;277;1174;758;2671;1035;3845
354960;201301;755;2459;685;2350;198;757;367;1223;565;1980
354970;201301;3672;12985;3302;12213;974;4037;1493;5253;2467;9290
354980;201301;31374;80090;17760;56251;4219;14814;5688;16857;9907;31671
354990;201301;30784;109912;29368;106896;7308;29702;16242;57324;23550;87026
354995;201301;1875;6082;1775;5932;515;1838;867;2908;1382;4746
355000;201301;1609;5625;1430;5307;570;2232;387;1439;957;3671
355010;201301;3318;10942;2969;10281;711;2772;1566;5297;2277;8069
355020;201301;3055;11458;2707;10779;1387;5813;778;3157;2165;8970
355030;201301;678224;2124358;635564;2040745;202878;702370;247046;782745;449924;1485115
355040;201301;2681;9318;2405;8789;958;3801;987;3473;1945;7274
355050;201301;1136;3835;962;3458;349;1371;253;885;602;2256
355060;201301;4510;16201;3729;14338;1155;4927;818;2862;1973;7789
355070;201301;5852;19332;5313;18430;1396;5555;2792;9116;4188;14671
355080;201301;1245;4779;1077;4315;445;1970;157;538;602;2508
355090;201301;1001;3774;870;3454;212;914;385;1465;597;2379
355100;201301;28836;96516;26088;91541;9654;35301;8761;31900;18415;67201
355110;201301;1226;4434;1133;4242;419;1690;420;1552;839;3242
355120;201301;614;2068;551;1943;184;708;242;850;426;1558
355130;201301;408;1209;323;1030;97;333;92;244;189;577
355140;201301;969;3639;935;3556;300;1260;437;1598;737;2858
355150;201301;3098;11128;2838;10565;1013;3922;1047;3756;2060;7678
355160;201301;1404;5104;1250;4856;564;2423;364;1271;928;3694
355170;201301;8347;25795;6504;22330;2329;8673;1895;6301;4224;14974
355180;201301;2670;8703;2390;8191;759;2970;900;2965;1659;5935
355190;201301;1217;4439;1132;4245;499;1924;315;1165;814;3089
355200;201301;859;3337;827;3272;415;1739;202;777;617;2516
355210;201301;2558;9237;2332;8729;813;3364;815;2844;1628;6208
355220;201301;27093;96379;25343;92986;11900;44971;7389;28035;19289;73006
355230;201301;861;2775;596;2148;137;553;138;458;275;1011
355240;201301;20444;65374;16108;55505;4116;15907;6350;20261;10466;36168
355250;201301;22487;79332;20718;76015;6358;24787;10098;36851;16456;61638
355255;201301;843;2424;649;2029;129;446;205;610;334;1056
355260;201301;1541;4513;1401;4259;411;1436;626;1771;1037;3207
355270;201301;1564;5030;1486;4903;259;1035;1010;3157;1269;4192
355280;201301;18403;60834;16592;57453;5136;19252;7577;25444;12713;44696
355290;201301;829;2788;771;2680;181;700;351;1157;532;1857
355300;201301;921;3212;743;2790;201;839;162;535;363;1374
355310;201301;973;3114;876;2931;265;910;355;1245;620;2155
355320;201301;699;2324;631;2169;201;758;217;664;418;1422
355330;201301;1468;5544;1272;5151;530;2359;300;1107;830;3466
355340;201301;2724;7908;2633;7768;652;2178;1603;4524;2255;6702
355350;201301;1259;4750;1179;4563;464;1940;294;1174;758;3114
355360;201301;1027;3857;970;3740;295;1257;567;2134;862;3391
355365;201301;309;1011;269;928;88;342;65;215;153;557
355370;201301;6249;17271;4722;15586;2023;7211;1785;5952;3808;13163
355380;201301;3562;11222;2834;9514;897;3283;613;1823;1510;5106
355385;201301;917;3183;890;3138;363;1391;284;1001;647;2392
355390;201301;1366;3961;1199;3627;325;1066;411;1241;736;2307
355395;201301;1423;4638;1198;4072;225;896;573;1788;798;2684
355400;201301;8141;29340;7599;28248;2315;9532;4081;14681;6396;24213
355410;201301;11791;45274;11262;44206;4725;19457;3429;13706;8154;33163
355420;201301;780;2956;755;2903;338;1345;236;938;574;2283
355430;201301;3437;10629;3029;9889;962;3436;1168;3674;2130;7110
355440;201301;819;2843;704;2554;227;863;215;721;442;1584
355450;201301;2387;8304;2035;7567;703;2816;567;2016;1270;4832
355460;201301;534;1613;421;1398;138;521;113;348;251;869
355465;201301;413;1277;357;1173;123;427;91;299;214;726
355470;201301;882;2856;721;2571;306;1195;173;570;479;1765
355475;201301;140;542;120;477;31;129;37;161;68;290
355480;201301;3093;11742;2925;11357;1012;4225;1200;4566;2212;8791
355490;201301;744;2264;612;2004;183;654;144;482;327;1136
355495;201301;633;2215;609;2172;220;862;227;770;447;1632
355500;201301;7435;24013;5525;19652;1523;5981;1044;3410;2567;9391
355510;201301;1557;4906;1347;4443;380;1411;338;1068;718;2479
355520;201301;360;994;261;798;68;237;72;189;140;426
355530;201301;146;425;100;331;25;91;19;64;44;155
355535;201301;730;2281;615;2065;181;728;205;586;386;1314
355540;201301;9695;32705;9255;31963;2707;10057;4767;16245;7474;26302
355550;201301;685;2227;654;2173;200;739;311;1006;511;1745
355560;201301;1384;4175;1105;3650;270;998;310;944;580;1942
355570;201301;174;612;158;571;50;189;28;95;78;284
355580;201301;1113;3551;1007;3335;460;1654;288;928;748;2582
355590;201301;225;665;209;643;49;180;112;339;161;519
355600;201301;909;3162;808;2938;413;1527;199;743;612;2270
355610;201301;1401;4214;1201;3905;373;1316;508;1593;881;2909
355620;201301;3603;12139;2979;10745;788;3265;1254;4152;2042;7417
355630;201301;3163;9453;2050;7074;455;1782;767;2489;1222;4271
355635;201301;854;3053;806;2954;236;940;381;1359;617;2299
355640;201301;3598;12431;3151;11417;1267;4765;685;2526;1952;7291
355645;201301;3223;12065;3097;11822;710;2984;1908;7198;2618;10182
355650;201301;6041;19833;5359;18497;1426;5836;2911;9240;4337;15076
355660;201301;1213;4108;1019;3705;384;1558;291;971;675;2529
355670;201301;1922;6433;1346;5024;393;1651;401;1319;794;2970
355680;201301;1653;5901;1400;5273;590;2316;271;991;861;3307
355690;201301;327;1187;300;1137;187;747;27;81;214;828
355695;201301;320;987;244;807;52;195;36;96;88;291
355700;201301;6029;22367;5659;21450;1780;7408;2573;9289;4353;16697
355710;201301;11095;30283;7828;24456;2911;9676;1963;6002;4874;15678
355715;201301;170;559;136;494;46;169;19;63;65;232
355720;201301;1421;4903;1239;4547;487;1954;335;1114;822;3068
355730;201301;723;2626;669;2522;306;1211;177;690;483;1901
410010;201301;1580;5207;1475;5008;434;1563;656;2259;1090;3822
410020;201301;1143;4121;1092;4037;397;1539;389;1412;786;2951
410030;201301;1085;4030;1012;3834;395;1551;228;884;623;2435
410040;201301;11653;40785;10932;39348;4355;16686;3044;10920;7399;27606
410045;201301;1072;3242;867;2900;280;984;376;1244;656;2228
410050;201301;2737;8362;2038;7040;765;2890;622;2102;1387;4992
410060;201301;1699;5783;1567;5497;515;1998;515;1767;1030;3765
410070;201301;2024;6043;1770;5548;761;2662;343;907;1104;3569
410080;201301;1301;4172;1151;3934;328;1176;668;2281;996;3457
410090;201301;1093;3614;997;3398;394;1461;281;886;675;2347
410100;201301;2503;8038;2148;7302;721;2788;549;1827;1270;4615
410105;201301;482;1612;405;1423;110;451;84;260;194;711
410110;201301;2068;6884;1955;6653;579;2207;803;2712;1382;4919
410115;201301;504;1472;444;1350;117;429;131;330;248;759
410120;201301;2741;9798;2615;9598;1062;4103;1025;3856;2087;7959
410130;201301;1276;4558;1196;4398;285;995;752;2857;1037;3852
410140;201301;11619;36131;9487;32048;3602;13376;3231;10724;6833;24100
410150;201301;16346;43785;8647;27481;1986;7266;1628;4687;3614;11953
410160;201301;3191;10691;2940;10251;1044;3965;1089;3839;2133;7804
410165;201301;711;2302;650;2167;145;522;328;1066;473;1588
410170;201301;1506;4882;1335;4520;556;2033;369;1208;925;3241
410180;201301;8362;28089;7497;26252;2081;8414;3591;11674;5672;20088
410185;201301;632;1842;595;1780;121;376;394;1200;515;1576
410190;201301;2046;6364;1926;6127;713;2448;622;1907;1335;4355
410200;201301;4867;14511;4165;13185;1568;5459;832;2591;2400;8050
410210;201301;2442;7645;2021;6760;588;2228;438;1306;1026;3534
410220;201301;564;1713;485;1555;114;408;171;533;285;941
410230;201301;1744;5840;1642;5675;678;2521;557;1888;1235;4409
410240;201301;4830;15795;4566;15258;1606;5724;1665;5604;3271;11328
410250;201301;2259;6747;1764;5777;632;2328;398;1154;1030;3482
410260;201301;1552;5023;1403;4766;456;1636;497;1710;953;3346
410270;201301;512;1574;451;1458;160;562;173;569;333;1131
410275;201301;845;2603;667;2298;120;465;388;1357;508;1822
410280;201301;2661;8255;1921;6596;506;1986;291;973;797;2959
410290;201301;2910;9725;2685;9317;738;2829;1242;4291;1980;7120
410300;201301;540;1603;507;1554;93;356;298;844;391;1200
410302;201301;528;1622;474;1545;55;174;306;1029;361;1203
410304;201301;1326;4628;1235;4447;391;1437;558;2100;949;3537
410305;201301;1878;5461;1659;5129;550;1780;859;2716;1409;4496
410310;201301;2152;7619;2014;7349;707;2752;669;2568;1376;5320
410315;201301;614;2040;537;1891;144;555;256;865;400;1420
410320;201301;1125;3436;839;2887;222;882;88;260;310;1142
410322;201301;452;1524;415;1442;136;520;148;512;284;1032
410330;201301;1363;4104;1198;3771;409;1414;358;1074;767;2488
410335;201301;989;3081;865;2855;263;972;294;930;557;1902
410337;201301;732;2077;646;1930;149;522;274;784;423;1306
410340;201301;556;1741;447;1479;99;373;103;292;202;665
410345;201301;1565;4971;1398;4658;534;1945;291;896;825;2841
410347;201301;801;2392;611;2027;216;775;120;369;336;1144
410350;201301;895;2988;738;2691;256;1044;99;326;355;1370
410360;201301;3120;10100;2889;9721;1084;3940;759;2588;1843;6528
410370;201301;11511;35418;9304;30895;2843;10640;2691;8401;5534;19041
410380;201301;1255;4184;1184;4038;352;1262;578;1990;930;3252
410390;201301;2678;8163;2244;7431;839;3008;687;2101;1526;5109
410395;201301;787;2900;738;2805;198;797;425;1643;623;2440
410400;201301;4727;15899;4260;14983;1461;5685;1253;4335;2714;10020
410405;201301;889;2748;754;2471;183;702;360;1103;543;1805
410410;201301;1276;4545;1234;4467;430;1711;377;1333;807;3044
410420;201301;9356;31697;8543;29902;3111;11885;2549;8501;5660;20386
410425;201301;3504;11661;2765;9988;858;3447;469;1678;1327;5125
410430;201301;13622;40027;10956;35157;3607;12618;3337;10807;6944;23425
410440;201301;3408;11370;3189;10980;800;2888;1685;5946;2485;8834
410442;201301;2755;9991;2623;9705;948;3640;976;3638;1924;7278
410445;201301;2144;7734;1933;7367;645;2584;839;3350;1484;5934
410450;201301;2342;7066;2014;6460;668;2339;552;1639;1220;3978
410460;201301;2276;7118;1937;6402;508;1794;810;2617;1318;4411
410465;201301;1502;6012;1420;5800;606;2536;393;1554;999;4090
410470;201301;1709;5729;1587;5482;481;1744;629;2191;1110;3935
410480;201301;25363;79491;22384;73920;9228;33364;6361;20190;15589;53554
410490;201301;9725;34499;9083;33089;3271;12813;3190;11673;6461;24486
410500;201301;1302;4421;1187;4186;453;1730;335;1213;788;2943
410510;201301;2053;5910;1668;5232;538;1802;603;1838;1141;3640
410520;201301;3096;11191;2966;10926;1198;4637;1017;3802;2215;8439
410530;201301;1461;4459;1305;4144;368;1332;523;1587;891;2919
410540;201301;3633;10904;2747;9330;782;2845;1047;3635;1829;6480
410550;201301;5758;18807;4756;16544;1744;6724;630;1979;2374;8703
410560;201301;1093;3764;902;3239;247;943;206;640;453;1583
410570;201301;2537;8988;2380;8705;764;2888;1019;3934;1783;6822
410580;201301;23234;77136;21415;73795;7954;29799;6945;23236;14899;53035
410590;201301;1179;3968;883;3144;192;787;227;730;419;1517
410600;201301;1707;5501;1537;5157;469;1640;728;2494;1197;4134
410610;201301;778;2556;709;2422;221;807;308;1027;529;1834
410620;201301;1608;6000;1494;5719;500;2051;441;1676;941;3727
410630;201301;2325;7151;2092;6759;600;2231;972;3065;1572;5296
410640;201301;4257;13482;3739;12574;1389;5252;938;3007;2327;8259
410645;201301;1155;4384;1129;4316;468;1890;385;1532;853;3422
410650;201301;2317;7448;2024;6897;774;2786;678;2294;1452;5080
410655;201301;845;2740;758;2565;243;883;238;794;481;1677
410657;201301;521;1702;490;1637;152;598;202;617;354;1215
410660;201301;3631;10915;2969;9492;1162;3966;617;1857;1779;5823
410670;201301;960;2851;756;2443;221;809;231;715;452;1524
410680;201301;2108;7870;1862;7209;562;2257;741;2969;1303;5226
410685;201301;621;1954;589;1896;145;470;357;1160;502;1630
410690;201301;110093;332193;82387;276170;23618;88500;23542;72432;47160;160932
410700;201301;2137;7394;2036;7183;761;2900;738;2493;1499;5393
410710;201301;1020;3376;864;3005;235;923;243;814;478;1737
410712;201301;653;2147;602;2041;275;1020;174;620;449;1640
410715;201301;1084;3533;995;3359;285;1025;386;1297;671;2322
410720;201301;3530;11840;3158;11048;984;3597;1003;3468;1987;7065
410725;201301;988;2931;798;2601;228;808;275;810;503;1618
410730;201301;685;2164;636;2060;295;1020;167;514;462;1534
410740;201301;834;2636;620;2196;167;668;246;849;413;1517
410750;201301;1616;5126;1482;4819;561;1997;443;1366;1004;3363
410752;201301;216;710;209;701;54;218;111;352;165;570
410753;201301;421;1385;388;1319;108;423;137;423;245;846
410754;201301;919;3113;826;2943;163;633;523;1894;686;2527
410755;201301;568;1760;510;1656;135;500;210;639;345;1139
410760;201301;2280;7790;2198;7624;894;3236;815;2842;1709;6078
410765;201301;13624;42969;11266;38283;3276;12365;2486;8441;5762;20806
410770;201301;783;2363;700;2209;198;701;309;942;507;1643
410773;201301;1161;3856;1057;3655;290;1145;464;1473;754;2618
410775;201301;1774;5460;1751;5428;398;1148;1231;4006;1629;5154
410780;201301;547;1775;482;1645;136;490;131;474;267;964
410785;201301;871;2962;721;2495;255;915;267;932;522;1847
410790;201301;707;2279;621;2081;224;839;144;433;368;1272
410800;201301;2017;6205;1808;5889;873;3021;516;1643;1389;4664
410810;201301;295;926;240;798;34;134;106;336;140;470
410820;201301;999;3153;911;2958;303;1082;283;891;586;1973
410830;201301;27531;88611;24022;82225;7558;28065;8882;30375;16440;58440
410832;201301;1095;3419;1025;3289;256;980;520;1547;776;2527
410840;201301;7478;24819;6827;23413;2481;9321;1782;5669;4263;14990
410845;201301;1462;4699;1325;4421;321;1173;704;2360;1025;3533
410850;201301;2510;7780;2314;7517;470;1858;1363;4325;1833;6183
410855;201301;669;2008;616;1905;185;605;223;710;408;1315
410860;201301;2618;8282;2415;7997;788;2722;1091;3777;1879;6499
410865;201301;1584;5769;1452;5503;243;961;936;3661;1179;4622
410870;201301;1330;4358;1280;4278;522;1892;460;1517;982;3409
410880;201301;4809;14681;4078;13440;1400;5136;1298;4107;2698;9243
410890;201301;1039;3326;826;2928;304;1164;135;438;439;1602
410895;201301;1157;4280;1085;4108;399;1596;403;1494;802;3090
410900;201301;782;2325;627;2080;139;520;170;552;309;1072
410910;201301;288;938;258;879;67;251;108;344;175;595
410920;201301;762;2460;631;2212;202;762;159;512;361;1274
410930;201301;1925;6439;1756;6166;554;2202;695;2376;1249;4578
410940;201301;18760;67327;17522;65184;6048;24232;8003;30038;14051;54270
410950;201301;1840;6386;1697;6123;389;1448;1020;3773;1409;5221
410960;201301;5286;16009;4107;14095;1522;5518;1422;5108;2944;10626
410965;201301;979;3455;928;3353;203;791;582;2147;785;2938
410970;201301;4781;15308;4160;14025;1560;5838;963;3303;2523;9141
410975;201301;1175;3786;1056;3580;222;859;554;1888;776;2747
410980;201301;4425;13882;3288;11442;996;3848;814;2659;1810;6507
410990;201301;960;3101;771;2675;280;1077;172;506;452;1583
411000;201301;351;1152;284;1001;76;298;51;165;127;463
411005;201301;417;1279;359;1144;109;353;86;262;195;615
411007;201301;2034;6900;1965;6799;641;2355;1005;3569;1646;5924
411010;201301;3606;12842;3432;12479;1528;5979;987;3429;2515;9408
411020;201301;2470;8358;2310;8073;800;3013;922;3280;1722;6293
411030;201301;775;2266;684;2107;249;848;175;503;424;1351
411040;201301;342;1164;296;1054;118;433;62;227;180;660
411050;201301;2067;7801;1917;7459;804;3333;448;1776;1252;5109
411060;201301;2006;6553;1794;6134;646;2461;334;1019;980;3480
411065;201301;350;1106;294;984;55;215;109;323;164;538
411070;201301;3270;11393;2676;10246;987;4138;305;1100;1292;5238
411080;201301;1754;5834;1672;5659;385;1465;945;3160;1330;4625
411090;201301;1018;2985;900;2816;274;989;270;799;544;1788
411095;201301;1438;4332;1182;3867;365;1288;359;1182;724;2470
411100;201301;1455;4333;1123;3697;307;1116;289;978;596;2094
411110;201301;874;2720;711;2387;228;821;126;366;354;1187
411120;201301;1562;5151;1425;4847;473;1725;469;1580;942;3305
411125;201301;4498;15028;4412;14875;1642;5845;2119;7076;3761;12921
411130;201301;711;2259;618;2071;212;738;228;782;440;1520
411140;201301;2134;7978;1927;7442;776;3120;482;2035;1258;5155
411150;201301;5553;16552;5034;15613;1656;5583;1519;4397;3175;9980
411155;201301;1046;3306;980;3157;394;1369;286;849;680;2218
411160;201301;283;891;262;847;114;401;89;274;203;675
411170;201301;749;2668;691;2522;227;888;212;757;439;1645
411180;201301;5641;18188;5120;17277;1785;6525;1614;5480;3399;12005
411190;201301;1700;5241;1469;4823;484;1741;423;1335;907;3076
411200;201301;3537;11974;3218;11452;1370;5239;1035;3660;2405;8899
411210;201301;2675;7977;2240;7199;902;3156;300;897;1202;4053
411220;201301;1117;3432;926;3080;266;999;373;1155;639;2154
411230;201301;911;2967;820;2780;290;1046;285;941;575;1987
411240;201301;784;2552;714;2399;340;1233;165;479;505;1712
411250;201301;3007;8670;2542;7825;784;2494;895;2804;1679;5298
411260;201301;247;739;199;656;58;224;96;296;154;520
411270;201301;1895;6283;1785;6106;653;2476;736;2456;1389;4932
411275;201301;1473;4590;1368;4385;434;1486;542;1723;976;3209
411280;201301;1634;5221;1349;4635;457;1784;206;640;663;2424
411290;201301;991;2926;864;2692;255;854;326;1053;581;1907
411295;201301;1029;3250;965;3151;229;824;442;1405;671;2229
411300;201301;1280;3411;904;2686;80;283;391;1065;471;1348
411310;201301;790;2399;658;2178;182;695;303;963;485;1658
411320;201301;5393;17308;4612;15758;1361;4936;1383;4581;2744;9517
411325;201301;1443;5022;1336;4828;149;620;968;3542;1117;4162
411330;201301;3332;11520;3114;11155;1198;4604;1048;3741;2246;8345
411340;201301;891;2685;634;2087;134;488;269;897;403;1385
411342;201301;848;2542;738;2302;221;788;258;715;479;1503
411345;201301;1020;3467;963;3358;288;1090;494;1712;782;2802
411350;201301;2390;7836;1932;6925;706;2700;337;1161;1043;3861
411360;201301;482;1286;330;1006;48;181;149;385;197;566
411370;201301;39355;119306;30476;102296;7787;30645;10076;31033;17863;61678
411373;201301;1270;4267;1119;3950;353;1413;253;825;606;2238
411375;201301;1254;3589;1032;3149;324;1045;340;1004;664;2049
411380;201301;1224;3342;791;2451;178;613;227;694;405;1307
411390;201301;1631;5441;1539;5301;226;887;1185;3971;1411;4858
411400;201301;1474;4622;1280;4212;354;1314;496;1627;850;2941
411410;201301;2289;7416;2077;6956;745;2870;620;1788;1365;4658
411420;201301;4189;12521;3473;11067;1161;4143;789;2284;1950;6427
411430;201301;2365;8330;2201;7998;651;2563;1004;3525;1655;6088
411435;201301;490;1691;455;1614;138;522;157;551;295;1073
411440;201301;2391;8325;2241;8028;866;3331;706;2549;1572;5880
411450;201301;1685;5468;1552;5244;439;1515;789;2759;1228;4274
411460;201301;3661;12483;3338;11777;1519;5636;614;2137;2133;7773
411470;201301;899;2901;738;2527;249;907;162;524;411;1431
411480;201301;4138;13459;3595;12448;1703;6305;820;2756;2523;9061
411490;201301;1560;5180;1406;4884;649;2487;319;1010;968;3497
411500;201301;1146;3862;1015;3526;423;1565;246;837;669;2402
411510;201301;2317;7085;1954;6440;700;2487;473;1453;1173;3940
411520;201301;25146;75222;18193;60579;6533;24126;3748;11776;10281;35902
411530;201301;798;2450;590;2053;267;1024;110;353;377;1377
411535;201301;447;1425;292;1056;66;257;23;72;89;329
411540;201301;2502;7264;2080;6545;506;1732;1017;3278;1523;5010
411545;201301;918;3499;900;3460;209;878;592;2257;801;3135
411550;201301;627;1863;528;1703;244;847;121;374;365;1221
411560;201301;2404;7539;2117;6907;611;2202;558;1674;1169;3876
411570;201301;4483;13747;3885;12803;1418;5053;1116;3907;2534;8960
411573;201301;942;3063;905;3005;243;872;477;1609;720;2481
411575;201301;1291;4406;1183;4140;352;1309;461;1635;813;2944
411580;201301;3421;10853;2834;9697;784;3044;557;1757;1341;4801
411585;201301;402;1485;330;1264;102;416;35;114;137;530
411590;201301;546;1699;495;1588;149;544;125;376;274;920
411600;201301;309;1004;274;920;78;322;49;160;127;482
411605;201301;2058;6214;1689;5525;502;1794;657;2102;1159;3896
411610;201301;2017;6180;1947;6077;491;1629;1278;3948;1769;5577
411620;201301;2495;8706;2371;8486;839;3261;959;3491;1798;6752
411630;201301;654;1849;418;1461;145;581;75;241;220;822
411640;201301;537;1744;461;1592;150;571;160;520;310;1091
411650;201301;255;859;218;766;81;325;63;202;144;527
411660;201301;667;2128;621;2047;154;516;281;956;435;1472
411670;201301;1550;4831;1436;4633;542;1934;459;1396;1001;3330
411680;201301;1597;5185;1440;4941;423;1418;759;2804;1182;4222
411690;201301;3183;10117;2875;9576;1063;3841;944;3168;2007;7009
411695;201301;770;2549;678;2368;146;532;356;1245;502;1777
411700;201301;1686;5255;1351;4624;434;1635;385;1268;819;2903
411705;201301;2101;7602;1873;7182;475;1870;1094;4303;1569;6173
411710;201301;2099;6724;1712;5810;582;2175;333;995;915;3170
411720;201301;783;2478;650;2159;183;674;185;576;368;1250
411721;201301;643;2055;584;1957;149;544;280;931;429;1475
411722;201301;635;1994;549;1843;156;614;211;673;367;1287
411725;201301;1170;3969;932;3438;270;1084;298;1114;568;2198
411727;201301;2255;6769;1968;6228;487;1710;985;3034;1472;4744
411729;201301;450;1383;392;1271;44;167;214;657;258;824
411730;201301;4759;15416;4370;14697;1244;4572;1986;6621;3230;11193
411740;201301;482;1521;419;1380;134;508;162;496;296;1004
411745;201301;787;2577;690;2363;205;773;184;581;389;1354
411750;201301;3505;11391;3058;10448;1085;4097;537;1657;1622;5754
411760;201301;7703;24997;7236;24171;3091;10847;2137;7620;5228;18467
411770;201301;3542;13251;3323;12727;1454;5827;796;3122;2250;8949
411780;201301;2707;9632;2643;9545;466;1644;1831;7003;2297;8647
411790;201301;2358;7646;2112;7243;780;2993;598;1997;1378;4990
411800;201301;1124;3515;760;2600;159;606;112;289;271;895
411810;201301;1365;4474;1234;4195;359;1418;337;988;696;2406
411820;201301;15199;49351;13033;45524;4720;16836;4411;16517;9131;33353
411830;201301;412;1196;349;1109;104;351;147;485;251;836
411840;201301;7674;23916;6536;21808;2206;8132;2141;6979;4347;15111
411845;201301;449;1523;368;1349;120;474;77;272;197;746
411850;201301;5591;18178;4985;17014;1582;5928;1804;6161;3386;12089
411860;201301;754;2605;683;2430;243;923;171;577;414;1500
411870;201301;869;3325;804;3162;147;622;216;796;363;1418
411880;201301;2320;6894;1994;6364;508;1775;1001;3254;1509;5029
411885;201301;1285;3735;1099;3478;413;1469;313;883;726;2352
411890;201301;1153;3674;914;3150;304;1183;234;702;538;1885
411900;201301;789;2713;685;2470;261;1017;179;629;440;1646
411910;201301;1075;3900;998;3701;320;1279;370;1330;690;2609
411915;201301;9506;29616;7373;25092;2218;8470;1935;6022;4153;14492
411920;201301;947;3518;878;3336;317;1284;207;800;524;2084
411925;201301;537;1665;458;1531;137;472;204;704;341;1176
411930;201301;5770;20131;5186;18876;1540;5890;2329;8727;3869;14617
411940;201301;3317;11719;3097;11268;1097;4255;997;3594;2094;7849
411950;201301;10772;36092;9786;34557;3552;13379;4216;14890;7768;28269
411960;201301;5325;17057;5049;16560;1566;5705;2352;7469;3918;13174
411965;201301;369;1338;332;1251;102;414;92;353;194;767
411970;201301;705;2184;578;1969;182;632;216;749;398;1381
411980;201301;1956;5582;1425;4783;212;786;866;2911;1078;3697
411990;201301;25211;91799;22710;86441;9289;37406;6113;23975;15402;61381
411995;201301;2790;9197;2610;8867;1112;3956;801;2812;1913;6768
412000;201301;1885;5729;1579;5157;370;1371;622;1804;992;3175
412010;201301;685;2404;627;2281;240;937;213;757;453;1694
412015;201301;534;1868;504;1805;100;408;314;1100;414;1508
412020;201301;388;1229;318;1088;124;457;131;431;255;888
412030;201301;397;1331;323;1202;79;355;108;371;187;726
412033;201301;637;2083;523;1814;148;572;88;278;236;850
412035;201301;837;2633;756;2480;209;781;324;1002;533;1783
412040;201301;675;2317;630;2205;267;986;183;643;450;1629
412050;201301;1508;4739;1254;4197;366;1368;287;911;653;2279
412060;201301;7253;26649;6791;25533;2223;8813;2958;11303;5181;20116
412065;201301;877;2855;814;2736;308;1176;235;736;543;1912
412070;201301;1002;2988;906;2782;217;727;362;1089;579;1816
412080;201301;1792;5918;1476;5275;501;1979;173;579;674;2558
412085;201301;172;547;144;499;47;193;40;117;87;310
412090;201301;4650;16169;4521;15944;1075;4014;2923;10507;3998;14521
412100;201301;2131;6997;1913;6612;649;2390;691;2360;1340;4750
412110;201301;737;2493;695;2416;289;1049;266;899;555;1948
412120;201301;2270;7988;2141;7681;543;2129;1109;3864;1652;5993
412125;201301;939;3010;852;2870;274;982;337;1174;611;2156
412130;201301;755;2219;564;1865;145;539;165;552;310;1091
412135;201301;525;1582;409;1333;89;319;189;571;278;890
412140;201301;1703;5415;1469;4958;477;1709;427;1454;904;3163
412150;201301;2546;8125;2315;7670;430;1636;1335;4243;1765;5879
412160;201301;981;3268;877;3067;251;990;413;1421;664;2411
412170;201301;3751;13695;3479;13164;1506;5980;1131;4259;2637;10239
412175;201301;1386;5137;1334;5033;412;1683;579;2223;991;3906
412180;201301;1593;5322;1275;4740;560;2253;299;1090;859;3343
412190;201301;2735;8750;2388;8198;958;3440;747;2739;1705;6179
412200;201301;2054;7377;1648;6194;407;1651;538;1972;945;3623
412210;201301;613;1896;458;1544;146;562;95;295;241;857
412215;201301;2929;10304;2716;9891;608;2285;1620;6085;2228;8370
412217;201301;1070;3435;1039;3377;250;914;596;1853;846;2767
412220;201301;6375;21413;6133;20953;2387;8542;2710;9385;5097;17927
412230;201301;2674;9757;2461;9285;933;3791;707;2635;1640;6426
412240;201301;6821;20766;4632;15759;1190;4476;654;2048;1844;6524
412250;201301;1992;6496;1840;6191;655;2378;604;1976;1259;4354
412260;201301;1121;3551;818;2879;221;875;210;653;431;1528
412265;201301;1067;3581;1012;3488;326;1302;463;1526;789;2828
412270;201301;688;2383;561;2053;143;604;90;298;233;902
412280;201301;825;2735;761;2629;123;458;458;1595;581;2053
412290;201301;1139;3331;990;3060;239;854;424;1249;663;2103
412300;201301;1499;4649;1271;4187;376;1446;412;1262;788;2708
412310;201301;1159;3382;1034;3226;227;562;689;2435;916;2997
412320;201301;832;2290;623;1954;154;564;286;890;440;1454
412330;201301;1888;5414;1489;4744;426;1448;661;2104;1087;3552
412340;201301;790;2635;626;2231;159;634;113;382;272;1016
412350;201301;2292;7698;1976;6971;678;2565;355;1151;1033;3716
412360;201301;300;1027;285;993;78;299;70;227;148;526
412370;201301;1044;3403;846;3013;328;1227;250;897;578;2124
412380;201301;1852;5844;1703;5578;373;1259;884;3070;1257;4329
412382;201301;644;1892;542;1699;160;578;173;496;333;1074
412385;201301;2318;7839;2239;7691;522;1705;1268;4740;1790;6445
412390;201301;2300;7220;2145;6963;823;2897;802;2599;1625;5496
412395;201301;932;2699;767;2438;115;363;511;1676;626;2039
412400;201301;1181;3712;1078;3538;339;1210;468;1555;807;2765
412402;201301;1816;5932;1625;5561;535;1956;435;1439;970;3395
412405;201301;3465;10844;2625;9066;791;3117;221;683;1012;3800
412410;201301;5877;20045;5467;19236;2577;9787;1087;3794;3664;13581
412420;201301;501;1561;432;1462;144;548;138;420;282;968
412430;201301;417;1326;368;1238;147;546;140;439;287;985
412440;201301;3823;11947;3452;11306;672;2394;1616;5546;2288;7940
412450;201301;514;1695;460;1555;135;507;153;458;288;965
412460;201301;941;2673;658;2153;149;586;203;644;352;1230
412470;201301;2081;7331;1991;7145;610;2297;965;3493;1575;5790
412480;201301;1362;4162;1085;3597;324;1183;266;776;590;1959
412490;201301;1228;3773;1115;3523;338;1116;326;1045;664;2161
412500;201301;1845;5785;1605;5325;556;1998;455;1440;1011;3438
412510;201301;2980;10294;2755;9723;963;3651;767;2763;1730;6414
412520;201301;1723;5087;1382;4549;380;1320;634;2119;1014;3439
412530;201301;721;2201;630;2031;235;824;164;505;399;1329
412535;201301;659;1962;617;1897;244;798;256;756;500;1554
412540;201301;1144;3587;1000;3298;251;962;400;1288;651;2250
412545;201301;847;2554;749;2354;152;535;279;798;431;1333
412550;201301;20687;65703;15796;55009;5147;19504;3374;11043;8521;30547
412555;201301;286;937;223;774;67;249;41;126;108;375
412560;201301;4169;14973;3771;14053;1286;5141;892;3127;2178;8268
412570;201301;3811;12351;3188;10993;1163;4284;726;2574;1889;6858
412575;201301;953;3160;832;2865;215;837;295;946;510;1783
412580;201301;1361;3922;1053;3414;302;1057;350;1086;652;2143
412590;201301;395;1315;349;1231;163;607;78;273;241;880
412600;201301;1368;4557;1227;4278;451;1713;374;1281;825;2994
412610;201301;688;2329;584;2082;216;837;146;466;362;1303
412620;201301;1283;4388;1184;4198;486;1825;367;1328;853;3153
412625;201301;13094;38292;11310;35005;4462;14864;2616;8128;7078;22992
412627;201301;866;2807;679;2415;245;930;153;546;398;1476
412630;201301;3310;11068;3009;10399;919;3442;923;3109;1842;6551
412635;201301;468;1485;401;1352;125;433;78;242;203;675
412640;201301;875;2795;714;2451;228;898;207;658;435;1556
412650;201301;2203;6388;1826;5734;507;1711;768;2278;1275;3989
412660;201301;2873;9006;2445;8127;672;2534;669;2132;1341;4666
412665;201301;657;1845;435;1492;149;559;144;474;293;1033
412667;201301;1451;4595;1218;4135;365;1417;361;1140;726;2557
412670;201301;622;2039;429;1546;108;446;64;198;172;644
412680;201301;1239;4325;1102;3993;369;1416;291;972;660;2388
412690;201301;568;1860;454;1594;183;698;60;191;243;889
412700;201301;1696;5925;1545;5641;580;2306;585;2114;1165;4420
412710;201301;8628;27900;7251;25021;2216;8359;1853;6219;4069;14578
412720;201301;1489;4884;1172;4100;316;1189;121;346;437;1535
412730;201301;2663;8294;1941;6778;648;2434;249;821;897;3255
412740;201301;1960;6621;1852;6398;839;3082;224;802;1063;3884
412750;201301;2899;10731;2833;10625;689;2798;1882;6979;2571;9777
412760;201301;1999;7085;1943;6980;733;2869;680;2347;1413;5216
412770;201301;10696;32961;7664;26233;2050;7836;1568;4900;3618;12736
412780;201301;1411;4854;1277;4515;399;1491;404;1368;803;2859
412785;201301;2209;6847;1775;6008;606;2198;745;2501;1351;4699
412788;201301;1197;4255;1155;4187;309;1287;619;2188;928;3475
412790;201301;1053;3461;919;3157;240;922;321;982;561;1904
412795;201301;934;2916;845;2758;310;1094;304;955;614;2049
412796;201301;3088;9938;2945;9692;847;3022;1395;4567;2242;7589
412800;201301;3189;9987;2656;9038;826;3047;827;2716;1653;5763
412810;201301;7618;22573;5727;18728;1912;6838;1427;4360;3339;11198
412820;201301;4802;16222;4020;14659;1377;5471;1060;3899;2437;9370
412830;201301;343;1224;324;1181;100;415;76;243;176;658
412840;201301;2196;6589;1898;6029;639;2279;553;1745;1192;4024
412850;201301;2665;8395;2411;8076;505;1906;1381;4582;1886;6488
412853;201301;1691;5392;1523;5110;405;1605;731;2288;1136;3893
412855;201301;1573;4761;1314;4267;460;1695;401;1199;861;2894
412860;201301;1107;3651;1028;3517;338;1275;427;1394;765;2669
412862;201301;685;2037;605;1882;189;637;196;596;385;1233
412863;201301;1187;4223;1153;4158;175;670;825;2975;1000;3645
412865;201301;589;1957;441;1556;96;371;169;594;265;965
412870;201301;945;2901;848;2768;335;1143;340;1163;675;2306
412880;201301;1558;4363;1327;4018;408;1369;427;1256;835;2625
420005;201301;408;1412;369;1312;93;366;166;556;259;922
420010;201301;2984;9967;2617;9308;454;1726;1760;6339;2214;8065
420020;201301;639;2305;504;1920;127;549;91;304;218;853
420030;201301;348;1219;259;996;80;360;52;179;132;539
420040;201301;939;3029;668;2533;234;976;190;679;424;1655
420050;201301;648;2205;599;2099;199;739;225;769;424;1508
420055;201301;229;823;195;729;56;212;39;129;95;341
420060;201301;352;1288;277;1082;77;324;38;138;115;462
420070;201301;1842;6204;1674;5790;300;1162;777;2811;1077;3973
420075;201301;135;465;107;384;33;129;27;91;60;220
420080;201301;512;1876;475;1780;204;817;88;322;292;1139
420090;201301;639;2385;513;2051;147;607;107;437;254;1044
420100;201301;1434;4908;1355;4806;289;1035;923;3352;1212;4387
420110;201301;409;1458;377;1381;127;455;157;610;284;1065
420120;201301;285;1030;241;931;112;461;35;119;147;580
420125;201301;347;1485;334;1454;142;649;84;348;226;997
420127;201301;468;1569;277;1057;100;404;33;137;133;541
420130;201301;2627;9290;2436;8929;727;3019;1035;3528;1762;6547
420140;201301;6099;18896;4817;16697;1810;6926;1327;4469;3137;11395
420150;201301;627;1989;526;1758;197;722;152;473;349;1195
420160;201301;245;812;168;609;53;231;33;99;86;330
420165;201301;142;521;125;479;44;180;26;103;70;283
420170;201301;178;650;151;596;71;327;18;46;89;373
420180;201301;331;1196;259;982;87;340;69;251;156;591
420190;201301;429;1497;328;1291;145;626;68;270;213;896
420195;201301;1282;3750;1023;3413;287;1083;490;1633;777;2716
420200;201301;2643;8917;1807;7004;673;2884;322;1123;995;4007
420205;201301;1004;3495;912;3315;306;1210;395;1448;701;2658
420207;201301;1055;3332;852;2923;298;1139;249;822;547;1961
420208;201301;448;1562;409;1468;173;642;127;467;300;1109
420209;201301;263;947;200;753;50;206;44;158;94;364
420210;201301;1625;5580;1134;4477;338;1512;134;480;472;1992
420213;201301;801;3157;777;3104;190;788;465;1879;655;2667
420215;201301;446;1617;376;1389;110;426;66;224;176;650
420220;201301;413;1665;393;1612;174;763;77;270;251;1033
420230;201301;3696;12386;3238;11620;839;3381;1872;6565;2711;9946
420240;201301;11338;36422;7964;29255;2063;8893;3057;10097;5120;18990
420243;201301;446;1587;420;1518;146;576;137;491;283;1067
420245;201301;839;2856;677;2556;212;919;132;467;344;1386
420250;201301;850;2797;802;2718;308;1120;325;1129;633;2249
420253;201301;585;1648;512;1544;118;386;257;837;375;1223
420257;201301;395;1302;335;1187;98;345;155;556;253;901
420260;201301;1218;4366;1137;4213;363;1433;545;2054;908;3487
420270;201301;325;1212;280;1084;31;129;33;130;64;259
420280;201301;2434;7507;1808;6413;593;2358;537;1705;1130;4063
420285;201301;116;376;63;242;14;65;5;18;19;83
420287;201301;609;1995;550;1884;148;538;235;808;383;1346
420290;201301;4737;15007;3539;12340;989;3824;1238;4109;2227;7933
420300;201301;5187;17281;3774;14214;1221;5202;769;2849;1990;8051
420310;201301;695;2333;667;2280;193;675;351;1207;544;1882
420315;201301;755;2862;683;2704;184;818;321;1270;505;2088
420320;201301;4146;14393;3714;13601;1254;5213;1456;5074;2710;10287
420325;201301;483;1616;466;1568;163;614;143;468;306;1082
420330;201301;1138;4194;1002;3801;382;1560;174;583;556;2143
420340;201301;1383;4471;1225;4140;332;1256;494;1591;826;2847
420350;201301;1499;5117;1390;4920;379;1415;718;2590;1097;4005
420360;201301;3158;10943;2760;10031;1194;4713;527;1815;1721;6528
420370;201301;1709;4986;1574;4820;214;706;1271;3833;1485;4539
420380;201301;5018;17912;4403;16393;1533;6196;1139;4233;2672;10429
420390;201301;1878;5944;1259;4599;472;1862;249;832;721;2694
420395;201301;2108;6809;1748;6024;555;2155;407;1340;962;3495
420400;201301;1369;4342;1109;3844;356;1432;368;1189;724;2621
420410;201301;668;2064;555;1868;137;514;279;923;416;1437
420415;201301;415;1427;395;1377;112;421;184;636;296;1057
420417;201301;762;2595;698;2455;144;506;372;1328;516;1834
420419;201301;375;1319;310;1196;161;636;90;360;251;996
420420;201301;13566;44060;11016;38535;3905;14686;3185;11141;7090;25827
420425;201301;996;3129;760;2579;129;534;280;886;409;1420
420430;201301;3747;12338;2723;9853;914;3574;704;2521;1618;6095
420435;201301;191;673;146;549;71;293;22;80;93;373
420440;201301;1362;4102;916;3241;317;1203;170;552;487;1755
420445;201301;405;1275;322;1132;91;337;149;525;240;862
420450;201301;1157;3507;700;2579;178;767;140;414;318;1181
420455;201301;2057;6814;1903;6531;621;2369;828;2811;1449;5180
420460;201301;9185;30495;7878;27985;2491;9896;3043;10414;5534;20310
420470;201301;925;2860;770;2596;272;984;220;726;492;1710
420475;201301;143;522;120;448;45;176;32;128;77;304
420480;201301;5510;17277;4804;16269;2094;7754;916;3127;3010;10881
420490;201301;647;2398;573;2199;194;783;139;510;333;1293
420500;201301;2043;6615;1792;6174;539;1946;954;3361;1493;5307
420510;201301;178;790;174;771;83;368;35;151;118;519
420515;201301;146;557;123;491;40;165;21;81;61;246
420517;201301;872;2860;793;2680;125;428;520;1801;645;2229
420519;201301;315;1006;278;925;66;222;147;507;213;729
420520;201301;602;2027;547;1916;135;523;239;807;374;1330
420530;201301;1251;4582;1114;4212;420;1730;261;914;681;2644
420535;201301;232;792;221;768;71;273;70;235;141;508
420540;201301;18398;59346;14623;51169;5345;20216;4453;15421;9798;35637
420543;201301;413;1252;322;1101;57;207;218;740;275;947
420545;201301;1241;4220;1091;3894;363;1442;354;1190;717;2632
420550;201301;4198;14820;3800;13891;1381;5598;1153;4201;2534;9799
420555;201301;423;1473;376;1367;158;605;99;369;257;974
420560;201301;548;1677;474;1541;64;235;253;833;317;1068
420570;201301;1675;5829;1415;5192;471;1845;355;1258;826;3103
420580;201301;802;2957;717;2789;243;1047;289;1125;532;2172
420590;201301;2855;9498;2219;7991;591;2324;444;1518;1035;3842
420600;201301;608;2321;574;2237;228;990;182;673;410;1663
420610;201301;540;1864;416;1570;153;627;66;224;219;851
420620;201301;1159;3801;1044;3578;419;1568;245;828;664;2396
420630;201301;899;3097;768;2753;252;986;221;689;473;1675
420640;201301;458;1691;329;1332;97;410;84;350;181;760
420650;201301;1960;6546;1327;4959;375;1604;290;916;665;2520
420660;201301;616;1970;548;1846;112;411;320;1072;432;1483
420665;201301;664;2097;523;1800;104;400;220;701;324;1101
420670;201301;1535;5255;1257;4583;386;1567;206;704;592;2271
420675;201301;207;681;151;548;33;129;69;235;102;364
420680;201301;442;1338;358;1205;96;354;154;510;250;864
420690;201301;744;2741;601;2343;182;787;192;713;374;1500
420700;201301;6029;19291;5164;17447;1981;7287;1190;3902;3171;11189
420710;201301;670;2543;600;2392;254;1066;136;525;390;1591
420720;201301;1740;5827;1598;5631;480;1772;896;3147;1376;4919
420730;201301;4252;13838;3819;13086;1580;5704;1255;4335;2835;10039
420740;201301;566;2142;558;2126;174;674;305;1189;479;1863
420750;201301;2242;7620;1711;6344;481;2026;515;1709;996;3735
420757;201301;100;361;89;342;26;110;19;62;45;172
420760;201301;406;1411;339;1227;80;321;116;417;196;738
420765;201301;522;1916;401;1560;133;533;81;310;214;843
420768;201301;1132;4304;1073;4169;348;1376;463;1895;811;3271
420770;201301;788;2677;578;2154;205;815;163;574;368;1389
420775;201301;561;1889;521;1815;122;428;299;1054;421;1482
420780;201301;1559;5088;1210;4205;406;1512;381;1271;787;2783
420785;201301;370;1268;320;1138;87;336;132;468;219;804
420790;201301;1189;4602;1069;4251;307;1301;487;1882;794;3183
420800;201301;759;2353;532;1866;170;646;116;390;286;1036
420810;201301;2260;8566;1960;7774;734;3168;534;2062;1268;5230
420820;201301;7239;26415;6361;24795;2368;10235;2311;8897;4679;19132
420830;201301;2438;8637;2171;8111;861;3450;752;2727;1613;6177
420840;201301;912;3253;766;2956;272;1166;239;842;511;2008
420845;201301;940;3463;830;3222;329;1382;140;520;469;1902
420850;201301;1471;5437;1206;4845;478;2050;270;1113;748;3163
420860;201301;586;1881;448;1604;198;768;148;526;346;1294
420870;201301;1237;3878;1042;3620;450;1691;322;1127;772;2818
420880;201301;1401;4881;1206;4382;368;1389;275;989;643;2378
420890;201301;11063;27237;5470;17822;1203;4706;2116;6233;3319;10939
420895;201301;155;446;93;307;25;89;37;116;62;205
420900;201301;2032;6214;1480;5152;496;1895;367;1221;863;3116
420910;201301;19929;64863;14108;52184;4242;17691;3353;11946;7595;29637
420915;201301;640;2598;606;2490;166;679;294;1274;460;1953
420917;201301;242;815;222;762;64;253;83;235;147;488
420920;201301;149;466;105;381;48;186;16;59;64;245
420930;201301;18725;60397;16638;56492;5976;22037;5720;19503;11696;41540
420940;201301;4363;14111;3915;13076;1225;4545;1366;4271;2591;8816
420945;201301;160;556;140;502;54;209;29;95;83;304
420950;201301;422;1460;279;1090;87;386;47;166;134;552
420960;201301;1319;4387;1147;4046;447;1713;309;990;756;2703
420970;201301;2499;8380;2250;7994;708;2612;1141;4204;1849;6816
420980;201301;339;1289;317;1229;103;396;168;682;271;1078
420985;201301;393;1380;328;1209;110;427;79;276;189;703
420990;201301;718;2382;555;2075;151;633;167;546;318;1179
421000;201301;625;2310;465;1875;165;716;55;178;220;894
421003;201301;408;1318;257;949;81;330;42;141;123;471
421005;201301;223;790;211;767;66;260;102;366;168;626
421010;201301;5881;19955;5116;18278;1914;7309;1602;5562;3516;12871
421020;201301;496;1761;445;1645;111;420;224;880;335;1300
421030;201301;1049;3902;959;3661;352;1397;299;1173;651;2570
421040;201301;780;2626;735;2542;227;845;320;1073;547;1918
421050;201301;1771;5107;1183;4163;329;1326;477;1601;806;2927
421055;201301;226;857;194;754;58;251;56;189;114;440
421060;201301;486;1922;420;1727;135;607;82;311;217;918
421070;201301;717;2435;541;2000;127;538;240;926;367;1464
421080;201301;590;2046;563;1977;204;749;220;765;424;1514
421085;201301;475;1413;290;1068;78;298;65;272;143;570
421090;201301;399;1228;318;1045;90;315;142;466;232;781
421100;201301;854;2914;721;2590;228;852;179;586;407;1438
421105;201301;1221;4328;1136;4171;350;1344;517;2018;867;3362
421110;201301;1595;5424;1389;5085;537;2163;465;1638;1002;3801
421120;201301;1401;4883;1202;4428;344;1478;393;1338;737;2816
421125;201301;319;1151;302;1098;112;428;101;347;213;775
421130;201301;4538;15735;4030;14854;1762;6911;1160;4459;2922;11370
421140;201301;377;1283;327;1164;107;421;114;384;221;805
421145;201301;449;1621;415;1521;82;342;209;738;291;1080
421150;201301;340;1363;319;1308;100;412;162;676;262;1088
421160;201301;662;2222;496;1877;141;595;135;486;276;1081
421165;201301;296;1097;243;915;60;236;104;396;164;632
421170;201301;1763;5970;1516;5285;511;1861;678;2335;1189;4196
421175;201301;1134;3726;973;3465;385;1498;320;1090;705;2588
421180;201301;430;1380;306;1119;103;433;116;377;219;810
421185;201301;369;1195;325;1106;72;234;161;573;233;807
421187;201301;297;981;258;903;72;259;102;349;174;608
421189;201301;527;1660;476;1552;134;474;191;617;325;1091
421190;201301;8145;28406;7043;26041;2545;9986;2389;8836;4934;18822
421200;201301;997;3520;906;3318;285;1162;417;1488;702;2650
421205;201301;192;658;149;557;34;149;35;111;69;260
421210;201301;1875;6160;1770;5890;597;2113;656;2184;1253;4297
421220;201301;2285;8315;2078;7910;719;2911;753;2916;1472;5827
421223;201301;763;2324;532;1928;178;675;266;957;444;1632
421225;201301;1037;3381;935;3177;276;1008;371;1229;647;2237
421227;201301;906;3317;863;3246;247;915;501;1980;748;2895
421230;201301;746;2635;687;2481;206;787;256;917;462;1704
421240;201301;512;1806;415;1532;147;587;62;212;209;799
421250;201301;1764;5733;1299;4884;491;1990;393;1451;884;3441
421260;201301;212;723;160;625;39;157;38;141;77;298
421270;201301;579;1809;399;1486;159;610;99;392;258;1002
421280;201301;1430;4849;1218;4505;477;2014;275;1040;752;3054
421290;201301;1828;5514;1318;4511;474;1730;318;1008;792;2738
421300;201301;230;840;217;813;128;524;40;128;168;652
421310;201301;500;1787;435;1599;161;592;101;370;262;962
421315;201301;333;1064;226;814;55;208;91;325;146;533
421320;201301;474;1673;334;1276;75;338;65;185;140;523
421330;201301;591;2157;530;2030;239;1032;66;235;305;1267
421335;201301;512;1809;432;1650;152;639;96;365;248;1004
421340;201301;1498;5322;1452;5237;549;2137;573;2043;1122;4180
421350;201301;873;3133;764;2905;305;1290;223;810;528;2100
421360;201301;2831;9448;2203;8111;626;2604;774;2764;1400;5368
421370;201301;1036;3862;909;3567;349;1494;235;911;584;2405
421380;201301;927;2858;800;2620;187;650;381;1248;568;1898
421390;201301;178;602;153;544;24;93;47;170;71;263
421400;201301;352;1454;298;1310;139;622;68;299;207;921
421410;201301;294;1057;264;993;63;234;136;534;199;768
421415;201301;305;1024;202;807;72;300;58;226;130;526
421420;201301;1352;4436;1103;3806;270;1005;269;908;539;1913
421430;201301;252;880;194;752;75;324;34;135;109;459
421440;201301;699;2280;538;1982;192;747;201;748;393;1495
421450;201301;571;2134;517;1992;234;951;153;583;387;1534
421460;201301;542;1957;452;1756;140;593;97;346;237;939
421470;201301;454;1822;426;1740;143;624;170;657;313;1281
421480;201301;2034;7267;1713;6548;604;2543;543;1947;1147;4490
421490;201301;213;841;196;797;104;437;41;165;145;602
421500;201301;2465;9336;2254;8892;1031;4345;562;2232;1593;6577
421505;201301;369;1331;345;1267;141;519;117;437;258;956
421507;201301;543;2012;510;1918;144;556;194;726;338;1282
421510;201301;248;1002;233;964;86;390;82;301;168;691
421520;201301;663;2044;544;1815;83;314;341;1118;424;1432
421530;201301;397;1454;306;1249;97;445;113;445;210;890
421535;201301;504;1818;441;1700;102;429;214;829;316;1258
421540;201301;361;1161;317;1072;77;291;114;364;191;655
421545;201301;1113;4093;977;3810;343;1472;194;723;537;2195
421550;201301;1834;6741;1731;6542;734;2961;573;2177;1307;5138
421555;201301;212;735;132;491;34;140;32;112;66;252
421560;201301;205;758;146;587;57;231;25;99;82;330
421565;201301;1018;3410;949;3284;454;1657;298;1025;752;2682
421567;201301;932;3675;826;3372;420;1738;155;664;575;2402
421568;201301;393;1499;376;1456;132;538;131;497;263;1035
421569;201301;146;547;130;499;33;142;44;153;77;295
421570;201301;846;3062;725;2775;287;1219;191;667;478;1886
421575;201301;611;2138;548;2004;118;447;284;1066;402;1513
421580;201301;3822;13497;3229;12170;1314;5481;757;2679;2071;8160
421590;201301;248;866;222;790;67;260;101;342;168;602
421600;201301;713;2367;610;2151;209;784;178;617;387;1401
421605;201301;594;1948;437;1631;158;663;101;373;259;1036
421610;201301;1744;4713;1374;4174;234;783;821;2505;1055;3288
421620;201301;4359;13997;3341;11931;1253;4798;1106;4001;2359;8799
421625;201301;312;1168;265;1020;95;390;90;320;185;710
421630;201301;2106;6923;1557;5600;463;1827;400;1424;863;3251
421635;201301;262;990;232;937;66;282;95;367;161;649
421640;201301;991;3397;900;3243;225;812;509;1890;734;2702
421650;201301;2222;7913;2056;7547;912;3638;354;1276;1266;4914
421660;201301;8108;29065;6844;26550;2621;11081;2041;7606;4662;18687
421670;201301;984;3529;875;3276;276;1126;275;1008;551;2134
421680;201301;1339;4668;1254;4454;553;2123;230;733;783;2856
421690;201301;1860;6531;1552;5759;528;2082;336;1242;864;3324
421700;201301;672;2220;516;1947;191;777;149;523;340;1300
421710;201301;323;1195;279;1077;114;445;69;265;183;710
421715;201301;212;717;180;639;48;182;56;201;104;383
421720;201301;2115;6394;1506;5480;653;2612;436;1512;1089;4124
421725;201301;119;452;114;438;39;156;48;178;87;334
421730;201301;419;1581;314;1228;103;448;77;270;180;718
421740;201301;581;1958;486;1738;158;648;123;373;281;1021
421750;201301;1267;4182;1071;3751;369;1390;321;1043;690;2433
421755;201301;402;1434;342;1252;91;354;106;382;197;736
421760;201301;327;1145;273;1039;103;447;113;395;216;842
421770;201301;3337;10668;2902;9915;1456;5144;701;2555;2157;7699
421775;201301;496;1635;386;1415;96;365;127;469;223;834
421780;201301;1634;5920;1368;5338;593;2461;360;1354;953;3815
421790;201301;803;2597;580;2159;203;857;132;453;335;1310
421795;201301;286;986;263;915;55;215;86;289;141;504
421800;201301;2079;7438;1780;6807;595;2551;541;1815;1136;4366
421810;201301;676;2405;593;2189;197;771;133;476;330;1247
421820;201301;872;3060;791;2887;201;876;319;1094;520;1970
421825;201301;1097;4012;1064;3919;191;772;621;2277;812;3049
421830;201301;2884;10439;2754;10192;650;2418;1631;6415;2281;8833
421835;201301;151;534;133;499;55;232;46;153;101;385
421840;201301;495;1825;453;1706;173;713;172;625;345;1338
421850;201301;516;1595;425;1456;158;558;157;583;315;1141
421860;201301;397;1398;314;1198;88;383;84;307;172;690
421870;201301;4814;14902;3601;12380;1195;4416;665;2228;1860;6644
421875;201301;235;835;172;659;47;207;40;124;87;331
421880;201301;837;3060;749;2850;302;1285;138;469;440;1754
421885;201301;348;1270;329;1218;97;374;157;582;254;956
421890;201301;1017;3649;893;3374;331;1332;275;1022;606;2354
421895;201301;392;1424;387;1416;118;427;205;778;323;1205
421900;201301;798;2728;675;2408;186;711;250;841;436;1552
421910;201301;420;1500;356;1341;109;470;86;279;195;749
421915;201301;578;1881;513;1755;83;320;337;1153;420;1473
421917;201301;461;1617;402;1503;150;637;107;357;257;994
421920;201301;671;2257;601;2161;290;1106;190;630;480;1736
421930;201301;3260;10541;2663;9218;897;3439;432;1485;1329;4924
421935;201301;765;2971;693;2796;211;902;262;1067;473;1969
421940;201301;284;1145;258;1067;91;408;88;344;179;752
421950;201301;3774;11291;2509;8882;870;3265;542;1975;1412;5240
421960;201301;228;796;197;720;73;282;61;213;134;495
421970;201301;1775;5892;1513;5276;566;2158;337;1047;903;3205
421985;201301;371;1137;266;917;46;193;93;332;139;525
430003;201301;865;2584;705;2322;224;810;264;894;488;1704
430005;201301;276;989;259;950;68;282;130;432;198;714
430010;201301;1834;5829;1506;5097;503;1768;568;1958;1071;3726
430020;201301;1032;2983;925;2820;263;890;470;1365;733;2255
430030;201301;1383;4180;1290;3981;410;1299;537;1655;947;2954
430040;201301;12181;32658;11120;31347;3505;9823;5951;17677;9456;27500
430045;201301;614;1880;567;1788;82;310;402;1221;484;1531
430047;201301;182;552;163;513;41;135;86;276;127;411
430050;201301;806;2491;591;2060;99;400;312;1058;411;1458
430055;201301;231;738;198;651;42;150;115;371;157;521
430057;201301;69;186;31;105;8;32;12;32;20;64
430060;201301;12750;44327;11844;42777;4362;16259;5193;19299;9555;35558
430063;201301;903;2931;828;2731;283;935;356;1237;639;2172
430064;201301;1567;4942;1382;4611;333;1112;829;2868;1162;3980
430066;201301;97;301;90;294;42;131;33;113;75;244
430070;201301;470;1660;416;1531;112;439;144;508;256;947
430080;201301;533;1866;452;1663;123;505;104;355;227;860
430085;201301;434;1523;401;1468;150;600;184;650;334;1250
430087;201301;903;2748;893;2730;80;251;795;2442;875;2693
430090;201301;609;1692;257;858;35;133;98;314;133;447
430100;201301;879;3079;809;2919;331;1312;214;653;545;1965
430105;201301;609;2158;554;2044;219;855;140;501;359;1356
430107;201301;252;855;211;739;47;179;112;379;159;558
430110;201301;2078;6404;1963;6229;643;2209;964;3061;1607;5270
430120;201301;1457;4799;1367;4622;190;655;1062;3597;1252;4252
430130;201301;4384;11466;4098;11106;691;1984;2811;7789;3502;9773
430140;201301;1045;3594;900;3229;325;1172;344;1269;669;2441
430150;201301;802;2333;623;1990;147;505;249;786;396;1291
430155;201301;482;1575;374;1330;95;328;158;570;253;898
430160;201301;16934;52302;15989;50785;4050;13936;8537;27981;12587;41917
430163;201301;1690;5351;1481;4946;376;1418;660;2208;1036;3626
430165;201301;253;958;232;915;109;429;44;176;153;605
430170;201301;658;2043;402;1457;115;474;129;417;244;891
430175;201301;842;3046;793;2937;221;807;452;1735;673;2542
430180;201301;1123;3230;1013;3071;198;635;605;1888;803;2523
430185;201301;688;1807;397;1234;55;219;154;426;209;645
430187;201301;721;2370;680;2314;185;720;347;1166;532;1886
430190;201301;2152;6647;1914;6223;524;1953;896;2939;1420;4892
430192;201301;197;647;163;547;34;129;96;311;130;440
430195;201301;180;594;85;330;15;63;14;43;29;106
430200;201301;1714;5895;1543;5588;676;2533;340;1317;1016;3850
430205;201301;413;1349;359;1253;43;178;243;846;286;1024
430210;201301;5449;16660;3551;12425;1056;3961;718;2339;1774;6300
430215;201301;288;940;245;852;65;251;121;409;186;660
430220;201301;563;1542;314;1085;74;293;58;195;132;488
430222;201301;290;926;231;800;79;299;88;291;167;590
430223;201301;241;840;236;827;59;209;136;486;195;695
430225;201301;39;135;35;119;4;9;7;21;11;30
430230;201301;2081;6785;1962;6656;421;1322;1396;4957;1817;6279
430235;201301;209;739;175;654;73;292;32;98;105;390
430237;201301;352;1067;318;1003;39;166;226;671;265;837
430240;201301;941;3031;785;2710;301;1151;203;624;504;1775
430245;201301;740;2736;664;2545;198;774;279;1104;477;1878
430250;201301;1583;4555;1464;4340;499;1546;622;1917;1121;3463
430258;201301;172;537;137;455;30;99;69;227;99;326
430260;201301;759;2246;539;1782;79;308;300;989;379;1297
430265;201301;317;1054;276;958;142;518;41;107;183;625
430270;201301;3232;9658;3018;9329;864;3025;1545;4729;2409;7754
430280;201301;4807;14772;4428;14056;1521;5196;1901;5941;3422;11137
430290;201301;2298;6794;2182;6668;350;1096;1716;5336;2066;6432
430300;201301;9148;29623;8162;27781;3504;12427;2985;10554;6489;22981
430310;201301;7749;25632;7197;24585;2586;9434;3013;10195;5599;19629
430320;201301;742;2415;597;2127;103;362;314;1169;417;1531
430330;201301;914;2628;835;2487;218;718;393;1096;611;1814
430340;201301;592;1739;447;1521;124;469;213;713;337;1182
430350;201301;5822;19672;5229;18333;1882;7061;2075;7175;3957;14236
430355;201301;147;487;118;421;29;133;26;78;55;211
430360;201301;971;2743;902;2639;144;474;580;1691;724;2165
430367;201301;328;953;235;776;34;132;93;289;127;421
430370;201301;537;1685;486;1573;173;605;142;427;315;1032
430380;201301;836;2228;470;1556;139;465;162;578;301;1043
430390;201301;3557;11577;3118;10599;878;3276;1072;3484;1950;6760
430400;201301;1171;2992;872;2566;197;696;492;1358;689;2054
430410;201301;654;1866;529;1662;114;399;287;908;401;1307
430420;201301;4122;12737;3594;11522;1163;3819;1500;4855;2663;8674
430430;201301;619;1883;480;1612;169;621;115;347;284;968
430435;201301;1671;4910;1602;4802;304;917;1107;3392;1411;4309
430440;201301;3935;12927;3463;12156;924;3645;1327;4725;2251;8370
430450;201301;8720;26596;7550;24065;2602;8600;2954;9489;5556;18089
430460;201301;21813;69793;18767;64492;7069;25859;6712;23455;13781;49314
430461;201301;445;1282;148;498;35;123;32;112;67;235
430462;201301;305;980;268;917;110;386;83;285;193;671
430463;201301;3456;11927;3145;11276;880;3459;1512;5409;2392;8868
430465;201301;548;1632;471;1487;129;439;258;820;387;1259
430466;201301;3965;12256;3792;11952;1317;4478;1691;5342;3008;9820
430467;201301;516;1676;458;1574;138;515;206;708;344;1223
430468;201301;1271;4022;1165;3855;482;1775;265;858;747;2633
430469;201301;116;338;42;175;15;64;6;28;21;92
430470;201301;5656;16820;4959;15662;1813;6205;1984;6228;3797;12433
430471;201301;900;3157;826;2989;320;1221;191;703;511;1924
430480;201301;761;2252;508;1701;111;412;129;387;240;799
430485;201301;206;673;130;488;24;84;51;213;75;297
430490;201301;467;1453;347;1221;123;458;101;364;224;822
430495;201301;377;1200;286;1005;90;343;75;264;165;607
430500;201301;1560;4554;1403;4277;388;1327;727;2165;1115;3492
430510;201301;24855;80653;19573;67182;6900;25758;5535;18354;12435;44112
430511;201301;453;1440;300;1053;89;307;64;224;153;531
430512;201301;1224;3416;1107;3220;327;972;500;1537;827;2509
430513;201301;570;1773;443;1484;103;365;190;631;293;996
430515;201301;543;1749;492;1620;106;368;216;739;322;1107
430517;201301;1257;4461;1205;4341;247;943;748;2676;995;3619
430520;201301;1606;5005;1434;4663;516;1786;620;1992;1136;3778
430530;201301;839;2526;615;2052;165;621;197;599;362;1220
430535;201301;2132;7329;1909;6775;570;2224;651;2291;1221;4515
430537;201301;550;1648;400;1408;60;203;306;1113;366;1316
430540;201301;669;1808;553;1648;135;453;311;885;446;1338
430543;201301;563;1577;516;1528;142;450;303;914;445;1364
430544;201301;648;2275;577;2072;141;538;298;1034;439;1572
430545;201301;1143;4043;1074;3959;347;1135;633;2601;980;3736
430550;201301;534;1812;457;1622;136;528;166;589;302;1117
430558;201301;114;340;87;287;37;137;15;37;52;174
430560;201301;322;920;262;809;57;221;115;339;172;560
430570;201301;1041;2936;845;2597;202;691;466;1380;668;2071
430580;201301;894;2812;671;2339;247;889;185;678;432;1567
430583;201301;112;320;54;183;8;35;12;38;20;73
430585;201301;295;888;248;780;88;318;114;331;202;649
430587;201301;295;959;264;895;139;486;71;233;210;719
430590;201301;1570;4530;1496;4411;320;1077;903;2574;1223;3651
430593;201301;36;143;34;136;14;58;10;37;24;95
430595;201301;132;441;94;369;42;165;4;13;46;178
430597;201301;357;1150;313;1049;56;201;151;483;207;684
430600;201301;1748;5301;1406;4532;360;1222;583;1888;943;3110
430605;201301;1153;3889;1023;3595;273;1051;416;1514;689;2565
430607;201301;655;1869;588;1747;111;380;376;1062;487;1442
430610;201301;7448;21483;6307;19696;1446;5052;3333;10390;4779;15442
430613;201301;183;511;139;422;38;136;62;167;100;303
430620;201301;903;2979;780;2693;247;959;308;978;555;1937
430630;201301;407;1328;271;964;89;316;60;209;149;525
430632;201301;691;2015;488;1598;74;289;299;946;373;1235
430635;201301;606;1822;476;1558;85;309;278;907;363;1216
430637;201301;447;1321;426;1285;57;200;317;916;374;1116
430640;201301;1444;4494;1145;3835;307;1115;251;716;558;1831
430642;201301;398;1195;335;1093;68;229;202;673;270;902
430645;201301;157;500;100;361;30;116;21;72;51;188
430650;201301;1791;6478;1615;6003;417;1585;820;3151;1237;4736
430655;201301;293;932;273;880;62;234;107;286;169;520
430660;201301;5340;17211;4550;15668;1673;6252;1712;5853;3385;12105
430670;201301;461;1391;425;1326;47;139;325;1047;372;1186
430673;201301;626;1692;457;1430;142;449;209;668;351;1117
430675;201301;135;438;111;392;22;86;59;211;81;297
430676;201301;4262;13589;4057;13249;1226;4305;2045;6853;3271;11158
430680;201301;1098;3461;905;3032;219;847;362;1128;581;1975
430690;201301;4117;12559;3570;11544;1214;3990;1586;5400;2800;9390
430692;201301;266;967;208;835;41;177;125;505;166;682
430693;201301;1683;4987;1408;4347;336;1137;492;1484;828;2621
430695;201301;473;1434;413;1314;95;337;192;576;287;913
430697;201301;362;1096;314;1023;104;351;142;485;246;836
430700;201301;9209;26114;5791;19201;1392;5134;1057;3370;2449;8504
430705;201301;395;1263;368;1215;96;334;203;686;299;1020
430710;201301;1694;4696;1445;4303;342;1086;823;2572;1165;3658
430720;201301;706;2025;522;1757;152;538;237;816;389;1354
430730;201301;1560;4734;1450;4556;337;1041;911;2985;1248;4026
430740;201301;526;1659;410;1400;149;528;91;319;240;847
430745;201301;490;1483;402;1301;67;235;240;750;307;985
430750;201301;1663;5025;1522;4776;518;1823;720;2113;1238;3936
430755;201301;590;1782;467;1517;134;498;189;555;323;1053
430760;201301;2962;8713;2764;8400;589;1917;1614;5070;2203;6987
430770;201301;6154;19769;5333;18231;1464;5409;2357;7984;3821;13393
430780;201301;1670;5361;1514;5095;550;2017;573;1762;1123;3779
430781;201301;604;1955;486;1714;150;546;216;775;366;1321
430783;201301;519;1451;444;1324;98;324;217;600;315;924
430786;201301;111;409;105;390;42;174;10;34;52;208
430790;201301;2541;7645;1958;6506;479;1860;863;2732;1342;4592
430800;201301;683;2256;640;2167;205;731;241;805;446;1536
430805;201301;387;1236;347;1154;25;101;259;860;284;961
430807;201301;253;833;241;805;55;200;125;415;180;615
430810;201301;461;1437;294;1052;60;254;49;159;109;413
430820;201301;1063;3730;963;3478;331;1298;311;1064;642;2362
430825;201301;442;1302;258;848;52;191;76;227;128;418
430830;201301;2632;8207;2470;7912;457;1484;1533;5255;1990;6739
430840;201301;880;2938;857;2893;229;698;522;1852;751;2550
430843;201301;94;316;75;249;14;43;32;104;46;147
430845;201301;475;1474;415;1360;138;476;98;321;236;797
430850;201301;3169;10136;2920;9681;969;3370;1179;3969;2148;7339
430860;201301;610;2209;553;2065;201;862;123;398;324;1260
430865;201301;709;2064;666;1981;197;614;368;1088;565;1702
430870;201301;395;1329;331;1192;111;420;140;491;251;911
430880;201301;1281;3948;1097;3559;474;1658;265;883;739;2541
430885;201301;159;574;139;531;54;205;33;135;87;340
430890;201301;1772;5047;1592;4764;204;681;1150;3501;1354;4182
430900;201301;3173;8953;3017;8746;598;1792;2041;6079;2639;7871
430905;201301;778;2609;714;2465;271;1021;219;720;490;1741
430910;201301;1629;5509;1480;5267;607;2333;546;1896;1153;4229
430912;201301;544;1648;438;1463;90;355;217;688;307;1043
430915;201301;340;1264;283;1121;92;403;99;373;191;776
430920;201301;15772;52732;15105;51661;5517;19454;8314;28441;13831;47895
430925;201301;86;253;70;223;21;72;34;108;55;180
430930;201301;8174;27208;7408;25734;2238;8200;3404;12147;5642;20347
430940;201301;1007;3294;873;3054;231;925;303;1018;534;1943
430950;201301;1543;4566;1255;3939;401;1324;406;1266;807;2590
430955;201301;90;310;73;266;28;110;15;51;43;161
430957;201301;280;1046;253;975;67;266;119;462;186;728
430960;201301;1577;4855;1368;4475;550;1882;493;1635;1043;3517
430965;201301;1068;3707;935;3410;251;979;476;1709;727;2688
430970;201301;455;1416;343;1154;99;374;104;341;203;715
430975;201301;573;1959;522;1835;93;329;360;1274;453;1603
430980;201301;537;1382;346;1096;102;367;125;347;227;714
430990;201301;591;2050;478;1748;186;697;148;556;334;1253
430995;201301;670;2108;625;2024;207;677;276;928;483;1605
431000;201301;1514;4344;1021;3343;297;1080;162;481;459;1561
431010;201301;2069;6891;1723;6143;575;2230;564;1914;1139;4144
431020;201301;13294;34824;9773;28424;2997;9220;3157;9457;6154;18677
431030;201301;367;1186;256;900;54;200;78;286;132;486
431033;201301;2479;7763;2353;7585;591;1941;1399;4768;1990;6709
431036;201301;117;389;96;338;23;87;28;86;51;173
431040;201301;948;2920;840;2737;255;889;403;1303;658;2192
431041;201301;548;1585;494;1505;183;586;167;544;350;1130
431043;201301;352;1222;289;1071;150;609;82;255;232;864
431046;201301;102;328;83;284;28;99;33;112;61;211
431050;201301;1679;4475;1513;4276;317;875;997;2962;1314;3837
431053;201301;544;1878;498;1796;178;701;185;639;363;1340
431055;201301;611;1865;593;1834;83;260;446;1409;529;1669
431057;201301;226;740;165;602;47;185;81;286;128;471
431060;201301;5858;17931;5620;17658;1006;2853;4213;13858;5219;16711
431065;201301;420;1365;412;1354;36;110;341;1148;377;1258
431070;201301;730;2217;579;1892;138;451;252;820;390;1271
431075;201301;238;759;163;585;36;143;47;172;83;315
431080;201301;598;2018;504;1814;149;570;89;312;238;882
431085;201301;897;2494;737;2226;146;474;402;1212;548;1686
431087;201301;578;1747;535;1667;34;90;456;1447;490;1537
431090;201301;424;1196;290;947;94;328;86;259;180;587
431100;201301;4522;13120;3949;12136;1111;3639;1883;5914;2994;9553
431110;201301;1423;4139;1257;3802;344;1086;704;2083;1048;3169
431112;201301;720;2367;694;2321;229;790;346;1188;575;1978
431113;201301;615;1924;486;1622;163;535;138;484;301;1019
431115;201301;1348;4296;1280;4174;327;1103;755;2467;1082;3570
431120;201301;2509;8486;2321;8129;767;2946;1004;3421;1771;6367
431123;201301;489;1653;431;1536;97;344;239;892;336;1236
431125;201301;1178;3995;1059;3748;339;1218;504;1870;843;3088
431127;201301;109;323;82;266;17;56;24;72;41;128
431130;201301;3479;10641;3088;10019;967;3405;1434;4703;2401;8108
431140;201301;2798;8746;2115;7351;518;2070;712;2269;1230;4339
431142;201301;528;1624;492;1568;75;258;335;1089;410;1347
431150;201301;1279;4058;1073;3659;327;1141;384;1351;711;2492
431160;201301;833;2660;721;2402;159;525;397;1356;556;1881
431162;201301;457;1369;330;1109;73;289;103;319;176;608
431164;201301;52;154;28;103;10;40;1;4;11;44
431170;201301;870;2716;743;2459;244;864;235;766;479;1630
431171;201301;836;2647;772;2523;288;1035;221;667;509;1702
431173;201301;457;1447;437;1409;95;324;280;897;375;1221
431175;201301;1297;3754;1161;3545;384;1227;531;1626;915;2853
431177;201301;966;3301;887;3139;302;1128;398;1442;700;2570
431179;201301;112;323;92;288;18;70;43;116;61;186
431180;201301;2922;9375;2555;8462;752;2750;840;2626;1592;5376
431190;201301;727;2083;491;1637;149;546;183;600;332;1146
431198;201301;317;1081;294;1034;139;555;61;192;200;747
431200;201301;215;670;117;409;25;99;24;81;49;180
431205;201301;284;961;233;816;63;220;81;283;144;503
431210;201301;741;2227;654;2040;161;533;357;1104;518;1637
431213;201301;282;967;269;949;91;347;106;355;197;702
431215;201301;303;930;186;648;56;225;36;108;92;333
431217;201301;215;709;196;667;73;271;48;164;121;435
431220;201301;1185;3129;1005;2839;162;517;598;1677;760;2194
431225;201301;1264;4011;1172;3862;308;1084;679;2282;987;3366
431230;201301;882;2811;740;2517;146;553;402;1369;548;1922
431235;201301;38;111;34;101;14;44;13;38;27;82
431237;201301;387;1351;348;1287;157;658;125;430;282;1088
431238;201301;50;170;44;158;11;46;15;50;26;96
431240;201301;2673;8960;2363;8382;875;3316;807;2821;1682;6137
431242;201301;420;1408;403;1379;198;732;34;123;232;855
431244;201301;404;1039;327;920;61;213;169;442;230;655
431245;201301;726;2300;695;2243;171;593;423;1362;594;1955
431247;201301;184;595;163;557;59;214;63;208;122;422
431250;201301;1842;6052;1663;5788;592;2186;689;2505;1281;4691
431260;201301;304;980;270;916;76;289;52;162;128;451
431261;201301;217;828;203;800;63;271;75;282;138;553
431262;201301;248;803;155;588;30;135;65;244;95;379
431265;201301;1110;3219;819;2566;218;783;299;795;517;1578
431267;201301;172;566;155;534;45;164;62;202;107;366
431270;201301;2153;6554;2007;6326;699;2331;971;3091;1670;5422
431275;201301;211;720;158;573;58;211;36;124;94;335
431280;201301;112;400;94;357;34;146;20;62;54;208
431290;201301;269;912;219;772;60;236;59;204;119;440
431295;201301;204;678;125;430;26;103;27;75;53;178
431300;201301;121;449;95;371;36;148;10;44;46;192
431301;201301;225;806;180;665;64;231;33;115;97;346
431303;201301;573;1697;511;1599;147;511;234;719;381;1230
431306;201301;1866;5481;1489;4801;349;1339;541;1560;890;2899
431308;201301;50;177;48;172;35;130;9;28;44;158
431310;201301;728;2455;570;2073;107;427;244;905;351;1332
431320;201301;743;2288;495;1779;161;632;102;351;263;983
431330;201301;1360;3849;856;2910;271;1005;197;655;468;1660
431333;201301;284;845;227;726;61;208;85;253;146;461
431335;201301;101;327;88;301;21;70;30;99;51;169
431337;201301;2234;7414;2057;7053;721;2595;770;2688;1491;5283
431339;201301;651;1983;533;1700;117;391;287;930;404;1321
431340;201301;24791;70480;19652;61793;5100;18043;8961;27531;14061;45574
431342;201301;570;1616;538;1557;121;362;341;976;462;1338
431344;201301;346;1035;286;931;29;108;179;592;208;700
431346;201301;233;694;185;575;59;198;55;165;114;363
431349;201301;483;1504;423;1351;82;269;216;696;298;965
431350;201301;3400;10820;3187;10481;541;2052;2143;6858;2684;8910
431360;201301;706;2053;588;1854;200;669;210;655;410;1324
431365;201301;1242;4047;1104;3810;460;1720;391;1329;851;3049
431370;201301;5177;15998;4660;15208;1135;3955;2666;8936;3801;12891
431380;201301;1113;3411;1073;3331;169;585;780;2382;949;2967
431390;201301;3375;10583;2821;9468;1068;3859;810;2597;1878;6456
431395;201301;1551;4861;1415;4645;363;1282;635;2143;998;3425
431400;201301;122;454;99;397;33;148;14;43;47;191
431402;201301;1079;2907;760;2346;165;561;349;1053;514;1614
431403;201301;308;922;234;785;78;291;51;165;129;456
431405;201301;3844;11613;3203;10659;720;2945;1629;5098;2349;8043
431406;201301;694;2363;572;2039;204;748;204;720;408;1468
431407;201301;608;1975;490;1667;160;554;164;557;324;1111
431410;201301;15373;50344;13351;46400;5749;21017;3433;12709;9182;33726
431413;201301;158;450;107;343;14;50;56;177;70;227
431415;201301;845;2538;768;2397;199;690;428;1307;627;1997
431417;201301;662;1774;537;1575;106;336;289;878;395;1214
431420;201301;1566;4511;1426;4293;367;1186;786;2392;1153;3578
431430;201301;483;1489;406;1367;144;525;156;504;300;1029
431440;201301;31207;95207;29011;91470;9897;32572;13381;43746;23278;76318
431442;201301;197;654;152;533;47;185;20;56;67;241
431445;201301;424;1257;348;1085;67;219;150;472;217;691
431446;201301;464;1398;370;1222;71;235;229;765;300;1000
431447;201301;791;2389;604;1949;106;348;289;977;395;1325
431449;201301;814;2499;718;2330;128;455;397;1300;525;1755
431450;201301;2132;5882;2004;5696;550;1579;1176;3370;1726;4949
431455;201301;566;1526;440;1289;75;267;262;734;337;1001
431460;201301;3580;10517;3222;9838;905;2943;1479;4560;2384;7503
431470;201301;2039;6374;1910;6077;569;1815;916;3062;1485;4877
431475;201301;92;314;61;243;20;80;3;10;23;90
431477;201301;545;1706;478;1577;123;398;257;873;380;1271
431478;201301;167;450;92;284;23;76;37;111;60;187
431480;201301;2197;7017;1871;6402;658;2413;478;1659;1136;4072
431490;201301;95301;288020;86246;274714;17976;64314;54849;172381;72825;236695
431500;201301;1177;3164;952;2748;289;863;328;937;617;1800
431505;201301;342;1035;331;1020;40;118;259;810;299;928
431507;201301;417;1108;392;1067;120;336;216;600;336;936
431510;201301;2140;6141;1891;5762;287;938;1294;3939;1581;4877
431513;201301;202;649;185;601;49;170;79;258;128;428
431514;201301;106;267;65;202;12;40;38;124;50;164
431515;201301;745;2350;598;1996;143;521;300;945;443;1466
431517;201301;85;302;84;299;43;156;20;65;63;221
431520;201301;388;1290;326;1133;113;407;86;295;199;702
431530;201301;4306;11218;3584;10441;803;2297;2303;7228;3106;9525
431531;201301;265;780;200;655;55;204;84;289;139;493
431532;201301;511;1538;486;1485;103;346;285;858;388;1204
431535;201301;361;1086;262;826;61;220;64;178;125;398
431540;201301;2012;6935;1890;6773;184;518;1501;5751;1685;6269
431545;201301;130;402;72;259;9;38;10;30;19;68
431550;201301;2362;7474;2228;7215;579;2108;1063;3424;1642;5532
431555;201301;730;2029;672;1940;145;425;361;1039;506;1464
431560;201301;22157;72379;20551;69322;9115;30993;6915;24887;16030;55880
431570;201301;5255;15894;5018;15512;574;1806;3991;12457;4565;14263
431575;201301;394;1216;348;1146;70;249;182;587;252;836
431580;201301;668;2239;589;2058;157;607;218;713;375;1320
431590;201301;835;2621;719;2341;89;321;404;1302;493;1623
431595;201301;589;1764;542;1668;140;455;236;748;376;1203
431600;201301;2037;6528;1721;5838;535;2040;391;1159;926;3199
431610;201301;1514;4508;1194;3953;320;1156;592;1951;912;3107
431620;201301;274;898;228;760;81;288;94;292;175;580
431630;201301;1257;3604;1080;3235;256;785;569;1731;825;2516
431640;201301;5304;17333;5017;16836;1660;5980;2387;7890;4047;13870
431642;201301;468;1513;441;1448;65;250;277;890;342;1140
431643;201301;174;541;164;522;49;169;83;245;132;414
431645;201301;1736;5556;1626;5363;415;1395;938;3189;1353;4584
431647;201301;160;465;137;415;46;147;45;117;91;264
431650;201301;169;580;120;479;30;143;31;109;61;252
431660;201301;1413;4379;1165;3859;416;1469;453;1443;869;2912
431670;201301;1219;3694;1058;3400;358;1291;402;1230;760;2521
431673;201301;150;522;131;474;43;168;36;137;79;305
431675;201301;273;947;222;786;59;216;58;186;117;402
431680;201301;9183;27803;7638;25021;2613;9155;2840;9406;5453;18561
431690;201301;23498;70986;20078;65994;6652;23190;8622;28925;15274;52115
431695;201301;131;489;109;419;25;92;26;76;51;168
431697;201301;457;1360;438;1328;139;448;197;598;336;1046
431700;201301;1601;4704;1433;4382;281;966;797;2369;1078;3335
431710;201301;12355;37862;10857;35264;3088;10397;5350;18061;8438;28458
431720;201301;6483;19518;5859;18493;1461;5261;3392;10420;4853;15681
431725;201301;41;150;40;147;22;82;6;22;28;104
431730;201301;3409;11121;2963;10283;916;3514;1274;4373;2190;7887
431740;201301;5864;17959;5381;17060;1836;6249;2050;6419;3886;12668
431750;201301;9910;29635;8693;27613;1705;5864;4951;16047;6656;21911
431755;201301;201;576;81;293;28;113;19;58;47;171
431760;201301;3495;11333;3097;10569;1007;3698;924;3130;1931;6828
431770;201301;2211;6449;1950;6015;496;1684;1042;3151;1538;4835
431775;201301;232;691;194;620;82;279;63;184;145;463
431780;201301;2374;6748;2003;6052;652;2106;590;1721;1242;3827
431790;201301;1037;3503;980;3399;297;1101;507;1741;804;2842
431795;201301;408;1360;356;1195;47;174;238;790;285;964
431800;201301;8864;27715;7939;26009;2438;8694;3286;10662;5724;19356
431805;201301;203;499;70;243;22;91;18;60;40;151
431810;201301;3606;10699;3198;9841;884;2889;1483;4543;2367;7432
431820;201301;2561;8513;2357;8117;870;3250;568;1899;1438;5149
431830;201301;9673;27675;8619;25943;3256;10558;3199;9671;6455;20229
431840;201301;3426;10797;3090;10106;1008;3388;1358;4522;2366;7910
431842;201301;689;1884;442;1393;92;332;164;495;256;827
431843;201301;255;876;244;852;82;292;114;410;196;702
431844;201301;159;499;128;437;38;144;38;135;76;279
431845;201301;539;1712;513;1662;51;165;374;1243;425;1408
431846;201301;502;1609;451;1496;92;347;255;840;347;1187
431848;201301;195;536;97;335;19;80;24;75;43;155
431849;201301;289;761;136;430;31;106;35;98;66;204
431850;201301;4857;14577;4411;13752;1116;3884;2354;7096;3470;10980
431860;201301;880;2703;789;2539;204;738;380;1162;584;1900
431861;201301;77;250;57;187;15;58;16;46;31;104
431862;201301;469;1666;422;1560;154;604;150;560;304;1164
431870;201301;25880;75288;22215;68712;6386;21726;9901;29990;16287;51716
431880;201301;4430;14813;3845;13407;1262;4842;1571;5292;2833;10134
431890;201301;5673;17151;5163;16181;2094;6821;1690;5497;3784;12318
431900;201301;936;3150;843;2975;290;1134;309;1004;599;2138
431910;201301;679;1809;448;1368;96;340;200;554;296;894
431912;201301;580;1732;472;1510;143;452;165;553;308;1005
431915;201301;1186;3513;995;3135;310;1002;329;1057;639;2059
431920;201301;1444;4359;1399;4295;203;602;1081;3408;1284;4010
431930;201301;1171;3478;992;3169;122;404;571;1940;693;2344
431935;201301;93;372;88;359;40;167;17;58;57;225
431936;201301;474;1398;436;1330;76;227;283;931;359;1158
431937;201301;281;813;206;660;54;186;66;201;120;387
431940;201301;2586;7456;1930;6246;604;2079;545;1745;1149;3824
431950;201301;1771;5891;1600;5558;500;1917;613;2034;1113;3951
431960;201301;3656;11266;3375;10701;1101;3722;1249;4013;2350;7735
431970;201301;498;1421;292;1000;58;214;98;319;156;533
431971;201301;126;393;112;372;23;86;68;214;91;300
431973;201301;442;1663;397;1568;72;286;226;975;298;1261
431975;201301;12;51;9;43;2;12;4;17;6;29
431980;201301;1509;4494;1436;4393;361;1281;803;2403;1164;3684
431990;201301;8249;24333;7081;22557;1436;5218;3844;12165;5280;17383
432000;201301;9388;29367;8187;27242;2956;10161;3466;11782;6422;21943
432010;201301;2385;7341;2138;6863;550;2022;1021;3121;1571;5143
432020;201301;1840;5449;1714;5271;370;1210;1040;3180;1410;4390
432023;201301;503;1526;400;1297;125;448;157;482;282;930
432026;201301;1228;3939;1112;3713;186;629;738;2520;924;3149
432030;201301;384;1203;336;1094;102;357;141;434;243;791
432032;201301;435;1226;345;1096;53;188;241;756;294;944
432035;201301;838;2793;779;2665;217;815;430;1424;647;2239
432040;201301;563;1834;466;1612;135;510;96;263;231;773
432045;201301;183;640;168;606;48;185;74;267;122;452
432050;201301;737;2223;684;2120;148;475;405;1282;553;1757
432055;201301;690;2323;646;2226;157;581;402;1371;559;1952
432057;201301;469;1330;418;1226;69;224;239;662;308;886
432060;201301;361;1095;191;690;62;240;49;170;111;410
432065;201301;182;607;161;568;46;188;70;233;116;421
432067;201301;839;2988;674;2575;211;825;271;1015;482;1840
432070;201301;2139;6473;1954;6098;710;2409;749;2354;1459;4763
432080;201301;3919;11975;3607;11432;1148;3813;1643;5205;2791;9018
432085;201301;245;826;219;779;86;354;63;211;149;565
432090;201301;1552;5156;1387;4778;561;2050;350;1060;911;3110
432100;201301;982;3116;681;2408;220;824;157;504;377;1328
432110;201301;2862;9001;2474;8253;955;3416;565;1911;1520;5327
432120;201301;4882;15625;4288;14457;1579;5815;1167;3825;2746;9640
432130;201301;1865;6091;1771;5926;546;1959;973;3271;1519;5230
432132;201301;385;1257;270;976;57;210;90;307;147;517
432135;201301;768;2350;732;2285;131;433;499;1561;630;1994
432140;201301;2827;8617;2452;7955;687;2255;1053;3842;1740;6097
432143;201301;1223;4029;1156;3914;261;901;769;2677;1030;3578
432145;201301;651;2232;546;2002;231;925;114;391;345;1316
432146;201301;226;765;193;680;71;260;55;198;126;458
432147;201301;786;2642;685;2436;212;772;341;1272;553;2044
432149;201301;375;1201;290;977;71;256;119;394;190;650
432150;201301;2804;9099;2444;8554;1072;3914;730;2696;1802;6610
432160;201301;4217;14432;3836;13778;1476;5605;1378;5231;2854;10836
432162;201301;305;777;96;329;27;105;25;70;52;175
432163;201301;318;838;108;344;22;68;26;83;48;151
432166;201301;719;2263;616;2051;155;574;253;774;408;1348
432170;201301;718;2539;543;2136;148;654;114;386;262;1040
432180;201301;2569;7115;1992;6253;631;2166;695;2106;1326;4272
432183;201301;379;1325;359;1289;157;576;108;399;265;975
432185;201301;728;2198;496;1687;137;513;155;514;292;1027
432190;201301;3226;9393;2644;8110;784;2597;860;2490;1644;5087
432195;201301;1215;3612;1105;3449;202;681;690;2151;892;2832
432200;201301;2935;9448;2465;8657;842;3099;1042;3800;1884;6899
432210;201301;405;1262;371;1218;113;428;172;523;285;951
432215;201301;822;2744;773;2655;152;501;502;1813;654;2314
432218;201301;286;868;250;788;43;156;136;410;179;566
432220;201301;3548;10107;3058;9295;639;2214;1730;5132;2369;7346
432225;201301;53;194;48;187;29;117;5;26;34;143
432230;201301;905;2770;838;2675;296;1030;390;1188;686;2218
432232;201301;505;1568;413;1388;96;363;223;741;319;1104
432234;201301;568;1652;519;1565;127;379;290;899;417;1278
432235;201301;66;220;42;159;21;92;9;31;30;123
432237;201301;473;1377;445;1330;39;150;368;1082;407;1232
432240;201301;14428;50883;12904;48820;3426;13832;7497;29133;10923;42965
432250;201301;5330;19469;5149;19104;2586;10154;1280;4980;3866;15134
432252;201301;381;1239;370;1217;119;393;193;668;312;1061
432253;201301;1145;4110;1012;3754;350;1360;353;1320;703;2680
432254;201301;292;826;166;560;55;190;23;82;78;272
432255;201301;161;425;92;318;30;119;33;109;63;228
432260;201301;5297;15742;4652;14669;1147;3892;2513;7923;3660;11815
432270;201301;2423;8059;2260;7773;613;2151;1263;4434;1876;6585
432280;201301;901;2953;699;2485;200;814;186;570;386;1384
432285;201301;108;353;78;266;24;93;19;51;43;144
432290;201301;526;1710;410;1426;86;345;165;542;251;887
432300;201301;21454;68903;20197;66781;5686;19844;10807;35947;16493;55791
432310;201301;951;3202;863;3036;208;780;449;1557;657;2337
432320;201301;251;749;197;645;61;199;67;235;128;434
432330;201301;154;507;103;382;32;134;12;41;44;175
432335;201301;198;595;108;372;38;136;15;40;53;176
432340;201301;255;694;143;449;45;145;41;121;86;266
432345;201301;720;2181;685;2129;191;697;363;1058;554;1755
432350;201301;399;1222;321;1079;90;324;92;293;182;617
432360;201301;51;176;44;157;15;56;19;65;34;121
432370;201301;442;1298;402;1231;35;106;271;831;306;937
432375;201301;756;2090;700;2005;124;367;450;1310;574;1677
432377;201301;54;197;29;112;5;21;7;23;12;44
432380;201301;823;3032;763;2883;355;1461;236;835;591;2296
500020;201301;1504;5550;1335;5158;537;2284;326;1169;863;3453
500025;201301;668;2014;590;1896;161;534;289;911;450;1445
500060;201301;4857;15578;4404;15043;347;1192;3813;13317;4160;14509
500070;201301;3122;10336;2743;9707;808;3166;1184;4139;1992;7305
500080;201301;1532;4932;1283;4517;450;1697;460;1686;910;3383
500085;201301;2076;5938;1607;5195;257;923;957;3003;1214;3926
500090;201301;1914;6094;1677;5688;400;1368;889;3124;1289;4492
500100;201301;2211;7066;2117;6960;846;3050;906;2915;1752;5965
500110;201301;6965;21632;5998;20219;999;3814;3717;12826;4716;16640
500124;201301;1240;4658;1129;4457;235;908;658;2799;893;3707
500150;201301;1227;3514;1055;3271;304;992;510;1583;814;2575
500190;201301;4244;12046;3405;11050;953;3365;1695;5735;2648;9100
500200;201301;2339;6484;1758;5668;499;1831;816;2508;1315;4339
500210;201301;4348;13907;3887;13253;886;3197;2180;7765;3066;10962
500215;201301;1599;5264;1408;4852;363;1424;646;2106;1009;3530
500220;201301;2251;7757;1987;7272;564;2208;835;3098;1399;5306
500230;201301;1411;4747;1323;4613;639;2370;422;1457;1061;3827
500240;201301;3728;12749;3098;11429;827;3336;1267;4885;2094;8221
500260;201301;2294;6675;1963;6151;515;1778;905;2684;1420;4462
500270;201301;86394;242636;65294;206830;22270;76703;18182;58840;40452;135543
500280;201301;1157;3641;1037;3486;262;942;552;1906;814;2848
500290;201301;3203;9082;2423;7687;784;2831;860;2521;1644;5352
500295;201301;2030;6718;1662;5798;463;1833;490;1536;953;3369
500310;201301;761;2190;695;2103;185;609;372;1088;557;1697
500315;201301;2678;8748;2365;8326;558;1924;1431;5357;1989;7281
500320;201301;11075;39891;10216;38506;3722;14466;4078;16550;7800;31016
500325;201301;3079;9286;2600;8538;894;3247;898;2769;1792;6016
500330;201301;4672;13962;4234;13256;1357;4652;1979;6076;3336;10728
500345;201301;2084;6978;1983;6762;578;2160;939;3123;1517;5283
500348;201301;2251;7176;2164;7024;287;998;1677;5455;1964;6453
500350;201301;1067;3435;743;2711;163;611;220;876;383;1487
500370;201301;19608;65541;16987;60533;4678;18468;7413;26362;12091;44830
500375;201301;1938;5960;1697;5549;477;1663;826;2754;1303;4417
500380;201301;2647;8077;2383;7545;758;2577;958;3037;1716;5614
500390;201301;488;1177;370;1010;66;226;235;575;301;801
500400;201301;1081;3673;1003;3499;358;1347;296;970;654;2317
500410;201301;1901;5565;1668;5266;494;1694;753;2391;1247;4085
500430;201301;2208;7333;1933;6926;638;2390;855;3181;1493;5571
500440;201301;1223;3759;1082;3534;302;1136;595;1843;897;2979
500450;201301;2045;6617;1669;5837;480;1895;334;1049;814;2944
500460;201301;3230;10596;2782;9981;755;2907;1428;5119;2183;8026
500470;201301;3025;10113;2800;9563;1030;3734;791;2607;1821;6341
500480;201301;1909;6526;1780;6316;198;754;1364;4940;1562;5694
500490;201301;793;2613;747;2525;260;925;326;1110;586;2035
500500;201301;2825;9364;2466;8889;902;3644;1014;3507;1916;7151
500510;201301;737;2154;582;1925;180;712;246;708;426;1420
500515;201301;1552;4674;1325;4338;313;1026;757;2623;1070;3649
500520;201301;2387;8925;2166;8645;611;2510;1278;5348;1889;7858
500525;201301;1015;3620;942;3502;273;1071;449;1754;722;2825
500540;201301;2931;10475;2626;9912;947;3816;935;3525;1882;7341
500560;201301;4167;14988;3837;14525;932;3732;2420;9296;3352;13028
500568;201301;3366;9524;2684;8579;672;2325;1378;4568;2050;6893
500570;201301;6705;19273;5161;16743;1590;5469;2182;7178;3772;12647
500580;201301;2650;8919;2337;8339;563;2157;1271;4508;1834;6665
500600;201301;2100;6780;1855;6407;681;2488;731;2469;1412;4957
500620;201301;7231;21289;5527;18661;1544;5805;2607;8704;4151;14509
500625;201301;759;2437;589;2083;187;734;188;615;375;1349
500630;201301;5561;16437;4664;15170;1823;6511;1231;4038;3054;10549
500635;201301;2031;8692;1864;8416;320;1379;1192;5808;1512;7187
500640;201301;1185;3347;1007;3079;172;602;659;1952;831;2554
500660;201301;12718;41141;11307;38711;2268;8256;7046;24371;9314;32627
500690;201301;2875;8628;2412;8050;449;1553;1562;5473;2011;7026
500710;201301;3040;10222;2924;10042;922;3264;1518;5326;2440;8590
500720;201301;3321;10976;2983;10399;1136;4285;1039;3602;2175;7887
500730;201301;733;2361;661;2223;196;717;270;890;466;1607
500740;201301;3081;9215;2411;8050;654;2502;993;3118;1647;5620
500750;201301;672;2195;642;2151;151;587;398;1272;549;1859
500755;201301;1070;3444;884;3103;238;897;369;1268;607;2165
500769;201301;4072;11837;3120;9979;915;3243;1092;3310;2007;6553
500770;201301;1442;4615;1252;4272;373;1341;528;1852;901;3193
500780;201301;865;3012;843;2959;314;1191;370;1223;684;2414
500790;201301;6677;21173;5958;19909;1500;5725;3033;9719;4533;15444
500793;201301;2227;6793;1871;6202;378;1472;914;2914;1292;4386
500795;201301;2052;6583;1870;6315;197;641;1454;5092;1651;5733
500797;201301;826;2437;683;2209;179;634;316;1047;495;1681
500800;201301;1879;6163;1692;5904;544;2052;841;2955;1385;5007
500830;201301;11948;39335;10190;35501;3705;13789;2808;9784;6513;23573
500840;201301;1132;3695;1008;3463;216;808;542;1836;758;2644
510010;201301;1187;3909;1129;3807;375;1353;522;1793;897;3146
510020;201301;2182;6782;1776;6131;626;2273;479;1581;1105;3854
510025;201301;8414;26769;7580;25394;2650;9677;2973;9816;5623;19493
510030;201301;2047;5705;1775;5329;552;1730;885;2710;1437;4440
510035;201301;856;2734;745;2567;188;672;410;1480;598;2152
510040;201301;1468;4250;1191;3851;322;1187;567;1780;889;2967
510050;201301;1476;4705;1262;4382;409;1542;522;1852;931;3394
510060;201301;1055;3252;849;2875;272;1020;258;836;530;1856
510080;201301;1246;3994;1074;3717;292;1170;465;1505;757;2675
510100;201301;520;1469;383;1216;116;436;151;437;267;873
510120;201301;230;504;169;436;16;41;146;381;162;422
510125;201301;2502;7096;2162;6572;431;1591;1198;3545;1629;5136
510130;201301;1820;5415;1662;5210;526;1717;754;2426;1280;4143
510140;201301;2663;9214;2340;8764;796;3060;1018;3946;1814;7006
510160;201301;1251;4367;1201;4309;90;362;1056;3792;1146;4154
510170;201301;5128;16884;4612;15949;1315;5026;2119;7157;3434;12183
510180;201301;7861;24735;6691;22671;2286;8161;2675;9663;4961;17824
510185;201301;983;3242;927;3162;280;914;531;1949;811;2863
510190;201301;1321;4974;1210;4792;340;1446;547;2266;887;3712
510250;201301;12915;43309;11495;41457;3644;13770;5953;22048;9597;35818
510260;201301;2462;9186;2365;9028;627;2219;1477;6051;2104;8270
510263;201301;3599;10620;2963;9612;903;3136;1209;3941;2112;7077
510267;201301;3862;12025;3351;11009;907;3313;1498;4765;2405;8078
510268;201301;779;2340;684;2211;225;780;321;1048;546;1828
510269;201301;769;2637;696;2515;270;1006;216;827;486;1833
510270;201301;1882;6290;1728;6078;507;1904;835;3098;1342;5002
510279;201301;1986;6720;1850;6490;695;2682;747;2510;1442;5192
510285;201301;1362;4449;1191;4111;395;1471;365;1188;760;2659
510300;201301;2855;9314;2661;9066;377;1416;2015;6883;2392;8299
510305;201301;1486;5045;1291;4697;377;1471;504;1950;881;3421
510310;201301;1053;3146;852;2834;328;1193;270;903;598;2096
510320;201301;3621;11330;3087;10271;1022;3946;644;1820;1666;5766
510325;201301;5129;17112;4542;16213;593;2075;3448;12764;4041;14839
510330;201301;2527;8676;2246;8149;632;2519;868;3258;1500;5777
510335;201301;4094;13750;3683;13185;692;2499;2607;9684;3299;12183
510336;201301;417;1405;392;1364;97;369;196;684;293;1053
510337;201301;2272;7927;2100;7617;869;3224;794;3061;1663;6285
510340;201301;52224;165827;44472;154234;18639;69686;11138;40886;29777;110572
510343;201301;1005;3226;958;3169;142;459;743;2536;885;2995
510345;201301;1497;4663;1364;4490;438;1493;570;1947;1008;3440
510350;201301;2904;9365;2558;8906;788;2911;1326;4709;2114;7620
510360;201301;1362;4347;1251;4194;310;1085;810;2731;1120;3816
510370;201301;743;2796;667;2664;230;961;289;1183;519;2144
510380;201301;451;1551;387;1417;153;619;70;234;223;853
510385;201301;841;3328;768;3151;146;615;391;1748;537;2363
510390;201301;998;3415;924;3324;263;958;499;1907;762;2865
510395;201301;803;2196;644;1990;141;475;386;1227;527;1702
510410;201301;3538;12418;3384;12160;1167;4480;1599;5724;2766;10204
510420;201301;1881;5270;1599;4889;269;980;965;2946;1234;3926
510450;201301;522;1559;418;1412;140;525;126;424;266;949
510452;201301;503;1641;415;1449;125;504;137;428;262;932
510454;201301;653;2221;583;2116;183;677;302;1143;485;1820
510455;201301;871;2824;731;2586;208;853;301;1038;509;1891
510460;201301;1575;4944;1475;4809;392;1465;874;2722;1266;4187
510480;201301;3668;10534;3007;9324;803;2700;1306;4016;2109;6716
510490;201301;1358;4786;1254;4634;405;1549;687;2575;1092;4124
510500;201301;1139;3823;984;3599;295;1211;535;1910;830;3121
510510;201301;2751;10104;2508;9731;1040;4177;970;3850;2010;8027
510515;201301;4881;15850;4176;14454;1231;4759;1317;4375;2548;9134
510517;201301;1426;4766;1307;4586;355;1254;818;2954;1173;4208
510520;201301;2046;5560;1682;5058;149;541;1287;3806;1436;4347
510523;201301;932;3033;791;2796;246;948;361;1242;607;2190
510525;201301;7114;18426;4464;14205;1189;4118;1454;4564;2643;8682
510530;201301;513;1593;463;1519;94;339;274;918;368;1257
510550;201301;2423;8400;2214;8097;660;2451;1146;4404;1806;6855
510558;201301;1850;5605;1468;5038;530;1943;467;1599;997;3542
510560;201301;1345;4758;1111;4363;451;1805;286;1194;737;2999
510562;201301;4309;14007;4030;13470;1545;5604;1420;4748;2965;10352
510590;201301;2397;7443;1959;6891;593;2283;894;3154;1487;5437
510600;201301;1293;3484;977;3034;173;609;575;1765;748;2374
510610;201301;2298;7572;2217;7479;310;1190;1778;5930;2088;7120
510615;201301;1944;6874;1758;6539;590;2374;791;2893;1381;5267
510617;201301;455;1601;438;1572;79;318;324;1152;403;1470
510618;201301;1111;3503;874;3035;241;936;373;1295;614;2231
510619;201301;679;1973;472;1600;113;433;156;525;269;958
510620;201301;1052;3035;798;2671;268;998;183;590;451;1588
510621;201301;1104;3980;983;3701;317;1287;381;1413;698;2700
510622;201301;2871;9544;2300;8209;688;2759;506;1610;1194;4369
510623;201301;3190;9870;2874;9428;1263;4234;885;3030;2148;7264
510624;201301;905;3210;836;3057;217;855;382;1342;599;2197
510625;201301;1871;6065;1637;5591;547;2061;550;1756;1097;3817
510626;201301;1123;3837;974;3602;295;1150;517;1958;812;3108
510627;201301;594;2008;501;1823;198;768;171;629;369;1397
510628;201301;1375;3886;1166;3631;190;664;813;2515;1003;3179
510629;201301;1579;5535;1433;5238;586;2240;322;1219;908;3459
510630;201301;2719;9311;2369;8745;854;3388;819;3142;1673;6530
510631;201301;379;1180;343;1121;80;258;221;735;301;993
510637;201301;2289;7375;2189;7205;747;2734;1024;3242;1771;5976
510642;201301;4228;14393;3668;13679;1238;4714;1867;7348;3105;12062
510645;201301;624;1661;527;1541;192;602;188;598;380;1200
510650;201301;5438;19548;5223;19251;1309;5093;3169;12051;4478;17144
510665;201301;1046;2947;841;2706;219;805;473;1518;692;2323
510670;201301;336;859;207;674;63;231;83;249;146;480
510675;201301;5762;19746;5104;18556;1955;7727;1572;5673;3527;13400
510677;201301;2266;5990;1714;5302;241;778;1270;3995;1511;4773
510680;201301;729;2427;643;2304;179;710;256;848;435;1558
510682;201301;2062;7067;1784;6545;500;1894;819;3201;1319;5095
510685;201301;686;2299;662;2258;198;707;353;1243;551;1950
510700;201301;2640;8457;2341;8028;521;1994;1469;4942;1990;6936
510704;201301;6417;19771;5775;18717;1898;6866;2633;8218;4531;15084
510706;201301;1249;4377;1175;4232;411;1555;544;1899;955;3454
510710;201301;3153;9588;2798;8945;855;3133;1173;3427;2028;6560
510715;201301;654;1808;459;1483;136;482;155;453;291;935
510718;201301;1481;4941;1390;4790;334;1214;886;3067;1220;4281
510719;201301;428;1022;265;794;48;188;127;343;175;531
510720;201301;1198;3014;905;2668;110;364;661;1959;771;2323
510724;201301;752;2472;686;2353;154;547;418;1439;572;1986
510726;201301;630;1764;566;1665;172;555;244;681;416;1236
510729;201301;542;1676;474;1565;132;478;221;720;353;1198
510730;201301;1939;6532;1834;6345;489;1964;1100;3614;1589;5578
510735;201301;1025;3694;918;3544;313;1202;466;1883;779;3085
510740;201301;907;2443;786;2297;117;359;572;1711;689;2070
510757;201301;573;2187;567;2173;156;620;344;1311;500;1931
510760;201301;22332;70010;19679;65305;7632;27074;6699;22247;14331;49321
510770;201301;3333;10716;3212;10553;651;2149;2115;7293;2766;9442
510774;201301;371;1061;313;982;39;145;218;682;257;827
510775;201301;798;2342;672;2164;265;931;285;950;550;1881
510776;201301;310;1044;285;995;82;315;128;415;210;730
510777;201301;1300;4300;1058;4000;233;1043;660;2433;893;3476
510779;201301;559;1763;461;1587;101;379;187;658;288;1037
510780;201301;3278;10517;3055;10210;731;2543;1847;6302;2578;8845
510785;201301;1767;5485;1516;5079;523;1803;616;2144;1139;3947
510787;201301;1780;5881;1618;5587;532;1988;537;1842;1069;3830
510788;201301;327;1046;300;1016;85;257;160;574;245;831
510790;201301;11419;36458;8657;31168;3004;12183;1413;5037;4417;17220
510792;201301;4494;15873;3706;14132;1149;4994;697;2479;1846;7473
510794;201301;1234;4070;1035;3782;563;2150;201;703;764;2853
510795;201301;7183;25514;6362;23746;2339;9205;1815;7036;4154;16241
510800;201301;1571;4827;1390;4603;393;1455;725;2320;1118;3775
510805;201301;1508;4561;1260;4201;315;1201;757;2452;1072;3653
510810;201301;572;1508;474;1374;142;466;248;684;390;1150
510820;201301;821;2135;642;1861;176;613;254;670;430;1283
510830;201301;512;1883;468;1812;171;689;204;838;375;1527
510835;201301;632;2084;514;1853;212;821;197;670;409;1491
510840;201301;40517;110907;34384;103337;9433;29860;18462;57368;27895;87228
510850;201301;1570;4826;1329;4448;618;2285;214;584;832;2869
510860;201301;2148;7678;1927;7229;725;2856;482;1858;1207;4714
510880;201301;776;2755;699;2606;282;1101;246;912;528;2013
510885;201301;471;1417;363;1250;88;357;167;557;255;914
510890;201301;827;2948;728;2744;243;1023;191;684;434;1707
510895;201301;962;3293;899;3188;296;1163;390;1318;686;2481
520005;201301;977;3380;925;3296;319;1221;369;1303;688;2524
520010;201301;1667;6109;1526;5798;709;2966;219;711;928;3677
520013;201301;3356;10026;2857;9242;808;2780;1427;4632;2235;7412
520015;201301;560;1567;453;1415;125;397;224;740;349;1137
520017;201301;1077;3681;982;3519;284;1072;441;1603;725;2675
520020;201301;318;915;276;860;92;297;145;466;237;763
520025;201301;17994;62569;17675;62134;3488;12929;12826;45152;16314;58081
520030;201301;4033;13900;3703;13377;1517;5781;1262;4841;2779;10622
520050;201301;300;946;287;918;68;245;179;550;247;795
520055;201301;591;1855;508;1725;150;512;233;832;383;1344
520060;201301;1532;5091;1393;4834;376;1447;580;2097;956;3544
520080;201301;1413;4963;1367;4875;319;1185;846;3060;1165;4245
520082;201301;595;2128;571;2077;180;653;315;1197;495;1850
520085;201301;957;3113;848;2847;225;818;340;1154;565;1972
520090;201301;732;2080;672;1976;101;304;447;1333;548;1637
520110;201301;30676;101277;25536;93776;11260;44431;7053;26329;18313;70760
520120;201301;261;693;156;515;48;172;55;204;103;376
520130;201301;3198;10096;3076;9916;927;3225;1603;5153;2530;8378
520140;201301;39122;137114;36542;131900;14027;54187;11784;42713;25811;96900
520145;201301;529;1405;394;1225;92;318;172;512;264;830
520150;201301;624;1715;536;1601;168;538;255;758;423;1296
520160;201301;733;2320;672;2236;252;883;299;1006;551;1889
520170;201301;3369;8851;2767;8213;717;2162;1694;5283;2411;7445
520180;201301;1330;4513;1251;4376;436;1624;503;1752;939;3376
520215;201301;1357;3871;1214;3667;244;852;753;2275;997;3127
520235;201301;748;2110;612;1916;197;686;264;798;461;1484
520250;201301;1031;3641;973;3533;338;1277;532;1931;870;3208
520260;201301;640;1809;528;1608;94;332;278;812;372;1144
520280;201301;534;1635;487;1556;224;734;142;508;366;1242
520310;201301;799;2215;663;2059;118;358;504;1605;622;1963
520320;201301;1175;3996;1022;3723;281;1082;461;1714;742;2796
520330;201301;2503;8185;2095;7521;704;2747;713;2539;1417;5286
520340;201301;1778;4811;1486;4465;298;863;1081;3363;1379;4226
520350;201301;2600;8481;2369;8031;967;3459;974;3244;1941;6703
520355;201301;1030;3738;1019;3714;401;1544;482;1752;883;3296
520357;201301;867;2471;757;2319;80;278;528;1613;608;1891
520360;201301;489;1376;447;1327;114;339;295;898;409;1237
520380;201301;937;2655;754;2388;191;669;398;1280;589;1949
520390;201301;1124;3144;810;2718;296;1131;282;870;578;2001
520393;201301;549;1552;510;1494;105;312;344;1025;449;1337
520396;201301;651;2175;631;2143;70;274;501;1704;571;1978
520400;201301;1737;5085;1508;4767;282;968;1036;3312;1318;4280
520410;201301;1332;3957;1107;3622;371;1332;495;1572;866;2904
520420;201301;307;906;254;821;66;251;128;399;194;650
520425;201301;1376;3988;1309;3861;432;1366;654;1895;1086;3261
520430;201301;1712;4827;1341;4239;345;1248;602;1886;947;3134
520440;201301;2240;6861;1941;6403;770;2740;623;2000;1393;4740
520450;201301;7717;23678;6741;22089;2271;8327;2198;6856;4469;15183
520455;201301;633;1971;545;1844;253;895;141;496;394;1391
520460;201301;670;2107;583;1966;224;809;213;733;437;1542
520465;201301;816;2313;724;2187;190;683;326;914;516;1597
520470;201301;1556;5301;1443;5129;368;1351;888;3253;1256;4604
520480;201301;799;2490;740;2414;175;585;491;1617;666;2202
520485;201301;1054;3728;992;3625;379;1466;449;1643;828;3109
520490;201301;4184;13606;3499;12535;788;3112;1991;7298;2779;10410
520495;201301;1358;3777;1144;3520;72;184;1034;3263;1106;3447
520500;201301;1929;5334;1769;5132;551;1648;858;2769;1409;4417
520505;201301;819;2460;712;2295;98;291;529;1754;627;2045
520510;201301;10314;29896;6938;24003;2240;8518;1693;5849;3933;14367
520520;201301;883;2807;802;2704;345;1229;305;1039;650;2268
520530;201301;2231;7279;2022;6962;470;1592;1117;4304;1587;5896
520540;201301;2611;8604;2441;8318;875;3102;1081;3656;1956;6758
520545;201301;1266;4062;1107;3729;373;1364;336;1083;709;2447
520547;201301;748;2402;600;2142;216;860;182;604;398;1464
520549;201301;7211;23310;6478;22488;1422;5424;4494;15443;5916;20867
520551;201301;3302;10490;3182;10347;962;3190;1728;5996;2690;9186
520552;201301;659;2308;646;2285;147;577;424;1477;571;2054
520570;201301;562;1721;430;1498;188;681;97;351;285;1032
520580;201301;1844;5610;1516;5098;501;1899;362;1124;863;3023
520590;201301;1378;4105;1245;3888;324;1131;607;1758;931;2889
520620;201301;6234;21457;5788;20754;1476;5641;3238;11821;4714;17462
520630;201301;544;1548;465;1455;136;395;297;972;433;1367
520640;201301;2021;6674;1949;6563;702;2437;957;3312;1659;5749
520650;201301;720;2229;678;2146;298;1005;267;829;565;1834
520660;201301;348;1153;312;1079;110;410;96;330;206;740
520670;201301;679;2178;672;2168;77;190;577;1926;654;2116
520680;201301;459;1568;440;1541;178;669;151;512;329;1181
520690;201301;303;802;215;681;28;95;122;404;150;499
520710;201301;288;833;270;810;7;27;228;673;235;700
520725;201301;1514;4306;1279;3995;342;1160;724;2264;1066;3424
520735;201301;571;1840;500;1726;197;709;166;561;363;1270
520740;201301;1471;4526;1287;4283;395;1382;614;2088;1009;3470
520750;201301;650;1806;498;1612;149;521;292;952;441;1473
520753;201301;1036;3196;1023;3177;155;441;828;2627;983;3068
520760;201301;1089;3174;980;3039;333;1108;538;1621;871;2729
520780;201301;1752;4715;1570;4480;184;533;1259;3646;1443;4179
520790;201301;2354;7207;2154;6909;278;943;1581;5182;1859;6125
520800;201301;15840;49387;14257;47485;3008;10341;9029;31755;12037;42096
520810;201301;768;2403;753;2374;85;290;605;1936;690;2226
520815;201301;269;1045;244;989;154;656;45;174;199;830
520830;201301;1607;4328;1264;3970;69;203;1131;3630;1200;3833
520840;201301;1566;5478;1448;5232;486;1844;562;2096;1048;3940
520850;201301;772;2288;614;2075;191;688;279;923;470;1611
520860;201301;6672;20063;5257;18220;1646;6209;2602;9112;4248;15321
520870;201301;109723;323792;81424;271235;27765;99696;24836;83254;52601;182950
520880;201301;5373;16831;4181;14810;1328;5182;527;1683;1855;6865
520890;201301;3264;10273;3039;9919;772;2682;1662;5375;2434;8057
520910;201301;3620;12111;3275;11417;1131;4256;1163;3909;2294;8165
520915;201301;852;2509;629;2061;131;467;256;791;387;1258
520920;201301;2264;6884;1949;6472;490;1783;998;3371;1488;5154
520929;201301;421;1322;394;1288;111;389;207;668;318;1057
520940;201301;875;2880;839;2835;104;399;676;2267;780;2666
520945;201301;621;1604;581;1548;69;196;444;1179;513;1375
520960;201301;823;2536;704;2372;119;426;465;1579;584;2005
520970;201301;3135;9450;2576;8439;552;2054;1139;3711;1691;5765
520980;201301;980;2748;918;2663;78;225;797;2332;875;2557
520990;201301;3525;11359;3134;10659;684;2399;1698;6363;2382;8762
520993;201301;931;2862;760;2506;188;676;355;1139;543;1815
520995;201301;2327;6640;2135;6387;370;1121;1577;4783;1947;5904
521000;201301;7165;22454;6273;21044;1557;5600;3638;12396;5195;17996
521010;201301;3105;10360;2841;9863;810;2978;1391;4913;2201;7891
521015;201301;619;1875;552;1777;119;397;316;1023;435;1420
521020;201301;4074;12577;3462;11363;1368;4825;792;2358;2160;7183
521030;201301;779;2179;699;2067;116;367;510;1519;626;1886
521040;201301;4807;14895;4406;14240;1017;3240;2819;9452;3836;12692
521056;201301;937;2975;823;2797;274;963;379;1316;653;2279
521060;201301;1059;3102;918;2852;258;875;311;924;569;1799
521080;201301;1036;2803;730;2272;216;803;267;754;483;1557
521090;201301;2953;9198;2602;8690;913;3264;1065;3560;1978;6824
521100;201301;1369;3672;1273;3564;253;715;913;2617;1166;3332
521120;201301;4352;13283;4004;12687;877;2668;2480;8205;3357;10873
521130;201301;949;2902;836;2723;178;648;449;1503;627;2151
521140;201301;841;2940;772;2777;334;1267;156;542;490;1809
521150;201301;9850;27743;8312;25364;2669;8886;4140;12629;6809;21515
521160;201301;586;1659;517;1525;91;293;325;929;416;1222
521170;201301;1269;3167;1110;2977;310;802;659;1789;969;2591
521180;201301;5607;20298;5305;19695;2126;8242;1874;7173;4000;15415
521190;201301;7622;23969;6055;21334;2244;8263;2149;7681;4393;15944
521200;201301;755;2084;717;2037;112;318;528;1529;640;1847
521205;201301;416;1444;400;1416;89;349;224;801;313;1150
521210;201301;683;2149;549;1925;238;928;197;606;435;1534
521220;201301;3219;9734;2850;9205;1118;3863;1013;3227;2131;7090
521225;201301;314;905;253;823;49;173;155;525;204;698
521230;201301;1139;3804;1115;3755;368;1308;587;1970;955;3278
521250;201301;23768;82601;22962;81263;9494;35584;9019;32512;18513;68096
521260;201301;554;1483;440;1245;102;367;186;491;288;858
521270;201301;1638;5489;1553;5340;160;487;1226;4401;1386;4888
521280;201301;1464;4856;1300;4605;460;1721;638;2255;1098;3976
521290;201301;474;1435;368;1256;98;400;156;505;254;905
521295;201301;1004;2995;947;2911;218;715;621;1912;839;2627
521300;201301;1609;4876;1465;4618;555;1925;380;1193;935;3118
521305;201301;793;2159;682;2009;132;376;456;1413;588;1789
521308;201301;4614;14430;3863;13221;748;2853;2392;8085;3140;10938
521310;201301;6240;20029;5490;18847;2321;8418;1678;5741;3999;14159
521340;201301;238;790;220;758;75;286;94;309;169;595
521350;201301;1948;5352;1639;4971;221;767;1091;3461;1312;4228
521370;201301;970;3196;912;3080;326;1171;377;1241;703;2412
521375;201301;1378;4098;1253;3914;345;1115;691;2221;1036;3336
521377;201301;958;3078;936;3046;112;342;775;2587;887;2929
521380;201301;3543;10854;3030;10098;722;2621;1621;5379;2343;8000
521385;201301;569;1680;518;1611;152;503;293;917;445;1420
521390;201301;1049;2905;819;2582;326;1113;294;946;620;2059
521400;201301;2297;6344;2004;6015;298;959;1548;4622;1846;5581
521405;201301;997;3225;983;3206;159;495;743;2490;902;2985
521410;201301;686;2312;646;2245;299;1018;237;873;536;1891
521440;201301;1365;3920;1343;3897;156;408;1140;3384;1296;3792
521450;201301;4602;14177;3911;12906;1373;4908;955;2966;2328;7874
521460;201301;6376;21267;5953;20579;1848;6780;3024;10628;4872;17408
521470;201301;606;1797;485;1582;135;494;124;407;259;901
521480;201301;509;1503;384;1290;137;483;94;311;231;794
521483;201301;2601;7360;2407;7083;529;1653;1481;4330;2010;5983
521486;201301;1432;4293;1311;4045;398;1364;728;2131;1126;3495
521487;201301;557;1531;444;1377;66;211;304;957;370;1168
521490;201301;761;2315;650;2172;138;501;390;1327;528;1828
521500;201301;1081;3712;1028;3634;86;295;896;3184;982;3479
521520;201301;822;2034;748;1953;155;294;501;1511;656;1805
521523;201301;10718;40673;10128;39681;2618;10977;5772;22940;8390;33917
521525;201301;901;2465;812;2352;112;352;544;1541;656;1893
521530;201301;1765;5560;1316;4673;623;2324;225;761;848;3085
521540;201301;805;2475;674;2220;232;868;172;488;404;1356
521550;201301;618;1776;559;1686;193;645;255;746;448;1391
521560;201301;4854;15157;3892;13902;1639;6392;960;3305;2599;9697
521565;201301;579;1777;535;1721;91;317;397;1284;488;1601
521570;201301;3447;10618;3066;10035;1267;4339;1094;3669;2361;8008
521580;201301;557;1511;450;1361;162;514;176;565;338;1079
521590;201301;699;2053;612;1913;264;890;144;487;408;1377
521600;201301;608;1583;457;1342;120;387;195;547;315;934
521630;201301;1704;4783;1468;4407;622;2177;276;667;898;2844
521640;201301;1413;4479;1329;4360;543;2009;358;1180;901;3189
521645;201301;571;1886;519;1772;176;656;223;717;399;1373
521680;201301;1291;4418;1239;4300;818;2923;282;988;1100;3911
521690;201301;489;1555;460;1498;93;336;271;874;364;1210
521710;201301;1918;6219;1732;5859;376;1364;1041;3481;1417;4845
521720;201301;1956;6030;1805;5819;447;1482;1102;3629;1549;5111
521730;201301;3474;12199;3348;11953;1495;5788;1128;3812;2623;9600
521740;201301;3134;9081;2580;8373;1321;4400;837;2839;2158;7239
521760;201301;11061;39551;10568;38802;1739;7175;7521;27744;9260;34919
521770;201301;2613;8172;2279;7522;977;3444;588;1853;1565;5297
521800;201301;8012;24978;7086;23639;2681;9278;3306;11434;5987;20712
521805;201301;628;1687;627;1686;219;530;351;1079;570;1609
521810;201301;776;2394;704;2289;203;698;365;1217;568;1915
521830;201301;5238;18288;4991;17893;1116;4328;3369;12035;4485;16363
521839;201301;603;1920;517;1733;142;523;226;722;368;1245
521850;201301;6016;17874;5718;17526;1279;3784;3960;12635;5239;16419
521860;201301;1631;5183;1445;4784;450;1638;525;1651;975;3289
521870;201301;542;1942;514;1871;161;654;191;651;352;1305
521878;201301;377;1353;358;1321;156;634;88;294;244;928
521880;201301;21302;59384;15248;49376;6007;20791;4278;14060;10285;34851
521890;201301;3338;10805;2932;10015;1198;4323;710;2440;1908;6763
521900;201301;1580;4310;1328;3963;372;1244;592;1702;964;2946
521910;201301;1117;3317;995;3176;269;936;573;1848;842;2784
521920;201301;393;1295;385;1278;161;568;183;599;344;1167
521925;201301;544;1774;539;1764;77;266;447;1466;524;1732
521930;201301;4241;14244;3949;13655;1705;6242;1097;3736;2802;9978
521935;201301;655;2011;630;1962;167;558;382;1151;549;1709
521940;201301;1137;3123;957;2858;374;1185;325;983;699;2168
521945;201301;621;2229;585;2185;132;459;417;1628;549;2087
521950;201301;431;1501;407;1449;160;607;148;517;308;1124
521960;201301;900;2725;785;2527;203;705;406;1314;609;2019
521970;201301;2177;6582;2098;6465;383;1247;1496;4687;1879;5934
521971;201301;957;2776;826;2576;236;817;398;1192;634;2009
521973;201301;696;2500;656;2417;263;1039;195;692;458;1731
521975;201301;12035;36808;11434;36026;2457;8428;7307;23140;9764;31568
521980;201301;1639;5508;1609;5469;300;956;1219;4315;1519;5271
521990;201301;972;3210;932;3130;198;721;569;1875;767;2596
522000;201301;1984;6078;1793;5832;400;1366;1092;3721;1492;5087
522005;201301;305;898;247;803;67;234;129;405;196;639
522010;201301;2707;8425;2408;7948;902;3272;734;2334;1636;5606
522015;201301;946;2926;812;2725;236;885;430;1433;666;2318
522020;201301;3950;11821;3576;11340;1035;3428;1932;6141;2967;9569
522026;201301;491;1625;423;1554;236;906;145;525;381;1431
522028;201301;499;1556;455;1483;129;454;245;777;374;1231
522040;201301;2823;7476;2047;6462;755;2576;787;2464;1542;5040
522045;201301;11825;40902;10597;38231;3628;14253;2508;8824;6136;23077
522050;201301;990;3021;846;2778;263;947;385;1228;648;2175
522060;201301;2464;8653;2394;8543;770;2908;1411;4981;2181;7889
522068;201301;1299;4564;1238;4491;127;414;1038;3885;1165;4299
522070;201301;800;2527;741;2432;147;575;458;1478;605;2053
522100;201301;796;2228;707;2089;264;891;329;898;593;1789
522108;201301;857;2573;793;2482;78;274;609;1944;687;2218
522119;201301;1388;4366;1231;4173;124;402;1034;3572;1158;3974
522130;201301;488;1439;422;1366;128;458;216;699;344;1157
522140;201301;15824;46795;14270;44849;4217;14092;7829;24741;12046;38833
522145;201301;911;2680;865;2606;492;1560;197;585;689;2145
522150;201301;1231;3308;1020;3043;346;1097;483;1514;829;2611
522155;201301;690;2140;635;2065;150;556;386;1246;536;1802
522157;201301;604;1897;563;1832;79;281;417;1362;496;1643
522160;201301;5209;15594;4148;13973;1944;7179;937;2989;2881;10168
522170;201301;3064;8656;2644;8108;643;1967;1479;4775;2122;6742
522180;201301;432;1324;350;1223;183;692;115;391;298;1083
522185;201301;13216;44206;12691;43491;2736;10213;8138;28041;10874;38254
522190;201301;650;1963;588;1822;122;403;356;1109;478;1512
522200;201301;1500;5177;1424;5028;553;2080;461;1605;1014;3685
522205;201301;1393;4083;1205;3792;370;1164;570;1852;940;3016
522220;201301;942;3116;868;3015;226;825;477;1757;703;2582
522230;201301;689;2547;684;2539;143;530;495;1887;638;2417
530010;201301;240026;804910;217625;758136;69178;263986;68957;242687;138135;506673
