ibge;anomes;cadunico_tot_fam;cadunico_tot_pes;cadunico_tot_fam_rpc_ate_meio_sm;cadunico_tot_pes_rpc_ate_meio_sm;cadunico_tot_fam_pob;cadunico_tot_pes_pob;cadunico_tot_fam_ext_pob;cadunico_tot_pes_ext_pob;cadunico_tot_fam_pob_e_ext_pob;cadunico_tot_pes_pob_e_ext_pob
110001;201412;4701;15230;4046;14187;1072;3880;2262;8073;3334;11953
110002;201412;14698;45722;12305;41392;3796;13820;5195;17408;8991;31228
110003;201412;1014;3259;916;3075;265;936;339;1108;604;2044
110004;201412;10486;33563;8687;29769;2945;10923;2342;7973;5287;18896
110005;201412;2438;8074;2254;7710;860;3032;905;3117;1765;6149
110006;201412;3454;9253;2158;7408;735;2665;642;2073;1377;4738
110007;201412;1616;4944;1482;4758;341;1196;769;2703;1110;3899
110008;201412;2728;9146;2550;8884;473;1545;1864;6813;2337;8358
110009;201412;5578;16021;4260;14007;1238;4462;1825;5827;3063;10289
110010;201412;8853;25316;7690;23858;1678;4829;4763;16025;6441;20854
110011;201412;11191;34017;9190;30544;3268;11422;3536;11761;6804;23183
110012;201412;17400;53523;14992;48894;5007;17081;5720;18736;10727;35817
110013;201412;5792;17922;4698;16217;1569;5724;1826;6417;3395;12141
110014;201412;4645;13499;3863;12348;778;2590;2420;7853;3198;10443
110015;201412;5795;17861;4425;15380;1494;5634;1483;5141;2977;10775
110018;201412;5473;15872;4376;14425;1358;4998;2005;6379;3363;11377
110020;201412;63069;180748;50680;164110;11276;38086;28482;94569;39758;132655
110025;201412;4757;13748;3883;12184;674;2251;2625;8215;3299;10466
110026;201412;866;2496;727;2325;200;646;428;1402;628;2048
110028;201412;8147;23708;5936;19834;1754;6432;1351;4370;3105;10802
110029;201412;1769;5114;1392;4486;424;1415;646;2117;1070;3532
110030;201412;12444;35041;9882;31566;2765;9500;4790;15712;7555;25212
110032;201412;4364;13984;3855;12854;1216;4233;1486;4896;2702;9129
110033;201412;5902;18704;5444;18011;1711;5507;2750;9745;4461;15252
110034;201412;4074;10574;3387;9734;580;1587;2547;7467;3127;9054
110037;201412;2197;7388;1895;6821;475;1759;1038;3781;1513;5540
110040;201412;3760;11989;3387;11323;1044;3780;1590;5230;2634;9010
110045;201412;5186;17314;4626;16645;1455;5623;2478;8856;3933;14479
110050;201412;1924;6089;1609;5646;515;1824;867;3123;1382;4947
110060;201412;1061;3576;932;3334;298;1154;394;1406;692;2560
110070;201412;2077;7055;1994;6874;438;1590;1259;4338;1697;5928
110080;201412;4076;12391;3796;12061;460;1302;3115;10256;3575;11558
110090;201412;976;2821;765;2486;221;826;348;1043;569;1869
110092;201412;1735;5610;1575;5401;333;1152;975;3515;1308;4667
110094;201412;3585;10957;3230;10461;884;2934;1827;6053;2711;8987
110100;201412;2739;8540;2333;7857;697;2487;1209;4064;1906;6551
110110;201412;1852;5877;1706;5698;725;2515;693;2370;1418;4885
110120;201412;1832;5936;1429;5019;461;1689;420;1482;881;3171
110130;201412;2875;8139;2109;6949;659;2274;853;2814;1512;5088
110140;201412;2769;9241;2490;8754;560;2041;1465;5247;2025;7288
110143;201412;1641;5162;1250;4481;314;1169;644;2303;958;3472
110145;201412;1083;3185;914;2908;199;686;556;1756;755;2442
110146;201412;487;1543;436;1463;98;336;252;861;350;1197
110147;201412;952;2790;731;2409;210;764;280;830;490;1594
110148;201412;1457;4333;1088;3559;331;1156;360;1128;691;2284
110149;201412;3981;11569;3076;10165;915;3083;1634;5544;2549;8627
110150;201412;3010;8670;2461;7875;319;1118;1657;5401;1976;6519
110155;201412;993;3203;927;3052;271;943;494;1605;765;2548
110160;201412;2226;6911;1802;6120;587;2048;816;2781;1403;4829
110170;201412;3281;9353;2480;7941;562;1924;1424;4524;1986;6448
110175;201412;1895;5715;1424;5104;225;874;890;3274;1115;4148
110180;201412;1745;5314;1469;4879;364;1253;852;2856;1216;4109
120001;201412;3105;10802;2953;10541;619;2356;1842;6675;2461;9031
120005;201412;1628;6616;1583;6536;188;754;1230;5263;1418;6017
120010;201412;4805;16731;4562;16315;817;2823;3194;11846;4011;14669
120013;201412;1951;7612;1889;7511;452;1771;1192;4993;1644;6764
120017;201412;2231;7915;2093;7654;583;2149;1013;4059;1596;6208
120020;201412;15050;65488;14607;64607;2423;10240;10617;49165;13040;59405
120025;201412;2954;10110;2849;9956;591;2213;1826;6463;2417;8676
120030;201412;6492;25382;6364;25225;447;1647;5561;22478;6008;24125
120032;201412;1431;6849;1368;6693;205;1164;989;4863;1194;6027
120033;201412;3711;14272;3674;14210;179;697;3339;13091;3518;13788
120034;201412;1910;7895;1853;7801;181;888;1557;6501;1738;7389
120035;201412;2937;13803;2895;13714;229;1065;2481;12054;2710;13119
120038;201412;3213;11643;3082;11371;833;3164;1734;6547;2567;9711
120039;201412;1556;8219;1525;8145;184;1039;1220;6604;1404;7643
120040;201412;49493;176088;44856;166627;12512;49141;22175;84185;34687;133326
120042;201412;2922;12512;2774;12169;403;1912;2003;8917;2406;10829
120043;201412;896;4269;862;4203;64;282;726;3675;790;3957
120045;201412;4758;16200;4687;16096;857;3005;3555;12358;4412;15363
120050;201412;8406;34525;8021;33673;1389;5622;5442;24118;6831;29740
120060;201412;7615;34230;7489;33989;666;3085;6305;29273;6971;32358
120070;201412;2938;10943;2862;10762;552;1983;1913;7508;2465;9491
120080;201412;3891;14607;3727;14340;572;2164;2805;11147;3377;13311
130002;201412;3044;12678;2864;12371;235;1092;2387;10436;2622;11528
130006;201412;1931;8101;1679;7628;279;1404;1141;5212;1420;6616
130008;201412;2081;8447;1987;8278;174;764;1614;6829;1788;7593
130010;201412;2914;9737;2558;9323;206;707;2211;8216;2417;8923
130014;201412;3600;11494;3094;10723;506;1887;2055;7196;2561;9083
130020;201412;2682;9526;2672;9514;32;106;2628;9381;2660;9487
130030;201412;7419;28364;7145;28015;724;2419;5939;24238;6663;26657
130040;201412;3758;11649;3397;11172;264;975;2900;9594;3164;10569
130050;201412;6304;25029;5603;23925;620;2581;4224;19002;4844;21583
130060;201412;5816;26403;5485;25863;551;2715;4409;21156;4960;23871
130063;201412;3538;15604;3489;15529;287;1202;3013;13754;3300;14956
130068;201412;3126;13137;2862;12609;417;1988;1953;8694;2370;10682
130070;201412;6966;22774;6285;21911;646;2235;5033;17995;5679;20230
130080;201412;5234;23187;5003;22833;952;4483;3346;15838;4298;20321
130083;201412;2204;8699;2080;8504;301;1430;1513;6178;1814;7608
130090;201412;2703;9618;2578;9451;166;688;2261;8323;2427;9011
130100;201412;5695;21248;5465;20941;328;1396;4834;18662;5162;20058
130110;201412;7076;22495;6607;21935;624;1887;5537;18978;6161;20865
130115;201412;4340;15445;4159;15208;94;295;3973;14634;4067;14929
130120;201412;14580;54825;13900;53919;1322;4576;11656;46853;12978;51429
130130;201412;3713;15522;3610;15344;378;1667;2954;12764;3332;14431
130140;201412;6453;24949;6367;24848;156;393;6158;24337;6314;24730
130150;201412;3561;13496;3486;13399;210;903;3103;11968;3313;12871
130160;201412;4066;16788;3964;16653;267;1020;3594;15317;3861;16337
130165;201412;2893;11865;2781;11670;361;1592;2216;9402;2577;10994
130170;201412;9597;34185;8392;32683;1172;4604;6339;25529;7511;30133
130180;201412;3509;11287;3426;11163;132;374;3167;10423;3299;10797
130185;201412;10611;35102;9749;34099;1075;3425;7951;29019;9026;32444
130190;201412;18689;63737;16442;60852;3272;11899;10812;42068;14084;53967
130195;201412;1913;7933;1853;7845;109;464;1645;7065;1754;7529
130200;201412;2056;7329;1894;7062;510;1886;1114;4304;1624;6190
130210;201412;1231;4807;1162;4690;136;593;936;3836;1072;4429
130220;201412;2058;8407;1871;8031;351;1688;1074;4671;1425;6359
130230;201412;3681;16443;3478;16107;406;1822;2647;12849;3053;14671
130240;201412;8686;32903;8013;31913;482;2154;6902;27900;7384;30054
130250;201412;19424;68042;18456;66758;2220;7417;14603;55134;16823;62551
130255;201412;4222;14829;3987;14451;152;478;3635;13437;3787;13915
130260;201412;268824;868461;241130;823131;69026;244336;121984;427546;191010;671882
130270;201412;7613;31065;6858;29875;1044;4514;4945;22544;5989;27058
130280;201412;3373;13268;3291;13151;171;531;2979;12268;3150;12799
130290;201412;11283;39847;10972;39457;217;497;10467;38353;10684;38850
130300;201412;4637;17662;4340;17221;384;1685;3549;14233;3933;15918
130310;201412;5382;19883;4923;19311;470;1770;4030;16266;4500;18036
130320;201412;3040;10511;2762;10136;363;1338;2028;7651;2391;8989
130330;201412;3784;13614;3399;13089;214;932;2905;11320;3119;12252
130340;201412;19278;72183;18163;70651;3700;13500;12207;50647;15907;64147
130350;201412;3349;13502;3207;13330;306;1347;2665;11281;2971;12628
130353;201412;6180;18943;5373;17854;1305;4230;3265;11621;4570;15851
130356;201412;4775;17088;4558;16751;469;1470;3735;14392;4204;15862
130360;201412;3123;8909;2760;8502;41;68;2628;8292;2669;8360
130370;201412;5220;20378;4486;19386;293;1516;3713;16166;4006;17682
130380;201412;7181;30135;6880;29703;501;2230;5927;25960;6428;28190
130390;201412;4946;21890;4615;21296;495;2426;3548;16788;4043;19214
130395;201412;2122;7612;1871;7074;265;1048;1247;4770;1512;5818
130400;201412;2141;8044;2069;7940;157;640;1811;7024;1968;7664
130406;201412;10125;38590;9048;36922;2137;8941;5504;23317;7641;32258
130410;201412;4172;15800;3809;15131;1171;4985;1689;6878;2860;11863
130420;201412;10359;43748;9966;43055;2895;12169;5951;27040;8846;39209
130423;201412;3273;12645;3088;12392;284;1309;2598;10457;2882;11766
130426;201412;2144;9197;2053;9034;335;1429;1494;6886;1829;8315
130430;201412;3741;13103;3533;12810;515;1927;2532;9402;3047;11329
130440;201412;4073;14154;3749;13794;253;793;3322;12591;3575;13384
140002;201412;1702;5385;1589;5238;177;567;1213;4109;1390;4676
140005;201412;3151;9151;2977;8963;102;229;2811;8580;2913;8809
140010;201412;49457;155226;43253;145146;10802;38880;22213;76057;33015;114937
140015;201412;3024;9752;2851;9517;372;999;2232;7844;2604;8843
140017;201412;3409;10505;3105;10121;306;870;2485;8434;2791;9304
140020;201412;4558;15429;4223;14980;394;1294;3472;12660;3866;13954
140023;201412;2205;7441;1973;7062;259;964;1397;5103;1656;6067
140028;201412;2271;6172;2205;6098;82;145;2052;5818;2134;5963
140030;201412;3829;12069;3654;11850;472;1200;3018;10237;3490;11437
140040;201412;1589;7482;1537;7338;144;759;1194;5805;1338;6564
140045;201412;2575;9354;2374;9049;488;1676;1543;6431;2031;8107
140047;201412;5683;15796;5086;14989;1479;4480;2598;8070;4077;12550
140050;201412;1553;4801;1418;4615;230;780;974;3236;1204;4016
140060;201412;1490;4630;1334;4373;281;957;856;2884;1137;3841
140070;201412;1519;7696;1480;7561;92;534;1295;6616;1387;7150
150010;201412;34653;109366;32972;107117;2281;7627;28039;92451;30320;100078
150013;201412;1735;5104;1608;4959;176;495;1283;4068;1459;4563
150020;201412;12645;42309;12255;41755;1010;3422;10536;36397;11546;39819
150030;201412;6810;29025;6601;28703;689;2536;5474;24902;6163;27438
150034;201412;4518;12389;4230;12024;258;661;3791;10930;4049;11591
150040;201412;13059;43550;11368;41464;2331;7861;7662;30084;9993;37945
150050;201412;6268;23798;6085;23467;590;2417;4975;19423;5565;21840
150060;201412;18018;58228;16874;56490;3290;10610;11577;40140;14867;50750
150070;201412;5979;24511;5376;23826;424;1980;4645;20873;5069;22853
150080;201412;68382;182682;58942;170216;9449;25650;40342;121076;49791;146726
150085;201412;5197;18168;4939;17795;583;1829;4000;14995;4583;16824
150090;201412;10310;39625;9715;38796;966;3821;7900;32228;8866;36049
150095;201412;5407;18233;4965;17563;461;1533;4022;14697;4483;16230
150100;201412;3602;13284;3363;12919;266;1221;2758;10542;3024;11763
150110;201412;3333;16244;3320;16212;189;812;3038;15078;3227;15890
150120;201412;6175;23845;6018;23560;775;3011;4757;18919;5532;21930
150125;201412;835;2543;771;2448;153;525;517;1622;670;2147
150130;201412;22076;68194;20653;66149;2003;6278;16464;53852;18467;60130
150140;201412;160861;472781;154412;464498;17959;53305;125578;383188;143537;436493
150145;201412;4970;15524;4580;15023;668;2235;3456;11531;4124;13766
150150;201412;10926;34982;10208;33835;1802;6197;7083;23770;8885;29967
150157;201412;3147;9546;2765;8999;384;1369;2031;6694;2415;8063
150160;201412;3028;10011;2835;9728;720;2446;1701;6064;2421;8510
150170;201412;22918;84108;21534;82054;3834;14577;15423;59873;19257;74450
150172;201412;3195;11046;2835;10467;438;1658;2078;7839;2516;9497
150175;201412;2125;6453;2023;6340;152;393;1743;5714;1895;6107
150178;201412;11095;33954;9347;31824;825;2638;7772;27134;8597;29772
150180;201412;18689;75035;17997;74065;1744;7553;14868;62071;16612;69624
150190;201412;7331;23582;6897;22982;424;984;5996;20821;6420;21805
150195;201412;5073;17056;4719;16476;367;1361;3968;13972;4335;15333
150200;201412;5309;17087;5103;16840;153;463;4743;15856;4896;16319
150210;201412;23928;91166;23224;90139;2226;7992;19251;77306;21477;85298
150215;201412;6642;21357;5870;20141;1600;5783;2940;10279;4540;16062
150220;201412;12884;40700;11602;38646;2708;9307;6302;21419;9010;30726
150230;201412;11423;38304;10226;36582;1024;4312;7957;28383;8981;32695
150240;201412;36055;108572;31993;101580;10358;33964;12825;42370;23183;76334
150250;201412;4237;16967;4089;16742;563;2260;3140;13315;3703;15575
150260;201412;2184;8731;2077;8520;425;1795;1293;5465;1718;7260
150270;201412;9822;29598;7584;26791;1655;6215;4736;17048;6391;23263
150275;201412;6064;22027;5724;21483;803;3023;4264;16369;5067;19392
150276;201412;2185;6552;1990;6279;391;1316;1452;4586;1843;5902
150277;201412;5121;15959;4445;15129;619;2099;3304;11631;3923;13730
150280;201412;5999;26453;5800;25985;1123;4999;3912;18107;5035;23106
150285;201412;2687;10827;2580;10614;510;2173;1683;7154;2193;9327
150290;201412;9791;29330;9392;28864;813;2064;8019;25618;8832;27682
150293;201412;9675;27686;7596;24699;2422;8250;3060;10629;5482;18879
150295;201412;6644;20193;5569;18926;1066;3412;3831;13967;4897;17379
150300;201412;1855;6481;1781;6389;129;426;1468;5451;1597;5877
150304;201412;4258;13228;3666;12401;594;2014;2530;8844;3124;10858
150307;201412;6846;22947;6341;22228;488;1674;5245;18897;5733;20571
150309;201412;7106;24604;6522;23826;1559;5616;4231;16254;5790;21870
150310;201412;5795;25777;5623;25481;754;3488;4319;20052;5073;23540
150320;201412;9344;23194;8822;22645;610;1300;7785;20502;8395;21802
150330;201412;14131;49339;13232;47996;1655;5782;10207;38303;11862;44085
150340;201412;2464;8059;2272;7767;371;1330;1607;5568;1978;6898
150345;201412;6871;23038;6343;22326;692;2382;5095;18406;5787;20788
150350;201412;7791;25032;7337;24410;1107;3267;5464;18888;6571;22155
150360;201412;22600;70312;19481;66260;3212;10951;13467;47557;16679;58508
150370;201412;10647;38873;10093;38141;1388;4609;8061;31842;9449;36451
150375;201412;2894;12230;2819;12118;332;1247;2336;10482;2668;11729
150380;201412;10084;29704;8881;28065;822;2757;7290;23264;8112;26021
150390;201412;8457;36090;8013;35229;1625;6860;5197;23958;6822;30818
150400;201412;5699;22903;5458;22390;568;2305;4226;17787;4794;20092
150405;201412;8737;26426;7687;25104;1435;4119;5327;18686;6762;22805
150410;201412;1756;6723;1691;6598;288;1213;1114;4414;1402;5627
150420;201412;37565;129364;32627;121120;9536;37413;14841;57579;24377;94992
150430;201412;6833;24294;6523;23772;844;3154;4858;18083;5702;21237
150440;201412;5583;19431;5372;19121;989;3389;3838;14091;4827;17480
150442;201412;22275;64464;20171;61565;3754;11642;13110;41257;16864;52899
150445;201412;5388;18764;4930;18048;656;2316;3731;14042;4387;16358
150450;201412;4415;21108;4249;20860;396;1934;3543;17799;3939;19733
150460;201412;7021;25630;5898;24421;369;1670;5188;21891;5557;23561
150470;201412;18154;55542;17526;54768;961;2436;15987;50981;16948;53417
150475;201412;1668;5788;1552;5634;194;689;1244;4664;1438;5353
150480;201412;14409;49139;13697;48060;1308;4603;11218;40241;12526;44844
150490;201412;6874;26261;6702;26020;287;1104;6103;23974;6390;25078
150495;201412;5013;18401;4893;18228;197;715;4537;17056;4734;17771
150497;201412;3309;11643;2996;11093;922;3559;1548;5845;2470;9404
150500;201412;3146;8865;2947;8564;404;1191;2205;6414;2609;7605
150503;201412;4257;13261;3668;12518;1344;4669;1829;6530;3173;11199
150506;201412;12634;44407;11615;42944;2463;8485;7852;30764;10315;39249
150510;201412;10048;39295;9311;37949;1463;6021;6499;27561;7962;33582
150520;201412;6790;26248;6693;26115;245;755;6296;24940;6541;25695
150530;201412;12395;43174;11182;41275;1320;4735;8545;32322;9865;37057
150540;201412;4800;14710;4280;13963;339;1155;3548;11588;3887;12743
150543;201412;5640;17613;5066;16773;1122;3852;3284;11105;4406;14957
150548;201412;8959;28658;8385;27916;437;1300;7580;25646;8017;26946
150549;201412;2291;7260;2149;7094;102;230;1966;6673;2068;6903
150550;201412;21520;68715;18983;64266;5831;20398;8496;29406;14327;49804
150553;201412;20589;72276;17520;65547;6886;27518;4560;17168;11446;44686
150555;201412;1834;5602;1605;5277;195;685;1200;3980;1395;4665
150560;201412;2037;6554;1930;6319;277;931;1364;4467;1641;5398
150563;201412;2926;9597;2706;9209;646;2348;1552;5296;2198;7644
150565;201412;3639;12712;3339;12238;236;1012;2687;9968;2923;10980
150570;201412;5728;21222;5607;21019;436;1625;4709;18087;5145;19712
150580;201412;10007;41166;9794;40900;758;2625;8603;37152;9361;39777
150590;201412;5697;23002;5552;22828;113;339;5314;22115;5427;22454
150600;201412;8178;31199;7912;30799;519;1872;6960;27739;7479;29611
150610;201412;2424;8326;2213;7887;278;1109;1546;5439;1824;6548
150611;201412;2762;9810;2589;9451;258;1012;1982;7279;2240;8291
150613;201412;12706;38698;10870;36024;3651;12504;5067;17486;8718;29990
150616;201412;3188;9531;2473;8506;654;2443;1146;3835;1800;6278
150618;201412;7443;25774;7069;25082;2239;8131;3538;13003;5777;21134
150619;201412;5471;18696;5076;18115;661;2573;3735;13414;4396;15987
150620;201412;6529;23471;5901;22675;815;3079;4609;18322;5424;21401
150630;201412;5757;17511;5477;17176;413;1234;4702;15074;5115;16308
150635;201412;4629;15143;4320;14543;929;3175;2551;8835;3480;12010
150640;201412;1726;5360;1681;5302;202;600;1366;4502;1568;5102
150650;201412;12713;39121;11423;36795;3164;10455;5568;18417;8732;28872
150655;201412;5471;18138;5021;17456;619;2257;3849;13564;4468;15821
150658;201412;4428;14004;4036;13430;817;3098;2616;8679;3433;11777
150660;201412;5989;18784;5423;17995;1381;4473;3166;10964;4547;15437
150670;201412;6976;19596;5880;18221;1510;4769;3579;11580;5089;16349
150680;201412;55365;209071;50945;200922;16704;66886;23142;97358;39846;164244
150690;201412;1982;6234;1799;5925;329;1021;1161;3973;1490;4994
150700;201412;6215;19100;5703;18430;1103;3627;3825;12673;4928;16300
150710;201412;4369;14487;3920;13765;462;1609;2993;10716;3455;12325
150715;201412;5185;16648;4580;15732;610;2200;3441;11991;4051;14191
150720;201412;6702;27224;6294;26489;973;4088;4547;19902;5520;23990
150730;201412;9760;33439;9134;32563;1092;3688;7405;27106;8497;30794
150740;201412;3799;12067;3439;11435;520;1826;2249;7561;2769;9387
150745;201412;5933;18634;5434;17954;1173;4014;3597;12008;4770;16022
150746;201412;1450;4737;1372;4597;206;744;942;3177;1148;3921
150747;201412;5284;16831;4717;16084;526;1598;3592;12940;4118;14538
150750;201412;3107;10461;2975;10293;165;497;2703;9509;2868;10006
150760;201412;11695;37847;10991;36926;2426;8070;7097;24741;9523;32811
150770;201412;5844;22133;5592;21762;677;2491;4424;18154;5101;20645
150775;201412;1222;3783;1083;3534;225;884;632;1988;857;2872
150780;201412;3321;10863;3280;10818;86;203;3118;10427;3204;10630
150790;201412;5388;17134;4957;16588;502;1618;4068;14064;4570;15682
150795;201412;16044;49245;14293;46715;2839;9008;9327;31757;12166;40765
150796;201412;3003;9054;2794;8807;356;1076;2186;7124;2542;8200
150797;201412;3870;13005;3624;12627;180;673;3170;11146;3350;11819
150800;201412;14545;48419;13185;46741;2684;8829;9205;34375;11889;43204
150803;201412;7034;25296;6655;24715;874;3299;4932;18819;5806;22118
150805;201412;2863;9911;2640;9574;369;1285;1967;7337;2336;8622
150808;201412;6166;20883;5227;19122;2231;8699;1165;4352;3396;13051
150810;201412;20243;62763;16875;58644;2477;8096;12103;44551;14580;52647
150812;201412;5431;16900;4965;16176;513;2093;3699;11660;4212;13753
150815;201412;9277;29643;8317;28448;1016;3355;6656;23475;7672;26830
150820;201412;11328;32294;10114;30961;668;1373;8874;28221;9542;29594
150830;201412;13106;49263;12003;47519;667;2851;10050;41118;10717;43969
150835;201412;2156;7803;1998;7439;542;2134;948;3551;1490;5685
150840;201412;8165;23518;6482;21107;1551;5528;3486;11198;5037;16726
160005;201412;772;2844;723;2759;99;450;507;1900;606;2350
160010;201412;1576;5228;1565;5216;117;281;1407;4834;1524;5115
160015;201412;1869;6826;1821;6748;182;577;1503;5816;1685;6393
160020;201412;2327;7706;2165;7482;290;1018;1608;5722;1898;6740
160021;201412;939;4035;918;3999;183;865;639;2825;822;3690
160023;201412;1062;4217;1045;4190;69;245;931;3807;1000;4052
160025;201412;1546;4281;1510;4241;16;44;1480;4161;1496;4205
160027;201412;8517;25849;7915;25184;2773;8375;4220;14482;6993;22857
160030;201412;47725;170260;42971;160893;10168;37981;25841;100416;36009;138397
160040;201412;4359;16856;4255;16699;142;649;3976;15616;4118;16265
160050;201412;3738;13881;3371;13342;1484;5806;1407;5947;2891;11753
160053;201412;2852;11061;2787;10961;640;2576;1870;7526;2510;10102
160055;201412;756;2908;743;2894;112;472;566;2222;678;2694
160060;201412;17967;60619;16980;59510;3728;12393;11783;43099;15511;55492
160070;201412;2439;9596;2376;9494;149;603;2109;8541;2258;9144
160080;201412;2768;10176;2752;10150;89;274;2621;9770;2710;10044
170025;201412;582;1946;527;1861;174;631;259;952;433;1583
170030;201412;1198;3933;1073;3701;328;1140;481;1709;809;2849
170035;201412;1595;4691;1308;4155;442;1473;449;1481;891;2954
170040;201412;1947;6345;1700;5987;291;1175;1146;4072;1437;5247
170070;201412;2127;5703;1697;5147;469;1536;885;2711;1354;4247
170100;201412;2602;7418;2289;6892;274;891;1760;5335;2034;6226
170105;201412;779;2461;630;2148;133;531;320;1046;453;1577
170110;201412;1198;3724;1046;3471;249;892;537;1768;786;2660
170130;201412;1475;4570;1269;4260;300;1038;704;2460;1004;3498
170190;201412;1708;4932;1337;4353;551;1729;331;1237;882;2966
170200;201412;1694;5012;1220;4103;354;1313;381;1235;735;2548
170210;201412;31943;95844;26758;86861;8869;30714;9208;31131;18077;61845
170215;201412;1236;3868;1087;3636;123;435;830;2809;953;3244
170220;201412;6706;22301;6078;21197;1284;4771;3526;12526;4810;17297
170230;201412;1572;5057;1349;4647;316;1255;660;2181;976;3436
170240;201412;3072;8755;2446;7898;351;1285;1676;5414;2027;6699
170255;201412;3763;11889;3097;10785;933;3330;1364;5000;2297;8330
170270;201412;1070;2741;756;2298;108;369;505;1504;613;1873
170290;201412;3068;9110;2701;8671;192;501;2315;7737;2507;8238
170300;201412;2141;6591;1792;6008;298;1061;1140;3865;1438;4926
170305;201412;812;2494;666;2221;118;421;379;1286;497;1707
170307;201412;1141;3937;963;3601;206;843;504;1960;710;2803
170310;201412;1744;4806;1377;4218;325;972;709;2311;1034;3283
170320;201412;1111;3238;833;2729;211;735;389;1315;600;2050
170330;201412;868;2643;737;2480;124;461;512;1690;636;2151
170360;201412;472;1579;412;1473;109;419;175;599;284;1018
170370;201412;1471;4254;1173;3779;283;983;543;1759;826;2742
170380;201412;2110;6625;1702;6000;348;1406;921;3207;1269;4613
170382;201412;558;1863;480;1736;119;494;271;958;390;1452
170384;201412;1630;6655;1524;6463;392;1752;895;3859;1287;5611
170386;201412;953;2831;823;2647;212;759;432;1396;644;2155
170388;201412;661;1982;554;1796;115;452;236;740;351;1192
170389;201412;958;3166;868;3024;114;470;614;2107;728;2577
170390;201412;1385;4028;1182;3771;164;562;869;2835;1033;3397
170410;201412;512;1665;461;1567;61;257;305;1009;366;1266
170460;201412;535;1469;385;1208;106;364;130;401;236;765
170510;201412;823;2763;659;2470;108;472;348;1294;456;1766
170550;201412;6357;18876;4884;16189;1824;6645;1063;3483;2887;10128
170555;201412;1420;4121;1124;3661;266;924;604;1997;870;2921
170560;201412;1015;3411;807;3138;177;744;472;1897;649;2641
170600;201412;1400;3904;1210;3660;249;723;794;2510;1043;3233
170610;201412;1683;5080;1308;4480;165;640;820;2864;985;3504
170625;201412;437;1365;334;1151;69;255;102;350;171;605
170650;201412;1283;4105;1118;3814;280;1030;530;1848;810;2878
170700;201412;4187;13732;3499;12574;804;3165;1724;6451;2528;9616
170710;201412;1931;5666;1555;5012;268;922;950;3093;1218;4015
170720;201412;1904;5098;1610;4648;312;840;1109;3328;1421;4168
170730;201412;1135;3221;930;2920;259;904;447;1409;706;2313
170740;201412;2306;8134;2037;7650;307;1262;1403;5318;1710;6580
170755;201412;910;2827;758;2497;197;698;288;922;485;1620
170765;201412;1625;4359;1299;3835;347;1083;575;1738;922;2821
170770;201412;1881;6381;1734;6106;343;1267;1072;3843;1415;5110
170820;201412;4267;13566;3850;12907;1051;3716;1770;6078;2821;9794
170825;201412;847;2511;647;2124;146;531;273;878;419;1409
170830;201412;1432;4244;1275;4005;39;80;1156;3688;1195;3768
170900;201412;2974;10250;2812;9948;323;1137;2139;7801;2462;8938
170930;201412;4447;13386;3615;12088;1262;4487;1272;4223;2534;8710
170950;201412;13708;39494;10041;32992;3573;13166;2279;7237;5852;20403
170980;201412;515;1527;393;1321;98;382;182;581;280;963
171050;201412;1419;4918;1313;4712;81;350;1117;3997;1198;4347
171070;201412;1766;5444;1614;5221;348;1150;991;3305;1339;4455
171090;201412;1004;2847;846;2607;93;308;613;1886;706;2194
171110;201412;673;1953;517;1689;134;475;278;894;412;1369
171150;201412;893;2602;647;2143;130;474;367;1228;497;1702
171180;201412;677;2062;489;1669;129;468;206;743;335;1211
171190;201412;1929;6937;1662;6387;403;1632;791;3156;1194;4788
171195;201412;891;3123;781;2910;137;552;408;1574;545;2126
171200;201412;730;2327;594;2071;146;574;278;909;424;1483
171215;201412;499;1461;376;1230;79;286;163;545;242;831
171240;201412;802;2746;739;2629;91;360;529;1923;620;2283
171245;201412;680;2241;560;1953;136;542;221;722;357;1264
171250;201412;1177;3391;963;3040;95;337;710;2218;805;2555
171270;201412;449;1834;415;1769;125;518;191;884;316;1402
171280;201412;962;2938;829;2719;203;680;428;1519;631;2199
171320;201412;4319;12952;3615;11818;1050;3580;1810;5981;2860;9561
171330;201412;3009;8905;2527;8139;649;2240;1309;4220;1958;6460
171360;201412;1601;5060;1348;4680;241;855;856;3042;1097;3897
171370;201412;803;2249;704;2100;150;500;371;1096;521;1596
171380;201412;1356;4454;1156;4066;427;1536;428;1536;855;3072
171395;201412;902;2730;715;2382;146;589;356;1153;502;1742
171420;201412;2310;7007;1831;6150;452;1614;821;2789;1273;4403
171430;201412;1082;3340;910;3065;209;707;517;1765;726;2472
171488;201412;2622;7915;2353;7541;587;1905;1328;4436;1915;6341
171500;201412;923;2822;798;2592;128;413;481;1598;609;2011
171510;201412;1006;3463;899;3295;139;533;588;2227;727;2760
171515;201412;629;1768;473;1528;88;297;248;797;336;1094
171525;201412;621;2052;520;1865;107;440;289;1017;396;1457
171550;201412;347;1150;279;1012;100;393;46;178;146;571
171570;201412;1340;4107;1163;3798;188;633;816;2683;1004;3316
171575;201412;2127;5995;1617;5042;358;1131;758;2461;1116;3592
171610;201412;6609;22092;5853;20689;1931;7262;2037;7157;3968;14419
171620;201412;2588;7700;2278;7255;162;587;1890;6044;2052;6631
171630;201412;933;3010;761;2709;230;886;292;1025;522;1911
171650;201412;2567;7926;2039;6939;543;1996;850;2862;1393;4858
171660;201412;2531;7027;1960;5996;299;999;1173;3608;1472;4607
171665;201412;1467;4377;1217;3977;191;678;778;2644;969;3322
171670;201412;2403;6517;1904;5776;486;1603;939;2759;1425;4362
171700;201412;1208;3885;1043;3579;162;621;669;2293;831;2914
171720;201412;764;2300;653;2095;225;756;269;879;494;1635
171750;201412;1357;4356;1155;3934;389;1375;428;1460;817;2835
171780;201412;1314;3541;944;3023;123;446;553;1811;676;2257
171790;201412;1757;5614;1454;5178;258;910;912;3418;1170;4328
171800;201412;738;2330;658;2215;99;353;453;1559;552;1912
171820;201412;10676;31955;9385;30277;2006;6949;5683;18543;7689;25492
171830;201412;1640;5965;1487;5631;417;1664;681;2582;1098;4246
171840;201412;849;2409;747;2268;68;210;580;1786;648;1996
171845;201412;832;2242;647;1933;108;352;369;1092;477;1444
171850;201412;1030;3654;912;3405;128;562;570;2112;698;2674
171855;201412;1298;4099;1164;3871;109;456;881;2853;990;3309
171865;201412;499;1586;417;1464;109;431;206;707;315;1138
171870;201412;717;2210;584;1974;132;481;262;931;394;1412
171875;201412;1440;4486;1206;4132;175;686;849;2884;1024;3570
171880;201412;991;3545;965;3501;123;468;724;2705;847;3173
171884;201412;996;2791;711;2356;155;599;240;872;395;1471
171886;201412;1565;5181;1318;4641;447;1688;427;1512;874;3200
171888;201412;735;2252;598;1991;89;309;353;1218;442;1527
171889;201412;509;1658;482;1609;92;300;304;1048;396;1348
171890;201412;1220;3883;1062;3654;156;606;697;2399;853;3005
171900;201412;519;1942;460;1811;139;547;220;885;359;1432
172000;201412;670;2150;555;1958;95;377;313;1098;408;1475
172010;201412;1234;4264;1153;4130;124;503;886;3192;1010;3695
172015;201412;367;1389;307;1288;60;261;175;767;235;1028
172020;201412;2467;8040;2210;7654;310;1130;1553;5485;1863;6615
172025;201412;786;2240;605;1930;87;315;333;1053;420;1368
172030;201412;1147;3858;1029;3643;129;540;722;2547;851;3087
172049;201412;1323;3567;1034;3046;131;392;790;2374;921;2766
172065;201412;1394;3888;1148;3587;105;364;965;3028;1070;3392
172080;201412;2685;8212;2248;7462;272;1060;1547;5061;1819;6121
172085;201412;542;1469;406;1218;92;297;145;419;237;716
172090;201412;3585;10581;2745;9390;587;2106;1581;5586;2168;7692
172093;201412;595;1881;466;1649;124;552;238;799;362;1351
172097;201412;726;2099;584;1868;151;523;231;738;382;1261
172100;201412;30852;100085;25581;89700;8546;32928;7094;24627;15640;57555
172110;201412;1746;6398;1571;6131;191;798;1169;4677;1360;5475
172120;201412;5724;17133;4693;15780;537;1832;3488;12015;4025;13847
172125;201412;336;1015;266;904;60;219;116;401;176;620
172130;201412;552;1555;445;1377;55;189;298;955;353;1144
172208;201412;2171;6576;2008;6315;378;1307;1172;3708;1550;5015
172210;201412;2515;7839;2276;7456;490;1738;1351;4360;1841;6098
210005;201412;23510;74068;20242;68947;6139;22375;9245;31821;15384;54196
210010;201412;1661;5887;1461;5575;153;601;1121;4367;1274;4968
210015;201412;3549;10989;3226;10504;264;602;2712;9306;2976;9908
210020;201412;7741;18874;7208;18215;452;1232;6000;15339;6452;16571
210030;201412;5981;19829;5639;19351;483;2016;4616;15755;5099;17771
210040;201412;2072;5764;1859;5518;163;498;1500;4480;1663;4978
210043;201412;6578;19139;5774;18100;553;1671;4492;14617;5045;16288
210047;201412;7006;26811;6454;25864;900;3868;4549;18495;5449;22363
210050;201412;2566;9021;2035;8197;682;2843;825;3485;1507;6328
210055;201412;1762;6024;1623;5813;203;740;1212;4401;1415;5141
210060;201412;8016;29681;7197;28358;774;3375;5339;21527;6113;24902
210070;201412;7248;21429;6755;20824;295;951;5995;18648;6290;19599
210080;201412;3844;13187;3745;13059;76;295;3548;12418;3624;12713
210083;201412;4386;15050;4116;14756;118;346;3887;14140;4005;14486
210087;201412;2832;8565;2618;8304;171;559;2265;7276;2436;7835
210090;201412;10528;33977;10053;33217;451;1721;8821;29223;9272;30944
210095;201412;6458;23888;6246;23566;611;2325;5112;19690;5723;22015
210100;201412;7740;23036;7247;22451;339;1214;6444;19968;6783;21182
210110;201412;3297;11315;3185;11172;224;822;2701;9656;2925;10478
210120;201412;27264;76488;23097;71497;2871;8416;17369;55980;20240;64396
210125;201412;3670;11683;3506;11504;261;709;3085;10379;3346;11088
210130;201412;4434;13130;4199;12801;362;1150;3473;10622;3835;11772
210135;201412;1703;4986;1499;4690;131;400;1222;3898;1353;4298
210140;201412;18793;59003;15794;54980;3080;10864;10194;36871;13274;47735
210150;201412;4805;12073;4361;11523;118;307;4019;10621;4137;10928
210160;201412;19505;62281;18126;60248;2159;6615;14337;49324;16496;55939
210170;201412;14620;52550;14327;52163;1020;3390;12613;46903;13633;50293
210173;201412;1896;7949;1841;7842;117;566;1611;6902;1728;7468
210177;201412;3117;9833;2942;9619;272;987;2443;7949;2715;8936
210180;201412;1588;4829;1488;4684;94;326;1263;3984;1357;4310
210190;201412;5269;16875;4898;16233;388;1695;3718;12056;4106;13751
210193;201412;1477;4706;1344;4480;99;367;1099;3712;1198;4079
210197;201412;2054;6809;1894;6631;205;630;1546;5644;1751;6274
210200;201412;9535;31547;8745;30408;1152;3740;6534;23734;7686;27474
210203;201412;6741;21994;6317;21450;454;1334;5553;19244;6007;20578
210207;201412;3133;10343;2934;9981;400;1282;2139;7510;2539;8792
210210;201412;9075;30489;8689;29963;283;991;7732;27235;8015;28226
210215;201412;1666;6559;1609;6461;173;734;1302;5283;1475;6017
210220;201412;6472;24575;6174;24092;535;2141;5012;20017;5547;22158
210230;201412;5461;18276;5065;17647;407;1495;4160;14646;4567;16141
210232;201412;12303;41272;10642;39210;1767;6542;7413;28922;9180;35464
210235;201412;3731;11435;3335;10942;259;896;2821;9364;3080;10260
210237;201412;2530;9398;2491;9346;49;138;2384;9052;2433;9190
210240;201412;3112;9805;2948;9568;221;690;2457;8098;2678;8788
210250;201412;4976;16014;4735;15712;130;524;4439;14737;4569;15261
210255;201412;2862;9149;2603;8701;528;1853;1636;5544;2164;7397
210260;201412;5392;17126;4894;16369;677;2217;3626;12451;4303;14668
210270;201412;5476;15590;4865;14737;153;535;4334;13230;4487;13765
210275;201412;3702;9253;3465;8996;109;225;3290;8647;3399;8872
210280;201412;6245;18133;5321;16952;425;1431;4346;14003;4771;15434
210290;201412;5881;19022;5390;18407;449;1458;4504;15777;4953;17235
210300;201412;39199;113744;32249;104991;2889;9829;25466;85406;28355;95235
210310;201412;2926;8417;2750;8167;133;353;2423;7261;2556;7614
210312;201412;2239;7214;2174;7112;110;434;1953;6393;2063;6827
210315;201412;2502;8672;2378;8496;139;560;2058;7400;2197;7960
210317;201412;4403;13171;4206;12921;272;796;3727;11621;3999;12417
210320;201412;20018;63098;18666;61452;1095;3484;16372;54950;17467;58434
210325;201412;3771;11760;3352;11133;411;1455;2494;8348;2905;9803
210330;201412;37842;92006;29671;83343;3957;8693;21560;67821;25517;76514
210340;201412;12274;37548;11185;36186;1529;4081;8243;28694;9772;32775
210350;201412;10863;33563;9993;32325;856;2700;8077;26734;8933;29434
210355;201412;4072;14507;3682;13984;175;480;3324;13072;3499;13552
210360;201412;17641;53300;16297;51386;1416;4649;12994;41588;14410;46237
210370;201412;9456;23399;8163;22011;295;629;7403;20473;7698;21102
210375;201412;3343;10134;2844;9521;756;2593;1638;5654;2394;8247
210380;201412;6577;18620;5860;17615;547;1479;4802;14826;5349;16305
210390;201412;2860;10071;2614;9662;136;632;2261;8375;2397;9007
210400;201412;5199;16225;4991;15976;298;886;4434;14421;4732;15307
210405;201412;9218;25258;7407;22784;2253;6863;3384;11498;5637;18361
210407;201412;2161;7553;1894;7125;221;788;1446;5673;1667;6461
210408;201412;2340;9104;2200;8941;99;363;1961;8290;2060;8653
210409;201412;4020;14538;3801;14193;296;1167;3071;11739;3367;12906
210410;201412;3666;11802;3420;11499;302;842;2938;10212;3240;11054
210420;201412;4341;14229;4010;13662;331;1141;3279;11372;3610;12513
210430;201412;2243;6893;2171;6804;136;442;1892;5969;2028;6411
210440;201412;4393;13573;4261;13383;248;733;3801;12106;4049;12839
210450;201412;2989;9418;2691;8976;207;781;2197;7318;2404;8099
210455;201412;4408;12906;3785;11991;668;2151;2588;8393;3256;10544
210460;201412;4142;13222;3849;12817;226;833;3289;11061;3515;11894
210462;201412;1825;6482;1709;6259;170;677;1318;4902;1488;5579
210465;201412;2793;9048;2605;8808;289;810;2117;7472;2406;8282
210467;201412;6548;21369;6119;20844;481;1404;5153;18201;5634;19605
210470;201412;2083;5763;1622;5088;105;343;1289;4100;1394;4443
210480;201412;14514;47864;12735;45458;3521;12389;7130;27233;10651;39622
210490;201412;3655;10681;3336;10216;281;910;2713;8314;2994;9224
210500;201412;6918;27132;6616;26606;787;2994;5101;21349;5888;24343
210510;201412;7069;23365;6755;22983;431;1117;5803;20640;6234;21757
210515;201412;3510;11676;3381;11514;141;411;3130;10825;3271;11236
210520;201412;2920;8951;2661;8588;216;671;2200;7266;2416;7937
210530;201412;43250;138107;36142;127244;10447;39922;17596;63561;28043;103483
210535;201412;3347;11685;3214;11481;174;619;2801;10140;2975;10759
210540;201412;13841;46675;12278;44200;3003;10492;6790;26480;9793;36972
210542;201412;6526;18794;5702;17892;353;884;4998;16172;5351;17056
210545;201412;2329;7632;2206;7427;91;429;1911;6390;2002;6819
210547;201412;4008;13907;3713;13438;318;1077;2977;11065;3295;12142
210550;201412;6581;18436;5713;17476;300;672;5198;16365;5498;17037
210560;201412;4342;13626;3869;12849;278;1030;3210;10654;3488;11684
210565;201412;1580;5426;1357;5090;133;592;1019;3845;1152;4437
210570;201412;13137;37305;11872;35844;1034;2542;9892;31040;10926;33582
210580;201412;3266;9866;2886;9385;383;1020;2186;7731;2569;8751
210590;201412;4497;13815;4192;13455;275;870;3652;11918;3927;12788
210592;201412;2626;8266;2523;8100;116;428;2216;7108;2332;7536
210594;201412;2857;8087;2341;7356;154;429;1933;6252;2087;6681
210596;201412;2942;10793;2761;10456;303;1210;2091;8059;2394;9269
210598;201412;2002;6202;1866;6033;114;437;1647;5293;1761;5730
210600;201412;3472;10151;3101;9636;300;991;2429;7560;2729;8551
210610;201412;2795;8885;2500;8526;202;776;2111;7204;2313;7980
210620;201412;1945;6017;1787;5816;54;148;1634;5406;1688;5554
210630;201412;3615;12915;3144;12029;455;1782;2056;8107;2511;9889
210632;201412;4907;16749;4481;16147;437;1608;3626;13258;4063;14866
210635;201412;1969;6951;1879;6815;85;297;1676;6186;1761;6483
210637;201412;2893;9658;2706;9391;167;584;2311;8158;2478;8742
210640;201412;4366;15104;4289;15017;17;46;4186;14772;4203;14818
210650;201412;7134;21711;6982;21530;132;362;6726;20888;6858;21250
210660;201412;7975;24348;7414;23499;264;773;6852;21824;7116;22597
210663;201412;2705;7953;2551;7755;172;570;2178;6667;2350;7237
210667;201412;1787;6331;1703;6200;86;359;1489;5472;1575;5831
210670;201412;4880;17953;4708;17662;433;1657;3731;14400;4164;16057
210675;201412;5002;14124;4658;13689;375;1022;3932;11795;4307;12817
210680;201412;4665;12955;4123;12321;245;690;3558;10787;3803;11477
210690;201412;7338;24424;6914;23967;285;882;6288;22284;6573;23166
210700;201412;2761;7938;2438;7567;511;1315;1630;5739;2141;7054
210710;201412;4989;16254;4754;15874;198;761;4190;14038;4388;14799
210720;201412;2604;9427;2451;9200;151;664;2145;8010;2296;8674
210725;201412;1200;4384;1028;4063;172;731;595;2382;767;3113
210730;201412;1280;3918;1119;3729;108;307;930;3186;1038;3493
210735;201412;4034;14492;3727;13950;636;2431;2582;9984;3218;12415
210740;201412;5385;15194;5020;14826;238;636;4666;13964;4904;14600
210745;201412;3942;11840;3674;11470;296;776;3091;9823;3387;10599
210750;201412;21075;57942;18947;55496;2125;6103;15107;45253;17232;51356
210760;201412;6173;16954;5791;16539;81;241;5620;16085;5701;16326
210770;201412;6507;17493;5464;16305;220;697;4926;14772;5146;15469
210780;201412;8885;29381;8156;28061;996;3617;5829;20413;6825;24030
210790;201412;4833;14777;4157;14009;324;835;3510;12388;3834;13223
210800;201412;5252;14673;4734;14092;197;617;4073;12574;4270;13191
210805;201412;3822;16066;3697;15842;197;820;3191;14022;3388;14842
210810;201412;5975;17774;5388;17096;407;802;4695;15654;5102;16456
210820;201412;9285;26704;8601;25731;1602;4700;5813;17946;7415;22646
210825;201412;5713;19310;5471;18998;316;994;4823;17106;5139;18100
210830;201412;8885;26795;8450;26283;658;1761;7215;23151;7873;24912
210840;201412;3896;10727;3512;10146;268;697;2829;8236;3097;8933
210845;201412;6021;18625;5793;18372;255;650;5217;17018;5472;17668
210850;201412;6469;23216;5959;22330;852;3574;4247;16005;5099;19579
210860;201412;18015;54831;16543;52837;1593;5239;13137;42532;14730;47771
210870;201412;6853;22203;6108;21267;705;2347;4684;16828;5389;19175
210880;201412;4474;14377;4342;14183;232;731;3873;12813;4105;13544
210890;201412;5650;16704;5232;16195;479;1585;4266;13350;4745;14935
210900;201412;5252;16379;4577;15285;1566;5331;1876;6695;3442;12026
210905;201412;1882;5898;1735;5695;130;340;1463;4960;1593;5300
210910;201412;10795;33779;9995;32490;1865;6470;6625;21767;8490;28237
210920;201412;3371;11395;3248;11215;192;635;2795;9852;2987;10487
210923;201412;1605;5745;1498;5588;224;841;1059;4148;1283;4989
210927;201412;4819;15117;4644;14938;34;111;4563;14718;4597;14829
210930;201412;2710;9747;2583;9578;205;917;2148;7968;2353;8885
210940;201412;3002;11678;2937;11548;296;1115;2408;9639;2704;10754
210945;201412;6080;17974;5849;17737;241;292;5546;17323;5787;17615
210950;201412;5950;17901;5128;16673;603;2022;3795;12577;4398;14599
210955;201412;2021;6609;1781;6237;324;1136;1170;4274;1494;5410
210960;201412;9569;31358;9147;30742;2485;8130;5485;19572;7970;27702
210970;201412;1411;5066;1243;4808;175;804;896;3470;1071;4274
210975;201412;1817;6143;1729;5986;150;553;1381;4841;1531;5394
210980;201412;10167;24349;9873;24022;684;1376;8764;21792;9448;23168
210990;201412;17684;51440;14100;46991;3079;10574;8548;29486;11627;40060
211000;201412;17226;54121;15282;51757;1016;3399;13103;45462;14119;48861
211003;201412;5242;18267;4772;17557;511;1993;3593;13589;4104;15582
211010;201412;6869;23975;6636;23704;137;457;6202;22497;6339;22954
211020;201412;7592;23785;7350;23390;323;976;6667;21321;6990;22297
211023;201412;2530;8391;2440;8231;164;567;2048;7053;2212;7620
211027;201412;3149;12009;3027;11816;325;1140;2377;9723;2702;10863
211030;201412;4410;13300;3955;12785;744;1896;2938;10172;3682;12068
211040;201412;4460;16754;4322;16539;157;655;3817;14892;3974;15547
211050;201412;10789;28361;10587;28137;420;1015;9919;26545;10339;27560
211060;201412;6338;22336;6168;22072;568;1925;5161;18874;5729;20799
211065;201412;1834;6197;1670;5987;47;152;1577;5727;1624;5879
211070;201412;9017;30287;8360;29164;763;2651;6685;23820;7448;26471
211080;201412;1407;4264;1154;3909;105;505;910;2985;1015;3490
211085;201412;2132;7051;1829;6614;294;1028;1288;4832;1582;5860
211090;201412;3751;11337;3512;11010;195;736;3015;9374;3210;10110
211100;201412;7012;18255;6828;18038;94;334;6515;17166;6609;17500
211102;201412;3210;11773;3052;11555;285;1013;2573;9987;2858;11000
211105;201412;2922;9271;2549;8754;218;829;2073;7123;2291;7952
211107;201412;4645;14545;4218;13980;260;813;3606;12263;3866;13076
211110;201412;6818;20284;5379;18213;997;3233;3457;12359;4454;15592
211120;201412;34530;95511;30499;90512;4698;13132;22121;68317;26819;81449
211125;201412;2265;7250;2042;6903;149;538;1697;5784;1846;6322
211130;201412;154801;450440;144079;436667;28999;87432;96985;301493;125984;388925
211140;201412;5723;18130;5366;17569;299;1067;4596;15071;4895;16138
211150;201412;10406;30855;9673;29943;658;2133;8285;25876;8943;28009
211153;201412;3206;9532;2939;9224;428;1121;2318;7658;2746;8779
211157;201412;1286;4172;1096;3877;135;564;744;2737;879;3301
211160;201412;4368;14639;3714;13540;409;1805;2673;9658;3082;11463
211163;201412;1785;5892;1686;5751;75;254;1500;5227;1575;5481
211167;201412;1555;5198;1448;5028;44;168;1324;4620;1368;4788
211170;201412;6861;18088;6588;17757;170;525;6096;16410;6266;16935
211172;201412;2476;7223;2177;6781;158;608;1810;5534;1968;6142
211174;201412;2956;8606;2689;8271;122;456;2368;7252;2490;7708
211176;201412;5722;16633;4782;15530;596;1724;3614;12299;4210;14023
211178;201412;3622;10356;3539;10264;87;201;3387;9910;3474;10111
211180;201412;4637;16157;4327;15687;409;1590;3467;12794;3876;14384
211190;201412;2997;9886;2715;9491;118;505;2348;8286;2466;8791
211195;201412;1525;4727;1283;4428;103;314;1051;3773;1154;4087
211200;201412;2257;7754;2010;7410;275;930;1485;5788;1760;6718
211210;201412;7229;22006;6948;21620;421;1307;6032;18985;6453;20292
211220;201412;37440;110425;32643;104146;6913;22693;20757;68078;27670;90771
211223;201412;6170;17689;5667;16883;845;2572;3787;11855;4632;14427
211227;201412;1655;6061;1543;5893;137;618;1225;4704;1362;5322
211230;201412;9285;30810;8454;29400;1202;4250;6049;21501;7251;25751
211240;201412;8600;29009;8220;28550;328;1139;7534;26371;7862;27510
211245;201412;5663;16315;5594;16230;169;387;5285;15524;5454;15911
211250;201412;12637;43997;11957;43214;1345;3530;9839;37872;11184;41402
211260;201412;8623;26871;8404;26577;589;1834;7422;23660;8011;25494
211270;201412;10760;36884;9766;35636;699;2796;7970;29757;8669;32553
211280;201412;12809;37824;12106;36971;1045;2529;10385;32888;11430;35417
211285;201412;2011;7034;1723;6504;404;1632;849;3362;1253;4994
211290;201412;7842;25766;7592;25449;838;2456;6194;21438;7032;23894
211300;201412;9184;27756;8361;26570;518;1737;7188;22986;7706;24723
211400;201412;13045;37574;10753;34952;2508;7893;6176;22656;8684;30549
220005;201412;1795;5218;1658;5001;67;280;1415;4147;1482;4427
220010;201412;1796;4680;1337;4085;106;407;1043;3114;1149;3521
220020;201412;3827;11729;3600;11341;600;2022;2439;7655;3039;9677
220025;201412;2244;5535;2013;5190;49;146;1767;4512;1816;4658
220027;201412;1440;3898;1324;3749;90;226;1115;3207;1205;3433
220030;201412;3532;10100;3443;9958;252;835;2929;8434;3181;9269
220040;201412;8854;27200;8342;26361;1727;5681;5189;16445;6916;22126
220045;201412;1517;4796;1367;4542;131;505;998;3265;1129;3770
220050;201412;4907;14337;4282;13398;359;1313;3385;10491;3744;11804
220060;201412;2154;5590;2048;5464;90;231;1864;4991;1954;5222
220070;201412;2703;7820;2414;7395;202;654;1890;5820;2092;6474
220080;201412;837;2597;792;2524;106;420;575;1764;681;2184
220090;201412;1938;4975;1660;4599;132;447;1371;3712;1503;4159
220095;201412;734;1994;692;1933;31;98;644;1787;675;1885
220100;201412;1436;4306;1214;3935;125;429;903;2968;1028;3397
220105;201412;2185;7128;1969;6704;165;580;1475;5046;1640;5626
220110;201412;3697;10632;3265;9992;216;816;2715;8159;2931;8975
220115;201412;2400;8600;2306;8450;238;958;1901;6962;2139;7920
220117;201412;1460;3872;1188;3473;118;362;922;2698;1040;3060
220120;201412;13262;37771;12268;36520;398;1452;11242;33438;11640;34890
220130;201412;899;3171;796;3038;61;197;695;2715;756;2912
220140;201412;1714;4563;1543;4347;229;464;1242;3697;1471;4161
220150;201412;7416;23199;7040;22687;399;1463;6107;19693;6506;21156
220155;201412;1111;3453;915;3079;75;315;629;2061;704;2376
220157;201412;1124;2834;1011;2671;43;114;865;2276;908;2390
220160;201412;2937;8760;2625;8222;195;736;2033;6309;2228;7045
220170;201412;1415;4417;1253;4147;103;417;1002;3292;1105;3709
220173;201412;2150;6475;1765;5742;77;356;1432;4593;1509;4949
220177;201412;1774;5228;1743;5180;68;209;1626;4838;1694;5047
220180;201412;1200;3229;1058;3007;53;189;804;2228;857;2417
220190;201412;4692;15236;4113;14501;489;1666;3239;11647;3728;13313
220191;201412;1508;5077;1437;4949;207;709;1058;3681;1265;4390
220192;201412;1805;5151;1427;4481;154;523;999;3118;1153;3641
220194;201412;1773;5227;1608;4952;157;550;1212;3646;1369;4196
220196;201412;2124;6314;1978;6065;223;751;1491;4584;1714;5335
220198;201412;1361;3815;1076;3443;19;67;1001;3233;1020;3300
220200;201412;4759;16156;4448;15689;746;2732;3131;11158;3877;13890
220202;201412;2147;6699;1939;6323;65;260;1705;5526;1770;5786
220205;201412;3036;7921;2676;7446;98;364;2349;6451;2447;6815
220207;201412;930;2872;811;2661;91;341;605;1975;696;2316
220208;201412;1821;6061;1642;5751;238;949;1153;4015;1391;4964
220209;201412;1643;5027;1477;4750;85;336;1146;3682;1231;4018
220210;201412;1973;5149;1699;4772;90;307;1355;3808;1445;4115
220211;201412;1717;4997;1627;4879;111;467;1363;4013;1474;4480
220213;201412;1894;5452;1747;5180;102;368;1389;4052;1491;4420
220217;201412;1917;6230;1837;6130;64;169;1696;5749;1760;5918
220220;201412;12128;34382;11063;32733;1361;3736;7899;24068;9260;27804
220225;201412;1062;3200;946;3039;46;195;813;2569;859;2764
220230;201412;6268;16356;5182;14900;222;618;4589;13283;4811;13901
220240;201412;2857;9034;2661;8687;215;779;2075;6752;2290;7531
220245;201412;1550;4157;1392;3935;73;216;1192;3420;1265;3636
220250;201412;3436;9395;3080;8914;72;190;2821;8269;2893;8459
220253;201412;1898;5585;1611;5085;142;511;1176;3762;1318;4273
220255;201412;1830;5158;1595;4767;90;355;1309;3801;1399;4156
220260;201412;4759;15309;4204;14253;339;1212;3274;11130;3613;12342
220265;201412;1326;4683;1226;4522;111;482;887;3286;998;3768
220270;201412;7115;22996;6885;22599;426;1902;5877;18842;6303;20744
220271;201412;1572;4430;1467;4277;71;190;1279;3788;1350;3978
220272;201412;1845;5634;1693;5384;104;421;1338;4216;1442;4637
220273;201412;1323;3791;1149;3513;120;397;873;2644;993;3041
220275;201412;2198;5775;1837;5310;85;270;1608;4642;1693;4912
220277;201412;2676;7226;2261;6603;153;494;1779;5226;1932;5720
220280;201412;1804;4729;1554;4349;137;498;1169;3173;1306;3671
220285;201412;1769;4694;1549;4383;101;322;1269;3664;1370;3986
220290;201412;6845;22089;5725;20623;618;2448;4326;15732;4944;18180
220300;201412;2011;6516;1761;6177;89;392;1489;5214;1578;5606
220310;201412;2686;8695;2243;8164;89;271;2029;7628;2118;7899
220320;201412;3509;10260;2903;9226;356;1237;2091;6636;2447;7873
220323;201412;1519;5443;1337;5182;143;630;1014;3962;1157;4592
220325;201412;1301;4125;1175;3871;160;570;785;2662;945;3232
220327;201412;1400;4485;1267;4256;64;314;1018;3372;1082;3686
220330;201412;3943;10939;3688;10606;248;734;3136;9131;3384;9865
220335;201412;2181;6277;1956;6006;101;347;1684;5223;1785;5570
220340;201412;1927;5385;1660;4999;140;469;1278;3810;1418;4279
220342;201412;1247;4051;1182;3946;121;461;868;3045;989;3506
220345;201412;3128;8160;2648;7403;76;217;2338;6524;2414;6741
220350;201412;4586;12165;4023;11403;340;1075;3148;8917;3488;9992
220360;201412;1525;4120;1206;3625;119;413;881;2620;1000;3033
220370;201412;9472;27195;8590;26034;447;1340;7675;23346;8122;24686
220375;201412;1624;5080;1500;4916;70;253;1356;4451;1426;4704
220380;201412;1496;3994;1269;3680;83;280;1010;2906;1093;3186
220385;201412;810;2150;663;1902;31;111;552;1546;583;1657
220390;201412;10402;32428;9391;30465;2623;8893;3776;12329;6399;21222
220400;201412;1545;3637;1294;3261;44;151;1114;2717;1158;2868
220410;201412;1408;4005;1184;3687;108;435;924;2798;1032;3233
220415;201412;913;2465;821;2344;81;227;617;1769;698;1996
220420;201412;2355;6810;2074;6244;140;424;1687;5099;1827;5523
220430;201412;3042;8706;2887;8495;351;1064;2267;6667;2618;7731
220435;201412;1714;5014;1577;4798;81;251;1317;4021;1398;4272
220440;201412;2863;8626;2373;8053;136;443;2091;7125;2227;7568
220450;201412;2781;8156;2375;7588;546;1860;1429;4549;1975;6409
220455;201412;1420;4380;1270;4176;50;157;1151;3836;1201;3993
220460;201412;1122;2985;1019;2855;68;209;885;2455;953;2664
220465;201412;2565;8454;2337;8118;582;2141;1393;4897;1975;7038
220470;201412;4211;12550;3783;11823;269;954;2900;8950;3169;9904
220480;201412;2544;7396;2286;7023;193;600;1832;5650;2025;6250
220490;201412;2547;7254;2361;7019;137;493;2014;5958;2151;6451
220500;201412;3507;9354;2913;8323;156;623;2373;6605;2529;7228
220510;201412;3002;8370;2211;7118;109;469;1690;5379;1799;5848
220515;201412;2045;5080;1799;4771;94;252;1512;4032;1606;4284
220520;201412;5356;14815;4945;14229;207;574;4382;12728;4589;13302
220525;201412;1497;4215;1386;4053;103;371;1125;3225;1228;3596
220527;201412;1523;4699;1367;4364;157;510;1013;3294;1170;3804
220530;201412;1269;3708;1147;3519;88;341;962;2872;1050;3213
220535;201412;874;2696;844;2654;84;284;670;2103;754;2387
220540;201412;3772;12355;3622;12120;277;1052;3005;10047;3282;11099
220545;201412;1472;5017;1406;4901;184;741;1021;3511;1205;4252
220550;201412;9714;31502;9115;30492;1352;4767;6436;21626;7788;26393
220551;201412;1494;4994;1380;4798;113;492;1087;3732;1200;4224
220552;201412;1728;5369;1474;4923;121;544;1095;3539;1216;4083
220553;201412;1687;4964;1387;4501;71;270;1134;3688;1205;3958
220554;201412;938;2598;810;2423;95;292;609;1848;704;2140
220555;201412;2541;7362;2373;7151;91;298;2054;6278;2145;6576
220556;201412;1563;4863;1406;4561;103;405;1063;3424;1166;3829
220557;201412;1691;5537;1527;5218;212;790;997;3418;1209;4208
220558;201412;1095;3419;1000;3251;93;378;760;2423;853;2801
220559;201412;1622;4543;1470;4302;76;261;1246;3630;1322;3891
220560;201412;1807;4460;1487;4032;88;246;1247;3369;1335;3615
220570;201412;7849;24835;7297;23992;1294;4239;4994;16817;6288;21056
220580;201412;6800;21963;6630;21760;387;1202;5990;19907;6377;21109
220585;201412;2025;7343;1934;7178;139;553;1613;6016;1752;6569
220590;201412;1510;4602;1356;4376;253;840;890;2938;1143;3778
220595;201412;2580;7403;2366;7116;87;308;2114;6367;2201;6675
220600;201412;1389;3413;1154;3123;196;418;809;2311;1005;2729
220605;201412;2135;6229;1866;5810;108;348;1493;4664;1601;5012
220610;201412;2836;8725;2742;8591;163;631;2343;7284;2506;7915
220620;201412;8160;27467;7849;27007;420;1671;6873;23700;7293;25371
220630;201412;432;1321;368;1201;61;226;211;683;272;909
220635;201412;1916;6755;1760;6416;171;759;1148;4189;1319;4948
220640;201412;2957;8556;2757;8262;239;809;2215;6621;2454;7430
220650;201412;2545;7152;2260;6697;153;512;1819;5358;1972;5870
220660;201412;2891;8795;2344;8084;247;1058;1891;6369;2138;7427
220665;201412;1267;4280;1197;4171;46;193;1085;3768;1131;3961
220667;201412;1846;6170;1743;6033;84;319;1498;5202;1582;5521
220669;201412;1970;6364;1829;6097;288;1121;1234;4069;1522;5190
220670;201412;2241;6729;2068;6511;162;405;1781;5803;1943;6208
220672;201412;2503;7127;2380;6974;247;694;1986;5913;2233;6607
220675;201412;1405;4097;1309;3934;127;357;989;3008;1116;3365
220680;201412;2320;7495;2207;7340;205;683;1800;6081;2005;6764
220690;201412;1824;5103;1608;4759;124;419;1271;3747;1395;4166
220695;201412;957;2780;887;2663;63;230;689;2033;752;2263
220700;201412;9441;27057;8482;25610;799;2662;6493;19567;7292;22229
220710;201412;800;2402;677;2187;60;185;495;1615;555;1800
220720;201412;2218;5912;2096;5746;96;222;1856;5158;1952;5380
220730;201412;1427;3972;1218;3650;46;178;1022;3037;1068;3215
220735;201412;1126;2868;913;2505;60;200;703;1922;763;2122
220740;201412;1461;4624;1222;4305;158;548;945;3424;1103;3972
220750;201412;4155;12037;3886;11628;477;1250;3008;9327;3485;10577
220755;201412;1248;3583;1157;3431;76;231;954;2830;1030;3061
220760;201412;2804;9637;2587;9335;135;569;2240;8140;2375;8709
220770;201412;25063;83535;22587;78579;7638;27645;8674;31239;16312;58884
220775;201412;1300;3249;1259;3203;20;34;1224;3135;1244;3169
220777;201412;1674;4689;1522;4461;104;293;1244;3629;1348;3922
220779;201412;1297;3674;1257;3617;58;202;1132;3222;1190;3424
220780;201412;6547;17007;5843;16030;456;1215;4794;13298;5250;14513
220785;201412;1370;3666;1324;3574;66;166;1210;3272;1276;3438
220790;201412;10069;31846;9518;30913;993;3455;7456;24123;8449;27578
220793;201412;952;2697;873;2569;61;204;718;2107;779;2311
220795;201412;1582;4385;1525;4301;108;329;1313;3709;1421;4038
220800;201412;18344;50985;16758;48682;1841;6146;12540;35919;14381;42065
220810;201412;3476;10129;3003;9291;196;760;2408;7354;2604;8114
220820;201412;5850;15995;5327;15302;314;974;4610;13287;4924;14261
220830;201412;7899;22429;7463;21723;836;2451;5774;16983;6610;19434
220840;201412;15566;49433;14004;46272;3662;12340;6639;22511;10301;34851
220850;201412;2959;10369;2821;10173;217;839;2414;8766;2631;9605
220855;201412;643;1986;564;1839;48;183;415;1335;463;1518
220860;201412;982;2683;890;2537;54;207;720;2007;774;2214
220865;201412;2746;7575;2219;6705;114;535;1793;5248;1907;5783
220870;201412;2523;8234;2207;7839;111;419;1965;7004;2076;7423
220880;201412;5630;14633;5128;14019;258;792;4535;12414;4793;13206
220885;201412;1386;4869;1216;4570;127;582;898;3373;1025;3955
220887;201412;1447;3679;1256;3416;42;145;1146;3106;1188;3251
220890;201412;1720;5937;1520;5599;140;492;1211;4615;1351;5107
220900;201412;2036;5860;1798;5377;119;350;1454;4381;1573;4731
220910;201412;1778;5235;1555;4903;81;262;1339;4274;1420;4536
220915;201412;1084;3117;941;2855;54;227;731;2156;785;2383
220920;201412;1410;5135;1302;4971;142;631;955;3627;1097;4258
220930;201412;1554;4961;1379;4731;93;375;1135;3916;1228;4291
220935;201412;1099;3346;975;3093;72;306;698;2115;770;2421
220937;201412;1637;4461;1369;3986;82;297;1072;3033;1154;3330
220940;201412;1497;4602;1381;4354;107;404;1054;3305;1161;3709
220945;201412;509;1798;465;1682;60;246;322;1163;382;1409
220950;201412;1312;3324;944;2698;41;160;725;2008;766;2168
220955;201412;1652;4554;1386;4128;106;333;1070;3184;1176;3517
220960;201412;927;2504;770;2232;43;163;604;1723;647;1886
220965;201412;1771;5259;1669;5113;78;325;1429;4324;1507;4649
220970;201412;2208;5898;1626;4931;165;512;1136;3468;1301;3980
220975;201412;673;2310;661;2292;48;179;593;2054;641;2233
220980;201412;1530;4547;1360;4241;152;529;902;2905;1054;3434
220985;201412;1379;3977;1306;3867;134;447;1003;2950;1137;3397
220987;201412;1555;4953;1427;4730;112;489;1087;3506;1199;3995
220990;201412;1894;5458;1645;5034;73;301;1280;3845;1353;4146
220995;201412;1325;3897;1015;3400;85;346;764;2586;849;2932
220997;201412;2225;7028;2122;6865;101;354;1939;6275;2040;6629
221000;201412;4602;14131;4252;13539;492;1789;3125;9844;3617;11633
221005;201412;1483;4689;1378;4485;470;1421;671;2323;1141;3744
221010;201412;1278;3430;1101;3196;72;207;921;2688;993;2895
221020;201412;1964;6056;1827;5807;127;541;1370;4287;1497;4828
221030;201412;1848;5145;1589;4762;116;472;1241;3661;1357;4133
221035;201412;1624;4360;1458;4159;90;227;1286;3732;1376;3959
221037;201412;648;1968;582;1850;32;144;457;1395;489;1539
221038;201412;657;1845;518;1609;41;131;345;1087;386;1218
221039;201412;991;2853;912;2735;63;223;781;2308;844;2531
221040;201412;5321;16209;4993;15680;381;1308;3943;12507;4324;13815
221050;201412;3892;11877;3574;11422;217;848;3034;9637;3251;10485
221060;201412;9444;25868;7974;23812;917;2815;5953;17918;6870;20733
221062;201412;1307;4617;1199;4423;33;124;1111;4113;1144;4237
221063;201412;1169;3791;1086;3634;310;1005;623;2228;933;3233
221065;201412;2907;8199;2663;7816;272;814;2111;6175;2383;6989
221070;201412;4433;13581;3992;12885;273;1008;3180;10281;3453;11289
221080;201412;3680;9774;3241;9175;199;616;2701;7667;2900;8283
221090;201412;1419;3915;1221;3587;45;186;1015;2917;1060;3103
221093;201412;1855;5526;1758;5335;403;1303;946;2805;1349;4108
221095;201412;1041;2756;892;2543;29;79;788;2257;817;2336
221097;201412;839;2388;731;2202;66;260;545;1612;611;1872
221100;201412;132039;397877;122997;382655;25818;87236;78052;238447;103870;325683
221110;201412;10664;34622;10119;33947;666;2524;8619;28923;9285;31447
221120;201412;4688;15312;4491;14961;1003;3393;2960;10062;3963;13455
221130;201412;4856;14240;4195;12897;1317;4167;1897;5801;3214;9968
221135;201412;1553;4852;1442;4688;155;591;1147;3681;1302;4272
221140;201412;1464;3657;1341;3493;102;268;1138;2970;1240;3238
221150;201412;1275;3282;1051;2896;37;160;840;2274;877;2434
221160;201412;926;2417;861;2315;59;177;663;1796;722;1973
221170;201412;1179;3712;1095;3559;79;305;886;2844;965;3149
230010;201412;3506;9485;2864;8383;177;600;2302;6732;2479;7332
230015;201412;2803;9822;2609;9382;402;1711;1700;5971;2102;7682
230020;201412;14891;48800;14329;47780;851;3094;12019;40363;12870;43457
230030;201412;13177;38158;12107;36497;858;2898;9845;29646;10703;32544
230040;201412;4718;13152;3978;11886;306;1081;3081;9103;3387;10184
230050;201412;2585;8926;1998;7334;414;1622;879;3213;1293;4835
230060;201412;2194;6443;1909;5926;125;459;1471;4519;1596;4978
230070;201412;4451;12250;3827;11288;378;1209;2790;8329;3168;9538
230075;201412;9202;33047;8584;31757;770;3682;6714;24403;7484;28085
230080;201412;2472;6695;2060;6095;128;426;1669;4926;1797;5352
230090;201412;3711;11123;3287;10370;370;1290;2419;7623;2789;8913
230100;201412;18373;55842;16783;52804;3908;12983;9169;29083;13077;42066
230110;201412;14466;46982;13426;44781;2677;9572;7805;25916;10482;35488
230120;201412;8388;23093;7338;21616;881;2557;5276;16133;6157;18690
230125;201412;2924;8616;2424;7652;196;721;1796;5633;1992;6354
230130;201412;5849;19270;4910;17218;504;2110;3416;11753;3920;13863
230140;201412;3708;11858;3141;10819;460;1667;2065;7281;2525;8948
230150;201412;1814;5734;1576;5242;282;1074;974;3133;1256;4207
230160;201412;6725;19915;5833;18604;463;1724;4512;14345;4975;16069
230170;201412;6821;21444;5830;19584;532;2074;4248;14148;4780;16222
230180;201412;2000;5751;1743;5277;145;538;1222;3622;1367;4160
230185;201412;4372;14376;3977;13650;702;2421;2493;8901;3195;11322
230190;201412;13334;42949;11950;40192;2639;9910;6093;20147;8732;30057
230195;201412;5193;16002;4598;15012;306;1312;3659;11605;3965;12917
230200;201412;5912;17156;5298;15969;622;2034;3788;11347;4410;13381
230205;201412;4506;14171;4005;13324;327;1376;2912;9651;3239;11027
230210;201412;9699;27838;8458;25880;2041;6330;4739;14957;6780;21287
230220;201412;14331;41424;12956;39045;1652;5615;9087;27023;10739;32638
230230;201412;7835;25507;7009;23835;1044;3741;4476;15365;5520;19106
230240;201412;14044;40292;12463;37503;803;3024;9773;28824;10576;31848
230250;201412;10461;32341;10241;32014;504;1881;8706;27095;9210;28976
230260;201412;15492;51863;14334;49514;2934;10646;8183;28929;11117;39575
230270;201412;7137;21617;6220;20002;787;2764;4326;13976;5113;16740
230280;201412;19755;59525;17573;55739;2238;7169;12604;40358;14842;47527
230290;201412;4832;14966;4178;13625;574;1913;2855;9355;3429;11268
230300;201412;5023;15257;4773;14889;511;1848;3640;11217;4151;13065
230310;201412;5077;15148;4417;14028;364;1460;3259;10131;3623;11591
230320;201412;7699;24494;7107;23457;751;2823;5303;17514;6054;20337
230330;201412;4851;14435;4209;13172;343;1265;3043;9405;3386;10670
230340;201412;3609;12401;3352;11846;515;2038;2126;7367;2641;9405
230350;201412;18908;58010;17066;54822;2710;9371;10828;35366;13538;44737
230360;201412;3218;9397;2678;8371;328;1166;1830;5654;2158;6820
230365;201412;3192;8815;2766;8114;160;572;2204;6411;2364;6983
230370;201412;59207;192772;53941;183443;15830;55783;25545;89903;41375;145686
230380;201412;7338;21315;6229;19384;545;1904;4433;13832;4978;15736
230390;201412;3762;11779;3324;11057;368;1509;2336;7647;2704;9156
230393;201412;3458;11408;2941;10318;301;1409;2054;6928;2355;8337
230395;201412;5411;16596;4936;15729;813;2739;3090;9939;3903;12678
230400;201412;5436;16741;4679;15558;347;1516;3642;11852;3989;13368
230410;201412;14955;47715;13210;44157;2082;7516;8164;27225;10246;34741
230420;201412;25902;84151;23527;79232;5780;21059;11499;38500;17279;59559
230423;201412;5002;16112;4611;15347;528;1947;3205;10814;3733;12761
230425;201412;5691;19023;5184;17871;747;2755;3471;11959;4218;14714
230426;201412;2927;8165;2356;7098;154;634;1738;5089;1892;5723
230427;201412;1811;5504;1368;4550;152;579;914;2937;1066;3516
230428;201412;9608;31014;9221;30335;1760;6415;5811;18953;7571;25368
230430;201412;4773;15239;4426;14546;435;1736;3196;10292;3631;12028
230435;201412;5256;17017;4693;16025;983;3741;2486;8505;3469;12246
230440;201412;378822;1160425;350949;1109808;90771;305502;170118;541344;260889;846846
230445;201412;4908;13208;4127;12060;357;1030;3070;9124;3427;10154
230450;201412;3869;12272;3288;11224;456;1822;2142;7264;2598;9086
230460;201412;1983;6575;1782;6208;202;823;1261;4366;1463;5189
230465;201412;4362;12967;3564;11513;308;1297;2436;7681;2744;8978
230470;201412;11616;42337;11051;41159;1509;5867;7817;29644;9326;35511
230480;201412;1518;4895;1299;4472;193;714;845;2926;1038;3640
230490;201412;2888;8521;2488;7763;464;1609;1296;3963;1760;5572
230495;201412;5924;19858;5342;18857;886;3745;3124;10982;4010;14727
230500;201412;10872;37100;10353;36175;980;3808;7750;27608;8730;31416
230510;201412;1541;5531;1232;4725;327;1346;449;1795;776;3141
230520;201412;5171;15730;4520;14565;495;1846;3062;9806;3557;11652
230523;201412;14863;48843;13003;44468;3452;13011;3734;12957;7186;25968
230526;201412;4346;13265;3826;12361;379;1456;2786;8973;3165;10429
230530;201412;5606;18458;5090;17758;1046;3724;3393;12065;4439;15789
230533;201412;4117;11727;3673;10893;279;919;2849;8380;3128;9299
230535;201412;5598;16649;4827;15226;646;2046;3233;10484;3879;12530
230540;201412;19758;56468;17440;52973;1023;3795;14441;43504;15464;47299
230550;201412;19402;58947;17465;55125;3653;12484;9584;29986;13237;42470
230560;201412;6758;19605;6028;18295;277;1114;4869;14606;5146;15720
230565;201412;3331;9443;2663;8132;185;698;1956;5862;2141;6560
230570;201412;4123;11187;3636;10570;243;850;2997;8643;3240;9493
230580;201412;10861;33049;10192;32102;621;1981;8809;28062;9430;30043
230590;201412;9003;28451;7872;26275;634;2699;5877;19124;6511;21823
230600;201412;3624;10292;2731;8434;197;692;1840;5615;2037;6307
230610;201412;6412;20793;5965;20067;825;2941;4240;14452;5065;17393
230620;201412;2173;6186;1737;5249;168;591;1090;3178;1258;3769
230625;201412;8071;26528;7180;24471;2181;7950;2251;7710;4432;15660
230630;201412;11676;37561;10613;35538;2821;9025;5090;18290;7911;27315
230640;201412;28044;92175;26091;89230;3500;12811;19180;66111;22680;78922
230650;201412;5136;15828;4593;14765;359;1485;3511;11014;3870;12499
230655;201412;8990;34065;8628;33433;713;2863;7213;28365;7926;31228
230660;201412;6643;20575;5782;19003;537;2108;4141;13602;4678;15710
230670;201412;6153;16639;4929;14510;260;992;3850;10989;4110;11981
230680;201412;2890;8456;2401;7523;363;1220;1474;4610;1837;5830
230690;201412;6285;20740;6172;20514;515;2140;4437;14457;4952;16597
230700;201412;9606;27747;8478;25716;833;3103;5967;17564;6800;20667
230710;201412;7789;25320;6831;23533;874;3066;4843;17007;5717;20073
230720;201412;2013;6323;1732;5784;233;820;1151;3909;1384;4729
230725;201412;3734;12647;3237;11418;749;2757;1497;5269;2246;8026
230730;201412;59910;182755;49753;165711;13949;50749;18816;64040;32765;114789
230740;201412;5796;17905;5326;17091;294;1283;4431;13981;4725;15264
230750;201412;9429;26882;7949;24527;667;2386;6066;18631;6733;21017
230760;201412;10142;30658;9496;29274;1027;3847;6897;20460;7924;24307
230763;201412;4403;13727;4016;12975;273;1267;3104;9682;3377;10949
230765;201412;43149;140617;39413;132825;12260;44202;13911;47488;26171;91690
230770;201412;24560;68945;22651;66226;2428;7806;16644;48675;19072;56481
230780;201412;6262;24279;5933;23517;1540;6202;2935;12300;4475;18502
230790;201412;2694;9032;2538;8767;302;1119;1933;6740;2235;7859
230800;201412;8210;29227;7465;27544;1783;7033;3522;12998;5305;20031
230810;201412;12972;42110;12280;40929;1284;4448;9556;32317;10840;36765
230820;201412;3577;12114;3124;11118;546;2194;1785;6346;2331;8540
230830;201412;8087;24511;7203;22900;784;2851;5042;15980;5826;18831
230835;201412;4307;11595;3600;10589;314;1037;2794;8164;3108;9201
230837;201412;3229;10956;2781;10034;339;1417;1895;6789;2234;8206
230840;201412;9742;31969;8894;30458;1043;3878;6463;22424;7506;26302
230850;201412;11029;33756;10159;32543;1184;4219;7613;24303;8797;28522
230860;201412;5304;15639;4797;14770;355;1305;3733;11428;4088;12733
230870;201412;19819;53894;17559;50289;1487;4825;13405;38165;14892;42990
230880;201412;1987;6870;1845;6576;246;1023;1217;4312;1463;5335
230890;201412;4030;14717;3693;13963;543;2446;2397;8839;2940;11285
230900;201412;3044;10201;2588;9231;558;1973;1351;4926;1909;6899
230910;201412;3151;9285;2527;8106;206;858;1840;5762;2046;6620
230920;201412;4946;14384;4546;13883;285;952;3873;11979;4158;12931
230930;201412;8051;24472;7169;22811;881;2968;4942;15800;5823;18768
230940;201412;7847;22585;6877;21122;444;1427;5559;17180;6003;18607
230945;201412;6204;18579;5306;17245;541;2020;3775;12447;4316;14467
230950;201412;7264;19818;6246;18462;422;1332;4954;14764;5376;16096
230960;201412;13869;43535;12605;41092;2732;9648;6274;20604;9006;30252
230970;201412;14115;44549;12599;41584;2789;10330;5912;19186;8701;29516
230980;201412;3057;9819;2660;9037;826;2842;1230;4351;2056;7193
230990;201412;1662;5128;1374;4531;153;633;915;2937;1068;3570
231000;201412;2935;7948;2309;6747;256;861;1481;4198;1737;5059
231010;201412;3319;9109;2810;8300;293;1037;2073;6030;2366;7067
231020;201412;8310;27788;7820;26779;1418;5029;4865;17004;6283;22033
231025;201412;8282;25736;7443;24246;1130;3858;4870;16195;6000;20053
231030;201412;8308;27104;6953;24253;1269;4805;4024;14105;5293;18910
231040;201412;3130;10210;2769;9453;245;1034;1997;6683;2242;7717
231050;201412;12809;36701;10938;33292;1048;3587;8019;24300;9067;27887
231060;201412;2507;8000;2286;7600;199;892;1646;5309;1845;6201
231070;201412;9472;29936;8644;28282;1556;5388;5187;17090;6743;22478
231080;201412;4433;13821;4025;13110;248;1122;3042;9589;3290;10711
231085;201412;5001;15940;4812;15651;725;2306;3509;11767;4234;14073
231090;201412;4189;11836;3398;10249;190;716;2472;7328;2662;8044
231095;201412;2318;7571;1995;6895;230;892;1342;4676;1572;5568
231100;201412;3154;9835;2641;8809;236;920;1910;6285;2146;7205
231110;201412;3857;12869;3767;12715;401;1517;2764;9353;3165;10870
231120;201412;2435;7941;2259;7626;393;1385;1451;4967;1844;6352
231123;201412;2262;6142;1903;5563;165;467;1500;4417;1665;4884
231126;201412;6920;19145;5591;17173;421;1587;4200;12735;4621;14322
231130;201412;20888;64920;19017;61666;4370;14588;10731;36211;15101;50799
231135;201412;4786;14004;3999;12752;408;1532;2920;9169;3328;10701
231140;201412;16683;53418;14847;49804;1479;6645;10090;32598;11569;39243
231150;201412;6135;17717;5203;15959;944;3163;2821;8483;3765;11646
231160;201412;6161;20820;5803;20126;1093;4025;3738;13006;4831;17031
231170;201412;4933;15703;4460;14717;520;2046;3021;9809;3541;11855
231180;201412;14503;43678;13016;40716;2249;7674;8011;24655;10260;32329
231190;201412;5172;14382;4305;13119;343;1232;3304;9937;3647;11169
231195;201412;4794;16175;4122;14831;435;1903;2942;10529;3377;12432
231200;201412;7979;27365;6951;25240;620;2928;5002;17776;5622;20704
231210;201412;5361;16447;4611;15380;319;1345;3585;12051;3904;13396
231220;201412;14560;41064;12353;37240;1222;4343;8277;24873;9499;29216
231230;201412;8831;30650;8181;29585;851;3653;6351;22857;7202;26510
231240;201412;12640;40005;11249;37341;2240;7983;6110;20586;8350;28569
231250;201412;1968;5794;1329;4200;399;1239;354;1120;753;2359
231260;201412;4102;11738;3679;11120;556;1685;2413;7503;2969;9188
231270;201412;8002;22219;7018;20636;636;2485;5155;14722;5791;17207
231280;201412;1786;5870;1655;5609;155;551;1231;4210;1386;4761
231290;201412;33434;116304;30167;108523;6852;27510;13349;46881;20201;74391
231300;201412;4791;13963;3873;12115;331;1271;2742;8320;3073;9591
231310;201412;7878;22526;6590;19883;1199;3793;3661;10893;4860;14686
231320;201412;7031;21758;6022;19774;366;1500;4446;14543;4812;16043
231325;201412;2664;8089;2362;7569;183;691;1766;5675;1949;6366
231330;201412;14531;45004;12172;40460;2029;6853;7496;25243;9525;32096
231335;201412;5367;15500;4630;14146;308;1217;3677;10990;3985;12207
231340;201412;18612;61019;17361;59208;1410;4661;14065;49288;15475;53949
231350;201412;13554;44171;13213;43661;1434;4515;10765;36280;12199;40795
231355;201412;4431;14429;4198;14024;277;1045;3408;11457;3685;12502
231360;201412;7624;25061;6916;23789;1555;5291;4176;14912;5731;20203
231370;201412;2496;6963;1957;6102;99;363;1506;4651;1605;5014
231375;201412;4210;14425;3942;13893;301;1356;3175;11027;3476;12383
231380;201412;5529;17861;5197;17387;804;2810;3551;12207;4355;15017
231390;201412;3552;11217;3313;10828;271;1118;2490;8035;2761;9153
231395;201412;4236;13702;3781;12933;726;2583;2284;7941;3010;10524
231400;201412;10741;32033;9738;30177;1001;3545;6783;21069;7784;24614
231410;201412;13179;45756;12155;43988;1035;4000;9610;34933;10645;38933
240010;201412;2609;8044;2243;7276;532;1927;1007;3124;1539;5051
240020;201412;12148;38191;10774;35544;2741;9605;5116;17186;7857;26791
240030;201412;2696;7867;2609;7726;216;759;2096;6114;2312;6873
240040;201412;859;2550;723;2280;50;227;524;1576;574;1803
240050;201412;3834;10395;3280;9451;218;753;2520;7166;2738;7919
240060;201412;1515;4487;1404;4287;124;444;1077;3199;1201;3643
240070;201412;2983;8651;2809;8318;503;1563;1797;5261;2300;6824
240080;201412;3240;8700;2814;8135;282;793;2138;6275;2420;7068
240090;201412;2367;6423;1986;5717;77;292;1571;4421;1648;4713
240100;201412;10798;30663;9853;28753;1278;4364;6179;17767;7457;22131
240110;201412;5311;16288;4694;15121;854;3088;2754;8561;3608;11649
240120;201412;3104;10360;2967;10100;548;2004;1876;6501;2424;8505
240130;201412;2952;7954;2531;7314;201;688;1971;5606;2172;6294
240140;201412;2318;7005;1996;6402;386;1412;1109;3484;1495;4896
240145;201412;6428;20109;5776;18955;1520;5488;2956;9727;4476;15215
240150;201412;1056;3167;860;2777;106;421;521;1611;627;2032
240160;201412;1451;4693;1273;4386;185;693;788;2808;973;3501
240165;201412;979;3090;852;2832;117;380;541;1864;658;2244
240170;201412;2635;7856;2323;7282;622;2160;1090;3351;1712;5511
240180;201412;3091;9628;2863;9219;721;2413;1490;4992;2211;7405
240185;201412;1541;5104;1474;4976;160;553;1111;3830;1271;4383
240190;201412;970;2960;880;2797;55;239;672;2085;727;2324
240200;201412;14255;37118;11837;33917;2515;7370;6565;19539;9080;26909
240210;201412;2905;8260;2675;7940;232;778;2197;6482;2429;7260
240220;201412;7558;24553;7148;23976;474;2034;6073;20182;6547;22216
240230;201412;5970;16372;5327;15307;427;1367;4240;12076;4667;13443
240240;201412;1913;5823;1334;4357;360;1306;280;787;640;2093
240250;201412;2962;8517;2790;8274;210;666;2262;6696;2472;7362
240260;201412;15235;50968;14478;49712;2609;9837;9250;31972;11859;41809
240270;201412;2570;8183;2355;7827;257;860;1743;5927;2000;6787
240280;201412;1720;4866;1537;4553;120;415;1150;3376;1270;3791
240290;201412;1458;4563;1252;4185;118;563;817;2624;935;3187
240300;201412;2248;6294;1606;4892;418;1362;573;1674;991;3036
240310;201412;10880;30759;9862;29138;2030;6553;5412;16028;7442;22581
240320;201412;2145;6355;1728;5485;114;490;1263;3869;1377;4359
240325;201412;40162;110859;31219;95951;10123;33440;8898;27914;19021;61354
240330;201412;1596;4804;1345;4302;157;624;852;2634;1009;3258
240340;201412;1851;5308;1580;4879;198;656;1132;3492;1330;4148
240350;201412;2221;6608;2078;6406;209;738;1693;5183;1902;5921
240360;201412;7576;22809;6601;21346;1297;4442;3958;13154;5255;17596
240370;201412;2124;5810;1781;5215;209;654;1175;3459;1384;4113
240375;201412;929;2467;817;2297;159;511;479;1304;638;1815
240380;201412;2752;8172;2188;6903;299;1002;1280;3991;1579;4993
240390;201412;1005;2756;844;2447;70;255;616;1730;686;1985
240400;201412;1541;4131;1294;3733;151;503;927;2597;1078;3100
240410;201412;559;1804;507;1695;85;329;317;1057;402;1386
240420;201412;5111;19330;4857;18744;1300;5112;2561;10338;3861;15450
240430;201412;3734;10540;3424;10013;313;1052;2555;7381;2868;8433
240440;201412;2899;7651;2627;7188;672;1866;1374;3790;2046;5656
240450;201412;3604;10874;3203;10105;345;1414;2160;6560;2505;7974
240460;201412;3120;9603;2959;9381;286;1076;2360;7399;2646;8475
240470;201412;3700;11436;2971;9880;391;1431;1845;6086;2236;7517
240480;201412;488;1274;401;1094;41;113;239;642;280;755
240485;201412;2185;6691;1908;6154;373;1305;1091;3546;1464;4851
240490;201412;1779;4483;1525;4103;88;316;1214;3150;1302;3466
240500;201412;2256;6629;2097;6367;209;701;1582;4806;1791;5507
240510;201412;1900;5690;1754;5419;209;670;1335;4177;1544;4847
240520;201412;1496;4329;1303;4051;194;681;906;2751;1100;3432
240530;201412;2268;7220;2035;6845;305;1073;1405;4752;1710;5825
240540;201412;1868;5725;1783;5583;174;624;1348;4215;1522;4839
240550;201412;841;2388;726;2192;61;210;557;1645;618;1855
240560;201412;3360;9832;3176;9556;320;958;2563;7769;2883;8727
240570;201412;3201;9079;2553;7625;594;1957;1053;2849;1647;4806
240580;201412;8486;25968;7962;25067;1097;3728;5962;18653;7059;22381
240590;201412;852;2389;732;2172;57;211;530;1538;587;1749
240600;201412;1639;4832;1287;4105;172;659;747;2271;919;2930
240610;201412;5200;14595;4456;13207;677;2121;2642;7677;3319;9798
240615;201412;1089;3144;898;2775;150;470;507;1562;657;2032
240620;201412;1830;5782;1650;5480;209;731;1248;4179;1457;4910
240630;201412;2177;6607;2024;6345;216;588;1497;4932;1713;5520
240640;201412;971;2828;813;2561;92;362;548;1697;640;2059
240650;201412;3970;12103;3625;11596;297;1065;2899;9332;3196;10397
240660;201412;2599;8252;2461;8038;260;903;1882;6209;2142;7112
240670;201412;2819;8426;2360;7468;356;1248;1334;4142;1690;5390
240680;201412;1561;4591;1264;4054;148;540;785;2510;933;3050
240690;201412;1156;3204;996;2944;101;356;736;2145;837;2501
240700;201412;2729;8196;2268;7323;116;552;1756;5521;1872;6073
240710;201412;19246;49693;16933;46541;3228;8689;10477;29720;13705;38409
240720;201412;5980;16860;5629;16313;1750;5382;2645;7502;4395;12884
240725;201412;1090;3286;844;2741;86;302;485;1542;571;1844
240730;201412;2414;7265;2082;6653;218;764;1474;4687;1692;5451
240740;201412;2333;6876;2081;6418;274;971;1342;4040;1616;5011
240750;201412;2362;8759;2150;8352;478;2035;1148;4526;1626;6561
240760;201412;1351;3855;1231;3696;130;326;934;2983;1064;3309
240770;201412;3445;9925;3099;9429;274;978;2442;7391;2716;8369
240780;201412;6199;17167;4962;15217;936;3006;2819;8852;3755;11858
240790;201412;887;2733;724;2442;52;218;523;1777;575;1995
240800;201412;42804;123441;38671;116320;10863;34215;16456;50414;27319;84629
240810;201412;103241;302778;96370;290547;28490;88519;46288;141668;74778;230187
240820;201412;7181;21402;6147;19730;1350;4729;3007;10039;4357;14768
240830;201412;9773;29832;9124;28894;684;2276;7524;24221;8208;26497
240840;201412;1347;3741;1153;3411;143;475;696;2038;839;2513
240850;201412;1339;3951;962;3119;185;646;470;1474;655;2120
240860;201412;1396;3929;1170;3541;94;326;866;2576;960;2902
240870;201412;1224;3389;1025;3005;132;452;661;1845;793;2297
240880;201412;1221;4164;1154;4063;145;604;839;2923;984;3527
240890;201412;5612;15818;4806;14360;987;3217;2376;6995;3363;10212
240895;201412;2880;9796;2598;9287;343;1295;1798;6554;2141;7849
240910;201412;2872;8903;2579;8347;228;887;1914;6111;2142;6998
240920;201412;881;2813;780;2583;208;766;332;1055;540;1821
240930;201412;3791;10111;3394;9605;302;868;2693;7740;2995;8608
240933;201412;1558;4500;1383;4203;206;709;875;2653;1081;3362
240940;201412;6923;19247;5764;17239;1071;3384;3238;9652;4309;13036
240950;201412;1220;3774;1150;3655;108;421;823;2608;931;3029
240960;201412;833;2597;737;2410;92;336;516;1688;608;2024
240970;201412;2016;5584;1674;4995;137;490;1239;3616;1376;4106
240980;201412;3438;11148;3190;10681;650;2352;1962;6556;2612;8908
240990;201412;3156;9398;2950;8976;561;1872;1800;5359;2361;7231
241000;201412;1132;3162;973;2881;75;261;706;2063;781;2324
241010;201412;3002;10084;2722;9548;381;1628;1919;6517;2300;8145
241020;201412;2230;6241;1811;5428;149;539;1163;3354;1312;3893
241025;201412;1593;4884;1434;4577;100;429;1041;3248;1141;3677
241030;201412;2642;8657;2363;8154;199;783;1821;6317;2020;7100
241040;201412;2291;7924;2086;7545;223;928;1511;5511;1734;6439
241050;201412;1407;4163;1245;3885;110;434;927;2818;1037;3252
241060;201412;1021;2924;920;2755;104;326;668;2005;772;2331
241070;201412;962;2719;835;2494;98;337;574;1667;672;2004
241080;201412;1241;3666;1046;3303;87;358;735;2253;822;2611
241090;201412;2199;6394;1872;5805;134;579;1480;4504;1614;5083
241100;201412;1226;3667;1048;3259;139;457;647;1986;786;2443
241105;201412;1236;3744;1144;3568;225;740;643;2066;868;2806
241110;201412;884;2805;735;2479;79;345;460;1516;539;1861
241120;201412;8074;24371;7359;23227;1580;5064;4614;14968;6194;20032
241140;201412;3606;9990;3156;9113;419;1273;2145;6122;2564;7395
241142;201412;718;2150;516;1704;135;513;146;433;281;946
241150;201412;6072;17919;5441;16843;841;2708;3638;11439;4479;14147
241160;201412;1138;3312;1068;3179;169;543;742;2205;911;2748
241170;201412;1410;4122;1285;3891;178;586;811;2560;989;3146
241180;201412;933;2656;757;2310;95;319;425;1257;520;1576
241190;201412;1202;3322;975;2863;83;302;626;1738;709;2040
241200;201412;21750;64697;19899;61653;5283;17182;9833;31058;15116;48240
241210;201412;1598;4605;1323;4039;274;917;644;1926;918;2843
241220;201412;8246;27527;7784;26634;1913;6800;4263;14894;6176;21694
241230;201412;3229;9475;2935;9044;218;824;2387;7288;2605;8112
241240;201412;1179;3469;890;2840;106;365;462;1528;568;1893
241250;201412;5831;18330;4945;16588;313;1553;3923;12828;4236;14381
241255;201412;1880;7161;1766;6919;455;1896;807;3256;1262;5152
241260;201412;5272;14238;4246;12646;331;1273;3083;8987;3414;10260
241270;201412;2125;6378;1857;5863;251;890;1140;3602;1391;4492
241280;201412;2198;6366;2029;6039;309;984;1356;4060;1665;5044
241290;201412;3403;9351;2715;8245;444;1411;1689;5145;2133;6556
241300;201412;1506;4353;1321;4029;89;276;1010;3128;1099;3404
241310;201412;1619;4966;1509;4790;228;719;1049;3423;1277;4142
241320;201412;979;3238;897;3069;155;565;527;1819;682;2384
241330;201412;1566;4937;1445;4776;144;560;1178;3876;1322;4436
241335;201412;2757;8426;2585;8120;174;576;2196;6901;2370;7477
241340;201412;2005;6189;1771;5681;431;1509;852;2690;1283;4199
241350;201412;1991;6343;1822;6015;180;762;1359;4348;1539;5110
241355;201412;1369;3857;1162;3503;65;207;1016;3058;1081;3265
241360;201412;2238;6129;1913;5517;131;444;1394;3867;1525;4311
241370;201412;1359;4190;1105;3650;194;692;568;1846;762;2538
241380;201412;751;2139;635;1905;117;386;340;1030;457;1416
241390;201412;3092;10156;2883;9774;511;1857;1920;6588;2431;8445
241400;201412;3654;10841;3384;10465;370;1289;2623;8170;2993;9459
241410;201412;2820;8246;2527;7852;398;1335;1785;5560;2183;6895
241415;201412;1750;5303;1591;5028;125;494;1198;3722;1323;4216
241420;201412;2336;8087;2033;7552;710;2953;617;2237;1327;5190
241430;201412;555;1691;446;1439;50;186;283;882;333;1068
241440;201412;6248;22612;5847;21926;1149;4489;3912;14921;5061;19410
241445;201412;1098;3275;1025;3173;136;360;795;2597;931;2957
241450;201412;3353;9287;3008;8778;500;1578;2009;5807;2509;7385
241460;201412;3747;10879;3281;9963;276;1011;2352;7058;2628;8069
241470;201412;1416;3958;1177;3663;129;508;865;2642;994;3150
241475;201412;1286;3986;1123;3681;70;334;831;2658;901;2992
241480;201412;3386;10893;3052;10391;1086;3735;1132;4244;2218;7979
241490;201412;645;1726;531;1551;45;152;339;967;384;1119
241500;201412;765;2412;690;2302;33;128;599;1999;632;2127
250010;201412;2875;8965;2466;8175;217;900;1851;6009;2068;6909
250020;201412;1726;4941;1324;4213;103;447;883;2691;986;3138
250030;201412;8345;23498;7541;22380;853;2564;5795;17493;6648;20057
250040;201412;4679;15617;4297;14839;784;2884;2673;9294;3457;12178
250050;201412;3878;11982;3607;11599;461;1663;2601;8440;3062;10103
250053;201412;1383;4055;1271;3907;214;664;821;2571;1035;3235
250057;201412;706;2849;689;2831;35;97;612;2656;647;2753
250060;201412;5259;16314;5006;15925;639;2317;3838;12032;4477;14349
250070;201412;3901;12255;3636;11783;211;945;3022;9531;3233;10476
250073;201412;824;2482;732;2316;67;249;550;1731;617;1980
250077;201412;2367;6889;1960;6245;265;916;1173;3786;1438;4702
250080;201412;4901;14247;4718;13975;564;1726;3575;10652;4139;12378
250090;201412;2658;7815;2550;7638;128;446;2144;6340;2272;6786
250100;201412;4198;13867;3954;13441;443;1710;3033;10268;3476;11978
250110;201412;5982;17878;5684;17457;754;2614;4283;13037;5037;15651
250115;201412;550;1791;483;1628;39;196;291;914;330;1110
250120;201412;2269;6761;1944;6151;186;675;1447;4564;1633;5239
250130;201412;5886;17999;5528;17493;328;1107;4689;15064;5017;16171
250135;201412;1110;3381;1009;3197;110;381;709;2257;819;2638
250140;201412;2198;7083;2025;6851;212;789;1547;5311;1759;6100
250150;201412;5106;17254;4641;16363;469;1987;3386;11799;3855;13786
250153;201412;1626;4359;1452;4106;117;407;1136;3212;1253;3619
250157;201412;1822;6087;1662;5755;287;1033;1069;3750;1356;4783
250160;201412;3488;10651;3352;10442;210;736;2884;9052;3094;9788
250170;201412;1680;4918;1549;4708;295;941;995;3090;1290;4031
250180;201412;17415;53565;16774;52508;2300;8397;12149;37120;14449;45517
250190;201412;4181;12233;3826;11642;672;2128;2451;7403;3123;9531
250200;201412;2296;6343;1820;5693;137;510;1499;4655;1636;5165
250205;201412;1045;3410;948;3223;94;422;615;2140;709;2562
250210;201412;1681;5457;1554;5265;180;752;1128;3758;1308;4510
250215;201412;1477;4985;1429;4899;208;800;916;3150;1124;3950
250220;201412;834;2386;695;2208;45;171;590;1860;635;2031
250230;201412;1807;4539;1466;3984;125;400;1162;3071;1287;3471
250240;201412;2763;8771;2431;8249;201;713;1853;6368;2054;7081
250250;201412;4738;14193;4337;13652;366;1162;3560;11346;3926;12508
250260;201412;1958;5922;1692;5485;147;579;1257;4039;1404;4618
250270;201412;1370;4256;1219;4067;154;526;922;3141;1076;3667
250280;201412;3910;11660;3575;11129;648;2078;2351;7595;2999;9673
250290;201412;2164;5767;1778;5265;65;244;1558;4609;1623;4853
250300;201412;5648;16607;5343;16222;629;2546;4277;12432;4906;14978
250310;201412;1225;3820;1105;3615;151;565;807;2610;958;3175
250320;201412;8191;25659;7773;24809;1073;3884;5289;16442;6362;20326
250330;201412;2733;8440;2343;7891;242;948;1798;6017;2040;6965
250340;201412;1168;3397;1076;3252;51;168;923;2801;974;2969
250350;201412;4763;12812;4234;12185;196;631;3701;10779;3897;11410
250355;201412;2219;6759;2004;6437;155;661;1560;4937;1715;5598
250360;201412;2111;6269;1961;6059;115;425;1569;4869;1684;5294
250370;201412;13811;39242;11880;36935;1223;3973;9712;30398;10935;34371
250375;201412;1133;3568;1063;3450;64;255;898;2908;962;3163
250380;201412;1739;4938;1639;4810;97;333;1435;4200;1532;4533
250390;201412;2046;5396;1642;4721;224;641;1088;3181;1312;3822
250400;201412;76148;206980;63685;187000;15684;48517;32128;96163;47812;144680
250403;201412;1622;5305;1520;5165;217;838;1089;3673;1306;4511
250407;201412;1222;3492;1062;3225;71;217;829;2506;900;2723
250410;201412;687;2189;604;2041;67;281;461;1538;528;1819
250415;201412;1717;5417;1560;5104;128;485;1206;3887;1334;4372
250420;201412;1358;4200;1256;4040;100;401;1037;3267;1137;3668
250430;201412;6888;19193;6421;18512;507;1749;5255;14873;5762;16622
250435;201412;1685;5071;1497;4708;219;795;886;2839;1105;3634
250440;201412;4758;13865;4427;13403;294;907;3649;11137;3943;12044
250450;201412;2113;5999;1865;5675;101;348;1664;5071;1765;5419
250460;201412;6644;19986;6145;19310;741;2493;4637;14710;5378;17203
250470;201412;1656;4597;1481;4346;145;512;1066;3040;1211;3552
250480;201412;4157;12409;3750;11822;157;635;3244;10191;3401;10826
250485;201412;644;1667;536;1494;29;95;428;1156;457;1251
250490;201412;4313;13850;4205;13690;1015;3475;2577;8453;3592;11928
250500;201412;1984;5970;1813;5688;390;1229;1055;3409;1445;4638
250510;201412;5065;14229;4464;13390;298;1057;3681;11031;3979;12088
250520;201412;1954;6004;1845;5815;323;1156;1107;3421;1430;4577
250523;201412;1844;5796;1746;5658;256;877;1267;4148;1523;5025
250527;201412;1526;4575;1434;4456;61;256;1292;3972;1353;4228
250530;201412;703;2134;614;2021;47;155;503;1687;550;1842
250535;201412;1356;4309;1288;4170;87;372;1021;3251;1108;3623
250540;201412;2538;7539;2377;7360;73;220;2201;6895;2274;7115
250550;201412;912;3059;837;2943;67;278;646;2249;713;2527
250560;201412;1855;5840;1808;5772;141;478;1543;4952;1684;5430
250570;201412;2639;8503;2318;7867;203;820;1756;5900;1959;6720
250580;201412;1215;3293;988;2929;99;412;719;2022;818;2434
250590;201412;1065;3236;958;3094;92;377;741;2347;833;2724
250600;201412;7320;21476;6902;20860;498;1434;5765;17681;6263;19115
250610;201412;3587;10454;3298;10016;406;1352;2361;7184;2767;8536
250620;201412;873;2534;805;2398;155;502;499;1463;654;1965
250625;201412;2373;7555;2339;7511;76;194;2188;7115;2264;7309
250630;201412;10820;34496;10241;33464;2327;8033;5829;19171;8156;27204
250640;201412;3968;11805;3709;11499;275;1032;3137;9631;3412;10663
250650;201412;989;2838;908;2692;121;425;545;1615;666;2040
250660;201412;2198;5429;1684;4812;29;74;1605;4618;1634;4692
250670;201412;2828;9390;2677;9115;261;1072;2006;6806;2267;7878
250680;201412;5113;14620;4864;14271;263;877;4225;12439;4488;13316
250690;201412;6565;17329;6286;16981;585;1707;5367;14388;5952;16095
250700;201412;5553;16474;5101;15807;829;2767;3461;10633;4290;13400
250710;201412;4808;15095;4407;14577;682;2296;3071;10441;3753;12737
250720;201412;2720;8030;2571;7780;143;566;2171;6514;2314;7080
250730;201412;3811;11730;3597;11421;440;1573;2683;8445;3123;10018
250740;201412;2112;6189;1849;5750;195;706;1355;4140;1550;4846
250750;201412;106535;312067;99879;301830;17299;57263;66472;198541;83771;255804
250760;201412;2368;6914;2174;6628;173;636;1736;5238;1909;5874
250770;201412;4134;14092;3908;13784;723;2762;2510;8923;3233;11685
250780;201412;1967;5773;1683;5244;199;778;1078;3221;1277;3999
250790;201412;2525;8233;2384;8029;550;1795;1520;5313;2070;7108
250800;201412;2908;8258;2526;7609;151;529;1970;5820;2121;6349
250810;201412;1410;4117;1216;3829;117;469;957;2950;1074;3419
250820;201412;2134;6459;2049;6337;127;427;1725;5381;1852;5808
250830;201412;6183;20300;5783;19496;761;2987;3976;13227;4737;16214
250840;201412;1054;3377;917;3099;116;435;589;2007;705;2442
250850;201412;2488;7181;2209;6726;217;842;1457;4586;1674;5428
250855;201412;1115;3377;1038;3257;103;386;787;2402;890;2788
250860;201412;3125;10329;2778;9676;664;2634;1095;3758;1759;6392
250870;201412;1108;3245;1010;3077;61;251;774;2275;835;2526
250880;201412;1476;4243;1324;4030;186;588;963;2935;1149;3523
250890;201412;10211;31620;9521;30658;1559;5817;6482;20463;8041;26280
250900;201412;3144;10222;2782;9541;357;1231;1928;6717;2285;7948
250905;201412;2163;6846;2062;6715;366;1214;1468;4864;1834;6078
250910;201412;5617;16230;5238;15666;493;1623;4111;12287;4604;13910
250915;201412;1757;5121;1618;4921;147;427;1340;4168;1487;4595
250920;201412;3661;10444;3428;10115;442;1236;2504;7676;2946;8912
250930;201412;2082;6707;1982;6549;325;1217;1383;4526;1708;5743
250933;201412;1217;3945;1165;3857;123;424;867;2911;990;3335
250937;201412;879;2722;783;2526;119;460;468;1503;587;1963
250939;201412;1784;5473;1610;5192;224;784;1076;3449;1300;4233
250940;201412;4116;12049;3803;11561;223;811;3051;9346;3274;10157
250950;201412;1203;3830;1104;3706;35;121;999;3388;1034;3509
250960;201412;1339;4153;1187;3949;113;454;922;3068;1035;3522
250970;201412;9465;25579;8340;23959;1214;3500;5822;16895;7036;20395
250980;201412;2801;8319;2546;7867;250;989;1763;5246;2013;6235
250990;201412;2207;7527;2026;7155;295;1199;1372;4791;1667;5990
251000;201412;2637;7460;2160;6781;131;475;1735;5452;1866;5927
251010;201412;2931;8519;2648;8083;183;655;2123;6544;2306;7199
251020;201412;1783;5233;1629;5037;147;503;1357;4218;1504;4721
251030;201412;1357;3759;1226;3537;131;429;805;2351;936;2780
251040;201412;1980;6256;1772;5922;177;828;1272;4093;1449;4921
251050;201412;1198;3454;1041;3170;174;565;593;1854;767;2419
251060;201412;1031;2387;783;2077;55;193;614;1578;669;1771
251065;201412;608;1799;530;1684;75;267;326;998;401;1265
251070;201412;653;1836;593;1750;62;247;457;1263;519;1510
251080;201412;22120;61697;20398;58759;5129;15478;11056;32230;16185;47708
251090;201412;3206;10035;2830;9309;275;1054;2045;6649;2320;7703
251100;201412;1044;3333;895;3036;167;653;510;1670;677;2323
251110;201412;2189;6351;1924;5861;224;743;1308;3984;1532;4727
251120;201412;6200;21175;5966;20763;767;3134;4553;15598;5320;18732
251130;201412;4121;10695;3705;10233;35;103;3585;9926;3620;10029
251140;201412;4673;14235;4324;13690;226;884;3439;10866;3665;11750
251150;201412;2933;9363;2678;8993;372;1407;1896;6410;2268;7817
251160;201412;1904;6313;1822;6198;98;389;1590;5413;1688;5802
251170;201412;1510;4602;1440;4518;122;460;1196;3709;1318;4169
251180;201412;2988;8910;2728;8566;581;1825;1634;5287;2215;7112
251190;201412;4560;12879;4404;12701;274;792;3945;11427;4219;12219
251200;201412;4318;13395;4081;13100;174;594;3664;11844;3838;12438
251203;201412;1390;4342;1298;4150;105;443;829;2748;934;3191
251207;201412;1239;3872;1070;3554;102;448;722;2313;824;2761
251210;201412;8388;23966;7304;22516;952;2881;5475;17282;6427;20163
251220;201412;1393;3677;1193;3380;187;553;777;2284;964;2837
251230;201412;5408;16132;4768;15380;419;1515;4043;13059;4462;14574
251240;201412;3312;10774;3227;10645;354;1272;2579;8511;2933;9783
251250;201412;11078;32964;10253;31702;1368;4778;7489;22876;8857;27654
251260;201412;568;1719;495;1616;37;119;371;1219;408;1338
251270;201412;4427;13819;4126;13448;152;590;3723;12186;3875;12776
251272;201412;1473;4385;1385;4262;123;405;1126;3496;1249;3901
251274;201412;1054;3265;974;3114;120;483;596;1933;716;2416
251275;201412;1461;4128;1382;4009;145;545;1025;2867;1170;3412
251276;201412;1550;4606;1459;4446;213;707;918;2892;1131;3599
251278;201412;664;2114;575;1906;89;333;344;1180;433;1513
251280;201412;2476;7676;2358;7481;242;862;1821;5718;2063;6580
251290;201412;6411;18042;6067;17614;869;2895;4432;12591;5301;15486
251300;201412;778;2668;721;2582;66;309;527;1848;593;2157
251310;201412;3444;9949;3166;9555;191;709;2561;7669;2752;8378
251315;201412;1783;6205;1719;6092;305;1103;1084;3948;1389;5051
251320;201412;2213;6169;1806;5514;149;501;1280;3970;1429;4471
251330;201412;2134;5507;1735;4989;113;458;1489;4154;1602;4612
251335;201412;1027;3529;958;3395;90;416;703;2420;793;2836
251340;201412;4060;11258;3417;10282;340;1259;2401;7060;2741;8319
251350;201412;1667;5050;1507;4816;202;712;1038;3292;1240;4004
251360;201412;1896;6154;1763;5992;112;450;1490;5110;1602;5560
251365;201412;922;2712;740;2339;57;222;484;1503;541;1725
251370;201412;24538;79800;23955;78932;3515;13371;17994;57950;21509;71321
251380;201412;1453;4498;1266;4181;93;394;1005;3245;1098;3639
251385;201412;906;2486;814;2341;93;273;553;1584;646;1857
251390;201412;6060;21209;5635;20467;1337;5122;3342;12230;4679;17352
251392;201412;1116;3279;1015;3120;93;294;759;2392;852;2686
251394;201412;646;1967;529;1745;42;162;373;1215;415;1377
251396;201412;898;2558;795;2379;121;380;535;1568;656;1948
251398;201412;1155;3347;960;2985;84;309;660;2034;744;2343
251400;201412;1415;3974;1258;3761;177;656;849;2447;1026;3103
251410;201412;1686;4364;1536;4123;173;532;1065;2907;1238;3439
251420;201412;2308;6525;1954;6125;200;694;1516;4734;1716;5428
251430;201412;1794;6283;1611;5984;115;510;1333;4948;1448;5458
251440;201412;1493;4426;1261;3971;141;500;903;2811;1044;3311
251445;201412;1700;5124;1611;4994;109;409;1364;4186;1473;4595
251450;201412;4990;15547;4451;14861;183;772;3859;12886;4042;13658
251455;201412;1226;3821;1082;3584;95;383;756;2516;851;2899
251460;201412;903;2768;862;2701;126;405;660;2100;786;2505
251465;201412;508;1586;446;1443;42;161;299;950;341;1111
251470;201412;1327;3829;1098;3405;134;479;645;2011;779;2490
251480;201412;1157;3127;1029;2919;62;228;822;2292;884;2520
251490;201412;2165;6339;1863;5921;315;1148;1157;3638;1472;4786
251500;201412;1842;6017;1782;5920;185;691;1411;4631;1596;5322
251510;201412;2741;9045;2508;8562;430;1569;1565;5389;1995;6958
251520;201412;1160;3126;1037;2931;157;467;577;1651;734;2118
251530;201412;12586;36019;12031;35223;709;2570;10352;29941;11061;32511
251540;201412;2964;9620;2727;9120;254;1018;2088;6947;2342;7965
251550;201412;4102;10241;3408;9346;186;635;2796;7510;2982;8145
251560;201412;765;2357;694;2231;107;414;415;1234;522;1648
251570;201412;1108;3217;926;2851;104;396;603;1890;707;2286
251580;201412;2249;6189;2063;5931;386;980;1422;4277;1808;5257
251590;201412;1793;5761;1740;5700;116;427;1502;4969;1618;5396
251593;201412;1104;3399;1019;3280;157;563;637;1996;794;2559
251597;201412;2049;6286;1966;6161;177;667;1559;4799;1736;5466
251600;201412;7670;22212;7226;21470;870;2602;5441;16459;6311;19061
251610;201412;3709;11095;3414;10689;363;1228;2610;8287;2973;9515
251615;201412;1239;3535;1028;3170;103;398;670;2103;773;2501
251620;201412;18034;50580;15802;47762;1805;5616;12036;36973;13841;42589
251630;201412;5513;13896;4740;12900;442;1250;3653;10055;4095;11305
251640;201412;2763;7943;2255;7023;217;811;1637;5051;1854;5862
251650;201412;4515;12779;4052;12194;333;1054;3318;10184;3651;11238
251660;201412;3740;12222;3401;11678;276;1256;2702;9068;2978;10324
251670;201412;4186;12508;3713;11860;80;258;3392;10943;3472;11201
251675;201412;783;2570;733;2494;169;612;412;1388;581;2000
251680;201412;2958;8228;2318;7247;126;520;1878;5773;2004;6293
251690;201412;3680;11194;3401;10690;310;1095;2491;7757;2801;8852
251700;201412;2247;7191;2111;7008;201;740;1711;5713;1912;6453
251710;201412;989;2570;724;2075;97;331;388;1074;485;1405
251720;201412;1467;4496;1327;4254;114;450;1027;3248;1141;3698
251740;201412;785;2213;622;1923;80;259;391;1205;471;1464
260005;201412;26082;64301;22729;59529;4853;12938;13705;35868;18558;48806
260010;201412;10065;27231;8055;24739;988;3219;5824;18105;6812;21324
260020;201412;6059;17515;5315;16398;499;1498;4005;12781;4504;14279
260030;201412;5614;16755;5129;15999;430;1534;4054;12565;4484;14099
260040;201412;10450;25269;8699;23278;728;1640;6996;19464;7724;21104
260050;201412;11489;35862;10654;34893;666;2315;9288;30735;9954;33050
260060;201412;4188;11599;3786;10914;367;1073;2926;8526;3293;9599
260070;201412;10097;29652;9516;28786;1830;5979;6247;18797;8077;24776
260080;201412;5593;15557;4918;14584;494;1662;3703;10809;4197;12471
260090;201412;5527;15280;5150;14750;1154;3175;3443;10187;4597;13362
260100;201412;3607;9637;3250;9148;244;827;2616;7451;2860;8278
260105;201412;4868;14299;4662;13905;716;2337;3252;9572;3968;11909
260110;201412;22814;65248;20898;62928;1346;4061;18006;54736;19352;58797
260120;201412;11474;35183;10547;33529;2762;9011;5559;18307;8321;27318
260130;201412;3244;9160;3062;8865;465;1291;2213;6557;2678;7848
260140;201412;13930;35388;11919;32916;1147;3444;9320;26082;10467;29526
260150;201412;3242;9241;2880;8719;220;807;2282;6927;2502;7734
260160;201412;6171;18768;5511;17966;501;1743;4509;14979;5010;16722
260170;201412;18401;50180;17533;49022;1694;4500;14104;39995;15798;44495
260180;201412;3482;10695;3168;10237;243;928;2581;8307;2824;9235
260190;201412;16885;40113;15726;38677;857;2248;13653;33573;14510;35821
260200;201412;11979;33322;10919;31797;1079;3384;8298;24811;9377;28195
260210;201412;11827;36152;10789;34646;894;3190;8653;28031;9547;31221
260220;201412;9823;29510;9502;29066;760;2910;8072;24179;8832;27089
260230;201412;10295;29565;9639;28687;704;2132;7893;23953;8597;26085
260240;201412;3056;9278;2633;8671;402;1423;1852;6141;2254;7564
260250;201412;2841;7570;2583;7244;190;570;2109;5955;2299;6525
260260;201412;12179;34743;11494;33841;1522;4724;8746;26290;10268;31014
260270;201412;3707;11029;3456;10651;356;1382;2669;8052;3025;9434
260280;201412;13436;43548;12304;41778;811;2959;10257;35358;11068;38317
260290;201412;35917;108705;34365;106014;6211;21075;22587;68862;28798;89937
260300;201412;8724;26386;7649;24778;550;2248;6076;19644;6626;21892
260310;201412;5332;15675;4964;15109;1590;4502;2484;8238;4074;12740
260320;201412;7234;23835;6692;23036;595;2078;5330;18722;5925;20800
260330;201412;3207;9915;2968;9518;295;1156;2036;6740;2331;7896
260340;201412;1959;5775;1827;5579;99;352;1595;4847;1694;5199
260345;201412;27738;89247;26309;86331;7900;28082;11635;36843;19535;64925
260350;201412;4502;12594;4248;12207;304;993;3510;10020;3814;11013
260360;201412;2561;7734;2387;7446;431;1506;1539;4778;1970;6284
260370;201412;6313;19270;5645;18071;675;2419;4060;13085;4735;15504
260380;201412;5121;16662;4712;16108;494;1741;3597;12480;4091;14221
260390;201412;4876;15117;4191;13972;491;1824;2972;9753;3463;11577
260392;201412;3649;11375;3384;11032;146;561;3024;9863;3170;10424
260400;201412;14588;42419;13941;41350;2349;7947;9567;27707;11916;35654
260410;201412;65864;192415;61564;185292;20576;62532;27358;85284;47934;147816
260415;201412;4220;13256;3663;12161;502;1988;2301;7500;2803;9488
260420;201412;12759;29439;11614;28221;780;1992;10019;24419;10799;26411
260430;201412;2834;9366;2545;8898;306;1227;1839;6363;2145;7590
260440;201412;3563;10752;3246;10107;596;2024;1926;5869;2522;7893
260450;201412;5473;16212;5128;15670;410;1378;4175;12782;4585;14160
260460;201412;6013;18528;5600;17861;1004;3531;3529;11080;4533;14611
260470;201412;5287;15046;4964;14605;450;1381;4058;12146;4508;13527
260480;201412;4101;11939;3656;11278;613;2110;2446;7537;3059;9647
260490;201412;6300;16110;5433;14718;580;1903;3805;10279;4385;12182
260500;201412;7046;19254;6454;18369;744;2224;4706;13558;5450;15782
260510;201412;10892;28423;10050;27274;817;2228;8038;22553;8855;24781
260515;201412;4738;14620;3692;12458;344;1346;2351;7927;2695;9273
260520;201412;16902;45186;16320;44385;3259;8824;11195;30872;14454;39696
260530;201412;10385;30949;9024;29017;567;1815;7650;24962;8217;26777
260540;201412;6147;15663;5720;15200;695;1531;4616;12698;5311;14229
260545;201412;43;166;31;127;4;18;7;27;11;45
260550;201412;2945;9735;2573;8973;646;2500;1150;3979;1796;6479
260560;201412;6971;17790;6180;16672;303;879;5417;14609;5720;15488
260570;201412;6958;23452;6427;22546;926;3641;4563;16086;5489;19727
260580;201412;4062;11144;3813;10755;276;912;3200;8855;3476;9767
260590;201412;6044;15322;5779;15012;264;610;5252;13811;5516;14421
260600;201412;28295;85632;26292;82214;3983;13443;17899;56296;21882;69739
260610;201412;7247;21667;6880;21133;1204;3957;4789;14616;5993;18573
260620;201412;17997;55167;17247;53864;3395;11789;10823;33122;14218;44911
260630;201412;2405;7088;2070;6538;211;802;1556;4865;1767;5667
260640;201412;18076;49550;17035;48086;2531;7455;11990;33955;14521;41410
260650;201412;5680;17766;5217;16971;644;2074;3679;12691;4323;14765
260660;201412;8688;23969;7778;22811;506;1575;6607;19528;7113;21103
260670;201412;2523;6989;2113;6426;279;947;1422;4357;1701;5304
260680;201412;24092;66345;22402;63365;4983;14667;12445;34903;17428;49570
260690;201412;3805;10365;3249;9506;182;671;2690;7791;2872;8462
260700;201412;5880;17459;5740;17311;90;161;5565;17008;5655;17169
260710;201412;1392;4199;1255;4000;141;531;950;2981;1091;3512
260720;201412;17699;58003;16776;56383;4329;14840;9126;31517;13455;46357
260730;201412;7520;24523;6719;23301;966;3482;4804;16920;5770;20402
260740;201412;1336;4053;1161;3739;167;608;713;2289;880;2897
260750;201412;6911;21765;6376;21035;617;1866;5253;17790;5870;19656
260760;201412;4981;13669;4643;13220;479;1475;3638;10377;4117;11852
260765;201412;8523;29118;8188;28603;1415;5736;5568;19234;6983;24970
260770;201412;4437;11463;4023;10915;252;851;3206;8550;3458;9401
260775;201412;5473;15803;5179;15353;601;2155;3715;10663;4316;12818
260780;201412;4109;13362;3925;13043;931;3452;2277;7476;3208;10928
260790;201412;125767;321942;119679;312882;26847;71619;72365;190234;99212;261853
260795;201412;3158;9909;2894;9494;469;1651;1924;6389;2393;8040
260800;201412;5022;13484;4642;12952;226;918;4047;10975;4273;11893
260805;201412;4249;12306;3799;11607;502;1678;2629;8015;3131;9693
260810;201412;7504;21723;7307;21467;475;1493;6374;18792;6849;20285
260820;201412;4723;13349;4379;12872;1145;3449;2531;7459;3676;10908
260825;201412;3149;10038;2920;9693;308;994;2303;7785;2611;8779
260830;201412;3906;12490;3546;11829;950;3053;2004;7019;2954;10072
260840;201412;4353;12519;3936;11909;295;1147;3234;9590;3529;10737
260845;201412;4421;12926;4108;12333;677;2143;2754;8298;3431;10441
260850;201412;5171;17315;4633;16132;1105;4307;2246;7631;3351;11938
260860;201412;3475;10887;3150;10293;276;958;2431;8002;2707;8960
260870;201412;4357;11989;3966;11497;529;1410;3011;8973;3540;10383
260875;201412;7589;20308;6781;19036;1239;3519;4182;12104;5421;15623
260880;201412;9046;28474;8534;27729;710;2364;7055;23163;7765;25527
260890;201412;15539;43992;14533;42465;1627;5287;10733;31453;12360;36740
260900;201412;6286;19207;5319;17487;869;3146;3239;10642;4108;13788
260910;201412;3268;9612;2955;9162;242;846;2365;7395;2607;8241
260915;201412;4732;15692;4548;15430;120;404;4209;14482;4329;14886
260920;201412;3575;10737;3390;10486;479;1601;2541;8005;3020;9606
260930;201412;4327;13633;3782;12784;491;1739;2712;9268;3203;11007
260940;201412;15950;43392;14576;41048;2421;8041;8940;24650;11361;32691
260950;201412;6522;20674;6108;19854;897;3637;3750;11539;4647;15176
260960;201412;69677;193560;65398;186578;14203;42255;37871;108824;52074;151079
260970;201412;5537;17455;5143;16890;551;2130;3819;12498;4370;14628
260980;201412;4119;13177;3884;12871;249;832;3310;11229;3559;12061
260990;201412;18938;58372;17430;56347;1929;6036;13393;44930;15322;50966
261000;201412;16370;45236;13165;40083;2687;8644;7132;22308;9819;30952
261010;201412;2866;7854;2670;7608;222;462;2275;6783;2497;7245
261020;201412;5949;17744;5430;16939;443;1641;4361;13285;4804;14926
261030;201412;3656;11789;3430;11397;343;1277;2698;8905;3041;10182
261040;201412;5559;17687;4756;16312;519;2089;3433;11644;3952;13733
261050;201412;9021;25439;8364;24360;1112;3312;5801;16859;6913;20171
261060;201412;12079;36611;11476;35621;1475;5277;8537;26003;10012;31280
261070;201412;53074;134992;47429;126924;9442;26081;29023;78198;38465;104279
261080;201412;6016;17942;5650;17364;411;1187;4766;14903;5177;16090
261090;201412;17185;47481;15977;45854;1604;4646;12718;36923;14322;41569
261100;201412;7656;24512;6942;23281;1103;3975;4544;15413;5647;19388
261110;201412;70239;200651;63516;190681;15811;47879;34316;108697;50127;156576
261120;201412;3861;10229;3460;9731;133;423;3085;8696;3218;9119
261130;201412;7442;19221;7094;18832;255;686;6535;17363;6790;18049
261140;201412;3370;9471;3071;9006;525;1710;1925;5549;2450;7259
261150;201412;5904;17348;5307;16467;679;2341;3868;12044;4547;14385
261153;201412;2079;6074;1711;5513;90;353;1361;4405;1451;4758
261160;201412;233554;606721;220950;589066;52745;141792;124300;341537;177045;483329
261170;201412;6139;17013;5631;16284;761;2247;4241;12368;5002;14615
261180;201412;10120;28367;9637;27676;1018;2993;7373;21420;8391;24413
261190;201412;5610;17658;5272;17218;775;3243;3652;11516;4427;14759
261200;201412;4079;9940;3726;9500;562;1416;2700;7042;3262;8458
261210;201412;2040;5353;1947;5235;134;348;1705;4656;1839;5004
261220;201412;13592;43194;11497;38585;2316;8342;5879;19793;8195;28135
261230;201412;4308;13160;3963;12722;189;694;3482;11226;3671;11920
261240;201412;5184;15106;4853;14528;807;2353;3379;10269;4186;12622
261245;201412;3985;12340;3426;11396;274;1139;2544;8470;2818;9609
261247;201412;3615;11025;3081;10042;365;1271;2191;7203;2556;8474
261250;201412;20016;53704;19179;52605;3533;9427;14037;39309;17570;48736
261255;201412;4504;13612;4022;12825;314;1122;3191;10308;3505;11430
261260;201412;12829;36080;11614;34648;704;1841;10105;30873;10809;32714
261270;201412;3869;11321;3550;10813;476;1585;2449;7392;2925;8977
261280;201412;2833;8635;2568;8246;264;931;1950;6291;2214;7222
261290;201412;3185;8970;2849;8547;210;716;2349;7116;2559;7832
261300;201412;10989;36046;9770;33910;1741;6840;5967;20525;7708;27365
261310;201412;8698;26174;8210;25356;2098;6620;4629;14434;6727;21054
261320;201412;6240;19264;5850;18550;570;1800;4521;14617;5091;16417
261330;201412;5702;16707;5471;16365;574;1718;4328;13047;4902;14765
261340;201412;4710;15288;4460;14883;670;2628;2868;9539;3538;12167
261350;201412;8464;28167;7959;27301;614;2548;6316;21478;6930;24026
261360;201412;9917;25424;8873;24029;1157;3234;6308;17403;7465;20637
261370;201412;21780;64246;20475;62201;4571;14519;12346;37770;16917;52289
261380;201412;4342;14776;4002;14135;640;2452;2674;9530;3314;11982
261390;201412;17915;54635;16261;51757;2789;9729;10048;31842;12837;41571
261400;201412;5093;17509;4602;16525;591;2396;3166;11416;3757;13812
261410;201412;8942;25618;8309;24653;1144;3426;6080;18376;7224;21802
261420;201412;8322;27762;7982;27272;2117;7902;4452;15366;6569;23268
261430;201412;3729;11504;3159;10729;376;1305;2348;8144;2724;9449
261440;201412;1722;5300;1580;5085;107;452;1288;4100;1395;4552
261450;201412;14688;41991;14279;41464;798;2398;12844;37408;13642;39806
261460;201412;8784;25044;8183;24210;824;2211;6194;19739;7018;21950
261470;201412;4112;11062;3741;10610;206;631;3248;9191;3454;9822
261480;201412;3635;13238;3377;12768;395;1692;2540;9443;2935;11135
261485;201412;5163;15911;4705;15089;926;3380;2738;8636;3664;12016
261500;201412;6010;16610;5281;15627;643;1716;4012;12388;4655;14104
261510;201412;2128;6695;1978;6468;175;567;1559;5180;1734;5747
261520;201412;2713;8769;2412;8208;176;715;1701;5871;1877;6586
261530;201412;12822;41127;11265;38058;2614;9590;5028;17024;7642;26614
261540;201412;7619;24534;7311;23978;1428;4645;4890;16391;6318;21036
261550;201412;3616;10692;3436;10431;398;1508;2722;8030;3120;9538
261560;201412;7272;23486;6623;22648;1223;4328;4612;16098;5835;20426
261570;201412;3744;11352;3268;10581;541;1807;2133;6978;2674;8785
261580;201412;5982;18724;5330;17664;472;1785;4217;14129;4689;15914
261590;201412;2954;8134;2561;7583;315;988;1826;5526;2141;6514
261600;201412;5465;14892;4663;13757;451;1368;3574;10661;4025;12029
261610;201412;2417;7119;2046;6573;120;495;1685;5292;1805;5787
261618;201412;2635;7436;2472;7220;253;805;1953;5649;2206;6454
261620;201412;4721;14434;4432;13970;659;2117;3040;9815;3699;11932
261630;201412;8268;24038;7001;21646;1199;4260;3952;11866;5151;16126
261640;201412;31463;81414;29007;78339;2057;5390;24395;67253;26452;72643
261650;201412;3913;12307;3649;11920;529;1842;2629;8649;3158;10491
270010;201412;4623;17395;4218;16563;524;2339;2916;11502;3440;13841
270020;201412;4166;12336;3901;11927;453;1589;2983;8990;3436;10579
270030;201412;46973;141663;44492;137678;11575;36425;25380;80198;36955;116623
270040;201412;10610;32599;10011;31888;1826;5350;7092;23613;8918;28963
270050;201412;4258;12155;3943;11744;417;1459;3064;9060;3481;10519
270060;201412;1788;5727;1683;5582;347;1252;1045;3501;1392;4753
270070;201412;4303;13327;3974;12881;201;895;3419;10917;3620;11812
270080;201412;1404;4325;1230;4022;221;822;776;2465;997;3287
270090;201412;2148;6690;2034;6467;63;249;1843;5791;1906;6040
270100;201412;6596;20393;6288;19953;1300;4323;4140;13118;5440;17441
270110;201412;3533;9934;3234;9591;543;1592;2136;6813;2679;8405
270120;201412;3229;9278;2917;8864;152;526;2543;7789;2695;8315
270130;201412;5399;16730;5092;16373;559;1620;4151;13785;4710;15405
270135;201412;1825;5040;1733;4939;136;216;1543;4598;1679;4814
270140;201412;10141;25037;8881;23405;762;2909;7091;17570;7853;20479
270150;201412;2809;9511;2738;9418;187;711;2419;8335;2606;9046
270160;201412;5218;17360;4788;16819;284;1056;4096;14468;4380;15524
270170;201412;4173;13518;3830;13012;781;3085;2214;7432;2995;10517
270180;201412;2377;7773;2107;7426;153;712;1713;5980;1866;6692
270190;201412;1976;6438;1868;6275;146;582;1477;4995;1623;5577
270200;201412;2811;9455;2628;9162;277;1158;2002;6867;2279;8025
270210;201412;4729;14927;4528;14666;396;1576;3809;12192;4205;13768
270220;201412;1752;5492;1620;5235;326;1167;856;2812;1182;3979
270230;201412;11555;37236;10109;34920;1506;6205;6544;22190;8050;28395
270235;201412;6608;21348;6221;20708;396;1641;5152;17037;5548;18678
270240;201412;10083;30032;8749;28272;1787;6033;5261;17185;7048;23218
270250;201412;3616;9155;3280;8772;173;444;2976;7997;3149;8441
270255;201412;5219;15846;4255;14117;374;1516;3057;10024;3431;11540
270260;201412;6641;21088;6448;20770;853;3134;4863;15739;5716;18873
270270;201412;1257;3593;1148;3427;218;684;670;1965;888;2649
270280;201412;3866;11215;3577;10797;469;1590;2567;7675;3036;9265
270290;201412;8675;30194;8190;29334;873;3663;6353;22592;7226;26255
270300;201412;3528;11852;3251;11538;216;860;2774;9912;2990;10772
270310;201412;7751;23610;6912;22215;412;1858;5672;17797;6084;19655
270320;201412;6672;21256;6442;20873;1428;5284;3870;12514;5298;17798
270330;201412;4964;16325;4648;15898;488;1800;3697;12752;4185;14552
270340;201412;1851;5663;1661;5406;188;652;1259;4164;1447;4816
270350;201412;2145;5880;1975;5661;265;775;1361;4117;1626;4892
270360;201412;2146;6704;2089;6635;238;718;1722;5614;1960;6332
270370;201412;1765;5698;1620;5446;176;669;1097;3805;1273;4474
270375;201412;3108;9214;2825;8787;405;1541;1903;5651;2308;7192
270380;201412;6182;18779;5823;18289;645;2065;4492;14397;5137;16462
270390;201412;1403;3854;1251;3660;159;560;904;2532;1063;3092
270400;201412;6162;18832;5601;18002;496;1872;4012;12707;4508;14579
270410;201412;5223;16065;4931;15518;615;2108;3562;11129;4177;13237
270420;201412;5810;18840;5626;18587;313;1477;4691;15185;5004;16662
270430;201412;144276;420639;136946;410035;37302;113308;73135;226094;110437;339402
270440;201412;5196;15817;4871;15342;386;1405;3842;12221;4228;13626
270450;201412;6854;21202;6585;20855;584;2163;5295;16779;5879;18942
270460;201412;3748;10141;3370;9629;265;895;2750;7742;3015;8637
270470;201412;11570;36876;10868;35691;1726;5678;7161;24254;8887;29932
270480;201412;3198;9953;2857;9349;358;1410;1903;5997;2261;7407
270490;201412;1014;3260;955;3176;91;361;727;2398;818;2759
270500;201412;5588;18822;5328;18475;494;1757;4285;15226;4779;16983
270510;201412;6266;19136;5695;18327;890;3634;4040;12401;4930;16035
270520;201412;3867;12404;3616;11997;890;3227;1877;6290;2767;9517
270530;201412;1602;4658;1419;4421;206;647;952;3090;1158;3737
270540;201412;2141;7273;1960;7009;173;810;1558;5475;1731;6285
270550;201412;7416;22167;6567;21042;1049;3475;4459;14678;5508;18153
270560;201412;3135;9688;2941;9386;494;1861;2068;6389;2562;8250
270570;201412;4430;14209;4020;13555;459;1914;2803;9323;3262;11237
270580;201412;2165;7045;2075;6907;283;988;1561;5283;1844;6271
270590;201412;1478;4945;1386;4786;65;266;1239;4285;1304;4551
270600;201412;2993;9977;2685;9498;237;1157;2057;7085;2294;8242
270610;201412;3377;10612;3123;10236;312;1128;2482;8091;2794;9219
270620;201412;1555;5131;1414;4918;146;665;1098;3714;1244;4379
270630;201412;18860;52777;17537;50681;2669;7743;12335;36306;15004;44049
270640;201412;6245;19012;5577;18146;469;1888;4505;14413;4974;16301
270642;201412;2536;8686;2362;8412;365;1472;1612;5777;1977;7249
270644;201412;2536;7384;2277;7097;178;507;1955;6215;2133;6722
270650;201412;4214;13260;4038;13012;849;3303;2467;7665;3316;10968
270660;201412;2563;6474;1999;5652;138;497;1422;4009;1560;4506
270670;201412;16886;44736;14644;42076;1972;5542;10824;32239;12796;37781
270680;201412;4353;13095;4180;12895;207;577;3754;11729;3961;12306
270690;201412;9446;26412;8698;25524;2873;8062;4355;13691;7228;21753
270700;201412;811;2514;762;2434;138;518;480;1488;618;2006
270710;201412;6063;20035;5788;19669;642;2335;4608;15771;5250;18106
270720;201412;3510;11746;3221;11251;255;1164;2585;8925;2840;10089
270730;201412;6900;21033;6542;20602;937;2949;5047;16177;5984;19126
270740;201412;2532;7240;2377;7025;359;1202;1651;4804;2010;6006
270750;201412;5128;16259;4738;15663;525;1889;3650;12098;4175;13987
270760;201412;3706;11043;3335;10428;369;1233;2474;7775;2843;9008
270770;201412;19203;51624;16298;48068;3253;9718;10023;30633;13276;40351
270780;201412;1994;6446;1857;6233;252;903;1314;4460;1566;5363
270790;201412;1764;5502;1608;5256;349;1256;939;3014;1288;4270
270800;201412;11900;35127;11095;34042;1020;3417;9023;27699;10043;31116
270810;201412;3591;10888;2872;9563;380;1426;1788;6013;2168;7439
270820;201412;1939;6458;1746;6119;294;1162;1131;3951;1425;5113
270830;201412;5667;16941;5137;16275;1022;3662;3326;10587;4348;14249
270840;201412;7663;25757;7073;25005;419;2050;6029;20963;6448;23013
270850;201412;7884;25574;7687;25332;1464;5774;5272;16655;6736;22429
270860;201412;11915;35539;10985;34265;1745;6307;7790;23775;9535;30082
270870;201412;2367;6943;1915;5996;306;1007;1152;3614;1458;4621
270880;201412;8164;26495;7693;25806;608;2509;6308;20892;6916;23401
270890;201412;2754;8334;2545;7978;411;1508;1766;5409;2177;6917
270895;201412;3122;11460;2959;11246;257;1057;2455;9440;2712;10497
270900;201412;1974;5385;1598;4834;111;413;1213;3604;1324;4017
270910;201412;3378;11567;3283;11389;330;1479;2596;8740;2926;10219
270915;201412;10296;34546;9303;32737;1763;7081;5456;19016;7219;26097
270920;201412;6687;20546;6273;19965;278;1255;5553;17480;5831;18735
270930;201412;17971;48435;14899;44594;2802;8838;9102;28025;11904;36863
270940;201412;6055;20339;5771;20010;672;2646;4444;15454;5116;18100
280010;201412;734;2164;640;2013;70;278;414;1266;484;1544
280020;201412;5225;15441;4562;14236;880;2891;2815;8799;3695;11690
280030;201412;78489;206605;68627;191769;17998;52549;33416;95123;51414;147672
280040;201412;3312;10228;2948;9711;349;1167;2193;7425;2542;8592
280050;201412;4221;13461;3907;12948;1305;4509;1708;5830;3013;10339
280060;201412;4501;14935;4205;14429;906;3321;2468;8592;3374;11913
280067;201412;7886;22239;6692;20585;785;2508;4876;15080;5661;17588
280070;201412;2009;6768;1908;6610;364;1328;1306;4576;1670;5904
280100;201412;4158;12958;3700;12141;961;3254;1827;6144;2788;9398
280110;201412;1475;4443;1355;4249;82;315;1124;3499;1206;3814
280120;201412;7765;24820;7171;23867;1080;3346;5135;17891;6215;21237
280130;201412;7978;22531;7385;21649;1241;4028;4905;14292;6146;18320
280140;201412;5898;15966;5318;15166;590;1664;4116;11901;4706;13565
280150;201412;3603;10996;3310;10452;511;1854;2169;6652;2680;8506
280160;201412;1564;4423;1406;4183;174;587;1019;3014;1193;3601
280170;201412;4895;14519;4413;13833;500;1504;3417;11029;3917;12533
280190;201412;1204;3408;1065;3185;96;376;774;2212;870;2588
280200;201412;1158;3551;1060;3402;164;659;733;2253;897;2912
280210;201412;13844;42723;12733;41119;2539;8359;8203;27308;10742;35667
280220;201412;1642;4984;1538;4837;114;419;1298;4066;1412;4485
280230;201412;3967;11534;3547;10839;659;2016;2125;6687;2784;8703
280240;201412;3597;10595;3267;10077;283;849;2575;8057;2858;8906
280250;201412;861;2275;724;2062;136;446;434;1145;570;1591
280260;201412;2142;5617;1950;5380;118;318;1697;4722;1815;5040
280270;201412;2321;7184;2023;6696;141;549;1579;5164;1720;5713
280280;201412;4246;13839;3914;13287;964;2752;2157;8262;3121;11014
280290;201412;17882;55705;16199;52974;2701;9579;10572;35036;13273;44615
280300;201412;10336;31409;9518;30467;843;2892;7875;25550;8718;28442
280310;201412;1509;4233;1305;3916;117;444;895;2605;1012;3049
280320;201412;8311;27325;7650;26136;1484;5636;4198;14360;5682;19996
280330;201412;5054;14141;4650;13570;576;1857;3566;10366;4142;12223
280340;201412;3919;11482;3695;11180;335;1100;2930;9014;3265;10114
280350;201412;22743;65168;20862;62324;2844;8738;14780;44900;17624;53638
280360;201412;6100;19241;5749;18692;1177;4314;3438;11036;4615;15350
280370;201412;2044;5782;1836;5456;207;702;1350;3942;1557;4644
280380;201412;1047;3184;962;3072;109;415;739;2335;848;2750
280390;201412;3414;9948;2943;9086;600;1794;1785;5595;2385;7389
280400;201412;4633;13264;4210;12683;987;2815;2598;8245;3585;11060
280410;201412;2457;7934;2146;7312;400;1555;1173;3845;1573;5400
280420;201412;4438;12681;4100;12167;253;787;3541;10569;3794;11356
280430;201412;2336;6076;2149;5845;153;512;1792;4853;1945;5365
280440;201412;5229;15171;4868;14735;451;1342;4086;12540;4537;13882
280445;201412;2549;7256;2332;6884;105;393;1928;5606;2033;5999
280450;201412;9342;25197;8556;24247;745;1689;7147;21067;7892;22756
280460;201412;7459;19776;6638;18635;949;2782;4776;13623;5725;16405
280470;201412;1923;5717;1735;5435;215;688;1269;4029;1484;4717
280480;201412;32628;97225;31174;95089;5303;18342;20830;62300;26133;80642
280490;201412;3872;11795;3447;10996;384;1373;2474;7853;2858;9226
280500;201412;896;2407;839;2335;27;86;755;2088;782;2174
280510;201412;2832;8275;2443;7759;305;1085;1813;5813;2118;6898
280520;201412;1795;5083;1641;4882;185;471;1299;4029;1484;4500
280530;201412;2341;6845;2186;6650;226;730;1774;5462;2000;6192
280540;201412;9661;25996;9020;25144;359;1194;8052;22321;8411;23515
280550;201412;6863;18584;5928;17095;659;2086;4301;12349;4960;14435
280560;201412;8232;24085;7711;23260;600;1952;6278;18894;6878;20846
280570;201412;7072;19545;6336;18593;836;2766;4500;13162;5336;15928
280580;201412;5560;17240;4710;15749;900;3037;2871;9915;3771;12952
280590;201412;2447;7400;2224;7123;301;1274;1590;4982;1891;6256
280600;201412;4123;12591;3845;12136;426;1534;2785;8745;3211;10279
280610;201412;2578;7279;2374;6982;308;1064;1655;4756;1963;5820
280620;201412;5445;16392;4795;15159;826;2501;3096;10096;3922;12597
280630;201412;3912;12723;3723;12441;402;1189;2994;10399;3396;11588
280640;201412;2326;6768;2175;6594;102;227;2003;6202;2105;6429
280650;201412;1189;3671;1067;3454;159;572;720;2337;879;2909
280660;201412;2746;7915;2615;7731;410;1186;2019;6026;2429;7212
280670;201412;15541;41139;14553;39786;2440;6938;10014;27383;12454;34321
280680;201412;2935;7779;2492;7145;171;543;2063;5919;2234;6462
280690;201412;1039;2934;894;2724;130;419;608;1828;738;2247
280700;201412;1200;3510;1041;3270;105;316;759;2444;864;2760
280710;201412;11551;31155;10720;30164;814;2090;9105;26040;9919;28130
280720;201412;2463;6670;2167;6332;274;833;1547;4602;1821;5435
280730;201412;976;2924;929;2858;76;227;785;2460;861;2687
280740;201412;13482;36518;11688;33849;1850;5236;7791;23179;9641;28415
280750;201412;3667;11204;3340;10629;343;1276;2390;7558;2733;8834
280760;201412;6013;18424;5482;17702;748;2442;3935;13186;4683;15628
290010;201412;3127;6995;2223;5598;70;286;1785;4256;1855;4542
290020;201412;5001;15856;4562;15399;389;1088;3964;13768;4353;14856
290030;201412;3408;10675;3230;10389;460;1556;2392;7692;2852;9248
290035;201412;4807;12613;4270;11927;300;901;3479;9978;3779;10879
290040;201412;3933;11259;3526;10783;264;1019;2867;8646;3131;9665
290050;201412;2775;9026;2579;8723;237;902;1981;6733;2218;7635
290060;201412;1362;3460;1137;3186;205;655;812;2213;1017;2868
290070;201412;32398;83646;27775;77859;6033;17056;15132;44698;21165;61754
290080;201412;6192;18723;5391;17678;671;2199;4039;13661;4710;15860
290090;201412;2323;5081;1848;4585;200;475;1521;3859;1721;4334
290100;201412;10515;29847;9268;27829;1592;4813;5801;18060;7393;22873
290110;201412;5468;16397;5222;15984;881;2979;3541;10675;4422;13654
290115;201412;5114;15146;4460;14263;351;1180;3483;11345;3834;12525
290120;201412;7142;19139;6461;18303;413;1163;5591;15932;6004;17095
290130;201412;4650;12239;3966;11411;302;1030;3207;9067;3509;10097
290135;201412;5377;13599;4647;12458;431;1383;3188;8395;3619;9778
290140;201412;4265;13389;3676;12611;327;1189;3042;10511;3369;11700
290150;201412;2178;6490;2073;6313;175;543;1757;5375;1932;5918
290160;201412;3600;9706;3503;9587;276;513;3128;8827;3404;9340
290170;201412;2910;9696;2677;9329;234;928;2232;7791;2466;8719
290180;201412;3149;8978;2747;8374;281;961;2047;6276;2328;7237
290190;201412;4240;13974;4085;13717;444;1543;3094;10523;3538;12066
290195;201412;2257;6227;1918;5722;144;515;1521;4538;1665;5053
290200;201412;3986;12646;3611;12004;376;1308;2761;9242;3137;10550
290205;201412;3116;9571;2824;9109;361;1399;2035;6427;2396;7826
290210;201412;15851;43833;14691;42410;2881;7276;9832;30676;12713;37952
290220;201412;2511;7550;2389;7358;277;1036;1767;5291;2044;6327
290225;201412;3157;8339;2951;8120;181;360;2657;7526;2838;7886
290230;201412;2426;7965;2359;7880;212;751;1987;6700;2199;7451
290240;201412;3990;10514;3592;9960;367;1091;2720;7457;3087;8548
290250;201412;3936;12395;3337;11470;267;958;2613;9120;2880;10078
290260;201412;5105;15073;4532;14205;452;1561;3527;11064;3979;12625
290265;201412;3518;11218;3260;10768;307;1193;2497;8227;2804;9420
290270;201412;12717;45639;11896;44372;1713;6700;8597;32635;10310;39335
290280;201412;5391;17594;5063;17012;473;1679;3838;13162;4311;14841
290290;201412;10027;32060;9113;30541;1637;5620;5997;20564;7634;26184
290300;201412;4499;12894;3183;10410;266;866;2203;7475;2469;8341
290310;201412;1590;4725;1427;4470;250;860;873;2705;1123;3565
290320;201412;28420;85741;24794;80791;6056;20785;13645;45400;19701;66185
290323;201412;4209;11014;3468;10208;213;704;2933;8581;3146;9285
290327;201412;4234;13381;3842;12659;651;2227;2513;8309;3164;10536
290330;201412;1998;5138;1873;4999;217;645;1549;4090;1766;4735
290340;201412;4654;14943;4395;14604;1220;4003;2533;8621;3753;12624
290350;201412;5133;15374;4245;14163;585;1972;2895;9951;3480;11923
290360;201412;4479;13854;3913;13082;211;749;3332;11286;3543;12035
290370;201412;4806;13967;4357;13414;449;1369;3588;11213;4037;12582
290380;201412;5690;16568;4982;15523;424;1441;3951;12366;4375;13807
290390;201412;15952;49646;14855;47868;3030;9612;9123;30690;12153;40302
290395;201412;2840;9156;2553;8659;224;931;1927;6521;2151;7452
290400;201412;3819;11421;3332;10737;366;1207;2523;8177;2889;9384
290405;201412;4615;14693;3976;13537;521;1833;2631;9226;3152;11059
290410;201412;6254;18456;5215;16915;593;2318;3713;11795;4306;14113
290420;201412;3440;10060;2845;9218;275;999;2224;7179;2499;8178
290430;201412;3616;11229;3222;10604;675;2357;1955;6495;2630;8852
290440;201412;3192;8329;2558;7487;242;780;1988;5905;2230;6685
290450;201412;3698;10718;3225;10041;543;1738;2121;6726;2664;8464
290460;201412;14204;42352;12910;40233;3688;12157;5738;17815;9426;29972
290470;201412;4870;13372;3796;11909;875;3037;1970;6333;2845;9370
290475;201412;5190;17844;4687;16922;546;2335;3330;11931;3876;14266
290480;201412;2698;7045;2386;6630;386;1126;1562;4431;1948;5557
290485;201412;5011;15874;4437;15025;459;2000;3482;11641;3941;13641
290490;201412;8501;22547;8167;22108;739;2139;6735;18209;7474;20348
290500;201412;4713;14850;3925;13365;761;2816;1975;6675;2736;9491
290510;201412;3552;10294;3092;9656;237;860;2484;7795;2721;8655
290515;201412;3103;9319;2791;8879;249;779;2200;7163;2449;7942
290520;201412;12089;37310;9804;33086;990;4083;6338;21160;7328;25243
290530;201412;5480;15695;4673;14531;433;1386;3707;11593;4140;12979
290540;201412;4038;11672;3836;11413;469;1301;3021;9240;3490;10541
290550;201412;4513;12193;3968;11534;170;494;3574;10468;3744;10962
290560;201412;5876;17787;5234;16806;1160;3975;3005;9807;4165;13782
290570;201412;42559;121894;39636;117532;5166;16232;28666;84622;33832;100854
290580;201412;7634;26186;7266;25631;1303;4558;5028;18305;6331;22863
290590;201412;7833;24568;6540;22383;466;1917;5138;17543;5604;19460
290600;201412;18887;57543;17400;55180;3330;10269;10974;36468;14304;46737
290610;201412;2486;8470;2091;7681;194;893;1515;5468;1709;6361
290620;201412;7332;21708;6534;20546;484;1641;5380;16986;5864;18627
290630;201412;8642;22983;7608;21881;831;2373;6209;18078;7040;20451
290640;201412;2813;8264;2327;7444;248;844;1664;5328;1912;6172
290650;201412;12401;36251;11628;35145;2788;8388;7102;22127;9890;30515
290660;201412;3846;10562;3141;9554;215;730;2486;7635;2701;8365
290670;201412;7233;22061;6552;20988;858;2684;4823;15944;5681;18628
290680;201412;10388;30795;9502;29733;598;2027;7953;25094;8551;27121
290682;201412;4657;13536;4170;12855;196;755;3486;10647;3682;11402
290685;201412;3440;8674;2507;7361;320;1022;1528;4585;1848;5607
290687;201412;8492;22866;6661;20497;1543;4959;3650;11547;5193;16506
290689;201412;3236;9246;2729;8452;251;818;2131;6706;2382;7524
290690;201412;5702;16524;5181;15855;553;1752;4100;12663;4653;14415
290700;201412;2316;7248;2195;7065;203;742;1733;5587;1936;6329
290710;201412;8065;25459;7455;24542;487;1572;6401;21339;6888;22911
290720;201412;19545;56938;17438;54356;1760;5013;14319;45955;16079;50968
290730;201412;7560;20998;6857;20075;1179;3392;4712;14015;5891;17407
290740;201412;968;2885;818;2638;116;394;530;1745;646;2139
290750;201412;10730;30387;9051;27276;1780;6090;4865;13975;6645;20065
290755;201412;2485;6953;2056;6234;135;478;1588;4795;1723;5273
290760;201412;4599;13451;3731;12120;434;1326;2615;8653;3049;9979
290770;201412;2698;9383;2497;9124;139;632;2036;7504;2175;8136
290780;201412;9291;23854;8165;22309;864;1967;6291;17863;7155;19830
290790;201412;4934;14492;4557;13963;415;1232;3630;11466;4045;12698
290800;201412;7734;16559;6045;14767;805;1760;4482;11568;5287;13328
290810;201412;5186;16364;4450;15189;320;1206;3387;11681;3707;12887
290820;201412;5611;15987;5007;15180;476;1601;3882;11808;4358;13409
290830;201412;4210;11693;3928;11257;251;936;3214;8974;3465;9910
290840;201412;18551;52033;16788;49593;2843;8052;11392;35194;14235;43246
290850;201412;7003;20622;6845;20397;1085;3079;5228;16107;6313;19186
290860;201412;5078;17639;4747;17221;680;2496;3528;13202;4208;15698
290870;201412;5008;14869;4134;13617;433;1723;2999;9789;3432;11512
290880;201412;1469;4055;1182;3593;111;342;817;2513;928;2855
290890;201412;7165;19034;6237;17977;749;2122;4917;14402;5666;16524
290900;201412;2562;7325;1880;6162;297;1031;949;3120;1246;4151
290910;201412;5060;13789;4307;12699;257;811;3603;10675;3860;11486
290920;201412;5073;14740;4562;14038;336;942;3759;11784;4095;12726
290930;201412;7916;24946;7064;23495;677;2662;5293;17362;5970;20024
290940;201412;3642;11594;3390;11264;291;959;2864;9740;3155;10699
290950;201412;1601;4502;1432;4254;206;613;989;2997;1195;3610
290960;201412;6190;17438;5642;16713;393;1189;4606;13806;4999;14995
290970;201412;3823;12215;3443;11542;484;1625;2209;7634;2693;9259
290980;201412;11090;32543;9598;29685;2788;9042;3655;11223;6443;20265
290990;201412;9483;28409;8313;26500;954;3199;6214;19821;7168;23020
291000;201412;3351;9991;3080;9640;347;1110;2447;7782;2794;8892
291005;201412;14566;39960;13056;37802;2103;6391;8957;26277;11060;32668
291010;201412;3220;10287;2579;8873;311;1140;1650;5732;1961;6872
291020;201412;1448;3828;1113;3234;138;476;675;1872;813;2348
291030;201412;2320;6335;1704;5099;192;629;1063;3098;1255;3727
291040;201412;5921;17946;5375;17176;655;2316;4028;12862;4683;15178
291050;201412;8236;27250;7477;25786;2063;7746;3663;12480;5726;20226
291060;201412;6470;23593;6119;23112;893;3829;4368;16456;5261;20285
291070;201412;17065;49355;15407;46980;1728;5275;11503;35713;13231;40988
291072;201412;23309;70475;19531;62969;5901;20183;7568;25129;13469;45312
291075;201412;5432;15476;4898;14768;392;1078;3776;11782;4168;12860
291077;201412;1607;4619;1322;4161;159;570;873;2721;1032;3291
291080;201412;85978;265365;76115;246836;24785;82858;26552;85269;51337;168127
291085;201412;5967;15768;5160;14688;559;1643;4041;11603;4600;13246
291090;201412;1540;3807;1343;3555;103;389;1105;2830;1208;3219
291100;201412;2726;7117;2232;6603;121;459;1881;5554;2002;6013
291110;201412;5242;18590;4688;17726;686;2922;3213;12059;3899;14981
291120;201412;7854;20965;7264;20111;947;2670;5408;15103;6355;17773
291125;201412;1838;3858;1451;3449;133;319;1115;2710;1248;3029
291130;201412;3055;9351;2649;8667;245;940;1901;6145;2146;7085
291140;201412;4345;12856;3891;12023;581;1815;2644;8257;3225;10072
291150;201412;2048;5353;1947;5233;176;503;1521;4066;1697;4569
291160;201412;5661;17465;4927;16317;1262;4208;2679;9054;3941;13262
291165;201412;2563;7421;2021;6392;118;511;1465;4500;1583;5011
291170;201412;21568;55978;18553;52156;1118;3760;14752;41265;15870;45025
291180;201412;6692;17513;5392;15624;643;2065;3809;10963;4452;13028
291185;201412;3994;10850;3680;10424;323;977;3044;8599;3367;9576
291190;201412;7769;21312;6909;20248;803;2416;5352;15951;6155;18367
291200;201412;2833;8557;2327;7623;188;646;1676;5566;1864;6212
291210;201412;7841;18467;6744;17205;540;1445;5430;13894;5970;15339
291220;201412;4367;13827;4071;13329;570;2071;2892;9390;3462;11461
291230;201412;4157;10706;3729;10216;122;300;3414;9464;3536;9764
291240;201412;5008;13376;4227;12012;260;782;3393;9530;3653;10312
291250;201412;3848;11499;3022;10097;340;1182;2055;6950;2395;8132
291260;201412;1199;3496;1108;3367;112;384;850;2570;962;2954
291270;201412;4363;14473;4008;13818;1136;4096;2176;7625;3312;11721
291280;201412;2492;6517;1872;5649;460;1448;1021;3069;1481;4517
291290;201412;6115;17069;5433;16204;893;2663;3549;10910;4442;13573
291300;201412;4715;13680;3930;12374;482;1715;2715;8469;3197;10184
291310;201412;5657;16034;4838;14604;382;1205;3765;11370;4147;12575
291320;201412;6356;20168;5445;18417;1298;4820;2876;9596;4174;14416
291330;201412;1733;5222;1576;4966;217;787;1036;3164;1253;3951
291340;201412;4192;12052;3346;10834;273;1016;2637;8503;2910;9519
291345;201412;3619;11652;3387;11395;222;704;2976;10262;3198;10966
291350;201412;5963;17618;5246;16390;421;1417;3968;12532;4389;13949
291360;201412;36783;105221;33932;101016;8713;25715;19723;60817;28436;86532
291370;201412;9363;27047;8919;26469;947;2740;6916;21055;7863;23795
291380;201412;3930;12037;3388;11144;279;964;2498;8414;2777;9378
291390;201412;10923;29957;9934;28787;1462;4074;7458;22008;8920;26082
291400;201412;17536;45671;14277;41290;2529;7257;8973;27061;11502;34318
291410;201412;3421;8891;2527;7587;193;768;1912;5581;2105;6349
291420;201412;2292;6067;2013;5730;125;380;1751;5001;1876;5381
291430;201412;3506;10128;3086;9580;241;962;2430;7396;2671;8358
291440;201412;6402;19886;5466;18236;575;2017;4092;13806;4667;15823
291450;201412;7990;24349;7101;23032;346;1099;5923;19682;6269;20781
291460;201412;14169;42331;12507;39729;2312;7833;7726;24775;10038;32608
291465;201412;8778;24997;7914;24008;776;2519;6430;19617;7206;22136
291470;201412;16488;45047;14526;42612;1477;4210;10947;33292;12424;37502
291480;201412;37136;99307;32808;93307;5142;16245;21463;60699;26605;76944
291490;201412;4641;15100;4509;14918;473;1545;3683;12428;4156;13973
291500;201412;4358;12590;3721;11667;291;1061;2946;9214;3237;10275
291510;201412;3804;11447;3491;11031;148;470;3143;10030;3291;10500
291520;201412;4191;11209;3636;10447;522;1475;2403;7161;2925;8636
291530;201412;2199;6330;1864;5812;477;1588;967;3099;1444;4687
291535;201412;4488;12928;4021;12246;332;1054;3098;9748;3430;10802
291540;201412;2356;5614;2001;5243;189;391;1693;4594;1882;4985
291550;201412;5862;15697;5222;14811;1220;3412;3020;8739;4240;12151
291560;201412;18449;45916;14031;40864;1327;3906;10810;32318;12137;36224
291570;201412;2546;6745;2408;6581;162;378;2162;6029;2324;6407
291580;201412;5704;17431;5049;16463;627;2480;3626;11751;4253;14231
291590;201412;2050;6312;1840;5969;276;920;1232;4163;1508;5083
291600;201412;5732;15711;4266;13504;1043;3624;1995;6185;3038;9809
291610;201412;5343;16109;5168;15878;354;1153;4437;13750;4791;14903
291620;201412;3189;7512;2617;6904;196;484;2062;5657;2258;6141
291630;201412;3286;8184;2838;7671;305;814;2260;6209;2565;7023
291640;201412;18637;50373;15203;45640;4217;13444;5803;17713;10020;31157
291650;201412;8450;24880;7732;24021;689;1770;6473;20800;7162;22570
291660;201412;2559;6625;2165;6067;235;792;1484;3997;1719;4789
291670;201412;2554;7022;2344;6696;370;1059;1412;4314;1782;5373
291680;201412;5156;14510;4601;13602;1100;3574;2264;6939;3364;10513
291685;201412;4874;12061;4053;11013;569;1514;2864;8064;3433;9578
291690;201412;4159;11258;3396;10038;318;932;2410;7203;2728;8135
291700;201412;9842;30380;8905;28768;1034;3435;6577;21643;7611;25078
291710;201412;6313;16522;5422;15377;896;2638;3453;10275;4349;12913
291720;201412;4236;14217;3674;13060;391;1621;2639;9256;3030;10877
291730;201412;6417;19621;5849;18857;961;3289;4171;13706;5132;16995
291733;201412;2708;7907;2280;7335;313;1090;1536;4966;1849;6056
291735;201412;2619;7416;2206;6793;129;472;1793;5452;1922;5924
291740;201412;4162;11991;3318;10704;349;1278;2381;7665;2730;8943
291750;201412;23191;60048;18007;52167;4130;12398;9372;27685;13502;40083
291760;201412;12979;40303;11615;37884;4530;16371;3968;12750;8498;29121
291770;201412;8376;23998;7408;22316;1178;3831;4879;14519;6057;18350
291780;201412;4543;13760;4250;13231;435;1366;3336;10426;3771;11792
291790;201412;2624;8102;2484;7908;122;502;2144;6757;2266;7259
291800;201412;33926;95611;30161;90283;6002;18375;18447;56961;24449;75336
291810;201412;11398;31637;9612;29492;626;2223;7854;24184;8480;26407
291820;201412;3816;11306;3428;10741;298;969;2694;8524;2992;9493
291830;201412;4560;12210;4202;11697;486;1423;3202;8983;3688;10406
291835;201412;6437;19879;5197;17730;1344;4950;2862;9721;4206;14671
291840;201412;51577;140279;43665;131641;5808;16862;32970;102587;38778;119449
291845;201412;3109;8893;2779;8502;229;625;2422;7561;2651;8186
291850;201412;4970;13831;4046;12437;439;1284;3042;9648;3481;10932
291855;201412;1803;4659;1556;4340;185;652;1151;3084;1336;3736
291860;201412;2173;6320;1823;5661;166;624;1196;3645;1362;4269
291870;201412;1445;3849;1084;3200;120;407;670;1957;790;2364
291875;201412;2972;9402;2674;8939;225;948;1943;6366;2168;7314
291880;201412;4870;15469;4573;14992;366;1199;3784;12543;4150;13742
291890;201412;1460;3661;1230;3383;313;877;729;2079;1042;2956
291900;201412;1356;3768;1148;3443;103;356;891;2658;994;3014
291905;201412;3061;8051;2505;7139;226;734;1760;5030;1986;5764
291910;201412;2787;7471;2365;6963;173;627;1954;5701;2127;6328
291915;201412;7317;22114;6232;20102;492;1657;4993;16356;5485;18013
291920;201412;33214;97152;30509;93075;6281;19874;18179;56647;24460;76521
291930;201412;2671;7896;2395;7457;246;853;1777;5528;2023;6381
291940;201412;3647;10316;2641;8470;410;1479;1483;4587;1893;6066
291950;201412;9570;31999;8669;30513;1840;6477;4968;18052;6808;24529
291955;201412;9569;29830;9108;29178;2161;6833;5469;18266;7630;25099
291960;201412;3449;10157;2884;9331;333;1001;2075;7060;2408;8061
291970;201412;4467;13380;3973;12739;560;1904;2772;9000;3332;10904
291980;201412;11794;33928;9008;29893;968;3354;6435;21848;7403;25202
291990;201412;2385;7211;2162;6882;170;574;1684;5497;1854;6071
291992;201412;2954;9036;2875;8879;450;1470;2110;6470;2560;7940
291995;201412;2249;6527;2004;6166;244;802;1510;4685;1754;5487
292000;201412;2328;6759;2054;6364;318;1126;1440;4411;1758;5537
292010;201412;6639;16851;5060;14541;495;1431;3874;11198;4369;12629
292020;201412;4632;15490;4292;14941;714;2594;2978;10551;3692;13145
292030;201412;2265;6974;2007;6590;265;938;1201;3980;1466;4918
292040;201412;4821;13206;4240;12599;331;857;3593;11103;3924;11960
292045;201412;2865;9768;2817;9699;97;317;2654;9152;2751;9469
292050;201412;6560;20346;5712;18641;557;2184;3863;12438;4420;14622
292060;201412;11995;32375;11209;31385;1106;2969;9126;25810;10232;28779
292070;201412;4607;14456;4463;14272;410;1218;3788;12285;4198;13503
292080;201412;3866;9888;3288;9150;271;778;2654;7467;2925;8245
292090;201412;4432;11558;3754;10783;322;1059;3067;8862;3389;9921
292100;201412;11343;31220;9525;28646;2768;8658;4223;13288;6991;21946
292105;201412;3280;10011;2830;9352;219;861;2265;7474;2484;8335
292110;201412;7305;19186;5584;16610;1239;3725;3164;9716;4403;13441
292120;201412;8832;24508;7750;22608;1667;4934;4041;12517;5708;17451
292130;201412;3227;8666;2860;8141;566;1518;1865;5476;2431;6994
292140;201412;5681;14529;4894;13456;1000;2653;3002;8689;4002;11342
292145;201412;2772;8462;2523;8075;205;648;1916;6407;2121;7055
292150;201412;13934;42168;12875;40495;912;3237;10112;32196;11024;35433
292160;201412;2853;8141;2453;7613;163;476;2095;6640;2258;7116
292170;201412;9471;27054;7991;24518;1140;3888;5048;15555;6188;19443
292180;201412;3658;10435;2899;9230;442;1381;1866;6087;2308;7468
292190;201412;3454;9672;2920;8901;594;1892;1811;5624;2405;7516
292200;201412;6609;21344;5729;19621;1667;6191;2377;8110;4044;14301
292205;201412;4132;12669;3713;12080;268;998;2993;9726;3261;10724
292210;201412;6929;19025;5841;17569;523;1696;4571;13967;5094;15663
292220;201412;2022;5603;1861;5381;385;1061;1139;3334;1524;4395
292225;201412;3218;9924;2951;9535;192;702;2442;7950;2634;8652
292230;201412;6535;19599;6208;19083;543;2186;4796;14248;5339;16434
292240;201412;4583;14177;4172;13297;593;2004;2713;8575;3306;10579
292250;201412;5289;16334;4894;15576;1160;3844;2457;7851;3617;11695
292260;201412;3289;10000;3126;9762;291;969;2539;7949;2830;8918
292265;201412;2939;9458;2627;8903;194;795;1977;6636;2171;7431
292270;201412;4228;10864;3348;9843;224;785;2764;8146;2988;8931
292273;201412;2883;6978;2222;6157;296;762;1607;4714;1903;5476
292275;201412;1956;5081;1744;4756;219;638;1285;3489;1504;4127
292280;201412;2119;6287;1914;6064;196;473;1495;5089;1691;5562
292285;201412;2732;7514;2377;7008;204;668;1855;5545;2059;6213
292290;201412;7665;22721;6398;21004;477;1772;5007;16654;5484;18426
292300;201412;9143;27331;7824;25779;1936;6550;4764;16185;6700;22735
292303;201412;2960;9119;2750;8834;129;496;2376;7608;2505;8104
292305;201412;3271;8794;3090;8551;128;383;2772;7699;2900;8082
292310;201412;6293;18329;5734;17559;256;881;4861;14910;5117;15791
292320;201412;6628;19217;5715;17670;575;1930;4385;13564;4960;15494
292330;201412;2099;5822;1959;5628;193;633;1554;4394;1747;5027
292335;201412;5532;14410;4932;13624;539;1440;3970;11131;4509;12571
292340;201412;6775;19132;5732;17443;660;2055;3993;12275;4653;14330
292350;201412;2256;6792;2067;6537;233;855;1622;5116;1855;5971
292360;201412;5227;14668;5026;14140;195;524;4433;12785;4628;13309
292370;201412;9468;27442;8562;26101;1122;3217;6135;19570;7257;22787
292380;201412;7684;22277;7143;21427;570;1587;5882;17904;6452;19491
292390;201412;3846;8608;3373;8094;120;203;3140;7640;3260;7843
292400;201412;22760;67597;21632;65796;3341;10637;15189;47029;18530;57666
292405;201412;4718;12119;3994;11211;280;778;3295;9332;3575;10110
292410;201412;1999;5349;1890;5226;142;379;1649;4596;1791;4975
292420;201412;3949;12595;3777;12379;170;474;3433;11484;3603;11958
292430;201412;5802;17235;4523;15434;348;1391;3375;11492;3723;12883
292440;201412;8916;29081;8230;28071;309;1215;7241;25024;7550;26239
292450;201412;4496;13275;3635;11892;359;1231;2599;8659;2958;9890
292460;201412;5778;17150;5043;15847;968;3184;3128;9902;4096;13086
292465;201412;2564;7635;2124;6925;231;859;1484;4880;1715;5739
292467;201412;2097;6765;1983;6573;368;1308;1311;4403;1679;5711
292470;201412;3314;8758;2699;7777;228;752;2041;5840;2269;6592
292480;201412;6641;17427;5682;16131;331;1068;4844;13735;5175;14803
292490;201412;2419;6635;2019;6051;181;633;1565;4641;1746;5274
292500;201412;6830;20335;5888;18700;705;2395;4135;13332;4840;15727
292510;201412;13813;39022;12116;36594;1222;3878;9329;28680;10551;32558
292520;201412;6208;18563;5579;17565;1579;5048;2860;9128;4439;14176
292525;201412;5749;14933;4934;13974;357;1081;4051;11588;4408;12669
292530;201412;27763;81391;24861;77458;6412;20625;13296;42865;19708;63490
292540;201412;3004;8505;2687;8078;332;1131;2043;6142;2375;7273
292550;201412;6977;22090;6127;20896;821;2980;4427;15457;5248;18437
292560;201412;4328;11827;3656;10906;289;1060;2946;8643;3235;9703
292570;201412;4229;12422;4048;12228;158;434;3593;11235;3751;11669
292575;201412;6360;21452;6171;21141;907;3235;4681;16076;5588;19311
292580;201412;7281;21477;6720;20758;555;1704;5560;17429;6115;19133
292590;201412;7627;23480;7259;22880;815;2681;5581;17608;6396;20289
292593;201412;3354;8710;2825;7932;270;764;2199;6174;2469;6938
292595;201412;6301;17337;5478;16259;500;1577;4220;12647;4720;14224
292600;201412;11008;30979;10165;29903;989;2367;8273;25186;9262;27553
292610;201412;4540;13056;3665;11567;400;1315;2438;7885;2838;9200
292620;201412;6122;17892;5300;16933;209;675;4834;15588;5043;16263
292630;201412;10166;25629;8695;23424;865;2385;6468;17769;7333;20154
292640;201412;8618;27365;7645;26053;626;2260;5903;20585;6529;22845
292650;201412;5175;13931;4930;13601;496;970;4108;12006;4604;12976
292660;201412;11696;34872;10920;33749;1302;4179;8307;26144;9609;30323
292665;201412;2714;8118;2635;8003;62;150;2508;7693;2570;7843
292670;201412;4019;11308;3101;9752;301;1043;2025;6403;2326;7446
292680;201412;3795;11404;3527;10987;425;1250;2743;8661;3168;9911
292690;201412;3482;9326;2472;7738;295;990;1655;5290;1950;6280
292700;201412;9225;27640;8099;25972;1116;3321;5689;19077;6805;22398
292710;201412;2018;6621;1913;6468;83;309;1720;5844;1803;6153
292720;201412;10075;25580;8747;24068;701;1947;7346;20461;8047;22408
292730;201412;3696;11126;3550;10913;445;1382;2631;8209;3076;9591
292740;201412;384437;1057499;363331;1026453;82330;244826;219756;619910;302086;864736
292750;201412;6506;17473;5647;16293;392;1163;4626;13496;5018;14659
292760;201412;4356;13719;3965;13035;575;2007;2608;8690;3183;10697
292770;201412;6337;19173;5889;18462;1304;4110;3620;11687;4924;15797
292780;201412;1946;4673;1513;4127;180;613;1093;2923;1273;3536
292790;201412;3561;9203;3397;9027;229;470;2962;8173;3191;8643
292800;201412;9847;29372;9113;28173;843;2908;7160;22080;8003;24988
292805;201412;3310;9502;3000;9063;549;1775;2033;6153;2582;7928
292810;201412;10355;30931;8642;28602;1181;4062;6207;21017;7388;25079
292820;201412;7750;21970;5631;18907;392;1543;4481;15102;4873;16645
292830;201412;1969;5786;1787;5531;101;419;1497;4564;1598;4983
292840;201412;8000;24873;7479;24146;389;1447;6590;21170;6979;22617
292850;201412;3352;8858;2759;7980;309;954;1992;5711;2301;6665
292860;201412;15873;42824;15098;41791;1880;5366;11659;32441;13539;37807
292870;201412;20506;56480;17875;52385;2953;9489;10759;31186;13712;40675
292880;201412;12698;36785;11300;34708;1460;4911;7771;23658;9231;28569
292890;201412;5970;20176;5349;19019;968;3651;3187;11569;4155;15220
292895;201412;2839;7050;2251;6168;318;886;1611;4391;1929;5277
292900;201412;3173;9766;2989;9481;354;1394;2089;6400;2443;7794
292905;201412;4439;12775;3671;11762;249;704;3019;9963;3268;10667
292910;201412;5325;16145;4816;15204;842;2893;2970;9300;3812;12193
292920;201412;9108;27001;8603;26242;814;2813;6787;20222;7601;23035
292925;201412;5339;16349;4695;15430;472;1592;3569;11847;4041;13439
292930;201412;6698;21568;6374;20986;642;2654;4775;15375;5417;18029
292935;201412;2203;6202;1829;5796;113;283;1557;5136;1670;5419
292937;201412;3388;8629;2834;7932;299;950;2185;6050;2484;7000
292940;201412;3221;8829;2537;7876;320;1004;1732;5587;2052;6591
292950;201412;8639;25967;8158;25133;992;3594;5883;17657;6875;21251
292960;201412;5184;13733;4532;12826;455;1401;3334;9365;3789;10766
292970;201412;4547;13580;4030;12906;203;818;3363;10802;3566;11620
292975;201412;3572;9671;3386;9403;373;996;2798;7879;3171;8875
292980;201412;3726;9951;2975;8973;377;1296;2064;6168;2441;7464
292990;201412;12552;35926;11281;34006;704;2245;9521;28756;10225;31001
293000;201412;3042;7924;2512;7250;123;414;2156;6234;2279;6648
293010;201412;19669;54895;17009;50639;3036;9795;10361;30716;13397;40511
293015;201412;8283;26671;6680;24163;1033;4128;4310;15523;5343;19651
293020;201412;9751;32127;9098;31203;625;2448;7512;25988;8137;28436
293030;201412;5843;16828;4645;15002;448;1485;3242;10930;3690;12415
293040;201412;3688;12136;3514;11794;187;684;3113;10431;3300;11115
293050;201412;21247;59315;18779;56136;2800;8582;12656;38741;15456;47323
293060;201412;4452;11408;3697;10206;419;1239;2543;6979;2962;8218
293070;201412;22004;65610;19788;61869;5323;16882;10049;32323;15372;49205
293075;201412;3513;11472;3180;11011;262;964;2570;8987;2832;9951
293076;201412;3872;10773;3565;10334;266;738;2985;8822;3251;9560
293077;201412;5138;15865;4453;14962;1105;3912;2443;8295;3548;12207
293080;201412;4947;15583;4493;14846;327;1432;3535;11443;3862;12875
293090;201412;3684;11452;3002;10477;304;1092;2251;7983;2555;9075
293100;201412;6026;18096;5115;16501;564;1943;3738;12191;4302;14134
293105;201412;4019;13376;3541;12457;500;1852;2415;8645;2915;10497
293110;201412;2087;6113;1895;5817;126;450;1555;4752;1681;5202
293120;201412;4179;13681;3865;13228;392;1276;3025;10620;3417;11896
293130;201412;4204;11734;3437;10865;191;670;3035;9729;3226;10399
293135;201412;31128;79129;23448;68328;4840;16301;10913;31276;15753;47577
293140;201412;2192;6365;2097;6224;214;748;1602;4652;1816;5400
293150;201412;5955;19526;5300;18247;1025;3674;3151;11175;4176;14849
293160;201412;3727;9945;3471;9651;471;945;2697;7989;3168;8934
293170;201412;3573;10675;3276;10222;472;1603;2283;7198;2755;8801
293180;201412;5230;14743;4259;13206;243;938;3429;10460;3672;11398
293190;201412;14331;43350;13455;42028;589;2612;11638;35739;12227;38351
293200;201412;6736;19280;5903;18157;286;1023;5021;15493;5307;16516
293210;201412;5255;15247;4754;14419;471;1571;3557;10813;4028;12384
293220;201412;5415;16097;4778;15008;1235;4012;2321;7406;3556;11418
293230;201412;4134;12785;3771;12242;601;2123;2633;8581;3234;10704
293240;201412;4687;12390;3634;10740;180;575;2806;8273;2986;8848
293245;201412;4631;13149;4197;12473;471;1416;3053;9336;3524;10752
293250;201412;6090;17057;5563;16269;666;2063;4037;11802;4703;13865
293260;201412;4921;14598;4086;13380;375;1338;3039;10057;3414;11395
293270;201412;5958;16194;5628;15840;535;1328;4857;13998;5392;15326
293280;201412;5804;16144;4999;15086;454;1271;3871;12052;4325;13323
293290;201412;16903;56261;15888;54237;3822;13581;8473;29492;12295;43073
293300;201412;7010;17024;5961;15831;468;1164;4838;13066;5306;14230
293305;201412;4962;12319;4301;11413;263;752;3593;9546;3856;10298
293310;201412;2832;7223;2285;6322;238;706;1599;4388;1837;5094
293315;201412;5050;12653;4532;11891;724;1862;2907;8044;3631;9906
293317;201412;2649;7711;2366;7191;273;872;1564;4752;1837;5624
293320;201412;8319;27579;8084;27286;676;2454;6846;23207;7522;25661
293325;201412;1971;5702;1642;5193;240;821;1118;3576;1358;4397
293330;201412;56400;178639;50642;168651;11556;41381;26722;89830;38278;131211
293340;201412;2761;7869;2172;6827;312;1096;1450;4462;1762;5558
293345;201412;3750;10955;3127;10091;356;1135;2284;7632;2640;8767
293350;201412;6935;19354;6599;18963;395;964;5883;17313;6278;18277
293360;201412;14275;43102;12944;41368;875;2766;11037;35933;11912;38699
310010;201412;1231;3329;895;2799;227;856;372;1059;599;1915
310020;201412;3920;12448;3248;10974;1111;4039;602;1850;1713;5889
310030;201412;2660;8569;2265;7855;636;2394;1145;3906;1781;6300
310040;201412;1056;2868;877;2617;87;297;664;1967;751;2264
310050;201412;1969;6805;1753;6294;342;1435;888;3138;1230;4573
310060;201412;3365;10988;2999;10501;376;1387;2270;8048;2646;9435
310070;201412;329;936;255;797;29;122;145;414;174;536
310080;201412;813;2492;664;2207;177;685;232;700;409;1385
310090;201412;5061;14959;4355;13721;676;2363;2686;8463;3362;10826
310100;201412;3507;10583;2903;9567;276;1095;2165;7085;2441;8180
310110;201412;6140;17206;5118;15644;1130;3932;2826;8531;3956;12463
310120;201412;635;2015;572;1905;209;838;249;705;458;1543
310130;201412;480;1491;438;1424;102;392;229;692;331;1084
310140;201412;267;927;233;864;82;343;52;164;134;507
310150;201412;5210;16056;4647;14998;1049;3777;2301;7384;3350;11161
310160;201412;7997;25389;6654;22958;2017;7695;2349;8046;4366;15741
310163;201412;903;2989;769;2716;208;815;299;1015;507;1830
310170;201412;10365;29098;9473;27773;1655;4987;6156;18689;7811;23676
310180;201412;1944;5627;1584;5114;413;1498;757;2362;1170;3860
310190;201412;2646;8888;2402;8477;761;2970;438;1592;1199;4562
310200;201412;1999;6689;1672;6011;480;1913;585;2056;1065;3969
310205;201412;1128;3323;915;2971;179;588;530;1770;709;2358
310210;201412;2692;8209;2462;7869;320;1155;1828;5828;2148;6983
310220;201412;1293;3670;1040;3341;221;774;593;1866;814;2640
310230;201412;3049;9882;2600;8888;740;2906;1054;3324;1794;6230
310240;201412;1059;3686;904;3395;161;670;457;1806;618;2476
310250;201412;999;3394;969;3344;229;912;538;1763;767;2675
310260;201412;3316;10614;2711;9315;708;2733;994;3281;1702;6014
310270;201412;2591;7527;2272;7060;202;669;1789;5627;1991;6296
310280;201412;2307;6463;2019;6029;437;1620;1080;3043;1517;4663
310285;201412;2243;7850;2100;7633;296;1127;1577;5864;1873;6991
310290;201412;1379;4308;1285;4162;381;1403;616;1810;997;3213
310300;201412;1951;6618;1840;6392;520;1997;988;3366;1508;5363
310310;201412;398;1094;288;867;54;159;136;411;190;570
310320;201412;422;1379;361;1251;69;300;176;588;245;888
310330;201412;530;1329;380;1063;41;151;206;515;247;666
310340;201412;8921;27312;7579;25039;1569;5423;4162;14148;5731;19571
310350;201412;16493;46476;12594;39602;4197;14391;3547;11088;7744;25479
310360;201412;492;1530;474;1500;79;291;319;960;398;1251
310370;201412;1537;5362;1460;5230;415;1554;794;2863;1209;4417
310375;201412;1431;3868;954;3005;170;612;403;1215;573;1827
310380;201412;408;1146;320;1021;128;451;127;374;255;825
310390;201412;511;1836;434;1659;117;483;78;262;195;745
310400;201412;10777;32284;8541;28216;2675;9629;2570;8477;5245;18106
310410;201412;1083;3496;710;2881;246;1061;155;628;401;1689
310420;201412;5995;17266;3594;11788;804;2937;615;1777;1419;4714
310430;201412;1710;5803;1405;5172;456;1808;365;1302;821;3110
310440;201412;641;1865;542;1703;147;504;220;674;367;1178
310445;201412;1284;4147;1054;3712;166;637;635;2214;801;2851
310450;201412;4831;13824;3930;12514;692;2352;2530;8231;3222;10583
310460;201412;1709;5457;1461;5020;482;1809;335;1199;817;3008
310470;201412;3904;9925;3237;9078;327;997;2537;7188;2864;8185
310480;201412;1245;3749;990;3243;235;910;413;1231;648;2141
310490;201412;3418;11502;3000;10689;999;3918;1132;3980;2131;7898
310500;201412;1568;5415;1438;5140;430;1691;578;2026;1008;3717
310510;201412;2705;8832;2241;7748;783;2942;469;1548;1252;4490
310520;201412;1471;3926;1165;3420;89;267;778;2302;867;2569
310530;201412;916;2886;551;1927;111;436;113;354;224;790
310540;201412;3880;12710;3554;12215;1222;4402;1415;4949;2637;9351
310550;201412;1273;3782;1048;3386;284;1095;455;1338;739;2433
310560;201412;17152;53470;14649;48490;4588;16849;4928;15456;9516;32305
310570;201412;1292;3971;1202;3848;180;636;868;2765;1048;3401
310590;201412;4307;12620;3389;10849;636;2287;1337;4083;1973;6370
310600;201412;1671;5651;1548;5374;535;2076;524;1687;1059;3763
310610;201412;590;1976;538;1871;161;665;180;552;341;1217
310620;201412;196770;621058;162126;550991;43461;164551;62428;202946;105889;367497
310630;201412;4416;14226;4178;13788;754;2828;2842;9180;3596;12008
310640;201412;1497;4573;1201;4033;423;1532;292;904;715;2436
310650;201412;2990;9536;2419;8559;456;1771;1344;4862;1800;6633
310660;201412;1444;4336;1254;4068;175;607;920;2965;1095;3572
310665;201412;1272;3971;1157;3801;191;663;800;2669;991;3332
310670;201412;59122;185459;53972;174044;16145;54569;22754;72660;38899;127229
310680;201412;823;2407;739;2274;175;575;381;1161;556;1736
310690;201412;1369;4519;1099;3999;332;1389;313;1056;645;2445
310700;201412;563;1506;456;1358;129;435;226;643;355;1078
310710;201412;7511;24420;5903;21719;1601;6579;1642;5939;3243;12518
310720;201412;893;2732;812;2577;232;848;361;1061;593;1909
310730;201412;10061;31545;9093;29980;2036;7291;5388;17791;7424;25082
310740;201412;5586;18594;4656;16683;1575;6185;1094;3735;2669;9920
310750;201412;1712;4350;1370;3907;226;651;946;2730;1172;3381
310760;201412;656;2040;554;1858;140;515;231;753;371;1268
310770;201412;947;3120;777;2852;267;1089;333;1160;600;2249
310780;201412;3895;11041;3400;10176;597;1829;2091;6280;2688;8109
310790;201412;1932;6150;1715;5750;462;1619;806;2791;1268;4410
310800;201412;3193;10296;2531;8977;987;3851;387;1316;1374;5167
310810;201412;1551;4367;1402;4115;317;1017;705;1996;1022;3013
310820;201412;1568;4392;1114;3587;304;1088;353;1085;657;2173
310825;201412;2514;8519;2005;7607;168;860;1468;5502;1636;6362
310830;201412;1481;4936;1178;4298;390;1513;349;1210;739;2723
310840;201412;2431;7826;2042;7103;768;2931;565;1841;1333;4772
310850;201412;1622;4817;1376;4492;209;776;984;3198;1193;3974
310855;201412;3311;10614;2922;9991;667;2430;1752;6102;2419;8532
310860;201412;8263;25460;7148;23538;1178;4122;4167;14079;5345;18201
310870;201412;979;2769;790;2453;156;529;423;1293;579;1822
310880;201412;1271;3909;965;3337;203;816;455;1545;658;2361
310890;201412;2878;9121;2295;8036;672;2660;699;2322;1371;4982
310900;201412;4696;15621;3959;14074;1156;4562;1522;5194;2678;9756
310910;201412;2175;6215;1431;4771;391;1453;339;1072;730;2525
310920;201412;2041;6158;1627;5557;413;1587;751;2561;1164;4148
310925;201412;978;3226;885;3059;353;1338;293;1002;646;2340
310930;201412;5824;16848;4642;15016;838;2958;2746;9068;3584;12026
310940;201412;6418;18592;5386;16991;1053;3620;2975;9348;4028;12968
310945;201412;1411;4009;1166;3663;231;847;689;2069;920;2916
310950;201412;2148;7039;1643;5889;523;2091;489;1621;1012;3712
310960;201412;500;1696;422;1542;159;633;135;490;294;1123
310970;201412;1621;5521;1186;4414;394;1608;176;571;570;2179
310980;201412;484;1251;324;951;54;194;144;367;198;561
310990;201412;1247;4267;1063;3853;270;1106;332;1104;602;2210
311000;201412;3659;12564;3201;11564;927;3853;1150;3856;2077;7709
311010;201412;998;3209;890;3013;275;987;431;1435;706;2422
311020;201412;985;3032;802;2700;202;761;319;1009;521;1770
311030;201412;1987;5860;1500;4881;460;1651;494;1453;954;3104
311040;201412;503;1697;434;1511;104;381;100;332;204;713
311050;201412;2693;8763;2312;8007;694;2639;931;3209;1625;5848
311060;201412;2086;6343;1552;5160;361;1330;393;1212;754;2542
311070;201412;1776;6257;1558;5810;428;1808;519;1912;947;3720
311080;201412;1242;3389;1109;3185;176;573;699;1994;875;2567
311090;201412;1689;6290;1428;5739;499;2280;267;1011;766;3291
311100;201412;2494;8651;2153;7921;941;3666;491;1803;1432;5469
311110;201412;4235;10200;3011;8445;600;1860;1547;4272;2147;6132
311115;201412;1221;3635;1052;3376;128;513;678;2171;806;2684
311120;201412;8057;22868;6195;19408;1633;5717;1647;4763;3280;10480
311130;201412;2456;7490;1957;6817;544;2229;861;2857;1405;5086
311140;201412;1507;4177;1244;3840;175;639;865;2593;1040;3232
311150;201412;2456;8240;2272;7936;607;2206;1148;4080;1755;6286
311160;201412;5095;17091;4239;15573;1561;6189;1329;4819;2890;11008
311170;201412;782;2413;614;2086;82;282;331;1186;413;1468
311180;201412;1676;4675;1222;3779;382;1286;291;821;673;2107
311190;201412;1127;3385;951;3017;251;908;366;1065;617;1973
311200;201412;2153;6613;1770;5789;569;2062;408;1181;977;3243
311205;201412;1226;3975;1070;3657;263;1019;427;1483;690;2502
311210;201412;997;3214;907;3078;172;587;624;2186;796;2773
311220;201412;943;3018;753;2585;207;759;258;873;465;1632
311230;201412;8397;26001;6933;23271;1380;5102;3322;11412;4702;16514
311240;201412;1380;4228;1151;3850;368;1323;393;1322;761;2645
311250;201412;995;3261;887;3091;259;1047;303;902;562;1949
311260;201412;3017;8207;2282;6941;681;2282;735;2179;1416;4461
311265;201412;1356;3656;1049;3211;177;649;644;1944;821;2593
311270;201412;3612;11584;3188;10994;555;2266;2138;7203;2693;9469
311280;201412;1505;4229;1090;3415;299;1041;322;976;621;2017
311290;201412;2387;7798;2210;7435;441;1489;1279;4433;1720;5922
311300;201412;5148;16923;4617;16039;718;2814;3024;10615;3742;13429
311310;201412;511;1806;476;1739;101;434;205;707;306;1141
311320;201412;4266;14315;3724;13085;926;3722;1339;4466;2265;8188
311330;201412;5695;17372;4953;16162;1724;6128;1791;5772;3515;11900
311340;201412;13217;42191;11781;39421;3817;13725;3701;12284;7518;26009
311350;201412;2221;6568;1803;5765;363;1389;842;2506;1205;3895
311360;201412;1376;3906;1093;3530;499;1683;275;909;774;2592
311370;201412;4771;14155;4193;13165;1103;4104;1705;4994;2808;9098
311380;201412;499;1622;421;1477;125;510;133;432;258;942
311390;201412;2050;7537;1921;7322;860;3645;619;2234;1479;5879
311400;201412;1783;5919;1603;5582;457;1802;716;2312;1173;4114
311410;201412;2107;7522;1945;7293;616;2476;1005;3816;1621;6292
311420;201412;2584;8768;2049;7457;685;2653;491;1590;1176;4243
311430;201412;4271;13229;3075;10539;751;2834;559;1843;1310;4677
311440;201412;2372;7950;1835;6904;674;2919;356;1275;1030;4194
311450;201412;1929;6766;1628;6031;487;1985;384;1306;871;3291
311455;201412;1651;4463;1399;4084;331;1085;744;2075;1075;3160
311460;201412;687;2253;525;1911;128;574;134;454;262;1028
311470;201412;627;1992;503;1719;145;593;157;485;302;1078
311480;201412;847;2337;799;2265;279;783;359;992;638;1775
311490;201412;315;1231;296;1171;112;463;98;375;210;838
311500;201412;533;1599;436;1416;147;511;173;552;320;1063
311510;201412;3254;10116;2648;8937;1007;3866;688;2155;1695;6021
311520;201412;709;2415;664;2320;252;939;245;832;497;1771
311530;201412;12079;31703;8294;25141;2199;7966;2472;7165;4671;15131
311535;201412;780;2345;547;1860;138;545;94;294;232;839
311540;201412;718;2580;686;2532;233;909;348;1254;581;2163
311545;201412;2354;7237;2173;7006;310;1125;1555;4998;1865;6123
311547;201412;1702;4706;1434;4288;148;469;964;2913;1112;3382
311550;201412;3479;11286;2979;10243;832;3198;1004;3363;1836;6561
311560;201412;305;798;262;745;68;218;135;358;203;576
311570;201412;2198;5492;1739;4921;119;348;1399;4035;1518;4383
311580;201412;2535;5491;2039;4902;600;1360;1143;2895;1743;4255
311590;201412;421;1336;366;1260;112;463;112;376;224;839
311600;201412;1465;4288;1221;3986;309;979;700;2385;1009;3364
311610;201412;3385;11708;3080;11189;1005;3647;1368;5312;2373;8959
311615;201412;2887;9330;2462;8600;293;1216;1742;6049;2035;7265
311620;201412;462;1481;416;1416;101;385;229;768;330;1153
311630;201412;1485;4428;1256;4021;284;908;673;2193;957;3101
311640;201412;899;2823;732;2536;154;597;428;1443;582;2040
311650;201412;2487;7137;2020;6376;307;1034;1180;3840;1487;4874
311660;201412;2800;9721;2354;8702;704;2895;394;1272;1098;4167
311670;201412;1496;4566;1267;4163;428;1545;522;1702;950;3247
311680;201412;2377;7362;1968;6765;467;1698;1110;3897;1577;5595
311690;201412;603;1622;497;1496;77;256;351;1045;428;1301
311700;201412;2362;6547;2033;6075;189;728;1574;4584;1763;5312
311710;201412;1796;5519;1395;4800;545;2046;404;1353;949;3399
311720;201412;415;1410;376;1327;65;264;219;757;284;1021
311730;201412;5772;15058;3494;10908;1067;3804;1164;3173;2231;6977
311740;201412;1018;2931;880;2758;358;1100;437;1428;795;2528
311750;201412;4063;13563;3670;12950;694;2738;2183;7674;2877;10412
311760;201412;817;2781;765;2670;205;832;337;1072;542;1904
311770;201412;2614;8230;2132;7351;580;2241;667;2215;1247;4456
311780;201412;1222;4516;1034;4034;378;1658;231;845;609;2503
311783;201412;2208;7018;1901;6413;175;705;1306;4491;1481;5196
311787;201412;595;2070;427;1555;77;301;107;342;184;643
311790;201412;1568;4789;1176;3996;336;1248;326;1055;662;2303
311800;201412;4125;14013;2987;10641;671;2581;224;654;895;3235
311810;201412;1065;3579;1009;3478;44;210;852;2912;896;3122
311820;201412;847;2778;715;2458;229;904;330;1054;559;1958
311830;201412;7690;26499;6432;23322;2341;9115;971;3272;3312;12387
311840;201412;3573;10641;3095;9919;951;3433;1382;4260;2333;7693
311850;201412;325;972;279;895;74;250;137;439;211;689
311860;201412;53036;162784;45623;148815;11837;42600;20455;64388;32292;106988
311870;201412;2467;7334;1945;6330;503;1870;648;1934;1151;3804
311880;201412;7365;21533;6625;20641;1116;3384;4479;14617;5595;18001
311890;201412;1665;5216;1387;4626;396;1460;552;1780;948;3240
311900;201412;823;2567;742;2453;148;484;468;1645;616;2129
311910;201412;4914;14290;3976;12990;1123;3962;1704;5596;2827;9558
311920;201412;2151;6991;1841;6501;228;899;1218;4279;1446;5178
311930;201412;5028;14796;4424;13831;1816;5970;1362;4298;3178;10268
311940;201412;12071;36870;9873;32233;3021;10803;2310;7071;5331;17874
311950;201412;2361;6963;1983;6461;180;639;1462;4759;1642;5398
311960;201412;441;1452;402;1370;119;476;185;555;304;1031
311970;201412;471;1685;407;1545;125;536;79;284;204;820
311980;201412;818;2262;578;1858;135;470;215;696;350;1166
311990;201412;565;1691;484;1556;189;645;162;492;351;1137
311995;201412;1196;3668;762;2589;156;588;172;499;328;1087
312000;201412;714;2207;664;2129;129;457;377;1202;506;1659
312010;201412;1058;3411;934;3146;202;750;413;1364;615;2114
312015;201412;1620;4947;1397;4559;202;788;843;2767;1045;3555
312020;201412;1046;3402;929;3219;258;999;448;1545;706;2544
312030;201412;1870;5542;1679;5296;156;579;1353;4235;1509;4814
312040;201412;706;2678;606;2375;174;768;131;478;305;1246
312050;201412;1484;5137;1287;4725;396;1612;295;1037;691;2649
312060;201412;773;2374;683;2248;315;1109;201;590;516;1699
312070;201412;1019;3148;665;2355;166;642;240;839;406;1481
312080;201412;2771;7765;2145;6768;456;1720;1058;3080;1514;4800
312083;201412;995;2819;826;2566;137;492;505;1543;642;2035
312087;201412;2386;7260;2113;6874;310;1064;1491;4945;1801;6009
312090;201412;10339;33326;9293;31507;2982;11099;3796;12482;6778;23581
312100;201412;1402;4702;1216;4400;266;1068;651;2402;917;3470
312110;201412;1225;4343;1086;4038;402;1669;213;704;615;2373
312120;201412;956;3325;856;3103;265;1069;244;792;509;1861
312125;201412;1362;4393;1216;4099;330;1180;587;2007;917;3187
312130;201412;873;2655;710;2312;164;602;290;914;454;1516
312140;201412;1106;3500;900;2994;215;791;307;899;522;1690
312150;201412;568;1622;477;1423;39;136;323;936;362;1072
312160;201412;8471;28706;7674;27020;2405;9217;2770;9801;5175;19018
312170;201412;1025;3034;915;2823;133;428;541;1693;674;2121
312180;201412;1653;5093;1496;4814;414;1392;606;1911;1020;3303
312190;201412;708;2333;557;2034;230;927;107;364;337;1291
312200;201412;5062;14946;4395;13871;521;1766;3142;9919;3663;11685
312210;201412;1278;3466;986;3035;280;942;444;1324;724;2266
312220;201412;2014;6571;1797;6317;231;845;1379;5037;1610;5882
312230;201412;18848;62600;15828;56529;7310;27569;3354;12375;10664;39944
312235;201412;1818;5204;1519;4752;167;652;1025;3200;1192;3852
312240;201412;1139;3888;975;3546;285;1115;346;1264;631;2379
312245;201412;2472;7184;2148;6746;178;501;1726;5530;1904;6031
312247;201412;949;2787;717;2408;190;720;346;1184;536;1904
312250;201412;1256;3611;1025;3214;226;815;465;1399;691;2214
312260;201412;989;3103;806;2831;137;571;516;1783;653;2354
312270;201412;813;2529;684;2287;152;618;261;753;413;1371
312280;201412;482;1662;443;1574;196;742;60;201;256;943
312290;201412;883;3026;829;2946;332;1333;229;786;561;2119
312300;201412;1172;3913;962;3404;289;1091;147;455;436;1546
312310;201412;974;3691;890;3478;261;1104;359;1360;620;2464
312320;201412;2460;7020;1946;5947;552;1873;471;1185;1023;3058
312330;201412;1226;3644;1066;3406;260;946;607;1930;867;2876
312340;201412;326;847;290;800;43;157;220;573;263;730
312350;201412;384;996;355;960;45;143;288;751;333;894
312352;201412;1703;5538;1562;5332;438;1502;935;3314;1373;4816
312360;201412;3847;12927;3325;11831;1063;4129;926;3239;1989;7368
312370;201412;1704;5541;1566;5311;577;2180;541;1710;1118;3890
312380;201412;2076;5995;1870;5686;241;746;1367;4278;1608;5024
312385;201412;1325;4033;1165;3765;154;643;791;2452;945;3095
312390;201412;2038;6760;1675;5933;523;1956;316;1034;839;2990
312400;201412;3571;11691;3079;10713;1126;4075;1074;3887;2200;7962
312410;201412;11246;37490;10081;35159;2945;11212;3854;13113;6799;24325
312420;201412;4282;13410;4063;13144;672;2206;2903;9611;3575;11817
312430;201412;8792;25912;7795;24408;1428;4494;5006;16208;6434;20702
312440;201412;699;2238;616;2092;142;527;315;1093;457;1620
312450;201412;1171;4120;1031;3857;430;1669;380;1423;810;3092
312460;201412;401;1207;356;1155;105;372;168;537;273;909
312470;201412;789;2223;538;1727;122;448;151;464;273;912
312480;201412;1429;4157;1169;3852;386;1379;540;1700;926;3079
312490;201412;2046;5459;1618;4838;230;816;998;2876;1228;3692
312500;201412;696;2254;632;2159;142;599;339;1110;481;1709
312510;201412;3028;9558;2466;8339;567;2229;1076;3321;1643;5550
312520;201412;411;1403;354;1288;119;448;125;465;244;913
312530;201412;635;2010;583;1927;111;458;343;1064;454;1522
312540;201412;1507;4738;1169;4055;271;1016;591;2022;862;3038
312550;201412;658;2113;592;1968;60;227;394;1287;454;1514
312560;201412;2296;6002;1985;5600;213;666;1522;4331;1735;4997
312570;201412;2855;8576;2426;7815;759;2604;779;2440;1538;5044
312580;201412;550;1838;449;1630;106;464;176;598;282;1062
312590;201412;1894;6303;1655;5791;444;1793;593;1892;1037;3685
312595;201412;2124;7162;1881;6576;512;1927;892;3072;1404;4999
312600;201412;837;2990;758;2821;201;882;358;1231;559;2113
312610;201412;9213;28000;7481;24750;2688;9573;2132;6846;4820;16419
312620;201412;2146;6166;1637;5480;129;467;1302;4482;1431;4949
312630;201412;516;1737;477;1663;126;491;219;738;345;1229
312640;201412;613;2000;500;1761;130;537;192;611;322;1148
312650;201412;2415;7056;1686;5660;200;764;933;3101;1133;3865
312660;201412;1381;3757;1137;3394;139;484;775;2276;914;2760
312670;201412;6343;19189;5584;18109;1392;5064;2792;8924;4184;13988
312675;201412;1498;4699;1273;4237;209;774;724;2412;933;3186
312680;201412;1759;5350;1567;5042;251;891;955;3143;1206;4034
312690;201412;2440;6608;1995;5977;399;1400;1083;3095;1482;4495
312695;201412;935;3336;874;3248;185;678;577;2230;762;2908
312700;201412;2096;6048;1564;5030;250;911;781;2470;1031;3381
312705;201412;1489;4267;1267;3917;192;625;847;2621;1039;3246
312707;201412;1809;5585;1465;4959;231;938;810;2689;1041;3627
312710;201412;8669;24123;6190;19747;2222;7824;1418;4264;3640;12088
312720;201412;788;2691;687;2460;185;731;249;828;434;1559
312730;201412;1999;4910;1453;4276;232;792;830;2435;1062;3227
312733;201412;1767;4745;1310;3885;124;458;910;2566;1034;3024
312735;201412;932;2724;825;2570;268;941;409;1213;677;2154
312737;201412;1059;2589;740;2149;242;723;297;906;539;1629
312738;201412;581;1817;439;1524;128;506;156;513;284;1019
312740;201412;517;1508;357;1299;122;479;95;356;217;835
312750;201412;1334;4792;1271;4667;319;1356;620;2207;939;3563
312760;201412;2461;7926;1915;6816;563;2211;432;1540;995;3751
312770;201412;47608;131070;36831;114109;10896;36705;12127;36876;23023;73581
312780;201412;2901;10228;2598;9697;511;2077;1490;5706;2001;7783
312790;201412;392;1027;237;744;73;264;64;169;137;433
312800;201412;5532;18503;4673;16725;1539;5895;1393;5036;2932;10931
312810;201412;2327;7155;1681;5950;548;2147;368;1227;916;3374
312820;201412;2211;6478;1987;6108;253;940;1294;3847;1547;4787
312825;201412;1563;4249;1365;4012;136;429;1073;3155;1209;3584
312830;201412;2864;9163;2010;7368;542;2165;387;1400;929;3565
312840;201412;1238;4063;1046;3691;208;883;492;1665;700;2548
312850;201412;653;2133;541;1907;118;494;200;682;318;1176
312860;201412;1330;3867;993;3293;314;1212;291;847;605;2059
312870;201412;5850;18505;4438;15686;1181;4709;1297;4419;2478;9128
312880;201412;1331;4027;1144;3705;198;726;649;2087;847;2813
312890;201412;1596;4828;1114;3791;371;1413;370;1204;741;2617
312900;201412;1505;4762;1379;4584;374;1298;823;2761;1197;4059
312910;201412;1627;3632;1210;3060;286;850;595;1379;881;2229
312920;201412;1056;3449;929;3265;278;1090;417;1428;695;2518
312930;201412;2312;6810;2023;6390;478;1580;1022;3311;1500;4891
312940;201412;960;3213;857;3031;262;1081;254;837;516;1918
312950;201412;3660;10415;2921;9276;1020;3476;1011;3200;2031;6676
312960;201412;2063;6140;1857;5868;292;895;1353;4408;1645;5303
312965;201412;1856;5896;1569;5373;293;1092;904;3146;1197;4238
312970;201412;1219;4150;1048;3876;407;1701;197;696;604;2397
312980;201412;22579;78268;21374;75472;7954;30107;8023;27602;15977;57709
312990;201412;422;1284;317;1097;115;445;100;343;215;788
313000;201412;541;1811;438;1601;131;587;157;513;288;1100
313005;201412;2745;8845;2423;8298;459;1669;1416;4902;1875;6571
313010;201412;4384;14529;3817;13538;1189;4639;1546;5253;2735;9892
313020;201412;1071;3678;966;3444;325;1297;286;896;611;2193
313030;201412;1660;4626;1304;4135;362;1300;641;1932;1003;3232
313040;201412;1020;3536;879;3143;202;808;298;994;500;1802
313050;201412;1986;6427;1623;5894;544;2198;596;2062;1140;4260
313055;201412;1595;5223;1455;5023;136;506;1110;3884;1246;4390
313060;201412;1044;3545;900;3181;382;1405;150;512;532;1917
313065;201412;2061;6656;1793;6231;318;1249;1261;4357;1579;5606
313070;201412;1296;3829;1059;3390;269;991;517;1562;786;2553
313080;201412;489;1530;394;1332;112;449;130;359;242;808
313090;201412;5746;16760;5053;15671;862;2789;3330;10511;4192;13300
313100;201412;1213;3888;1121;3732;172;626;818;2715;990;3341
313110;201412;1808;5236;1388;4431;327;1208;526;1532;853;2740
313115;201412;2979;10344;2842;10071;839;3333;1390;4687;2229;8020
313120;201412;4110;11409;3556;10647;848;2744;2223;6612;3071;9356
313130;201412;22919;69962;19405;62470;5055;17950;7269;22027;12324;39977
313140;201412;717;1885;539;1607;43;162;365;1064;408;1226
313150;201412;1703;5332;1519;4999;678;2324;413;1388;1091;3712
313160;201412;1196;3636;1050;3387;219;817;614;1902;833;2719
313170;201412;9789;35426;8664;32596;3231;12706;1902;7152;5133;19858
313180;201412;2873;7510;2151;6547;643;2163;776;2285;1419;4448
313190;201412;3756;13643;3291;12313;956;3888;1059;3805;2015;7693
313200;201412;1530;4814;1356;4523;225;876;846;2862;1071;3738
313210;201412;4759;14714;4001;13651;942;3752;2114;6939;3056;10691
313220;201412;1316;3977;957;3195;268;1021;259;751;527;1772
313230;201412;2616;9237;2423;8929;428;1640;1555;5922;1983;7562
313240;201412;9022;29869;7583;27224;2086;8303;3187;11349;5273;19652
313250;201412;7965;24745;7124;23311;1335;4461;4207;14143;5542;18604
313260;201412;650;2005;526;1758;122;469;152;476;274;945
313270;201412;5994;17560;5271;16440;907;3012;3404;10700;4311;13712
313280;201412;557;1803;430;1498;87;352;111;356;198;708
313290;201412;1058;3788;879;3429;297;1282;222;797;519;2079
313300;201412;2064;7021;1721;6152;549;2145;318;1001;867;3146
313310;201412;1142;3993;1006;3693;275;1132;194;636;469;1768
313320;201412;2586;7650;2039;6735;437;1556;879;2909;1316;4465
313330;201412;3772;12153;3193;11076;613;2469;1739;5946;2352;8415
313340;201412;2380;5788;1821;4995;395;1130;999;2725;1394;3855
313350;201412;3501;10946;2705;9160;699;2548;590;1846;1289;4394
313360;201412;1283;3848;985;3316;315;1242;439;1354;754;2596
313370;201412;1542;5400;1438;5108;299;1250;672;2204;971;3454
313375;201412;2257;6022;1527;4916;390;1529;535;1655;925;3184
313380;201412;7090;24164;6155;22102;2305;8943;1925;6591;4230;15534
313390;201412;962;3450;924;3395;134;559;636;2327;770;2886
313400;201412;3948;11243;3618;10849;405;1274;2850;8717;3255;9991
313410;201412;1424;4076;1201;3766;278;952;689;2161;967;3113
313420;201412;21295;51764;13231;37628;3184;10177;3009;8213;6193;18390
313430;201412;1314;4238;1120;3815;313;1218;428;1368;741;2586
313440;201412;7044;16711;5104;14397;719;2220;3425;9681;4144;11901
313450;201412;747;2234;596;1914;149;576;210;606;359;1182
313460;201412;2566;9016;2298;8561;742;3028;703;2502;1445;5530
313470;201412;3574;9950;3358;9704;328;832;2839;8413;3167;9245
313480;201412;1163;3404;891;2916;162;608;390;1200;552;1808
313490;201412;1766;5659;1217;4678;520;2061;214;849;734;2910
313500;201412;454;1482;428;1429;101;391;215;687;316;1078
313505;201412;9384;27769;8674;26934;515;1137;7820;25085;8335;26222
313507;201412;1538;4280;1348;4012;247;844;814;2462;1061;3306
313510;201412;16873;48986;14870;46194;2708;8562;9395;30037;12103;38599
313520;201412;16951;50614;14226;45990;2118;7763;9084;29291;11202;37054
313530;201412;611;2047;527;1890;91;382;202;663;293;1045
313535;201412;2738;8055;2425;7521;305;993;1652;5169;1957;6162
313540;201412;1153;3634;886;2953;270;950;211;644;481;1594
313545;201412;1440;5208;1266;4877;211;1013;776;2841;987;3854
313550;201412;2101;6978;1896;6564;533;1973;916;3076;1449;5049
313560;201412;2389;5863;2062;5489;331;796;1513;4225;1844;5021
313570;201412;855;3099;748;2890;280;1159;265;971;545;2130
313580;201412;6427;18111;5408;16712;842;2878;3714;11514;4556;14392
313590;201412;1118;3300;902;3046;419;1515;325;1072;744;2587
313600;201412;4098;12377;3566;11529;615;2177;2201;7215;2816;9392
313610;201412;1207;3736;1035;3398;260;921;459;1491;719;2412
313620;201412;7708;25609;7167;24512;2523;9164;2442;8206;4965;17370
313630;201412;9583;28629;7823;25884;2199;8077;3114;10618;5313;18695
313640;201412;952;2889;767;2606;265;983;253;834;518;1817
313650;201412;2382;7727;2108;7272;306;1079;1527;5364;1833;6443
313652;201412;1044;3754;957;3579;174;699;569;2138;743;2837
313655;201412;1046;3381;849;3048;160;680;509;1771;669;2451
313657;201412;1318;4100;1143;3825;150;677;807;2485;957;3162
313660;201412;961;3260;877;3105;222;912;417;1392;639;2304
313665;201412;3391;11225;3117;10603;737;2833;1518;4972;2255;7805
313670;201412;50848;144813;34502;115895;9847;36741;10519;34233;20366;70974
313680;201412;1160;3478;995;3211;142;469;687;2254;829;2723
313690;201412;1000;3594;890;3354;269;1037;341;1324;610;2361
313695;201412;1560;5017;1309;4604;172;680;887;3146;1059;3826
313700;201412;4030;13279;3401;12412;606;2284;2277;8520;2883;10804
313710;201412;1458;4107;1206;3723;347;1159;562;1687;909;2846
313720;201412;5728;19189;4879;17348;1314;5213;1545;5017;2859;10230
313730;201412;1342;3587;1022;3192;197;703;580;1793;777;2496
313740;201412;2190;7893;1820;6929;634;2717;239;833;873;3550
313750;201412;3076;9457;2668;8661;879;3041;813;2489;1692;5530
313753;201412;1974;5944;1623;5323;515;1829;642;2109;1157;3938
313760;201412;4545;14802;3728;13091;1140;4367;1096;3630;2236;7997
313770;201412;3921;12997;3623;12395;1251;4524;1265;4246;2516;8770
313780;201412;4208;11930;3375;10700;847;3101;1575;4867;2422;7968
313790;201412;568;1970;549;1941;132;466;304;1117;436;1583
313800;201412;1301;3708;1148;3462;192;651;733;2206;925;2857
313810;201412;1644;4843;1580;4751;177;511;1258;3872;1435;4383
313820;201412;14737;41709;12368;37700;3084;10688;5475;16370;8559;27058
313830;201412;450;1530;385;1390;118;484;117;407;235;891
313835;201412;1098;3598;1043;3516;269;972;555;1852;824;2824
313840;201412;8466;24740;6728;21740;1941;7027;2150;6678;4091;13705
313850;201412;1316;3668;1178;3432;296;992;608;1667;904;2659
313860;201412;2859;8788;2275;7514;646;2416;530;1612;1176;4028
313862;201412;1249;3289;838;2572;209;678;299;936;508;1614
313865;201412;2372;7387;2160;7044;318;1158;1514;4926;1832;6084
313867;201412;1163;3982;983;3613;350;1384;328;1229;678;2613
313868;201412;1640;5726;1447;5321;179;771;977;3579;1156;4350
313870;201412;945;2943;835;2787;274;1058;267;789;541;1847
313880;201412;2294;7387;2097;7115;525;2056;1036;3269;1561;5325
313890;201412;2081;5624;1735;5181;286;842;1133;3467;1419;4309
313900;201412;4984;18150;4632;17350;1697;7002;1359;5057;3056;12059
313910;201412;790;2694;675;2449;264;1039;115;389;379;1428
313920;201412;3991;12662;3494;11784;645;2189;2101;7383;2746;9572
313925;201412;2167;5735;1492;4456;132;431;945;2799;1077;3230
313930;201412;5566;18146;4633;16487;857;3297;2597;9469;3454;12766
313940;201412;8101;27447;6806;25354;2295;9355;2501;9636;4796;18991
313950;201412;5065;14668;4185;13224;1348;4803;1525;4600;2873;9403
313960;201412;6583;17407;5152;15417;1697;5639;1406;4091;3103;9730
313970;201412;1568;4567;1348;4316;218;768;887;2927;1105;3695
313980;201412;1351;4395;1133;4002;385;1503;376;1303;761;2806
313990;201412;2035;7659;1784;7049;632;2712;444;1624;1076;4336
314000;201412;8758;29446;8120;28219;2107;8476;4427;14844;6534;23320
314010;201412;1212;3443;1001;3179;169;639;600;1852;769;2491
314015;201412;1659;6154;1512;5830;534;2168;481;1848;1015;4016
314020;201412;550;1708;428;1439;125;475;110;340;235;815
314030;201412;871;2828;690;2408;125;482;263;907;388;1389
314040;201412;676;1958;581;1795;189;627;289;879;478;1506
314050;201412;2059;6669;1681;5868;510;1978;519;1681;1029;3659
314053;201412;1566;5131;1435;4972;242;824;982;3551;1224;4375
314055;201412;2363;6995;2084;6603;180;604;1585;5123;1765;5727
314060;201412;1169;3674;955;3317;107;440;627;2166;734;2606
314070;201412;3862;12067;2916;10170;834;3151;722;2384;1556;5535
314080;201412;1961;6039;1302;4510;285;1112;331;1020;616;2132
314085;201412;1985;6741;1715;6356;522;2141;656;2396;1178;4537
314090;201412;3656;12435;3253;11637;1052;4082;1166;4240;2218;8322
314100;201412;3741;9938;3228;9225;384;1057;2478;7275;2862;8332
314110;201412;4690;15440;4121;14233;1039;4156;1562;4948;2601;9104
314120;201412;1097;2671;581;1841;168;604;151;458;319;1062
314130;201412;702;2055;373;1286;66;247;73;253;139;500
314140;201412;5340;16528;4614;15126;1029;3620;2110;6926;3139;10546
314150;201412;1839;4892;1424;4234;272;920;702;2035;974;2955
314160;201412;2577;6863;2021;6116;148;474;1613;5056;1761;5530
314170;201412;1155;3536;952;3086;160;610;504;1564;664;2174
314180;201412;6666;21015;5828;19745;1597;5900;2635;9111;4232;15011
314190;201412;878;2674;733;2439;227;878;284;888;511;1766
314200;201412;3202;10250;2840;9589;410;1612;1899;6288;2309;7900
314210;201412;2097;6411;1874;6002;323;1192;1120;3431;1443;4623
314220;201412;1820;5900;1501;5260;515;2016;362;1116;877;3132
314225;201412;1284;3828;1143;3635;77;235;989;3209;1066;3444
314230;201412;758;2615;694;2494;224;881;252;865;476;1746
314240;201412;1225;3871;1071;3647;198;640;711;2544;909;3184
314250;201412;556;1671;423;1393;95;358;150;443;245;801
314260;201412;1331;4805;1248;4622;433;1709;432;1577;865;3286
314270;201412;3013;10081;2671;9456;332;1328;1807;6462;2139;7790
314280;201412;3523;10048;2487;8028;748;2767;712;2007;1460;4774
314290;201412;5641;15666;4783;14295;1212;3950;2771;8140;3983;12090
314300;201412;2051;6848;1836;6342;626;2239;649;2202;1275;4441
314310;201412;6972;22071;6122;20336;2345;8338;1765;5650;4110;13988
314315;201412;986;3778;910;3627;171;769;536;2170;707;2939
314320;201412;3786;11181;2985;10093;1015;3713;1226;4138;2241;7851
314330;201412;59569;187890;54248;178955;16507;59213;23213;75793;39720;135006
314340;201412;2628;7331;1447;4842;404;1492;133;298;537;1790
314345;201412;1423;4712;1248;4436;382;1403;659;2378;1041;3781
314350;201412;1510;4425;1220;3948;509;1782;332;1051;841;2833
314360;201412;778;2435;514;1846;147;611;128;428;275;1039
314370;201412;580;2039;533;1961;175;690;253;926;428;1616
314380;201412;1276;3877;919;3183;331;1220;249;889;580;2109
314390;201412;16605;49515;12996;42547;3878;13815;3630;11338;7508;25153
314400;201412;5746;16339;4645;14774;1637;5335;2079;6913;3716;12248
314410;201412;2889;9291;2474;8425;797;3080;836;2669;1633;5749
314420;201412;816;2357;647;2119;86;355;450;1446;536;1801
314430;201412;8603;25441;7666;23604;2517;8311;2467;7711;4984;16022
314435;201412;1358;4364;1202;4084;167;706;762;2531;929;3237
314437;201412;1238;3251;1078;3012;90;248;855;2418;945;2666
314440;201412;765;2135;538;1814;206;761;104;320;310;1081
314450;201412;1860;5492;1586;5100;511;1853;738;2253;1249;4106
314460;201412;4621;16001;3973;14513;1330;5262;791;2825;2121;8087
314465;201412;2474;7858;2277;7517;210;861;1714;5538;1924;6399
314467;201412;1194;3358;1010;3032;141;403;671;2069;812;2472
314470;201412;2526;8221;1997;6989;563;2255;507;1526;1070;3781
314480;201412;6543;22091;4516;16539;908;3590;502;1604;1410;5194
314490;201412;1019;3002;814;2593;243;844;320;963;563;1807
314500;201412;3035;8542;2340;7190;694;2331;753;2298;1447;4629
314505;201412;1832;5635;1722;5453;339;1185;1063;3380;1402;4565
314510;201412;2096;5901;1458;4940;536;2000;379;1226;915;3226
314520;201412;4056;15335;3289;13357;1067;4757;617;2287;1684;7044
314530;201412;7359;25447;6768;24518;1331;4945;3908;14767;5239;19712
314535;201412;3121;8490;2633;7839;339;1117;1918;5714;2257;6831
314537;201412;1500;4466;1206;3939;246;918;619;2031;865;2949
314540;201412;472;1464;412;1333;122;463;142;424;264;887
314545;201412;1473;4604;1282;4305;243;931;768;2551;1011;3482
314550;201412;647;1829;497;1629;121;497;179;528;300;1025
314560;201412;5589;19715;4835;17784;1234;4995;1297;4586;2531;9581
314570;201412;339;1045;282;912;85;300;132;413;217;713
314580;201412;510;1753;407;1510;112;472;85;308;197;780
314585;201412;874;2904;623;2336;175;735;175;654;350;1389
314587;201412;1833;5769;1621;5385;302;1000;879;2994;1181;3994
314590;201412;4436;15457;3298;12334;887;3518;458;1588;1345;5106
314600;201412;2165;7483;1764;6700;685;2865;365;1311;1050;4176
314610;201412;8877;31313;8228;29802;2613;10400;2973;10178;5586;20578
314620;201412;1927;5598;1708;5316;223;657;1289;4144;1512;4801
314625;201412;1585;5323;1545;5272;167;568;1254;4360;1421;4928
314630;201412;5418;15884;4733;14786;568;1977;3329;10532;3897;12509
314640;201412;854;2451;718;2211;254;825;201;577;455;1402
314650;201412;1384;4070;1052;3463;267;1005;396;1190;663;2195
314655;201412;1611;4834;1236;4126;255;896;634;2127;889;3023
314660;201412;239;661;183;555;20;70;101;292;121;362
314670;201412;1612;4433;1280;3844;233;786;728;2175;961;2961
314675;201412;2008;6119;1766;5691;228;830;1120;3628;1348;4458
314690;201412;2819;8937;2372;8149;683;2709;701;2231;1384;4940
314700;201412;10158;36778;8306;32562;3275;13793;1838;7254;5113;21047
314710;201412;9284;29446;6535;23277;1652;6596;1004;3241;2656;9837
314720;201412;2778;9304;2324;8371;695;2771;898;3184;1593;5955
314730;201412;2653;8196;2190;7514;757;2855;724;2398;1481;5253
314740;201412;3262;10797;2918;10143;841;3245;1190;3948;2031;7193
314750;201412;353;1146;312;1057;65;258;143;463;208;721
314760;201412;1729;5893;1262;4690;271;1215;299;920;570;2135
314770;201412;1190;3749;702;2385;89;377;121;304;210;681
314780;201412;338;927;254;815;83;310;108;340;191;650
314790;201412;14026;42929;10726;37052;4719;18205;1794;5699;6513;23904
314795;201412;1628;4847;1392;4472;156;629;1032;3193;1188;3822
314800;201412;17945;54656;14493;47584;5795;19921;3001;10010;8796;29931
314810;201412;13615;40747;10631;35354;3445;12711;2638;8768;6083;21479
314820;201412;1160;3213;790;2645;269;983;251;775;520;1758
314830;201412;1877;6188;1604;5710;562;2187;615;2237;1177;4424
314840;201412;1140;4040;892;3654;235;1110;467;1863;702;2973
314850;201412;2326;6595;1892;5838;362;1309;1072;3269;1434;4578
314860;201412;3417;11618;3108;11104;680;2676;1818;6514;2498;9190
314870;201412;5997;19036;5305;18102;757;2871;3787;13140;4544;16011
314875;201412;1769;6032;1716;5955;245;831;1390;4900;1635;5731
314880;201412;878;2509;768;2346;73;234;547;1694;620;1928
314890;201412;628;1906;446;1525;109;439;139;414;248;853
314900;201412;456;1411;364;1256;96;349;167;573;263;922
314910;201412;1844;6393;1595;5934;649;2658;419;1444;1068;4102
314915;201412;2626;8242;2298;7751;224;885;1768;5922;1992;6807
314920;201412;670;1938;504;1689;112;432;226;709;338;1141
314930;201412;5450;18641;4797;17187;1581;6192;1141;3989;2722;10181
314940;201412;427;1260;396;1205;99;331;210;604;309;935
314950;201412;407;1370;336;1233;94;379;76;274;170;653
314960;201412;869;2771;684;2384;213;801;167;544;380;1345
314970;201412;592;2018;504;1850;141;598;141;491;282;1089
314980;201412;2346;7193;2085;6743;860;2936;335;1034;1195;3970
314990;201412;3303;10671;2652;9199;968;3719;502;1547;1470;5266
314995;201412;1674;5158;1499;4909;199;781;1051;3383;1250;4164
315000;201412;1169;3374;941;3003;180;674;531;1664;711;2338
315010;201412;506;1619;414;1420;129;521;138;415;267;936
315015;201412;2036;6288;1832;6039;278;934;1322;4534;1600;5468
315020;201412;799;2504;604;2067;118;454;269;882;387;1336
315030;201412;1027;3140;879;2858;343;1180;212;678;555;1858
315040;201412;970;3004;887;2855;169;581;541;1718;710;2299
315050;201412;1710;5084;1404;4573;439;1563;525;1682;964;3245
315053;201412;1183;3514;1026;3266;250;950;434;1338;684;2288
315057;201412;1979;6672;1601;6085;274;1073;966;3801;1240;4874
315060;201412;1051;3428;792;2829;232;891;165;601;397;1492
315070;201412;778;2320;691;2198;195;693;363;1107;558;1800
315080;201412;3575;12177;3193;11363;847;3265;1451;5133;2298;8398
315090;201412;783;2836;694;2645;179;738;256;1008;435;1746
315100;201412;1253;4291;953;3572;263;1114;216;735;479;1849
315110;201412;1732;5348;1514;4948;403;1440;689;2222;1092;3662
315120;201412;14516;34977;10320;29501;1887;5661;5603;16818;7490;22479
315130;201412;1866;6222;1687;5863;582;2228;461;1547;1043;3775
315140;201412;2722;9098;2275;8125;649;2700;756;2411;1405;5111
315150;201412;5039;13829;3762;11599;899;3196;1403;4165;2302;7361
315160;201412;1440;4202;1247;3866;283;959;637;1907;920;2866
315170;201412;1420;4161;1186;3827;216;743;665;2333;881;3076
315180;201412;16030;48451;11086;37717;2946;11298;2510;8077;5456;19375
315190;201412;2451;6523;2000;5861;583;1819;966;2835;1549;4654
315200;201412;4762;16060;3932;14161;1245;4891;1062;3700;2307;8591
315210;201412;9443;28557;7718;25098;2407;8525;2683;8539;5090;17064
315213;201412;1171;3767;1117;3693;106;307;942;3209;1048;3516
315217;201412;2818;9451;2353;8647;380;1593;1381;5077;1761;6670
315220;201412;10191;29618;8561;27118;2332;7323;4383;14490;6715;21813
315230;201412;2736;7286;2428;6914;170;365;2072;6166;2242;6531
315240;201412;3524;11046;3128;10423;646;2332;1882;6241;2528;8573
315250;201412;10566;33645;7944;28487;2554;10226;2415;8584;4969;18810
315260;201412;1155;3749;898;3171;309;1211;178;568;487;1779
315270;201412;906;3232;782;2972;256;1047;197;718;453;1765
315280;201412;4113;12563;3189;10498;1099;3817;782;2436;1881;6253
315290;201412;1345;3825;1016;3287;369;1317;186;592;555;1909
315300;201412;554;1580;431;1428;215;739;139;455;354;1194
315310;201412;1291;4254;1127;3960;167;681;736;2527;903;3208
315320;201412;910;2928;752;2707;204;803;353;1321;557;2124
315330;201412;692;2502;420;1762;126;584;44;197;170;781
315340;201412;4388;12670;3646;11499;900;3074;1652;5302;2552;8376
315350;201412;1930;5431;1476;4774;293;967;872;2932;1165;3899
315360;201412;1760;5900;1419;4997;321;1228;485;1607;806;2835
315370;201412;615;1865;542;1754;130;459;303;973;433;1432
315380;201412;297;1040;253;927;90;363;42;139;132;502
315390;201412;1997;7126;1711;6424;607;2436;413;1522;1020;3958
315400;201412;4949;15018;4239;13638;1050;3694;1974;6283;3024;9977
315410;201412;1908;5220;1608;4757;262;963;996;2832;1258;3795
315415;201412;1250;4176;1147;4013;460;1608;490;1805;950;3413
315420;201412;1231;3955;910;3261;258;997;161;554;419;1551
315430;201412;4213;11484;3151;9673;880;3040;896;2647;1776;5687
315440;201412;1006;3103;892;2926;181;673;471;1537;652;2210
315445;201412;2301;6479;1918;5955;275;976;1332;4113;1607;5089
315450;201412;2601;8220;2389;7896;515;1667;1493;5151;2008;6818
315460;201412;40859;137407;36331;127602;13008;49006;8914;30392;21922;79398
315470;201412;594;1814;504;1650;89;340;286;903;375;1243
315480;201412;1561;4848;1002;3555;217;873;180;588;397;1461
315490;201412;3447;9707;2846;8855;512;1849;1531;4664;2043;6513
315500;201412;471;1447;301;1038;59;251;110;317;169;568
315510;201412;1557;4435;1328;4066;84;282;1010;3116;1094;3398
315520;201412;1208;3691;988;3386;173;678;612;2040;785;2718
315530;201412;527;1856;494;1796;228;883;169;592;397;1475
315540;201412;1301;3972;1036;3524;237;980;371;1220;608;2200
315550;201412;1900;5481;1548;5012;549;1988;545;1742;1094;3730
315560;201412;7509;24433;6832;23512;915;3460;4737;16463;5652;19923
315570;201412;2441;7684;2276;7432;530;1955;1282;4115;1812;6070
315580;201412;2869;8774;2308;7714;665;2604;828;2545;1493;5149
315590;201412;939;2727;838;2574;145;516;501;1482;646;1998
315600;201412;2749;9649;2262;8787;423;1708;1269;5178;1692;6886
315610;201412;1077;3181;888;2778;196;762;331;870;527;1632
315620;201412;359;1260;339;1220;102;358;173;653;275;1011
315630;201412;1058;3382;890;3088;253;943;246;824;499;1767
315640;201412;840;2517;711;2274;211;757;271;816;482;1573
315645;201412;906;2886;778;2592;318;1161;195;620;513;1781
315650;201412;2092;5876;1772;5424;162;635;1326;3991;1488;4626
315660;201412;2785;7404;2401;6805;508;1500;1398;3952;1906;5452
315670;201412;12327;43314;11118;40822;3926;15492;3557;12784;7483;28276
315680;201412;3034;10475;2462;9362;951;3722;558;2240;1509;5962
315690;201412;3933;11634;2875;9696;911;3373;762;2600;1673;5973
315700;201412;7768;24498;6599;22139;1376;5258;3145;10103;4521;15361
315710;201412;1936;5643;1529;4986;182;720;958;3076;1140;3796
315720;201412;3089;9992;2827;9485;680;2694;1472;4660;2152;7354
315725;201412;1715;5254;1395;4831;394;1408;730;2577;1124;3985
315727;201412;688;2156;590;1954;149;542;255;816;404;1358
315730;201412;1019;3142;930;2977;208;722;521;1667;729;2389
315733;201412;1223;3935;1127;3749;458;1611;380;1245;838;2856
315737;201412;1402;4245;1111;3706;114;445;710;2399;824;2844
315740;201412;1132;3534;960;3195;205;812;489;1529;694;2341
315750;201412;1214;3767;1081;3568;117;471;799;2591;916;3062
315760;201412;1004;2764;965;2714;25;75;894;2520;919;2595
315765;201412;1606;4867;1481;4677;143;476;1154;3691;1297;4167
315770;201412;1762;5721;1576;5315;463;1705;514;1660;977;3365
315780;201412;25209;83092;23005;78261;7405;26905;7124;24231;14529;51136
315790;201412;3443;11715;3054;10903;387;1340;2057;7569;2444;8909
315800;201412;1598;6217;1267;5204;356;1651;266;1026;622;2677
315810;201412;1569;4429;1322;4036;219;715;849;2556;1068;3271
315820;201412;3083;10019;2614;9306;819;3023;1178;4333;1997;7356
315830;201412;1523;5112;1337;4697;339;1344;386;1236;725;2580
315840;201412;807;2138;597;1765;96;330;236;637;332;967
315850;201412;1345;4741;1291;4622;332;1240;581;2029;913;3269
315860;201412;491;1744;389;1539;113;519;82;311;195;830
315870;201412;490;1477;415;1365;132;482;130;390;262;872
315880;201412;1162;3155;954;2881;246;875;397;1143;643;2018
315890;201412;1768;6024;1593;5748;561;2131;727;2673;1288;4804
315895;201412;5401;16843;4928;15919;1288;4634;2257;7087;3545;11721
315900;201412;838;2606;786;2523;146;575;505;1498;651;2073
315910;201412;629;2219;587;2138;214;809;285;1022;499;1831
315920;201412;1616;4692;1069;3521;294;1089;307;915;601;2004
315930;201412;1163;3239;930;2832;257;855;322;963;579;1818
315935;201412;1194;4042;1098;3836;351;1345;353;1195;704;2540
315940;201412;683;2170;609;2019;178;655;252;810;430;1465
315950;201412;1308;4009;1199;3797;270;852;734;2394;1004;3246
315960;201412;2898;9602;2138;8043;1017;4378;121;367;1138;4745
315970;201412;824;2301;656;2066;76;229;478;1562;554;1791
315980;201412;4623;11353;2963;8536;792;2624;884;2225;1676;4849
315990;201412;4599;13620;4018;12720;884;3270;2139;6715;3023;9985
316000;201412;631;2017;554;1901;232;872;178;579;410;1451
316010;201412;498;1760;431;1623;102;458;148;492;250;950
316020;201412;1209;3847;975;3436;178;736;561;1962;739;2698
316030;201412;3811;10702;2691;8838;388;1406;1416;4768;1804;6174
316040;201412;3667;11618;2637;9283;470;1934;372;1000;842;2934
316045;201412;2231;7048;2046;6746;294;877;1467;5095;1761;5972
316050;201412;377;1199;307;1088;69;271;171;580;240;851
316060;201412;806;2424;651;2190;122;508;357;1133;479;1641
316070;201412;6553;21292;5716;19338;1621;6134;2329;7457;3950;13591
316080;201412;764;2842;687;2631;179;751;133;519;312;1270
316090;201412;678;1980;467;1526;113;422;128;386;241;808
316095;201412;1405;4589;1245;4289;267;943;792;2804;1059;3747
316100;201412;2777;9328;2096;7562;565;2339;425;1417;990;3756
316105;201412;988;2777;733;2349;199;705;283;910;482;1615
316110;201412;12993;44897;11746;42620;1682;6686;7989;29700;9671;36386
316120;201412;1376;4614;1194;4171;396;1450;413;1388;809;2838
316130;201412;1580;3561;1016;2774;198;641;508;1338;706;1979
316140;201412;1116;3290;856;2876;123;464;516;1751;639;2215
316150;201412;1531;4556;1429;4372;327;1170;818;2446;1145;3616
316160;201412;1281;3832;995;3256;179;681;468;1500;647;2181
316165;201412;1021;2793;855;2535;176;609;491;1418;667;2027
316170;201412;1468;4234;1099;3577;248;901;460;1415;708;2316
316180;201412;1371;4366;1019;3595;294;1199;259;808;553;2007
316190;201412;2826;8803;1372;4871;312;1170;203;608;515;1778
316200;201412;3990;12927;3068;11038;775;3231;893;3112;1668;6343
316210;201412;5560;17666;4840;16301;2182;7899;952;3198;3134;11097
316220;201412;722;2259;502;1820;120;520;65;243;185;763
316225;201412;1179;3386;1034;3169;145;537;714;2129;859;2666
316230;201412;484;1421;390;1258;78;273;199;674;277;947
316240;201412;6937;21277;5974;20021;686;2333;4577;15568;5263;17901
316245;201412;3288;11392;3061;11013;276;1254;2337;8354;2613;9608
316250;201412;9561;29306;7981;26036;2686;9608;2430;7469;5116;17077
316255;201412;2580;7954;2271;7584;353;1179;1666;5625;2019;6804
316257;201412;1480;4162;1128;3521;265;912;412;1250;677;2162
316260;201412;1973;5566;1473;4821;270;983;811;2721;1081;3704
316265;201412;1367;3789;977;2982;113;428;573;1650;686;2078
316270;201412;5242;16801;4830;15941;1386;4820;2134;7122;3520;11942
316280;201412;3489;11501;3142;10807;594;2241;1765;6110;2359;8351
316290;201412;3483;11303;3051;10456;779;3072;1323;4306;2102;7378
316292;201412;3903;12844;3548;12204;962;3631;1714;5632;2676;9263
316294;201412;868;2793;559;2049;128;551;65;219;193;770
316295;201412;2096;7405;1967;7143;447;1902;1080;3694;1527;5596
316300;201412;1044;3200;881;2903;85;287;610;2054;695;2341
316310;201412;691;2189;537;1870;131;523;192;651;323;1174
316320;201412;588;1962;514;1851;146;579;147;506;293;1085
316330;201412;1077;3260;845;2764;134;450;508;1676;642;2126
316340;201412;1186;3857;1013;3503;309;1232;334;1059;643;2291
316350;201412;1536;4788;1386;4530;293;955;713;2491;1006;3446
316360;201412;800;2080;621;1823;72;219;465;1375;537;1594
316370;201412;5296;17491;4679;16220;1648;6117;1057;3708;2705;9825
316380;201412;1582;4398;1285;3962;132;467;921;2849;1053;3316
316390;201412;961;2874;800;2597;259;914;344;1130;603;2044
316400;201412;1566;5186;1316;4737;352;1356;549;1981;901;3337
316410;201412;1249;4166;1167;4034;257;947;693;2410;950;3357
316420;201412;2125;6973;1931;6706;285;1165;1252;4329;1537;5494
316430;201412;1004;3063;805;2691;240;887;282;884;522;1771
316440;201412;710;2315;584;2117;231;953;147;515;378;1468
316443;201412;745;2237;612;1973;160;570;241;741;401;1311
316447;201412;1605;5043;1482;4860;117;409;1272;4190;1389;4599
316450;201412;2355;8009;2074;7474;399;1515;1304;4811;1703;6326
316460;201412;939;3026;883;2934;271;969;484;1550;755;2519
316470;201412;8495;27947;6739;24053;2088;8511;2029;6859;4117;15370
316480;201412;255;878;229;828;66;249;70;244;136;493
316490;201412;385;1243;363;1188;126;433;153;485;279;918
316500;201412;1100;4019;735;2868;162;683;42;161;204;844
316510;201412;987;3579;878;3339;346;1368;240;903;586;2271
316520;201412;1264;3919;1050;3584;263;1011;404;1251;667;2262
316530;201412;1145;3749;953;3344;240;1042;349;1029;589;2071
316540;201412;1050;3436;944;3255;253;1036;363;1149;616;2185
316550;201412;1359;4550;1246;4370;267;1022;777;2733;1044;3755
316553;201412;2232;8058;1814;7029;624;2619;414;1540;1038;4159
316555;201412;3056;10372;2669;9937;245;889;2140;8187;2385;9076
316556;201412;598;1650;480;1439;37;146;366;1062;403;1208
316557;201412;745;2735;711;2676;340;1364;191;672;531;2036
316560;201412;385;1305;321;1161;90;381;76;230;166;611
316570;201412;1484;4706;1298;4318;257;938;678;2253;935;3191
316580;201412;301;884;226;728;62;238;73;209;135;447
316590;201412;1563;4353;1173;3687;210;781;680;2045;890;2826
316600;201412;1191;3898;1049;3606;373;1348;294;988;667;2336
316610;201412;640;2333;577;2214;139;592;337;1288;476;1880
316620;201412;2362;7399;2048;6781;459;1707;1110;3601;1569;5308
316630;201412;1589;5318;1391;4890;581;2136;429;1506;1010;3642
316640;201412;264;868;231;799;65;255;86;277;151;532
316650;201412;999;3758;872;3544;207;866;471;2043;678;2909
316660;201412;190;532;123;392;21;81;54;159;75;240
316670;201412;1861;5446;1479;4713;577;2034;349;1007;926;3041
316680;201412;2128;6126;1798;5633;240;736;1380;4419;1620;5155
316690;201412;1254;4278;1132;4028;392;1580;427;1473;819;3053
316695;201412;1271;3962;1125;3705;126;411;730;2514;856;2925
316700;201412;367;1228;340;1166;84;336;164;518;248;854
316710;201412;3540;13381;3067;12291;1076;4586;931;3890;2007;8476
316720;201412;19459;65444;16413;58545;5614;21352;4189;14664;9803;36016
316730;201412;449;1427;396;1325;102;400;203;624;305;1024
316740;201412;784;2685;703;2518;264;1020;223;773;487;1793
316750;201412;436;1507;385;1395;100;411;129;434;229;845
316760;201412;3752;12623;3167;11924;1818;6855;958;3816;2776;10671
316770;201412;1540;4498;1365;4261;210;720;935;2990;1145;3710
316780;201412;747;2565;679;2430;252;974;187;624;439;1598
316790;201412;896;2645;656;2211;194;726;221;733;415;1459
316800;201412;6042;20121;5477;19042;1153;4650;2761;9158;3914;13808
316805;201412;921;2506;865;2431;148;391;653;1901;801;2292
316810;201412;631;1960;553;1791;182;646;238;742;420;1388
316820;201412;430;1205;279;937;88;327;62;215;150;542
316830;201412;666;2351;642;2309;222;874;274;946;496;1820
316840;201412;3020;9185;2608;8415;702;2574;1089;3332;1791;5906
316850;201412;2287;7128;2051;6696;447;1605;1146;3744;1593;5349
316860;201412;25480;78403;22612;73010;6270;22432;9818;31113;16088;53545
316870;201412;7579;25188;6485;22526;2367;8860;1291;4347;3658;13207
316880;201412;968;3214;911;3108;348;1323;291;933;639;2256
316890;201412;1545;3937;1239;3522;474;1503;538;1452;1012;2955
316900;201412;2876;9048;2486;8245;785;2925;820;2455;1605;5380
316905;201412;508;1739;442;1588;189;705;131;466;320;1171
316910;201412;776;2639;606;2260;152;592;179;691;331;1283
316920;201412;1696;5060;1352;4527;269;964;646;2177;915;3141
316930;201412;9997;34565;8254;30483;2485;10090;1538;5327;4023;15417
316935;201412;5217;15665;3626;12396;1225;4656;724;2324;1949;6980
316940;201412;7265;24276;5991;21469;1629;6437;1558;5374;3187;11811
316950;201412;1652;4817;1420;4485;219;818;941;2953;1160;3771
316960;201412;5710;14611;4706;13310;1036;3154;2703;7667;3739;10821
316970;201412;3769;12182;3557;11819;1166;4422;1216;3718;2382;8140
316980;201412;1119;3332;812;2802;336;1278;199;688;535;1966
316990;201412;10588;35180;9212;31912;3646;13712;1162;3823;4808;17535
317000;201412;2825;9768;2720;9646;207;627;2183;8522;2390;9149
317005;201412;2716;8588;2464;8241;394;1338;1764;6015;2158;7353
317010;201412;34330;89928;21783;69050;6340;22185;5431;18033;11771;40218
317020;201412;59090;171261;37315;124556;9824;36145;9088;28308;18912;64453
317030;201412;907;2535;750;2298;120;430;424;1288;544;1718
317040;201412;13929;41882;11952;38192;4020;13365;4825;15713;8845;29078
317043;201412;900;2537;764;2360;158;503;483;1522;641;2025
317047;201412;1249;3272;927;2732;172;563;422;1233;594;1796
317050;201412;1943;6854;1614;6061;461;1868;599;2158;1060;4026
317052;201412;2575;8179;2282;7731;270;1022;1703;5815;1973;6837
317057;201412;1872;5339;1443;4599;200;770;803;2474;1003;3244
317060;201412;419;1250;311;1001;73;273;101;286;174;559
317065;201412;1271;4219;1156;4030;127;526;901;3114;1028;3640
317070;201412;9727;31945;7254;26148;2114;8410;1493;5408;3607;13818
317075;201412;1324;4122;1110;3719;379;1381;372;1185;751;2566
317080;201412;7583;21601;6751;20187;2084;6650;2610;7787;4694;14437
317090;201412;5093;17128;4747;16532;720;2573;3273;11628;3993;14201
317100;201412;3591;10355;2933;9236;982;3405;1158;3455;2140;6860
317103;201412;2068;7198;1746;6527;361;1674;788;2857;1149;4531
317107;201412;1429;4402;1227;3988;250;948;678;2064;928;3012
317110;201412;791;2089;540;1622;154;537;218;606;372;1143
317115;201412;1150;3680;993;3340;151;529;639;2174;790;2703
317120;201412;13963;47464;11833;42349;3883;14886;4379;15391;8262;30277
317130;201412;9389;29752;8312;27799;2295;8598;3659;11947;5954;20545
317140;201412;684;2337;644;2260;89;341;424;1487;513;1828
317150;201412;1110;3039;935;2840;105;360;696;2119;801;2479
317160;201412;3973;10504;2948;9169;387;1369;2021;6222;2408;7591
317170;201412;2048;5870;1762;5381;224;811;1070;3079;1294;3890
317180;201412;1901;6419;1490;5497;440;1780;469;1674;909;3454
317190;201412;1438;4122;1185;3775;170;553;829;2654;999;3207
317200;201412;5099;16600;4545;15456;1490;5555;1487;4838;2977;10393
317210;201412;1167;3530;964;3228;254;953;476;1601;730;2554
317220;201412;363;1287;352;1274;125;462;183;675;308;1137
320010;201412;6138;19204;5365;17498;1010;3527;2769;8983;3779;12510
320013;201412;2132;6294;1497;5076;235;842;795;2758;1030;3600
320016;201412;3666;10166;3085;9324;487;1455;2154;6656;2641;8111
320020;201412;4581;14534;4016;13347;1341;4750;1445;4763;2786;9513
320030;201412;1597;5133;1279;4422;401;1475;479;1601;880;3076
320035;201412;2002;6006;1793;5681;528;1868;872;2620;1400;4488
320040;201412;3266;10942;2624;9375;669;2637;745;2532;1414;5169
320050;201412;2020;5484;1741;4957;299;953;1056;2947;1355;3900
320060;201412;11851;37676;9124;31163;2328;8784;3115;10018;5443;18802
320070;201412;1643;5425;1360;4738;390;1512;338;1040;728;2552
320080;201412;5868;17199;4566;14526;1439;4886;1413;4439;2852;9325
320090;201412;9258;26576;7170;22449;1978;6607;3130;9507;5108;16114
320100;201412;3300;9968;2695;8749;683;2382;1259;4015;1942;6397
320110;201412;1574;4781;1418;4480;390;1319;503;1551;893;2870
320115;201412;1848;6602;1671;6240;893;3481;466;1748;1359;5229
320120;201412;19193;63114;15823;56222;5470;20863;4569;16381;10039;37244
320130;201412;44337;146710;40803;139125;11112;41169;19168;63847;30280;105016
320140;201412;4204;13481;2910;10329;774;3060;322;1056;1096;4116
320150;201412;18930;53534;13860;43632;4294;14613;2609;8043;6903;22656
320160;201412;5655;17254;4815;15761;1317;4873;1949;5870;3266;10743
320170;201412;1705;5544;1410;4863;395;1431;539;1887;934;3318
320180;201412;915;3011;814;2849;333;1205;272;963;605;2168
320190;201412;3976;13663;3131;11527;966;3771;905;3267;1871;7038
320200;201412;1199;3841;1042;3528;304;1099;438;1515;742;2614
320210;201412;5089;14278;4366;12912;930;3132;2364;6645;3294;9777
320220;201412;3120;9498;2447;8273;727;2685;942;3213;1669;5898
320225;201412;1604;5560;1318;4827;489;1903;286;1090;775;2993
320230;201412;4545;15014;4129;14284;1429;5332;1469;5110;2898;10442
320240;201412;11301;33783;8581;28522;2494;8962;2298;7621;4792;16583
320245;201412;4215;14333;3895;13534;1303;4824;1344;4523;2647;9347
320250;201412;1901;5926;1413;4814;387;1481;302;907;689;2388
320255;201412;2105;7028;1825;6538;746;2883;647;2381;1393;5264
320260;201412;1098;3396;825;2709;225;833;262;726;487;1559
320265;201412;2621;8046;2218;7543;382;1340;1513;5300;1895;6640
320270;201412;2860;8719;2166;7304;568;2077;932;3078;1500;5155
320280;201412;7547;23011;6749;21442;1688;5850;3128;9656;4816;15506
320290;201412;1772;5855;1374;4825;493;1815;317;1019;810;2834
320300;201412;4495;15147;4095;14215;1326;4890;1229;4240;2555;9130
320305;201412;4933;16169;4417;14970;1141;4228;1960;6430;3101;10658
320310;201412;2100;6344;1833;5838;502;1710;788;2434;1290;4144
320313;201412;2491;7475;1757;5761;496;1870;302;885;798;2755
320316;201412;2396;7325;2086;6675;676;2265;843;2659;1519;4924
320320;201412;20689;65769;17148;58813;5207;19726;6291;21033;11498;40759
320330;201412;3196;9580;2732;8778;588;1853;1573;5271;2161;7124
320332;201412;5312;17992;4756;16930;1697;6370;1721;6259;3418;12629
320334;201412;1677;5539;1211;4478;408;1689;249;836;657;2525
320335;201412;2405;7246;1649;5470;534;1958;326;1009;860;2967
320340;201412;6071;17012;4830;14852;1181;3986;2241;6793;3422;10779
320350;201412;5753;15090;4164;12275;997;3187;1673;4844;2670;8031
320360;201412;1815;4856;1340;3943;264;892;630;1714;894;2606
320370;201412;3676;12019;3009;10561;942;3391;1131;3976;2073;7367
320380;201412;2991;9031;2663;8422;507;1752;1601;4971;2108;6723
320390;201412;7691;23510;6269;20494;2053;7398;1974;6061;4027;13459
320400;201412;4209;12141;3484;11033;1032;3672;1428;4209;2460;7881
320405;201412;4291;12687;3877;12105;1191;4016;2012;6157;3203;10173
320410;201412;6455;16044;4633;13860;933;2943;2750;8246;3683;11189
320420;201412;1653;5125;1182;4271;390;1545;215;764;605;2309
320425;201412;2496;6392;2027;5685;364;1118;1207;3373;1571;4491
320430;201412;2516;7316;2245;6775;487;1562;1179;3511;1666;5073
320435;201412;2718;9111;2302;8229;1085;4025;691;2581;1776;6606
320440;201412;1478;4950;1312;4487;388;1441;427;1381;815;2822
320450;201412;2598;8335;2187;7436;661;2427;900;2970;1561;5397
320455;201412;4753;16284;3483;13026;1154;4558;840;3090;1994;7648
320460;201412;3305;10648;2620;9195;753;2847;944;3174;1697;6021
320465;201412;1786;5612;1380;4634;338;1221;531;1717;869;2938
320470;201412;4944;15087;3453;11722;1087;4035;530;1593;1617;5628
320480;201412;2036;6130;1670;5398;423;1583;708;2166;1131;3749
320490;201412;15840;49427;12950;43580;4282;15510;3925;13295;8207;28805
320495;201412;1401;4402;1061;3623;470;1654;135;490;605;2144
320500;201412;49911;155114;43360;142443;12910;46184;19612;62702;32522;108886
320501;201412;4074;13110;3639;12369;1146;4388;1589;5219;2735;9607
320503;201412;1747;6050;1424;5283;478;1940;441;1473;919;3413
320506;201412;3568;11284;2357;8132;764;2816;189;563;953;3379
320510;201412;9520;30241;8244;27616;2502;9085;3466;11372;5968;20457
320515;201412;2257;6472;1919;5766;567;1788;658;1934;1225;3722
320517;201412;2406;7799;1956;6827;773;2907;432;1410;1205;4317
320520;201412;38224;120266;31826;107474;9966;36776;12512;41978;22478;78754
320530;201412;30815;95340;25911;85435;6768;25407;11633;36263;18401;61670
330010;201412;19908;61696;18007;57756;3655;13070;10549;32815;14204;45885
330015;201412;2061;5730;1780;5200;461;1510;679;1909;1140;3419
330020;201412;17967;53637;16355;50976;3746;12727;9320;28572;13066;41299
330022;201412;1756;5616;1544;5207;329;1295;840;2716;1169;4011
330023;201412;3654;11863;3384;11298;954;3441;1364;4354;2318;7795
330025;201412;4190;11768;3522;10783;896;3031;1952;5835;2848;8866
330030;201412;8451;28649;7435;26452;2002;7823;3337;11393;5339;19216
330040;201412;15330;44401;12949;40362;3434;11528;6369;19363;9803;30891
330045;201412;73524;208772;66301;197810;9566;30786;46122;136401;55688;167187
330050;201412;3057;9745;2712;9045;942;3504;794;2457;1736;5961
330060;201412;5997;18027;5334;17050;1337;4727;2967;9482;4304;14209
330070;201412;27284;83619;24383;78414;6647;22691;11234;36213;17881;58904
330080;201412;9893;28280;9330;27433;1746;4993;6320;19063;8066;24056
330090;201412;3403;9378;3133;8918;833;2547;1542;4320;2375;6867
330093;201412;2088;6210;1729;5484;433;1464;581;1758;1014;3222
330095;201412;1292;4443;1173;4166;428;1685;225;710;653;2395
330100;201412;59116;192180;54030;183004;11984;45079;27993;95138;39977;140217
330110;201412;2817;8906;2556;8404;808;2868;832;2716;1640;5584
330115;201412;2530;7514;2308;7141;658;2240;1086;3243;1744;5483
330120;201412;2665;7724;2417;7372;749;2495;1122;3289;1871;5784
330130;201412;4295;14102;3856;13251;1259;4646;1553;5321;2812;9967
330140;201412;3724;11316;3351;10776;933;3205;1665;5426;2598;8631
330150;201412;2690;8041;2075;6747;551;1952;515;1627;1066;3579
330160;201412;1476;5103;1369;4879;502;1923;511;1776;1013;3699
330170;201412;111584;337734;103793;325127;17211;57604;70281;220119;87492;277723
330180;201412;1951;5905;1695;5417;231;934;1066;3173;1297;4107
330185;201412;8711;27384;7860;25728;2128;7388;3899;12840;6027;20228
330187;201412;4608;13219;4065;12305;828;2730;2462;7473;3290;10203
330190;201412;30571;90695;28788;87717;6715;21546;17549;52966;24264;74512
330200;201412;14855;46830;13320;43917;3313;11124;7038;23649;10351;34773
330205;201412;2705;7355;2371;6775;584;1865;1182;3270;1766;5135
330210;201412;4507;11883;3273;9595;977;3104;811;2341;1788;5445
330220;201412;12314;38540;11068;35842;3645;12703;3274;10112;6919;22815
330225;201412;4271;13451;4002;13044;499;1880;2918;9635;3417;11515
330227;201412;19169;53710;16825;50368;4173;13246;9435;27930;13608;41176
330230;201412;1549;4609;1408;4355;413;1419;576;1682;989;3101
330240;201412;21540;66851;18978;62005;7534;26618;3795;12045;11329;38663
330245;201412;1338;4200;1089;3689;314;1159;258;874;572;2033
330250;201412;39370;115482;36205;110052;10916;33665;17206;53451;28122;87116
330260;201412;4243;13275;3788;12308;938;3339;1743;5426;2681;8765
330270;201412;15697;44456;12879;40083;3914;13014;4901;15331;8815;28345
330280;201412;2190;6772;1839;6037;392;1427;885;2750;1277;4177
330285;201412;20497;60269;18769;57710;3717;12218;11976;36872;15693;49090
330290;201412;3766;10639;3323;9993;681;2334;1971;5678;2652;8012
330300;201412;4257;13780;3942;13190;919;3307;2121;7099;3040;10406
330310;201412;2907;8375;2592;7815;619;1903;1308;3944;1927;5847
330320;201412;13408;40109;12546;38765;1948;6551;8964;27555;10912;34106
330330;201412;34348;98081;31246;93010;7018;22379;19154;56276;26172;78655
330340;201412;16010;48942;12888;42720;4151;14646;3697;12197;7848;26843
330350;201412;100457;311993;95658;304671;17908;58131;66286;213330;84194;271461
330360;201412;6038;18768;5892;18538;710;2429;4657;14580;5367;17009
330370;201412;4084;14942;3794;14273;1481;5831;1237;4674;2718;10505
330380;201412;5042;16196;4338;14859;1072;3951;2109;7135;3181;11086
330385;201412;4285;14831;3954;14146;1368;5192;1501;5326;2869;10518
330390;201412;25371;85227;22926;80157;5838;22704;11220;38248;17058;60952
330395;201412;3575;10589;3281;10067;593;2024;1994;6041;2587;8065
330400;201412;2738;9090;2491;8602;522;2096;1310;4188;1832;6284
330410;201412;3178;10132;2730;9228;627;2263;1378;4648;2005;6911
330411;201412;2743;8692;2390;7947;463;1811;1284;4012;1747;5823
330412;201412;1481;5069;1170;4455;316;1372;425;1520;741;2892
330414;201412;27219;77059;23319;71756;4321;13825;15089;46789;19410;60614
330415;201412;3881;12004;3386;11068;932;3243;1434;4713;2366;7956
330420;201412;9558;29305;6701;23467;1976;7578;1205;4105;3181;11683
330430;201412;8799;25793;7759;23908;1819;6140;3887;11778;5706;17918
330440;201412;2182;7260;1826;6512;636;2543;411;1318;1047;3861
330450;201412;1756;5933;1609;5655;492;1958;705;2427;1197;4385
330452;201412;11798;35671;9341;30691;2585;9383;3605;11370;6190;20753
330455;201412;512943;1486226;433720;1354800;114278;379571;217402;676187;331680;1055758
330460;201412;1444;4780;1315;4547;340;1353;623;2117;963;3470
330470;201412;5053;16015;4577;15090;1534;5568;1672;5264;3206;10832
330475;201412;8750;27393;7782;25701;2258;8109;3377;11101;5635;19210
330480;201412;6877;20350;6278;19401;1688;5594;3035;9274;4723;14868
330490;201412;108412;300551;100009;288197;12691;38270;76507;221487;89198;259757
330500;201412;7269;22099;6825;21206;1458;4854;3879;12266;5337;17120
330510;201412;45066;143666;41850;138209;13660;45897;20435;68980;34095;114877
330513;201412;1639;4904;1488;4618;522;1647;594;1874;1116;3521
330515;201412;3199;10109;2884;9504;941;3268;1014;3299;1955;6567
330520;201412;13832;41343;12489;38948;3278;10734;6275;19623;9553;30357
330530;201412;1622;4849;1463;4542;391;1305;650;1981;1041;3286
330540;201412;3652;10835;3089;9891;858;2962;1317;4158;2175;7120
330550;201412;9190;30281;8046;28091;3466;12750;1858;6499;5324;19249
330555;201412;10974;33108;9809;31329;1950;6388;6201;20194;8151;26582
330560;201412;4453;13533;4075;12887;906;3254;2112;6424;3018;9678
330570;201412;3775;10892;3192;9902;837;2673;1629;5131;2466;7804
330575;201412;5898;17330;5316;16315;1130;3810;3162;9350;4292;13160
330580;201412;18135;58106;15743;53154;5075;18006;5977;20415;11052;38421
330590;201412;2039;6112;1903;5874;530;1677;1019;3176;1549;4853
330600;201412;11071;32085;8940;28579;1382;5317;5290;16285;6672;21602
330610;201412;9591;30694;8820;29259;2044;7605;4706;15387;6750;22992
330615;201412;1767;6218;1597;5801;701;2676;454;1689;1155;4365
330620;201412;4241;14711;3858;13953;1421;5465;1079;4006;2500;9471
330630;201412;24667;76955;21023;70047;5194;19501;10627;33863;15821;53364
350010;201412;3075;9582;2365;8070;786;2818;444;1424;1230;4242
350020;201412;652;1858;492;1547;139;491;196;586;335;1077
350030;201412;5115;16119;4180;14055;1705;6252;981;3090;2686;9342
350040;201412;623;2226;521;1987;169;700;119;396;288;1096
350050;201412;1471;4753;1224;4262;343;1365;409;1313;752;2678
350055;201412;691;2223;653;2163;201;755;321;993;522;1748
350060;201412;94;322;86;307;27;114;32;104;59;218
350070;201412;2709;8884;2044;7308;502;1968;404;1244;906;3212
350075;201412;581;1998;494;1838;171;704;136;460;307;1164
350080;201412;653;1898;498;1586;118;412;192;605;310;1017
350090;201412;617;1739;454;1452;126;437;127;362;253;799
350100;201412;2145;7185;1705;6170;574;2218;503;1752;1077;3970
350110;201412;515;1557;393;1275;89;331;152;451;241;782
350115;201412;1272;4015;1109;3627;228;864;566;1688;794;2552
350120;201412;550;1461;270;855;66;235;49;145;115;380
350130;201412;3978;12010;3569;11177;847;2992;1700;4963;2547;7955
350140;201412;712;2250;635;2104;154;582;277;870;431;1452
350150;201412;470;1595;421;1480;163;601;120;425;283;1026
350160;201412;6933;21655;5192;17811;1517;5810;1988;6207;3505;12017
350170;201412;2363;8341;2082;7600;708;2702;502;1738;1210;4440
350180;201412;1489;3924;1227;3470;329;964;533;1485;862;2449
350190;201412;3569;11887;3049;10829;804;3371;1506;4849;2310;8220
350200;201412;416;1426;377;1354;128;513;139;490;267;1003
350210;201412;7928;22041;6167;18966;2339;7783;2064;6023;4403;13806
350220;201412;3281;10489;2970;9912;1003;3810;958;2915;1961;6725
350230;201412;807;2729;737;2606;243;929;263;935;506;1864
350240;201412;617;1880;538;1753;126;459;303;959;429;1418
350250;201412;2868;10639;2766;10434;1123;4485;970;3641;2093;8126
350260;201412;1143;3031;916;2631;222;652;397;1155;619;1807
350270;201412;5546;16983;4831;15433;1001;3446;2333;7350;3334;10796
350275;201412;2164;7257;1932;6867;564;2191;718;2405;1282;4596
350280;201412;24827;63754;15745;47338;4029;12867;3843;11542;7872;24409
350290;201412;2073;7006;1752;6273;525;1946;548;2014;1073;3960
350300;201412;549;1703;491;1588;147;491;207;675;354;1166
350310;201412;991;3322;888;3073;207;816;370;1224;577;2040
350315;201412;582;1826;474;1593;92;392;145;442;237;834
350320;201412;12467;39423;10601;35427;3133;11185;1641;5535;4774;16720
350330;201412;13525;39198;8801;27574;1933;6346;3213;9327;5146;15673
350335;201412;567;1672;521;1577;138;431;220;729;358;1160
350340;201412;1201;3703;892;3077;230;888;281;924;511;1812
350350;201412;781;2480;684;2318;169;676;254;853;423;1529
350360;201412;948;3334;817;3041;256;999;296;1134;552;2133
350370;201412;753;2319;550;1843;118;445;112;319;230;764
350380;201412;4046;13079;3345;11901;1325;5131;855;2865;2180;7996
350390;201412;9109;29236;8040;27143;2349;8454;3554;11649;5903;20103
350395;201412;382;1130;238;828;61;229;53;177;114;406
350400;201412;8913;26016;7304;23040;2068;7151;2856;8604;4924;15755
350410;201412;8815;31273;7267;27662;2478;10215;1633;5959;4111;16174
350420;201412;975;3104;773;2712;374;1363;95;325;469;1688
350430;201412;888;2808;760;2576;207;822;370;1197;577;2019
350440;201412;1515;4881;1413;4672;458;1622;678;2150;1136;3772
350450;201412;8272;24967;6461;21270;1879;6730;1741;5387;3620;12117
350460;201412;1653;4877;1174;3821;341;1247;358;1050;699;2297
350470;201412;261;723;214;646;51;190;107;291;158;481
350480;201412;766;2366;512;1770;84;327;91;270;175;597
350490;201412;2148;6242;1826;5795;526;1922;794;2321;1320;4243
350500;201412;638;1885;555;1754;148;502;229;689;377;1191
350510;201412;1195;3774;958;3196;259;986;348;1050;607;2036
350520;201412;1079;3974;878;3501;278;1224;227;834;505;2058
350530;201412;2697;8125;2217;7068;796;2734;631;1843;1427;4577
350535;201412;1519;4558;1433;4402;98;369;1156;3512;1254;3881
350540;201412;2139;6044;1761;5349;513;1681;663;1996;1176;3677
350550;201412;12005;34503;9207;29562;2473;8900;3540;10759;6013;19659
350560;201412;3739;12437;3362;11620;647;2395;1741;6076;2388;8471
350570;201412;22543;77428;20454;72534;6720;25454;7384;25187;14104;50641
350580;201412;2079;6774;1604;5626;493;1905;248;750;741;2655
350590;201412;4035;12693;2995;10464;877;3422;1020;3207;1897;6629
350600;201412;42919;109212;29624;87218;5908;19212;14963;42395;20871;61607
350610;201412;9741;28403;7645;24726;2046;7372;3295;10311;5341;17683
350620;201412;510;1550;414;1393;106;402;172;541;278;943
350630;201412;1815;5548;1417;4742;414;1569;305;901;719;2470
350635;201412;5750;18200;4522;15792;1361;5050;1717;5972;3078;11022
350640;201412;710;2314;557;1905;149;549;149;477;298;1026
350650;201412;7099;21778;3781;13469;1130;4433;358;1264;1488;5697
350660;201412;4019;12484;3461;11492;814;2996;1860;6032;2674;9028
350670;201412;1959;6098;1820;5836;384;1355;1118;3456;1502;4811
350680;201412;1290;4009;1027;3461;293;1147;401;1281;694;2428
350690;201412;1145;3803;964;3421;301;1176;283;936;584;2112
350700;201412;2932;10027;2528;9098;991;3862;838;2703;1829;6565
350710;201412;2463;7753;2197;7308;347;1275;1464;4840;1811;6115
350715;201412;1122;3413;981;3147;307;1127;328;950;635;2077
350720;201412;145;439;130;406;44;153;45;120;89;273
350730;201412;463;1741;435;1665;131;559;148;530;279;1089
350740;201412;2553;7753;2188;6928;571;1969;909;2842;1480;4811
350745;201412;417;1292;310;1036;62;246;139;407;201;653
350750;201412;10659;32634;8172;27520;2288;8455;2076;6534;4364;14989
350760;201412;13409;42179;11750;39090;3581;13179;5020;15945;8601;29124
350770;201412;951;2800;688;2279;161;610;274;873;435;1483
350775;201412;714;2016;609;1838;151;529;284;831;435;1360
350780;201412;2246;6854;1671;5617;515;1920;234;729;749;2649
350790;201412;2307;7459;1791;6358;543;2081;401;1267;944;3348
350800;201412;3329;11215;3148;10907;654;2579;1924;6486;2578;9065
350810;201412;2709;7878;2344;7244;833;2793;729;2256;1562;5049
350820;201412;601;1645;442;1312;90;325;187;496;277;821
350830;201412;953;2995;676;2318;126;465;145;422;271;887
350840;201412;2520;8992;2069;7829;666;2770;411;1327;1077;4097
350850;201412;7099;24031;5918;21207;2150;8159;1470;5061;3620;13220
350860;201412;3561;11382;3400;11128;467;1755;2582;8373;3049;10128
350870;201412;2643;8794;2299;8257;662;2580;1285;4659;1947;7239
350880;201412;1770;5973;1511;5389;495;1872;320;1127;815;2999
350890;201412;718;2121;503;1630;110;417;131;336;241;753
350900;201412;4783;16111;3872;13947;1079;4214;975;3299;2054;7513
350910;201412;960;2890;862;2677;335;1084;300;902;635;1986
350920;201412;10700;31792;9729;30119;1823;6230;6242;18629;8065;24859
350925;201412;4620;14185;3848;12567;1023;3634;1601;4857;2624;8491
350930;201412;1660;4598;1370;4115;175;631;942;2721;1117;3352
350940;201412;2400;8018;2188;7662;496;2019;1291;4329;1787;6348
350945;201412;985;3268;865;3002;211;811;392;1301;603;2112
350950;201412;76680;244742;64254;218556;18446;68352;26315;86625;44761;154977
350960;201412;4973;17398;4380;16036;853;3590;2480;8733;3333;12323
350970;201412;4762;17018;4131;15474;1471;5973;1163;4090;2634;10063
350980;201412;739;2397;675;2286;319;1131;195;676;514;1807
350990;201412;1931;6678;1687;6198;592;2341;518;1836;1110;4177
350995;201412;882;3099;836;3006;200;846;455;1565;655;2411
351000;201412;3798;11507;3250;10442;513;1887;1818;5625;2331;7512
351010;201412;457;1358;324;1082;125;464;81;262;206;726
351015;201412;982;3273;847;3014;290;1139;308;1055;598;2194
351020;201412;8322;26864;7308;25226;1984;7331;3515;12259;5499;19590
351030;201412;1673;5999;1523;5650;404;1753;575;1980;979;3733
351040;201412;3934;12534;3621;11959;793;3072;2141;6661;2934;9733
351050;201412;10796;33973;8469;29360;2704;10214;2822;9644;5526;19858
351060;201412;38599;119243;31953;106562;9630;34396;12429;40726;22059;75122
351070;201412;1983;5578;1391;4506;493;1745;240;645;733;2390
351080;201412;2985;8959;2353;8136;685;2637;1079;3608;1764;6245
351090;201412;418;1446;325;1237;87;377;77;287;164;664
351100;201412;2232;7018;1862;6259;721;2503;567;1937;1288;4440
351110;201412;8671;22410;4771;15504;1320;4773;1228;3669;2548;8442
351120;201412;671;1997;542;1718;72;265;276;786;348;1051
351130;201412;934;2607;491;1675;93;382;122;379;215;761
351140;201412;2090;7226;1900;6805;710;2766;586;2030;1296;4796
351150;201412;2384;8265;1882;6888;553;2207;433;1429;986;3636
351160;201412;1627;5699;1457;5299;474;1909;505;1753;979;3662
351170;201412;1705;5649;1377;4870;354;1360;573;1885;927;3245
351190;201412;737;2391;594;2017;145;531;125;367;270;898
351200;201412;2465;7395;2065;6570;541;1953;745;2140;1286;4093
351210;201412;1199;3731;972;3263;293;1055;326;1013;619;2068
351220;201412;3704;12475;3267;11556;851;3250;1506;5286;2357;8536
351230;201412;2088;6836;1848;6374;504;1923;965;3244;1469;5167
351240;201412;1048;3311;748;2613;209;808;187;561;396;1369
351250;201412;919;2636;663;2112;134;461;297;913;431;1374
351260;201412;1218;3593;1085;3312;278;924;449;1303;727;2227
351270;201412;426;1499;387;1416;116;488;144;470;260;958
351280;201412;5633;16988;4132;13569;1080;3786;1347;4034;2427;7820
351290;201412;1185;3474;938;2987;288;953;327;968;615;1921
351300;201412;12158;43087;9861;37756;2941;12210;3388;12864;6329;25074
351310;201412;3602;11256;2994;10142;746;2903;1399;4406;2145;7309
351320;201412;1059;3727;920;3395;310;1240;236;767;546;2007
351330;201412;307;872;259;784;111;340;62;184;173;524
351340;201412;6996;24243;6281;22735;1854;7069;2926;10615;4780;17684
351350;201412;8488;27789;7406;25402;2274;8212;2585;8443;4859;16655
351360;201412;5013;15356;4672;14715;1265;4327;2116;6456;3381;10783
351370;201412;2348;7470;1866;6434;548;2142;611;1914;1159;4056
351380;201412;39649;123113;36374;116537;9333;32577;16865;51926;26198;84503
351385;201412;259;813;249;796;85;277;104;324;189;601
351390;201412;1347;4480;1164;4095;409;1577;453;1490;862;3067
351400;201412;1252;4077;1176;3892;467;1640;346;1159;813;2799
351410;201412;3124;9446;2757;8779;630;2155;1474;4588;2104;6743
351420;201412;469;1386;336;1100;99;332;67;217;166;549
351430;201412;926;2953;844;2805;134;472;596;1989;730;2461
351440;201412;4960;15148;4113;13236;1472;4864;1026;3117;2498;7981
351450;201412;1930;5474;1672;5109;532;1682;786;2477;1318;4159
351460;201412;867;2718;735;2466;360;1276;208;666;568;1942
351470;201412;1151;3523;1024;3274;367;1281;336;1042;703;2323
351480;201412;3101;10043;2813;9547;627;2530;1449;4738;2076;7268
351490;201412;2101;7107;1879;6617;365;1487;1053;3555;1418;5042
351492;201412;194;613;135;470;26;106;61;201;87;307
351495;201412;166;566;131;476;42;164;43;144;85;308
351500;201412;23292;73779;19917;66876;6367;23422;7581;24423;13948;47845
351510;201412;8419;26930;7053;24291;1793;6698;3465;11775;5258;18473
351512;201412;460;1361;385;1215;89;296;188;587;277;883
351515;201412;2371;7620;1730;6142;518;2006;475;1553;993;3559
351518;201412;1850;6147;1305;5092;382;1692;297;1059;679;2751
351519;201412;905;2830;741;2456;216;849;275;796;491;1645
351520;201412;831;2319;408;1451;80;328;66;200;146;528
351530;201412;397;1216;294;972;40;144;100;289;140;433
351535;201412;2748;7084;2195;6289;247;812;1556;4408;1803;5220
351540;201412;2309;7262;2002;6686;873;3108;419;1376;1292;4484
351550;201412;4419;12919;3137;10339;748;2816;1162;3689;1910;6505
351560;201412;458;1476;396;1334;122;442;80;263;202;705
351565;201412;252;849;233;800;74;290;98;305;172;595
351570;201412;13976;44855;12106;40948;3406;12277;5856;19468;9262;31745
351580;201412;417;1168;304;929;57;174;106;315;163;489
351590;201412;548;1517;424;1261;119;381;107;298;226;679
351600;201412;2037;5779;1799;5372;373;1277;879;2453;1252;3730
351610;201412;715;1962;563;1693;97;336;283;800;380;1136
351620;201412;18379;59481;13802;49532;3484;13872;3454;10886;6938;24758
351630;201412;17186;56373;15667;53703;3841;13803;9021;30918;12862;44721
351640;201412;9720;30977;8095;28004;1850;7036;4273;14469;6123;21505
351650;201412;442;1328;247;823;68;246;40;123;108;369
351660;201412;772;2437;568;1923;138;502;166;498;304;1000
351670;201412;4112;12809;3399;11270;692;2663;1686;5216;2378;7879
351680;201412;688;2111;425;1428;99;352;70;207;169;559
351685;201412;475;1453;385;1290;103;355;160;550;263;905
351690;201412;1414;4210;1081;3428;425;1347;302;909;727;2256
351700;201412;1582;4700;1413;4374;472;1519;520;1561;992;3080
351710;201412;828;2589;689;2276;172;589;226;696;398;1285
351720;201412;1841;5758;1329;4423;318;1150;441;1361;759;2511
351730;201412;1210;3540;1015;3273;405;1452;342;1042;747;2494
351740;201412;4822;13610;3937;11766;1030;3299;1326;3735;2356;7034
351750;201412;1636;5378;1372;4810;451;1755;391;1260;842;3015
351760;201412;3997;12690;3446;11450;971;3459;1382;4379;2353;7838
351770;201412;2489;7911;2117;7243;625;2284;1047;3516;1672;5800
351780;201412;1660;4708;1040;3316;268;929;250;745;518;1674
351790;201412;1215;3611;1047;3370;371;1248;441;1405;812;2653
351800;201412;432;963;321;810;41;113;199;485;240;598
351810;201412;1243;3723;1160;3619;275;988;751;2250;1026;3238
351820;201412;1972;6287;1588;5575;529;1971;193;652;722;2623
351830;201412;4726;15109;3815;12905;899;3321;1801;5862;2700;9183
351840;201412;9443;32634;8357;30340;2852;10997;2853;10178;5705;21175
351850;201412;1643;5162;1295;4432;339;1350;446;1336;785;2686
351860;201412;3811;12328;3408;11478;1011;3701;1461;4683;2472;8384
351870;201412;36976;113916;32978;106485;8751;29973;17049;54913;25800;84886
351880;201412;107782;348953;93650;317819;29334;105340;28173;93991;57507;199331
351885;201412;668;2427;621;2318;184;746;280;1001;464;1747
351890;201412;871;2637;700;2269;220;770;173;528;393;1298
351900;201412;1472;4532;1268;4209;378;1332;494;1641;872;2973
351905;201412;468;1590;394;1451;91;407;204;686;295;1093
351907;201412;16753;52158;14407;47640;2889;10941;7907;25057;10796;35998
351910;201412;1280;4014;1156;3801;290;1084;451;1389;741;2473
351920;201412;1238;3547;1144;3396;267;894;660;1910;927;2804
351925;201412;1062;3164;958;2963;157;577;577;1671;734;2248
351930;201412;3320;11224;3089;10734;858;3481;1501;4744;2359;8225
351940;201412;1083;3321;995;3165;284;990;569;1727;853;2717
351950;201412;1471;4075;1069;3303;189;654;549;1628;738;2282
351960;201412;4380;13107;3354;11217;958;3382;1538;5136;2496;8518
351970;201412;7206;27267;6511;25728;2346;9698;2170;8634;4516;18332
351980;201412;1015;3089;807;2668;190;716;313;907;503;1623
351990;201412;1694;4864;1351;4190;403;1437;334;894;737;2331
352000;201412;2602;8371;2367;7885;655;2343;1034;3274;1689;5617
352010;201412;2374;7989;2119;7368;731;2654;446;1531;1177;4185
352020;201412;1670;5343;1468;4923;441;1579;537;1745;978;3324
352030;201412;5092;15369;4407;14360;1125;3877;2402;7925;3527;11802
352040;201412;2127;7338;1771;6430;489;1922;420;1409;909;3331
352042;201412;2767;7778;1973;6080;445;1492;985;2978;1430;4470
352044;201412;1440;4859;1094;3970;255;1001;210;678;465;1679
352050;201412;7272;23420;4941;18069;1475;5976;992;3128;2467;9104
352060;201412;876;2590;760;2391;201;757;309;883;510;1640
352070;201412;762;2050;701;1954;268;784;256;757;524;1541
352080;201412;611;1832;484;1598;145;543;168;500;313;1043
352090;201412;1807;5858;1414;4979;375;1487;359;1092;734;2579
352100;201412;2589;8092;1868;6623;532;2103;644;2076;1176;4179
352110;201412;518;1907;461;1764;144;583;165;604;309;1187
352115;201412;426;1401;364;1263;90;361;162;512;252;873
352120;201412;904;2758;774;2538;145;540;430;1389;575;1929
352130;201412;1944;5627;1362;4441;402;1395;442;1324;844;2719
352140;201412;1798;5548;1244;4311;331;1238;528;1785;859;3023
352150;201412;732;2215;559;1872;156;530;245;798;401;1328
352160;201412;1323;3696;1194;3524;269;848;700;2074;969;2922
352170;201412;2693;8190;2421;7664;554;1970;1304;3891;1858;5861
352180;201412;3777;10817;3232;9801;905;3026;1316;3749;2221;6775
352190;201412;1226;3770;1120;3581;244;898;590;1790;834;2688
352200;201412;469;1621;385;1450;83;337;192;750;275;1087
352210;201412;16574;44512;13094;39313;2436;7670;7960;24363;10396;32033
352215;201412;577;1811;523;1731;75;297;318;1039;393;1336
352220;201412;15506;51604;14148;48756;4921;17987;5067;17333;9988;35320
352230;201412;14225;48645;12438;45166;3935;15529;4731;16842;8666;32371
352240;201412;10856;33609;9250;30612;3015;11206;3523;10933;6538;22139
352250;201412;22299;72159;19596;66462;5587;20418;7432;24889;13019;45307
352260;201412;6322;18947;4188;14340;1042;3977;1438;4531;2480;8508
352265;201412;938;2969;787;2715;122;507;471;1560;593;2067
352270;201412;2604;8939;2220;8037;852;3186;520;1818;1372;5004
352280;201412;2583;7967;2148;7206;587;2212;702;2235;1289;4447
352290;201412;1373;4405;1185;3988;302;1168;389;1180;691;2348
352300;201412;1068;3177;867;2809;250;890;390;1209;640;2099
352310;201412;34177;107781;29834;100218;7646;27562;17251;57510;24897;85072
352320;201412;5784;17921;4976;16331;1485;5338;1710;5082;3195;10420
352330;201412;1875;6205;1635;5869;570;2182;546;1942;1116;4124
352340;201412;6092;20679;4909;17814;1568;6135;966;3185;2534;9320
352350;201412;1880;6876;1708;6477;494;2012;606;2219;1100;4231
352360;201412;1248;4081;1108;3804;291;1204;638;2034;929;3238
352370;201412;942;3210;853;3010;197;798;403;1366;600;2164
352380;201412;1058;3369;929;3141;338;1270;265;861;603;2131
352390;201412;16977;47485;11325;36252;2260;8410;5485;16309;7745;24719
352400;201412;3416;9940;2190;7450;599;2220;718;2249;1317;4469
352410;201412;3907;11435;3008;9875;967;3450;961;3003;1928;6453
352420;201412;1333;3806;1229;3627;424;1392;510;1476;934;2868
352430;201412;6745;21110;5900;19694;2235;8068;2000;6566;4235;14634
352440;201412;16848;53014;13748;46757;3910;14336;5056;16705;8966;31041
352450;201412;689;2023;469;1587;123;470;111;327;234;797
352460;201412;2314;7691;1966;7018;656;2599;584;1926;1240;4525
352470;201412;4526;12478;2564;8283;463;1676;969;2928;1432;4604
352480;201412;5689;16050;4597;14006;1144;4008;1926;5381;3070;9389
352490;201412;777;2755;651;2442;158;654;145;510;303;1164
352500;201412;9009;28616;8410;27601;4031;14282;2550;7588;6581;21870
352510;201412;3657;12469;2981;10985;1117;4437;711;2536;1828;6973
352520;201412;2545;9018;2256;8323;627;2467;1113;4041;1740;6508
352530;201412;7312;23600;5303;18941;1592;6137;829;2673;2421;8810
352540;201412;490;1589;368;1307;62;258;107;367;169;625
352550;201412;903;3026;620;2320;165;698;115;373;280;1071
352560;201412;690;2053;510;1648;112;401;193;566;305;967
352570;201412;1607;5295;1159;4198;278;1152;262;836;540;1988
352580;201412;974;2900;833;2656;261;933;377;1129;638;2062
352585;201412;225;737;176;633;65;247;35;131;100;378
352590;201412;11744;37479;10232;34421;2323;8681;5655;18307;7978;26988
352600;201412;2071;6575;1875;6189;624;2193;742;2363;1366;4556
352610;201412;3654;11322;3102;10331;1060;3859;966;3035;2026;6894
352620;201412;5777;18277;5449;17834;1209;4266;3487;11389;4696;15655
352630;201412;881;2904;830;2777;262;943;373;1227;635;2170
352640;201412;3268;10370;2688;9080;570;2139;1237;4045;1807;6184
352650;201412;892;2622;666;2147;152;536;216;643;368;1179
352660;201412;1109;3842;896;3320;258;1046;221;765;479;1811
352670;201412;11380;35027;6989;24917;2161;8160;1303;4459;3464;12619
352680;201412;3490;12145;2693;10159;652;2718;706;2365;1358;5083
352690;201412;30344;87194;21573;69131;5088;17982;9529;29375;14617;47357
352700;201412;806;2383;640;2125;200;750;283;888;483;1638
352710;201412;5664;16803;4146;13667;1112;4069;1584;4973;2696;9042
352720;201412;9504;31619;8740;29969;2908;10414;3405;11597;6313;22011
352725;201412;451;1304;291;959;56;218;99;297;155;515
352730;201412;2839;9783;2492;8826;684;2685;806;2555;1490;5240
352740;201412;2370;7044;2001;6397;504;1877;982;2917;1486;4794
352750;201412;447;1359;317;1056;95;343;70;199;165;542
352760;201412;1082;3808;960;3549;296;1178;453;1599;749;2777
352770;201412;975;2997;904;2868;289;983;324;1020;613;2003
352780;201412;654;2210;566;1999;140;560;184;588;324;1148
352790;201412;627;1817;449;1465;100;350;109;345;209;695
352800;201412;1274;4705;998;3913;321;1311;214;725;535;2036
352810;201412;1153;3067;800;2374;168;585;261;729;429;1314
352820;201412;642;1888;515;1686;206;706;105;342;311;1048
352830;201412;496;1403;343;1081;77;270;69;177;146;447
352840;201412;3911;13558;3420;12457;1090;4210;1043;3762;2133;7972
352850;201412;10570;34085;9200;31599;2812;10215;3354;11563;6166;21778
352860;201412;1102;3647;1020;3460;390;1383;315;1000;705;2383
352870;201412;1156;2940;878;2400;145;500;465;1167;610;1667
352880;201412;2571;7575;1949;6209;502;1706;544;1591;1046;3297
352885;201412;320;1090;305;1057;89;334;141;463;230;797
352890;201412;845;2330;680;2002;157;522;282;750;439;1272
352900;201412;19364;57411;14102;46277;3331;11944;5580;17361;8911;29305
352910;201412;286;922;245;827;85;289;36;115;121;404
352920;201412;3457;10638;2918;9548;968;3434;1040;3147;2008;6581
352930;201412;7087;22763;5820;19872;1751;6468;1083;3470;2834;9938
352940;201412;26349;87963;22275;78047;8031;29659;3948;13109;11979;42768
352950;201412;338;1059;237;837;64;273;66;193;130;466
352960;201412;630;1964;416;1448;78;301;75;241;153;542
352965;201412;388;1108;315;969;88;295;56;164;144;459
352970;201412;3484;9135;3052;8520;499;1447;2083;5900;2582;7347
352980;201412;1606;4834;1364;4444;397;1318;660;2257;1057;3575
352990;201412;3803;12375;3392;11626;1051;4049;1291;4192;2342;8241
353000;201412;574;1616;395;1220;92;307;89;242;181;549
353010;201412;3071;8675;2266;7052;616;2154;770;2191;1386;4345
353020;201412;4644;12778;3133;9444;550;1872;1280;3505;1830;5377
353030;201412;4089;12028;3343;10561;1018;3487;879;2599;1897;6086
353040;201412;748;2149;642;1978;197;662;247;743;444;1405
353050;201412;5833;20012;4965;18165;1752;6920;1636;5695;3388;12615
353060;201412;36355;116072;33896;112031;5292;20755;23793;75675;29085;96430
353070;201412;9955;33161;7530;27595;2482;9668;2011;7283;4493;16951
353080;201412;5546;18483;4190;15351;1316;5234;1179;3997;2495;9231
353090;201412;620;2068;547;1910;95;396;271;862;366;1258
353100;201412;318;910;220;691;100;327;51;158;151;485
353110;201412;8232;25681;7354;24076;1919;6657;3903;12893;5822;19550
353120;201412;489;1620;410;1447;136;535;103;311;239;846
353130;201412;3198;9860;2748;9095;1052;3778;983;3110;2035;6888
353140;201412;2836;7943;2252;6763;720;2373;752;2040;1472;4413
353150;201412;2058;6444;1708;5790;603;2156;472;1612;1075;3768
353160;201412;715;2075;536;1695;167;540;100;284;267;824
353170;201412;529;1858;479;1764;167;693;196;694;363;1387
353180;201412;5834;18106;5033;16580;769;2908;3112;9987;3881;12895
353190;201412;3877;12230;3331;10975;772;2830;1561;4755;2333;7585
353200;201412;884;3039;746;2692;238;938;222;768;460;1706
353205;201412;555;1789;461;1577;106;367;171;585;277;952
353210;201412;1178;3094;916;2627;110;383;601;1671;711;2054
353215;201412;593;1843;511;1660;111;403;152;462;263;865
353220;201412;881;2705;742;2391;206;691;220;714;426;1405
353230;201412;979;3121;888;2960;235;872;259;794;494;1666
353240;201412;2373;7818;2149;7356;624;2380;976;3130;1600;5510
353250;201412;1325;3754;1088;3320;301;971;419;1220;720;2191
353260;201412;1272;3651;1068;3327;324;1095;426;1242;750;2337
353270;201412;706;2136;610;1948;183;632;186;549;369;1181
353280;201412;644;2113;554;1934;193;735;151;500;344;1235
353282;201412;1871;6110;1791;5963;374;1372;1060;3407;1434;4779
353284;201412;311;861;202;638;46;146;57;187;103;333
353286;201412;148;436;99;318;28;90;13;43;41;133
353290;201412;534;1789;450;1643;156;628;192;658;348;1286
353300;201412;1840;5821;1573;5221;476;1728;569;1687;1045;3415
353310;201412;360;1107;327;1043;147;488;94;280;241;768
353320;201412;591;1669;507;1532;113;383;259;749;372;1132
353325;201412;616;2104;509;1854;129;512;84;278;213;790
353330;201412;623;1832;429;1386;98;369;191;553;289;922
353340;201412;3319;10724;2815;9727;1003;3674;984;3351;1987;7025
353350;201412;3710;11229;3207;10325;1138;3926;1356;4241;2494;8167
353360;201412;475;1650;420;1519;106;443;235;805;341;1248
353370;201412;754;2448;670;2236;156;545;352;1165;508;1710
353380;201412;421;1379;373;1291;101;402;158;519;259;921
353390;201412;5710;15365;3963;12150;843;2926;1522;4230;2365;7156
353400;201412;648;2015;539;1787;143;514;146;412;289;926
353410;201412;719;2206;610;2029;178;667;312;1007;490;1674
353420;201412;721;2140;560;1753;182;600;176;515;358;1115
353430;201412;2614;9075;1883;6958;523;2011;198;652;721;2663
353440;201412;64618;211735;56157;191323;17250;61796;18867;62592;36117;124388
353450;201412;491;1485;417;1336;116;421;161;501;277;922
353460;201412;3743;10499;3163;9483;567;1851;1679;5052;2246;6903
353470;201412;11930;37617;9374;32257;3024;11237;2359;7795;5383;19032
353475;201412;1769;5084;1250;3936;281;970;371;1054;652;2024
353480;201412;1593;4767;1415;4429;312;1085;792;2393;1104;3478
353490;201412;1678;4796;1393;4223;409;1385;412;1122;821;2507
353500;201412;1266;3659;1137;3427;480;1516;406;1175;886;2691
353510;201412;1420;4579;1172;3933;346;1281;340;986;686;2267
353520;201412;1308;3883;1056;3423;337;1178;363;1168;700;2346
353530;201412;2902;8687;2590;8101;630;2210;1250;3753;1880;5963
353540;201412;2237;6805;1977;6343;614;2051;852;2754;1466;4805
353550;201412;7068;20333;6214;18954;1126;4028;3580;10276;4706;14304
353560;201412;2147;7104;1777;6415;449;1807;652;2299;1101;4106
353570;201412;564;1770;455;1539;100;383;242;739;342;1122
353580;201412;2592;8401;2417;8091;667;2500;1377;4482;2044;6982
353590;201412;855;2439;695;2151;251;838;181;567;432;1405
353600;201412;2011;5731;1823;5394;407;1326;938;2754;1345;4080
353610;201412;677;2331;542;2037;146;631;152;534;298;1165
353620;201412;2272;7583;1966;6965;594;2255;647;2166;1241;4421
353625;201412;405;1106;280;888;106;369;80;237;186;606
353630;201412;1731;5931;1312;4846;302;1210;217;690;519;1900
353640;201412;1732;4969;1487;4455;355;1091;691;2098;1046;3189
353650;201412;7000;21427;5076;17126;1176;4282;1784;5701;2960;9983
353657;201412;360;1142;322;1059;62;240;132;407;194;647
353660;201412;1468;3746;1051;3085;443;1426;195;435;638;1861
353670;201412;5068;16710;4399;15196;1482;5625;1378;4427;2860;10052
353680;201412;724;2528;671;2430;311;1195;223;787;534;1982
353690;201412;584;1553;377;1201;92;348;145;414;237;762
353700;201412;2530;7998;2199;7292;517;1893;822;2561;1339;4454
353710;201412;3539;9555;1836;6554;564;2184;522;1835;1086;4019
353715;201412;505;1489;416;1321;87;303;172;529;259;832
353720;201412;2217;6845;1891;6349;363;1353;1095;3648;1458;5001
353730;201412;4730;14610;3723;12300;932;3339;1084;3281;2016;6620
353740;201412;2339;7132;1873;6124;645;2190;537;1688;1182;3878
353750;201412;856;2956;667;2488;181;747;193;710;374;1457
353760;201412;8435;24737;6814;22004;1568;5542;3536;11318;5104;16860
353770;201412;853;2622;528;1810;120;444;53;113;173;557
353780;201412;6169;21839;5554;20566;2475;9390;1529;5877;4004;15267
353790;201412;1843;6501;1510;5752;462;1980;353;1308;815;3288
353800;201412;15565;49569;12282;43178;3472;13447;4761;16158;8233;29605
353810;201412;1234;4075;1063;3681;323;1212;392;1313;715;2525
353820;201412;1355;4733;1250;4470;369;1496;562;1865;931;3361
353830;201412;829;2254;647;1924;131;424;279;811;410;1235
353850;201412;1950;6355;1806;6098;432;1598;877;2822;1309;4420
353860;201412;2472;8356;2020;7245;580;2231;564;1962;1144;4193
353870;201412;24430;75444;17994;61797;4303;16476;5943;18357;10246;34833
353880;201412;2432;7700;2018;6970;304;1268;1196;4050;1500;5318
353890;201412;2734;6925;1917;5573;444;1428;931;2576;1375;4004
353900;201412;1187;3722;883;3026;223;856;214;646;437;1502
353910;201412;2196;7755;2088;7466;669;2565;953;3400;1622;5965
353920;201412;2390;7119;1724;5664;421;1480;303;875;724;2355
353930;201412;4308;15091;3561;13382;1273;5070;844;3141;2117;8211
353940;201412;1562;5031;1323;4499;348;1338;513;1616;861;2954
353950;201412;3759;12140;3438;11562;559;2180;2208;7211;2767;9391
353960;201412;631;2008;489;1685;119;441;137;400;256;841
353970;201412;557;1653;482;1545;47;183;358;1129;405;1312
353980;201412;15247;45314;12697;40871;3100;10684;6484;20547;9584;31231
353990;201412;521;1634;477;1528;139;498;195;562;334;1060
354000;201412;2070;6092;1402;4743;349;1297;148;442;497;1739
354010;201412;418;1278;367;1190;134;441;146;484;280;925
354020;201412;4596;14021;4045;12773;1127;3913;1728;5045;2855;8958
354025;201412;1147;3241;899;2808;254;842;230;720;484;1562
354030;201412;667;1778;465;1460;124;434;172;495;296;929
354040;201412;827;2261;640;1901;92;317;354;971;446;1288
354050;201412;1087;3546;955;3268;341;1285;293;964;634;2249
354060;201412;5380;16899;3806;13380;1030;3927;1393;4685;2423;8612
354070;201412;3620;12002;3096;10798;1123;4189;599;2016;1722;6205
354075;201412;2301;8601;2193;8401;709;2962;977;3709;1686;6671
354080;201412;1960;6047;1465;4837;441;1513;370;1075;811;2588
354085;201412;329;886;288;808;33;120;209;548;242;668
354090;201412;1318;3964;1244;3842;149;518;939;2880;1088;3398
354100;201412;17532;60138;14963;55048;4059;15835;6841;25011;10900;40846
354105;201412;969;3045;827;2774;203;803;382;1163;585;1966
354110;201412;850;2444;693;2209;209;756;217;628;426;1384
354120;201412;1922;5331;1489;4499;317;1090;623;1715;940;2805
354130;201412;5957;17716;4830;15424;1960;6659;1075;3088;3035;9747
354140;201412;24865;63473;15142;45117;3166;10370;5681;15657;8847;26027
354150;201412;4696;13043;3669;11186;998;3375;1660;4822;2658;8197
354160;201412;4113;13622;3557;12363;1064;3975;1437;4843;2501;8818
354165;201412;423;1550;379;1441;140;576;103;392;243;968
354170;201412;1680;5401;1358;4622;307;1177;478;1427;785;2604
354180;201412;534;1622;508;1574;82;296;310;895;392;1191
354190;201412;1709;5698;1477;5174;504;1902;497;1658;1001;3560
354200;201412;1217;3532;986;3086;203;724;407;1143;610;1867
354210;201412;888;3030;784;2819;179;756;337;1120;516;1876
354220;201412;3375;10461;2978;9675;947;3370;1255;3898;2202;7268
354230;201412;820;2708;771;2621;203;734;384;1286;587;2020
354240;201412;1462;4950;1160;4236;347;1369;276;944;623;2313
354250;201412;689;2059;490;1699;209;814;134;431;343;1245
354260;201412;7785;23885;6921;22402;2082;7363;2707;8595;4789;15958
354270;201412;1229;4314;1102;4034;331;1348;428;1555;759;2903
354280;201412;858;2564;791;2447;157;570;475;1427;632;1997
354290;201412;1367;4806;1265;4582;383;1479;427;1528;810;3007
354300;201412;3480;11735;3353;11488;897;3281;1746;5859;2643;9140
354310;201412;819;2712;650;2312;185;731;209;735;394;1466
354320;201412;883;2653;755;2394;225;802;242;689;467;1491
354323;201412;413;1178;314;988;80;279;94;259;174;538
354325;201412;1219;4114;1061;3740;236;965;431;1390;667;2355
354330;201412;8463;26384;7360;24135;1962;6895;3663;11603;5625;18498
354340;201412;32162;103969;26947;94146;9880;37019;9666;32866;19546;69885
354350;201412;1145;3426;1063;3273;287;970;563;1660;850;2630
354360;201412;480;1577;374;1349;102;391;38;133;140;524
354370;201412;1192;4032;1036;3705;150;657;661;2285;811;2942
354380;201412;1372;4126;1135;3693;435;1554;208;585;643;2139
354390;201412;12334;39019;8899;31374;2273;8727;2280;7680;4553;16407
354400;201412;2236;7942;1910;7139;533;2116;589;2097;1122;4213
354410;201412;6697;20354;5548;18419;1309;4663;2827;9358;4136;14021
354420;201412;1732;5133;1422;4459;454;1505;497;1479;951;2984
354425;201412;3571;10225;3077;9306;1084;3465;968;2953;2052;6418
354430;201412;1404;4606;1293;4419;350;1344;605;1979;955;3323
354440;201412;590;1733;459;1465;93;326;205;625;298;951
354450;201412;525;1527;324;1079;51;215;76;215;127;430
354460;201412;939;2698;764;2385;276;910;326;994;602;1904
354470;201412;542;1551;421;1300;72;285;190;507;262;792
354480;201412;822;2430;718;2257;157;576;372;1083;529;1659
354490;201412;808;2734;637;2316;164;648;208;676;372;1324
354500;201412;2648;8967;2401;8497;970;3848;527;1759;1497;5607
354510;201412;792;2507;701;2336;166;605;386;1252;552;1857
354515;201412;363;1262;292;1091;71;302;93;319;164;621
354520;201412;7399;25367;4989;18441;1502;6217;1853;6505;3355;12722
354530;201412;3001;10787;2795;10368;801;3241;1421;5212;2222;8453
354540;201412;1354;4150;1128;3713;439;1588;249;757;688;2345
354550;201412;601;1926;532;1770;105;361;230;735;335;1096
354560;201412;1500;4458;1085;3513;254;835;399;1249;653;2084
354570;201412;774;2369;597;1955;182;621;117;353;299;974
354580;201412;9719;28318;7639;24317;1618;5775;3478;10462;5096;16237
354600;201412;1808;6202;1601;5773;468;1945;707;2388;1175;4333
354610;201412;496;1379;309;968;57;179;82;221;139;400
354620;201412;438;1491;364;1352;112;476;139;486;251;962
354625;201412;291;969;244;870;67;259;67;231;134;490
354630;201412;1947;6609;1744;6138;794;2847;496;1680;1290;4527
354640;201412;4356;14431;3616;12782;1073;4270;801;2568;1874;6838
354650;201412;1055;3245;951;3026;191;683;549;1703;740;2386
354660;201412;2262;6690;1766;5798;380;1390;915;2976;1295;4366
354670;201412;1689;5514;1358;4658;394;1483;357;1066;751;2549
354680;201412;5523;18556;5036;17464;1461;5395;2014;6820;3475;12215
354690;201412;884;2971;630;2335;131;508;184;631;315;1139
354700;201412;1193;3384;795;2526;143;558;343;918;486;1476
354710;201412;652;1914;553;1713;136;477;215;617;351;1094
354720;201412;216;614;167;515;61;186;41;123;102;309
354730;201412;7512;25056;5847;21355;1523;6098;2461;8656;3984;14754
354740;201412;280;858;201;708;52;186;51;184;103;370
354750;201412;2600;8180;2114;7364;710;2716;768;2608;1478;5324
354760;201412;2308;7645;1909;6731;633;2400;401;1315;1034;3715
354765;201412;314;831;201;627;47;172;28;79;75;251
354770;201412;2903;8498;2319;7528;1066;3679;456;1413;1522;5092
354780;201412;37497;114119;33331;104699;7235;25395;16888;50262;24123;75657
354790;201412;921;3006;803;2793;215;840;357;1136;572;1976
354800;201412;1827;5366;1616;5072;343;1210;1028;3217;1371;4427
354805;201412;1002;3082;734;2468;115;426;142;433;257;859
354810;201412;674;2220;460;1684;134;553;88;272;222;825
354820;201412;1130;3964;992;3669;271;1148;293;981;564;2129
354830;201412;494;1476;409;1317;132;470;162;480;294;950
354840;201412;833;2449;738;2281;224;749;305;931;529;1680
354850;201412;15713;50034;11687;41476;3013;11848;4335;14286;7348;26134
354860;201412;1355;4412;1219;4175;298;1190;569;1837;867;3027
354870;201412;48655;154881;44700;146338;12970;45316;20680;66558;33650;111874
354880;201412;4543;13846;3138;10681;828;3143;813;2335;1641;5478
354890;201412;16564;50420;13900;45108;4018;14027;4757;14840;8775;28867
354900;201412;632;1797;502;1598;177;594;178;567;355;1161
354910;201412;6891;21056;3929;14212;885;3560;410;1370;1295;4930
354920;201412;522;1552;402;1335;115;427;110;344;225;771
354925;201412;381;1097;224;764;44;171;36;99;80;270
354930;201412;319;910;255;789;86;283;87;271;173;554
354940;201412;2270;8111;1743;6630;658;2655;246;848;904;3503
354950;201412;1591;5243;1417;4995;263;1066;858;2995;1121;4061
354960;201412;797;2533;694;2363;201;759;277;908;478;1667
354970;201412;4385;14573;3826;13380;770;3128;2040;6777;2810;9905
354980;201412;33826;84965;19510;59987;4421;15308;6736;19042;11157;34350
354990;201412;47054;148724;39655;133150;8735;32393;20460;66560;29195;98953
354995;201412;2045;6426;1917;6246;493;1715;1007;3288;1500;5003
355000;201412;1752;5880;1529;5442;562;2170;330;1089;892;3259
355010;201412;3955;12503;3222;10823;903;3293;1264;4174;2167;7467
355020;201412;2849;9761;2291;8616;1018;4130;557;2047;1575;6177
355030;201412;897512;2602428;789568;2382996;197019;648482;354012;1031267;551031;1679749
355040;201412;3152;10305;2834;9720;876;3319;1422;4687;2298;8006
355050;201412;1330;4169;1086;3664;378;1345;259;872;637;2217
355060;201412;5294;18112;4212;15644;1121;4648;1064;3622;2185;8270
355070;201412;6796;21345;6054;20068;1380;5343;3255;10083;4635;15426
355080;201412;1409;5005;1083;4170;326;1384;164;541;490;1925
355090;201412;1167;4153;985;3717;233;957;406;1482;639;2439
355100;201412;25346;80236;21705;73862;7033;25642;8255;27961;15288;53603
355110;201412;1366;4764;1238;4472;428;1672;417;1463;845;3135
355120;201412;682;2177;583;1984;169;633;252;829;421;1462
355130;201412;634;1708;375;1137;90;322;133;331;223;653
355140;201412;1165;4104;1117;4002;302;1188;549;1963;851;3151
355150;201412;3949;12835;3461;11925;1018;3717;1479;4902;2497;8619
355160;201412;1773;5972;1532;5555;636;2573;429;1396;1065;3969
355170;201412;10443;29934;7486;24563;2578;9114;1958;6324;4536;15438
355180;201412;2928;9063;2434;8116;661;2562;912;2782;1573;5344
355190;201412;1439;4955;1250;4542;525;1969;368;1295;893;3264
355200;201412;961;3524;902;3404;408;1628;224;814;632;2442
355210;201412;3063;10488;2783;9871;784;3147;1241;4092;2025;7239
355220;201412;34313;113954;30300;105758;12382;44773;8935;31653;21317;76426
355230;201412;1397;3986;777;2547;146;516;192;554;338;1070
355240;201412;26056;76792;18380;60470;4266;15453;6981;21539;11247;36992
355250;201412;26824;89666;23874;83646;7364;27311;10059;34869;17423;62180
355255;201412;956;2651;674;2064;146;489;180;494;326;983
355260;201412;1678;4901;1503;4587;425;1479;595;1653;1020;3132
355270;201412;1783;5476;1697;5340;237;890;1225;3734;1462;4624
355280;201412;25670;77188;21703;69427;5233;18805;9590;29125;14823;47930
355290;201412;918;2962;828;2796;190;682;371;1214;561;1896
355300;201412;978;3193;785;2766;194;742;261;871;455;1613
355310;201412;1143;3457;971;3148;229;766;468;1560;697;2326
355320;201412;774;2475;676;2246;199;756;234;660;433;1416
355330;201412;2044;6794;1500;5659;510;2147;450;1614;960;3761
355340;201412;3249;8771;3007;8354;670;2091;1762;4678;2432;6769
355350;201412;1494;5167;1309;4771;437;1720;394;1380;831;3100
355360;201412;1303;4498;1201;4288;262;1012;798;2869;1060;3881
355365;201412;323;1025;273;925;78;299;73;237;151;536
355370;201412;7713;20051;5658;17500;1841;6214;2345;7311;4186;13525
355380;201412;3752;11434;2909;9437;838;3024;611;1646;1449;4670
355385;201412;1040;3354;973;3235;426;1538;282;864;708;2402
355390;201412;1457;4083;1236;3646;350;1132;462;1298;812;2430
355395;201412;1907;5797;1428;4683;279;1023;593;1765;872;2788
355400;201412;9976;33938;8834;31541;3102;12017;3155;10829;6257;22846
355410;201412;15624;55105;13516;50414;5022;20081;3587;13493;8609;33574
355420;201412;849;3068;794;2930;297;1173;266;988;563;2161
355430;201412;4006;11678;3400;10599;774;2688;1735;5223;2509;7911
355440;201412;1000;3313;796;2770;211;780;232;709;443;1489
355450;201412;2801;9337;2278;8133;667;2609;750;2515;1417;5124
355460;201412;613;1697;452;1401;105;393;163;426;268;819
355465;201412;459;1415;392;1287;118;413;101;326;219;739
355470;201412;1008;3093;805;2729;246;929;306;977;552;1906
355475;201412;136;521;120;472;36;142;44;183;80;325
355480;201412;3387;12383;3183;11933;994;3942;1434;5288;2428;9230
355490;201412;936;2721;688;2220;168;562;142;451;310;1013
355495;201412;784;2613;718;2482;191;741;282;954;473;1695
355500;201412;9135;27097;6045;20157;1444;5331;1361;4148;2805;9479
355510;201412;2308;6341;1478;4666;347;1246;434;1252;781;2498
355520;201412;480;1209;287;822;62;199;97;245;159;444
355530;201412;311;730;128;392;14;45;39;124;53;169
355535;201412;702;2159;553;1869;163;629;148;417;311;1046
355540;201412;10628;34437;10052;33430;2976;10621;4924;15969;7900;26590
355550;201412;844;2517;733;2344;187;659;359;1113;546;1772
355560;201412;1463;4387;1068;3529;277;1036;217;565;494;1601
355570;201412;217;703;169;587;34;119;32;88;66;207
355580;201412;1359;4047;1116;3569;384;1347;422;1307;806;2654
355590;201412;268;754;237;689;53;179;119;340;172;519
355600;201412;1151;3689;965;3260;399;1465;237;762;636;2227
355610;201412;1581;4623;1334;4221;355;1253;599;1825;954;3078
355620;201412;4150;13284;3294;11270;720;2814;1402;4387;2122;7201
355630;201412;3510;10195;2177;7344;483;1829;669;2043;1152;3872
355635;201412;1041;3451;906;3214;141;563;604;2140;745;2703
355640;201412;4039;13287;3254;11495;1119;4110;623;2136;1742;6246
355645;201412;3539;12588;3287;12121;644;2608;1995;7345;2639;9953
355650;201412;6923;21705;6000;19858;1086;4309;3627;11229;4713;15538
355660;201412;1434;4639;1192;4144;363;1444;482;1555;845;2999
355670;201412;2553;8171;1784;6318;464;1906;657;2032;1121;3938
355680;201412;1847;6322;1481;5434;542;2090;334;1162;876;3252
355690;201412;443;1408;333;1213;200;781;30;83;230;864
355695;201412;380;1137;244;798;31;105;23;50;54;155
355700;201412;6971;24510;6125;22468;1832;7266;2508;8874;4340;16140
355710;201412;13234;33924;8259;24802;2694;8586;2185;6256;4879;14842
355715;201412;277;854;180;636;43;168;35;105;78;273
355720;201412;1577;5186;1280;4508;395;1529;384;1201;779;2730
355730;201412;820;2898;728;2680;276;1053;172;635;448;1688
410010;201412;1687;5403;1506;5023;425;1535;469;1542;894;3077
410020;201412;1313;4431;1194;4177;363;1337;444;1522;807;2859
410030;201412;1092;3759;898;3267;269;1034;164;588;433;1622
410040;201412;13722;45836;12446;43193;4405;16269;3800;13090;8205;29359
410045;201412;995;2837;693;2225;185;656;217;634;402;1290
410050;201412;2182;6223;1374;4537;385;1338;286;896;671;2234
410060;201412;2173;6868;1930;6387;552;2003;782;2570;1334;4573
410070;201412;2269;6482;1847;5625;693;2271;415;1135;1108;3406
410080;201412;1557;4655;1286;4150;325;1122;603;1866;928;2988
410090;201412;1183;3737;1075;3517;338;1236;386;1201;724;2437
410100;201412;2430;7444;1721;5759;513;1940;245;760;758;2700
410105;201412;485;1547;355;1230;76;300;46;116;122;416
410110;201412;2485;7476;2033;6573;423;1595;745;2280;1168;3875
410115;201412;643;1777;508;1506;117;386;175;478;292;864
410120;201412;3027;10410;2859;10147;1036;3840;1224;4471;2260;8311
410130;201412;1477;4897;1335;4562;436;1491;563;1938;999;3429
410140;201412;17007;46667;11824;36988;3238;11190;4017;12383;7255;23573
410150;201412;16829;41706;7890;23606;1746;5769;1627;4318;3373;10087
410160;201412;3504;11097;3178;10539;1045;3814;1141;3795;2186;7609
410165;201412;730;2154;580;1822;144;485;254;759;398;1244
410170;201412;2056;6201;1693;5442;606;2134;495;1540;1101;3674
410180;201412;9658;31066;8311;28050;2105;8039;3539;11068;5644;19107
410185;201412;684;1877;591;1702;135;412;290;826;425;1238
410190;201412;2406;7169;2037;6314;651;2165;515;1494;1166;3659
410200;201412;3742;10606;2623;8242;648;2276;364;1039;1012;3315
410210;201412;2880;8803;2237;7369;534;1971;499;1387;1033;3358
410220;201412;629;1819;445;1430;92;333;136;409;228;742
410230;201412;1703;5530;1511;5178;546;2062;568;1865;1114;3927
410240;201412;5481;16991;4979;15912;1721;5951;1593;4896;3314;10847
410250;201412;2492;7008;1684;5297;493;1722;335;947;828;2669
410260;201412;1724;5332;1469;4847;438;1550;536;1732;974;3282
410270;201412;600;1736;478;1495;120;418;189;573;309;991
410275;201412;887;2698;618;2083;105;383;307;1035;412;1418
410280;201412;3016;8982;2141;7074;498;1881;442;1336;940;3217
410290;201412;3300;10004;2793;9019;694;2436;1228;3957;1922;6393
410300;201412;689;1952;598;1751;91;317;301;784;392;1101
410302;201412;356;962;243;772;29;104;141;447;170;551
410304;201412;1511;4867;1371;4573;420;1444;554;1921;974;3365
410305;201412;2304;6126;1941;5559;562;1729;1063;3052;1625;4781
410310;201412;2557;8405;2315;7934;658;2447;895;3077;1553;5524
410315;201412;698;2065;467;1600;110;389;148;478;258;867
410320;201412;1295;3811;794;2666;145;546;68;191;213;737
410322;201412;625;1853;445;1450;128;422;120;374;248;796
410330;201412;1590;4453;1357;4014;391;1248;468;1362;859;2610
410335;201412;1022;3028;870;2751;203;726;342;1016;545;1742
410337;201412;877;2327;678;1941;135;455;267;678;402;1133
410340;201412;620;1854;472;1465;91;329;152;398;243;727
410345;201412;1833;5365;1378;4391;385;1336;391;1157;776;2493
410347;201412;667;1827;416;1343;70;271;155;485;225;756
410350;201412;893;2714;590;2062;138;554;100;307;238;861
410360;201412;3918;11691;3383;10716;1003;3434;1265;3937;2268;7371
410370;201412;13996;41296;10433;33249;2733;9836;3089;8950;5822;18786
410380;201412;1490;4729;1359;4440;344;1223;618;1923;962;3146
410390;201412;2742;7964;2164;6860;779;2679;582;1644;1361;4323
410395;201412;916;3066;813;2837;202;809;385;1330;587;2139
410400;201412;5617;18098;4924;16706;1467;5613;1663;5415;3130;11028
410405;201412;1026;2999;817;2578;205;760;328;982;533;1742
410410;201412;1392;4671;1321;4557;487;1883;412;1328;899;3211
410420;201412;9688;31718;8336;28546;2838;10483;1984;6269;4822;16752
410425;201412;3390;10874;2382;8496;534;2092;319;1073;853;3165
410430;201412;16886;46145;12399;37634;3316;10981;3918;11783;7234;22764
410440;201412;3716;11712;3332;10962;873;3121;1547;5059;2420;8180
410442;201412;3107;10680;2791;9937;938;3527;878;3102;1816;6629
410445;201412;2262;7584;1943;6990;560;2220;715;2656;1275;4876
410450;201412;2256;6448;1757;5468;610;1997;328;907;938;2904
410460;201412;2443;7350;2021;6494;564;1928;734;2234;1298;4162
410465;201412;2151;7563;1826;6791;572;2306;672;2305;1244;4611
410470;201412;1499;4864;1212;4173;317;1240;341;1137;658;2377
410480;201412;32688;95593;24758;78940;8412;29109;5664;17081;14076;46190
410490;201412;12047;38835;9663;33509;2912;11087;2881;9615;5793;20702
410500;201412;1640;5168;1333;4484;488;1806;394;1292;882;3098
410510;201412;2564;6820;1823;5307;414;1279;729;1941;1143;3220
410520;201412;3351;11689;3166;11285;1155;4346;1176;4174;2331;8520
410530;201412;1806;5175;1476;4509;361;1253;599;1717;960;2970
410540;201412;3774;10971;2536;8456;668;2383;804;2644;1472;5027
410550;201412;7454;22540;5360;17825;1635;5995;886;2698;2521;8693
410560;201412;1454;4530;1109;3727;314;1175;288;762;602;1937
410570;201412;3013;9815;2732;9302;865;3054;1015;3723;1880;6777
410580;201412;27639;86802;23694;78450;8036;29050;6916;21527;14952;50577
410590;201412;1289;4070;775;2600;136;482;182;539;318;1021
410600;201412;2128;6255;1760;5515;459;1493;757;2391;1216;3884
410610;201412;855;2593;716;2327;153;562;317;988;470;1550
410620;201412;1398;5042;1137;4308;364;1464;191;687;555;2151
410630;201412;2623;7852;1977;6386;542;1931;498;1450;1040;3381
410640;201412;5389;15684;4216;13407;1443;5213;950;2809;2393;8022
410645;201412;1337;4710;1275;4592;567;2206;382;1359;949;3565
410650;201412;2575;7881;2065;6793;741;2567;473;1477;1214;4044
410655;201412;976;2942;794;2577;218;782;265;831;483;1613
410657;201412;727;2133;539;1743;148;526;201;588;349;1114
410660;201412;3358;9704;2403;7529;754;2500;529;1491;1283;3991
410670;201412;1035;2938;773;2409;225;756;196;554;421;1310
410680;201412;2653;9124;2185;7911;660;2397;714;2719;1374;5116
410685;201412;738;2163;651;2011;98;304;461;1441;559;1745
410690;201412;106919;311614;72237;237077;17547;63597;17440;51432;34987;115029
410700;201412;2467;7783;2288;7421;717;2540;945;2947;1662;5487
410710;201412;1153;3581;889;2945;273;979;230;678;503;1657
410712;201412;843;2591;725;2362;297;1059;224;749;521;1808
410715;201412;1135;3552;934;3101;245;876;360;1155;605;2031
410720;201412;3471;10338;2511;8268;659;2426;707;2136;1366;4562
410725;201412;1097;3148;775;2487;161;549;156;436;317;985
410730;201412;757;2292;685;2132;287;961;191;571;478;1532
410740;201412;862;2555;593;1993;112;442;282;935;394;1377
410750;201412;2034;6036;1709;5339;512;1745;515;1499;1027;3244
410752;201412;314;902;215;686;50;191;86;247;136;438
410753;201412;495;1488;336;1104;78;300;110;328;188;628
410754;201412;997;3083;864;2860;95;350;582;1983;677;2333
410755;201412;871;2246;679;1939;97;331;408;1117;505;1448
410760;201412;2779;8853;2563;8431;896;3100;1005;3215;1901;6315
410765;201412;16366;49027;11826;39519;2825;10576;1671;5154;4496;15730
410770;201412;965;2728;745;2284;238;795;220;643;458;1438
410773;201412;1410;4130;1190;3764;281;1027;628;1888;909;2915
410775;201412;1897;5534;1786;5359;516;1560;951;2905;1467;4465
410780;201412;517;1465;392;1249;116;374;161;569;277;943
410785;201412;693;2244;559;1897;234;841;132;449;366;1290
410790;201412;608;1910;507;1666;140;510;107;280;247;790
410800;201412;3009;7902;2366;6822;795;2571;856;2293;1651;4864
410810;201412;311;966;248;821;37;139;115;382;152;521
410820;201412;1118;3387;894;2838;278;941;203;615;481;1556
410830;201412;33739;99831;27473;88436;8634;30483;9420;29592;18054;60075
410832;201412;1228;3693;1096;3448;240;880;549;1620;789;2500
410840;201412;6671;19830;4388;14754;1307;4784;604;1795;1911;6579
410845;201412;1602;4728;1343;4171;288;974;614;1850;902;2824
410850;201412;2899;8586;2578;8088;600;2171;1373;4287;1973;6458
410855;201412;786;2198;617;1830;185;594;213;595;398;1189
410860;201412;4224;12030;3501;10639;802;2607;1615;4920;2417;7527
410865;201412;1769;6024;1603;5705;400;1521;868;3157;1268;4678
410870;201412;1461;4438;1362;4270;642;2157;453;1383;1095;3540
410880;201412;4687;14145;3760;12326;941;3485;889;2605;1830;6090
410890;201412;1133;3541;834;2939;222;850;79;236;301;1086
410895;201412;1074;3759;958;3497;362;1425;291;1006;653;2431
410900;201412;972;2743;727;2323;160;594;228;678;388;1272
410910;201412;437;1185;361;1052;68;236;195;532;263;768
410920;201412;914;2803;750;2498;214;790;246;764;460;1554
410930;201412;1831;5463;1531;4903;391;1496;639;1980;1030;3476
410940;201412;22232;74343;19622;69325;6407;24601;7449;26504;13856;51105
410950;201412;1934;6413;1763;6097;366;1322;1081;3782;1447;5104
410960;201412;7343;20484;4807;15663;1540;5471;1310;4166;2850;9637
410965;201412;1153;3605;1016;3318;350;1195;397;1286;747;2481
410970;201412;5320;16152;4337;14151;1535;5620;885;2840;2420;8460
410975;201412;1606;4676;1311;4145;243;890;605;1902;848;2792
410980;201412;5707;16269;3395;11409;788;2920;623;1971;1411;4891
410990;201412;843;2467;504;1684;168;619;91;238;259;857
411000;201412;454;1375;306;1025;70;269;50;134;120;403
411005;201412;546;1603;366;1162;102;329;61;168;163;497
411007;201412;2176;6982;1909;6363;553;1943;724;2419;1277;4362
411010;201412;4267;14643;3859;13715;1395;5459;977;3238;2372;8697
411020;201412;2613;8274;2340;7796;794;2975;790;2598;1584;5573
411030;201412;907;2466;753;2180;243;772;218;586;461;1358
411040;201412;607;1813;342;1132;99;352;75;235;174;587
411050;201412;2204;7810;1943;7198;639;2556;330;1129;969;3685
411060;201412;2203;6945;1889;6254;583;2079;320;966;903;3045
411065;201412;403;1238;324;1079;67;232;120;383;187;615
411070;201412;5269;16434;3838;13269;1127;4305;608;1856;1735;6161
411080;201412;2170;6661;1923;6162;556;1981;613;1872;1169;3853
411090;201412;758;1862;554;1549;118;406;143;352;261;758
411095;201412;1699;4886;1273;4018;292;1043;334;955;626;1998
411100;201412;1557;4471;1138;3651;264;950;239;680;503;1630
411110;201412;976;2950;718;2359;217;761;122;342;339;1103
411120;201412;1983;6063;1574;5171;463;1635;481;1511;944;3146
411125;201412;4917;16137;4750;15783;1608;5662;2084;6801;3692;12463
411130;201412;826;2474;670;2139;195;641;213;696;408;1337
411140;201412;2065;7383;1767;6646;626;2456;501;1956;1127;4412
411150;201412;6130;17330;4929;14890;1434;4674;1252;3455;2686;8129
411155;201412;1297;3761;1092;3351;345;1161;430;1235;775;2396
411160;201412;348;1034;307;947;105;336;104;314;209;650
411170;201412;869;2905;751;2620;224;825;247;849;471;1674
411180;201412;6673;20183;5704;18360;1704;6037;1846;5864;3550;11901
411190;201412;1914;5608;1628;5065;499;1742;479;1391;978;3133
411200;201412;4664;14131;3827;12686;1170;4310;1475;4715;2645;9025
411210;201412;2434;7037;1921;6061;756;2538;322;975;1078;3513
411220;201412;1236;3586;1007;3146;260;943;432;1218;692;2161
411230;201412;1312;3738;850;2758;260;935;200;574;460;1509
411240;201412;1290;3077;690;2085;163;525;228;639;391;1164
411250;201412;2628;7753;2181;6871;619;2100;672;2083;1291;4183
411260;201412;314;873;203;666;38;139;91;286;129;425
411270;201412;2163;6890;1966;6505;587;2132;863;2784;1450;4916
411275;201412;1631;4955;1392;4393;420;1386;398;1214;818;2600
411280;201412;1860;5707;1425;4771;423;1572;259;778;682;2350
411290;201412;1050;2923;866;2553;246;760;298;892;544;1652
411295;201412;1139;3364;1036;3175;244;813;424;1280;668;2093
411300;201412;1170;3024;834;2355;83;268;385;1007;468;1275
411310;201412;894;2548;678;2160;122;443;272;853;394;1296
411320;201412;5876;17424;4344;14312;1252;4355;997;3101;2249;7456
411325;201412;1612;5094;1425;4728;269;1003;834;2748;1103;3751
411330;201412;3855;12378;3359;11402;1275;4730;983;3215;2258;7945
411340;201412;1019;2983;669;2163;151;551;261;816;412;1367
411342;201412;904;2596;740;2238;212;700;218;593;430;1293
411345;201412;1125;3575;1028;3384;319;1143;474;1557;793;2700
411350;201412;3086;9358;2148;7351;639;2390;252;792;891;3182
411360;201412;595;1510;375;1087;49;188;167;401;216;589
411370;201412;47242;136491;35794;114219;7509;27977;13428;39181;20937;67158
411373;201412;1506;4767;1252;4250;350;1329;348;1142;698;2471
411375;201412;1210;3386;938;2841;243;775;334;957;577;1732
411380;201412;1335;3577;823;2477;149;495;255;717;404;1212
411390;201412;1920;5881;1673;5435;452;1627;704;2162;1156;3789
411400;201412;1951;5748;1464;4622;324;1153;421;1212;745;2365
411410;201412;2718;8400;2198;7161;689;2531;570;1605;1259;4136
411420;201412;4784;13941;3542;11091;893;3108;697;1788;1590;4896
411430;201412;3117;9988;2639;9106;802;3014;1141;3853;1943;6867
411435;201412;399;1302;321;1093;87;323;131;418;218;741
411440;201412;2710;8814;2439;8271;889;3190;728;2572;1617;5762
411450;201412;2264;6917;2050;6524;462;1517;1192;3844;1654;5361
411460;201412;4651;14414;3131;10702;1093;3992;568;1815;1661;5807
411470;201412;875;2640;580;1908;117;424;112;311;229;735
411480;201412;5260;16051;4117;13744;1570;5709;916;2931;2486;8640
411490;201412;1587;4898;1369;4482;462;1703;384;1108;846;2811
411500;201412;1824;5072;1276;4037;346;1205;333;1018;679;2223
411510;201412;2542;7441;2000;6370;669;2343;453;1273;1122;3616
411520;201412;26051;71414;15382;48372;3564;12321;3560;10385;7124;22706
411530;201412;957;2758;648;2173;231;870;107;289;338;1159
411535;201412;501;1500;225;805;39;163;27;71;66;234
411540;201412;2821;7604;2098;6245;320;1047;1083;3183;1403;4230
411545;201412;1066;3668;981;3500;198;759;639;2303;837;3062
411550;201412;805;2205;637;1931;254;842;153;448;407;1290
411560;201412;2755;8326;2163;6894;601;2080;457;1326;1058;3406
411570;201412;6648;18346;4885;15319;1407;4888;1171;3758;2578;8646
411573;201412;1032;3102;973;2999;209;682;564;1765;773;2447
411575;201412;1594;5150;1352;4603;346;1260;507;1717;853;2977
411580;201412;3611;10496;2496;8125;535;2070;412;1046;947;3116
411585;201412;625;2130;427;1543;120;461;74;250;194;711
411590;201412;595;1773;530;1646;140;486;187;566;327;1052
411600;201412;383;1156;308;1013;86;335;86;285;172;620
411605;201412;2413;6736;1750;5435;449;1521;677;2031;1126;3552
411610;201412;2492;7070;2219;6662;464;1501;1465;4355;1929;5856
411620;201412;3012;9734;2811;9378;857;3056;1260;4274;2117;7330
411630;201412;446;1154;256;848;49;205;55;158;104;363
411640;201412;622;1922;507;1680;151;544;188;569;339;1113
411650;201412;188;623;162;578;40;169;62;203;102;372
411660;201412;907;2558;732;2212;184;592;314;950;498;1542
411670;201412;1747;5093;1533;4650;490;1655;551;1555;1041;3210
411680;201412;1783;5449;1553;5055;376;1195;925;3166;1301;4361
411690;201412;3695;11095;3009;9750;955;3245;784;2608;1739;5853
411695;201412;737;2393;587;2062;141;540;209;742;350;1282
411700;201412;2013;5850;1422;4664;340;1236;370;1119;710;2355
411705;201412;2379;8076;2068;7452;487;1778;1135;4225;1622;6003
411710;201412;2275;6914;1841;5951;555;1919;463;1391;1018;3310
411720;201412;773;2286;574;1825;103;361;153;443;256;804
411721;201412;740;2243;621;1994;198;700;121;351;319;1051
411722;201412;753;2275;572;1859;140;523;165;466;305;989
411725;201412;1368;4420;834;3022;202;768;186;663;388;1431
411727;201412;2338;6764;1889;5810;462;1542;782;2267;1244;3809
411729;201412;533;1471;386;1205;122;425;108;294;230;719
411730;201412;5384;15713;4530;14083;2010;6435;1270;4022;3280;10457
411740;201412;628;1835;431;1373;95;336;159;477;254;813
411745;201412;975;2999;799;2612;214;731;219;693;433;1424
411750;201412;4688;14445;3547;11680;993;3649;737;2210;1730;5859
411760;201412;9161;27143;8141;25367;3057;10172;2482;7835;5539;18007
411770;201412;3789;13135;3259;11831;1229;4737;702;2555;1931;7292
411780;201412;3146;10245;3018;10095;398;1239;2261;8012;2659;9251
411790;201412;2789;8052;2045;6546;598;2226;684;2085;1282;4311
411800;201412;1492;4327;900;2948;160;603;172;455;332;1058
411810;201412;1656;5053;1420;4548;391;1429;461;1295;852;2724
411820;201412;17301;54561;14350;48879;5150;18086;4315;15245;9465;33331
411830;201412;428;1163;333;1020;153;469;34;114;187;583
411840;201412;9755;28899;7490;24385;2146;7599;1975;6170;4121;13769
411845;201412;609;1893;429;1440;97;359;109;337;206;696
411850;201412;6235;18922;5172;16714;1412;4906;1551;4963;2963;9869
411860;201412;954;3033;783;2660;222;777;227;740;449;1517
411870;201412;1080;3793;825;3090;151;603;207;746;358;1349
411880;201412;2109;6153;1701;5389;513;1870;439;1179;952;3049
411885;201412;803;2196;628;1853;136;522;244;628;380;1150
411890;201412;1410;4362;983;3325;269;973;184;553;453;1526
411900;201412;963;3098;669;2345;195;687;114;404;309;1091
411910;201412;1273;4339;1073;3870;346;1380;318;1062;664;2442
411915;201412;13359;37842;8608;27707;1953;6942;2139;6301;4092;13243
411920;201412;1106;3859;968;3513;282;1132;225;764;507;1896
411925;201412;579;1659;388;1300;110;380;113;363;223;743
411930;201412;6557;21570;5753;19905;1881;6960;2041;7087;3922;14047
411940;201412;3740;12561;3283;11564;1092;4037;840;2873;1932;6910
411950;201412;10792;34601;8960;30827;2386;8969;4094;13814;6480;22783
411960;201412;5017;15203;4576;14334;1165;4098;2097;6383;3262;10481
411965;201412;634;1858;472;1594;97;372;171;586;268;958
411970;201412;813;2293;626;1998;205;730;171;509;376;1239
411980;201412;1470;4581;1230;4046;217;763;514;1695;731;2458
411990;201412;32543;110124;27945;99960;9698;37146;8014;28620;17712;65766
411995;201412;3267;10238;2891;9454;1160;4121;762;2417;1922;6538
412000;201412;2077;5523;1667;4810;320;1088;849;2207;1169;3295
412010;201412;744;2526;612;2205;169;633;138;465;307;1098
412015;201412;682;2078;544;1771;114;396;268;868;382;1264
412020;201412;453;1329;320;1039;111;390;122;372;233;762
412030;201412;672;2115;445;1560;92;381;130;411;222;792
412033;201412;802;2450;558;1860;140;507;125;368;265;875
412035;201412;1057;2972;781;2461;200;689;318;949;518;1638
412040;201412;801;2631;707;2382;248;862;236;778;484;1640
412050;201412;1704;5095;1310;4252;335;1242;276;843;611;2085
412060;201412;7218;25216;6534;23666;2008;7758;2509;9109;4517;16867
412065;201412;1024;3127;833;2707;246;907;242;722;488;1629
412070;201412;1301;3616;1073;3159;233;726;394;1138;627;1864
412080;201412;1456;4478;845;3012;155;625;61;157;216;782
412085;201412;384;1111;176;588;45;176;48;137;93;313
412090;201412;5009;16300;4785;15882;1053;3708;2966;9974;4019;13682
412100;201412;2301;7244;2006;6705;669;2364;681;2203;1350;4567
412110;201412;1170;3361;795;2546;235;811;229;715;464;1526
412120;201412;1920;6542;1681;5975;442;1780;748;2485;1190;4265
412125;201412;1002;3123;892;2935;252;876;361;1210;613;2086
412130;201412;618;1836;462;1512;100;361;123;387;223;748
412135;201412;572;1654;409;1312;105;376;144;410;249;786
412140;201412;1467;4481;1196;3884;309;1069;364;1168;673;2237
412150;201412;3059;9024;2645;8197;405;1444;1586;4763;1991;6207
412160;201412;1005;3257;656;2346;186;776;191;645;377;1421
412170;201412;4718;15395;3927;13810;1347;5095;1425;4897;2772;9992
412175;201412;1422;4881;1259;4506;354;1385;527;1869;881;3254
412180;201412;1861;5889;1429;5062;483;1883;420;1416;903;3299
412190;201412;3322;9758;2602;8496;856;2990;691;2281;1547;5271
412200;201412;2380;7850;1672;5929;405;1573;523;1831;928;3404
412210;201412;781;2222;460;1528;114;427;73;230;187;657
412215;201412;3762;11767;3425;11155;626;2034;2202;7400;2828;9434
412217;201412;1268;3706;1177;3547;219;767;766;2184;985;2951
412220;201412;5169;17336;4942;16880;1512;5418;2708;9244;4220;14662
412230;201412;3121;10571;2699;9688;775;3103;841;2888;1616;5991
412240;201412;10116;26654;5702;17963;1297;4584;1013;2861;2310;7445
412250;201412;2248;6837;1958;6176;619;2135;519;1502;1138;3637
412260;201412;1420;4153;956;3134;205;788;303;866;508;1654
412265;201412;1267;3957;1134;3710;278;1043;552;1775;830;2818
412270;201412;887;2846;664;2326;154;611;137;446;291;1057
412280;201412;601;1904;442;1556;242;897;46;153;288;1050
412290;201412;1224;3472;969;2957;204;706;368;1028;572;1734
412300;201412;1859;5628;1539;4987;470;1697;409;1255;879;2952
412310;201412;1249;3531;1118;3354;200;518;742;2480;942;2998
412320;201412;750;2074;547;1711;135;473;186;587;321;1060
412330;201412;2012;5513;1538;4641;345;1105;743;2236;1088;3341
412340;201412;823;2585;535;1827;85;318;99;319;184;637
412350;201412;2745;8741;2240;7581;731;2630;343;1041;1074;3671
412360;201412;350;1108;269;893;49;191;84;228;133;419
412370;201412;1164;3658;915;3159;323;1196;265;890;588;2086
412380;201412;2100;6420;1800;5734;550;1843;524;1635;1074;3478
412382;201412;714;2050;487;1550;104;351;148;436;252;787
412385;201412;2542;8025;2282;7426;733;2527;750;2435;1483;4962
412390;201412;2591;7677;2349;7261;784;2602;917;2863;1701;5465
412395;201412;996;2774;790;2438;124;396;474;1467;598;1863
412400;201412;1205;3741;1054;3440;334;1126;383;1292;717;2418
412402;201412;2141;6513;1725;5613;530;1927;454;1271;984;3198
412405;201412;3759;10943;2373;7866;575;2170;318;952;893;3122
412410;201412;6610;21240;5903;19817;2455;9046;1316;4307;3771;13353
412420;201412;561;1663;441;1404;134;464;141;379;275;843
412430;201412;515;1487;419;1290;109;377;166;464;275;841
412440;201412;4148;12421;3491;11248;728;2575;1331;4432;2059;7007
412450;201412;320;1028;242;824;45;161;39;92;84;253
412460;201412;1033;2962;739;2398;186;707;171;505;357;1212
412470;201412;1894;6479;1671;5918;554;2054;575;2079;1129;4133
412480;201412;1350;3979;916;2981;218;767;144;378;362;1145
412490;201412;1317;3890;1162;3525;315;1005;348;1021;663;2026
412500;201412;2122;6293;1807;5665;500;1793;485;1331;985;3124
412510;201412;2828;9562;2474;8646;740;2770;945;3288;1685;6058
412520;201412;1908;5336;1421;4478;442;1490;447;1372;889;2862
412530;201412;834;2494;696;2182;205;646;213;667;418;1313
412535;201412;544;1648;349;1150;92;335;79;217;171;552
412540;201412;1175;3434;882;2795;154;562;319;999;473;1561
412545;201412;971;2799;780;2376;148;518;301;822;449;1340
412550;201412;25717;77904;17189;58123;4775;17435;3590;11289;8365;28724
412555;201412;356;1087;244;807;58;214;46;124;104;338
412560;201412;5121;16412;4039;14115;1054;4201;984;3167;2038;7368
412570;201412;4184;12670;2923;9730;721;2742;614;1920;1335;4662
412575;201412;887;2744;705;2304;171;637;221;663;392;1300
412580;201412;1492;4151;1082;3422;272;895;329;1002;601;1897
412590;201412;518;1569;405;1349;134;478;123;423;257;901
412600;201412;1608;5024;1358;4500;431;1579;424;1314;855;2893
412610;201412;862;2741;673;2279;226;870;188;544;414;1414
412620;201412;1328;4347;1088;3824;352;1340;234;786;586;2126
412625;201412;14590;41629;11801;36144;4224;13748;2733;8215;6957;21963
412627;201412;1071;3291;736;2534;267;993;83;265;350;1258
412630;201412;3656;11676;3137;10519;857;3034;1026;3335;1883;6369
412635;201412;565;1738;398;1345;96;351;54;170;150;521
412640;201412;886;2684;590;1969;135;480;87;248;222;728
412650;201412;2381;6870;1971;6084;534;1869;670;1832;1204;3701
412660;201412;3250;9761;2620;8407;669;2382;613;1810;1282;4192
412665;201412;748;2008;458;1471;169;594;128;382;297;976
412667;201412;1491;4473;1176;3817;308;1153;306;919;614;2072
412670;201412;704;2222;478;1663;113;443;83;225;196;668
412680;201412;1726;5448;1265;4384;336;1256;330;1027;666;2283
412690;201412;825;2601;645;2198;245;893;123;407;368;1300
412700;201412;1898;6102;1640;5661;637;2425;549;1856;1186;4281
412710;201412;9066;28508;7603;25412;2215;8103;2022;6441;4237;14544
412720;201412;1746;5543;1206;4103;292;1070;167;458;459;1528
412730;201412;2932;8866;1986;6758;635;2318;268;792;903;3110
412740;201412;2254;7404;1959;6720;787;2828;343;1211;1130;4039
412750;201412;3723;11893;3321;11215;592;2332;2163;7123;2755;9455
412760;201412;2498;8269;2378;8058;694;2648;1093;3527;1787;6175
412770;201412;13139;38195;8241;27216;1916;7045;1849;5549;3765;12594
412780;201412;1533;5017;1346;4575;404;1468;430;1389;834;2857
412785;201412;2560;7470;1855;5973;460;1625;879;2745;1339;4370
412788;201412;1468;4738;1324;4439;338;1300;490;1466;828;2766
412790;201412;1277;3932;1027;3402;268;955;281;853;549;1808
412795;201412;1092;3190;938;2906;286;921;339;1023;625;1944
412796;201412;2807;8782;2575;8311;725;2643;1050;3150;1775;5793
412800;201412;3746;11006;2904;9296;786;2793;899;2694;1685;5487
412810;201412;11196;31512;6581;21150;1624;5647;1485;4228;3109;9875
412820;201412;7062;21211;5204;17515;1474;5408;1158;3914;2632;9322
412830;201412;419;1346;351;1197;95;380;100;295;195;675
412840;201412;2261;6485;1875;5695;511;1695;476;1383;987;3078
412850;201412;2505;7602;2130;6977;413;1617;1012;3115;1425;4732
412853;201412;1556;4487;1370;4123;154;613;838;2320;992;2933
412855;201412;1734;4972;1347;4145;425;1508;363;968;788;2476
412860;201412;1365;4088;1140;3641;293;1054;477;1465;770;2519
412862;201412;882;2375;641;1899;158;513;240;663;398;1176
412863;201412;1275;4284;1222;4188;192;704;840;2864;1032;3568
412865;201412;701;2192;518;1741;115;412;202;695;317;1107
412870;201412;1054;3056;885;2770;311;1038;274;850;585;1888
412880;201412;1614;4467;1363;4046;425;1383;341;958;766;2341
420005;201412;553;1661;366;1229;82;303;132;419;214;722
420010;201412;3590;10732;2992;9765;495;1707;2019;6759;2514;8466
420020;201412;815;2671;467;1718;81;353;61;166;142;519
420030;201412;631;1807;349;1247;98;398;61;208;159;606
420040;201412;1006;3126;651;2397;194;784;127;398;321;1182
420050;201412;856;2677;680;2266;208;725;271;869;479;1594
420055;201412;322;1025;217;766;54;200;43;131;97;331
420060;201412;390;1385;291;1104;83;345;42;142;125;487
420070;201412;1438;4606;1148;3906;192;710;627;2172;819;2882
420075;201412;210;616;117;399;31;127;35;103;66;230
420080;201412;654;2129;530;1864;186;701;127;437;313;1138
420090;201412;697;2482;538;2101;163;659;96;373;259;1032
420100;201412;1566;5014;1443;4844;396;1366;821;2789;1217;4155
420110;201412;462;1587;419;1492;116;424;196;707;312;1131
420120;201412;350;1235;294;1108;111;460;64;221;175;681
420125;201412;401;1621;370;1546;154;681;113;442;267;1123
420127;201412;622;1924;281;1052;91;355;42;157;133;512
420130;201412;2598;8875;2228;8104;683;2709;769;2584;1452;5293
420140;201412;5400;15853;3725;12589;1032;3919;710;2184;1742;6103
420150;201412;884;2543;563;1870;165;607;178;534;343;1141
420160;201412;335;996;208;708;38;148;57;181;95;329
420165;201412;244;786;158;558;39;161;36;119;75;280
420170;201412;250;816;173;658;67;298;20;50;87;348
420180;201412;479;1510;285;1031;83;315;60;203;143;518
420190;201412;615;1958;367;1358;123;497;65;220;188;717
420195;201412;1480;4271;1185;3846;289;1005;575;1931;864;2936
420200;201412;3071;10023;1905;7218;601;2525;326;1105;927;3630
420205;201412;1164;3848;1035;3614;290;1083;484;1686;774;2769
420207;201412;1526;4513;1070;3537;323;1222;315;934;638;2156
420208;201412;547;1605;356;1237;131;502;105;343;236;845
420209;201412;381;1216;237;853;45;173;73;249;118;422
420210;201412;1931;6198;1312;4992;403;1788;198;650;601;2438
420213;201412;958;3460;908;3341;198;750;573;2139;771;2889
420215;201412;532;1735;384;1350;120;440;68;221;188;661
420220;201412;440;1710;412;1647;175;748;110;389;285;1137
420230;201412;4949;15188;3735;12846;950;3690;1714;5711;2664;9401
420240;201412;14736;42876;9256;32236;2107;8699;3666;11536;5773;20235
420243;201412;627;1950;500;1665;120;463;177;565;297;1028
420245;201412;1295;4036;890;3166;252;1003;197;606;449;1609
420250;201412;843;2710;781;2607;268;981;332;1116;600;2097
420253;201412;688;1813;560;1631;127;383;275;875;402;1258
420257;201412;447;1372;335;1155;91;327;156;530;247;857
420260;201412;1456;4730;1242;4342;339;1295;571;2002;910;3297
420270;201412;635;2056;260;966;49;187;35;111;84;298
420280;201412;2431;6558;1452;4739;309;1222;548;1578;857;2800
420285;201412;161;473;55;204;6;23;3;10;9;33
420287;201412;668;2052;569;1860;159;536;202;662;361;1198
420290;201412;7115;21296;4551;15265;1053;3872;1465;4569;2518;8441
420300;201412;6345;19559;4127;14668;1053;4214;852;2962;1905;7176
420310;201412;909;2760;866;2689;186;615;548;1664;734;2279
420315;201412;1004;3271;801;2849;240;942;313;1102;553;2044
420320;201412;5270;16439;4325;14719;1263;4775;1777;5865;3040;10640
420325;201412;472;1519;445;1454;132;463;159;506;291;969
420330;201412;1347;4709;1056;3888;348;1368;253;817;601;2185
420340;201412;1550;4845;1178;3950;283;1040;281;879;564;1919
420350;201412;1714;5502;1455;4960;424;1522;616;2110;1040;3632
420360;201412;3966;12646;2902;10170;1045;4029;515;1619;1560;5648
420370;201412;2138;6018;1766;5426;223;700;1394;4273;1617;4973
420380;201412;5876;19478;4692;16593;1498;5689;1255;4417;2753;10106
420390;201412;2200;6603;1336;4730;402;1525;335;1127;737;2652
420395;201412;2062;6447;1515;5175;349;1321;303;911;652;2232
420400;201412;1567;4674;1139;3813;347;1349;326;985;673;2334
420410;201412;873;2425;613;1984;160;579;313;990;473;1569
420415;201412;539;1721;413;1403;139;508;126;410;265;918
420417;201412;835;2676;707;2366;133;478;363;1204;496;1682
420419;201412;470;1497;318;1181;137;553;75;278;212;831
420420;201412;11887;35864;8957;29736;2800;10454;2766;8635;5566;19089
420425;201412;1333;3686;818;2606;95;373;360;1041;455;1414
420430;201412;4343;13682;2983;10428;885;3364;868;2972;1753;6336
420435;201412;300;953;212;739;50;208;103;339;153;547
420440;201412;1511;4427;914;3142;360;1332;171;543;531;1875
420445;201412;455;1312;354;1132;79;252;178;586;257;838
420450;201412;1338;3966;787;2773;193;766;162;479;355;1245
420455;201412;2375;7355;2108;6873;551;2050;951;3029;1502;5079
420460;201412;10575;33120;8400;28931;2438;9475;3090;10132;5528;19607
420470;201412;1310;3610;843;2705;242;875;240;717;482;1592
420475;201412;185;599;122;442;41;154;32;116;73;270
420480;201412;6238;18606;5126;16636;2044;7362;926;2944;2970;10306
420490;201412;966;2856;631;2234;203;763;154;527;357;1290
420500;201412;2179;6697;1762;5891;558;2037;815;2678;1373;4715
420510;201412;199;837;184;798;77;344;52;207;129;551
420515;201412;164;588;131;511;40;169;25;99;65;268
420517;201412;987;3064;889;2868;177;625;517;1647;694;2272
420519;201412;478;1337;350;1081;64;208;131;397;195;605
420520;201412;840;2360;659;2103;185;657;318;976;503;1633
420530;201412;1456;5011;1152;4242;360;1451;302;977;662;2428
420535;201412;287;853;174;611;57;223;26;75;83;298
420540;201412;24596;71711;16855;54724;5096;18012;4863;14624;9959;32636
420543;201412;507;1354;358;1109;47;176;212;685;259;861
420545;201412;1785;5724;1457;4994;401;1545;490;1569;891;3114
420550;201412;5155;16613;4037;14034;1128;4470;1037;3385;2165;7855
420555;201412;487;1536;401;1353;129;481;134;427;263;908
420560;201412;607;1793;507;1579;91;309;261;811;352;1120
420570;201412;2191;7195;1750;6109;520;2043;573;1880;1093;3923
420580;201412;1354;4386;1099;3919;323;1279;480;1700;803;2979
420590;201412;3661;11513;2553;8899;698;2636;491;1541;1189;4177
420600;201412;1014;3510;915;3276;240;922;394;1439;634;2361
420610;201412;662;2162;450;1661;147;594;82;270;229;864
420620;201412;1234;3869;1090;3596;393;1376;296;967;689;2343
420630;201412;1263;4001;908;3137;249;923;284;877;533;1800
420640;201412;723;2255;344;1297;88;377;27;78;115;455
420650;201412;2251;6856;1297;4585;283;1134;237;714;520;1848
420660;201412;695;2063;556;1800;127;467;265;837;392;1304
420665;201412;869;2512;551;1848;118;433;173;516;291;949
420670;201412;1885;5955;1393;4841;330;1312;293;889;623;2201
420675;201412;256;805;179;621;43;166;60;196;103;362
420680;201412;528;1286;314;953;63;218;108;303;171;521
420690;201412;879;3050;621;2290;127;502;167;545;294;1047
420700;201412;3769;10906;2818;8935;673;2500;909;2706;1582;5206
420710;201412;832;2982;691;2688;266;1125;198;732;464;1857
420720;201412;2005;6185;1728;5805;470;1646;968;3268;1438;4914
420730;201412;4950;15385;4244;14045;1440;5113;1629;5281;3069;10394
420740;201412;859;2755;794;2651;202;703;496;1646;698;2349
420750;201412;2689;8792;1879;6798;446;1842;570;1792;1016;3634
420757;201412;146;429;96;355;33;137;28;94;61;231
420760;201412;477;1540;349;1194;85;321;89;283;174;604
420765;201412;717;2363;410;1556;111;453;83;294;194;747
420768;201412;1329;4611;1074;4021;357;1403;389;1467;746;2870
420770;201412;953;2967;591;2138;189;738;144;493;333;1231
420775;201412;716;2286;445;1528;132;455;92;296;224;751
420780;201412;1721;5289;1125;3797;307;1114;265;817;572;1931
420785;201412;325;989;226;733;44;159;76;216;120;375
420790;201412;1447;5113;1158;4351;345;1427;452;1600;797;3027
420800;201412;989;2903;572;1939;189;707;121;376;310;1083
420810;201412;2722;9448;2184;8171;773;3209;577;2097;1350;5306
420820;201412;9356;30687;7145;26518;2374;9756;2238;8328;4612;18084
420830;201412;2990;10006;2552;9157;938;3654;870;3020;1808;6674
420840;201412;1051;3089;582;2120;165;671;163;542;328;1213
420845;201412;1472;4848;1162;4231;424;1749;265;862;689;2611
420850;201412;2159;7098;1421;5453;483;1987;291;1113;774;3100
420860;201412;691;2015;462;1589;159;611;185;626;344;1237
420870;201412;1457;4199;1140;3721;431;1563;364;1106;795;2669
420880;201412;1516;5104;1222;4312;349;1294;228;737;577;2031
420890;201412;13584;33008;5983;19098;1187;4323;1892;5247;3079;9570
420895;201412;240;661;116;380;35;122;27;80;62;202
420900;201412;2500;7201;1606;5394;448;1624;417;1318;865;2942
420910;201412;23984;72871;15512;54663;3625;14581;4396;14329;8021;28910
420915;201412;723;2823;624;2549;197;818;267;1106;464;1924
420917;201412;474;1478;254;820;62;237;88;235;150;472
420920;201412;217;638;111;390;49;182;16;57;65;239
420930;201412;22006;65491;17976;58525;5396;19258;6592;21126;11988;40384
420940;201412;4724;14299;3896;12459;1082;3844;1142;3290;2224;7134
420945;201412;242;755;158;547;50;193;41;134;91;327
420950;201412;681;1962;316;1179;70;302;49;153;119;455
420960;201412;1517;4718;1311;4347;414;1564;515;1570;929;3134
420970;201412;2782;8794;2426;8181;704;2600;1115;3792;1819;6392
420980;201412;494;1591;398;1413;128;456;183;709;311;1165
420985;201412;634;1883;358;1270;107;410;98;328;205;738
420990;201412;969;2860;653;2300;177;692;185;598;362;1290
421000;201412;709;2569;502;2012;152;664;69;224;221;888
421003;201412;737;2089;302;1040;64;250;57;152;121;402
421005;201412;263;847;216;763;71;270;102;351;173;621
421010;201412;7273;22016;5377;18284;1749;6488;1588;5088;3337;11576
421020;201412;513;1639;387;1388;67;241;206;777;273;1018
421030;201412;1039;3820;963;3629;344;1372;328;1249;672;2621
421040;201412;969;2912;784;2578;250;897;305;929;555;1826
421050;201412;2151;5728;1173;3898;321;1222;279;779;600;2001
421055;201412;295;948;191;688;60;235;49;144;109;379
421060;201412;578;2088;462;1755;108;449;146;534;254;983
421070;201412;816;2565;530;1868;141;570;129;434;270;1004
421080;201412;729;2340;643;2164;190;673;312;1035;502;1708
421085;201412;615;1656;332;1136;81;302;91;330;172;632
421090;201412;510;1435;340;1062;85;285;135;404;220;689
421100;201412;1114;3386;774;2630;230;818;174;522;404;1340
421105;201412;1593;5025;1350;4572;344;1271;540;1862;884;3133
421110;201412;1694;5568;1469;5170;544;2074;456;1496;1000;3570
421120;201412;1751;5649;1251;4428;291;1194;372;1176;663;2370
421125;201412;472;1399;352;1174;103;385;130;409;233;794
421130;201412;3533;11630;2917;10454;1046;4171;958;3398;2004;7569
421140;201412;448;1406;356;1201;94;355;136;430;230;785
421145;201412;623;2052;448;1562;77;299;198;668;275;967
421150;201412;604;1947;457;1667;125;492;185;671;310;1163
421160;201412;1223;3683;678;2364;156;617;234;749;390;1366
421165;201412;339;1201;270;983;64;237;115;421;179;658
421170;201412;2065;6418;1640;5470;438;1551;856;2810;1294;4361
421175;201412;1505;4499;1178;3948;345;1360;440;1316;785;2676
421180;201412;649;1829;355;1190;95;356;116;339;211;695
421185;201412;496;1402;362;1132;76;228;172;561;248;789
421187;201412;357;1108;274;936;75;272;121;396;196;668
421189;201412;544;1670;487;1557;117;382;184;582;301;964
421190;201412;12233;38031;8302;29444;2413;9172;2238;7778;4651;16950
421200;201412;1120;3700;961;3352;256;981;352;1179;608;2160
421205;201412;246;773;183;633;44;181;46;130;90;311
421210;201412;2200;6829;1804;5839;610;2074;553;1716;1163;3790
421220;201412;2572;8768;2237;8045;793;3105;616;2182;1409;5287
421223;201412;787;2239;494;1712;138;503;218;742;356;1245
421225;201412;1287;4000;1063;3522;282;1005;442;1467;724;2472
421227;201412;971;3198;863;3030;217;756;509;1848;726;2604
421230;201412;773;2619;690;2423;202;756;245;829;447;1585
421240;201412;573;1896;355;1259;81;301;71;223;152;524
421250;201412;2140;6547;1431;5226;522;2069;358;1269;880;3338
421260;201412;423;1276;161;619;44;167;32;117;76;284
421265;201412;468;1571;407;1437;101;371;154;544;255;915
421270;201412;827;2286;466;1569;147;526;126;463;273;989
421280;201412;1824;5792;1477;5217;499;1951;479;1692;978;3643
421290;201412;2122;5981;1317;4359;419;1504;315;929;734;2433
421300;201412;343;1065;285;940;99;374;110;339;209;713
421310;201412;543;1857;459;1630;158;570;118;401;276;971
421315;201412;404;1214;234;847;53;198;36;135;89;333
421320;201412;606;2079;405;1518;82;340;69;210;151;550
421330;201412;663;2308;573;2117;229;947;89;317;318;1264
421335;201412;590;1948;468;1699;127;503;104;387;231;890
421340;201412;2140;6590;1835;6058;402;1536;1044;3374;1446;4910
421350;201412;1170;3995;971;3549;321;1310;289;1005;610;2315
421360;201412;3413;10140;2223;7765;539;2147;712;2298;1251;4445
421370;201412;1173;4124;983;3665;334;1372;298;1057;632;2429
421380;201412;1127;3256;902;2823;180;618;437;1368;617;1986
421390;201412;220;684;146;504;26;89;39;145;65;234
421400;201412;431;1631;350;1439;140;613;88;341;228;954
421410;201412;404;1214;298;1002;63;218;149;507;212;725
421415;201412;449;1409;215;800;68;268;54;184;122;452
421420;201412;1432;4474;1073;3593;249;886;232;712;481;1598
421430;201412;312;1026;243;884;76;314;48;167;124;481
421440;201412;917;2743;624;2173;168;630;240;798;408;1428
421450;201412;665;2158;457;1694;148;602;86;295;234;897
421460;201412;795;2413;484;1785;126;515;115;398;241;913
421470;201412;554;2027;461;1806;137;556;175;687;312;1243
421480;201412;2792;8194;1653;5908;436;1790;406;1273;842;3063
421490;201412;365;1190;191;748;71;298;49;188;120;486
421500;201412;2826;10002;2452;9193;990;4140;548;1980;1538;6120
421505;201412;444;1508;395;1386;115;426;164;567;279;993
421507;201412;738;2362;512;1838;115;428;191;691;306;1119
421510;201412;315;1185;288;1130;93;424;125;425;218;849
421520;201412;841;2272;547;1660;60;237;287;793;347;1030
421530;201412;535;1787;338;1325;89;397;115;432;204;829
421535;201412;713;2139;404;1464;79;311;197;677;276;988
421540;201412;434;1258;359;1115;87;294;146;434;233;728
421545;201412;1319;4528;1052;3957;339;1414;232;824;571;2238
421550;201412;2367;7913;2070;7332;726;2855;620;2108;1346;4963
421555;201412;347;1050;131;466;24;96;22;71;46;167
421560;201412;240;729;101;363;24;95;23;80;47;175
421565;201412;1167;3639;1053;3448;436;1553;376;1191;812;2744
421567;201412;991;3687;851;3317;412;1651;179;694;591;2345
421568;201412;536;1705;375;1323;102;367;109;385;211;752
421569;201412;223;718;133;493;33;138;33;107;66;245
421570;201412;1405;4540;848;3149;295;1206;193;670;488;1876
421575;201412;640;2144;570;2001;117;439;327;1151;444;1590
421580;201412;4426;14706;3485;12541;1241;4996;882;2854;2123;7850
421590;201412;268;855;216;743;45;164;108;354;153;518
421600;201412;600;1805;437;1450;130;475;106;325;236;800
421605;201412;724;2250;511;1806;131;531;142;465;273;996
421610;201412;1905;4953;1480;4316;208;678;924;2645;1132;3323
421620;201412;5507;16957;3878;13452;1296;4851;1258;4368;2554;9219
421625;201412;450;1411;254;923;66;269;87;304;153;573
421630;201412;3019;9154;1736;6047;524;2001;308;1011;832;3012
421635;201412;375;1241;263;973;67;274;99;328;166;602
421640;201412;1245;3865;998;3394;209;718;587;2045;796;2763
421650;201412;2488;8311;2116;7445;824;3196;361;1159;1185;4355
421660;201412;10389;34709;8363;30496;2738;11053;2652;9062;5390;20115
421670;201412;1329;4322;965;3461;307;1212;277;980;584;2192
421680;201412;1536;5026;1343;4557;526;1880;266;871;792;2751
421690;201412;2122;7006;1636;5800;447;1734;264;854;711;2588
421700;201412;758;2358;458;1647;144;585;138;416;282;1001
421710;201412;371;1309;250;953;98;387;64;235;162;622
421715;201412;319;908;192;641;57;202;56;176;113;378
421720;201412;1743;5323;1160;4100;434;1700;333;1102;767;2802
421725;201412;136;478;128;460;51;201;37;133;88;334
421730;201412;671;2076;341;1251;89;355;68;199;157;554
421740;201412;723;2235;483;1644;118;476;112;280;230;756
421750;201412;1561;4637;1177;3831;324;1151;471;1416;795;2567
421755;201412;476;1499;341;1157;103;387;100;305;203;692
421760;201412;638;2129;351;1291;92;382;123;424;215;806
421770;201412;3980;12081;3170;10413;1222;4178;922;3120;2144;7298
421775;201412;604;1776;395;1388;91;335;123;417;214;752
421780;201412;1870;6446;1457;5491;543;2216;442;1566;985;3782
421790;201412;1076;3035;655;2318;208;835;167;539;375;1374
421795;201412;423;1292;283;936;53;201;85;272;138;473
421800;201412;3017;9667;2322;8268;636;2562;859;2784;1495;5346
421810;201412;710;2291;514;1833;149;558;91;321;240;879
421820;201412;1360;4175;940;3306;220;900;236;727;456;1627
421825;201412;1498;4957;1387;4691;225;897;891;2888;1116;3785
421830;201412;3329;11275;3077;10759;786;2954;1533;5421;2319;8375
421835;201412;205;638;159;562;48;202;79;256;127;458
421840;201412;540;1927;468;1747;162;664;174;619;336;1283
421850;201412;548;1598;360;1206;93;352;110;367;203;719
421860;201412;367;1150;227;833;45;177;52;169;97;346
421870;201412;5588;16422;3940;12972;1246;4429;756;2377;2002;6806
421875;201412;445;1338;203;759;56;240;43;142;99;382
421880;201412;1148;3750;916;3203;281;1122;244;783;525;1905
421885;201412;385;1322;335;1220;87;321;136;495;223;816
421890;201412;1127;3855;969;3509;335;1358;303;1046;638;2404
421895;201412;448;1526;410;1449;113;400;221;810;334;1210
421900;201412;926;3006;757;2598;222;806;260;819;482;1625
421910;201412;569;1787;406;1404;98;379;126;381;224;760
421915;201412;607;1851;450;1491;106;376;141;432;247;808
421917;201412;644;2003;506;1761;166;686;181;568;347;1254
421920;201412;909;2665;634;2282;280;1050;209;753;489;1803
421930;201412;4292;12090;2884;9475;918;3368;504;1556;1422;4924
421935;201412;916;3176;719;2720;196;827;265;969;461;1796
421940;201412;371;1348;256;1004;73;323;59;204;132;527
421950;201412;4788;13608;2580;8843;783;2845;571;1971;1354;4816
421960;201412;266;853;213;731;56;212;61;198;117;410
421970;201412;2467;7333;1691;5583;613;2191;340;988;953;3179
421985;201412;547;1445;298;935;59;218;92;290;151;508
422000;201412;897;2649;711;2285;164;569;317;1057;481;1626
430003;201412;914;2658;719;2313;207;738;227;707;434;1445
430005;201412;330;1090;277;975;60;226;149;505;209;731
430010;201412;2394;6719;1802;5623;535;1726;720;2268;1255;3994
430020;201412;1137;3038;987;2815;226;744;570;1549;796;2293
430030;201412;1634;4415;1336;3872;523;1636;268;700;791;2336
430040;201412;13154;34618;10846;30698;3410;10125;3688;10361;7098;20486
430045;201412;784;2173;625;1847;115;386;349;1002;464;1388
430047;201412;284;713;169;514;34;98;75;228;109;326
430050;201412;1151;3110;706;2215;151;532;210;591;361;1123
430055;201412;310;889;194;613;35;124;100;312;135;436
430057;201412;87;226;41;131;7;25;13;30;20;55
430060;201412;17054;55309;14880;51361;4399;15846;7147;25178;11546;41024
430063;201412;1128;3338;913;2870;247;786;436;1416;683;2202
430064;201412;1739;5181;1442;4674;426;1406;632;2118;1058;3524
430066;201412;184;472;136;395;26;88;75;201;101;289
430070;201412;732;2167;401;1383;108;402;113;352;221;754
430080;201412;697;2248;536;1875;140;541;159;520;299;1061
430085;201412;778;2172;542;1751;153;560;210;649;363;1209
430087;201412;1023;3127;971;3029;116;403;745;2298;861;2701
430090;201412;876;2326;303;1007;42;165;64;213;106;378
430100;201412;1218;3707;872;2976;306;1159;225;642;531;1801
430105;201412;892;2808;675;2372;207;809;179;587;386;1396
430107;201412;274;928;215;750;43;165;86;283;129;448
430110;201412;2394;6917;2132;6485;694;2223;935;2844;1629;5067
430120;201412;1896;5764;1489;4896;338;1176;805;2583;1143;3759
430130;201412;4713;12112;4197;11351;848;2474;2425;6567;3273;9041
430140;201412;1298;4153;988;3413;307;1096;333;1121;640;2217
430150;201412;991;2660;643;2001;161;542;170;509;331;1051
430155;201412;578;1745;408;1382;89;295;197;678;286;973
430160;201412;19408;56996;17874;54461;3904;12916;10030;31255;13934;44171
430163;201412;2046;6136;1752;5589;396;1418;867;2782;1263;4200
430165;201412;527;1493;249;912;95;373;68;234;163;607
430170;201412;817;2383;367;1286;72;274;69;207;141;481
430175;201412;974;3080;766;2582;190;594;349;1265;539;1859
430180;201412;1173;3191;989;2882;257;838;471;1333;728;2171
430185;201412;784;1963;406;1231;64;219;138;376;202;595
430187;201412;767;2345;600;1978;176;666;204;619;380;1285
430190;201412;2454;7294;2134;6658;537;1911;1022;3164;1559;5075
430192;201412;208;643;108;339;16;49;31;94;47;143
430195;201412;304;923;77;278;8;29;12;36;20;65
430200;201412;1705;5501;1419;4873;437;1585;396;1340;833;2925
430205;201412;532;1530;402;1285;57;217;260;812;317;1029
430210;201412;7126;19880;3949;13007;1038;3708;846;2540;1884;6248
430215;201412;369;1082;261;842;57;201;114;354;171;555
430220;201412;746;1946;349;1153;67;246;67;209;134;455
430222;201412;327;996;253;833;53;214;113;348;166;562
430223;201412;370;1091;323;1018;73;235;200;644;273;879
430225;201412;60;174;36;115;8;22;8;20;16;42
430230;201412;2183;6903;2059;6773;350;1012;1615;5528;1965;6540
430235;201412;293;962;233;809;71;268;59;189;130;457
430237;201412;513;1394;387;1164;48;187;253;727;301;914
430240;201412;938;2462;608;1892;145;521;244;711;389;1232
430245;201412;1003;3174;767;2642;208;737;343;1216;551;1953
430250;201412;1664;4598;1482;4270;618;1835;418;1221;1036;3056
430258;201412;183;524;127;415;21;76;51;165;72;241
430260;201412;876;2461;579;1841;80;283;316;1010;396;1293
430265;201412;349;1087;279;928;88;290;43;128;131;418
430270;201412;3735;10532;3337;9850;784;2627;1788;5190;2572;7817
430280;201412;5621;15806;4728;14151;1350;4283;2075;6182;3425;10465
430290;201412;2685;7286;2500;7054;289;809;2076;5965;2365;6774
430300;201412;10936;32993;9118;29420;3089;10435;3750;12345;6839;22780
430310;201412;9481;29549;8150;26917;2592;9196;3397;10845;5989;20041
430320;201412;894;2626;606;2030;106;316;312;1103;418;1419
430330;201412;1041;2842;870;2514;266;808;349;935;615;1743
430340;201412;793;1994;442;1464;101;386;209;681;310;1067
430350;201412;6620;20933;5586;18628;2048;7203;1953;6365;4001;13568
430355;201412;353;893;149;467;31;108;27;70;58;178
430360;201412;1189;3187;993;2799;198;632;529;1430;727;2062
430367;201412;370;1021;241;785;46;161;65;203;111;364
430370;201412;511;1489;377;1217;112;399;104;302;216;701
430380;201412;901;2319;499;1579;134;452;176;573;310;1025
430390;201412;4768;13827;3414;10997;886;3080;967;2966;1853;6046
430400;201412;1428;3439;983;2749;296;929;422;1075;718;2004
430410;201412;739;2000;564;1706;106;349;288;870;394;1219
430420;201412;4861;14102;3890;11863;1161;3632;1584;4818;2745;8450
430430;201412;858;2369;543;1760;171;606;152;470;323;1076
430435;201412;2192;5939;1744;5111;414;1274;907;2680;1321;3954
430440;201412;5216;16180;4156;13918;887;3115;1913;6692;2800;9807
430450;201412;9334;26785;7400;22770;2862;9231;2029;6225;4891;15456
430460;201412;29883;90250;23783;78845;7443;26471;8413;27860;15856;54331
430461;201412;498;1380;169;551;31;110;47;147;78;257
430462;201412;372;1086;292;944;118;422;77;227;195;649
430463;201412;4299;13856;3742;12751;914;3380;1868;6380;2782;9760
430465;201412;684;1858;577;1672;119;393;374;1048;493;1441
430466;201412;4903;13900;4462;13187;1154;3734;2367;6952;3521;10686
430467;201412;623;1884;547;1756;133;474;265;813;398;1287
430468;201412;1555;4504;1352;4178;510;1687;436;1341;946;3028
430469;201412;242;682;66;251;8;39;18;65;26;104
430470;201412;8027;21562;5698;17458;1883;6187;1347;4037;3230;10224
430471;201412;928;3063;827;2846;300;1073;218;756;518;1829
430480;201412;992;2688;532;1727;89;315;140;397;229;712
430485;201412;263;800;140;502;30;105;53;193;83;298
430490;201412;560;1650;398;1341;120;416;139;487;259;903
430495;201412;451;1330;300;1001;61;226;86;259;147;485
430500;201412;1690;4754;1424;4288;452;1488;605;1793;1057;3281
430510;201412;26435;80756;20699;67864;7222;25875;6004;18653;13226;44528
430511;201412;490;1476;221;754;38;146;42;118;80;264
430512;201412;1389;3622;1216;3333;351;980;463;1327;814;2307
430513;201412;771;2126;489;1510;86;271;235;730;321;1001
430515;201412;637;1866;498;1564;103;315;221;722;324;1037
430517;201412;1515;4935;1298;4469;271;983;788;2710;1059;3693
430520;201412;1907;5522;1453;4551;461;1553;534;1608;995;3161
430530;201412;989;2777;514;1657;90;340;145;418;235;758
430535;201412;2663;8424;2158;7310;593;2235;727;2392;1320;4627
430537;201412;648;1856;450;1515;47;160;343;1170;390;1330
430540;201412;823;1950;586;1636;134;406;333;908;467;1314
430543;201412;617;1624;555;1561;120;356;388;1104;508;1460
430544;201412;810;2621;670;2291;143;526;345;1146;488;1672
430545;201412;1504;4845;1310;4597;442;1556;677;2524;1119;4080
430550;201412;742;2204;498;1675;111;401;188;629;299;1030
430558;201412;120;359;73;247;32;122;10;25;42;147
430560;201412;414;1035;239;709;34;121;83;232;117;353
430570;201412;1297;3344;882;2564;242;790;408;1085;650;1875
430580;201412;1231;3353;758;2442;248;835;195;647;443;1482
430583;201412;157;429;46;154;7;25;3;10;10;35
430585;201412;374;996;243;716;74;242;103;271;177;513
430587;201412;304;943;256;841;94;320;80;265;174;585
430590;201412;1582;4431;1496;4292;298;948;967;2748;1265;3696
430593;201412;36;138;32;125;10;49;11;35;21;84
430595;201412;273;782;107;386;36;148;17;51;53;199
430597;201412;414;1266;312;1016;59;215;125;385;184;600
430600;201412;2346;6440;1381;4258;306;1001;461;1387;767;2388
430605;201412;1432;4448;1128;3795;280;1028;468;1604;748;2632
430607;201412;818;2109;639;1811;106;321;389;1113;495;1434
430610;201412;8844;23852;6784;20454;1801;5979;2674;8032;4475;14011
430613;201412;266;660;114;349;25;73;28;76;53;149
430620;201412;1015;3094;825;2661;249;886;326;988;575;1874
430630;201412;519;1569;299;1002;92;318;55;170;147;488
430632;201412;780;2166;457;1434;93;337;231;671;324;1008
430635;201412;715;1979;509;1573;117;390;250;764;367;1154
430637;201412;566;1613;503;1482;84;292;323;906;407;1198
430640;201412;2090;5843;1064;3509;244;843;216;590;460;1433
430642;201412;521;1376;316;996;64;217;127;388;191;605
430645;201412;199;583;109;376;26;95;27;90;53;185
430650;201412;2201;7207;1905;6581;432;1514;1038;3708;1470;5222
430655;201412;317;955;276;866;71;243;102;267;173;510
430660;201412;6444;18806;5110;16335;1551;5446;2073;6561;3624;12007
430670;201412;520;1523;471;1426;46;133;352;1104;398;1237
430673;201412;819;1997;449;1365;122;385;187;565;309;950
430675;201412;295;870;132;434;29;108;48;146;77;254
430676;201412;4905;14801;4361;13838;1358;4567;1710;5611;3068;10178
430680;201412;1158;3452;830;2720;174;652;319;942;493;1594
430690;201412;4770;13721;3868;11932;1240;3977;1378;4342;2618;8319
430692;201412;317;1069;226;887;30;121;142;561;172;682
430693;201412;1861;5235;1338;4084;307;1040;381;1088;688;2128
430695;201412;521;1510;384;1231;82;304;164;490;246;794
430697;201412;496;1406;375;1194;115;357;146;507;261;864
430700;201412;9674;25254;4350;14439;915;3372;417;1320;1332;4692
430705;201412;422;1329;388;1270;127;453;150;491;277;944
430710;201412;1934;4967;1481;4187;340;1037;655;1913;995;2950
430720;201412;958;2388;634;1906;185;604;246;743;431;1347
430730;201412;2003;5365;1483;4499;358;1051;766;2467;1124;3518
430740;201412;644;1814;386;1260;116;403;74;222;190;625
430745;201412;556;1584;327;1026;71;234;96;308;167;542
430750;201412;1962;5537;1606;4922;390;1315;805;2366;1195;3681
430755;201412;684;1912;479;1465;100;362;216;594;316;956
430760;201412;3901;10006;2898;8596;704;2303;1446;4375;2150;6678
430770;201412;7710;22766;6220;19980;1404;4910;3178;10069;4582;14979
430780;201412;2832;7944;1857;5983;526;1857;677;2081;1203;3938
430781;201412;681;2015;485;1596;138;470;158;508;296;978
430783;201412;628;1597;451;1302;97;317;207;552;304;869
430786;201412;131;427;102;351;34;121;24;83;58;204
430790;201412;4532;12494;2982;9265;640;2297;1272;3630;1912;5927
430800;201412;907;2690;616;1995;148;506;211;647;359;1153
430805;201412;516;1460;373;1197;46;143;227;759;273;902
430807;201412;389;1136;254;826;58;222;78;228;136;450
430810;201412;776;2170;378;1275;72;272;72;215;144;487
430820;201412;1212;3853;868;2964;246;896;259;822;505;1718
430825;201412;481;1346;240;759;48;161;79;222;127;383
430830;201412;2742;8023;2527;7693;364;1107;1644;5311;2008;6418
430840;201412;1064;3275;960;3058;246;806;449;1477;695;2283
430843;201412;131;389;78;255;16;50;34;107;50;157
430845;201412;357;1083;284;925;116;403;38;113;154;516
430850;201412;3514;10685;3097;9906;842;2850;1391;4444;2233;7294
430860;201412;939;2550;549;1872;183;719;141;431;324;1150
430865;201412;761;2062;694;1946;227;665;333;923;560;1588
430870;201412;748;2117;438;1466;129;443;108;335;237;778
430880;201412;1496;4278;1169;3643;434;1408;341;1101;775;2509
430885;201412;227;670;165;567;48;180;62;203;110;383
430890;201412;1853;4907;1294;3790;94;333;675;1901;769;2234
430900;201412;3549;9383;3132;8705;763;2311;1654;4466;2417;6777
430905;201412;1212;3537;805;2629;242;869;212;661;454;1530
430910;201412;1976;6172;1518;5218;532;1957;555;1834;1087;3791
430912;201412;636;1768;478;1500;75;273;277;845;352;1118
430915;201412;497;1617;334;1266;104;419;96;386;200;805
430920;201412;17853;55627;16034;52133;4486;15599;9091;29144;13577;44743
430925;201412;96;273;73;227;23;80;35;105;58;185
430930;201412;10836;32813;8033;27133;2457;8798;2762;9671;5219;18469
430940;201412;1407;4373;970;3322;245;934;267;855;512;1789
430950;201412;1676;4710;1260;3838;387;1257;403;1173;790;2430
430955;201412;166;506;93;306;32;109;25;77;57;186
430957;201412;331;1116;266;972;71;278;116;429;187;707
430960;201412;1904;5442;1662;5014;602;1939;590;1800;1192;3739
430965;201412;1498;4407;1287;4032;95;355;1054;3281;1149;3636
430970;201412;567;1584;327;1053;73;261;97;298;170;559
430975;201412;673;2186;519;1803;86;323;281;970;367;1293
430980;201412;615;1464;348;1058;94;323;140;383;234;706
430990;201412;711;2286;537;1843;175;616;147;490;322;1106
430995;201412;768;2279;666;2077;232;761;245;750;477;1511
431000;201412;1790;4711;921;2869;198;697;125;318;323;1015
431010;201412;3065;8932;1997;6730;520;1921;595;1857;1115;3778
431020;201412;15349;37969;10398;28951;2826;8079;3326;9509;6152;17588
431030;201412;392;1169;212;744;56;211;49;161;105;372
431033;201412;2941;8533;2674;8121;694;2190;1423;4510;2117;6700
431036;201412;247;662;114;388;18;63;25;72;43;135
431040;201412;1115;3187;892;2809;259;906;442;1349;701;2255
431041;201412;617;1691;549;1594;164;491;240;729;404;1220
431043;201412;441;1449;326;1178;154;608;104;336;258;944
431046;201412;133;396;98;319;24;90;34;105;58;195
431050;201412;1970;4959;1539;4222;358;1056;845;2283;1203;3339
431053;201412;666;2201;553;1947;177;676;172;616;349;1292
431055;201412;726;1998;671;1900;70;200;493;1403;563;1603
431057;201412;392;1154;225;789;55;197;85;297;140;494
431060;201412;6553;19277;6103;18665;1752;5226;3395;10852;5147;16078
431065;201412;542;1544;457;1390;55;180;299;905;354;1085
431070;201412;779;2275;458;1537;97;333;115;354;212;687
431075;201412;298;911;199;690;37;143;66;233;103;376
431080;201412;763;2490;618;2168;172;644;134;450;306;1094
431085;201412;993;2626;789;2262;139;429;478;1352;617;1781
431087;201412;653;1886;570;1722;80;236;371;1129;451;1365
431090;201412;592;1494;304;942;102;334;66;186;168;520
431100;201412;4911;13649;4086;12193;1215;3834;1656;5043;2871;8877
431110;201412;1705;4559;1280;3701;296;919;631;1757;927;2676
431112;201412;673;2117;637;2050;203;665;305;975;508;1640
431113;201412;710;2081;528;1671;154;501;139;442;293;943
431115;201412;1630;4762;1444;4433;299;956;865;2656;1164;3612
431120;201412;3004;9411;2494;8396;778;2872;991;3225;1769;6097
431123;201412;605;1807;455;1510;107;390;242;808;349;1198
431125;201412;1455;4468;1095;3690;333;1101;364;1330;697;2431
431127;201412;201;519;60;195;8;22;5;12;13;34
431130;201412;4202;12059;3303;10433;887;3037;1374;4330;2261;7367
431140;201412;4406;11090;2350;7495;447;1638;562;1548;1009;3186
431142;201412;579;1732;518;1616;70;220;337;1072;407;1292
431150;201412;1395;4198;1118;3654;303;1039;417;1368;720;2407
431160;201412;1046;3099;872;2729;170;539;433;1456;603;1995
431162;201412;491;1304;230;776;34;145;37;98;71;243
431164;201412;161;449;45;166;15;59;1;4;16;63
431170;201412;1004;2907;774;2454;276;903;217;681;493;1584
431171;201412;934;2777;801;2507;295;970;210;629;505;1599
431173;201412;533;1561;476;1457;113;357;279;860;392;1217
431175;201412;1352;3755;1159;3458;388;1217;462;1380;850;2597
431177;201412;1116;3581;928;3192;323;1214;390;1325;713;2539
431179;201412;346;737;89;265;12;47;24;58;36;105
431180;201412;2352;6803;1675;5327;402;1386;432;1294;834;2680
431190;201412;835;2279;463;1517;121;436;127;407;248;843
431198;201412;404;1314;353;1208;161;585;84;280;245;865
431200;201412;348;985;108;363;25;90;10;29;35;119
431205;201412;389;1227;235;823;57;199;86;296;143;495
431210;201412;828;2308;712;2084;192;566;384;1131;576;1697
431213;201412;313;968;257;859;79;294;89;283;168;577
431215;201412;343;1015;170;580;34;115;17;45;51;160
431217;201412;249;751;191;615;61;212;49;168;110;380
431220;201412;1208;3127;835;2400;126;417;423;1148;549;1565
431225;201412;1446;4256;1244;3909;299;983;675;2150;974;3133
431230;201412;997;2928;773;2456;128;429;417;1317;545;1746
431235;201412;75;179;35;106;9;30;11;31;20;61
431237;201412;463;1499;406;1415;123;481;184;622;307;1103
431238;201412;54;173;44;148;10;34;14;49;24;83
431240;201412;2895;8726;2468;7986;860;3014;747;2349;1607;5363
431242;201412;452;1432;415;1360;163;579;69;217;232;796
431244;201412;513;1250;347;969;72;238;162;416;234;654
431245;201412;1242;3368;998;2932;186;580;616;1813;802;2393
431247;201412;243;756;191;652;79;291;67;215;146;506
431250;201412;1989;6215;1751;5870;540;1945;755;2588;1295;4533
431260;201412;434;1266;291;969;81;307;69;209;150;516
431261;201412;234;810;199;726;43;178;69;241;112;419
431262;201412;412;1125;171;563;25;106;71;231;96;337
431265;201412;1477;3944;808;2491;190;668;218;552;408;1220
431267;201412;211;632;177;567;45;164;85;254;130;418
431270;201412;2845;7547;2124;6405;572;1806;957;2977;1529;4783
431275;201412;255;798;149;530;45;157;31;96;76;253
431280;201412;288;818;117;398;24;95;27;75;51;170
431290;201412;385;1240;294;1011;83;331;74;242;157;573
431295;201412;232;741;139;471;26;97;39;115;65;212
431300;201412;325;900;90;340;26;98;5;21;31;119
431301;201412;258;840;166;591;46;159;29;90;75;249
431303;201412;829;2219;521;1565;120;431;168;461;288;892
431306;201412;2338;6439;1719;5269;318;1176;604;1644;922;2820
431308;201412;56;193;52;182;34;119;13;48;47;167
431310;201412;822;2500;504;1742;107;386;161;573;268;959
431320;201412;1040;3025;615;2133;178;682;155;510;333;1192
431330;201412;2683;6725;1263;4030;393;1374;167;502;560;1876
431333;201412;473;1262;214;647;43;140;69;173;112;313
431335;201412;97;290;81;250;19;56;31;92;50;148
431337;201412;2761;8524;2091;7042;569;2032;513;1638;1082;3670
431339;201412;738;2054;509;1548;108;340;239;723;347;1063
431340;201412;29354;78540;21124;64046;5350;17795;7083;20850;12433;38645
431342;201412;654;1706;551;1531;160;478;293;782;453;1260
431344;201412;413;1131;306;940;29;89;202;635;231;724
431346;201412;349;921;198;583;57;168;56;163;113;331
431349;201412;701;2027;464;1444;106;338;158;487;264;825
431350;201412;4279;12746;3662;11623;753;2742;1960;6015;2713;8757
431360;201412;874;2322;623;1893;161;512;244;761;405;1273
431365;201412;1533;4620;1324;4261;480;1660;528;1723;1008;3383
431370;201412;5585;16055;4545;14221;1325;4462;1663;5235;2988;9697
431380;201412;1108;3419;1032;3248;173;584;707;2192;880;2776
431390;201412;3869;10925;2601;8431;796;2923;774;2280;1570;5203
431395;201412;1721;5090;1496;4704;445;1493;608;1906;1053;3399
431400;201412;258;831;148;538;46;176;18;45;64;221
431402;201412;1401;3406;820;2350;179;533;393;1094;572;1627
431403;201412;330;988;243;824;79;291;53;178;132;469
431405;201412;4988;14187;3982;12667;966;3547;1909;5820;2875;9367
431406;201412;872;2692;652;2188;211;738;279;920;490;1658
431407;201412;698;2078;468;1571;139;475;114;359;253;834
431410;201412;17615;53702;13520;45438;4891;17558;3139;10937;8030;28495
431413;201412;218;535;99;309;11;38;41;121;52;159
431415;201412;988;2826;787;2436;198;671;348;1020;546;1691
431417;201412;718;1821;573;1603;93;268;325;931;418;1199
431420;201412;1669;4641;1460;4305;343;1049;788;2425;1131;3474
431430;201412;631;1727;439;1361;105;351;149;424;254;775
431440;201412;34567;100353;30183;93024;9877;31332;13185;42607;23062;73939
431442;201412;220;692;168;558;56;207;25;63;81;270
431445;201412;521;1430;302;921;59;190;124;368;183;558
431446;201412;524;1542;385;1248;96;315;164;535;260;850
431447;201412;868;2496;610;1903;138;459;255;807;393;1266
431449;201412;968;2745;786;2422;120;405;444;1388;564;1793
431450;201412;2432;6297;2191;5932;456;1319;1458;3898;1914;5217
431455;201412;739;1891;414;1181;132;379;117;318;249;697
431460;201412;3804;10698;3263;9650;993;3009;1193;3635;2186;6644
431470;201412;1926;5685;1533;4813;423;1317;660;2165;1083;3482
431475;201412;201;591;55;214;10;43;4;15;14;58
431477;201412;772;2088;531;1608;82;273;309;906;391;1179
431478;201412;263;688;100;301;24;76;31;85;55;161
431480;201412;3147;8883;2404;7510;706;2436;932;2777;1638;5213
431490;201412;123440;343359;107328;318626;17954;60512;71836;209198;89790;269710
431500;201412;1233;3228;972;2730;268;742;390;1117;658;1859
431505;201412;499;1279;411;1155;50;132;303;885;353;1017
431507;201412;470;1158;371;972;72;185;229;607;301;792
431510;201412;2297;6335;1882;5583;393;1276;933;2657;1326;3933
431513;201412;286;784;126;405;29;100;58;186;87;286
431514;201412;112;291;41;141;5;26;3;9;8;35
431515;201412;805;2385;559;1757;117;419;221;600;338;1019
431517;201412;101;326;91;300;37;132;28;78;65;210
431520;201412;503;1510;317;1031;60;216;89;279;149;495
431530;201412;4906;11768;3760;10434;1187;3381;1706;5034;2893;8415
431531;201412;317;894;215;684;55;185;82;259;137;444
431532;201412;597;1679;519;1514;153;483;221;631;374;1114
431535;201412;458;1289;277;863;64;215;79;225;143;440
431540;201412;2314;7476;2061;7104;281;899;1382;5101;1663;6000
431545;201412;267;758;58;203;6;22;11;49;17;71
431550;201412;2633;7779;2371;7302;529;1847;1188;3584;1717;5431
431555;201412;854;2212;701;1958;152;417;389;1095;541;1512
431560;201412;26664;81193;21346;70261;8136;27306;6566;22601;14702;49907
431570;201412;5883;16555;5209;15439;1493;4550;2671;7992;4164;12542
431575;201412;500;1325;357;1074;70;244;113;301;183;545
431580;201412;860;2603;606;2021;174;648;192;574;366;1222
431590;201412;1042;2897;712;2212;104;337;330;1023;434;1360
431595;201412;657;1843;533;1575;136;411;210;622;346;1033
431600;201412;2476;7233;1813;5878;467;1739;402;1156;869;2895
431610;201412;1814;5125;1324;4222;320;1053;586;1889;906;2942
431620;201412;465;1413;261;854;75;264;110;327;185;591
431630;201412;1570;4212;1096;3241;297;904;485;1448;782;2352
431640;201412;6600;19359;5962;18336;1433;4878;3390;10273;4823;15151
431642;201412;582;1666;480;1467;82;294;241;697;323;991
431643;201412;232;623;197;557;28;89;116;310;144;399
431645;201412;1928;5678;1713;5287;372;1214;986;3072;1358;4286
431647;201412;189;547;129;401;39;127;33;89;72;216
431650;201412;283;879;192;683;34;134;47;141;81;275
431660;201412;1632;4794;1165;3813;363;1231;402;1263;765;2494
431670;201412;1499;4106;1174;3509;316;1055;521;1474;837;2529
431673;201412;256;746;156;521;42;157;44;141;86;298
431675;201412;652;1820;228;777;58;209;58;169;116;378
431680;201412;11122;30831;8398;25893;2526;8400;2720;8399;5246;16799
431690;201412;28328;80485;22735;71402;6850;23049;9402;30017;16252;53066
431695;201412;163;557;118;440;31;118;31;84;62;202
431697;201412;537;1517;475;1401;135;403;213;649;348;1052
431700;201412;1737;4888;1472;4371;280;882;789;2306;1069;3188
431710;201412;13801;40312;11247;35851;3601;12161;3910;12748;7511;24909
431720;201412;7747;21805;6207;18803;1460;4948;2981;8823;4441;13771
431725;201412;34;119;32;115;13;48;11;39;24;87
431730;201412;4151;12596;3313;10984;977;3574;1049;3544;2026;7118
431740;201412;6318;18358;5394;16604;1956;6504;1450;4236;3406;10740
431750;201412;11075;31455;9441;28770;2079;6842;4903;15242;6982;22084
431755;201412;322;879;68;250;14;59;15;47;29;106
431760;201412;4428;13247;3635;11721;1007;3535;1231;3798;2238;7333
431770;201412;2453;6685;2060;6047;478;1467;1138;3320;1616;4787
431775;201412;253;700;182;565;76;249;42;113;118;362
431780;201412;2497;6685;1879;5512;530;1674;536;1489;1066;3163
431790;201412;1365;4276;1176;3907;273;961;636;2133;909;3094
431795;201412;503;1470;337;1050;66;223;123;383;189;606
431800;201412;10055;29710;8239;26207;2778;9537;2253;6966;5031;16503
431805;201412;318;773;87;301;12;47;16;55;28;102
431810;201412;3802;10499;3053;8963;656;2052;1424;4133;2080;6185
431820;201412;3022;9502;2629;8706;718;2535;1018;3304;1736;5839
431830;201412;12528;31783;10025;27966;3167;9484;3958;11180;7125;20664
431840;201412;3770;11216;3309;10358;983;3197;1499;4775;2482;7972
431842;201412;789;2009;401;1206;79;268;131;356;210;624
431843;201412;392;1143;342;1053;66;219;189;569;255;788
431844;201412;230;627;132;444;35;137;45;138;80;275
431845;201412;578;1708;501;1546;58;186;337;1051;395;1237
431846;201412;550;1626;472;1486;93;337;280;880;373;1217
431848;201412;199;542;106;355;22;87;21;65;43;152
431849;201412;432;1062;107;320;27;84;28;70;55;154
431850;201412;5348;15581;4661;14218;1178;3812;2078;6283;3256;10095
431860;201412;1019;2841;783;2415;159;562;416;1217;575;1779
431861;201412;103;319;64;227;14;47;9;29;23;76
431862;201412;513;1728;411;1498;146;576;104;362;250;938
431870;201412;27715;78388;22757;69290;6263;20833;9533;28212;15796;49045
431880;201412;5229;16298;4277;14139;1223;4419;1733;5556;2956;9975
431890;201412;6502;17984;5270;15781;1905;5984;1713;5270;3618;11254
431900;201412;1103;3231;789;2609;238;891;301;888;539;1779
431910;201412;1047;2491;495;1422;100;316;185;483;285;799
431912;201412;649;1866;499;1569;169;510;165;555;334;1065
431915;201412;1488;4027;1111;3343;282;920;446;1331;728;2251
431920;201412;1579;4401;1432;4190;194;526;1103;3320;1297;3846
431930;201412;1393;3831;1058;3287;168;493;628;2086;796;2579
431935;201412;124;448;109;417;45;195;31;96;76;291
431936;201412;483;1394;388;1184;73;211;208;693;281;904
431937;201412;366;979;217;670;57;193;43;117;100;310
431940;201412;2950;8034;1927;6015;520;1732;541;1644;1061;3376
431950;201412;2055;6497;1832;6093;499;1811;767;2448;1266;4259
431960;201412;3891;11445;3528;10734;1052;3357;1291;3951;2343;7308
431970;201412;528;1447;266;848;41;151;79;233;120;384
431971;201412;142;404;110;346;21;68;38;107;59;175
431973;201412;520;1780;458;1652;63;224;280;1063;343;1287
431975;201412;35;96;15;60;4;19;3;13;7;32
431980;201412;1650;4772;1418;4291;374;1251;536;1508;910;2759
431990;201412;9200;25441;6965;21672;1546;5495;2742;8045;4288;13540
432000;201412;12048;34909;9698;30713;3131;10354;3930;12468;7061;22822
432010;201412;2733;7962;2285;7117;568;1958;1036;3138;1604;5096
432020;201412;2548;6330;2048;5674;303;919;1394;3838;1697;4757
432023;201412;578;1685;397;1281;102;369;135;403;237;772
432026;201412;1401;4189;1045;3435;210;710;557;1837;767;2547
432030;201412;457;1346;357;1124;87;281;162;493;249;774
432032;201412;592;1549;398;1184;68;230;218;613;286;843
432035;201412;929;2906;825;2706;172;590;501;1632;673;2222
432040;201412;1070;2698;576;1873;152;557;145;383;297;940
432045;201412;266;816;177;639;45;171;66;247;111;418
432050;201412;840;2417;737;2218;142;456;427;1308;569;1764
432055;201412;889;2731;742;2418;163;585;434;1365;597;1950
432057;201412;486;1265;379;1065;53;166;237;624;290;790
432060;201412;488;1374;206;713;54;207;54;164;108;371
432065;201412;250;731;193;625;49;172;88;267;137;439
432067;201412;1123;3569;818;2873;219;788;392;1369;611;2157
432070;201412;2671;7245;1857;5599;565;1901;569;1608;1134;3509
432080;201412;4554;13235;3956;12152;1246;4026;1594;4848;2840;8874
432085;201412;352;1023;253;854;67;263;121;393;188;656
432090;201412;1903;5817;1579;5111;598;2064;496;1453;1094;3517
432100;201412;1319;3891;704;2429;196;706;106;286;302;992
432110;201412;3274;9815;2560;8274;825;2915;433;1299;1258;4214
432120;201412;5783;17326;4966;15816;1858;6290;1663;5293;3521;11583
432130;201412;2588;7287;2086;6618;680;2378;954;3023;1634;5401
432132;201412;507;1473;271;930;36;133;100;316;136;449
432135;201412;812;2462;771;2390;122;403;541;1670;663;2073
432140;201412;3032;8894;2451;7819;688;2263;972;3380;1660;5643
432143;201412;1499;4518;1281;4150;309;1028;704;2349;1013;3377
432145;201412;1270;4042;858;3051;270;1046;163;527;433;1573
432146;201412;288;911;209;716;72;266;51;166;123;432
432147;201412;850;2684;680;2309;203;703;270;941;473;1644
432149;201412;384;1137;235;776;63;221;90;292;153;513
432150;201412;4299;12365;3244;10362;1020;3570;1036;3165;2056;6735
432160;201412;5107;16416;4532;15419;1541;5513;1808;6388;3349;11901
432162;201412;418;1023;100;323;21;77;28;76;49;153
432163;201412;407;1073;107;338;14;43;24;78;38;121
432166;201412;849;2547;694;2217;134;497;339;1007;473;1504
432170;201412;978;3184;639;2403;142;548;129;454;271;1002
432180;201412;3107;8224;2149;6569;633;2069;642;1922;1275;3991
432183;201412;477;1522;394;1348;173;613;95;324;268;937
432185;201412;1030;2821;648;2091;137;496;282;893;419;1389
432190;201412;3860;10643;2768;8198;786;2414;858;2393;1644;4807
432195;201412;1419;3961;1214;3641;204;657;771;2293;975;2950
432200;201412;3567;10842;2868;9586;767;2762;1365;4662;2132;7424
432210;201412;509;1458;403;1284;108;405;192;561;300;966
432215;201412;957;2965;823;2740;152;482;512;1802;664;2284
432218;201412;334;914;254;760;48;154;114;312;162;466
432220;201412;4295;11397;3532;10181;432;1467;2336;6603;2768;8070
432225;201412;68;222;57;201;25;89;15;52;40;141
432230;201412;1268;3576;858;2673;263;902;304;843;567;1745
432232;201412;618;1829;486;1567;126;454;214;671;340;1125
432234;201412;570;1571;410;1199;98;294;173;484;271;778
432235;201412;81;246;47;168;14;63;8;27;22;90
432237;201412;524;1457;474;1376;35;135;370;1043;405;1178
432240;201412;16577;54356;14383;51328;3047;12055;8609;31442;11656;43497
432250;201412;6006;20696;5536;19725;2252;8666;1646;5905;3898;14571
432252;201412;520;1510;425;1332;131;433;193;620;324;1053
432253;201412;1410;4519;996;3486;311;1129;297;1048;608;2177
432254;201412;769;2075;226;732;49;171;37;101;86;272
432255;201412;230;590;128;423;34;119;42;135;76;254
432260;201412;7925;20139;5465;15955;1349;4117;2364;7041;3713;11158
432270;201412;2960;9016;2540;8279;791;2648;1092;3645;1883;6293
432280;201412;1262;3510;635;2088;123;431;158;462;281;893
432285;201412;188;600;69;235;24;89;12;32;36;121
432290;201412;628;1892;415;1393;103;374;155;502;258;876
432300;201412;26262;79603;23559;74852;5785;19551;12912;40927;18697;60478
432310;201412;904;2715;742;2433;159;594;412;1314;571;1908
432320;201412;304;828;176;563;51;164;56;183;107;347
432330;201412;314;841;117;398;16;54;11;34;27;88
432335;201412;221;647;95;332;26;99;12;33;38;132
432340;201412;353;894;167;512;36;120;58;169;94;289
432345;201412;798;2249;738;2151;158;559;407;1090;565;1649
432350;201412;509;1405;311;1016;80;282;84;249;164;531
432360;201412;174;532;39;140;11;48;14;43;25;91
432370;201412;508;1435;397;1208;42;121;252;794;294;915
432375;201412;926;2352;727;2023;121;353;438;1232;559;1585
432377;201412;170;558;43;145;7;31;16;45;23;76
432380;201412;990;3410;893;3223;343;1393;356;1212;699;2605
500020;201412;2185;6672;1612;5549;406;1621;596;1901;1002;3522
500025;201412;1188;2907;771;2179;131;383;412;1145;543;1528
500060;201412;6873;20169;5469;17845;838;2784;3553;12055;4391;14839
500070;201412;4368;12884;3685;11694;896;3215;1675;5232;2571;8447
500080;201412;1815;5377;1368;4562;448;1638;456;1555;904;3193
500085;201412;2254;5982;1655;5068;219;748;1007;2981;1226;3729
500090;201412;2517;7277;1908;6163;427;1438;938;3110;1365;4548
500100;201412;2719;8189;2483;7810;777;2777;1156;3482;1933;6259
500110;201412;8529;25070;6948;22641;1160;4066;3981;13690;5141;17756
500124;201412;2019;6452;1710;5924;316;1072;998;3752;1314;4824
500150;201412;1600;4112;1205;3456;289;949;551;1425;840;2374
500190;201412;5600;14317;4285;12639;916;2907;2403;7433;3319;10340
500200;201412;2861;7293;2097;6093;383;1277;1207;3420;1590;4697
500210;201412;5196;15360;4425;14170;1000;3377;2316;7583;3316;10960
500215;201412;1663;5124;1336;4472;258;963;565;1809;823;2772
500220;201412;2940;9295;2399;8284;578;2147;929;3276;1507;5423
500230;201412;2832;7398;2174;6406;647;2053;910;2723;1557;4776
500240;201412;5218;16074;3758;13049;742;2767;1470;5397;2212;8164
500260;201412;2799;7403;2144;6329;394;1279;1045;2927;1439;4206
500270;201412;120503;313247;78594;240269;21989;72875;20559;62472;42548;135347
500280;201412;1487;4205;1261;3896;170;548;892;2831;1062;3379
500290;201412;4417;10922;2766;8274;801;2752;854;2319;1655;5071
500295;201412;2742;8330;1841;6110;429;1612;481;1377;910;2989
500310;201412;884;2365;755;2171;186;574;354;982;540;1556
500315;201412;3361;10514;2865;9770;549;1883;1828;6524;2377;8407
500320;201412;15666;51400;13302;47017;4277;15998;4960;18575;9237;34573
500325;201412;4437;11688;3331;9912;866;2817;1599;4646;2465;7463
500330;201412;6562;17869;5038;15033;1182;3823;2486;7318;3668;11141
500345;201412;2691;7607;2205;6811;515;1789;1163;3473;1678;5262
500348;201412;2656;7591;2358;7103;246;846;1758;5271;2004;6117
500350;201412;1285;3923;805;2810;144;544;251;892;395;1436
500370;201412;25069;77631;19381;66557;5066;19302;6588;22682;11654;41984
500375;201412;2935;8019;2124;6483;542;1796;858;2669;1400;4465
500380;201412;3172;9089;2665;8168;915;2897;925;2847;1840;5744
500390;201412;627;1348;410;1041;48;149;288;690;336;839
500400;201412;1455;4505;1115;3675;297;1080;348;1060;645;2140
500410;201412;2307;6471;1829;5746;477;1667;852;2656;1329;4323
500430;201412;2937;8461;2326;7579;554;1994;1042;3479;1596;5473
500440;201412;1509;4245;1174;3686;268;932;589;1804;857;2736
500450;201412;2255;6997;1768;6012;462;1758;373;1141;835;2899
500460;201412;3974;11806;3050;10213;936;3489;818;2686;1754;6175
500470;201412;3006;8937;2106;6946;608;2173;345;1032;953;3205
500480;201412;2079;6640;1924;6414;201;649;1539;5296;1740;5945
500490;201412;1151;3237;934;2854;303;1023;309;949;612;1972
500500;201412;3794;11788;3027;10591;1171;4619;930;3203;2101;7822
500510;201412;917;2418;579;1813;108;391;253;716;361;1107
500515;201412;2000;5256;1595;4706;269;763;953;3066;1222;3829
500520;201412;3034;10378;2706;9917;527;2050;1734;6558;2261;8608
500525;201412;1267;4048;1032;3583;233;858;511;1870;744;2728
500540;201412;5977;16982;3608;12280;1143;4467;673;2084;1816;6551
500560;201412;5139;16677;4606;15887;843;3111;3172;11046;4015;14157
500568;201412;4170;10706;3043;9049;703;2265;1504;4444;2207;6709
500570;201412;8381;22916;5766;18116;1804;6069;1807;5612;3611;11681
500580;201412;3692;10692;2947;9385;398;1391;2008;6392;2406;7783
500600;201412;3745;10268;2613;8164;675;2278;1032;3197;1707;5475
500620;201412;8564;23840;6180;19634;1352;4813;2980;9496;4332;14309
500625;201412;773;2328;474;1647;103;393;159;532;262;925
500627;201412;471;1360;359;1143;77;250;113;379;190;629
500630;201412;6491;18106;5107;15971;1668;5711;1697;5261;3365;10972
500635;201412;2648;10166;2207;9449;347;1373;1385;6510;1732;7883
500640;201412;1725;4213;1346;3667;130;396;994;2682;1124;3078
500660;201412;18926;54952;14960;48160;4208;15317;5923;18730;10131;34047
500690;201412;3117;8876;2528;8127;906;2987;965;3367;1871;6354
500710;201412;4032;12089;3465;11111;854;2993;1704;5445;2558;8438
500720;201412;6161;16724;4039;12885;1233;4298;1176;3629;2409;7927
500730;201412;1047;2979;789;2462;184;629;323;975;507;1604
500740;201412;3962;11110;3123;9553;590;2158;1396;4200;1986;6358
500750;201412;898;2597;819;2498;177;566;516;1618;693;2184
500755;201412;1298;3830;929;3060;231;859;331;985;562;1844
500769;201412;5071;13710;3205;9826;698;2380;875;2339;1573;4719
500770;201412;1856;5504;1393;4602;417;1518;457;1509;874;3027
500780;201412;1156;3557;978;3211;300;1074;390;1230;690;2304
500790;201412;9349;26324;7815;23599;1511;5327;4304;12458;5815;17785
500793;201412;2402;6958;1900;6120;379;1390;891;2719;1270;4109
500795;201412;2637;7662;2255;7126;305;833;1652;5580;1957;6413
500797;201412;1028;2743;741;2262;145;471;338;1036;483;1507
500800;201412;2843;7946;2230;7079;876;3146;727;2321;1603;5467
500830;201412;18115;52000;13105;41898;3736;12934;4133;12743;7869;25677
500840;201412;1530;4326;1092;3457;193;657;506;1556;699;2213
510010;201412;1377;4201;1204;3912;387;1289;544;1816;931;3105
510020;201412;3297;9563;2227;7387;600;2115;675;2144;1275;4259
510025;201412;9739;29031;8277;26443;2401;8423;3483;10738;5884;19161
510030;201412;2192;5940;1794;5294;531;1679;769;2201;1300;3880
510035;201412;930;2741;775;2497;151;495;450;1509;601;2004
510040;201412;1832;5101;1433;4499;314;1112;743;2325;1057;3437
510050;201412;1922;5639;1394;4634;379;1367;505;1650;884;3017
510060;201412;1449;4191;1084;3507;261;906;399;1258;660;2164
510080;201412;1158;3596;920;3148;290;1112;243;752;533;1864
510100;201412;694;1850;475;1413;74;242;206;573;280;815
510120;201412;313;655;180;482;20;56;115;307;135;363
510125;201412;3283;8710;2574;7475;507;1802;1200;3264;1707;5066
510130;201412;2216;6091;1870;5541;549;1703;778;2338;1327;4041
510140;201412;3093;9919;2466;8909;1007;4014;615;2041;1622;6055
510160;201412;1369;4599;1268;4464;123;492;1013;3561;1136;4053
510170;201412;6248;19064;5197;17156;1161;4271;2536;8104;3697;12375
510180;201412;12385;33226;8922;27579;2694;8743;3175;10740;5869;19483
510185;201412;1553;4526;1279;4162;218;674;841;3008;1059;3682
510190;201412;2169;6655;1529;5616;417;1694;606;2305;1023;3999
510250;201412;14896;46110;12750;42990;3814;13793;5975;20645;9789;34438
510260;201412;2601;10085;2321;9471;744;3228;972;4235;1716;7463
510263;201412;4662;12888;3436;10816;984;3336;1133;3459;2117;6795
510267;201412;5594;16200;4025;12820;976;3363;1318;4026;2294;7389
510268;201412;930;2743;798;2549;203;695;418;1341;621;2036
510269;201412;995;3041;776;2626;238;846;315;1083;553;1929
510270;201412;2636;8329;2335;7772;423;1484;1301;4446;1724;5930
510279;201412;2144;6761;1888;6270;603;2182;670;2052;1273;4234
510285;201412;1426;4259;1112;3678;294;1068;423;1328;717;2396
510300;201412;3450;10405;2974;9721;331;1189;2260;7448;2591;8637
510305;201412;1684;5316;1360;4679;410;1519;397;1342;807;2861
510310;201412;1124;3274;893;2887;309;1077;308;971;617;2048
510320;201412;3835;11225;2953;9500;883;3268;625;1812;1508;5080
510325;201412;5754;18095;4846;16816;997;3569;3272;11674;4269;15243
510330;201412;2988;9650;2488;8719;659;2553;965;3378;1624;5931
510335;201412;4946;15120;4144;14057;719;2397;2830;10139;3549;12536
510336;201412;628;1924;499;1663;126;460;233;758;359;1218
510337;201412;2315;7625;1959;6932;800;2857;562;2182;1362;5039
510340;201412;69301;200697;53917;176051;20880;74409;12245;41625;33125;116034
510343;201412;1177;3505;1049;3330;135;425;814;2659;949;3084
510345;201412;1724;5122;1419;4558;358;1245;519;1572;877;2817
510350;201412;3788;10620;2979;9492;799;2714;1424;4679;2223;7393
510360;201412;2009;5161;1411;4417;250;868;935;2864;1185;3732
510370;201412;1018;3591;909;3417;218;859;541;2074;759;2933
510380;201412;532;1656;385;1364;151;596;67;218;218;814
510385;201412;1053;3853;792;3212;149;630;372;1606;521;2236
510390;201412;1218;3721;1124;3613;296;829;687;2426;983;3255
510395;201412;918;2290;685;1976;121;368;361;1138;482;1506
510410;201412;4449;14482;4095;13803;1105;3961;2141;7301;3246;11262
510420;201412;2443;6382;1823;5319;269;948;978;2812;1247;3760
510450;201412;603;1659;443;1419;114;422;181;553;295;975
510452;201412;613;2010;435;1582;97;397;187;650;284;1047
510454;201412;922;2934;794;2727;152;539;498;1767;650;2306
510455;201412;1012;3099;762;2597;189;747;258;836;447;1583
510460;201412;2335;6418;1885;5770;297;1084;1190;3528;1487;4612
510480;201412;4582;12317;3273;9842;881;2803;883;2495;1764;5298
510490;201412;1512;4947;1351;4702;297;1199;814;2747;1111;3946
510500;201412;1581;4735;1084;3732;284;1129;466;1540;750;2669
510510;201412;3237;11410;2853;10749;1049;4228;1115;4186;2164;8414
510515;201412;6148;19047;4745;15889;1136;4234;1268;4007;2404;8241
510517;201412;1944;5764;1658;5296;526;1732;765;2524;1291;4256
510520;201412;2386;5874;1754;5021;130;440;1233;3588;1363;4028
510523;201412;1116;3369;957;3099;188;648;588;1924;776;2572
510525;201412;8302;21630;5550;17237;1363;4570;2124;6519;3487;11089
510530;201412;589;1664;499;1529;92;349;281;835;373;1184
510550;201412;2883;9431;2412;8584;728;2697;989;3584;1717;6281
510558;201412;2326;6567;1842;5870;489;1708;859;2760;1348;4468
510560;201412;1770;5714;1242;4759;400;1647;335;1314;735;2961
510562;201412;5538;16694;4659;14967;1534;5420;1545;5019;3079;10439
510590;201412;3238;8680;2596;7848;685;2146;1294;4044;1979;6190
510600;201412;1519;3939;993;3056;188;648;429;1210;617;1858
510610;201412;2943;8617;2565;8096;247;897;2021;6379;2268;7276
510615;201412;2258;6998;1910;6435;577;2083;893;3051;1470;5134
510617;201412;665;1979;557;1789;71;229;419;1396;490;1625
510618;201412;1462;4254;1035;3416;238;923;472;1482;710;2405
510619;201412;811;2228;506;1648;92;340;120;357;212;697
510620;201412;1433;3640;822;2692;257;978;192;570;449;1548
510621;201412;982;3425;862;3168;241;974;306;1061;547;2035
510622;201412;3896;11981;2656;9178;761;2871;420;1205;1181;4076
510623;201412;3945;11345;3232;10105;978;3254;1374;4223;2352;7477
510624;201412;1398;4253;1018;3498;246;947;363;1137;609;2084
510625;201412;2302;6773;1843;5947;553;1963;472;1447;1025;3410
510626;201412;1476;4400;1112;3861;360;1387;506;1775;866;3162
510627;201412;813;2360;552;1811;151;549;162;524;313;1073
510628;201412;1680;4236;1245;3647;143;461;903;2633;1046;3094
510629;201412;1842;5953;1517;5235;464;1778;515;1704;979;3482
510630;201412;2559;8630;2045;7612;618;2605;505;1878;1123;4483
510631;201412;416;1195;373;1127;63;188;258;784;321;972
510637;201412;2992;8772;2601;8109;725;2435;1285;3969;2010;6404
510642;201412;5065;16432;4303;15387;1309;5004;2089;7785;3398;12789
510645;201412;954;2207;630;1770;203;584;230;686;433;1270
510650;201412;6161;20908;5683;20316;1211;4478;3744;13989;4955;18467
510665;201412;1368;3749;932;2936;292;977;293;887;585;1864
510670;201412;421;948;220;661;41;151;91;254;132;405
510675;201412;7025;22440;5698;19802;1874;7316;1460;4817;3334;12133
510677;201412;2592;6590;1917;5711;297;889;1353;4206;1650;5095
510680;201412;858;2667;706;2373;168;617;265;827;433;1444
510682;201412;2488;7735;1949;6712;536;2037;572;1909;1108;3946
510685;201412;1016;2721;859;2511;104;341;621;1797;725;2138
510700;201412;4437;11686;3096;9722;683;2289;1737;5559;2420;7848
510704;201412;9409;25840;7739;23103;1846;6188;4037;11750;5883;17938
510706;201412;1995;6125;1492;5304;408;1484;736;2690;1144;4174
510710;201412;3722;10518;2753;8533;796;2648;785;2182;1581;4830
510715;201412;663;1694;417;1241;94;311;175;482;269;793
510718;201412;2034;5655;1606;5155;660;2171;610;2068;1270;4239
510719;201412;468;1070;287;831;39;155;126;330;165;485
510720;201412;1345;3165;1007;2772;133;373;725;2036;858;2409
510724;201412;869;2646;722;2372;176;655;365;1124;541;1779
510726;201412;698;1869;555;1636;137;424;214;599;351;1023
510729;201412;815;2128;553;1689;140;466;244;745;384;1211
510730;201412;2547;7859;2173;7168;579;2129;1006;3188;1585;5317
510735;201412;1148;3864;932;3503;244;993;476;1783;720;2776
510740;201412;1180;2907;864;2446;219;616;471;1385;690;2001
510757;201412;719;2451;625;2261;179;686;288;1042;467;1728
510760;201412;31262;85973;23350;72336;7828;26069;7566;23316;15394;49385
510770;201412;4797;12649;4222;11972;635;1737;2740;8716;3375;10453
510774;201412;454;1242;378;1119;85;294;176;531;261;825
510775;201412;858;2416;681;2137;242;824;241;748;483;1572
510776;201412;480;1356;398;1211;102;347;190;558;292;905
510777;201412;1662;4915;1241;4341;187;728;920;3232;1107;3960
510779;201412;728;2127;535;1767;103;371;234;780;337;1151
510780;201412;4117;12143;3469;11172;843;2808;1774;5977;2617;8785
510785;201412;2012;5897;1593;5184;544;1862;537;1769;1081;3631
510787;201412;2321;7128;1916;6422;729;2598;543;1774;1272;4372
510788;201412;497;1339;379;1157;152;457;117;395;269;852
510790;201412;16436;48136;10941;37387;3079;11975;1422;4667;4501;16642
510792;201412;6902;21397;4877;17292;1189;4852;1141;3696;2330;8548
510794;201412;1428;4399;1138;3934;473;1771;294;926;767;2697
510795;201412;10206;32071;7767;27186;2536;9592;2064;7302;4600;16894
510800;201412;1902;5418;1576;4966;458;1576;741;2231;1199;3807
510805;201412;2119;5891;1701;5285;194;639;1276;4007;1470;4646
510810;201412;723;1766;562;1546;158;467;274;719;432;1186
510820;201412;872;2134;631;1774;148;489;258;660;406;1149
510830;201412;615;2066;531;1926;163;621;269;1048;432;1669
510835;201412;748;2266;538;1847;168;624;186;586;354;1210
510840;201412;54657;136828;43453;122485;10628;31461;22924;66861;33552;98322
510850;201412;1735;5062;1348;4427;523;1929;261;711;784;2640
510860;201412;2657;8680;2011;7256;707;2810;296;983;1003;3793
510880;201412;868;2879;742;2649;249;946;305;1112;554;2058
510885;201412;604;1696;473;1507;82;306;221;698;303;1004
510890;201412;967;3149;814;2877;284;1144;259;803;543;1947
510895;201412;1201;3796;1031;3467;303;1163;424;1342;727;2505
520005;201412;1356;4382;1245;4204;398;1404;573;1963;971;3367
520010;201412;1975;6784;1723;6263;726;2940;389;1287;1115;4227
520013;201412;4088;11372;3058;9494;785;2575;1272;3962;2057;6537
520015;201412;578;1607;466;1439;123;404;187;598;310;1002
520017;201412;1131;3459;964;3183;269;993;411;1294;680;2287
520020;201412;432;1172;337;1019;83;261;165;514;248;775
520025;201412;25842;82133;24956;81086;2885;9809;20605;67337;23490;77146
520030;201412;4942;15788;4316;14765;1229;4513;1957;6782;3186;11295
520050;201412;378;1092;330;1007;62;207;216;647;278;854
520055;201412;872;2581;719;2283;154;479;360;1188;514;1667
520060;201412;1739;5321;1510;4873;363;1300;625;2027;988;3327
520080;201412;1724;5252;1493;4911;367;1188;819;2841;1186;4029
520082;201412;842;2607;774;2492;163;488;464;1581;627;2069
520085;201412;1077;3335;924;3023;237;821;327;1063;564;1884
520090;201412;1049;2485;793;2141;175;418;430;1248;605;1666
520110;201412;44714;131857;34695;116653;13620;50883;8772;29503;22392;80386
520120;201412;262;682;153;488;39;141;34;113;73;254
520130;201412;3949;11518;3632;11042;804;2595;2181;6645;2985;9240
520140;201412;45367;149510;39965;138923;14693;55335;10608;36446;25301;91781
520145;201412;556;1435;402;1197;98;316;155;459;253;775
520150;201412;680;1835;561;1692;153;497;297;888;450;1385
520160;201412;921;2701;780;2488;253;848;304;980;557;1828
520170;201412;4447;10571;3538;9564;524;1495;2633;7279;3157;8774
520180;201412;1971;5908;1637;5355;416;1548;684;2184;1100;3732
520215;201412;1951;5045;1629;4552;262;760;1017;2885;1279;3645
520235;201412;864;2309;667;2019;193;642;299;872;492;1514
520250;201412;1315;4122;1102;3766;335;1223;514;1790;849;3013
520260;201412;795;2060;555;1609;88;277;262;738;350;1015
520280;201412;588;1727;541;1659;268;871;145;491;413;1362
520310;201412;1148;2838;881;2463;219;590;432;1336;651;1926
520320;201412;1787;5665;1447;4987;180;663;922;3253;1102;3916
520330;201412;2940;9186;2250;7953;742;2882;462;1530;1204;4412
520340;201412;1984;5018;1557;4508;212;538;1182;3587;1394;4125
520350;201412;3348;9855;2832;8859;892;3058;1318;3968;2210;7026
520355;201412;1243;4211;1148;4059;414;1569;487;1695;901;3264
520357;201412;907;2473;760;2251;78;254;534;1567;612;1821
520360;201412;656;1877;581;1745;129;397;291;900;420;1297
520380;201412;1294;3538;890;2764;181;618;412;1270;593;1888
520390;201412;1269;3359;881;2810;298;1094;330;956;628;2050
520393;201412;605;1579;527;1458;87;250;347;964;434;1214
520396;201412;774;2467;665;2252;96;358;449;1544;545;1902
520400;201412;1850;5213;1583;4856;289;956;1015;3123;1304;4079
520410;201412;1682;4409;1295;3887;344;1113;683;2041;1027;3154
520420;201412;347;968;246;768;54;182;76;209;130;391
520425;201412;1532;4250;1386;3999;436;1351;670;1890;1106;3241
520430;201412;2212;5859;1498;4536;347;1190;561;1580;908;2770
520440;201412;3844;10131;2718;8196;955;3153;754;2263;1709;5416
520450;201412;10490;29806;7544;24208;2079;7346;1255;3691;3334;11037
520455;201412;719;2140;581;1910;215;767;176;578;391;1345
520460;201412;945;2704;750;2369;177;631;344;1045;521;1676
520465;201412;871;2385;758;2238;165;563;428;1212;593;1775
520470;201412;1873;6049;1696;5777;372;1261;1102;3931;1474;5192
520480;201412;1041;3028;842;2698;196;672;453;1439;649;2111
520485;201412;1372;4404;1182;4073;379;1400;609;2102;988;3502
520490;201412;4530;13966;3587;12496;1229;4556;1475;5261;2704;9817
520495;201412;1464;3891;1186;3544;105;315;998;3026;1103;3341
520500;201412;2089;5554;1837;5205;583;1732;816;2474;1399;4206
520505;201412;914;2600;790;2413;189;608;473;1466;662;2074
520510;201412;11633;32907;7953;26692;2532;9222;2168;7358;4700;16580
520520;201412;1119;3242;923;2952;328;1105;369;1201;697;2306
520530;201412;2401;7491;2047;6902;509;1682;998;3737;1507;5419
520540;201412;3424;10023;2739;8785;839;2839;954;3086;1793;5925
520545;201412;1385;4272;1180;3872;348;1234;367;1175;715;2409
520547;201412;863;2717;712;2461;285;1037;211;687;496;1724
520549;201412;10113;29734;8405;27582;2670;9198;4070;13592;6740;22790
520551;201412;3986;11963;3772;11699;1063;3502;2199;6988;3262;10490
520552;201412;783;2517;747;2469;121;450;521;1710;642;2160
520570;201412;567;1631;392;1319;162;578;88;289;250;867
520580;201412;2923;7907;2138;6725;747;2569;732;2247;1479;4816
520590;201412;1575;4439;1267;3925;333;1076;413;1226;746;2302
520620;201412;7370;23517;6659;22438;1460;5289;4060;13814;5520;19103
520630;201412;795;2147;615;1880;149;466;298;920;447;1386
520640;201412;2971;8580;2524;7834;815;2647;1040;3308;1855;5955
520650;201412;950;2635;762;2268;243;778;340;1006;583;1784
520660;201412;417;1270;354;1170;129;446;106;351;235;797
520670;201412;883;2691;821;2595;66;177;707;2286;773;2463
520680;201412;667;1938;558;1793;172;591;246;792;418;1383
520690;201412;389;994;267;813;52;138;130;429;182;567
520710;201412;511;1318;329;968;10;30;196;571;206;601
520725;201412;1896;4893;1465;4252;346;1096;810;2344;1156;3440
520735;201412;806;2344;604;1952;192;689;197;617;389;1306
520740;201412;1797;5196;1506;4796;389;1320;727;2299;1116;3619
520750;201412;763;2010;571;1741;144;464;307;970;451;1434
520753;201412;1350;3866;1262;3731;174;471;929;2893;1103;3364
520760;201412;1216;3336;1040;3104;269;834;627;1910;896;2744
520780;201412;2171;5318;1803;4824;223;548;1335;3657;1558;4205
520790;201412;2857;7723;2409;7088;362;1025;1700;5216;2062;6241
520800;201412;18454;53670;16249;51010;3787;11580;9740;33106;13527;44686
520810;201412;987;2678;877;2542;149;429;647;1952;796;2381
520815;201412;531;1734;394;1439;188;786;22;56;210;842
520830;201412;1749;4463;1364;4060;55;124;1230;3759;1285;3883
520840;201412;1857;6135;1606;5647;544;2056;491;1750;1035;3806
520850;201412;840;2468;648;2183;200;720;276;906;476;1626
520860;201412;7447;21036;5455;18251;1608;5803;2325;7985;3933;13788
520870;201412;112628;306338;76009;241460;22733;79247;20099;61366;42832;140613
520880;201412;7209;20444;5099;17090;1554;5846;825;2641;2379;8487
520890;201412;4164;11906;3501;10783;756;2463;1806;5584;2562;8047
520910;201412;3641;10875;2692;8931;861;3075;563;1793;1424;4868
520915;201412;946;2726;705;2257;157;537;289;891;446;1428
520920;201412;3580;9496;2459;7689;638;2155;783;2538;1421;4693
520929;201412;491;1396;424;1305;128;391;208;660;336;1051
520940;201412;1110;3229;937;2973;114;397;669;2112;783;2509
520945;201412;720;1762;586;1552;176;433;286;778;462;1211
520960;201412;923;2685;749;2403;138;450;420;1384;558;1834
520970;201412;3182;9440;2606;8383;612;2146;1038;3266;1650;5412
520980;201412;1023;2803;926;2664;276;892;519;1433;795;2325
520990;201412;2911;9645;2756;9412;541;1917;1790;6310;2331;8227
520993;201412;1228;3339;984;2935;131;434;638;1893;769;2327
520995;201412;2715;7449;2434;7077;375;1109;1739;5111;2114;6220
521000;201412;8337;25027;7021;22782;1862;6711;3037;9694;4899;16405
521010;201412;4126;12676;3436;11365;971;3419;1326;4446;2297;7865
521015;201412;750;2071;621;1865;142;405;344;1076;486;1481
521020;201412;3903;11123;2742;8714;849;2927;502;1386;1351;4313
521030;201412;828;2177;693;1967;170;508;365;1043;535;1551
521040;201412;6258;17590;5517;16464;1930;5824;2591;8212;4521;14036
521056;201412;1026;3123;856;2845;295;1024;359;1248;654;2272
521060;201412;1151;3239;1000;2995;277;783;434;1354;711;2137
521080;201412;1295;3174;825;2396;173;605;314;761;487;1366
521090;201412;3411;9891;2849;9126;997;3359;1113;3690;2110;7049
521100;201412;1589;3995;1391;3770;262;700;950;2674;1212;3374
521120;201412;5125;14400;4450;13395;1208;3698;2277;7054;3485;10752
521130;201412;1207;3361;943;2861;189;680;499;1483;688;2163
521140;201412;1033;3325;889;3019;300;1087;250;833;550;1920
521150;201412;13570;35463;8625;25715;3141;10062;2311;6756;5452;16818
521160;201412;883;2145;542;1519;109;337;262;694;371;1031
521170;201412;1439;3460;1176;3101;313;776;673;1810;986;2586
521180;201412;6771;22558;6108;21316;2278;8459;1908;6639;4186;15098
521190;201412;9759;28627;6912;23456;2237;8117;2029;6853;4266;14970
521200;201412;889;2341;792;2194;124;368;522;1439;646;1807
521205;201412;589;1747;462;1514;56;209;269;886;325;1095
521210;201412;951;2700;675;2152;243;893;243;678;486;1571
521220;201412;4052;11302;3311;10286;1079;3579;1382;4281;2461;7860
521225;201412;417;1035;327;924;50;148;214;629;264;777
521230;201412;1401;4418;1288;4177;449;1545;614;1943;1063;3488
521250;201412;28804;93701;26457;90077;10617;38347;9663;33672;20280;72019
521260;201412;833;2031;664;1734;113;368;388;950;501;1318
521270;201412;1891;5842;1727;5586;172;444;1331;4540;1503;4984
521280;201412;1913;5913;1594;5303;501;1796;583;1922;1084;3718
521290;201412;553;1588;407;1348;121;466;150;476;271;942
521295;201412;1214;3276;1082;3102;160;466;850;2468;1010;2934
521300;201412;1884;5527;1735;5296;370;1109;1089;3441;1459;4550
521305;201412;864;2346;709;2121;143;395;443;1404;586;1799
521308;201412;5375;15760;4111;13464;977;3388;1964;6417;2941;9805
521310;201412;8108;24453;6216;20761;1997;7072;1546;4927;3543;11999
521340;201412;275;823;250;786;42;152;162;492;204;644
521350;201412;2261;5843;1850;5275;274;785;1205;3666;1479;4451
521370;201412;1035;3320;918;3098;323;1174;306;985;629;2159
521375;201412;1430;4185;1212;3791;319;1087;599;1806;918;2893
521377;201412;1125;3063;1066;2994;110;256;900;2625;1010;2881
521380;201412;4828;13653;3439;11009;715;2525;706;2298;1421;4823
521385;201412;627;1747;554;1649;165;518;274;809;439;1327
521390;201412;1124;2942;830;2530;244;848;289;850;533;1698
521400;201412;2447;6600;2083;6171;335;1100;1544;4550;1879;5650
521405;201412;1452;4172;1168;3650;384;1320;508;1584;892;2904
521410;201412;848;2643;768;2508;297;944;318;1101;615;2045
521440;201412;1533;4231;1486;4173;126;325;1293;3724;1419;4049
521450;201412;5249;16005;4367;14364;1368;4797;1297;4172;2665;8969
521460;201412;7659;23108;6830;21759;1785;6156;3540;11146;5325;17302
521470;201412;765;2166;571;1787;158;563;112;326;270;889
521480;201412;526;1528;388;1274;117;391;122;396;239;787
521483;201412;3310;8619;2615;7442;772;2329;967;2665;1739;4994
521486;201412;1807;4833;1593;4503;250;774;1141;3193;1391;3967
521487;201412;637;1645;452;1356;94;265;204;656;298;921
521490;201412;876;2486;688;2207;81;317;490;1571;571;1888
521500;201412;1430;4536;1132;3884;236;927;473;1481;709;2408
521520;201412;921;2198;727;1920;217;533;347;980;564;1513
521523;201412;11867;44154;11043;42674;4207;17419;2020;8538;6227;25957
521525;201412;1167;3020;1020;2819;141;445;709;1902;850;2347
521530;201412;2149;6389;1446;4944;514;1855;294;949;808;2804
521540;201412;1000;2727;685;2170;175;662;217;634;392;1296
521550;201412;1012;2597;892;2410;248;725;465;1208;713;1933
521560;201412;5070;15523;4038;14113;1585;6005;1276;4442;2861;10447
521565;201412;710;1836;605;1704;108;291;416;1206;524;1497
521570;201412;4942;13836;3466;10893;1077;3545;1143;3631;2220;7176
521580;201412;699;1656;488;1365;171;519;158;441;329;960
521590;201412;766;2158;624;1925;227;730;134;436;361;1166
521600;201412;639;1666;455;1356;124;396;152;403;276;799
521630;201412;1872;4918;1480;4337;535;1796;278;672;813;2468
521640;201412;2192;5882;1804;5329;618;2031;659;1981;1277;4012
521645;201412;679;2027;551;1730;99;345;268;779;367;1124
521680;201412;1508;4810;1267;4302;678;2448;210;675;888;3123
521690;201412;602;1775;539;1655;133;475;264;753;397;1228
521710;201412;2494;7769;2130;6998;485;1685;1014;3336;1499;5021
521720;201412;2249;6455;1985;6084;492;1510;1231;3836;1723;5346
521730;201412;4104;13538;3697;12739;1550;5896;1005;3183;2555;9079
521740;201412;3898;10631;3060;9542;1224;3965;1303;4283;2527;8248
521760;201412;12822;43396;11708;41528;2599;10167;6541;23466;9140;33633
521770;201412;2926;8736;2442;7819;1005;3416;718;2197;1723;5613
521800;201412;9233;26858;7714;24495;2593;8721;3118;10247;5711;18968
521805;201412;1005;2315;776;1974;215;484;425;1203;640;1687
521810;201412;847;2434;716;2229;176;598;371;1133;547;1731
521830;201412;5569;18587;5163;17956;1115;4187;3282;11429;4397;15616
521839;201412;747;2120;571;1778;130;458;210;617;340;1075
521850;201412;6348;17528;5137;15331;1209;3753;2038;5779;3247;9532
521860;201412;1966;5756;1636;5129;416;1434;606;1848;1022;3282
521870;201412;564;1970;516;1842;170;662;148;486;318;1148
521878;201412;749;2250;544;1803;148;554;225;708;373;1262
521880;201412;27105;71384;18359;56852;6071;19984;5717;17956;11788;37940
521890;201412;3860;11855;3142;10415;1190;4242;781;2535;1971;6777
521900;201412;1717;4577;1372;4109;361;1161;557;1574;918;2735
521910;201412;1258;3468;1087;3264;266;828;617;1940;883;2768
521920;201412;416;1258;365;1172;123;434;140;421;263;855
521925;201412;685;2077;598;1907;126;449;256;746;382;1195
521930;201412;4080;13183;3654;12350;1269;4587;1045;3526;2314;8113
521935;201412;709;2081;638;1946;178;554;321;963;499;1517
521940;201412;1211;3305;990;2935;320;984;394;1177;714;2161
521945;201412;716;2389;662;2319;131;426;458;1716;589;2142
521950;201412;618;1793;495;1591;129;453;229;742;358;1195
521960;201412;940;2756;787;2490;193;671;367;1127;560;1798
521970;201412;2530;7246;2282;6919;348;1064;1666;5183;2014;6247
521971;201412;1111;2990;823;2444;181;574;292;832;473;1406
521973;201412;954;3093;818;2816;248;894;264;891;512;1785
521975;201412;14737;40970;13802;39826;2411;7336;9639;28004;12050;35340
521980;201412;1979;5914;1804;5705;300;860;1372;4555;1672;5415
521990;201412;1145;3443;1001;3220;154;551;644;2072;798;2623
522000;201412;2220;6489;1925;6085;395;1316;1149;3758;1544;5074
522005;201412;403;1020;281;820;81;230;101;295;182;525
522010;201412;3073;9052;2555;8159;957;3190;599;1902;1556;5092
522015;201412;1050;3063;852;2757;231;786;413;1360;644;2146
522020;201412;5276;14132;4491;13077;1021;3172;2710;7918;3731;11090
522026;201412;768;2178;563;1942;203;773;192;668;395;1441
522028;201412;555;1636;454;1411;89;288;282;863;371;1151
522040;201412;3286;8355;2472;7323;759;2362;1207;3610;1966;5972
522045;201412;14607;47564;12086;42281;3966;15301;2728;9273;6694;24574
522050;201412;1118;3236;884;2814;279;972;330;972;609;1944
522060;201412;2827;8574;2223;7609;648;2448;1050;3516;1698;5964
522068;201412;1638;5258;1525;5133;136;362;1264;4507;1400;4869
522070;201412;856;2566;764;2422;101;385;518;1634;619;2019
522100;201412;805;2256;715;2121;268;886;323;891;591;1777
522108;201412;976;2891;850;2699;88;294;633;2045;721;2339
522119;201412;1425;4291;1176;3951;241;837;666;2325;907;3162
522130;201412;524;1475;446;1383;136;439;235;740;371;1179
522140;201412;19194;53878;16235;49068;5121;16627;6284;18532;11405;35159
522145;201412;952;2661;876;2539;419;1291;280;795;699;2086
522150;201412;1280;3334;1049;2998;370;1117;375;1107;745;2224
522155;201412;896;2567;784;2407;174;521;481;1539;655;2060
522157;201412;729;2095;626;1938;71;241;487;1513;558;1754
522160;201412;6467;18165;4553;14772;1656;5997;659;1989;2315;7986
522170;201412;3189;8890;2613;7986;836;2589;930;2950;1766;5539
522180;201412;481;1360;359;1169;141;492;126;424;267;916
522185;201412;16173;48700;14073;45872;3361;11650;7931;26231;11292;37881
522190;201412;1033;2631;809;2265;144;417;449;1280;593;1697
522200;201412;1730;5722;1541;5326;530;1979;452;1488;982;3467
522205;201412;1353;3967;1123;3578;305;1035;522;1657;827;2692
522220;201412;1416;3858;1138;3510;283;891;565;1929;848;2820
522230;201412;1248;3699;1097;3456;158;560;741;2344;899;2904
530010;201412;265856;853998;236294;796104;72515;266313;85703;287324;158218;553637
110001;201411;4706;15260;4056;14222;1068;3873;2282;8141;3350;12014
110002;201411;14598;45548;12277;41359;3795;13837;5226;17553;9021;31390
110003;201411;1004;3241;912;3071;260;922;342;1121;602;2043
110004;201411;10412;33434;8651;29701;2946;10961;2342;7973;5288;18934
110005;201411;2437;8075;2253;7712;859;3031;907;3130;1766;6161
110006;201411;3454;9250;2158;7407;736;2658;643;2084;1379;4742
110007;201411;1608;4926;1477;4743;338;1194;771;2702;1109;3896
110008;201411;2686;9036;2513;8785;470;1544;1835;6729;2305;8273
110009;201411;5567;16011;4262;14021;1236;4452;1837;5871;3073;10323
110010;201411;8821;25251;7673;23813;1664;4786;4769;16050;6433;20836
110011;201411;11173;34054;9199;30624;3285;11484;3544;11806;6829;23290
110012;201411;17353;53434;14976;48870;5022;17142;5730;18780;10752;35922
110013;201411;5672;17634;4598;15964;1528;5582;1858;6566;3386;12148
110014;201411;4633;13478;3855;12334;780;2601;2403;7811;3183;10412
110015;201411;5717;17708;4401;15337;1508;5695;1474;5136;2982;10831
110018;201411;5461;15876;4384;14455;1364;5029;2013;6398;3377;11427
110020;201411;62596;179515;50538;163610;11087;37345;28922;96118;40009;133463
110025;201411;4738;13708;3873;12164;659;2196;2647;8305;3306;10501
110026;201411;863;2492;727;2326;199;645;431;1407;630;2052
110028;201411;8134;23713;5947;19890;1770;6490;1364;4415;3134;10905
110029;201411;1754;5099;1391;4486;427;1431;647;2119;1074;3550
110030;201411;12399;35010;9882;31590;2753;9456;4837;15889;7590;25345
110032;201411;4350;13976;3849;12860;1217;4247;1483;4894;2700;9141
110033;201411;5871;18689;5426;18011;1707;5518;2746;9763;4453;15281
110034;201411;4051;10529;3372;9699;581;1589;2531;7429;3112;9018
110037;201411;2190;7360;1889;6794;475;1757;1037;3776;1512;5533
110040;201411;3711;11890;3362;11264;1024;3723;1615;5318;2639;9041
110045;201411;5151;17245;4605;16587;1419;5487;2494;8948;3913;14435
110050;201411;1908;6040;1597;5607;513;1819;860;3098;1373;4917
110060;201411;1057;3574;930;3336;294;1135;406;1458;700;2593
110070;201411;2081;7075;2002;6901;437;1589;1278;4403;1715;5992
110080;201411;4050;12359;3786;12045;460;1308;3110;10244;3570;11552
110090;201411;979;2830;767;2493;223;836;348;1040;571;1876
110092;201411;1738;5618;1577;5408;335;1157;975;3517;1310;4674
110094;201411;3530;10859;3210;10402;846;2820;1858;6153;2704;8973
110100;201411;2732;8537;2328;7856;693;2475;1210;4081;1903;6556
110110;201411;1842;5858;1697;5681;730;2524;698;2401;1428;4925
110120;201411;1827;5927;1428;5025;461;1691;422;1494;883;3185
110130;201411;2876;8154;2117;6979;646;2233;885;2909;1531;5142
110140;201411;2745;9194;2471;8716;558;2047;1470;5279;2028;7326
110143;201411;1633;5146;1246;4473;312;1163;641;2296;953;3459
110145;201411;1077;3166;913;2904;195;674;558;1764;753;2438
110146;201411;488;1547;437;1467;99;340;252;861;351;1201
110147;201411;950;2793;728;2409;214;780;275;819;489;1599
110148;201411;1455;4325;1088;3556;329;1146;361;1133;690;2279
110149;201411;3962;11507;3073;10132;888;2979;1681;5690;2569;8669
110150;201411;2998;8673;2461;7889;317;1115;1660;5419;1977;6534
110155;201411;984;3184;919;3034;270;942;491;1599;761;2541
110160;201411;2251;6976;1813;6164;592;2073;826;2817;1418;4890
110170;201411;3273;9338;2481;7949;564;1927;1426;4539;1990;6466
110175;201411;1888;5716;1421;5109;217;844;901;3324;1118;4168
110180;201411;1742;5313;1467;4879;361;1245;856;2870;1217;4115
120001;201411;3097;10788;2947;10532;625;2384;1831;6641;2456;9025
120005;201411;1617;6500;1572;6420;170;647;1243;5277;1413;5924
120010;201411;4756;16633;4513;16213;827;2867;3139;11709;3966;14576
120013;201411;1937;7574;1879;7478;446;1746;1191;4994;1637;6740
120017;201411;2229;7901;2094;7646;583;2138;1010;4051;1593;6189
120020;201411;15045;65458;14604;64579;2442;10321;10595;49042;13037;59363
120025;201411;2914;10023;2822;9883;595;2218;1799;6393;2394;8611
120030;201411;6456;25278;6328;25121;450;1664;5528;22371;5978;24035
120032;201411;1433;6860;1372;6710;206;1165;991;4873;1197;6038
120033;201411;3702;14233;3666;14172;179;695;3331;13054;3510;13749
120034;201411;1918;7863;1861;7770;182;886;1567;6490;1749;7376
120035;201411;2913;13747;2876;13662;230;1072;2465;12006;2695;13078
120038;201411;3211;11652;3082;11384;830;3154;1739;6573;2569;9727
120039;201411;1555;8208;1524;8134;184;1039;1221;6599;1405;7638
120040;201411;49100;174966;44583;165753;12536;49226;21998;83589;34534;132815
120042;201411;2904;12464;2759;12124;407;1928;1984;8848;2391;10776
120043;201411;896;4258;862;4192;68;302;723;3647;791;3949
120045;201411;4736;16162;4667;16060;863;3028;3524;12283;4387;15311
120050;201411;8380;34431;8008;33613;1353;5481;5464;24193;6817;29674
120060;201411;7596;34108;7472;33870;668;3089;6283;29136;6951;32225
120070;201411;2934;10933;2859;10752;554;1990;1914;7508;2468;9498
120080;201411;3875;14564;3713;14297;574;2178;2790;11090;3364;13268
130002;201411;3034;12657;2856;12353;242;1126;2369;10371;2611;11497
130006;201411;1892;8021;1687;7629;284;1419;1154;5252;1438;6671
130008;201411;2081;8450;1988;8283;174;763;1618;6847;1792;7610
130010;201411;2911;9736;2556;9323;206;709;2208;8211;2414;8920
130014;201411;3588;11459;3088;10696;507;1890;2048;7172;2555;9062
130020;201411;2678;9481;2668;9469;33;107;2622;9334;2655;9441
130030;201411;7413;28330;7139;27979;716;2384;5943;24247;6659;26631
130040;201411;3740;11595;3380;11123;267;987;2882;9534;3149;10521
130050;201411;6208;24679;5514;23586;635;2649;4122;18603;4757;21252
130060;201411;5966;26705;5596;26127;596;2813;4465;21308;5061;24121
130063;201411;3523;15546;3474;15470;287;1205;3000;13695;3287;14900
130068;201411;3132;13157;2868;12627;419;2006;1959;8708;2378;10714
130070;201411;6929;22694;6260;21844;640;2212;5012;17950;5652;20162
130080;201411;5229;23178;5002;22829;947;4460;3361;15891;4308;20351
130083;201411;2191;8657;2068;8463;304;1444;1497;6122;1801;7566
130090;201411;2681;9574;2558;9409;167;689;2240;8275;2407;8964
130100;201411;5680;21234;5452;20929;332;1411;4816;18628;5148;20039
130110;201411;7070;22500;6602;21941;626;1892;5529;18974;6155;20866
130115;201411;4305;15331;4124;15094;96;300;3935;14512;4031;14812
130120;201411;14577;54814;13900;53912;1321;4576;11656;46845;12977;51421
130130;201411;3677;15410;3575;15233;378;1668;2916;12645;3294;14313
130140;201411;6437;24887;6349;24784;155;391;6142;24279;6297;24670
130150;201411;3513;13405;3438;13308;211;915;3055;11869;3266;12784
130160;201411;4060;16744;3959;16610;268;1020;3591;15282;3859;16302
130165;201411;2852;11770;2743;11578;364;1605;2179;9312;2543;10917
130170;201411;9538;34056;8353;32573;1173;4594;6304;25440;7477;30034
130180;201411;3483;11215;3399;11090;131;373;3141;10351;3272;10724
130185;201411;10515;34933;9705;33993;1091;3507;7895;28829;8986;32336
130190;201411;18519;63259;16316;60452;3213;11650;10779;42022;13992;53672
130195;201411;1905;7891;1845;7803;109;465;1637;7022;1746;7487
130200;201411;2047;7329;1890;7072;493;1836;1129;4370;1622;6206
130210;201411;1215;4784;1148;4670;137;599;922;3808;1059;4407
130220;201411;2060;8402;1875;8030;348;1675;1091;4726;1439;6401
130230;201411;3678;16413;3476;16079;408;1827;2644;12822;3052;14649
130240;201411;8663;32852;7993;31866;487;2172;6876;27828;7363;30000
130250;201411;19254;67676;18329;66437;2205;7401;14516;54859;16721;62260
130255;201411;4215;14789;3981;14412;151;473;3630;13405;3781;13878
130260;201411;267436;864253;240123;819702;68229;241110;122485;429654;190714;670764
130270;201411;7615;31110;6865;29932;1039;4498;4960;22610;5999;27108
130280;201411;3367;13231;3285;13114;168;516;2977;12242;3145;12758
130290;201411;11232;39687;10941;39321;215;487;10437;38226;10652;38713
130300;201411;4620;17636;4323;17195;388;1705;3528;14189;3916;15894
130310;201411;5353;19819;4895;19248;477;1802;3998;16178;4475;17980
130320;201411;3004;10438;2731;10069;354;1333;2006;7584;2360;8917
130330;201411;3789;13630;3404;13105;214;932;2910;11336;3124;12268
130340;201411;19170;71813;18115;70366;3686;13455;12180;50411;15866;63866
130350;201411;3342;13473;3203;13306;305;1339;2660;11256;2965;12595
130353;201411;6166;18912;5363;17824;1299;4216;3259;11602;4558;15818
130356;201411;4717;16914;4510;16595;467;1451;3698;14288;4165;15739
130360;201411;3115;8872;2760;8473;41;68;2628;8263;2669;8331
130370;201411;5210;20338;4475;19341;294;1520;3700;16112;3994;17632
130380;201411;7099;29812;6798;29378;507;2262;5832;25580;6339;27842
130390;201411;4942;21883;4611;21289;494;2419;3545;16788;4039;19207
130395;201411;2102;7555;1851;7016;266;1056;1226;4702;1492;5758
130400;201411;2135;8019;2063;7915;161;653;1804;6989;1965;7642
130406;201411;10094;38427;9018;36758;2098;8645;5521;23496;7619;32141
130410;201411;4167;15797;3809;15138;1160;4939;1702;6934;2862;11873
130420;201411;10347;43667;9953;42971;2894;12150;5921;26923;8815;39073
130423;201411;3264;12625;3081;12376;290;1342;2584;10405;2874;11747
130426;201411;2123;9101;2030;8933;339;1447;1463;6749;1802;8196
130430;201411;3727;13075;3521;12784;516;1936;2517;9360;3033;11296
130440;201411;4073;14176;3748;13813;249;781;3328;12629;3577;13410
140002;201411;1700;5392;1589;5249;179;575;1211;4111;1390;4686
140005;201411;3109;9060;2939;8877;105;235;2769;8484;2874;8719
140010;201411;48738;153795;42859;144244;10649;38366;22234;76406;32883;114772
140015;201411;2996;9656;2831;9435;368;988;2218;7775;2586;8763
140017;201411;3369;10402;3074;10032;301;870;2467;8361;2768;9231
140020;201411;4541;15406;4214;14971;401;1315;3454;12622;3855;13937
140023;201411;2194;7417;1966;7040;256;937;1421;5209;1677;6146
140028;201411;2255;6137;2193;6067;83;146;2039;5786;2122;5932
140030;201411;3833;12067;3658;11849;468;1189;3029;10261;3497;11450
140040;201411;1585;7468;1533;7324;144;761;1190;5787;1334;6548
140045;201411;2566;9320;2366;9020;474;1619;1551;6462;2025;8081
140047;201411;5651;15718;5071;14929;1479;4469;2585;8032;4064;12501
140050;201411;1547;4779;1412;4593;222;748;979;3255;1201;4003
140060;201411;1489;4633;1334;4377;279;945;858;2896;1137;3841
140070;201411;1515;7667;1477;7534;91;529;1294;6602;1385;7131
150010;201411;34491;109085;32830;106863;2282;7651;27906;92183;30188;99834
150013;201411;1712;5076;1593;4939;174;493;1273;4054;1447;4547
150020;201411;12541;42026;12163;41489;1014;3453;10446;36109;11460;39562
150030;201411;6777;28960;6573;28642;680;2488;5468;24921;6148;27409
150034;201411;4532;12416;4240;12045;262;678;3799;10939;4061;11617
150040;201411;12999;43432;11325;41368;2322;7851;7630;30001;9952;37852
150050;201411;6209;23639;6035;23329;591;2416;4937;19316;5528;21732
150060;201411;17833;57774;16729;56095;3283;10616;11466;39807;14749;50423
150070;201411;5949;24436;5356;23764;425;1983;4627;20810;5052;22793
150080;201411;67500;181071;58444;169137;9113;24734;40459;121655;49572;146389
150085;201411;5184;18143;4930;17774;586;1841;3989;14962;4575;16803
150090;201411;10266;39544;9681;38736;980;3880;7858;32123;8838;36003
150095;201411;5403;18348;4989;17720;449;1496;4065;14889;4514;16385
150100;201411;3602;13294;3364;12930;266;1217;2753;10534;3019;11751
150110;201411;3321;16117;3309;16086;189;821;3026;14936;3215;15757
150120;201411;6147;23814;5994;23535;787;3063;4727;18855;5514;21918
150125;201411;831;2537;768;2443;153;525;514;1617;667;2142
150130;201411;21955;67947;20562;65945;1964;6179;16451;53877;18415;60056
150140;201411;160009;470891;153726;462838;17761;52760;125326;382705;143087;435465
150145;201411;4947;15483;4574;15009;666;2244;3455;11510;4121;13754
150150;201411;10852;34868;10168;33769;1805;6229;7049;23688;8854;29917
150157;201411;3131;9534;2764;9010;388;1366;2045;6756;2433;8122
150160;201411;3013;9972;2825;9698;694;2346;1730;6178;2424;8524
150170;201411;22592;83521;21375;81782;3820;14584;15442;60035;19262;74619
150172;201411;3160;10970;2814;10420;424;1605;2088;7903;2512;9508
150175;201411;2121;6457;2024;6349;150;385;1748;5735;1898;6120
150178;201411;11060;33910;9328;31798;832;2659;7753;27101;8585;29760
150180;201411;18629;74833;17941;73869;1735;7498;14825;61930;16560;69428
150190;201411;7314;23531;6882;22929;424;988;5975;20751;6399;21739
150195;201411;5008;16939;4657;16358;372;1386;3913;13863;4285;15249
150200;201411;5284;17011;5085;16771;155;466;4724;15789;4879;16255
150210;201411;23549;90344;22925;89431;2146;7784;19128;77006;21274;84790
150215;201411;6563;21102;5815;19935;1574;5678;2938;10254;4512;15932
150220;201411;12825;40701;11587;38717;2653;9089;6403;21870;9056;30959
150230;201411;11379;38265;10208;36588;967;4114;8029;28686;8996;32800
150240;201411;35753;108046;31946;101563;10326;33896;13002;42999;23328;76895
150250;201411;4210;16876;4069;16663;567;2260;3120;13261;3687;15521
150260;201411;2162;8655;2059;8456;422;1781;1278;5421;1700;7202
150270;201411;9778;29510;7559;26725;1593;5977;4799;17305;6392;23282
150275;201411;6035;21960;5696;21418;805;3040;4241;16306;5046;19346
150276;201411;2175;6528;1985;6266;382;1292;1459;4607;1841;5899
150277;201411;5101;15930;4436;15112;615;2100;3310;11643;3925;13743
150280;201411;5999;26366;5805;25915;1079;4749;4002;18479;5081;23228
150285;201411;2674;10755;2583;10574;497;2109;1718;7261;2215;9370
150290;201411;9694;29177;9322;28741;819;2089;7944;25477;8763;27566
150293;201411;9447;27407;7562;24696;2415;8238;3113;10833;5528;19071
150295;201411;6638;20237;5579;18987;1074;3442;3831;13978;4905;17420
150300;201411;1845;6467;1773;6379;125;411;1473;5482;1598;5893
150304;201411;4232;13178;3646;12362;576;1956;2542;8905;3118;10861
150307;201411;6821;22917;6329;22211;494;1692;5238;18881;5732;20573
150309;201411;7069;24530;6495;23764;1566;5649;4210;16190;5776;21839
150310;201411;5683;25582;5526;25306;730;3334;4306;20235;5036;23569
150320;201411;9250;23141;8778;22641;597;1296;7754;20491;8351;21787
150330;201411;14030;49205;13170;47916;1616;5660;10217;38409;11833;44069
150340;201411;2448;8031;2266;7761;375;1344;1598;5549;1973;6893
150345;201411;6696;22870;6226;22224;658;2354;5051;18412;5709;20766
150350;201411;7641;24854;7253;24310;1046;3173;5457;18917;6503;22090
150360;201411;22478;70106;19416;66146;3197;10912;13463;47587;16660;58499
150370;201411;10473;38430;9934;37712;1352;4514;7953;31561;9305;36075
150375;201411;2885;12188;2812;12079;329;1228;2335;10471;2664;11699
150380;201411;9986;29552;8812;27953;823;2770;7231;23145;8054;25915
150390;201411;8398;35889;7962;35036;1631;6878;5156;23784;6787;30662
150400;201411;5695;22908;5454;22397;574;2325;4224;17805;4798;20130
150405;201411;8646;26359;7694;25173;1435;4186;5365;18781;6800;22967
150410;201411;1753;6714;1699;6612;290;1215;1119;4421;1409;5636
150420;201411;37342;128850;32533;120884;9356;36671;15129;58819;24485;95490
150430;201411;6780;24317;6479;23813;819;3110;4878;18269;5697;21379
150440;201411;5521;19275;5321;18978;981;3372;3806;14007;4787;17379
150442;201411;22160;64257;20119;61473;3683;11459;13167;41478;16850;52937
150445;201411;5368;18711;4917;18006;651;2303;3729;14035;4380;16338
150450;201411;4415;21083;4250;20837;399;1946;3545;17780;3944;19726
150460;201411;6989;25534;5873;24342;373;1671;5175;21853;5548;23524
150470;201411;18069;55309;17462;54561;971;2453;15910;50743;16881;53196
150475;201411;1578;5443;1466;5296;184;641;1174;4389;1358;5030
150480;201411;14384;49106;13710;48085;1265;4410;11307;40558;12572;44968
150490;201411;6813;26050;6644;25813;292;1148;6051;23755;6343;24903
150495;201411;4993;18338;4877;18166;201;729;4518;16983;4719;17712
150497;201411;3302;11640;2996;11103;925;3567;1554;5868;2479;9435
150500;201411;3135;8859;2947;8579;415;1216;2202;6424;2617;7640
150503;201411;4227;13201;3645;12465;1329;4613;1825;6533;3154;11146
150506;201411;12644;44496;11630;43040;2437;8378;7903;30989;10340;39367
150510;201411;10015;39256;9296;37963;1476;6114;6482;27523;7958;33637
150520;201411;6754;26206;6659;26075;249;779;6256;24861;6505;25640
150530;201411;12282;43022;11136;41242;1321;4776;8488;32220;9809;36996
150540;201411;4759;14660;4271;13960;341;1175;3546;11597;3887;12772
150543;201411;5552;17382;5005;16585;1099;3772;3263;11041;4362;14813
150548;201411;8904;28519;8340;27792;443;1312;7530;25519;7973;26831
150549;201411;2284;7226;2147;7065;103;230;1963;6644;2066;6874
150550;201411;21458;68641;19024;64426;5792;20226;8723;30226;14515;50452
150553;201411;19943;70388;17097;64175;6736;27049;4455;16792;11191;43841
150555;201411;1816;5558;1595;5246;197;693;1189;3941;1386;4634
150560;201411;2037;6560;1934;6338;278;933;1368;4486;1646;5419
150563;201411;2911;9564;2697;9187;641;2344;1550;5280;2191;7624
150565;201411;3631;12703;3335;12236;244;1043;2679;9953;2923;10996
150570;201411;5682;21146;5570;20955;434;1631;4690;18074;5124;19705
150580;201411;10063;41327;9857;41077;774;2666;8641;37273;9415;39939
150590;201411;5703;23022;5558;22848;116;354;5316;22118;5432;22472
150600;201411;8126;31072;7874;30693;527;1906;6915;27603;7442;29509
150610;201411;2410;8301;2207;7883;276;1106;1545;5450;1821;6556
150611;201411;2757;9814;2588;9463;257;1020;1982;7285;2239;8305
150613;201411;12584;38469;10789;35863;3609;12356;5045;17496;8654;29852
150616;201411;3160;9434;2467;8456;646;2404;1178;3925;1824;6329
150618;201411;7413;25732;7060;25075;2236;8131;3552;13054;5788;21185
150619;201411;5442;18578;5058;18014;661;2566;3715;13310;4376;15876
150620;201411;6506;23396;5884;22609;812;3077;4590;18256;5402;21333
150630;201411;5706;17452;5438;17128;406;1235;4671;15030;5077;16265
150635;201411;4609;15104;4317;14539;922;3168;2585;8953;3507;12121
150640;201411;1716;5339;1671;5281;201;595;1357;4486;1558;5081
150650;201411;12664;39042;11407;36772;3146;10418;5597;18523;8743;28941
150655;201411;5459;18100;5011;17424;625;2275;3842;13536;4467;15811
150658;201411;4419;14005;4028;13432;783;2985;2646;8806;3429;11791
150660;201411;5962;18736;5404;17960;1366;4424;3166;10983;4532;15407
150670;201411;6869;19405;5800;18070;1548;4890;3461;11299;5009;16189
150680;201411;55089;208779;50799;200869;16715;67004;23128;97596;39843;164600
150690;201411;1966;6225;1789;5927;339;1072;1157;3975;1496;5047
150700;201411;6145;18996;5651;18351;1104;3631;3799;12638;4903;16269
150710;201411;4362;14463;3916;13751;458;1617;3004;10735;3462;12352
150715;201411;5154;16607;4563;15713;606;2190;3444;12013;4050;14203
150720;201411;6698;27224;6297;26501;983;4124;4546;19893;5529;24017
150730;201411;9703;33296;9097;32451;1091;3684;7388;27039;8479;30723
150740;201411;3788;12055;3431;11422;515;1798;2253;7593;2768;9391
150745;201411;5923;18645;5438;17984;1171;4016;3611;12060;4782;16076
150746;201411;1451;4741;1374;4604;206;743;945;3186;1151;3929
150747;201411;5207;16740;4675;16038;520;1607;3568;12902;4088;14509
150750;201411;3090;10410;2965;10252;165;498;2694;9468;2859;9966
150760;201411;11662;37783;10974;36878;2451;8160;7062;24645;9513;32805
150770;201411;5809;22054;5558;21684;679;2508;4402;18086;5081;20594
150775;201411;1213;3762;1074;3511;226;885;626;1971;852;2856
150780;201411;3300;10813;3259;10768;85;202;3098;10378;3183;10580
150790;201411;5345;17075;4942;16556;499;1618;4068;14044;4567;15662
150795;201411;15967;49049;14251;46589;2809;8916;9340;31794;12149;40710
150796;201411;2978;9015;2778;8777;353;1077;2186;7130;2539;8207
150797;201411;3862;12985;3624;12620;190;699;3162;11119;3352;11818
150800;201411;14457;48282;13133;46647;2688;8864;9189;34352;11877;43216
150803;201411;7003;25249;6655;24744;875;3298;4933;18851;5808;22149
150805;201411;2858;9903;2638;9570;375;1303;1957;7312;2332;8615
150808;201411;6124;20799;5207;19075;2216;8663;1173;4378;3389;13041
150810;201411;20091;62492;16793;58462;2468;8097;12050;44397;14518;52494
150812;201411;5430;16896;4972;16191;504;2062;3725;11731;4229;13793
150815;201411;9206;29458;8256;28275;1020;3366;6594;23301;7614;26667
150820;201411;11196;32102;10089;30885;662;1352;8876;28215;9538;29567
150830;201411;13039;49185;11992;47497;672;2881;10052;41074;10724;43955
150835;201411;2144;7788;1986;7424;539;2128;939;3536;1478;5664
150840;201411;8108;23338;6451;20979;1541;5483;3479;11166;5020;16649
160005;201411;771;2844;722;2759;99;452;506;1895;605;2347
160010;201411;1567;5222;1556;5210;117;283;1396;4820;1513;5103
160015;201411;1839;6729;1798;6658;186;595;1476;5704;1662;6299
160020;201411;2326;7701;2165;7478;292;1030;1604;5701;1896;6731
160021;201411;940;4036;919;4000;183;865;640;2826;823;3691
160023;201411;1063;4215;1046;4188;71;254;931;3797;1002;4051
160025;201411;1543;4261;1508;4223;17;50;1477;4137;1494;4187
160027;201411;8498;25802;7900;25142;2776;8402;4206;14429;6982;22831
160030;201411;46850;167824;42359;158990;9896;37075;25806;100380;35702;137455
160040;201411;4315;16786;4225;16650;148;664;3949;15575;4097;16239
160050;201411;3720;13837;3366;13314;1452;5681;1435;6058;2887;11739
160053;201411;2821;10943;2757;10844;619;2450;1869;7548;2488;9998
160055;201411;757;2902;744;2888;113;475;566;2213;679;2688
160060;201411;17916;60470;16932;59365;3747;12458;11708;42863;15455;55321
160070;201411;2422;9537;2360;9438;139;557;2103;8537;2242;9094
160080;201411;2771;10184;2755;10158;89;274;2624;9778;2713;10052
170025;201411;580;1941;524;1854;174;634;257;947;431;1581
170030;201411;1197;3935;1073;3705;330;1150;484;1715;814;2865
170035;201411;1591;4695;1307;4163;444;1489;449;1481;893;2970
170040;201411;1914;6288;1682;5951;291;1189;1135;4032;1426;5221
170070;201411;2115;5694;1703;5168;471;1544;888;2722;1359;4266
170100;201411;2593;7377;2283;6859;271;880;1763;5327;2034;6207
170105;201411;772;2442;624;2131;133;533;314;1027;447;1560
170110;201411;1200;3734;1047;3476;248;891;540;1777;788;2668
170130;201411;1472;4564;1267;4258;294;1009;714;2505;1008;3514
170190;201411;1706;4908;1343;4344;551;1719;338;1254;889;2973
170200;201411;1677;4973;1221;4104;360;1334;389;1268;749;2602
170210;201411;31731;95443;26660;86658;8863;30753;9208;31143;18071;61896
170215;201411;1208;3801;1066;3582;122;430;813;2764;935;3194
170220;201411;6684;22229;6066;21148;1270;4714;3534;12546;4804;17260
170230;201411;1565;5050;1345;4644;320;1280;656;2166;976;3446
170240;201411;3062;8740;2437;7882;352;1287;1671;5411;2023;6698
170255;201411;3751;11874;3094;10786;925;3307;1372;5034;2297;8341
170270;201411;1068;2738;757;2298;108;374;505;1502;613;1876
170290;201411;3063;9116;2703;8683;194;509;2315;7745;2509;8254
170300;201411;2139;6588;1791;6006;294;1049;1139;3865;1433;4914
170305;201411;811;2505;665;2231;119;427;382;1298;501;1725
170307;201411;1119;3916;957;3605;201;820;505;1981;706;2801
170310;201411;1740;4794;1377;4210;323;964;713;2319;1036;3283
170320;201411;1109;3229;832;2723;208;729;387;1308;595;2037
170330;201411;867;2642;736;2477;128;470;510;1687;638;2157
170360;201411;468;1573;412;1478;107;413;178;611;285;1024
170370;201411;1471;4252;1171;3775;281;981;548;1772;829;2753
170380;201411;2110;6631;1704;6007;347;1409;925;3216;1272;4625
170382;201411;559;1864;480;1733;122;503;269;948;391;1451
170384;201411;1631;6662;1525;6470;389;1736;902;3896;1291;5632
170386;201411;948;2823;818;2639;212;758;427;1391;639;2149
170388;201411;659;1980;559;1810;117;460;235;739;352;1199
170389;201411;956;3159;868;3021;115;477;617;2110;732;2587
170390;201411;1380;4031;1179;3778;162;558;866;2840;1028;3398
170410;201411;509;1666;458;1565;60;256;307;1023;367;1279
170460;201411;536;1474;387;1216;107;368;131;405;238;773
170510;201411;825;2773;661;2480;110;482;348;1294;458;1776
170550;201411;6296;18790;4866;16180;1811;6617;1087;3576;2898;10193
170555;201411;1412;4106;1122;3658;267;926;604;1995;871;2921
170560;201411;1008;3401;803;3131;173;711;476;1935;649;2646
170600;201411;1397;3906;1211;3666;247;719;801;2531;1048;3250
170610;201411;1676;5057;1303;4468;162;627;817;2854;979;3481
170625;201411;435;1358;335;1157;67;250;102;354;169;604
170650;201411;1286;4114;1120;3821;280;1030;531;1852;811;2882
170700;201411;4163;13671;3474;12512;802;3162;1716;6424;2518;9586
170710;201411;1924;5651;1551;5006;264;900;952;3115;1216;4015
170720;201411;1892;5058;1602;4617;305;824;1112;3326;1417;4150
170730;201411;1124;3205;925;2912;260;905;444;1406;704;2311
170740;201411;2300;8116;2031;7632;306;1255;1404;5326;1710;6581
170755;201411;906;2815;758;2494;195;689;289;925;484;1614
170765;201411;1624;4360;1299;3836;346;1084;579;1745;925;2829
170770;201411;1876;6364;1731;6094;342;1260;1069;3836;1411;5096
170820;201411;4254;13561;3838;12900;1051;3714;1760;6062;2811;9776
170825;201411;840;2490;640;2102;147;535;268;862;415;1397
170830;201411;1432;4242;1274;4001;40;82;1154;3680;1194;3762
170900;201411;2964;10226;2802;9924;325;1152;2129;7776;2454;8928
170930;201411;4441;13393;3613;12101;1265;4492;1268;4223;2533;8715
170950;201411;13634;39322;10024;32940;3572;13143;2281;7240;5853;20383
170980;201411;516;1523;397;1319;92;358;202;632;294;990
171050;201411;1414;4918;1309;4714;81;347;1117;4016;1198;4363
171070;201411;1757;5423;1610;5211;351;1161;991;3305;1342;4466
171090;201411;998;2845;839;2602;94;308;614;1903;708;2211
171110;201411;668;1938;521;1695;133;470;286;918;419;1388
171150;201411;890;2596;644;2137;130;476;366;1227;496;1703
171180;201411;668;2050;489;1678;133;477;206;747;339;1224
171190;201411;1926;6942;1656;6387;403;1627;791;3184;1194;4811
171195;201411;889;3115;781;2910;138;552;412;1592;550;2144
171200;201411;719;2299;587;2049;140;545;281;931;421;1476
171215;201411;495;1454;376;1233;79;290;162;539;241;829
171240;201411;799;2736;739;2624;87;342;535;1935;622;2277
171245;201411;676;2232;558;1950;136;540;222;733;358;1273
171250;201411;1178;3400;972;3057;91;324;726;2259;817;2583
171270;201411;449;1819;415;1754;116;453;204;948;320;1401
171280;201411;954;2932;824;2720;194;654;434;1547;628;2201
171320;201411;4250;12838;3593;11799;1055;3606;1809;5995;2864;9601
171330;201411;2970;8821;2523;8132;646;2235;1329;4298;1975;6533
171360;201411;1595;5047;1341;4666;241;863;847;3013;1088;3876
171370;201411;799;2244;702;2093;147;490;373;1103;520;1593
171380;201411;1352;4452;1151;4060;429;1544;423;1526;852;3070
171395;201411;904;2740;724;2410;147;591;361;1171;508;1762
171420;201411;2301;6985;1828;6138;447;1595;821;2790;1268;4385
171430;201411;1072;3317;905;3047;206;699;518;1762;724;2461
171488;201411;2604;7868;2343;7506;600;1936;1307;4375;1907;6311
171500;201411;918;2810;794;2580;127;411;480;1591;607;2002
171510;201411;1001;3458;896;3292;140;534;587;2228;727;2762
171515;201411;624;1767;474;1538;90;305;247;800;337;1105
171525;201411;621;2050;520;1864;107;439;290;1018;397;1457
171550;201411;347;1150;284;1023;103;394;48;186;151;580
171570;201411;1334;4091;1160;3787;187;635;817;2690;1004;3325
171575;201411;2118;5987;1621;5064;362;1143;755;2458;1117;3601
171610;201411;6531;21958;5818;20622;1939;7292;2028;7150;3967;14442
171620;201411;2578;7687;2272;7248;162;588;1884;6034;2046;6622
171630;201411;927;3000;760;2707;228;885;294;1028;522;1913
171650;201411;2561;7916;2044;6949;543;1990;853;2867;1396;4857
171660;201411;2649;7274;2075;6259;349;1122;1220;3721;1569;4843
171665;201411;1455;4335;1206;3939;190;676;775;2629;965;3305
171670;201411;2393;6491;1897;5760;485;1601;946;2786;1431;4387
171700;201411;1203;3879;1039;3573;162;624;663;2274;825;2898
171720;201411;760;2284;650;2080;226;756;262;852;488;1608
171750;201411;1354;4355;1159;3952;385;1363;433;1475;818;2838
171780;201411;1298;3526;936;3018;124;450;556;1822;680;2272
171790;201411;1751;5601;1447;5164;255;903;910;3414;1165;4317
171800;201411;735;2330;660;2221;102;365;453;1556;555;1921
171820;201411;10632;31852;9361;30214;2009;6953;5684;18572;7693;25525
171830;201411;1642;5963;1490;5635;417;1657;685;2598;1102;4255
171840;201411;848;2413;746;2272;69;214;577;1781;646;1995
171845;201411;829;2239;644;1927;105;340;375;1113;480;1453
171850;201411;1029;3646;912;3399;130;568;568;2099;698;2667
171855;201411;1299;4101;1168;3883;114;478;886;2868;1000;3346
171865;201411;500;1587;418;1465;109;431;207;708;316;1139
171870;201411;715;2206;581;1969;134;492;259;923;393;1415
171875;201411;1438;4477;1208;4129;178;699;857;2906;1035;3605
171880;201411;980;3527;958;3487;121;460;719;2699;840;3159
171884;201411;1002;2818;722;2391;155;605;250;902;405;1507
171886;201411;1567;5185;1325;4657;450;1692;430;1526;880;3218
171888;201411;732;2244;595;1983;90;313;353;1219;443;1532
171889;201411;506;1642;478;1588;91;292;304;1043;395;1335
171890;201411;1214;3856;1059;3633;158;609;692;2373;850;2982
171900;201411;515;1936;456;1805;139;557;218;880;357;1437
172000;201411;671;2152;557;1962;90;362;321;1119;411;1481
172010;201411;1230;4251;1153;4127;125;506;888;3195;1013;3701
172015;201411;366;1381;305;1280;61;262;173;763;234;1025
172020;201411;2470;8069;2218;7692;310;1129;1574;5563;1884;6692
172025;201411;780;2228;603;1923;90;325;333;1047;423;1372
172030;201411;1144;3854;1027;3641;130;548;720;2541;850;3089
172049;201411;1321;3560;1036;3048;129;382;792;2380;921;2762
172065;201411;1375;3866;1140;3577;105;364;957;3015;1062;3379
172080;201411;2677;8203;2252;7474;276;1076;1547;5058;1823;6134
172085;201411;540;1469;408;1221;94;303;146;421;240;724
172090;201411;3574;10567;2742;9390;597;2132;1563;5543;2160;7675
172093;201411;593;1872;464;1640;124;548;235;791;359;1339
172097;201411;727;2110;589;1889;158;549;232;742;390;1291
172100;201411;30611;99724;25486;89553;8568;33068;7062;24605;15630;57673
172110;201411;1735;6356;1565;6095;193;791;1166;4670;1359;5461
172120;201411;5704;17088;4679;15745;534;1821;3477;11995;4011;13816
172125;201411;333;1005;265;897;62;232;122;416;184;648
172130;201411;550;1552;450;1391;61;208;301;964;362;1172
172208;201411;2258;6881;2102;6630;411;1410;1207;3847;1618;5257
172210;201411;2502;7777;2271;7407;472;1676;1379;4428;1851;6104
210005;201411;23356;73863;20177;68865;6096;22254;9280;31988;15376;54242
210010;201411;1664;5894;1466;5587;152;597;1126;4380;1278;4977
210015;201411;3550;10992;3229;10511;265;604;2714;9311;2979;9915
210020;201411;7703;18828;7176;18177;453;1242;5967;15291;6420;16533
210030;201411;5966;19782;5628;19314;478;1996;4620;15764;5098;17760
210040;201411;2071;5767;1857;5518;163;498;1498;4481;1661;4979
210043;201411;6551;19095;5767;18080;566;1707;4481;14579;5047;16286
210047;201411;6961;26739;6428;25812;897;3860;4534;18465;5431;22325
210050;201411;2557;9012;2035;8214;680;2834;834;3525;1514;6359
210055;201411;1762;6017;1623;5808;203;737;1210;4392;1413;5129
210060;201411;7987;29576;7179;28272;771;3361;5327;21460;6098;24821
210070;201411;7238;21397;6750;20797;299;976;5987;18602;6286;19578
210080;201411;3827;13126;3728;12998;78;303;3531;12355;3609;12658
210083;201411;4366;14995;4103;14708;119;344;3872;14093;3991;14437
210087;201411;2801;8502;2595;8250;168;555;2251;7230;2419;7785
210090;201411;10499;33910;10032;33161;452;1725;8802;29172;9254;30897
210095;201411;6446;23831;6239;23516;606;2323;5111;19648;5717;21971
210100;201411;7726;23007;7237;22426;336;1203;6439;19957;6775;21160
210110;201411;3288;11314;3178;11173;227;834;2692;9647;2919;10481
210120;201411;27066;76271;23006;71392;2810;8344;17443;56113;20253;64457
210125;201411;3644;11641;3484;11466;256;704;3068;10341;3324;11045
210130;201411;4396;13047;4173;12736;359;1126;3453;10584;3812;11710
210135;201411;1701;4987;1497;4690;128;399;1228;3916;1356;4315
210140;201411;18719;58854;15737;54854;3058;10764;10195;36944;13253;47708
210150;201411;4794;12052;4353;11505;118;307;4011;10601;4129;10908
210160;201411;19447;62148;18077;60125;2160;6615;14293;49216;16453;55831
210170;201411;14598;52549;14308;52165;1022;3400;12605;46930;13627;50330
210173;201411;1881;7914;1826;7807;114;553;1599;6879;1713;7432
210177;201411;3103;9812;2928;9597;280;1028;2423;7889;2703;8917
210180;201411;1581;4815;1483;4676;96;336;1256;3967;1352;4303
210190;201411;5271;16886;4901;16245;388;1695;3720;12063;4108;13758
210193;201411;1474;4699;1343;4475;99;371;1098;3703;1197;4074
210197;201411;2033;6771;1874;6595;195;605;1540;5641;1735;6246
210200;201411;9504;31487;8723;30363;1167;3776;6498;23643;7665;27419
210203;201411;6709;21933;6293;21398;459;1350;5524;19176;5983;20526
210207;201411;3133;10347;2937;9990;397;1276;2146;7529;2543;8805
210210;201411;9064;30445;8680;29925;284;998;7722;27190;8006;28188
210215;201411;1668;6574;1612;6477;173;734;1306;5300;1479;6034
210220;201411;6466;24592;6173;24118;529;2107;5019;20084;5548;22191
210230;201411;5454;18281;5062;17664;404;1478;4158;14668;4562;16146
210232;201411;12288;41373;10654;39354;1761;6537;7425;29061;9186;35598
210235;201411;3708;11397;3316;10908;255;893;2813;9348;3068;10241
210237;201411;2529;9371;2490;9319;50;138;2383;9029;2433;9167
210240;201411;3115;9792;2952;9561;222;696;2455;8076;2677;8772
210250;201411;4960;15947;4722;15648;128;519;4428;14677;4556;15196
210255;201411;2819;9042;2564;8601;520;1835;1604;5456;2124;7291
210260;201411;5367;17066;4875;16315;678;2227;3607;12387;4285;14614
210270;201411;5466;15577;4858;14726;152;529;4327;13221;4479;13750
210275;201411;3689;9231;3448;8970;110;229;3274;8619;3384;8848
210280;201411;6211;18042;5298;16874;422;1426;4336;13963;4758;15389
210290;201411;5890;19039;5402;18426;454;1465;4507;15782;4961;17247
210300;201411;39092;113648;32181;104942;2894;9873;25408;85341;28302;95214
210310;201411;2915;8386;2747;8146;132;353;2419;7235;2551;7588
210312;201411;2223;7167;2162;7069;116;452;1936;6334;2052;6786
210315;201411;2502;8687;2379;8512;139;562;2058;7409;2197;7971
210317;201411;4406;13183;4209;12933;271;793;3730;11632;4001;12425
210320;201411;19947;62925;18618;61317;1105;3514;16325;54813;17430;58327
210325;201411;3766;11745;3350;11118;410;1459;2494;8332;2904;9791
210330;201411;37759;91683;29623;83062;3912;8566;21602;67803;25514;76369
210340;201411;12213;37456;11136;36110;1499;4015;8234;28692;9733;32707
210350;201411;10811;33461;9955;32248;854;2713;8041;26628;8895;29341
210355;201411;4068;14499;3678;13975;173;466;3320;13077;3493;13543
210360;201411;17565;53147;16253;51272;1406;4650;12966;41482;14372;46132
210370;201411;9322;23202;8081;21870;292;622;7330;20339;7622;20961
210375;201411;3326;10093;2834;9489;688;2364;1728;5941;2416;8305
210380;201411;6558;18611;5849;17614;552;1504;4789;14807;5341;16311
210390;201411;2851;10031;2611;9626;136;630;2262;8355;2398;8985
210400;201411;5179;16187;4974;15941;305;907;4412;14371;4717;15278
210405;201411;9208;25235;7406;22783;2249;6839;3410;11588;5659;18427
210407;201411;2150;7536;1893;7127;216;778;1453;5695;1669;6473
210408;201411;2329;9083;2192;8923;96;359;1960;8293;2056;8652
210409;201411;4017;14526;3800;14186;294;1152;3076;11760;3370;12912
210410;201411;3660;11797;3418;11499;302;845;2933;10197;3235;11042
210420;201411;4323;14201;4002;13647;338;1158;3264;11344;3602;12502
210430;201411;2236;6845;2164;6757;135;443;1889;5934;2024;6377
210440;201411;4387;13577;4257;13389;246;730;3796;12107;4042;12837
210450;201411;2985;9402;2689;8964;205;768;2197;7320;2402;8088
210455;201411;4389;12895;3775;11986;667;2155;2578;8385;3245;10540
210460;201411;4134;13220;3844;12820;225;834;3286;11066;3511;11900
210462;201411;1825;6484;1713;6268;171;682;1322;4909;1493;5591
210465;201411;2780;9028;2594;8789;287;807;2110;7459;2397;8266
210467;201411;6516;21292;6090;20769;479;1390;5128;18143;5607;19533
210470;201411;2074;5748;1613;5073;105;343;1280;4083;1385;4426
210480;201411;14446;47724;12687;45343;3518;12410;7085;27079;10603;39489
210490;201411;3640;10671;3332;10221;280;910;2708;8313;2988;9223
210500;201411;6911;27079;6610;26555;772;2943;5109;21350;5881;24293
210510;201411;7078;23380;6771;23006;428;1079;5827;20719;6255;21798
210515;201411;3474;11507;3350;11352;141;407;3097;10658;3238;11065
210520;201411;2900;8926;2652;8577;212;662;2198;7274;2410;7936
210530;201411;43002;137605;36017;126936;10406;39762;17630;63759;28036;103521
210535;201411;3336;11646;3206;11446;171;613;2799;10118;2970;10731
210540;201411;13780;46581;12232;44126;2998;10516;6753;26366;9751;36882
210542;201411;6516;18777;5693;17876;346;874;4999;16169;5345;17043
210545;201411;2311;7609;2192;7405;92;431;1897;6369;1989;6800
210547;201411;3999;13879;3709;13422;318;1085;2976;11052;3294;12137
210550;201411;6549;18351;5687;17397;300;670;5175;16294;5475;16964
210560;201411;4336;13618;3866;12844;276;1029;3210;10652;3486;11681
210565;201411;1576;5425;1354;5090;133;596;1015;3839;1148;4435
210570;201411;13101;37221;11862;35789;1028;2538;9892;30994;10920;33532
210580;201411;3251;9832;2873;9354;379;1013;2180;7710;2559;8723
210590;201411;4500;13817;4197;13459;278;878;3655;11917;3933;12795
210592;201411;2621;8256;2518;8090;114;418;2214;7110;2328;7528
210594;201411;2850;8069;2339;7346;154;429;1934;6249;2088;6678
210596;201411;2931;10780;2752;10447;300;1196;2090;8072;2390;9268
210598;201411;2006;6211;1868;6039;115;443;1651;5303;1766;5746
210600;201411;3453;10123;3105;9643;302;1000;2434;7564;2736;8564
210610;201411;2787;8864;2495;8508;203;783;2109;7194;2312;7977
210620;201411;1939;5993;1780;5790;49;141;1633;5386;1682;5527
210630;201411;3605;12915;3138;12031;459;1799;2038;8064;2497;9863
210632;201411;4884;16721;4463;16131;432;1605;3618;13257;4050;14862
210635;201411;1958;6921;1869;6786;82;289;1669;6164;1751;6453
210637;201411;2883;9636;2701;9375;165;579;2308;8148;2473;8727
210640;201411;4363;15003;4286;14916;17;46;4183;14671;4200;14717
210650;201411;7079;21539;6934;21366;133;365;6678;20723;6811;21088
210660;201411;7934;24284;7385;23460;261;758;6826;21797;7087;22555
210663;201411;2710;7968;2558;7769;171;565;2185;6683;2356;7248
210667;201411;1780;6311;1697;6181;89;366;1480;5438;1569;5804
210670;201411;4874;17925;4701;17633;434;1664;3725;14368;4159;16032
210675;201411;4973;13966;4637;13544;372;996;3920;11709;4292;12705
210680;201411;4672;12992;4135;12369;241;680;3575;10852;3816;11532
210690;201411;7319;24365;6891;23904;285;886;6273;22229;6558;23115
210700;201411;2748;7908;2429;7542;507;1305;1634;5742;2141;7047
210710;201411;4977;16203;4745;15825;198;760;4181;13988;4379;14748
210720;201411;2601;9428;2449;9203;153;674;2143;8008;2296;8682
210725;201411;1195;4371;1024;4052;170;732;591;2360;761;3092
210730;201411;1277;3907;1117;3719;109;311;927;3172;1036;3483
210735;201411;4029;14505;3724;13965;605;2308;2627;10156;3232;12464
210740;201411;5353;15130;4991;14765;237;632;4636;13901;4873;14533
210745;201411;3926;11807;3664;11449;299;790;3079;9788;3378;10578
210750;201411;20930;57655;18842;55257;2079;5977;15086;45223;17165;51200
210760;201411;6158;16911;5779;16499;85;251;5605;16036;5690;16287
210770;201411;6485;17461;5463;16296;222;709;4925;14758;5147;15467
210780;201411;8896;29417;8168;28099;1001;3633;5834;20437;6835;24070
210790;201411;4815;14743;4148;13986;324;832;3506;12378;3830;13210
210800;201411;5242;14650;4731;14078;197;614;4069;12564;4266;13178
210805;201411;3810;16041;3687;15819;195;819;3183;13998;3378;14817
210810;201411;5965;17747;5378;17069;399;795;4694;15631;5093;16426
210820;201411;9281;26654;8601;25688;1593;4667;5833;17967;7426;22634
210825;201411;5667;19076;5433;18778;313;982;4791;16901;5104;17883
210830;201411;8846;26849;8433;26377;509;1293;7432;23930;7941;25223
210840;201411;3886;10701;3507;10130;272;711;2821;8206;3093;8917
210845;201411;6007;18620;5779;18366;255;648;5205;17016;5460;17664
210850;201411;6434;23144;5932;22269;849;3548;4237;16014;5086;19562
210860;201411;17949;54618;16514;52685;1582;5214;13135;42445;14717;47659
210870;201411;6852;22182;6108;21246;702;2331;4691;16830;5393;19161
210880;201411;4462;14331;4330;14137;226;718;3865;12783;4091;13501
210890;201411;5587;16631;5206;16161;472;1585;4258;13333;4730;14918
210900;201411;5199;16306;4554;15253;1562;5328;1878;6711;3440;12039
210905;201411;1870;5852;1738;5671;134;354;1459;4919;1593;5273
210910;201411;10774;33757;9991;32502;1870;6498;6621;21761;8491;28259
210920;201411;3379;11403;3257;11224;193;637;2805;9868;2998;10505
210923;201411;1573;5704;1480;5563;221;842;1047;4129;1268;4971
210927;201411;4815;15098;4644;14923;35;110;4566;14715;4601;14825
210930;201411;2700;9732;2575;9566;205;917;2142;7957;2347;8874
210940;201411;2978;11633;2916;11507;299;1121;2384;9591;2683;10712
210945;201411;6082;17971;5850;17733;235;286;5553;17325;5788;17611
210950;201411;5905;17875;5112;16694;613;2075;3782;12565;4395;14640
210955;201411;2002;6578;1770;6216;308;1106;1184;4308;1492;5414
210960;201411;9534;31283;9113;30668;2448;8018;5516;19682;7964;27700
210970;201411;1403;5051;1237;4802;174;804;895;3471;1069;4275
210975;201411;1805;6117;1720;5963;152;561;1373;4820;1525;5381
210980;201411;10088;24202;9803;23884;691;1380;8702;21666;9393;23046
210990;201411;17626;51189;14066;46797;3006;10303;8625;29675;11631;39978
211000;201411;17059;53944;15246;51720;1026;3426;13078;45408;14104;48834
211003;201411;5200;18194;4737;17493;513;2001;3549;13495;4062;15496
211010;201411;6867;23835;6639;23569;139;469;6201;22341;6340;22810
211020;201411;7571;23683;7345;23322;277;776;6760;21611;7037;22387
211023;201411;2524;8388;2436;8232;165;573;2045;7054;2210;7627
211027;201411;3141;11997;3020;11805;319;1126;2378;9728;2697;10854
211030;201411;4399;13283;3948;12772;747;1901;2929;10153;3676;12054
211040;201411;4439;16716;4302;16502;158;657;3798;14855;3956;15512
211050;201411;10731;28326;10543;28117;421;1017;9872;26520;10293;27537
211060;201411;6312;22296;6148;22038;580;1957;5129;18808;5709;20765
211065;201411;1820;6174;1657;5965;52;172;1557;5681;1609;5853
211070;201411;8932;30122;8286;29012;753;2632;6634;23727;7387;26359
211080;201411;1406;4257;1153;3902;106;508;908;2973;1014;3481
211085;201411;2118;7021;1819;6592;292;1026;1285;4818;1577;5844
211090;201411;3725;11313;3490;10991;195;737;2993;9355;3188;10092
211100;201411;6989;18212;6813;18004;92;331;6502;17135;6594;17466
211102;201411;3189;11734;3032;11518;284;1017;2554;9948;2838;10965
211105;201411;2919;9255;2551;8743;218;832;2074;7106;2292;7938
211107;201411;4641;14497;4218;13935;266;820;3602;12218;3868;13038
211110;201411;6793;20233;5364;18176;976;3173;3476;12415;4452;15588
211120;201411;34278;94807;30235;89795;4586;12853;21947;67805;26533;80658
211125;201411;2259;7231;2040;6892;150;547;1695;5766;1845;6313
211130;201411;154405;449957;143896;436486;28707;86579;97443;303189;126150;389768
211140;201411;5700;18099;5353;17557;294;1050;4590;15082;4884;16132
211150;201411;10375;30791;9657;29898;672;2158;8267;25856;8939;28014
211153;201411;3209;9542;2942;9234;429;1126;2319;7660;2748;8786
211157;201411;1282;4168;1092;3873;135;564;744;2744;879;3308
211160;201411;4351;14622;3710;13547;414;1832;2667;9650;3081;11482
211163;201411;1765;5837;1671;5709;76;243;1494;5215;1570;5458
211167;201411;1552;5197;1447;5028;43;162;1322;4618;1365;4780
211170;201411;6846;18067;6577;17741;170;523;6083;16389;6253;16912
211172;201411;2463;7186;2165;6745;158;606;1799;5501;1957;6107
211174;201411;2950;8594;2684;8262;123;461;2364;7245;2487;7706
211176;201411;5703;16569;4781;15496;601;1741;3631;12327;4232;14068
211178;201411;3628;10377;3545;10285;87;201;3393;9931;3480;10132
211180;201411;4627;16133;4318;15664;409;1599;3457;12761;3866;14360
211190;201411;2988;9862;2708;9469;121;516;2339;8256;2460;8772
211195;201411;1513;4728;1289;4454;106;330;1056;3784;1162;4114
211200;201411;2253;7739;2005;7394;275;935;1484;5776;1759;6711
211210;201411;7140;21793;6871;21421;427;1328;5955;18779;6382;20107
211220;201411;37345;110247;32581;104017;6919;22725;20708;67978;27627;90703
211223;201411;6146;17625;5650;16834;840;2549;3783;11847;4623;14396
211227;201411;1653;6043;1540;5875;138;619;1223;4690;1361;5309
211230;201411;9251;30745;8435;29360;1198;4229;6037;21480;7235;25709
211240;201411;8529;28857;8171;28423;324;1155;7496;26255;7820;27410
211245;201411;5641;16279;5572;16194;171;396;5259;15475;5430;15871
211250;201411;12498;43891;11845;43136;1329;3519;9781;37861;11110;41380
211260;201411;8577;26789;8368;26506;584;1831;7396;23604;7980;25435
211270;201411;10405;36570;9697;35636;689;2779;7978;29870;8667;32649
211280;201411;12767;37731;12090;36906;1039;2514;10384;32863;11423;35377
211285;201411;2009;7023;1723;6494;405;1627;848;3359;1253;4986
211290;201411;7846;25776;7598;25461;840;2465;6201;21452;7041;23917
211300;201411;9165;27724;8346;26547;525;1758;7161;22927;7686;24685
211400;201411;13036;37526;10745;34922;2511;7898;6185;22674;8696;30572
220005;201411;1769;5183;1647;4989;68;288;1408;4136;1476;4424
220010;201411;1790;4663;1331;4069;108;409;1045;3125;1153;3534
220020;201411;3821;11709;3595;11322;594;2007;2443;7661;3037;9668
220025;201411;2236;5521;2004;5171;49;149;1769;4521;1818;4670
220027;201411;1433;3877;1319;3732;91;233;1110;3188;1201;3421
220030;201411;3516;10080;3430;9943;253;840;2915;8411;3168;9251
220040;201411;8823;27152;8323;26337;1719;5665;5186;16465;6905;22130
220045;201411;1513;4789;1364;4536;131;507;995;3253;1126;3760
220050;201411;4898;14291;4287;13384;364;1331;3386;10456;3750;11787
220060;201411;2151;5588;2046;5464;91;235;1862;4989;1953;5224
220070;201411;2696;7816;2409;7396;198;640;1884;5820;2082;6460
220080;201411;848;2627;802;2550;111;439;577;1765;688;2204
220090;201411;1931;4964;1660;4595;131;446;1372;3709;1503;4155
220095;201411;728;1985;686;1924;30;99;639;1777;669;1876
220100;201411;1430;4295;1208;3924;127;439;898;2956;1025;3395
220105;201411;2180;7133;1973;6729;164;586;1476;5052;1640;5638
220110;201411;3688;10626;3259;9991;223;828;2697;8125;2920;8953
220115;201411;2388;8574;2296;8427;240;967;1888;6926;2128;7893
220117;201411;1457;3866;1186;3469;119;365;915;2678;1034;3043
220120;201411;13219;37703;12233;36461;401;1462;11204;33368;11605;34830
220130;201411;896;3164;796;3034;62;202;695;2711;757;2913
220140;201411;1707;4545;1539;4333;230;468;1240;3687;1470;4155
220150;201411;7378;23123;7008;22622;406;1490;6070;19604;6476;21094
220155;201411;1104;3437;919;3093;80;338;635;2080;715;2418
220157;201411;1108;2808;1002;2654;43;114;857;2263;900;2377
220160;201411;2936;8764;2626;8229;197;745;2031;6306;2228;7051
220170;201411;1398;4386;1246;4134;104;422;996;3280;1100;3702
220173;201411;2145;6467;1762;5738;78;360;1430;4591;1508;4951
220177;201411;1771;5209;1739;5158;67;205;1623;4820;1690;5025
220180;201411;1202;3233;1059;3008;53;189;807;2234;860;2423
220190;201411;4668;15197;4091;14464;472;1625;3238;11662;3710;13287
220191;201411;1506;5073;1436;4948;209;718;1057;3678;1266;4396
220192;201411;1802;5143;1426;4476;155;525;997;3113;1152;3638
220194;201411;1768;5212;1600;4931;158;556;1207;3630;1365;4186
220196;201411;2109;6287;1967;6045;220;746;1489;4581;1709;5327
220198;201411;1356;3802;1072;3433;19;67;998;3225;1017;3292
220200;201411;4752;16143;4444;15681;751;2761;3122;11118;3873;13879
220202;201411;2140;6686;1934;6318;67;270;1699;5513;1766;5783
220205;201411;3034;7907;2675;7433;98;364;2349;6438;2447;6802
220207;201411;930;2866;810;2653;91;341;606;1971;697;2312
220208;201411;1805;6040;1634;5744;240;956;1146;3998;1386;4954
220209;201411;1633;5006;1470;4733;84;329;1138;3666;1222;3995
220210;201411;1960;5119;1696;4765;90;307;1355;3809;1445;4116
220211;201411;1714;5000;1625;4883;111;466;1359;4013;1470;4479
220213;201411;1890;5438;1743;5167;102;368;1383;4031;1485;4399
220217;201411;1906;6186;1827;6087;64;171;1687;5705;1751;5876
220220;201411;12096;34374;11051;32754;1358;3737;7898;24107;9256;27844
220225;201411;1057;3190;944;3032;48;199;809;2558;857;2757
220230;201411;6261;16347;5178;14895;223;623;4584;13271;4807;13894
220240;201411;2825;8957;2644;8644;211;768;2070;6741;2281;7509
220245;201411;1546;4147;1388;3925;73;216;1190;3416;1263;3632
220250;201411;3424;9371;3072;8896;72;191;2814;8253;2886;8444
220253;201411;1896;5582;1611;5086;142;513;1182;3776;1324;4289
220255;201411;1834;5162;1602;4772;94;367;1317;3817;1411;4184
220260;201411;5304;16911;4719;15810;470;1667;3498;11772;3968;13439
220265;201411;1311;4656;1217;4501;109;471;889;3295;998;3766
220270;201411;7088;22944;6871;22571;428;1909;5860;18800;6288;20709
220271;201411;1570;4421;1466;4269;74;198;1276;3775;1350;3973
220272;201411;1837;5618;1687;5373;105;427;1332;4200;1437;4627
220273;201411;1326;3799;1153;3522;120;397;876;2650;996;3047
220275;201411;2178;5744;1832;5299;90;285;1594;4607;1684;4892
220277;201411;2674;7225;2261;6605;155;500;1777;5223;1932;5723
220280;201411;1804;4743;1557;4368;135;493;1170;3188;1305;3681
220285;201411;1752;4668;1540;4367;100;316;1262;3658;1362;3974
220290;201411;6815;22022;5708;20572;606;2376;4335;15793;4941;18169
220300;201411;2003;6499;1755;6164;91;404;1484;5206;1575;5610
220310;201411;2683;8667;2240;8136;91;279;2024;7592;2115;7871
220320;201411;3501;10253;2905;9241;347;1203;2108;6698;2455;7901
220323;201411;1511;5419;1333;5164;143;627;1008;3938;1151;4565
220325;201411;1302;4127;1179;3879;166;594;787;2661;953;3255
220327;201411;1402;4485;1267;4253;65;319;1019;3369;1084;3688
220330;201411;3923;10890;3677;10566;252;743;3126;9097;3378;9840
220335;201411;2178;6260;1956;5992;102;350;1687;5219;1789;5569
220340;201411;1920;5376;1658;5000;139;469;1278;3811;1417;4280
220342;201411;1247;4048;1181;3942;121;461;868;3042;989;3503
220345;201411;3129;8164;2649;7406;75;216;2340;6528;2415;6744
220350;201411;4578;12153;4022;11403;342;1075;3149;8923;3491;9998
220360;201411;1520;4111;1203;3620;117;409;881;2626;998;3035
220370;201411;9451;27181;8584;26040;450;1347;7664;23345;8114;24692
220375;201411;1613;5057;1490;4894;71;257;1346;4426;1417;4683
220380;201411;1493;3989;1266;3675;83;279;1005;2896;1088;3175
220385;201411;803;2135;661;1896;32;114;550;1540;582;1654
220390;201411;10353;32303;9347;30351;2606;8843;3765;12299;6371;21142
220400;201411;1535;3618;1291;3255;45;155;1111;2709;1156;2864
220410;201411;1407;4006;1183;3688;109;437;921;2794;1030;3231
220415;201411;911;2454;818;2331;81;224;617;1765;698;1989
220420;201411;2352;6805;2077;6255;142;430;1688;5103;1830;5533
220430;201411;3023;8679;2870;8470;358;1079;2241;6618;2599;7697
220435;201411;1694;4974;1556;4757;84;258;1293;3966;1377;4224
220440;201411;2825;8534;2338;7966;132;436;2064;7058;2196;7494
220450;201411;2778;8169;2375;7602;546;1859;1433;4580;1979;6439
220455;201411;1420;4386;1270;4182;49;156;1152;3843;1201;3999
220460;201411;1122;2996;1019;2866;68;211;886;2467;954;2678
220465;201411;2563;8448;2338;8114;575;2119;1401;4914;1976;7033
220470;201411;4191;12498;3773;11789;270;956;2888;8916;3158;9872
220480;201411;2523;7372;2282;7025;194;609;1827;5643;2021;6252
220490;201411;2540;7244;2357;7015;136;492;2011;5955;2147;6447
220500;201411;3502;9340;2911;8316;156;625;2371;6598;2527;7223
220510;201411;2997;8357;2208;7108;106;458;1689;5375;1795;5833
220515;201411;2040;5068;1796;4763;95;255;1510;4024;1605;4279
220520;201411;5356;14812;4955;14247;205;569;4393;12749;4598;13318
220525;201411;1494;4214;1385;4055;106;383;1121;3213;1227;3596
220527;201411;1519;4700;1366;4370;158;519;1012;3292;1170;3811
220530;201411;1264;3697;1145;3512;89;344;961;2867;1050;3211
220535;201411;874;2697;844;2655;81;280;674;2115;755;2395
220540;201411;3763;12343;3615;12110;281;1070;2998;10031;3279;11101
220545;201411;1466;5011;1406;4911;188;751;1019;3514;1207;4265
220550;201411;9700;31439;9112;30443;1359;4802;6413;21503;7772;26305
220551;201411;1489;4989;1378;4799;113;492;1085;3733;1198;4225
220552;201411;1724;5365;1472;4923;122;549;1092;3534;1214;4083
220553;201411;1683;4961;1380;4490;69;267;1135;3694;1204;3961
220554;201411;940;2603;811;2426;97;296;608;1845;705;2141
220555;201411;2540;7363;2371;7150;92;304;2051;6270;2143;6574
220556;201411;1555;4857;1400;4560;107;426;1055;3410;1162;3836
220557;201411;1689;5531;1527;5216;211;790;999;3419;1210;4209
220558;201411;1095;3422;1002;3258;95;384;761;2428;856;2812
220559;201411;1610;4533;1462;4301;76;262;1237;3633;1313;3895
220560;201411;1796;4437;1482;4016;90;253;1242;3346;1332;3599
220570;201411;7779;24673;7242;23861;1273;4159;4998;16881;6271;21040
220580;201411;6791;21933;6621;21730;389;1214;5979;19865;6368;21079
220585;201411;2017;7334;1928;7173;139;554;1609;6014;1748;6568
220590;201411;1511;4632;1360;4410;257;859;890;2945;1147;3804
220595;201411;2580;7402;2368;7119;87;304;2117;6377;2204;6681
220600;201411;1385;3411;1159;3138;194;410;812;2322;1006;2732
220605;201411;2133;6228;1868;5813;110;354;1497;4670;1607;5024
220610;201411;2839;8735;2745;8601;163;632;2346;7293;2509;7925
220620;201411;8142;27419;7831;26961;419;1672;6857;23655;7276;25327
220630;201411;430;1315;366;1195;61;226;211;681;272;907
220635;201411;1913;6753;1759;6415;175;775;1149;4193;1324;4968
220640;201411;2937;8507;2750;8240;243;819;2208;6595;2451;7414
220650;201411;2535;7131;2256;6693;151;505;1824;5380;1975;5885
220660;201411;2833;8725;2288;8014;253;1092;1835;6278;2088;7370
220665;201411;1251;4259;1187;4160;48;198;1075;3757;1123;3955
220667;201411;1834;6143;1734;6009;85;324;1488;5174;1573;5498
220669;201411;1964;6364;1827;6108;286;1109;1239;4100;1525;5209
220670;201411;2232;6699;2060;6482;162;401;1771;5774;1933;6175
220672;201411;2501;7127;2380;6976;246;693;1987;5916;2233;6609
220675;201411;1401;4087;1306;3927;125;355;989;3005;1114;3360
220680;201411;2310;7490;2200;7338;212;707;1785;6060;1997;6767
220690;201411;1813;5081;1603;4743;124;420;1269;3736;1393;4156
220695;201411;949;2768;881;2654;62;228;684;2026;746;2254
220700;201411;9383;26971;8474;25607;796;2652;6500;19613;7296;22265
220710;201411;795;2381;681;2185;59;183;497;1616;556;1799
220720;201411;2213;5905;2092;5741;96;222;1853;5154;1949;5376
220730;201411;1423;3957;1215;3636;47;180;1022;3030;1069;3210
220735;201411;1125;2867;916;2510;63;208;701;1916;764;2124
220740;201411;1461;4628;1222;4309;158;548;945;3428;1103;3976
220750;201411;4146;12023;3880;11618;482;1258;3001;9315;3483;10573
220755;201411;1245;3575;1155;3425;75;230;954;2829;1029;3059
220760;201411;2781;9595;2572;9302;135;567;2224;8103;2359;8670
220770;201411;25009;83504;22584;78659;7591;27510;8797;31718;16388;59228
220775;201411;1292;3234;1257;3195;20;34;1222;3127;1242;3161
220777;201411;1669;4680;1518;4452;104;292;1240;3623;1344;3915
220779;201411;1279;3661;1240;3605;62;217;1114;3204;1176;3421
220780;201411;6519;16945;5824;15990;455;1208;4779;13274;5234;14482
220785;201411;1368;3663;1322;3571;65;169;1209;3266;1274;3435
220790;201411;9991;31769;9490;30892;1029;3565;7392;23983;8421;27548
220793;201411;952;2699;873;2571;61;204;718;2109;779;2313
220795;201411;1575;4381;1521;4300;110;337;1310;3708;1420;4045
220800;201411;18250;50836;16695;48572;1852;6193;12496;35829;14348;42022
220810;201411;3460;10104;2993;9279;201;782;2393;7331;2594;8113
220820;201411;5835;15982;5320;15303;316;980;4599;13279;4915;14259
220830;201411;7891;22415;7461;21717;843;2468;5767;16963;6610;19431
220840;201411;15507;49337;13972;46242;3678;12391;6639;22595;10317;34986
220850;201411;2960;10372;2822;10176;219;848;2413;8759;2632;9607
220855;201411;643;1986;564;1839;48;186;415;1332;463;1518
220860;201411;982;2682;890;2535;54;207;721;2008;775;2215
220865;201411;2745;7571;2217;6699;116;541;1792;5243;1908;5784
220870;201411;2524;8238;2208;7843;111;419;1966;7008;2077;7427
220880;201411;5624;14600;5122;13987;257;791;4530;12383;4787;13174
220885;201411;1377;4851;1209;4556;125;572;894;3368;1019;3940
220887;201411;1444;3681;1256;3422;43;148;1143;3105;1186;3253
220890;201411;1708;5915;1513;5582;139;486;1205;4604;1344;5090
220900;201411;2036;5851;1801;5374;119;348;1469;4419;1588;4767
220910;201411;1773;5223;1553;4895;82;267;1340;4277;1422;4544
220915;201411;1081;3117;939;2857;55;231;730;2160;785;2391
220920;201411;1405;5132;1302;4975;144;640;952;3617;1096;4257
220930;201411;1548;4951;1376;4724;94;379;1131;3903;1225;4282
220935;201411;1095;3338;974;3093;72;306;698;2118;770;2424
220937;201411;1632;4456;1370;3990;81;293;1075;3044;1156;3337
220940;201411;1492;4588;1375;4337;108;406;1051;3295;1159;3701
220945;201411;509;1799;466;1684;61;250;322;1161;383;1411
220950;201411;1309;3314;942;2684;41;160;724;1998;765;2158
220955;201411;1651;4549;1386;4125;107;336;1072;3185;1179;3521
220960;201411;926;2503;769;2231;45;169;601;1716;646;1885
220965;201411;1762;5234;1661;5089;79;328;1423;4305;1502;4633
220970;201411;2204;5883;1624;4921;166;512;1132;3456;1298;3968
220975;201411;669;2304;658;2287;50;185;590;2047;640;2232
220980;201411;1527;4542;1357;4236;152;534;901;2903;1053;3437
220985;201411;1381;3988;1308;3878;134;448;1004;2955;1138;3403
220987;201411;1550;4939;1424;4720;109;477;1084;3498;1193;3975
220990;201411;1888;5441;1637;5011;72;296;1277;3843;1349;4139
220995;201411;1284;3810;1010;3391;88;361;762;2573;850;2934
220997;201411;2216;7001;2113;6838;103;361;1927;6240;2030;6601
221000;201411;4594;14112;4250;13532;500;1818;3117;9812;3617;11630
221005;201411;1471;4670;1364;4464;458;1390;672;2340;1130;3730
221010;201411;1275;3423;1098;3189;73;210;918;2682;991;2892
221020;201411;1960;6052;1824;5804;125;537;1369;4287;1494;4824
221030;201411;1846;5138;1589;4759;116;472;1239;3653;1355;4125
221035;201411;1619;4358;1455;4159;89;227;1283;3730;1372;3957
221037;201411;643;1960;577;1841;34;153;454;1387;488;1540
221038;201411;657;1843;520;1609;40;130;348;1090;388;1220
221039;201411;983;2836;909;2724;61;213;779;2305;840;2518
221040;201411;5296;16174;4975;15656;379;1297;3934;12504;4313;13801
221050;201411;3889;11875;3578;11431;218;861;3041;9646;3259;10507
221060;201411;9441;25845;7975;23791;919;2821;5955;17888;6874;20709
221062;201411;1301;4606;1196;4418;34;129;1108;4107;1142;4236
221063;201411;1170;3789;1087;3632;312;1006;623;2230;935;3236
221065;201411;2891;8192;2653;7818;276;824;2096;6163;2372;6987
221070;201411;4425;13548;3990;12867;274;1012;3177;10264;3451;11276
221080;201411;3663;9752;3233;9166;199;613;2688;7649;2887;8262
221090;201411;1420;3916;1221;3587;46;188;1014;2915;1060;3103
221093;201411;1855;5531;1757;5335;406;1316;949;2813;1355;4129
221095;201411;1042;2755;893;2542;29;79;789;2259;818;2338
221097;201411;834;2385;729;2204;65;262;547;1621;612;1883
221100;201411;130825;395473;122321;381217;25514;86435;78221;239373;103735;325808
221110;201411;10614;34537;10072;33866;671;2551;8576;28840;9247;31391
221120;201411;4664;15248;4466;14897;1003;3386;2944;10033;3947;13419
221130;201411;4851;14277;4210;12979;1269;4031;1974;6066;3243;10097
221135;201411;1541;4833;1433;4672;158;598;1136;3659;1294;4257
221140;201411;1464;3662;1340;3497;102;268;1136;2971;1238;3239
221150;201411;1273;3275;1050;2890;36;155;840;2273;876;2428
221160;201411;924;2417;860;2317;60;179;662;1796;722;1975
221170;201411;1174;3702;1091;3551;79;308;885;2843;964;3151
230010;201411;3494;9467;2855;8371;181;614;2291;6711;2472;7325
230015;201411;2795;9791;2608;9365;401;1694;1699;5959;2100;7653
230020;201411;14852;48704;14296;47695;865;3147;11966;40199;12831;43346
230030;201411;13134;38114;12091;36491;864;2914;9830;29649;10694;32563
230040;201411;4712;13178;3982;11928;303;1079;3093;9161;3396;10240
230050;201411;2579;8917;1991;7324;415;1625;874;3200;1289;4825
230060;201411;2182;6424;1901;5912;124;458;1461;4501;1585;4959
230070;201411;4447;12269;3834;11329;383;1234;2803;8375;3186;9609
230075;201411;9263;33215;8643;31921;789;3733;6726;24437;7515;28170
230080;201411;2467;6690;2055;6088;131;435;1661;4910;1792;5345
230090;201411;3710;11118;3288;10366;368;1280;2421;7631;2789;8911
230100;201411;18295;55706;16711;52668;3932;13083;9092;28896;13024;41979
230110;201411;14427;46958;13411;44804;2659;9512;7834;26090;10493;35602
230120;201411;8367;23042;7324;21579;870;2521;5340;16217;6210;18738
230125;201411;2984;8763;2473;7782;203;738;1814;5670;2017;6408
230130;201411;5847;19275;4919;17252;509;2124;3422;11778;3931;13902
230140;201411;3683;11805;3128;10786;459;1659;2058;7273;2517;8932
230150;201411;1812;5723;1575;5229;284;1081;977;3137;1261;4218
230160;201411;6675;19845;5790;18542;469;1753;4464;14252;4933;16005
230170;201411;6795;21415;5825;19602;539;2117;4239;14138;4778;16255
230180;201411;1997;5751;1743;5287;146;543;1220;3621;1366;4164
230185;201411;4367;14376;3976;13657;698;2407;2504;8946;3202;11353
230190;201411;13198;42733;11906;40164;2628;9894;6117;20300;8745;30194
230195;201411;5162;15937;4579;14970;312;1331;3623;11512;3935;12843
230200;201411;5910;17165;5298;15983;625;2035;3792;11378;4417;13413
230205;201411;4526;14195;4033;13363;325;1369;2941;9704;3266;11073
230210;201411;9681;27803;8448;25860;2048;6361;4728;14921;6776;21282
230220;201411;14296;41384;12930;39016;1645;5616;9066;26987;10711;32603
230230;201411;7824;25512;6997;23834;1043;3749;4470;15361;5513;19110
230240;201411;13997;40231;12425;37452;807;3055;9740;28766;10547;31821
230250;201411;10437;32276;10216;31945;503;1875;8685;27043;9188;28918
230260;201411;15458;51793;14319;49492;2932;10644;8173;28930;11105;39574
230270;201411;7110;21558;6208;19975;782;2742;4353;14093;5135;16835
230280;201411;19651;59391;17559;55746;2241;7199;12574;40279;14815;47478
230290;201411;4825;14978;4176;13648;574;1931;2857;9361;3431;11292
230300;201411;4991;15208;4747;14848;519;1876;3611;11158;4130;13034
230310;201411;5055;15109;4399;13995;366;1470;3246;10102;3612;11572
230320;201411;7677;24483;7095;23465;762;2864;5284;17491;6046;20355
230330;201411;4847;14424;4218;13190;341;1257;3061;9461;3402;10718
230340;201411;3570;12336;3321;11799;502;2015;2113;7353;2615;9368
230350;201411;18870;57935;17025;54753;2702;9348;10813;35330;13515;44678
230360;201411;3202;9369;2671;8361;324;1148;1829;5662;2153;6810
230365;201411;3182;8829;2761;8136;162;581;2196;6419;2358;7000
230370;201411;58820;191989;53708;182950;15837;55903;25519;90003;41356;145906
230380;201411;7320;21276;6228;19377;548;1915;4429;13810;4977;15725
230390;201411;3762;11796;3325;11069;370;1514;2335;7651;2705;9165
230393;201411;3444;11398;2930;10310;301;1412;2043;6906;2344;8318
230395;201411;5294;16361;4852;15563;774;2663;3124;10089;3898;12752
230400;201411;5404;16695;4661;15539;347;1514;3630;11845;3977;13359
230410;201411;15826;50194;14022;46644;2328;8331;8450;28088;10778;36419
230420;201411;25818;84055;23475;79195;5773;21075;11485;38540;17258;59615
230423;201411;4982;16075;4601;15334;527;1938;3192;10801;3719;12739
230425;201411;5672;18984;5164;17829;743;2748;3454;11915;4197;14663
230426;201411;2921;8149;2354;7089;157;646;1733;5071;1890;5717
230427;201411;1811;5492;1369;4542;151;577;915;2928;1066;3505
230428;201411;9584;31001;9202;30333;1751;6402;5833;19068;7584;25470
230430;201411;4762;15224;4426;14560;434;1733;3203;10327;3637;12060
230435;201411;5255;17019;4694;16025;994;3791;2499;8530;3493;12321
230440;201411;376038;1155350;349122;1106477;89834;303553;170574;543536;260408;847089
230445;201411;4881;13158;4115;12029;358;1029;3086;9201;3444;10230
230450;201411;3858;12253;3282;11215;453;1807;2140;7271;2593;9078
230460;201411;1981;6578;1783;6216;202;819;1268;4392;1470;5211
230465;201411;4350;12965;3552;11508;310;1308;2425;7664;2735;8972
230470;201411;11609;42326;11055;41178;1507;5866;7844;29746;9351;35612
230480;201411;1515;4890;1297;4468;195;718;841;2917;1036;3635
230490;201411;2898;8560;2501;7807;464;1618;1314;4019;1778;5637
230495;201411;5904;19814;5333;18844;890;3754;3121;10983;4011;14737
230500;201411;10863;37092;10357;36198;957;3699;7812;27857;8769;31556
230510;201411;1539;5525;1229;4718;327;1345;449;1792;776;3137
230520;201411;5165;15728;4523;14577;497;1868;3066;9814;3563;11682
230523;201411;14795;48717;12989;44478;3436;12973;3767;13096;7203;26069
230526;201411;4275;13092;3760;12195;394;1516;2715;8776;3109;10292
230530;201411;5580;18415;5065;17714;1025;3657;3401;12105;4426;15762
230533;201411;4122;11723;3671;10871;278;914;2854;8380;3132;9294
230535;201411;5575;16603;4824;15223;643;2017;3245;10527;3888;12544
230540;201411;19722;56366;17410;52882;1032;3829;14410;43393;15442;47222
230550;201411;19337;58800;17424;55032;3673;12534;9541;29904;13214;42438
230560;201411;6716;19502;5989;18194;276;1103;4832;14517;5108;15620
230565;201411;3312;9423;2649;8116;187;705;1942;5842;2129;6547
230570;201411;4105;11144;3624;10535;244;853;2994;8630;3238;9483
230580;201411;10821;32989;10166;32059;618;1979;8791;28028;9409;30007
230590;201411;8982;28431;7867;26290;636;2717;5885;19165;6521;21882
230600;201411;3615;10281;2722;8419;197;690;1825;5579;2022;6269
230610;201411;6385;20763;5946;20051;808;2898;4240;14473;5048;17371
230620;201411;2164;6177;1737;5253;165;588;1091;3183;1256;3771
230625;201411;8034;26435;7148;24392;2149;7864;2269;7788;4418;15652
230630;201411;11646;37580;10596;35582;2767;8869;5172;18605;7939;27474
230640;201411;27963;92029;26051;89145;3513;12865;19143;66039;22656;78904
230650;201411;5129;15823;4596;14783;355;1466;3519;11050;3874;12516
230655;201411;8976;34020;8616;33394;714;2858;7208;28341;7922;31199
230660;201411;6595;20525;5751;18983;537;2107;4150;13735;4687;15842
230670;201411;6132;16617;4939;14558;271;1031;3851;11011;4122;12042
230680;201411;2866;8413;2388;7501;364;1227;1461;4587;1825;5814
230690;201411;6270;20722;6159;20498;514;2139;4443;14498;4957;16637
230700;201411;9585;27716;8470;25706;841;3133;5952;17523;6793;20656
230710;201411;7771;25295;6827;23538;868;3048;4868;17094;5736;20142
230720;201411;2012;6319;1733;5783;233;820;1152;3909;1385;4729
230725;201411;3795;12840;3303;11619;768;2835;1540;5389;2308;8224
230730;201411;59593;182042;49662;165485;13912;50606;19132;65108;33044;115714
230740;201411;5796;17897;5329;17086;296;1289;4437;13987;4733;15276
230750;201411;9393;26830;7923;24490;672;2416;6044;18590;6716;21006
230760;201411;10076;30529;9439;29161;1017;3823;6871;20421;7888;24244
230763;201411;4393;13724;4012;12985;280;1295;3096;9664;3376;10959
230765;201411;43051;140535;39415;132974;12276;44308;13951;47652;26227;91960
230770;201411;24490;68790;22593;66087;2374;7648;16675;48805;19049;56453
230780;201411;6251;24255;5924;23494;1528;6152;2950;12387;4478;18539
230790;201411;2687;9016;2537;8761;300;1115;1933;6734;2233;7849
230800;201411;8196;29208;7453;27527;1788;7055;3521;12998;5309;20053
230810;201411;12940;42059;12261;40901;1299;4506;9519;32230;10818;36736
230820;201411;3575;12102;3126;11117;548;2202;1788;6349;2336;8551
230830;201411;8070;24489;7191;22890;785;2848;5029;15958;5814;18806
230835;201411;4292;11580;3593;10588;316;1051;2786;8160;3102;9211
230837;201411;3219;10947;2773;10028;334;1409;1893;6795;2227;8204
230840;201411;9715;31975;8876;30480;1055;3916;6430;22398;7485;26314
230850;201411;11009;33721;10148;32527;1182;4217;7612;24311;8794;28528
230860;201411;5292;15623;4791;14763;355;1313;3729;11414;4084;12727
230870;201411;19585;53645;17494;50234;1494;4880;13352;38099;14846;42979
230880;201411;1988;6877;1847;6587;245;1022;1220;4320;1465;5342
230890;201411;4068;14833;3722;14066;548;2467;2409;8880;2957;11347
230900;201411;3042;10216;2601;9281;557;1968;1357;4953;1914;6921
230910;201411;3135;9251;2518;8086;209;865;1826;5726;2035;6591
230920;201411;4926;14347;4530;13854;285;954;3853;11941;4138;12895
230930;201411;8035;24454;7164;22813;875;2961;4952;15839;5827;18800
230940;201411;7844;22556;6879;21104;449;1442;5563;17168;6012;18610
230945;201411;6201;18578;5308;17255;548;2050;3767;12418;4315;14468
230950;201411;7253;19788;6234;18427;422;1324;4943;14733;5365;16057
230960;201411;13611;43010;12430;40713;2682;9522;6250;20626;8932;30148
230970;201411;14075;44529;12601;41642;2785;10323;5998;19468;8783;29791
230980;201411;3046;9802;2648;9016;819;2823;1225;4346;2044;7169
230990;201411;1661;5136;1373;4537;153;633;914;2942;1067;3575
231000;201411;2930;7937;2311;6754;259;875;1482;4202;1741;5077
231010;201411;3311;9104;2816;8310;288;1021;2088;6073;2376;7094
231020;201411;8293;27736;7811;26751;1416;5023;4870;17009;6286;22032
231025;201411;8223;25610;7401;24149;1130;3843;4844;16157;5974;20000
231030;201411;8271;27046;6935;24230;1272;4823;4020;14119;5292;18942
231040;201411;3130;10218;2772;9468;244;1032;1995;6677;2239;7709
231050;201411;12738;36585;10909;33243;1052;3611;7981;24225;9033;27836
231060;201411;2503;8000;2282;7600;201;902;1638;5293;1839;6195
231070;201411;9544;30137;8719;28500;1585;5469;5223;17197;6808;22666
231080;201411;4421;13814;4021;13114;249;1133;3035;9567;3284;10700
231085;201411;4989;15919;4806;15640;721;2286;3511;11787;4232;14073
231090;201411;4180;11825;3396;10254;185;703;2482;7370;2667;8073
231095;201411;2309;7575;1989;6910;232;912;1337;4676;1569;5588
231100;201411;3151;9829;2638;8805;235;923;1908;6278;2143;7201
231110;201411;3843;12833;3753;12677;401;1522;2754;9323;3155;10845
231120;201411;2432;7946;2256;7629;391;1378;1450;4975;1841;6353
231123;201411;2261;6136;1901;5555;165;468;1499;4411;1664;4879
231126;201411;6889;19087;5570;17128;419;1588;4179;12684;4598;14272
231130;201411;20837;64895;18976;61656;4375;14626;10697;36170;15072;50796
231135;201411;4782;13999;4002;12762;410;1545;2928;9194;3338;10739
231140;201411;16472;53016;14750;49606;1467;6613;10038;32513;11505;39126
231150;201411;6122;17716;5197;15968;953;3200;2825;8510;3778;11710
231160;201411;6159;20834;5804;20144;1099;4051;3731;12990;4830;17041
231170;201411;4935;15713;4463;14731;519;2037;3023;9811;3542;11848
231180;201411;14465;43634;13022;40770;2245;7667;8042;24793;10287;32460
231190;201411;5169;14372;4309;13127;341;1215;3315;9978;3656;11193
231195;201411;4777;16144;4112;14819;430;1881;2942;10548;3372;12429
231200;201411;7944;27305;6925;25195;624;2954;4973;17704;5597;20658
231210;201411;5348;16429;4605;15373;321;1356;3574;12021;3895;13377
231220;201411;14531;41048;12331;37237;1223;4356;8249;24847;9472;29203
231230;201411;9080;31520;8426;30415;912;3874;6437;23146;7349;27020
231240;201411;12577;39885;11204;37259;2211;7893;6113;20632;8324;28525
231250;201411;1975;5810;1348;4269;363;1122;424;1321;787;2443
231260;201411;4100;11709;3684;11106;550;1670;2432;7537;2982;9207
231270;201411;7976;22182;6997;20607;638;2490;5132;14680;5770;17170
231280;201411;1782;5853;1654;5599;156;555;1231;4201;1387;4756
231290;201411;33358;116124;30125;108407;6862;27602;13353;46887;20215;74489
231300;201411;4780;13956;3873;12129;331;1272;2744;8339;3075;9611
231310;201411;7857;22492;6573;19864;1217;3837;3644;10875;4861;14712
231320;201411;6988;21661;5984;19683;361;1476;4434;14530;4795;16006
231325;201411;2656;8073;2351;7546;181;687;1758;5657;1939;6344
231330;201411;14513;44977;12168;40464;2031;6866;7496;25260;9527;32126
231335;201411;5361;15490;4632;14155;313;1231;3673;10981;3986;12212
231340;201411;18603;60959;17365;59175;1403;4635;14088;49320;15491;53955
231350;201411;13461;44009;13133;43518;1432;4500;10673;36105;12105;40605
231355;201411;4399;14377;4170;13983;279;1052;3385;11425;3664;12477
231360;201411;7599;24995;6898;23738;1576;5350;4144;14813;5720;20163
231370;201411;2472;6979;1972;6196;108;404;1504;4665;1612;5069
231375;201411;4173;14344;3915;13821;306;1368;3147;10951;3453;12319
231380;201411;5484;17810;5149;17330;798;2832;3526;12166;4324;14998
231390;201411;3535;11181;3315;10828;269;1113;2489;8027;2758;9140
231395;201411;4228;13680;3778;12922;722;2572;2284;7942;3006;10514
231400;201411;10710;31995;9712;30150;1005;3574;6768;21055;7773;24629
231410;201411;13170;45753;12171;44046;1049;4046;9668;35151;10717;39197
240010;201411;2596;8015;2243;7274;534;1933;1012;3144;1546;5077
240020;201411;12117;38111;10767;35516;2773;9724;5108;17146;7881;26870
240030;201411;2696;7857;2609;7716;214;753;2099;6115;2313;6868
240040;201411;848;2535;718;2275;50;227;520;1571;570;1798
240050;201411;3828;10395;3277;9451;222;758;2513;7163;2735;7921
240060;201411;1510;4482;1408;4300;135;483;1083;3224;1218;3707
240070;201411;2972;8608;2804;8289;501;1556;1797;5252;2298;6808
240080;201411;3237;8679;2812;8117;280;771;2143;6297;2423;7068
240090;201411;2353;6413;1979;5717;76;292;1571;4440;1647;4732
240100;201411;10756;30625;9841;28792;1287;4396;6172;17799;7459;22195
240110;201411;5317;16299;4707;15156;851;3057;2785;8674;3636;11731
240120;201411;3094;10322;2957;10063;545;1995;1876;6510;2421;8505
240130;201411;2934;7931;2523;7305;201;695;1973;5617;2174;6312
240140;201411;2305;6976;1997;6400;385;1405;1113;3491;1498;4896
240145;201411;6409;20092;5767;18958;1521;5510;2961;9735;4482;15245
240150;201411;1047;3149;856;2770;106;423;517;1604;623;2027
240160;201411;1436;4669;1268;4380;181;680;790;2810;971;3490
240165;201411;979;3092;852;2834;115;375;545;1875;660;2250
240170;201411;2613;7821;2316;7270;628;2162;1073;3324;1701;5486
240180;201411;3074;9602;2854;9208;722;2425;1484;4978;2206;7403
240185;201411;1536;5093;1475;4981;161;558;1115;3842;1276;4400
240190;201411;954;2918;863;2749;56;245;661;2052;717;2297
240200;201411;14213;36963;11800;33829;2507;7344;6593;19625;9100;26969
240210;201411;2885;8224;2656;7906;229;776;2187;6460;2416;7236
240220;201411;7497;24404;7100;23845;450;1970;6066;20157;6516;22127
240230;201411;5930;16300;5302;15262;433;1394;4213;12013;4646;13407
240240;201411;1907;5809;1359;4437;371;1337;283;797;654;2134
240250;201411;2952;8499;2789;8266;210;669;2263;6694;2473;7363
240260;201411;15210;50964;14461;49726;2582;9776;9286;32125;11868;41901
240270;201411;2560;8164;2350;7820;255;846;1750;5962;2005;6808
240280;201411;1713;4852;1533;4540;122;421;1146;3362;1268;3783
240290;201411;1458;4566;1252;4188;118;561;818;2635;936;3196
240300;201411;2230;6264;1591;4862;419;1368;558;1637;977;3005
240310;201411;10819;30666;9770;28967;2057;6641;5387;15965;7444;22606
240320;201411;2138;6342;1727;5486;114;488;1260;3869;1374;4357
240325;201411;40003;110535;31178;95850;10041;33190;9068;28469;19109;61659
240330;201411;1597;4813;1346;4310;156;620;853;2641;1009;3261
240340;201411;1839;5291;1571;4867;198;660;1129;3495;1327;4155
240350;201411;2221;6614;2077;6410;210;738;1691;5186;1901;5924
240360;201411;7583;22815;6609;21357;1296;4438;3973;13190;5269;17628
240370;201411;2117;5793;1782;5216;193;603;1201;3537;1394;4140
240375;201411;927;2466;817;2298;159;510;480;1308;639;1818
240380;201411;2746;8173;2186;6900;302;1005;1273;3974;1575;4979
240390;201411;998;2746;843;2443;71;257;617;1738;688;1995
240400;201411;1532;4118;1290;3732;152;512;926;2599;1078;3111
240410;201411;559;1804;508;1698;87;336;318;1059;405;1395
240420;201411;5022;19056;4786;18514;1294;5068;2521;10229;3815;15297
240430;201411;3724;10536;3415;10010;316;1060;2545;7374;2861;8434
240440;201411;2881;7626;2618;7179;673;1866;1371;3792;2044;5658
240450;201411;3588;10829;3190;10073;345;1407;2150;6545;2495;7952
240460;201411;3106;9595;2958;9393;282;1068;2370;7433;2652;8501
240470;201411;3699;11420;2973;9876;390;1427;1849;6093;2239;7520
240480;201411;474;1246;392;1075;41;113;238;642;279;755
240485;201411;2179;6684;1908;6160;377;1313;1089;3536;1466;4849
240490;201411;1770;4465;1519;4091;88;317;1207;3136;1295;3453
240500;201411;2245;6619;2098;6383;210;708;1587;4825;1797;5533
240510;201411;1897;5688;1752;5421;209;672;1334;4175;1543;4847
240520;201411;1495;4327;1302;4049;194;681;906;2751;1100;3432
240530;201411;2269;7214;2038;6845;294;1035;1426;4817;1720;5852
240540;201411;1869;5721;1786;5582;170;609;1357;4238;1527;4847
240550;201411;843;2388;728;2192;61;210;559;1645;620;1855
240560;201411;3349;9807;3167;9534;313;948;2562;7765;2875;8713
240570;201411;3187;9038;2547;7603;592;1947;1052;2845;1644;4792
240580;201411;8461;25953;7946;25067;1113;3756;5927;18614;7040;22370
240590;201411;849;2383;731;2171;57;211;529;1533;586;1744
240600;201411;1623;4783;1278;4072;171;650;739;2247;910;2897
240610;201411;5181;14538;4455;13193;650;2048;2688;7799;3338;9847
240615;201411;1085;3136;900;2779;151;478;507;1559;658;2037
240620;201411;1804;5751;1636;5465;209;748;1242;4172;1451;4920
240630;201411;2161;6577;2020;6335;214;584;1495;4928;1709;5512
240640;201411;971;2829;813;2562;92;363;548;1697;640;2060
240650;201411;3964;12086;3628;11590;294;1048;2907;9351;3201;10399
240660;201411;2595;8237;2457;8022;262;914;1875;6179;2137;7093
240670;201411;2818;8426;2367;7495;356;1253;1337;4145;1693;5398
240680;201411;1553;4573;1257;4034;148;534;784;2509;932;3043
240690;201411;1152;3196;995;2942;102;361;732;2132;834;2493
240700;201411;2718;8191;2263;7329;117;554;1753;5533;1870;6087
240710;201411;19169;49471;16895;46394;3215;8682;10478;29685;13693;38367
240720;201411;5960;16856;5610;16301;1737;5347;2644;7529;4381;12876
240725;201411;1092;3292;847;2749;87;307;489;1552;576;1859
240730;201411;2408;7261;2078;6653;215;760;1474;4693;1689;5453
240740;201411;2300;6870;2056;6428;267;907;1356;4222;1623;5129
240750;201411;2348;8727;2143;8334;480;2045;1158;4557;1638;6602
240760;201411;1346;3849;1231;3696;120;291;952;3045;1072;3336
240770;201411;3572;10261;3200;9727;306;1083;2468;7461;2774;8544
240780;201411;6146;17038;4935;15137;929;3005;2816;8829;3745;11834
240790;201411;887;2740;722;2440;51;216;524;1779;575;1995
240800;201411;42650;123153;38595;116184;10872;34259;16423;50368;27295;84627
240810;201411;102701;301871;96035;289978;28447;88578;46223;141645;74670;230223
240820;201411;7160;21348;6137;19703;1327;4643;3055;10198;4382;14841
240830;201411;9752;29786;9108;28855;685;2289;7517;24188;8202;26477
240840;201411;1342;3732;1154;3414;143;478;697;2041;840;2519
240850;201411;1327;3945;964;3147;187;664;483;1533;670;2197
240860;201411;1390;3916;1167;3535;98;342;864;2570;962;2912
240870;201411;1216;3374;1022;3000;136;467;659;1842;795;2309
240880;201411;1223;4171;1156;4070;144;598;846;2945;990;3543
240890;201411;5611;15825;4810;14377;987;3213;2399;7066;3386;10279
240895;201411;2873;9790;2596;9290;348;1315;1797;6555;2145;7870
240910;201411;2861;8913;2581;8390;222;865;1935;6220;2157;7085
240920;201411;878;2811;778;2584;211;770;333;1068;544;1838
240930;201411;3779;10095;3385;9586;308;885;2681;7711;2989;8596
240933;201411;1558;4501;1383;4204;207;712;874;2651;1081;3363
240940;201411;6877;19180;5740;17204;1075;3409;3230;9637;4305;13046
240950;201411;1216;3766;1147;3649;110;431;822;2609;932;3040
240960;201411;829;2586;734;2400;92;335;514;1682;606;2017
240970;201411;2007;5585;1669;5003;137;493;1231;3607;1368;4100
240980;201411;3423;11135;3181;10679;654;2380;1954;6540;2608;8920
240990;201411;3146;9369;2944;8956;554;1848;1804;5376;2358;7224
241000;201411;1122;3137;965;2861;79;275;706;2064;785;2339
241010;201411;2994;10067;2724;9556;384;1647;1925;6527;2309;8174
241020;201411;2213;6207;1802;5407;151;542;1158;3341;1309;3883
241025;201411;1586;4859;1426;4552;102;434;1035;3229;1137;3663
241030;201411;2632;8633;2359;8145;200;791;1816;6298;2016;7089
241040;201411;2293;7923;2088;7543;221;917;1514;5521;1735;6438
241050;201411;1400;4148;1246;3886;110;434;927;2818;1037;3252
241060;201411;1022;2931;925;2769;108;342;671;2011;779;2353
241070;201411;956;2715;831;2491;99;340;571;1665;670;2005
241080;201411;1234;3656;1046;3308;89;367;733;2249;822;2616
241090;201411;2197;6387;1870;5796;134;573;1488;4530;1622;5103
241100;201411;1226;3658;1047;3256;134;439;651;2002;785;2441
241105;201411;1226;3725;1140;3557;224;741;644;2078;868;2819
241110;201411;878;2795;734;2476;80;350;463;1528;543;1878
241120;201411;8047;24311;7330;23166;1531;4901;4667;15165;6198;20066
241140;201411;3593;9982;3157;9135;417;1279;2151;6149;2568;7428
241142;201411;716;2150;515;1707;134;512;149;442;283;954
241150;201411;6048;17893;5435;16855;841;2714;3641;11460;4482;14174
241160;201411;1140;3322;1070;3189;169;544;745;2215;914;2759
241170;201411;1410;4128;1289;3905;177;585;813;2567;990;3152
241180;201411;942;2648;764;2303;93;310;443;1287;536;1597
241190;201411;1192;3291;968;2838;86;314;624;1725;710;2039
241200;201411;21668;64527;19856;61556;5302;17261;9837;31093;15139;48354
241210;201411;1593;4596;1317;4029;274;919;641;1924;915;2843
241220;201411;8220;27498;7775;26631;1909;6788;4271;14946;6180;21734
241230;201411;3223;9475;2937;9061;225;846;2382;7276;2607;8122
241240;201411;1175;3462;875;2799;108;366;459;1524;567;1890
241250;201411;5812;18305;4936;16586;317;1567;3926;12860;4243;14427
241255;201411;1874;7142;1761;6901;455;1898;803;3241;1258;5139
241260;201411;5259;14205;4239;12622;330;1263;3073;8969;3403;10232
241270;201411;2122;6380;1857;5869;251;883;1137;3603;1388;4486
241280;201411;2190;6361;2028;6045;311;997;1353;4054;1664;5051
241290;201411;3394;9339;2712;8246;445;1419;1689;5145;2134;6564
241300;201411;1492;4320;1318;4022;90;277;1010;3133;1100;3410
241310;201411;1607;4973;1502;4804;230;729;1040;3420;1270;4149
241320;201411;979;3247;897;3078;155;566;527;1828;682;2394
241330;201411;1567;4944;1449;4788;144;561;1180;3882;1324;4443
241335;201411;2749;8410;2582;8117;173;571;2192;6895;2365;7466
241340;201411;2003;6202;1768;5688;432;1512;860;2728;1292;4240
241350;201411;1983;6334;1823;6023;179;762;1362;4360;1541;5122
241355;201411;1363;3839;1161;3499;67;215;1016;3052;1083;3267
241360;201411;2230;6125;1916;5536;134;452;1396;3885;1530;4337
241370;201411;1358;4190;1096;3635;190;677;571;1864;761;2541
241380;201411;746;2138;637;1919;112;375;348;1055;460;1430
241390;201411;3058;10093;2857;9720;519;1886;1890;6517;2409;8403
241400;201411;3629;10818;3375;10456;375;1312;2611;8144;2986;9456
241410;201411;2822;8256;2529;7861;397;1334;1787;5568;2184;6902
241415;201411;1725;5249;1570;4981;125;493;1189;3708;1314;4201
241420;201411;2334;8083;2032;7551;691;2875;636;2321;1327;5196
241430;201411;546;1663;440;1418;49;185;281;875;330;1060
241440;201411;6203;22526;5803;21842;1138;4464;3891;14887;5029;19351
241445;201411;1096;3270;1023;3168;138;362;794;2597;932;2959
241450;201411;3350;9290;3006;8781;501;1587;2002;5785;2503;7372
241460;201411;3731;10847;3277;9957;279;1020;2347;7044;2626;8064
241470;201411;1395;3921;1174;3658;127;501;869;2653;996;3154
241475;201411;1282;3974;1122;3673;69;328;829;2652;898;2980
241480;201411;3377;10892;3047;10395;1081;3707;1143;4305;2224;8012
241490;201411;645;1725;526;1537;47;158;339;966;386;1124
241500;201411;759;2391;689;2290;34;138;601;1985;635;2123
250010;201411;2861;8936;2455;8152;221;914;1842;5988;2063;6902
250020;201411;1716;4918;1317;4198;105;457;878;2680;983;3137
250030;201411;8326;23454;7532;22346;866;2589;5770;17426;6636;20015
250040;201411;4661;15581;4293;14836;776;2863;2674;9296;3450;12159
250050;201411;3867;11948;3600;11572;462;1677;2597;8411;3059;10088
250053;201411;1377;4042;1268;3902;208;646;827;2590;1035;3236
250057;201411;709;2845;692;2827;35;98;614;2647;649;2745
250060;201411;5223;16254;4982;15882;639;2318;3812;11975;4451;14293
250070;201411;3897;12239;3638;11778;213;949;3023;9529;3236;10478
250073;201411;821;2472;729;2305;69;259;548;1719;617;1978
250077;201411;2363;6880;1964;6244;265;919;1175;3776;1440;4695
250080;201411;4892;14226;4714;13964;563;1733;3573;10639;4136;12372
250090;201411;2647;7813;2539;7637;127;439;2143;6351;2270;6790
250100;201411;4158;13783;3926;13380;442;1711;3015;10223;3457;11934
250110;201411;5957;17845;5666;17433;755;2619;4276;13049;5031;15668
250115;201411;551;1793;483;1629;40;202;288;904;328;1106
250120;201411;2272;6764;1951;6161;189;686;1448;4560;1637;5246
250130;201411;5839;17887;5495;17407;331;1125;4649;14948;4980;16073
250135;201411;1106;3371;1007;3193;109;376;707;2252;816;2628
250140;201411;2193;7071;2021;6842;214;794;1542;5296;1756;6090
250150;201411;5081;17176;4634;16321;466;1970;3384;11782;3850;13752
250153;201411;1618;4338;1453;4099;119;415;1135;3199;1254;3614
250157;201411;1802;6046;1653;5737;288;1039;1057;3726;1345;4765
250160;201411;3475;10665;3342;10461;214;749;2873;9069;3087;9818
250170;201411;1665;4903;1542;4705;294;937;991;3099;1285;4036
250180;201411;17361;53491;16735;52457;2313;8435;12105;37066;14418;45501
250190;201411;4156;12193;3815;11626;653;2091;2470;7444;3123;9535
250200;201411;2291;6315;1817;5668;136;504;1497;4634;1633;5138
250205;201411;1039;3400;944;3219;95;428;616;2143;711;2571
250210;201411;1676;5444;1549;5252;179;750;1127;3756;1306;4506
250215;201411;1471;4978;1428;4900;207;796;913;3145;1120;3941
250220;201411;832;2380;694;2204;46;173;588;1853;634;2026
250230;201411;1803;4526;1462;3969;128;405;1155;3052;1283;3457
250240;201411;2760;8753;2430;8237;204;725;1852;6356;2056;7081
250250;201411;4716;14140;4322;13609;372;1178;3542;11295;3914;12473
250260;201411;1941;5893;1685;5467;148;581;1251;4023;1399;4604
250270;201411;1369;4252;1218;4063;154;526;919;3134;1073;3660
250280;201411;3892;11634;3565;11116;650;2090;2342;7575;2992;9665
250290;201411;2158;5753;1771;5250;65;244;1554;4602;1619;4846
250300;201411;5644;16597;5338;16211;624;2519;4281;12456;4905;14975
250310;201411;1225;3824;1107;3623;152;567;809;2620;961;3187
250320;201411;8178;25654;7764;24809;1067;3876;5294;16468;6361;20344
250330;201411;2725;8425;2340;7887;248;975;1793;6006;2041;6981
250340;201411;1165;3388;1074;3244;53;173;921;2792;974;2965
250350;201411;4750;12784;4228;12164;193;618;3699;10774;3892;11392
250355;201411;2213;6743;1998;6421;153;651;1554;4918;1707;5569
250360;201411;2106;6268;1958;6062;114;424;1564;4863;1678;5287
250370;201411;13791;39192;11870;36887;1225;3997;9703;30333;10928;34330
250375;201411;1128;3558;1060;3444;63;253;896;2904;959;3157
250380;201411;1733;4928;1633;4800;97;335;1429;4188;1526;4523
250390;201411;2024;5373;1645;4740;226;651;1084;3169;1310;3820
250400;201411;75647;205924;63554;186632;15613;48267;32312;96798;47925;145065
250403;201411;1622;5300;1521;5161;212;822;1095;3686;1307;4508
250407;201411;1219;3486;1059;3219;71;217;827;2501;898;2718
250410;201411;687;2188;604;2040;67;281;461;1537;528;1818
250415;201411;1855;5813;1678;5466;138;528;1230;3945;1368;4473
250420;201411;1357;4198;1254;4037;100;401;1036;3266;1136;3667
250430;201411;6868;19145;6402;18464;502;1736;5246;14854;5748;16590
250435;201411;1685;5071;1497;4708;216;787;890;2848;1106;3635
250440;201411;4754;13866;4430;13415;294;901;3657;11172;3951;12073
250450;201411;2109;5988;1863;5666;102;345;1661;5065;1763;5410
250460;201411;6634;19961;6137;19289;744;2501;4629;14685;5373;17186
250470;201411;1641;4567;1470;4324;151;537;1052;3002;1203;3539
250480;201411;4141;12380;3737;11798;157;635;3235;10177;3392;10812
250485;201411;639;1662;537;1495;28;94;428;1152;456;1246
250490;201411;4296;13837;4193;13688;979;3364;2619;8613;3598;11977
250500;201411;1976;5954;1807;5674;389;1232;1054;3405;1443;4637
250510;201411;5042;14152;4453;13339;301;1085;3670;10962;3971;12047
250520;201411;1945;5980;1841;5801;326;1165;1105;3406;1431;4571
250523;201411;1843;5803;1746;5667;257;885;1266;4150;1523;5035
250527;201411;1529;4584;1439;4467;61;256;1296;3982;1357;4238
250530;201411;698;2127;613;2018;47;159;503;1689;550;1848
250535;201411;1354;4301;1287;4164;86;370;1020;3243;1106;3613
250540;201411;2534;7538;2372;7358;75;228;2196;6889;2271;7117
250550;201411;908;3055;835;2941;66;275;644;2244;710;2519
250560;201411;1844;5825;1797;5757;142;478;1531;4936;1673;5414
250570;201411;2609;8436;2314;7867;205;834;1748;5876;1953;6710
250580;201411;1212;3287;989;2933;100;413;715;2012;815;2425
250590;201411;1068;3242;961;3100;94;385;741;2343;835;2728
250600;201411;7293;21402;6883;20799;498;1440;5753;17628;6251;19068
250610;201411;3576;10434;3298;10016;406;1352;2362;7183;2768;8535
250620;201411;874;2542;807;2408;157;509;499;1463;656;1972
250625;201411;2358;7533;2323;7488;78;200;2170;7084;2248;7284
250630;201411;10775;34399;10205;33391;2307;8000;5833;19200;8140;27200
250640;201411;3962;11790;3705;11486;278;1044;3130;9606;3408;10650
250650;201411;982;2829;901;2682;123;433;538;1602;661;2035
250660;201411;2190;5408;1678;4794;30;72;1600;4605;1630;4677
250670;201411;2825;9371;2675;9096;265;1088;2000;6771;2265;7859
250680;201411;5103;14593;4856;14246;266;885;4212;12402;4478;13287
250690;201411;6556;17309;6282;16966;560;1663;5382;14405;5942;16068
250700;201411;5534;16449;5092;15796;822;2756;3473;10669;4295;13425
250710;201411;4788;15038;4384;14516;678;2293;3061;10407;3739;12700
250720;201411;2708;8002;2565;7763;143;565;2164;6494;2307;7059
250730;201411;3805;11712;3595;11409;443;1583;2678;8422;3121;10005
250740;201411;2109;6195;1847;5757;198;717;1350;4133;1548;4850
250750;201411;106207;311519;99635;301415;17301;57335;66278;198193;83579;255528
250760;201411;2346;6875;2165;6607;177;652;1722;5197;1899;5849
250770;201411;4127;14071;3906;13771;725;2777;2509;8904;3234;11681
250780;201411;1959;5761;1679;5239;198;764;1078;3240;1276;4004
250790;201411;2520;8215;2380;8015;549;1788;1521;5319;2070;7107
250800;201411;2880;8218;2508;7585;150;528;1955;5798;2105;6326
250810;201411;1407;4114;1215;3829;118;475;956;2949;1074;3424
250820;201411;2119;6428;2036;6310;128;428;1715;5371;1843;5799
250830;201411;6151;20241;5774;19485;771;3024;3970;13212;4741;16236
250840;201411;1051;3371;915;3094;116;435;588;2006;704;2441
250850;201411;2488;7176;2211;6726;217;842;1458;4581;1675;5423
250855;201411;1116;3395;1042;3282;99;371;797;2440;896;2811
250860;201411;3117;10307;2777;9665;660;2614;1094;3754;1754;6368
250870;201411;1219;3480;1057;3214;69;275;783;2300;852;2575
250880;201411;1472;4236;1323;4027;185;589;962;2928;1147;3517
250890;201411;10161;31529;9483;30587;1562;5825;6440;20370;8002;26195
250900;201411;3148;10239;2786;9557;355;1228;1934;6738;2289;7966
250905;201411;2161;6835;2062;6706;363;1211;1471;4858;1834;6069
250910;201411;5602;16200;5223;15635;492;1631;4098;12253;4590;13884
250915;201411;1746;5100;1606;4894;142;428;1335;4144;1477;4572
250920;201411;3666;10459;3432;10129;443;1239;2507;7687;2950;8926
250930;201411;2069;6690;1974;6540;329;1245;1375;4503;1704;5748
250933;201411;1214;3928;1164;3845;126;433;862;2889;988;3322
250937;201411;879;2722;783;2526;119;460;468;1503;587;1963
250939;201411;1772;5459;1602;5180;226;794;1068;3434;1294;4228
250940;201411;4105;12032;3799;11552;228;831;3039;9306;3267;10137
250950;201411;1166;3784;1094;3685;38;135;990;3360;1028;3495
250960;201411;1339;4153;1187;3949;112;450;923;3072;1035;3522
250970;201411;9369;25456;8317;23949;1214;3500;5806;16881;7020;20381
250980;201411;2790;8297;2537;7847;253;1001;1758;5229;2011;6230
250990;201411;2195;7506;2016;7143;298;1220;1366;4780;1664;6000
251000;201411;2632;7458;2155;6778;132;481;1729;5442;1861;5923
251010;201411;2923;8500;2642;8068;184;658;2115;6523;2299;7181
251020;201411;1775;5232;1629;5046;150;513;1352;4216;1502;4729
251030;201411;1356;3774;1228;3559;129;426;806;2363;935;2789
251040;201411;1962;6228;1764;5915;183;851;1262;4072;1445;4923
251050;201411;1181;3454;1036;3191;173;570;585;1857;758;2427
251060;201411;1037;2425;807;2136;63;211;631;1622;694;1833
251065;201411;606;1799;530;1686;73;263;329;1007;402;1270
251070;201411;648;1827;593;1747;63;251;458;1262;521;1513
251080;201411;22048;61528;20356;58655;5154;15534;11001;32106;16155;47640
251090;201411;3172;9943;2810;9255;279;1066;2033;6615;2312;7681
251100;201411;1040;3336;899;3060;180;708;502;1640;682;2348
251110;201411;2193;6355;1936;5892;220;726;1325;4043;1545;4769
251120;201411;6102;20976;5880;20587;744;3101;4526;15543;5270;18644
251130;201411;4113;10681;3696;10218;36;104;3575;9910;3611;10014
251140;201411;4664;14202;4318;13667;226;885;3431;10833;3657;11718
251150;201411;2934;9373;2680;9006;374;1409;1898;6424;2272;7833
251160;201411;1908;6326;1825;6210;98;389;1593;5425;1691;5814
251170;201411;1506;4584;1436;4500;121;454;1192;3690;1313;4144
251180;201411;2984;8902;2727;8563;584;1833;1630;5279;2214;7112
251190;201411;4545;12830;4389;12652;277;810;3926;11357;4203;12167
251200;201411;4289;13328;4072;13053;176;600;3652;11790;3828;12390
251203;201411;1388;4329;1296;4137;107;451;825;2729;932;3180
251207;201411;1239;3885;1071;3570;102;448;725;2336;827;2784
251210;201411;8374;23944;7298;22504;957;2908;5463;17238;6420;20146
251220;201411;1386;3672;1191;3381;186;554;775;2281;961;2835
251230;201411;5391;16088;4751;15336;420;1529;4026;13003;4446;14532
251240;201411;3301;10773;3217;10645;350;1265;2577;8522;2927;9787
251250;201411;11025;32837;10214;31594;1377;4809;7444;22749;8821;27558
251260;201411;567;1719;494;1616;39;127;368;1211;407;1338
251270;201411;4415;13728;4112;13353;156;610;3702;12062;3858;12672
251272;201411;1469;4394;1381;4271;126;414;1115;3483;1241;3897
251274;201411;1053;3265;980;3129;126;503;603;1954;729;2457
251275;201411;1457;4114;1379;3997;148;553;1023;2861;1171;3414
251276;201411;1550;4606;1459;4446;212;706;920;2895;1132;3601
251278;201411;663;2109;574;1903;89;334;345;1178;434;1512
251280;201411;2468;7676;2356;7493;253;905;1810;5700;2063;6605
251290;201411;6396;18005;6056;17581;870;2896;4421;12559;5291;15455
251300;201411;779;2684;723;2600;68;319;527;1856;595;2175
251310;201411;3414;9904;3141;9516;191;714;2536;7620;2727;8334
251315;201411;1772;6183;1709;6072;308;1124;1078;3927;1386;5051
251320;201411;2211;6167;1807;5517;153;516;1280;3964;1433;4480
251330;201411;2105;5469;1731;4983;113;455;1485;4147;1598;4602
251335;201411;1028;3521;959;3386;91;415;705;2419;796;2834
251340;201411;4054;11238;3414;10270;343;1270;2396;7037;2739;8307
251350;201411;1659;5034;1506;4813;205;730;1040;3292;1245;4022
251360;201411;1893;6130;1764;5972;117;468;1490;5084;1607;5552
251365;201411;922;2712;739;2335;57;222;484;1501;541;1723
251370;201411;24429;79585;23851;78726;3525;13410;17880;57692;21405;71102
251380;201411;1444;4481;1260;4166;93;394;1000;3235;1093;3629
251385;201411;899;2475;810;2334;91;273;552;1582;643;1855
251390;201411;6033;21162;5613;20431;1288;4920;3397;12484;4685;17404
251392;201411;1111;3283;1014;3129;95;304;756;2390;851;2694
251394;201411;646;1968;529;1746;42;162;374;1220;416;1382
251396;201411;897;2555;795;2378;115;367;542;1584;657;1951
251398;201411;1155;3346;962;2988;84;309;661;2036;745;2345
251400;201411;1408;3972;1262;3775;178;663;850;2451;1028;3114
251410;201411;1682;4356;1533;4114;175;538;1062;2896;1237;3434
251420;201411;2297;6512;1947;6119;197;690;1511;4727;1708;5417
251430;201411;1789;6276;1612;5986;121;537;1326;4920;1447;5457
251440;201411;1489;4422;1259;3971;143;506;904;2817;1047;3323
251445;201411;1687;5103;1598;4972;111;419;1353;4166;1464;4585
251450;201411;4973;15510;4439;14829;182;769;3850;12860;4032;13629
251455;201411;1224;3818;1080;3581;94;381;756;2516;850;2897
251460;201411;905;2769;865;2704;128;413;665;2103;793;2516
251465;201411;506;1573;459;1478;46;176;304;961;350;1137
251470;201411;1327;3826;1096;3397;134;481;647;2015;781;2496
251480;201411;1150;3115;1024;2909;62;228;819;2286;881;2514
251490;201411;2146;6301;1857;5907;323;1175;1163;3651;1486;4826
251500;201411;1836;5995;1777;5901;187;698;1407;4612;1594;5310
251510;201411;2730;9020;2504;8553;433;1581;1559;5372;1992;6953
251520;201411;1148;3108;1031;2926;151;459;576;1650;727;2109
251530;201411;12552;35955;11998;35159;714;2590;10314;29854;11028;32444
251540;201411;2953;9608;2719;9111;253;1015;2080;6939;2333;7954
251550;201411;4088;10216;3397;9324;189;650;2788;7489;2977;8139
251560;201411;760;2341;693;2225;107;419;417;1231;524;1650
251570;201411;1103;3217;925;2856;108;412;602;1893;710;2305
251580;201411;2238;6168;2055;5918;377;959;1430;4295;1807;5254
251590;201411;1788;5742;1740;5686;116;428;1505;4969;1621;5397
251593;201411;1090;3372;1005;3255;156;558;639;2013;795;2571
251597;201411;2043;6283;1965;6165;177;666;1555;4790;1732;5456
251600;201411;7656;22174;7217;21441;875;2620;5431;16421;6306;19041
251610;201411;3696;11079;3414;10701;361;1232;2619;8323;2980;9555
251615;201411;1228;3528;1037;3197;106;405;678;2127;784;2532
251620;201411;17989;50552;15777;47756;1842;5740;11957;36777;13799;42517
251630;201411;5493;13880;4745;12931;431;1220;3682;10153;4113;11373
251640;201411;2755;7914;2246;6991;219;819;1629;5021;1848;5840
251650;201411;4501;12761;4042;12180;332;1056;3313;10181;3645;11237
251660;201411;3710;12167;3380;11638;273;1242;2684;9040;2957;10282
251670;201411;4178;12458;3716;11822;82;268;3387;10872;3469;11140
251675;201411;781;2566;732;2491;171;616;410;1383;581;1999
251680;201411;2944;8205;2321;7251;130;532;1877;5769;2007;6301
251690;201411;3668;11169;3387;10658;310;1099;2477;7719;2787;8818
251700;201411;2236;7176;2104;6999;205;759;1703;5694;1908;6453
251710;201411;975;2540;724;2077;97;329;387;1073;484;1402
251720;201411;1457;4486;1321;4248;114;450;1022;3244;1136;3694
251740;201411;777;2183;618;1899;85;281;382;1169;467;1450
260005;201411;25928;64022;22648;59355;4863;12952;13668;35797;18531;48749
260010;201411;9948;27029;7966;24565;971;3186;5821;18080;6792;21266
260020;201411;6035;17507;5315;16425;510;1535;3995;12773;4505;14308
260030;201411;5558;16616;5097;15907;435;1553;4040;12513;4475;14066
260040;201411;10434;25210;8673;23204;723;1624;7027;19512;7750;21136
260050;201411;11419;35747;10589;34785;666;2326;9243;30669;9909;32995
260060;201411;4166;11551;3785;10911;362;1067;2941;8562;3303;9629
260070;201411;9968;29461;9446;28681;1839;6004;6213;18755;8052;24759
260080;201411;5594;15624;4931;14662;497;1675;3709;10865;4206;12540
260090;201411;5478;15186;5122;14685;1155;3183;3430;10154;4585;13337
260100;201411;3590;9606;3250;9142;248;847;2613;7432;2861;8279
260105;201411;4848;14254;4652;13884;722;2351;3240;9549;3962;11900
260110;201411;22712;65204;20830;62923;1358;4111;17929;54679;19287;58790
260120;201411;11418;35059;10547;33515;2785;9045;5571;18339;8356;27384
260130;201411;3230;9129;3055;8847;466;1299;2208;6543;2674;7842
260140;201411;13886;35326;11881;32857;1154;3475;9277;25990;10431;29465
260150;201411;3237;9241;2878;8723;220;808;2280;6929;2500;7737
260160;201411;6154;18740;5500;17953;509;1767;4502;14974;5011;16741
260170;201411;18208;49854;17375;48748;1648;4369;14039;39971;15687;44340
260180;201411;3483;10714;3170;10257;243;930;2581;8316;2824;9246
260190;201411;16708;39845;15638;38506;851;2242;13618;33525;14469;35767
260200;201411;11929;33315;10859;31778;1080;3402;8248;24776;9328;28178
260210;201411;11787;36079;10761;34596;901;3214;8637;28010;9538;31224
260220;201411;9750;29429;9461;29020;772;2958;8038;24139;8810;27097
260230;201411;10256;29524;9620;28668;702;2133;7882;23942;8584;26075
260240;201411;3030;9210;2619;8625;374;1317;1876;6227;2250;7544
260250;201411;2816;7535;2578;7237;190;570;2111;5966;2301;6536
260260;201411;11984;34539;11469;33829;1338;4193;8954;26957;10292;31150
260270;201411;3689;11010;3443;10647;358;1387;2661;8065;3019;9452
260280;201411;13405;43497;12281;41741;814;2961;10247;35366;11061;38327
260290;201411;35760;108305;34289;105769;6118;20873;22711;69126;28829;89999
260300;201411;8664;26253;7593;24663;553;2255;6059;19643;6612;21898
260310;201411;5299;15632;4959;15108;1601;4527;2484;8247;4085;12774
260320;201411;7189;23759;6663;22986;596;2075;5295;18654;5891;20729
260330;201411;3197;9896;2960;9504;296;1160;2024;6709;2320;7869
260340;201411;1957;5775;1828;5584;99;351;1596;4853;1695;5204
260345;201411;27529;88908;26144;86078;7822;27880;11804;37468;19626;65348
260350;201411;4464;12549;4217;12171;304;1000;3489;9996;3793;10996
260360;201411;2532;7723;2380;7475;444;1548;1511;4728;1955;6276
260370;201411;6272;19252;5659;18155;685;2432;4066;13154;4751;15586
260380;201411;5108;16633;4706;16091;492;1739;3593;12468;4085;14207
260390;201411;4869;15086;4195;13980;490;1814;2980;9786;3470;11600
260392;201411;3637;11373;3379;11039;148;560;3014;9857;3162;10417
260400;201411;14495;42249;13878;41218;2361;7978;9525;27632;11886;35610
260410;201411;65305;191452;61306;184812;20487;62308;27595;86114;48082;148422
260415;201411;4207;13239;3653;12147;505;2007;2295;7491;2800;9498
260420;201411;12681;29364;11561;28173;791;2027;9951;24316;10742;26343
260430;201411;2814;9311;2530;8853;306;1230;1828;6326;2134;7556
260440;201411;3538;10732;3244;10134;597;2024;1941;5949;2538;7973
260450;201411;5453;16181;5113;15647;418;1401;4156;12742;4574;14143
260460;201411;5985;18471;5581;17823;986;3475;3540;11121;4526;14596
260470;201411;5296;15057;4970;14609;463;1433;4058;12105;4521;13538
260480;201411;4082;11890;3626;11209;609;2105;2451;7532;3060;9637
260490;201411;6277;16090;5429;14723;592;1939;3788;10257;4380;12196
260500;201411;7003;19162;6446;18339;741;2215;4709;13558;5450;15773
260510;201411;10854;28363;10024;27228;815;2239;8015;22496;8830;24735
260515;201411;4725;14632;3690;12464;352;1378;2344;7909;2696;9287
260520;201411;16840;45095;16267;44308;3268;8827;11129;30780;14397;39607
260530;201411;10351;30889;9006;28983;564;1799;7644;24974;8208;26773
260540;201411;6056;15536;5691;15134;690;1527;4602;12648;5292;14175
260545;201411;43;166;31;127;5;23;7;27;12;50
260550;201411;2932;9713;2568;8972;645;2504;1156;3999;1801;6503
260560;201411;6931;17738;6169;16656;306;884;5405;14585;5711;15469
260570;201411;6931;23401;6402;22498;935;3670;4538;16030;5473;19700
260580;201411;4042;11101;3812;10741;280;920;3200;8848;3480;9768
260590;201411;6020;15262;5760;14957;255;580;5253;13806;5508;14386
260600;201411;28001;85089;26135;81904;4012;13557;17777;56025;21789;69582
260610;201411;7223;21599;6862;21080;1211;3969;4782;14608;5993;18577
260620;201411;17947;55065;17209;53795;3371;11711;10852;33236;14223;44947
260630;201411;2401;7081;2067;6534;213;812;1550;4845;1763;5657
260640;201411;18064;49536;17026;48073;2530;7451;11995;33976;14525;41427
260650;201411;5659;17693;5234;16970;658;2108;3682;12661;4340;14769
260660;201411;8691;24009;7793;22864;521;1626;6600;19522;7121;21148
260670;201411;2520;6981;2110;6419;283;963;1422;4351;1705;5314
260680;201411;24056;66222;22390;63302;5000;14720;12480;34990;17480;49710
260690;201411;3792;10340;3244;9491;183;675;2682;7767;2865;8442
260700;201411;5869;17413;5728;17264;91;166;5554;16958;5645;17124
260710;201411;1381;4190;1251;4005;142;541;948;2987;1090;3528
260720;201411;17645;57900;16733;56296;4333;14903;9123;31492;13456;46395
260730;201411;7498;24484;6700;23270;954;3456;4802;16931;5756;20387
260740;201411;1335;4039;1161;3727;167;597;712;2286;879;2883
260750;201411;6876;21721;6356;21016;605;1842;5253;17805;5858;19647
260760;201411;4947;13592;4623;13167;478;1479;3624;10328;4102;11807
260765;201411;8453;29060;8140;28585;1415;5735;5538;19264;6953;24999
260770;201411;4423;11437;4014;10900;250;850;3201;8541;3451;9391
260775;201411;5461;15767;5162;15308;594;2132;3716;10673;4310;12805
260780;201411;4090;13337;3913;13033;930;3455;2276;7486;3206;10941
260790;201411;125013;320667;119327;312273;26702;71374;72567;190910;99269;262284
260795;201411;3133;9865;2880;9467;467;1652;1922;6382;2389;8034
260800;201411;4982;13426;4605;12902;226;922;4015;10931;4241;11853
260805;201411;4231;12277;3796;11601;514;1709;2619;7993;3133;9702
260810;201411;7497;21702;7304;21451;467;1486;6383;18790;6850;20276
260820;201411;4722;13368;4385;12909;1155;3470;2535;7486;3690;10956
260825;201411;3144;10041;2917;9699;315;1020;2300;7785;2615;8805
260830;201411;3863;12400;3531;11801;956;3074;2004;7027;2960;10101
260840;201411;4339;12490;3930;11892;290;1136;3238;9598;3528;10734
260845;201411;4399;12878;4093;12294;678;2147;2750;8294;3428;10441
260850;201411;5143;17288;4616;16129;1106;4320;2245;7653;3351;11973
260860;201411;3427;10798;3133;10271;276;968;2412;7970;2688;8938
260870;201411;4331;11950;3950;11470;522;1400;3006;8965;3528;10365
260875;201411;7588;20350;6799;19112;1193;3373;4262;12364;5455;15737
260880;201411;9036;28503;8546;27803;720;2404;7096;23313;7816;25717
260890;201411;15443;43908;14514;42494;1638;5336;10727;31503;12365;36839
260900;201411;6254;19134;5306;17464;868;3128;3240;10667;4108;13795
260910;201411;3253;9588;2930;9115;241;849;2354;7374;2595;8223
260915;201411;4715;15647;4536;15391;119;399;4200;14450;4319;14849
260920;201411;3553;10702;3376;10469;480;1613;2528;7980;3008;9593
260930;201411;4316;13579;3787;12768;482;1688;2727;9311;3209;10999
260940;201411;15855;43305;14522;41017;2449;8144;8889;24589;11338;32733
260950;201411;6469;20527;6070;19735;897;3664;3759;11544;4656;15208
260960;201411;69266;192885;65258;186290;14229;42347;37895;108955;52124;151302
260970;201411;5533;17437;5143;16881;550;2126;3822;12503;4372;14629
260980;201411;4098;13122;3867;12821;252;842;3298;11189;3550;12031
260990;201411;18786;58181;17308;56204;1945;6123;13264;44711;15209;50834
261000;201411;16294;45166;13118;40048;2697;8698;7153;22379;9850;31077
261010;201411;2857;7851;2665;7608;222;462;2271;6785;2493;7247
261020;201411;5950;17747;5440;16965;439;1647;4392;13353;4831;15000
261030;201411;3630;11754;3417;11390;340;1262;2696;8942;3036;10204
261040;201411;5524;17622;4732;16270;515;2085;3415;11609;3930;13694
261050;201411;8993;25381;8360;24348;1124;3345;5801;16862;6925;20207
261060;201411;11949;36340;11400;35434;1493;5332;8476;25857;9969;31189
261070;201411;52451;133808;47052;126155;9449;26163;28820;77817;38269;103980
261080;201411;5993;17937;5638;17373;411;1202;4761;14915;5172;16117
261090;201411;17115;47394;15939;45819;1604;4658;12696;36914;14300;41572
261100;201411;7620;24457;6930;23268;1075;3887;4588;15574;5663;19461
261110;201411;69470;199181;63162;189927;15826;47935;34469;109482;50295;157417
261120;201411;3829;10180;3443;9697;131;410;3075;8689;3206;9099
261130;201411;7401;19124;7061;18743;264;713;6497;17255;6761;17968
261140;201411;3352;9419;3063;8966;524;1706;1937;5574;2461;7280
261150;201411;5870;17293;5288;16440;678;2342;3851;12022;4529;14364
261153;201411;2025;5915;1692;5437;94;358;1365;4420;1459;4778
261160;201411;232186;604345;220224;587700;52237;140511;125234;344451;177471;484962
261170;201411;6266;17372;5773;16669;792;2318;4357;12697;5149;15015
261180;201411;10012;28185;9576;27562;1048;3065;7342;21350;8390;24415
261190;201411;5597;17615;5266;17181;773;3244;3649;11484;4422;14728
261200;201411;4046;9901;3717;9485;565;1423;2690;7018;3255;8441
261210;201411;2037;5349;1945;5233;133;348;1703;4652;1836;5000
261220;201411;13516;43056;11482;38592;2315;8356;5876;19798;8191;28154
261230;201411;4287;13092;3942;12654;181;658;3488;11235;3669;11893
261240;201411;5167;15080;4841;14510;800;2322;3372;10274;4172;12596
261245;201411;3977;12340;3428;11414;274;1142;2543;8485;2817;9627
261247;201411;3608;11003;3078;10024;370;1287;2185;7176;2555;8463
261250;201411;19964;53590;19141;52511;3503;9377;14041;39289;17544;48666
261255;201411;4510;13637;4037;12862;320;1139;3194;10313;3514;11452
261260;201411;12749;35999;11587;34630;699;1871;10084;30816;10783;32687
261270;201411;3871;11312;3554;10807;479;1589;2458;7408;2937;8997
261280;201411;2835;8633;2570;8246;263;930;1953;6287;2216;7217
261290;201411;3168;8936;2843;8529;213;722;2346;7105;2559;7827
261300;201411;10889;35847;9726;33814;1739;6817;5994;20689;7733;27506
261310;201411;8679;26161;8207;25372;2092;6614;4654;14512;6746;21126
261320;201411;6218;19245;5830;18532;570;1799;4506;14612;5076;16411
261330;201411;5685;16674;5465;16348;571;1716;4326;13035;4897;14751
261340;201411;4689;15264;4445;14870;670;2633;2867;9565;3537;12198
261350;201411;8359;27997;7889;27192;620;2574;6262;21405;6882;23979
261360;201411;9781;25227;8819;23944;1156;3249;6266;17320;7422;20569
261370;201411;21712;64101;20437;62113;4517;14345;12434;38048;16951;52393
261380;201411;4316;14743;3983;14122;636;2427;2667;9546;3303;11973
261390;201411;17830;54457;16221;51671;2785;9722;10047;31852;12832;41574
261400;201411;5061;17454;4591;16511;591;2401;3156;11409;3747;13810
261410;201411;8875;25470;8279;24572;1144;3433;6073;18349;7217;21782
261420;201411;8292;27658;7956;27171;2110;7857;4454;15392;6564;23249
261430;201411;3699;11441;3142;10682;381;1320;2331;8094;2712;9414
261440;201411;1715;5279;1573;5064;105;444;1283;4088;1388;4532
261450;201411;14659;41924;14247;41393;798;2405;12807;37314;13605;39719
261460;201411;8638;24874;8063;24072;799;2176;6129;19693;6928;21869
261470;201411;4070;11016;3728;10603;208;641;3234;9177;3442;9818
261480;201411;3614;13190;3361;12731;398;1701;2523;9399;2921;11100
261485;201411;5155;15895;4700;15087;936;3387;2725;8638;3661;12025
261500;201411;5999;16580;5268;15596;650;1735;4009;12386;4659;14121
261510;201411;2124;6696;1978;6476;177;573;1558;5186;1735;5759
261520;201411;2702;8742;2390;8163;177;725;1699;5858;1876;6583
261530;201411;12718;40932;11213;37952;2601;9582;5035;17048;7636;26630
261540;201411;7592;24464;7289;23920;1418;4607;4893;16408;6311;21015
261550;201411;3602;10675;3427;10423;403;1535;2709;7993;3112;9528
261560;201411;7226;23404;6596;22591;1222;4323;4591;16060;5813;20383
261570;201411;3725;11321;3258;10562;529;1767;2155;7048;2684;8815
261580;201411;5964;18763;5320;17719;478;1807;4210;14202;4688;16009
261590;201411;2923;8076;2549;7558;310;985;1835;5538;2145;6523
261600;201411;5416;14823;4626;13704;459;1385;3542;10615;4001;12000
261610;201411;2377;7059;2044;6562;119;485;1676;5268;1795;5753
261618;201411;2623;7421;2460;7204;252;803;1945;5640;2197;6443
261620;201411;4711;14417;4430;13970;655;2112;3051;9841;3706;11953
261630;201411;8255;24071;7044;21795;1220;4326;3956;11882;5176;16208
261640;201411;31259;81186;28847;78160;2078;5469;24244;66992;26322;72461
261650;201411;3900;12294;3648;11924;528;1838;2625;8636;3153;10474
270010;201411;4620;17400;4216;16573;520;2326;2919;11525;3439;13851
270020;201411;4144;12312;3882;11908;457;1605;2966;8968;3423;10573
270030;201411;47011;141810;44545;137864;11547;36328;25485;80551;37032;116879
270040;201411;10581;32628;10019;31973;1703;4899;7383;24574;9086;29473
270050;201411;4155;12019;3852;11626;406;1457;2996;8949;3402;10406
270060;201411;1789;5744;1685;5600;346;1247;1045;3515;1391;4762
270070;201411;4298;13304;3975;12867;200;888;3422;10912;3622;11800
270080;201411;1381;4292;1220;4020;223;828;771;2475;994;3303
270090;201411;2140;6678;2033;6475;61;233;1848;5829;1909;6062
270100;201411;6586;20357;6291;19953;1301;4328;4160;13175;5461;17503
270110;201411;3524;9926;3232;9589;546;1608;2135;6802;2681;8410
270120;201411;3195;9240;2889;8831;152;525;2515;7753;2667;8278
270130;201411;5375;16683;5075;16332;536;1544;4162;13830;4698;15374
270135;201411;1817;5051;1725;4950;130;209;1541;4616;1671;4825
270140;201411;10090;25011;8884;23447;762;2922;7099;17622;7861;20544
270150;201411;2801;9502;2733;9413;187;708;2412;8328;2599;9036
270160;201411;5193;17310;4772;16783;292;1085;4071;14401;4363;15486
270170;201411;4164;13553;3837;13077;799;3158;2209;7425;3008;10583
270180;201411;2357;7752;2092;7412;157;730;1694;5949;1851;6679
270190;201411;1972;6427;1866;6266;148;591;1473;4977;1621;5568
270200;201411;2810;9448;2626;9148;274;1148;2003;6862;2277;8010
270210;201411;4725;14933;4525;14672;397;1583;3812;12213;4209;13796
270220;201411;1747;5479;1615;5222;325;1166;853;2803;1178;3969
270230;201411;11508;37151;10072;34852;1508;6201;6543;22242;8051;28443
270235;201411;6564;21286;6206;20692;398;1649;5140;17025;5538;18674
270240;201411;10053;29954;8735;28217;1744;5870;5348;17496;7092;23366
270250;201411;3616;9166;3283;8792;176;457;2972;7994;3148;8451
270255;201411;5202;15797;4251;14094;378;1543;3050;9984;3428;11527
270260;201411;6605;21026;6421;20719;856;3147;4839;15691;5695;18838
270270;201411;1245;3569;1140;3411;213;671;670;1969;883;2640
270280;201411;3842;11194;3567;10791;468;1594;2559;7659;3027;9253
270290;201411;8654;30162;8189;29341;879;3693;6353;22591;7232;26284
270300;201411;3487;11839;3258;11573;214;854;2785;9958;2999;10812
270310;201411;7722;23546;6897;22168;419;1888;5659;17752;6078;19640
270320;201411;6643;21233;6420;20859;1445;5359;3826;12407;5271;17766
270330;201411;4964;16314;4654;15897;488;1792;3704;12763;4192;14555
270340;201411;1846;5658;1662;5414;190;664;1259;4169;1449;4833
270350;201411;2135;5866;1971;5654;267;781;1358;4104;1625;4885
270360;201411;2136;6685;2081;6618;239;725;1716;5599;1955;6324
270370;201411;1759;5689;1615;5438;180;679;1091;3795;1271;4474
270375;201411;3108;9217;2830;8795;404;1539;1904;5645;2308;7184
270380;201411;6152;18715;5798;18229;638;2056;4483;14374;5121;16430
270390;201411;1400;3851;1249;3658;161;567;899;2521;1060;3088
270400;201411;6136;18805;5587;17985;500;1887;4003;12705;4503;14592
270410;201411;5193;15988;4913;15459;604;2083;3566;11129;4170;13212
270420;201411;5789;18808;5618;18568;305;1449;4699;15228;5004;16677
270430;201411;143846;419785;136827;409674;37019;112202;73808;228335;110827;340537
270440;201411;5181;15801;4860;15331;384;1399;3844;12247;4228;13646
270450;201411;6823;21154;6563;20823;583;2153;5276;16760;5859;18913
270460;201411;3731;10119;3353;9606;266;902;2734;7716;3000;8618
270470;201411;11513;36743;10827;35587;1721;5662;7144;24209;8865;29871
270480;201411;3193;9953;2856;9359;363;1426;1902;6009;2265;7435
270490;201411;1015;3257;955;3170;90;357;728;2397;818;2754
270500;201411;5518;18687;5257;18338;483;1739;4224;15106;4707;16845
270510;201411;6259;19153;5695;18350;886;3629;4059;12473;4945;16102
270520;201411;3853;12381;3604;11981;880;3180;1903;6401;2783;9581
270530;201411;1589;4638;1405;4398;208;655;957;3101;1165;3756
270540;201411;2118;7236;1942;6979;175;818;1541;5444;1716;6262
270550;201411;7368;22029;6526;20913;1045;3460;4431;14601;5476;18061
270560;201411;3120;9673;2934;9381;495;1868;2056;6369;2551;8237
270570;201411;4404;14190;4007;13559;460;1913;2794;9336;3254;11249
270580;201411;2145;7013;2060;6878;279;974;1552;5271;1831;6245
270590;201411;1473;4935;1382;4777;68;281;1231;4259;1299;4540
270600;201411;2985;9955;2680;9480;236;1157;2052;7065;2288;8222
270610;201411;3361;10594;3115;10228;315;1137;2474;8085;2789;9222
270620;201411;1552;5121;1411;4908;147;671;1093;3693;1240;4364
270630;201411;18789;52570;17479;50501;2642;7682;12352;36328;14994;44010
270640;201411;6208;18947;5555;18107;473;1902;4486;14377;4959;16279
270642;201411;2534;8683;2359;8407;367;1490;1610;5766;1977;7256
270644;201411;2509;7311;2256;7030;176;491;1945;6185;2121;6676
270650;201411;4202;13246;4029;13001;853;3327;2459;7644;3312;10971
270660;201411;2541;6457;1996;5650;142;503;1420;4009;1562;4512
270670;201411;16799;44600;14574;41958;1948;5532;10774;32116;12722;37648
270680;201411;4340;13069;4166;12866;207;579;3739;11694;3946;12273
270690;201411;9410;26344;8679;25477;2850;8011;4353;13681;7203;21692
270700;201411;806;2499;758;2422;137;515;478;1483;615;1998
270710;201411;6048;19990;5774;19625;644;2342;4591;15718;5235;18060
270720;201411;3494;11718;3211;11232;254;1158;2579;8916;2833;10074
270730;201411;6891;21017;6533;20583;938;2951;5037;16156;5975;19107
270740;201411;2520;7225;2366;7011;348;1186;1651;4803;1999;5989
270750;201411;5097;16204;4717;15623;526;1883;3628;12059;4154;13942
270760;201411;3693;11031;3327;10428;372;1246;2465;7763;2837;9009
270770;201411;19011;51247;16159;47755;3175;9564;9989;30507;13164;40071
270780;201411;1990;6429;1852;6215;255;920;1308;4433;1563;5353
270790;201411;1766;5523;1612;5279;351;1265;941;3026;1292;4291
270800;201411;11829;35013;11047;33953;1023;3423;8984;27621;10007;31044
270810;201411;3567;10856;2856;9546;373;1418;1790;6020;2163;7438
270820;201411;1932;6452;1742;6115;292;1160;1131;3957;1423;5117
270830;201411;5633;16900;5108;16240;1027;3689;3308;10548;4335;14237
270840;201411;7871;26250;7158;25342;458;2188;6033;21053;6491;23241
270850;201411;7849;25523;7656;25288;1447;5727;5261;16660;6708;22387
270860;201411;11828;35442;10992;34296;1745;6305;7817;23855;9562;30160
270870;201411;2369;6943;1919;5998;310;1013;1160;3637;1470;4650
270880;201411;8109;26373;7647;25698;596;2489;6273;20794;6869;23283
270890;201411;2754;8340;2547;7989;411;1515;1768;5411;2179;6926
270895;201411;3113;11433;2953;11222;256;1047;2450;9427;2706;10474
270900;201411;1973;5379;1595;4826;110;413;1213;3597;1323;4010
270910;201411;3360;11538;3271;11365;334;1505;2580;8689;2914;10194
270915;201411;10275;34577;9305;32817;1778;7168;5444;19004;7222;26172
270920;201411;6658;20499;6260;19943;283;1277;5534;17433;5817;18710
270930;201411;17873;48324;14821;44508;2775;8828;9064;27926;11839;36754
270940;201411;6025;20266;5753;19951;673;2630;4458;15508;5131;18138
280010;201411;734;2162;641;2012;71;282;415;1264;486;1546
280020;201411;5205;15396;4561;14224;879;2887;2820;8812;3699;11699
280030;201411;77896;205613;68385;191276;17801;52012;33610;95734;51411;147746
280040;201411;3306;10218;2947;9709;353;1179;2189;7417;2542;8596
280050;201411;4194;13414;3890;12917;1290;4457;1738;5953;3028;10410
280060;201411;4489;14899;4200;14405;901;3295;2474;8612;3375;11907
280067;201411;7869;22179;6692;20570;789;2526;4909;15175;5698;17701
280070;201411;2006;6766;1908;6613;360;1313;1312;4599;1672;5912
280100;201411;4135;12921;3689;12126;974;3300;1801;6087;2775;9387
280110;201411;1469;4434;1348;4238;81;314;1120;3498;1201;3812
280120;201411;7753;24795;7161;23845;1080;3339;5129;17891;6209;21230
280130;201411;7980;22626;7411;21780;1234;4015;4946;14462;6180;18477
280140;201411;5876;15927;5303;15144;583;1652;4105;11884;4688;13536
280150;201411;3600;11001;3307;10462;511;1854;2171;6666;2682;8520
280160;201411;1562;4429;1406;4194;174;591;1020;3026;1194;3617
280170;201411;4869;14456;4395;13790;502;1505;3411;11026;3913;12531
280190;201411;1202;3408;1063;3185;98;385;773;2214;871;2599
280200;201411;1155;3538;1057;3389;169;677;726;2229;895;2906
280210;201411;13811;42634;12719;41063;2547;8368;8215;27352;10762;35720
280220;201411;1648;4985;1546;4841;113;412;1307;4081;1420;4493
280230;201411;3954;11530;3537;10840;663;2036;2117;6679;2780;8715
280240;201411;3592;10618;3262;10100;278;842;2581;8097;2859;8939
280250;201411;860;2271;724;2062;138;456;434;1143;572;1599
280260;201411;2131;5604;1941;5369;118;318;1689;4711;1807;5029
280270;201411;2320;7181;2023;6697;142;554;1578;5161;1720;5715
280280;201411;4235;13830;3910;13294;964;2771;2159;8269;3123;11040
280290;201411;17797;55547;16128;52835;2700;9576;10529;34959;13229;44535
280300;201411;10315;31465;9508;30538;838;2880;7878;25643;8716;28523
280310;201411;1502;4225;1305;3916;117;445;891;2591;1008;3036
280320;201411;8278;27250;7630;26090;1473;5597;4186;14328;5659;19925
280330;201411;5041;14112;4642;13550;577;1869;3559;10343;4136;12212
280340;201411;3907;11469;3691;11180;331;1093;2933;9032;3264;10125
280350;201411;22652;65084;20829;62337;2833;8709;14809;45063;17642;53772
280360;201411;6089;19192;5740;18648;1173;4281;3444;11057;4617;15338
280370;201411;2037;5772;1829;5443;205;702;1348;3941;1553;4643
280380;201411;1041;3167;956;3055;110;424;739;2334;849;2758
280390;201411;3402;9931;2940;9090;597;1785;1791;5624;2388;7409
280400;201411;4645;13298;4229;12733;980;2794;2633;8343;3613;11137
280410;201411;2453;7929;2146;7318;399;1552;1180;3873;1579;5425
280420;201411;4432;12660;4098;12151;251;782;3544;10575;3795;11357
280430;201411;2329;6069;2145;5844;153;514;1789;4853;1942;5367
280440;201411;5225;15165;4865;14730;455;1353;4075;12514;4530;13867
280445;201411;2539;7241;2322;6869;106;401;1917;5582;2023;5983
280450;201411;9312;25121;8550;24209;750;1699;7141;21032;7891;22731
280460;201411;7431;19737;6619;18610;958;2818;4748;13570;5706;16388
280470;201411;1921;5704;1735;5425;217;688;1269;4025;1486;4713
280480;201411;32475;96894;31058;94822;5274;18260;20826;62341;26100;80601
280490;201411;3858;11783;3435;10984;383;1374;2468;7850;2851;9224
280500;201411;886;2387;833;2319;26;82;752;2078;778;2160
280510;201411;2818;8247;2429;7726;300;1083;1806;5788;2106;6871
280520;201411;1781;5079;1636;4888;187;475;1290;4022;1477;4497
280530;201411;2335;6833;2182;6640;226;731;1768;5443;1994;6174
280540;201411;9624;25931;8989;25088;356;1172;8022;22276;8378;23448
280550;201411;6825;18534;5923;17093;658;2105;4307;12348;4965;14453
280560;201411;8206;24051;7687;23227;604;1968;6253;18855;6857;20823
280570;201411;7052;19526;6324;18584;830;2748;4491;13162;5321;15910
280580;201411;5558;17207;4705;15712;902;3052;2879;9926;3781;12978
280590;201411;2451;7415;2228;7138;302;1279;1594;4996;1896;6275
280600;201411;4122;12589;3842;12126;423;1525;2787;8752;3210;10277
280610;201411;2573;7262;2370;6965;305;1042;1654;4761;1959;5803
280620;201411;5407;16353;4780;15151;826;2527;3100;10108;3926;12635
280630;201411;3897;12689;3708;12407;396;1180;2987;10378;3383;11558
280640;201411;2327;6754;2176;6580;105;233;2001;6182;2106;6415
280650;201411;1189;3671;1068;3456;161;575;719;2337;880;2912
280660;201411;2738;7903;2612;7724;390;1147;2040;6070;2430;7217
280670;201411;15487;40993;14513;39656;2328;6615;10126;27678;12454;34293
280680;201411;2932;7768;2497;7154;168;530;2072;5947;2240;6477
280690;201411;1037;2937;893;2729;132;432;605;1824;737;2256
280700;201411;1198;3502;1041;3268;105;316;758;2437;863;2753
280710;201411;11498;31066;10672;30081;807;2076;9075;25979;9882;28055
280720;201411;2456;6644;2161;6308;257;769;1568;4674;1825;5443
280730;201411;975;2924;928;2858;76;226;785;2465;861;2691
280740;201411;13434;36407;11637;33732;1834;5197;7779;23172;9613;28369
280750;201411;3655;11198;3329;10617;340;1278;2383;7551;2723;8829
280760;201411;5985;18359;5458;17645;740;2403;3959;13293;4699;15696
290010;201411;3118;6978;2226;5597;72;292;1782;4239;1854;4531
290020;201411;5005;15862;4567;15408;390;1096;3968;13770;4358;14866
290030;201411;3388;10638;3225;10386;457;1552;2401;7722;2858;9274
290035;201411;4806;12623;4272;11938;308;913;3483;9990;3791;10903
290040;201411;3921;11229;3521;10761;266;1015;2865;8640;3131;9655
290050;201411;2771;9015;2577;8715;239;916;1980;6723;2219;7639
290060;201411;1358;3451;1134;3178;205;655;809;2205;1014;2860
290070;201411;32290;83517;27712;77775;5998;16989;15162;44776;21160;61765
290080;201411;6161;18679;5373;17653;668;2212;4025;13623;4693;15835
290090;201411;2318;5072;1849;4583;201;479;1522;3855;1723;4334
290100;201411;10489;29863;9253;27854;1623;4903;5757;17993;7380;22896
290110;201411;5442;16356;5206;15964;881;2990;3539;10684;4420;13674
290115;201411;5101;15109;4459;14253;353;1196;3476;11309;3829;12505
290120;201411;7113;19109;6449;18290;416;1180;5578;15908;5994;17088
290130;201411;4653;12256;3983;11444;311;1051;3223;9114;3534;10165
290135;201411;5369;13620;4653;12497;440;1404;3196;8443;3636;9847
290140;201411;4221;13297;3651;12553;327;1196;3029;10483;3356;11679
290150;201411;2144;6408;2044;6252;168;526;1743;5349;1911;5875
290160;201411;3593;9703;3499;9588;275;513;3124;8825;3399;9338
290170;201411;2908;9693;2675;9326;244;965;2222;7758;2466;8723
290180;201411;3126;8927;2736;8343;284;967;2029;6225;2313;7192
290190;201411;4221;13944;4076;13699;446;1554;3090;10511;3536;12065
290195;201411;2254;6240;1920;5740;148;529;1516;4537;1664;5066
290200;201411;3954;12606;3595;11989;379;1312;2740;9216;3119;10528
290205;201411;3096;9541;2810;9088;359;1406;2030;6415;2389;7821
290210;201411;15818;43775;14681;42377;2862;7179;9860;30787;12722;37966
290220;201411;2495;7522;2380;7344;272;1014;1765;5303;2037;6317
290225;201411;3140;8297;2936;8080;177;350;2647;7499;2824;7849
290230;201411;2422;7974;2363;7897;216;767;1989;6705;2205;7472
290240;201411;3987;10504;3594;9957;369;1103;2719;7437;3088;8540
290250;201411;3926;12380;3329;11457;274;987;2603;9092;2877;10079
290260;201411;5078;15046;4513;14189;447;1546;3518;11082;3965;12628
290265;201411;3514;11252;3275;10836;312;1203;2514;8309;2826;9512
290270;201411;12671;45541;11855;44286;1711;6715;8568;32572;10279;39287
290280;201411;5361;17535;5042;16964;489;1742;3807;13067;4296;14809
290290;201411;9939;31889;9049;30410;1622;5588;5972;20544;7594;26132
290300;201411;4486;12867;3190;10425;262;845;2200;7469;2462;8314
290310;201411;1593;4744;1431;4492;250;860;878;2731;1128;3591
290320;201411;28171;85316;24644;80522;5910;20365;13779;45941;19689;66306
290323;201411;4208;11096;3475;10303;222;757;2953;8700;3175;9457
290327;201411;4193;13321;3828;12631;652;2229;2506;8308;3158;10537
290330;201411;1990;5138;1868;5004;219;655;1542;4084;1761;4739
290340;201411;4658;14975;4397;14634;1196;3930;2538;8670;3734;12600
290350;201411;5119;15355;4231;14143;587;1995;2879;9900;3466;11895
290360;201411;4438;13773;3890;13016;212;747;3317;11257;3529;12004
290370;201411;4778;13912;4335;13368;452;1378;3559;11141;4011;12519
290380;201411;5688;16579;4982;15537;428;1449;3949;12368;4377;13817
290390;201411;15901;49590;14823;47831;3043;9637;9107;30700;12150;40337
290395;201411;2837;9141;2552;8649;225;932;1926;6514;2151;7446
290400;201411;3802;11397;3326;10726;370;1219;2518;8171;2888;9390
290405;201411;4584;14672;3976;13589;500;1758;2663;9387;3163;11145
290410;201411;6231;18410;5205;16890;595;2333;3715;11795;4310;14128
290420;201411;3430;10044;2839;9207;276;1008;2218;7163;2494;8171
290430;201411;3615;11248;3225;10630;662;2316;1982;6591;2644;8907
290440;201411;3179;8323;2553;7493;243;784;1995;5934;2238;6718
290450;201411;3685;10703;3217;10033;537;1725;2117;6717;2654;8442
290460;201411;14092;42256;12849;40224;3722;12345;5709;17795;9431;30140
290470;201411;4868;13412;3799;11960;870;3027;1981;6391;2851;9418
290475;201411;5138;17760;4653;16885;556;2343;3310;11974;3866;14317
290480;201411;2697;7050;2384;6628;383;1118;1570;4452;1953;5570
290485;201411;4995;15846;4426;15005;461;2015;3474;11618;3935;13633
290490;201411;8457;22481;8130;22049;738;2142;6702;18147;7440;20289
290500;201411;4705;14865;3947;13442;789;2914;1969;6655;2758;9569
290510;201411;3546;10295;3085;9656;236;862;2482;7806;2718;8668
290515;201411;3063;9254;2790;8861;259;811;2193;7134;2452;7945
290520;201411;12041;37205;9789;33052;1017;4172;6300;21068;7317;25240
290530;201411;5460;15662;4665;14521;426;1371;3704;11594;4130;12965
290540;201411;4035;11667;3835;11413;465;1296;3026;9245;3491;10541
290550;201411;4498;12175;3956;11518;171;501;3560;10441;3731;10942
290560;201411;6178;18359;5404;17213;1192;4034;3078;10006;4270;14040
290570;201411;42120;121218;39426;117190;5076;16038;28727;84927;33803;100965
290580;201411;7562;26062;7224;25547;1322;4631;4989;18194;6311;22825
290590;201411;7793;24457;6514;22302;469;1926;5103;17434;5572;19360
290600;201411;18873;57569;17401;55230;3273;10113;11056;36745;14329;46858
290610;201411;2478;8469;2088;7693;201;927;1514;5469;1715;6396
290620;201411;7326;21708;6536;20561;486;1643;5385;17021;5871;18664
290630;201411;8566;22849;7546;21763;838;2393;6144;17952;6982;20345
290640;201411;2798;8241;2318;7433;243;820;1659;5336;1902;6156
290650;201411;12277;36100;11521;35002;2794;8438;7004;21950;9798;30388
290660;201411;3844;10568;3143;9569;218;746;2484;7629;2702;8375
290670;201411;7227;22063;6552;21001;855;2680;4822;15947;5677;18627
290680;201411;10364;30737;9492;29696;606;2048;7954;25081;8560;27129
290682;201411;4643;13533;4171;12882;202;785;3482;10642;3684;11427
290685;201411;3417;8653;2515;7389;324;1027;1532;4600;1856;5627
290687;201411;8483;22823;6671;20535;1498;4836;3739;11818;5237;16654
290689;201411;3224;9224;2720;8435;253;825;2126;6693;2379;7518
290690;201411;5686;16481;5174;15828;550;1749;4104;12662;4654;14411
290700;201411;2300;7218;2194;7062;205;754;1729;5567;1934;6321
290710;201411;8005;25375;7404;24465;482;1565;6358;21272;6840;22837
290720;201411;19493;56828;17390;54253;1776;5083;14258;45786;16034;50869
290730;201411;7522;20942;6830;20038;1186;3413;4696;13990;5882;17403
290740;201411;966;2884;816;2638;117;398;527;1736;644;2134
290750;201411;10642;30269;9060;27378;1788;6169;4894;14083;6682;20252
290755;201411;2478;6938;2053;6224;133;477;1589;4795;1722;5272
290760;201411;4594;13471;3738;12161;420;1298;2656;8781;3076;10079
290770;201411;2689;9349;2490;9092;138;628;2032;7483;2170;8111
290780;201411;9238;23798;8141;22302;867;1991;6272;17850;7139;19841
290790;201411;4905;14456;4546;13949;416;1233;3615;11435;4031;12668
290800;201411;7671;16456;5880;14553;823;1801;4476;11570;5299;13371
290810;201411;5149;16314;4426;15163;322;1220;3361;11638;3683;12858
290820;201411;5593;15973;4996;15175;479;1621;3868;11787;4347;13408
290830;201411;4198;11683;3920;11250;247;938;3211;8967;3458;9905
290840;201411;18484;51961;16760;49581;2777;7858;11488;35530;14265;43388
290850;201411;6980;20616;6829;20398;1113;3208;5166;15944;6279;19152
290860;201411;5075;17640;4741;17220;695;2547;3515;13170;4210;15717
290870;201411;4967;14810;4124;13612;444;1759;2994;9793;3438;11552
290880;201411;1456;4039;1197;3623;109;340;827;2527;936;2867
290890;201411;7153;19015;6230;17966;750;2128;4907;14376;5657;16504
290900;201411;2558;7347;1884;6210;296;1055;981;3226;1277;4281
290910;201411;5056;13773;4309;12696;258;815;3613;10700;3871;11515
290920;201411;5045;14686;4540;13990;331;933;3742;11748;4073;12681
290930;201411;7859;24867;7029;23442;683;2674;5254;17284;5937;19958
290940;201411;3634;11568;3384;11241;288;952;2863;9729;3151;10681
290950;201411;1600;4500;1435;4259;209;624;990;3003;1199;3627
290960;201411;6164;17395;5621;16678;394;1199;4585;13760;4979;14959
290970;201411;3811;12202;3441;11546;488;1643;2224;7686;2712;9329
290980;201411;10997;32406;9560;29642;2753;8962;3709;11401;6462;20363
290990;201411;9456;28346;8297;26453;951;3194;6207;19795;7158;22989
291000;201411;3344;9995;3074;9646;348;1121;2436;7767;2784;8888
291005;201411;14526;39922;13022;37780;2114;6430;8925;26238;11039;32668
291010;201411;3209;10284;2578;8884;315;1149;1646;5732;1961;6881
291020;201411;1447;3824;1113;3235;139;477;672;1867;811;2344
291030;201411;2319;6356;1726;5168;192;640;1064;3112;1256;3752
291040;201411;5876;17877;5334;17105;657;2314;3984;12783;4641;15097
291050;201411;8212;27209;7462;25765;2067;7761;3654;12485;5721;20246
291060;201411;6443;23551;6100;23084;892;3836;4359;16447;5251;20283
291070;201411;16937;49235;15392;47039;1735;5301;11527;35877;13262;41178
291072;201411;23243;70449;19510;63035;5937;20340;7573;25220;13510;45560
291075;201411;5420;15469;4904;14779;389;1063;3787;11807;4176;12870
291077;201411;1601;4612;1324;4172;167;601;871;2710;1038;3311
291080;201411;85601;264318;75997;246406;24495;81919;27176;87286;51671;169205
291085;201411;5924;15713;5134;14659;576;1704;4010;11543;4586;13247
291090;201411;1536;3809;1345;3566;107;406;1104;2825;1211;3231
291100;201411;2726;7127;2233;6615;119;451;1885;5579;2004;6030
291110;201411;5233;18567;4682;17704;680;2896;3224;12095;3904;14991
291120;201411;7819;20882;7248;20064;941;2658;5427;15149;6368;17807
291125;201411;1835;3857;1450;3451;132;316;1115;2714;1247;3030
291130;201411;3054;9358;2650;8676;247;955;1903;6154;2150;7109
291140;201411;4304;12792;3868;11987;578;1821;2627;8216;3205;10037
291150;201411;2047;5349;1947;5230;179;507;1520;4065;1699;4572
291160;201411;5665;17467;4932;16322;1264;4206;2683;9061;3947;13267
291165;201411;2549;7394;2011;6372;119;520;1456;4474;1575;4994
291170;201411;21482;55758;18489;51978;1131;3799;14741;41216;15872;45015
291180;201411;6685;17511;5392;15640;633;2038;3825;11025;4458;13063
291185;201411;3998;10857;3689;10441;322;981;3053;8614;3375;9595
291190;201411;7742;21265;6892;20222;790;2362;5360;16011;6150;18373
291200;201411;2808;8510;2318;7606;185;642;1683;5595;1868;6237
291210;201411;7787;18343;6709;17118;547;1449;5426;13892;5973;15341
291220;201411;4358;13853;4073;13367;577;2108;2894;9407;3471;11515
291230;201411;4134;10677;3715;10193;121;301;3402;9434;3523;9735
291240;201411;5012;13391;4231;12027;260;782;3397;9543;3657;10325
291250;201411;3848;11493;3026;10104;338;1176;2057;6955;2395;8131
291260;201411;1195;3494;1105;3366;113;390;850;2577;963;2967
291270;201411;4345;14436;3998;13800;1136;4090;2172;7628;3308;11718
291280;201411;2489;6509;1871;5653;465;1463;1023;3084;1488;4547
291290;201411;6098;17062;5436;16223;892;2662;3555;10933;4447;13595
291300;201411;4691;13641;3922;12362;487;1727;2707;8451;3194;10178
291310;201411;5623;15978;4820;14578;382;1201;3746;11343;4128;12544
291320;201411;6348;20156;5451;18433;1304;4843;2881;9600;4185;14443
291330;201411;1730;5219;1579;4980;219;796;1040;3172;1259;3968
291340;201411;4179;12046;3344;10846;278;1039;2627;8485;2905;9524
291345;201411;3607;11634;3387;11394;216;690;2984;10281;3200;10971
291350;201411;6036;17804;5314;16587;440;1465;3976;12559;4416;14024
291360;201411;36694;105143;33889;100995;8640;25474;19806;61152;28446;86626
291370;201411;9310;26993;8899;26449;954;2757;6891;21022;7845;23779
291380;201411;3922;12029;3382;11140;277;962;2496;8417;2773;9379
291390;201411;10868;29885;9888;28726;1439;4010;7439;22003;8878;26013
291400;201411;17529;45731;14295;41403;2431;7022;9130;27506;11561;34528
291410;201411;3413;8879;2522;7584;192;766;1909;5580;2101;6346
291420;201411;2292;6073;2018;5746;117;332;1790;5150;1907;5482
291430;201411;3493;10116;3074;9569;244;968;2418;7389;2662;8357
291440;201411;6372;19855;5448;18216;571;2002;4093;13822;4664;15824
291450;201411;7950;24263;7075;22965;348;1121;5901;19587;6249;20708
291460;201411;13979;41989;12396;39542;2239;7591;7889;25366;10128;32957
291465;201411;8646;24851;7831;23913;771;2542;6367;19497;7138;22039
291470;201411;16419;44940;14470;42522;1479;4218;10911;33233;12390;37451
291480;201411;37009;99188;32768;93329;5105;16182;21548;61018;26653;77200
291490;201411;4634;15091;4510;14922;470;1535;3720;12523;4190;14058
291500;201411;4342;12552;3712;11641;291;1061;2944;9207;3235;10268
291510;201411;3784;11413;3476;11004;149;473;3127;10002;3276;10475
291520;201411;4184;11200;3641;10458;528;1489;2400;7150;2928;8639
291530;201411;2192;6320;1858;5803;476;1584;958;3083;1434;4667
291535;201411;4493;12951;4030;12274;333;1053;3106;9771;3439;10824
291540;201411;2329;5533;1980;5168;190;385;1671;4523;1861;4908
291550;201411;5822;15634;5208;14789;1226;3429;3011;8729;4237;12158
291560;201411;18245;45647;13944;40726;1332;3941;10757;32216;12089;36157
291570;201411;2537;6734;2403;6574;166;382;2149;6009;2315;6391
291580;201411;5689;17433;5046;16481;619;2459;3632;11783;4251;14242
291590;201411;2048;6326;1839;5984;278;936;1231;4168;1509;5104
291600;201411;5710;15682;4254;13502;1039;3643;2011;6249;3050;9892
291610;201411;5330;16113;5166;15898;358;1170;4445;13799;4803;14969
291620;201411;3185;7518;2619;6916;192;479;2071;5684;2263;6163
291630;201411;3268;8161;2830;7661;303;797;2257;6224;2560;7021
291640;201411;18486;50152;15130;45574;4166;13309;5929;18180;10095;31489
291650;201411;8430;24870;7721;24025;692;1753;6471;20857;7163;22610
291660;201411;2552;6613;2162;6061;246;827;1474;3969;1720;4796
291670;201411;2539;6983;2334;6665;372;1070;1399;4266;1771;5336
291680;201411;5139;14490;4599;13618;1099;3578;2261;6941;3360;10519
291685;201411;4846;12027;4049;11005;573;1532;2869;8068;3442;9600
291690;201411;4145;11244;3401;10069;325;954;2411;7223;2736;8177
291700;201411;9802;30312;8942;28857;1043;3470;6606;21713;7649;25183
291710;201411;6299;16511;5419;15380;903;2668;3452;10271;4355;12939
291720;201411;4243;14258;3683;13104;399;1651;2642;9270;3041;10921
291730;201411;6365;19549;5827;18834;964;3300;4154;13687;5118;16987
291733;201411;2698;7888;2274;7322;316;1101;1527;4940;1843;6041
291735;201411;2605;7385;2196;6767;128;470;1786;5432;1914;5902
291740;201411;4153;11988;3313;10705;353;1292;2373;7651;2726;8943
291750;201411;23076;59902;17963;52143;4059;12223;9435;27902;13494;40125
291760;201411;12938;40277;11601;37900;4503;16256;4017;12971;8520;29227
291770;201411;8358;23991;7414;22348;1186;3891;4884;14518;6070;18409
291780;201411;4506;13725;4222;13208;442;1403;3297;10347;3739;11750
291790;201411;2619;8086;2478;7891;121;501;2144;6759;2265;7260
291800;201411;33754;95387;30072;90182;6001;18421;18398;56888;24399;75309
291810;201411;11356;31588;9588;29470;624;2227;7835;24169;8459;26396
291820;201411;3812;11297;3426;10737;304;982;2691;8514;2995;9496
291830;201411;4555;12212;4201;11702;494;1453;3196;8960;3690;10413
291835;201411;6414;19820;5184;17699;1320;4866;2911;9891;4231;14757
291840;201411;51354;139891;43512;131337;5684;16494;33017;102842;38701;119336
291845;201411;3106;8884;2777;8493;231;633;2420;7546;2651;8179
291850;201411;4944;13800;4096;12571;460;1334;3061;9711;3521;11045
291855;201411;1792;4649;1543;4326;186;653;1143;3083;1329;3736
291860;201411;2146;6289;1820;5667;174;639;1185;3628;1359;4267
291870;201411;1444;3849;1091;3218;120;404;679;1987;799;2391
291875;201411;2958;9371;2661;8909;230;966;1919;6299;2149;7265
291880;201411;4854;15427;4568;14977;355;1170;3806;12609;4161;13779
291890;201411;1460;3664;1232;3389;312;875;732;2088;1044;2963
291900;201411;1353;3785;1148;3464;108;378;887;2659;995;3037
291905;201411;3056;8043;2509;7150;223;725;1768;5060;1991;5785
291910;201411;2782;7454;2360;6946;174;624;1950;5693;2124;6317
291915;201411;7198;21892;6202;20052;495;1671;4996;16366;5491;18037
291920;201411;33267;97361;30587;93321;6292;19871;18278;57010;24570;76881
291930;201411;2663;7872;2388;7434;248;864;1764;5484;2012;6348
291940;201411;3649;10323;2653;8495;411;1475;1481;4579;1892;6054
291950;201411;9538;31936;8648;30468;1847;6498;4950;18017;6797;24515
291955;201411;9482;29634;9030;28989;2157;6823;5408;18101;7565;24924
291960;201411;3451;10167;2882;9333;335;1009;2074;7053;2409;8062
291970;201411;4457;13372;3963;12730;564;1927;2765;8983;3329;10910
291980;201411;11765;33869;8990;29856;975;3402;6432;21842;7407;25244
291990;201411;2363;7188;2144;6867;173;586;1667;5457;1840;6043
291992;201411;2941;9019;2866;8868;447;1467;2106;6467;2553;7934
291995;201411;2211;6475;1972;6125;245;805;1478;4641;1723;5446
292000;201411;2314;6739;2048;6353;315;1121;1438;4397;1753;5518
292010;201411;6615;16818;5042;14510;493;1432;3859;11173;4352;12605
292020;201411;4623;15464;4286;14919;699;2546;2985;10570;3684;13116
292030;201411;2265;6987;2011;6618;267;955;1217;4038;1484;4993
292040;201411;4801;13190;4224;12589;325;846;3590;11115;3915;11961
292045;201411;2850;9727;2803;9659;100;338;2637;9089;2737;9427
292050;201411;6552;20345;5715;18668;569;2236;3860;12439;4429;14675
292060;201411;11930;32324;11175;31374;1098;2956;9109;25830;10207;28786
292070;201411;4587;14423;4442;14238;405;1210;3770;12250;4175;13460
292080;201411;3846;9868;3278;9142;270;783;2646;7457;2916;8240
292090;201411;4403;11520;3747;10777;321;1063;3064;8858;3385;9921
292100;201411;11294;31125;9517;28636;2752;8596;4284;13472;7036;22068
292105;201411;3279;10009;2832;9356;220;865;2266;7473;2486;8338
292110;201411;7284;19151;5577;16602;1230;3701;3178;9767;4408;13468
292120;201411;8822;24500;7755;22622;1663;4897;4057;12569;5720;17466
292130;201411;3216;8636;2852;8119;562;1508;1866;5472;2428;6980
292140;201411;5652;14490;4870;13422;974;2595;3006;8712;3980;11307
292145;201411;2775;8473;2526;8086;206;654;1918;6412;2124;7066
292150;201411;13897;42127;12850;40470;906;3238;10102;32192;11008;35430
292160;201411;2846;8124;2448;7598;164;481;2088;6619;2252;7100
292170;201411;9428;27050;7996;24602;1144;3895;5036;15606;6180;19501
292180;201411;3655;10434;2902;9237;440;1374;1870;6095;2310;7469
292190;201411;3449;9671;2920;8907;593;1895;1818;5638;2411;7533
292200;201411;6618;21520;5791;19894;1686;6244;2471;8480;4157;14724
292205;201411;4132;12668;3721;12096;269;999;3003;9753;3272;10752
292210;201411;6904;19068;5844;17644;532;1723;4569;14024;5101;15747
292220;201411;2019;5603;1859;5382;387;1064;1135;3331;1522;4395
292225;201411;3206;9895;2942;9507;187;678;2440;7954;2627;8632
292230;201411;6504;19521;6184;19020;548;2192;4777;14203;5325;16395
292240;201411;4565;14233;4167;13379;605;2057;2672;8505;3277;10562
292250;201411;5284;16354;4902;15633;1148;3837;2510;8008;3658;11845
292260;201411;3272;9966;3122;9743;294;977;2534;7929;2828;8906
292265;201411;2917;9409;2619;8872;193;774;1980;6662;2173;7436
292270;201411;4285;11044;3396;10009;244;868;2780;8198;3024;9066
292273;201411;2876;6971;2218;6152;291;747;1609;4724;1900;5471
292275;201411;1950;5072;1746;4759;214;629;1289;3491;1503;4120
292280;201411;2115;6280;1915;6062;199;477;1495;5086;1694;5563
292285;201411;2723;7498;2372;6997;206;676;1849;5528;2055;6204
292290;201411;7650;22664;6391;20963;475;1773;5012;16645;5487;18418
292300;201411;9096;27272;7809;25767;1932;6525;4763;16221;6695;22746
292303;201411;2958;9118;2749;8834;129;495;2377;7614;2506;8109
292305;201411;3262;8776;3085;8541;128;384;2770;7694;2898;8078
292310;201411;6256;18290;5700;17525;254;891;4836;14885;5090;15776
292320;201411;6586;19157;5698;17657;572;1939;4376;13559;4948;15498
292330;201411;2095;5825;1956;5632;189;621;1554;4408;1743;5029
292335;201411;5517;14397;4922;13617;537;1439;3963;11119;4500;12558
292340;201411;6775;19127;5736;17445;657;2047;4003;12293;4660;14340
292350;201411;2246;6771;2057;6517;234;858;1614;5099;1848;5957
292360;201411;5178;14649;4973;14112;182;510;4414;12780;4596;13290
292370;201411;9438;27404;8531;26060;1123;3228;6111;19528;7234;22756
292380;201411;7665;22225;7128;21379;567;1582;5870;17857;6437;19439
292390;201411;3840;8603;3376;8099;116;196;3147;7653;3263;7849
292400;201411;22673;67375;21564;65609;3327;10607;15167;46957;18494;57564
292405;201411;4702;12112;3981;11209;277;779;3293;9355;3570;10134
292410;201411;1998;5347;1888;5221;141;376;1649;4596;1790;4972
292420;201411;3939;12578;3769;12364;171;469;3425;11476;3596;11945
292430;201411;5779;17193;4515;15416;331;1329;3394;11559;3725;12888
292440;201411;8845;28946;8172;27950;308;1209;7179;24889;7487;26098
292450;201411;4488;13255;3635;11890;352;1220;2621;8732;2973;9952
292460;201411;5783;17189;5056;15902;976;3218;3135;9935;4111;13153
292465;201411;2552;7610;2122;6912;229;855;1490;4887;1719;5742
292467;201411;2097;6785;1984;6594;367;1305;1320;4444;1687;5749
292470;201411;3305;8739;2700;7777;231;765;2042;5828;2273;6593
292480;201411;6609;17351;5663;16074;331;1060;4825;13683;5156;14743
292490;201411;2413;6620;2014;6038;182;638;1562;4631;1744;5269
292500;201411;6802;20277;5876;18678;712;2424;4129;13320;4841;15744
292510;201411;13751;38956;12075;36567;1227;3900;9308;28689;10535;32589
292520;201411;6188;18509;5563;17518;1574;5027;2850;9110;4424;14137
292525;201411;5704;14883;4938;13980;363;1083;4057;11622;4420;12705
292530;201411;27623;81086;24762;77225;6242;20058;13516;43626;19758;63684
292540;201411;2995;8502;2685;8082;333;1137;2039;6134;2372;7271
292550;201411;6950;22057;6115;20886;829;3014;4410;15412;5239;18426
292560;201411;4305;11798;3662;10933;291;1063;2949;8659;3240;9722
292570;201411;4203;12385;4033;12205;158;437;3578;11208;3736;11645
292575;201411;6341;21415;6153;21101;908;3239;4666;16039;5574;19278
292580;201411;7234;21418;6677;20704;546;1696;5534;17393;6080;19089
292590;201411;7594;23446;7234;22858;818;2696;5555;17584;6373;20280
292593;201411;3348;8704;2823;7931;269;765;2200;6175;2469;6940
292595;201411;6275;17313;5456;16241;495;1566;4204;12642;4699;14208
292600;201411;10955;30926;10145;29889;971;2316;8291;25276;9262;27592
292610;201411;4515;12994;3662;11567;421;1387;2437;7884;2858;9271
292620;201411;6100;17875;5293;16934;214;697;4823;15563;5037;16260
292630;201411;10140;25617;8699;23460;866;2382;6482;17824;7348;20206
292640;201411;8600;27321;7639;26032;631;2286;5902;20568;6533;22854
292650;201411;5162;13924;4919;13602;498;984;4091;11979;4589;12963
292660;201411;11605;34693;10869;33634;1295;4142;8289;26125;9584;30267
292665;201411;2725;8111;2652;8003;65;156;2522;7687;2587;7843
292670;201411;4012;11301;3096;9751;309;1068;2024;6406;2333;7474
292680;201411;3781;11367;3515;10959;415;1231;2741;8652;3156;9883
292690;201411;3485;9335;2476;7749;295;990;1659;5300;1954;6290
292700;201411;9198;27603;8059;25912;1122;3358;5670;19066;6792;22424
292710;201411;2008;6593;1906;6445;83;309;1712;5819;1795;6128
292720;201411;10005;25519;8721;24056;700;1948;7331;20465;8031;22413
292730;201411;3688;11096;3543;10883;449;1385;2626;8196;3075;9581
292740;201411;380747;1049410;360182;1019297;81573;243042;218771;618259;300344;861301
292750;201411;6477;17435;5634;16277;394;1160;4617;13504;5011;14664
292760;201411;4335;13723;3954;13053;569;1995;2618;8770;3187;10765
292770;201411;6304;19116;5870;18423;1308;4116;3598;11650;4906;15766
292780;201411;1946;4683;1515;4140;179;609;1101;2950;1280;3559
292790;201411;3548;9200;3385;9025;230;473;2948;8166;3178;8639
292800;201411;9811;29316;9086;28133;842;2907;7143;22058;7985;24965
292805;201411;3300;9491;2993;9055;554;1796;2020;6122;2574;7918
292810;201411;10354;30951;8649;28634;1187;4084;6206;21028;7393;25112
292820;201411;7724;21927;5615;18883;397;1562;4477;15114;4874;16676
292830;201411;1963;5767;1783;5515;100;407;1495;4560;1595;4967
292840;201411;7876;24724;7371;24020;395;1468;6473;21013;6868;22481
292850;201411;3349;8858;2758;7983;309;959;1995;5725;2304;6684
292860;201411;15760;42647;15028;41664;1879;5361;11620;32392;13499;37753
292870;201411;20411;56287;17813;52260;2976;9574;10735;31131;13711;40705
292880;201411;12630;36693;11257;34649;1479;4954;7706;23548;9185;28502
292890;201411;5959;20158;5340;19002;965;3640;3181;11567;4146;15207
292895;201411;2829;7044;2245;6167;317;887;1603;4383;1920;5270
292900;201411;3163;9766;2982;9484;357;1407;2085;6400;2442;7807
292905;201411;4429;12747;3671;11753;253;713;3031;9988;3284;10701
292910;201411;5317;16161;4819;15241;841;2892;2978;9342;3819;12234
292920;201411;9057;26882;8561;26134;826;2858;6737;20083;7563;22941
292925;201411;5317;16313;4686;15420;469;1586;3572;11869;4041;13455
292930;201411;6676;21549;6358;20977;645;2670;4765;15370;5410;18040
292935;201411;2178;6166;1819;5777;119;297;1543;5105;1662;5402
292937;201411;3385;8626;2837;7936;306;974;2182;6037;2488;7011
292940;201411;3218;8828;2534;7873;317;997;1735;5603;2052;6600
292950;201411;8592;25883;8132;25080;998;3622;5876;17664;6874;21286
292960;201411;5161;13709;4513;12812;463;1433;3305;9313;3768;10746
292970;201411;4535;13571;4022;12902;199;802;3357;10803;3556;11605
292975;201411;3550;9628;3369;9361;368;994;2790;7855;3158;8849
292980;201411;3673;9878;2961;8962;379;1311;2058;6176;2437;7487
292990;201411;12521;35854;11278;33977;704;2249;9537;28772;10241;31021
293000;201411;3031;7899;2495;7218;122;412;2151;6231;2273;6643
293010;201411;19604;54821;17005;50682;3040;9821;10385;30836;13425;40657
293015;201411;8256;26571;6666;24101;1043;4164;4295;15464;5338;19628
293020;201411;9743;32097;9097;31182;625;2432;7511;25988;8136;28420
293030;201411;5832;16826;4648;15026;451;1495;3242;10941;3693;12436
293040;201411;3662;12020;3488;11662;183;662;3093;10324;3276;10986
293050;201411;21158;59142;18725;56018;2823;8646;12651;38740;15474;47386
293060;201411;4459;11429;3708;10235;421;1245;2555;7011;2976;8256
293070;201411;21740;65208;19672;61678;5315;16922;10025;32328;15340;49250
293075;201411;3509;11448;3178;10991;259;949;2571;8982;2830;9931
293076;201411;3865;10757;3561;10321;265;737;2983;8812;3248;9549
293077;201411;5106;15816;4427;14921;1089;3866;2399;8193;3488;12059
293080;201411;4934;15568;4499;14869;334;1456;3536;11450;3870;12906
293090;201411;3649;11399;2975;10431;306;1099;2223;7932;2529;9031
293100;201411;5989;18049;5094;16473;560;1936;3732;12206;4292;14142
293105;201411;4011;13351;3537;12440;497;1846;2413;8625;2910;10471
293110;201411;2076;6109;1883;5815;124;445;1548;4753;1672;5198
293120;201411;4168;13668;3859;13227;396;1291;3016;10603;3412;11894
293130;201411;4185;11719;3428;10861;191;676;3031;9738;3222;10414
293135;201411;31335;79889;23761;69341;4889;16474;11231;32284;16120;48758
293140;201411;2184;6354;2089;6215;218;764;1596;4641;1814;5405
293150;201411;5947;19515;5301;18254;1036;3706;3146;11167;4182;14873
293160;201411;3706;9905;3452;9613;475;957;2679;7949;3154;8906
293170;201411;3569;10685;3280;10250;474;1612;2306;7293;2780;8905
293180;201411;5530;15492;4520;13917;343;1250;3506;10650;3849;11900
293190;201411;14312;43300;13454;42003;593;2637;11638;35701;12231;38338
293200;201411;6696;19225;5868;18110;282;1021;4995;15449;5277;16470
293210;201411;5240;15230;4752;14424;466;1548;3559;10835;4025;12383
293220;201411;5392;16061;4768;14998;1232;4032;2347;7483;3579;11515
293230;201411;4135;12806;3774;12268;599;2104;2646;8643;3245;10747
293240;201411;4684;12359;3632;10725;180;579;2804;8254;2984;8833
293245;201411;4621;13153;4197;12490;491;1481;3042;9332;3533;10813
293250;201411;6070;16999;5553;16236;665;2039;4037;11810;4702;13849
293260;201411;4914;14580;4082;13369;374;1342;3031;10028;3405;11370
293270;201411;5950;16201;5625;15852;535;1326;4853;14013;5388;15339
293280;201411;5794;16153;4997;15106;457;1275;3868;12080;4325;13355
293290;201411;16861;56179;15854;54166;3794;13522;8503;29601;12297;43123
293300;201411;6936;16943;5925;15806;472;1201;4842;13100;5314;14301
293305;201411;4934;12274;4276;11372;270;769;3573;9510;3843;10279
293310;201411;2819;7207;2280;6322;238;709;1598;4390;1836;5099
293315;201411;5044;12675;4539;11928;735;1883;2896;8033;3631;9916
293317;201411;2641;7696;2360;7177;272;871;1561;4743;1833;5614
293320;201411;8261;27387;8065;27135;687;2496;6822;23021;7509;25517
293325;201411;1969;5705;1641;5198;245;837;1112;3564;1357;4401
293330;201411;56226;178178;50541;168382;11518;41302;26917;90571;38435;131873
293340;201411;2757;7851;2180;6844;313;1096;1459;4483;1772;5579
293345;201411;3737;10950;3117;10091;356;1134;2276;7634;2632;8768
293350;201411;6929;19331;6595;18941;403;989;5878;17284;6281;18273
293360;201411;14237;43040;12924;41332;861;2705;11035;35964;11896;38669
310010;201411;1228;3322;885;2772;226;856;368;1046;594;1902
310020;201411;3902;12409;3246;10980;1119;4080;605;1859;1724;5939
310030;201411;2647;8550;2262;7857;642;2417;1136;3889;1778;6306
310040;201411;1054;2869;877;2621;87;298;665;1974;752;2272
310050;201411;1963;6802;1747;6291;333;1415;903;3203;1236;4618
310060;201411;3357;10989;2995;10505;378;1391;2267;8053;2645;9444
310070;201411;327;933;253;794;30;127;142;406;172;533
310080;201411;805;2478;654;2181;174;675;239;735;413;1410
310090;201411;5053;14960;4355;13739;681;2377;2684;8469;3365;10846
310100;201411;3496;10568;2901;9566;275;1093;2167;7092;2442;8185
310110;201411;6117;17186;5113;15660;1134;3952;2816;8522;3950;12474
310120;201411;623;1988;563;1886;210;842;243;693;453;1535
310130;201411;479;1491;437;1424;104;398;226;689;330;1087
310140;201411;267;930;233;867;82;343;52;168;134;511
310150;201411;5173;15965;4631;14959;1041;3761;2312;7429;3353;11190
310160;201411;7960;25284;6630;22877;2011;7662;2361;8084;4372;15746
310163;201411;878;2933;755;2680;207;813;299;1018;506;1831
310170;201411;10302;29022;9427;27718;1651;4992;6136;18668;7787;23660
310180;201411;1941;5617;1582;5108;411;1491;761;2370;1172;3861
310190;201411;2643;8882;2399;8471;761;2965;431;1574;1192;4539
310200;201411;1988;6656;1668;5994;482;1921;581;2047;1063;3968
310205;201411;1104;3282;905;2954;182;601;525;1761;707;2362
310210;201411;2675;8192;2447;7854;318;1148;1818;5828;2136;6976
310220;201411;1289;3669;1039;3342;224;791;594;1869;818;2660
310230;201411;3042;9872;2596;8881;742;2912;1049;3312;1791;6224
310240;201411;1055;3675;901;3386;160;667;454;1798;614;2465
310250;201411;999;3407;970;3358;226;900;546;1802;772;2702
310260;201411;3293;10536;2703;9279;686;2650;1015;3367;1701;6017
310270;201411;2570;7485;2258;7025;201;665;1775;5595;1976;6260
310280;201411;2287;6431;2012;6007;445;1645;1073;3023;1518;4668
310285;201411;2239;7846;2100;7639;297;1130;1577;5864;1874;6994
310290;201411;1362;4269;1270;4128;373;1383;607;1787;980;3170
310300;201411;1951;6627;1840;6401;522;1991;993;3406;1515;5397
310310;201411;397;1090;287;863;54;159;135;407;189;566
310320;201411;420;1376;358;1245;68;296;175;587;243;883
310330;201411;524;1323;377;1063;42;155;206;519;248;674
310340;201411;8877;27269;7571;25080;1552;5387;4196;14281;5748;19668
310350;201411;16379;46198;12526;39480;4204;14421;3526;11092;7730;25513
310360;201411;488;1520;472;1493;79;291;320;964;399;1255
310370;201411;1515;5330;1457;5220;421;1577;787;2833;1208;4410
310375;201411;1454;3922;977;3061;175;628;422;1260;597;1888
310380;201411;408;1147;321;1026;129;458;127;372;256;830
310390;201411;510;1832;435;1661;117;484;78;259;195;743
310400;201411;10739;32198;8535;28199;2677;9641;2579;8518;5256;18159
310410;201411;1080;3492;707;2874;248;1073;153;617;401;1690
310420;201411;5978;17265;3576;11766;824;3035;623;1814;1447;4849
310430;201411;1704;5792;1402;5170;460;1819;361;1295;821;3114
310440;201411;641;1868;543;1708;148;510;225;686;373;1196
310445;201411;1277;4134;1056;3715;162;620;642;2236;804;2856
310450;201411;4825;13819;3929;12513;697;2371;2522;8211;3219;10582
310460;201411;1697;5433;1457;5006;480;1802;335;1198;815;3000
310470;201411;3882;9907;3227;9078;322;997;2532;7187;2854;8184
310480;201411;1236;3747;993;3262;238;917;415;1240;653;2157
310490;201411;3406;11477;2993;10678;1000;3921;1137;4009;2137;7930
310500;201411;1565;5409;1437;5141;427;1666;584;2061;1011;3727
310510;201411;2685;8776;2233;7725;790;2966;465;1535;1255;4501
310520;201411;1459;3904;1157;3407;88;265;781;2318;869;2583
310530;201411;900;2857;540;1899;111;440;111;350;222;790
310540;201411;3870;12712;3559;12239;1226;4426;1416;4948;2642;9374
310550;201411;1266;3771;1042;3376;286;1106;450;1325;736;2431
310560;201411;17104;53349;14621;48419;4590;16851;4918;15453;9508;32304
310570;201411;1292;3984;1209;3875;168;592;899;2883;1067;3475
310590;201411;4276;12544;3366;10790;644;2321;1330;4073;1974;6394
310600;201411;1664;5631;1546;5368;533;2069;531;1711;1064;3780
310610;201411;588;1972;537;1872;161;666;180;555;341;1221
310620;201411;195774;619218;161558;549999;43401;164557;62366;203268;105767;367825
310630;201411;4379;14140;4151;13722;773;2893;2802;9068;3575;11961
310640;201411;1491;4569;1195;4028;423;1536;289;903;712;2439
310650;201411;2983;9522;2415;8542;464;1791;1334;4835;1798;6626
310660;201411;1440;4341;1254;4076;179;616;920;2972;1099;3588
310665;201411;1266;3960;1154;3793;192;675;798;2661;990;3336
310670;201411;58797;184778;53846;173803;16105;54528;22813;72891;38918;127419
310680;201411;824;2407;740;2274;175;575;382;1161;557;1736
310690;201411;1364;4510;1098;3997;335;1400;313;1056;648;2456
310700;201411;559;1506;452;1354;128;432;225;645;353;1077
310710;201411;7530;24446;5912;21754;1636;6710;1658;5998;3294;12708
310720;201411;885;2705;806;2559;231;842;361;1066;592;1908
310730;201411;10028;31470;9080;29942;2026;7261;5391;17809;7417;25070
310740;201411;5524;18466;4620;16586;1567;6174;1097;3746;2664;9920
310750;201411;1706;4345;1363;3895;228;656;941;2723;1169;3379
310760;201411;655;2036;553;1854;139;512;231;747;370;1259
310770;201411;849;3008;791;2902;284;1160;352;1230;636;2390
310780;201411;3883;11020;3400;10177;602;1844;2095;6287;2697;8131
310790;201411;1926;6135;1710;5739;464;1624;806;2793;1270;4417
310800;201411;3177;10262;2510;8935;991;3878;389;1324;1380;5202
310810;201411;1543;4347;1397;4099;320;1024;697;1976;1017;3000
310820;201411;1563;4384;1112;3583;305;1085;350;1077;655;2162
310825;201411;2508;8510;2007;7614;168;864;1473;5515;1641;6379
310830;201411;1484;4946;1181;4311;386;1500;354;1233;740;2733
310840;201411;2418;7822;2032;7098;770;2953;555;1818;1325;4771
310850;201411;1611;4805;1371;4486;212;781;987;3212;1199;3993
310855;201411;3291;10572;2908;9957;665;2427;1745;6085;2410;8512
310860;201411;8243;25417;7143;23516;1162;4076;4196;14173;5358;18249
310870;201411;1019;2891;830;2569;164;552;431;1318;595;1870
310880;201411;1273;3923;969;3354;204;823;458;1552;662;2375
310890;201411;2854;9072;2275;7985;672;2661;690;2295;1362;4956
310900;201411;4673;15565;3962;14091;1162;4586;1535;5261;2697;9847
310910;201411;2170;6200;1439;4790;396;1477;346;1084;742;2561
310920;201411;2009;6089;1603;5502;406;1576;766;2625;1172;4201
310925;201411;977;3227;886;3065;351;1334;289;994;640;2328
310930;201411;5758;16707;4612;14940;833;2944;2725;9015;3558;11959
310940;201411;6446;18749;5413;17133;1059;3631;2991;9439;4050;13070
310945;201411;1393;3975;1150;3633;229;843;674;2034;903;2877
310950;201411;2130;6998;1640;5883;530;2130;487;1613;1017;3743
310960;201411;500;1692;425;1548;158;632;138;495;296;1127
310970;201411;1607;5490;1179;4398;389;1592;175;570;564;2162
310980;201411;481;1249;323;951;56;201;146;378;202;579
310990;201411;1242;4257;1060;3849;272;1118;333;1107;605;2225
311000;201411;3627;12493;3174;11505;911;3799;1146;3861;2057;7660
311010;201411;997;3204;890;3011;279;1004;428;1420;707;2424
311020;201411;976;3009;800;2693;195;740;321;1010;516;1750
311030;201411;1976;5843;1494;4871;460;1654;488;1437;948;3091
311040;201411;502;1693;433;1507;106;387;101;337;207;724
311050;201411;2690;8752;2306;7992;695;2651;924;3181;1619;5832
311060;201411;2591;8102;2049;6904;607;2208;502;1611;1109;3819
311070;201411;1771;6250;1557;5810;434;1832;513;1895;947;3727
311080;201411;1242;3388;1111;3188;176;572;704;2007;880;2579
311090;201411;1686;6286;1426;5737;504;2304;275;1037;779;3341
311100;201411;2476;8610;2148;7911;938;3659;497;1825;1435;5484
311110;201411;4210;10145;2998;8416;602;1871;1545;4267;2147;6138
311115;201411;1218;3627;1049;3368;129;513;674;2162;803;2675
311120;201411;8015;22794;6175;19374;1631;5718;1653;4803;3284;10521
311130;201411;2447;7464;1942;6778;548;2247;854;2845;1402;5092
311140;201411;1487;4142;1233;3818;173;630;857;2580;1030;3210
311150;201411;2451;8226;2265;7917;608;2207;1143;4065;1751;6272
311160;201411;5068;17026;4235;15560;1561;6172;1338;4866;2899;11038
311170;201411;773;2402;610;2082;82;283;329;1185;411;1468
311180;201411;1664;4641;1211;3743;376;1260;287;811;663;2071
311190;201411;1128;3386;950;3016;249;899;373;1089;622;1988
311200;201411;2157;6644;1775;5822;577;2101;410;1190;987;3291
311205;201411;1220;3966;1067;3655;262;1015;427;1489;689;2504
311210;201411;984;3183;895;3049;164;563;626;2197;790;2760
311220;201411;943;3020;752;2585;208;765;257;870;465;1635
311230;201411;9183;28191;7671;25409;1636;5934;3660;12391;5296;18325
311240;201411;1375;4218;1147;3840;366;1315;391;1320;757;2635
311250;201411;990;3252;886;3087;257;1037;308;921;565;1958
311260;201411;3001;8192;2273;6922;686;2298;725;2153;1411;4451
311265;201411;1354;3641;1043;3194;171;633;666;2018;837;2651
311270;201411;3603;11583;3183;10999;558;2279;2140;7222;2698;9501
311280;201411;1501;4223;1093;3423;304;1052;327;992;631;2044
311290;201411;2382;7784;2208;7426;439;1479;1283;4440;1722;5919
311300;201411;5143;16908;4614;16023;720;2827;3027;10607;3747;13434
311310;201411;507;1798;478;1744;103;437;207;707;310;1144
311320;201411;4247;14275;3710;13053;934;3764;1336;4454;2270;8218
311330;201411;5673;17306;4876;16045;1719;6113;1784;5755;3503;11868
311340;201411;13143;42036;11743;39331;3828;13784;3697;12287;7525;26071
311350;201411;2210;6545;1799;5759;365;1396;839;2497;1204;3893
311360;201411;1371;3898;1087;3519;493;1660;278;924;771;2584
311370;201411;4764;14153;4189;13171;1102;4111;1715;5029;2817;9140
311380;201411;495;1615;419;1473;123;505;132;426;255;931
311390;201411;2040;7515;1914;7299;862;3658;615;2214;1477;5872
311400;201411;1773;5894;1604;5582;457;1805;722;2330;1179;4135
311410;201411;2100;7510;1942;7285;621;2499;1004;3810;1625;6309
311420;201411;2559;8705;2050;7462;714;2781;497;1609;1211;4390
311430;201411;4195;13098;3064;10539;749;2823;570;1903;1319;4726
311440;201411;2355;7917;1823;6871;677;2935;352;1261;1029;4196
311450;201411;1915;6733;1617;6000;491;2009;384;1298;875;3307
311455;201411;1649;4473;1401;4100;328;1072;754;2121;1082;3193
311460;201411;687;2250;526;1909;128;572;136;461;264;1033
311470;201411;626;1991;502;1718;145;593;158;489;303;1082
311480;201411;842;2332;794;2260;261;744;373;1027;634;1771
311490;201411;315;1232;296;1172;113;467;97;372;210;839
311500;201411;535;1605;439;1426;148;515;174;554;322;1069
311510;201411;3238;10096;2634;8922;1007;3874;700;2207;1707;6081
311520;201411;709;2414;664;2319;252;939;245;831;497;1770
311530;201411;12004;31578;8260;25084;2204;7986;2458;7132;4662;15118
311535;201411;775;2334;546;1857;138;545;96;299;234;844
311540;201411;719;2580;687;2532;230;894;348;1253;578;2147
311545;201411;2338;7207;2160;6979;310;1122;1541;4971;1851;6093
311547;201411;1694;4687;1429;4276;151;479;964;2909;1115;3388
311550;201411;3470;11286;2974;10243;842;3247;1002;3366;1844;6613
311560;201411;301;797;263;749;66;216;142;378;208;594
311570;201411;2194;5482;1739;4917;117;342;1405;4049;1522;4391
311580;201411;2507;5458;2038;4897;597;1340;1149;2919;1746;4259
311590;201411;414;1319;360;1245;113;464;107;365;220;829
311600;201411;1454;4271;1214;3976;305;971;699;2387;1004;3358
311610;201411;3427;11865;3151;11406;1037;3752;1400;5419;2437;9171
311615;201411;2872;9306;2455;8592;294;1224;1735;6033;2029;7257
311620;201411;463;1487;417;1422;103;391;228;768;331;1159
311630;201411;1485;4432;1258;4028;286;915;674;2197;960;3112
311640;201411;901;2828;738;2554;151;580;442;1503;593;2083
311650;201411;2487;7106;2020;6349;308;1046;1177;3794;1485;4840
311660;201411;2777;9671;2344;8686;704;2909;390;1260;1094;4169
311670;201411;1492;4560;1269;4167;428;1546;527;1713;955;3259
311680;201411;2372;7346;1963;6747;468;1702;1107;3879;1575;5581
311690;201411;602;1619;496;1493;78;261;349;1037;427;1298
311700;201411;2349;6545;2032;6085;191;737;1573;4588;1764;5325
311710;201411;1793;5522;1397;4813;544;2038;410;1384;954;3422
311720;201411;416;1418;379;1341;69;281;230;797;299;1078
311730;201411;5746;14985;3503;10930;1071;3808;1182;3245;2253;7053
311740;201411;1021;2935;885;2764;365;1121;436;1417;801;2538
311750;201411;4052;13550;3667;12957;703;2780;2183;7692;2886;10472
311760;201411;815;2775;764;2669;204;832;341;1084;545;1916
311770;201411;2604;8223;2126;7357;583;2257;666;2220;1249;4477
311780;201411;1207;4475;1018;3988;378;1662;226;823;604;2485
311783;201411;2191;6986;1890;6399;177;710;1292;4472;1469;5182
311787;201411;599;2101;433;1592;81;322;104;336;185;658
311790;201411;1554;4748;1165;3961;333;1237;324;1049;657;2286
311800;201411;4075;13889;2951;10508;688;2634;229;680;917;3314
311810;201411;1064;3580;1008;3479;45;215;849;2905;894;3120
311820;201411;852;2792;717;2464;231;916;333;1057;564;1973
311830;201411;8642;29837;7401;26703;2800;10767;1236;4185;4036;14952
311840;201411;3549;10593;3070;9868;943;3402;1363;4228;2306;7630
311850;201411;325;972;279;895;74;250;137;439;211;689
311860;201411;52772;162436;45477;148689;11830;42643;20386;64396;32216;107039
311870;201411;2456;7310;1943;6326;507;1884;651;1945;1158;3829
311880;201411;7349;21522;6617;20638;1094;3318;4483;14649;5577;17967
311890;201411;1662;5212;1387;4629;400;1471;547;1764;947;3235
311900;201411;823;2565;743;2453;146;481;469;1645;615;2126
311910;201411;4900;14254;3972;12973;1129;3986;1696;5561;2825;9547
311920;201411;2146;6974;1836;6485;227;893;1219;4281;1446;5174
311930;201411;4982;14735;4410;13810;1810;5958;1357;4289;3167;10247
311940;201411;11985;36673;9851;32179;3025;10815;2332;7150;5357;17965
311950;201411;2367;6987;1996;6500;161;559;1518;4971;1679;5530
311960;201411;438;1445;400;1366;117;468;186;560;303;1028
311970;201411;471;1684;407;1544;125;536;79;283;204;819
311980;201411;806;2235;578;1860;135;470;214;694;349;1164
311990;201411;562;1685;483;1553;189;645;162;492;351;1137
311995;201411;1181;3635;773;2622;158;596;172;500;330;1096
312000;201411;710;2201;664;2130;131;467;375;1198;506;1665
312010;201411;1055;3408;935;3151;198;733;417;1385;615;2118
312015;201411;1617;4947;1396;4561;203;784;841;2772;1044;3556
312020;201411;1026;3330;909;3150;255;986;448;1543;703;2529
312030;201411;1869;5549;1677;5302;159;592;1347;4228;1506;4820
312040;201411;707;2681;607;2378;174;768;131;478;305;1246
312050;201411;1480;5137;1284;4725;398;1620;291;1024;689;2644
312060;201411;768;2361;677;2231;313;1102;200;588;513;1690
312070;201411;1015;3133;659;2335;165;635;238;832;403;1467
312080;201411;2752;7706;2133;6726;459;1730;1043;3030;1502;4760
312083;201411;997;2826;829;2578;139;502;501;1527;640;2029
312087;201411;2381;7245;2110;6863;310;1067;1488;4937;1798;6004
312090;201411;10268;33197;9260;31433;2969;11085;3787;12455;6756;23540
312100;201411;1395;4710;1220;4415;264;1051;669;2480;933;3531
312110;201411;1220;4329;1086;4033;408;1688;213;704;621;2392
312120;201411;956;3326;859;3112;272;1090;251;827;523;1917
312125;201411;1348;4360;1207;4075;331;1174;579;1989;910;3163
312130;201411;872;2659;709;2316;167;621;288;906;455;1527
312140;201411;1091;3463;892;2978;213;783;300;881;513;1664
312150;201411;570;1625;479;1426;39;136;326;941;365;1077
312160;201411;8418;28588;7650;26969;2407;9226;2754;9765;5161;18991
312170;201411;1023;3037;914;2829;135;436;541;1699;676;2135
312180;201411;1641;5063;1488;4795;414;1399;603;1901;1017;3300
312190;201411;704;2322;554;2024;229;923;108;366;337;1289
312200;201411;5038;14929;4374;13849;529;1793;3113;9865;3642;11658
312210;201411;1273;3449;984;3026;271;912;456;1360;727;2272
312220;201411;2003;6558;1792;6311;234;856;1368;5009;1602;5865
312230;201411;18757;62415;15770;56411;7295;27563;3354;12382;10649;39945
312235;201411;1796;5168;1507;4725;162;641;1033;3224;1195;3865
312240;201411;1135;3886;971;3538;286;1120;347;1267;633;2387
312245;201411;2465;7165;2140;6725;182;515;1722;5520;1904;6035
312247;201411;948;2788;718;2409;188;714;347;1187;535;1901
312250;201411;1240;3582;1021;3201;226;812;468;1406;694;2218
312260;201411;984;3104;803;2840;133;560;534;1873;667;2433
312270;201411;813;2527;683;2283;153;620;258;741;411;1361
312280;201411;481;1662;442;1573;197;746;59;199;256;945
312290;201411;875;3004;823;2928;331;1329;225;772;556;2101
312300;201411;1145;3831;955;3393;295;1115;147;463;442;1578
312310;201411;974;3691;890;3478;261;1105;362;1371;623;2476
312320;201411;2461;7027;1952;5972;559;1903;475;1199;1034;3102
312330;201411;1225;3643;1064;3403;261;951;606;1928;867;2879
312340;201411;326;847;290;800;43;157;220;573;263;730
312350;201411;384;1002;356;967;46;146;289;756;335;902
312352;201411;1701;5547;1562;5342;440;1505;933;3317;1373;4822
312360;201411;3824;12912;3311;11838;1077;4203;912;3212;1989;7415
312370;201411;1700;5526;1566;5304;574;2163;548;1740;1122;3903
312380;201411;2060;5977;1855;5666;249;781;1343;4221;1592;5002
312385;201411;1313;4019;1157;3756;155;648;786;2443;941;3091
312390;201411;2026;6737;1666;5924;522;1956;314;1030;836;2986
312400;201411;3555;11670;3072;10707;1123;4067;1078;3914;2201;7981
312410;201411;11170;37306;10012;34980;2950;11243;3785;12915;6735;24158
312420;201411;4259;13417;4041;13151;680;2243;2881;9600;3561;11843
312430;201411;8760;25848;7787;24386;1416;4472;5034;16289;6450;20761
312440;201411;694;2224;606;2071;145;541;310;1072;455;1613
312450;201411;1164;4106;1027;3847;429;1669;380;1421;809;3090
312460;201411;401;1209;357;1160;85;308;188;604;273;912
312470;201411;786;2232;541;1741;128;475;151;466;279;941
312480;201411;1412;4118;1160;3823;389;1388;534;1682;923;3070
312490;201411;2038;5448;1615;4840;230;816;996;2875;1226;3691
312500;201411;692;2248;626;2150;139;586;341;1123;480;1709
312510;201411;2966;9431;2423;8250;567;2237;1033;3216;1600;5453
312520;201411;406;1390;353;1283;121;454;124;460;245;914
312530;201411;622;1995;578;1921;113;463;336;1050;449;1513
312540;201411;1502;4725;1163;4042;277;1037;587;2003;864;3040
312550;201411;645;2083;584;1956;58;224;393;1291;451;1515
312560;201411;2275;5966;1976;5578;211;669;1522;4326;1733;4995
312570;201411;2838;8555;2417;7802;759;2608;774;2434;1533;5042
312580;201411;547;1827;447;1624;106;463;176;598;282;1061
312590;201411;1889;6293;1649;5779;453;1828;585;1866;1038;3694
312595;201411;2123;7158;1881;6573;516;1940;887;3049;1403;4989
312600;201411;831;2981;755;2818;200;878;355;1225;555;2103
312610;201411;9101;27793;7480;24757;2700;9627;2166;6963;4866;16590
312620;201411;2140;6152;1630;5468;126;450;1301;4491;1427;4941
312630;201411;517;1744;478;1670;129;505;216;727;345;1232
312640;201411;611;1995;499;1759;131;541;191;608;322;1149
312650;201411;2409;7048;1692;5684;207;799;932;3093;1139;3892
312660;201411;1371;3762;1132;3403;139;499;772;2274;911;2773
312670;201411;6302;19152;5577;18113;1395;5077;2793;8939;4188;14016
312675;201411;1492;4689;1267;4227;206;751;721;2424;927;3175
312680;201411;1751;5336;1563;5034;249;888;953;3137;1202;4025
312690;201411;2438;6626;1996;6003;399;1409;1085;3110;1484;4519
312695;201411;928;3320;868;3233;182;665;573;2217;755;2882
312700;201411;2049;5959;1543;4980;244;894;787;2502;1031;3396
312705;201411;1485;4268;1269;3926;193;625;848;2626;1041;3251
312707;201411;1788;5510;1471;4978;234;955;815;2696;1049;3651
312710;201411;8595;24035;6197;19779;2234;7879;1428;4283;3662;12162
312720;201411;774;2645;694;2485;181;723;286;972;467;1695
312730;201411;1973;4870;1437;4248;231;792;841;2476;1072;3268
312733;201411;1762;4739;1311;3893;118;429;921;2613;1039;3042
312735;201411;926;2717;820;2566;267;933;407;1216;674;2149
312737;201411;1055;2587;740;2155;244;730;296;907;540;1637
312738;201411;578;1809;437;1517;127;504;155;511;282;1015
312740;201411;517;1501;354;1290;121;478;95;356;216;834
312750;201411;1329;4783;1268;4661;321;1360;612;2189;933;3549
312760;201411;2460;7925;1916;6821;559;2196;431;1537;990;3733
312770;201411;47403;130684;36729;113915;10915;36806;12191;37127;23106;73933
312780;201411;2887;10193;2587;9666;511;2078;1483;5683;1994;7761
312790;201411;390;1023;238;748;73;264;65;173;138;437
312800;201411;5491;18437;4655;16702;1536;5881;1395;5067;2931;10948
312810;201411;2316;7124;1671;5918;545;2134;370;1233;915;3367
312820;201411;2207;6476;1983;6105;253;945;1295;3853;1548;4798
312825;201411;1558;4241;1361;4005;137;433;1074;3159;1211;3592
312830;201411;2874;9258;2052;7528;555;2226;392;1421;947;3647
312840;201411;1236;4057;1043;3682;207;879;489;1654;696;2533
312850;201411;650;2129;538;1900;121;504;201;687;322;1191
312860;201411;1332;3878;995;3306;315;1219;291;848;606;2067
312870;201411;5854;18567;4472;15834;1216;4858;1310;4458;2526;9316
312880;201411;1325;4006;1140;3692;202;743;647;2080;849;2823
312890;201411;1584;4802;1103;3762;366;1399;366;1192;732;2591
312900;201411;1499;4816;1374;4641;358;1253;833;2857;1191;4110
312910;201411;1622;3622;1210;3055;286;844;592;1372;878;2216
312920;201411;1052;3437;926;3256;281;1102;413;1416;694;2518
312930;201411;2299;6785;2017;6375;472;1561;1025;3318;1497;4879
312940;201411;953;3192;853;3013;263;1083;250;820;513;1903
312950;201411;3636;10361;2913;9253;1011;3458;1039;3280;2050;6738
312960;201411;2061;6149;1859;5883;279;857;1365;4448;1644;5305
312965;201411;1851;5889;1565;5368;298;1104;903;3149;1201;4253
312970;201411;1208;4129;1045;3874;413;1727;200;710;613;2437
312980;201411;22395;77797;21231;75081;7935;30061;7958;27410;15893;57471
312990;201411;418;1280;316;1099;117;454;100;344;217;798
313000;201411;541;1816;441;1612;132;588;159;522;291;1110
313005;201411;2741;8834;2420;8288;456;1664;1424;4920;1880;6584
313010;201411;4356;14492;3807;13536;1182;4626;1555;5298;2737;9924
313020;201411;1064;3663;964;3435;324;1295;286;894;610;2189
313030;201411;1640;4594;1296;4120;350;1261;662;2011;1012;3272
313040;201411;1009;3516;867;3113;203;812;294;991;497;1803
313050;201411;1982;6420;1624;5892;541;2186;597;2062;1138;4248
313055;201411;1589;5208;1448;5005;139;513;1101;3858;1240;4371
313060;201411;1042;3545;900;3186;383;1410;150;512;533;1922
313065;201411;2052;6646;1792;6239;318;1252;1263;4370;1581;5622
313070;201411;1286;3808;1048;3363;269;990;513;1552;782;2542
313080;201411;489;1536;395;1344;113;455;131;367;244;822
313090;201411;5694;16698;5043;15662;853;2768;3332;10524;4185;13292
313100;201411;1199;3848;1116;3721;174;635;817;2708;991;3343
313110;201411;1799;5233;1381;4422;325;1208;525;1533;850;2741
313115;201411;2940;10262;2809;10000;841;3362;1358;4608;2199;7970
313120;201411;4058;11350;3534;10624;860;2780;2184;6543;3044;9323
313130;201411;22690;69364;19263;62068;5013;17805;7228;21958;12241;39763
313140;201411;714;1879;536;1601;43;161;364;1063;407;1224
313150;201411;1698;5310;1516;4989;685;2340;413;1391;1098;3731
313160;201411;1193;3629;1048;3383;216;806;615;1906;831;2712
313170;201411;9850;35783;8812;33192;3355;13177;1983;7485;5338;20662
313180;201411;2866;7495;2151;6540;641;2155;781;2293;1422;4448
313190;201411;3743;13627;3289;12314;952;3876;1074;3861;2026;7737
313200;201411;1528;4809;1354;4518;225;881;847;2862;1072;3743
313210;201411;4752;14736;4012;13707;937;3757;2143;7028;3080;10785
313220;201411;1302;3938;949;3160;269;1028;262;757;531;1785
313230;201411;2601;9212;2414;8915;435;1662;1540;5887;1975;7549
313240;201411;8959;29740;7555;27151;2081;8293;3175;11322;5256;19615
313250;201411;7950;24728;7130;23336;1331;4448;4230;14235;5561;18683
313260;201411;647;2014;531;1783;128;498;155;482;283;980
313270;201411;5943;17451;5242;16370;898;2999;3409;10735;4307;13734
313280;201411;556;1801;429;1496;85;344;111;360;196;704
313290;201411;1051;3760;872;3403;292;1260;219;790;511;2050
313300;201411;2055;7002;1711;6131;546;2145;318;1003;864;3148
313310;201411;1104;3899;993;3655;278;1154;192;635;470;1789
313320;201411;2572;7649;2041;6756;426;1508;892;2970;1318;4478
313330;201411;4135;13252;3563;12201;723;2832;1858;6306;2581;9138
313340;201411;2368;5759;1813;4972;386;1109;1004;2733;1390;3842
313350;201411;3478;10912;2684;9106;694;2529;586;1837;1280;4366
313360;201411;1270;3816;974;3286;312;1227;435;1351;747;2578
313370;201411;1547;5396;1460;5154;300;1253;695;2268;995;3521
313375;201411;2229;5960;1492;4843;390;1532;528;1637;918;3169
313380;201411;7060;24117;6135;22078;2301;8939;1922;6604;4223;15543
313390;201411;953;3435;920;3385;134;559;630;2309;764;2868
313400;201411;3926;11217;3600;10827;403;1276;2833;8691;3236;9967
313410;201411;1425;4075;1208;3774;275;942;699;2183;974;3125
313420;201411;21209;51612;13247;37665;3205;10248;3049;8298;6254;18546
313430;201411;1324;4291;1148;3926;327;1267;435;1396;762;2663
313440;201411;7019;16692;5092;14388;722;2237;3424;9698;4146;11935
313450;201411;745;2227;594;1907;151;584;208;598;359;1182
313460;201411;2558;8999;2287;8539;741;3026;701;2506;1442;5532
313470;201411;3559;9911;3352;9676;333;839;2827;8374;3160;9213
313480;201411;1160;3395;892;2918;157;592;394;1211;551;1803
313490;201411;1741;5610;1208;4660;512;2027;220;879;732;2906
313500;201411;452;1473;426;1420;103;398;214;682;317;1080
313505;201411;9309;27611;8622;26798;510;1125;7782;24985;8292;26110
313507;201411;1530;4257;1345;3995;248;844;810;2448;1058;3292
313510;201411;16846;48893;14820;46095;2701;8544;9426;30159;12127;38703
313520;201411;16916;50563;14215;45982;2122;7776;9076;29290;11198;37066
313530;201411;602;2019;517;1859;92;385;194;636;286;1021
313535;201411;2727;8036;2417;7512;313;1024;1643;5158;1956;6182
313540;201411;1150;3638;893;2985;276;970;214;656;490;1626
313545;201411;1437;5197;1263;4866;211;1009;776;2848;987;3857
313550;201411;2079;6918;1887;6541;530;1973;918;3085;1448;5058
313560;201411;2376;5839;2051;5470;320;769;1526;4267;1846;5036
313570;201411;851;3089;746;2885;280;1160;263;963;543;2123
313580;201411;6419;18107;5411;16724;822;2815;3755;11638;4577;14453
313590;201411;1116;3298;904;3048;421;1520;326;1076;747;2596
313600;201411;4077;12342;3552;11501;627;2210;2178;7163;2805;9373
313610;201411;1204;3726;1035;3395;266;948;460;1485;726;2433
313620;201411;7584;25405;7135;24448;2528;9189;2441;8226;4969;17415
313630;201411;9493;28527;7791;25861;2224;8183;3070;10521;5294;18704
313640;201411;950;2889;768;2613;268;994;252;834;520;1828
313650;201411;2378;7741;2105;7286;304;1071;1528;5397;1832;6468
313652;201411;1043;3748;956;3573;173;696;570;2138;743;2834
313655;201411;1043;3371;848;3039;161;675;511;1772;672;2447
313657;201411;1291;4061;1131;3803;159;711;792;2447;951;3158
313660;201411;951;3242;872;3094;220;902;417;1399;637;2301
313665;201411;3360;11144;3095;10545;728;2804;1523;4992;2251;7796
313670;201411;50483;144005;34354;115566;9815;36695;10517;34265;20332;70960
313680;201411;1152;3465;992;3213;141;469;689;2267;830;2736
313690;201411;998;3587;891;3358;271;1043;342;1330;613;2373
313695;201411;1544;4973;1297;4571;168;667;881;3137;1049;3804
313700;201411;4018;13269;3390;12403;592;2233;2283;8564;2875;10797
313710;201411;1456;4105;1205;3723;347;1158;562;1690;909;2848
313720;201411;5671;19056;4867;17314;1314;5224;1544;4999;2858;10223
313730;201411;1340;3581;1025;3197;191;681;591;1826;782;2507
313740;201411;2176;7876;1803;6899;646;2776;232;812;878;3588
313750;201411;3068;9439;2659;8644;879;3050;815;2496;1694;5546
313753;201411;1965;5923;1613;5304;507;1797;644;2128;1151;3925
313760;201411;4532;14770;3717;13061;1136;4372;1116;3693;2252;8065
313770;201411;3910;12973;3616;12380;1250;4523;1262;4238;2512;8761
313780;201411;4194;11890;3370;10669;838;3064;1611;4976;2449;8040
313790;201411;567;1971;548;1942;133;471;305;1119;438;1590
313800;201411;1298;3703;1148;3463;192;649;734;2213;926;2862
313810;201411;1638;4840;1575;4749;179;518;1248;3854;1427;4372
313820;201411;14523;41501;12185;37505;3098;10757;5334;16161;8432;26918
313830;201411;449;1525;384;1384;118;484;116;401;234;885
313835;201411;1095;3596;1040;3513;262;947;565;1891;827;2838
313840;201411;8391;24629;6735;21757;1945;7018;2169;6746;4114;13764
313850;201411;1313;3662;1177;3429;295;980;614;1693;909;2673
313860;201411;2828;8744;2272;7507;648;2436;534;1618;1182;4054
313862;201411;1245;3307;855;2653;233;766;300;945;533;1711
313865;201411;2368;7384;2157;7041;319;1161;1511;4923;1830;6084
313867;201411;1153;3957;976;3594;350;1381;326;1222;676;2603
313868;201411;1636;5716;1443;5308;180;776;977;3577;1157;4353
313870;201411;937;2927;829;2771;271;1044;273;814;544;1858
313880;201411;2293;7381;2096;7109;524;2054;1043;3286;1567;5340
313890;201411;2076;5620;1739;5192;286;842;1136;3474;1422;4316
313900;201411;4963;18092;4617;17300;1702;7020;1358;5056;3060;12076
313910;201411;790;2698;673;2445;265;1043;115;389;380;1432
313920;201411;3991;12655;3495;11784;647;2202;2104;7382;2751;9584
313925;201411;2168;5734;1492;4452;131;429;947;2799;1078;3228
313930;201411;5552;18122;4634;16492;842;3253;2619;9543;3461;12796
313940;201411;8006;27245;6751;25206;2284;9307;2496;9628;4780;18935
313950;201411;5086;14753;4212;13320;1372;4901;1538;4631;2910;9532
313960;201411;6543;17355;5146;15412;1693;5630;1416;4137;3109;9767
313970;201411;1560;4557;1320;4286;219;778;879;2911;1098;3689
313980;201411;1313;4312;1119;3964;381;1490;369;1285;750;2775
313990;201411;2034;7672;1783;7061;638;2735;443;1631;1081;4366
314000;201411;8711;29371;8088;28164;2114;8503;4397;14791;6511;23294
314010;201411;1206;3432;996;3169;171;647;590;1822;761;2469
314015;201411;1649;6141;1506;5823;534;2179;478;1845;1012;4024
314020;201411;549;1709;427;1439;126;482;107;331;233;813
314030;201411;873;2835;692;2415;123;470;266;918;389;1388
314040;201411;672;1950;577;1785;184;605;291;887;475;1492
314050;201411;2044;6640;1669;5842;509;1987;515;1665;1024;3652
314053;201411;1560;5128;1436;4976;241;816;991;3579;1232;4395
314055;201411;2349;6981;2079;6601;181;609;1586;5132;1767;5741
314060;201411;1163;3663;950;3305;107;440;622;2155;729;2595
314070;201411;3830;11973;2884;10071;826;3141;719;2382;1545;5523
314080;201411;1961;6051;1327;4588;287;1120;336;1037;623;2157
314085;201411;1946;6695;1692;6329;527;2172;637;2353;1164;4525
314090;201411;3651;12428;3252;11639;1055;4093;1167;4254;2222;8347
314100;201411;3720;9912;3210;9200;382;1055;2465;7253;2847;8308
314110;201411;4662;15370;4105;14182;1043;4178;1554;4929;2597;9107
314120;201411;1094;2661;582;1845;172;617;152;458;324;1075
314130;201411;703;2063;379;1310;67;248;76;262;143;510
314140;201411;5314;16494;4608;15123;1029;3634;2126;6984;3155;10618
314150;201411;1836;4883;1422;4229;272;918;697;2028;969;2946
314160;201411;2565;6839;2005;6083;146;467;1613;5053;1759;5520
314170;201411;1153;3528;951;3082;161;614;506;1572;667;2186
314180;201411;6672;21046;5834;19776;1600;5912;2634;9120;4234;15032
314190;201411;873;2668;731;2437;228;883;283;886;511;1769
314200;201411;3195;10254;2836;9602;414;1628;1901;6318;2315;7946
314210;201411;2096;6421;1875;6014;325;1200;1116;3426;1441;4626
314220;201411;1812;5884;1496;5253;511;2006;359;1109;870;3115
314225;201411;1270;3801;1132;3611;79;244;980;3185;1059;3429
314230;201411;750;2599;687;2482;224;884;247;854;471;1738
314240;201411;1208;3838;1055;3610;204;655;704;2525;908;3180
314250;201411;556;1669;423;1391;95;357;151;446;246;803
314260;201411;1326;4811;1247;4642;433;1713;435;1605;868;3318
314270;201411;2991;10029;2662;9432;331;1327;1812;6472;2143;7799
314280;201411;3514;10042;2489;8033;753;2778;715;2017;1468;4795
314290;201411;5627;15656;4781;14302;1189;3884;2808;8260;3997;12144
314300;201411;2030;6812;1833;6340;622;2228;657;2226;1279;4454
314310;201411;6950;22041;6102;20308;2332;8297;1765;5671;4097;13968
314315;201411;986;3782;910;3631;171;773;537;2173;708;2946
314320;201411;3764;11149;2979;10082;1019;3737;1220;4115;2239;7852
314330;201411;59251;187272;54059;178566;16420;59004;23305;76170;39725;135174
314340;201411;2621;7316;1441;4829;397;1462;135;302;532;1764
314345;201411;1417;4705;1246;4432;384;1413;655;2372;1039;3785
314350;201411;1499;4397;1211;3919;498;1749;333;1049;831;2798
314360;201411;773;2426;514;1848;147;614;130;435;277;1049
314370;201411;580;2037;533;1959;174;687;251;920;425;1607
314380;201411;1274;3871;919;3183;328;1214;255;910;583;2124
314390;201411;16575;49488;12999;42593;3882;13866;3631;11338;7513;25204
314400;201411;5723;16289;4641;14763;1615;5271;2127;7061;3742;12332
314410;201411;2884;9283;2471;8420;797;3084;833;2659;1630;5743
314420;201411;812;2361;647;2129;87;362;449;1450;536;1812
314430;201411;8573;25383;7658;23586;2531;8335;2485;7777;5016;16112
314435;201411;1340;4317;1184;4037;165;702;762;2544;927;3246
314437;201411;1235;3245;1076;3007;91;252;854;2415;945;2667
314440;201411;764;2127;538;1809;206;760;104;316;310;1076
314450;201411;1855;5482;1579;5083;519;1879;729;2229;1248;4108
314460;201411;4616;16001;3972;14518;1335;5283;794;2843;2129;8126
314465;201411;2468;7844;2273;7506;209;852;1711;5533;1920;6385
314467;201411;1191;3358;1010;3043;142;415;673;2080;815;2495
314470;201411;2515;8197;1993;6981;563;2259;504;1513;1067;3772
314480;201411;6514;22046;4514;16561;920;3661;501;1613;1421;5274
314490;201411;1017;2999;812;2589;244;845;319;959;563;1804
314500;201411;3044;8559;2354;7229;698;2352;784;2404;1482;4756
314505;201411;1823;5630;1717;5451;337;1178;1066;3395;1403;4573
314510;201411;2085;5884;1453;4935;536;2007;384;1246;920;3253
314520;201411;4033;15265;3276;13311;1070;4771;619;2293;1689;7064
314530;201411;7353;25494;6765;24573;1309;4882;3942;14950;5251;19832
314535;201411;3094;8441;2615;7802;341;1124;1903;5679;2244;6803
314537;201411;1495;4452;1201;3925;246;916;613;2011;859;2927
314540;201411;471;1465;413;1340;121;461;143;428;264;889
314545;201411;1470;4610;1279;4311;242;923;764;2561;1006;3484
314550;201411;645;1828;495;1628;124;510;177;524;301;1034
314560;201411;5527;19643;4826;17770;1246;5042;1277;4524;2523;9566
314570;201411;358;1104;307;987;89;312;143;443;232;755
314580;201411;506;1746;405;1507;116;486;85;308;201;794
314585;201411;875;2916;623;2345;173;728;174;656;347;1384
314587;201411;1826;5765;1615;5385;304;1005;876;2997;1180;4002
314590;201411;4422;15425;3286;12302;883;3510;458;1594;1341;5104
314600;201411;2171;7518;1774;6746;696;2912;374;1356;1070;4268
314610;201411;8825;31223;8188;29724;2602;10358;2961;10179;5563;20537
314620;201411;1916;5579;1698;5299;222;658;1280;4125;1502;4783
314625;201411;1584;5318;1544;5266;167;567;1252;4351;1419;4918
314630;201411;5405;15879;4732;14809;582;2026;3324;10535;3906;12561
314640;201411;853;2449;718;2211;254;825;201;577;455;1402
314650;201411;1381;4073;1057;3480;268;1013;405;1218;673;2231
314655;201411;1611;4840;1236;4131;261;919;633;2125;894;3044
314660;201411;233;645;179;538;24;86;104;296;128;382
314670;201411;1595;4403;1267;3817;231;773;716;2145;947;2918
314675;201411;2009;6115;1770;5692;229;836;1128;3645;1357;4481
314690;201411;2815;8930;2364;8123;679;2690;701;2236;1380;4926
314700;201411;10075;36577;8311;32590;3301;13869;1869;7394;5170;21263
314710;201411;9219;29276;6490;23143;1646;6577;995;3214;2641;9791
314720;201411;2769;9289;2314;8346;697;2785;897;3186;1594;5971
314730;201411;2640;8148;2179;7479;754;2842;721;2385;1475;5227
314740;201411;3252;10767;2911;10117;844;3258;1184;3921;2028;7179
314750;201411;351;1142;313;1055;68;268;143;460;211;728
314760;201411;1724;5919;1255;4701;270;1221;297;922;567;2143
314770;201411;1192;3756;708;2405;89;376;119;299;208;675
314780;201411;337;925;255;815;85;315;111;348;196;663
314790;201411;13997;42856;10699;37005;4613;17862;1890;6017;6503;23879
314795;201411;1583;4792;1365;4443;160;668;1017;3182;1177;3850
314800;201411;17893;54568;14498;47613;5813;20001;3017;10063;8830;30064
314810;201411;13556;40637;10579;35251;3429;12694;2637;8758;6066;21452
314820;201411;1156;3205;789;2642;272;997;246;755;518;1752
314830;201411;1871;6189;1593;5695;559;2179;613;2241;1172;4420
314840;201411;1139;4035;893;3655;235;1104;469;1877;704;2981
314850;201411;2330;6609;1898;5855;363;1318;1077;3277;1440;4595
314860;201411;3399;11588;3099;11095;667;2653;1833;6569;2500;9222
314870;201411;5960;18987;5287;18077;757;2890;3777;13119;4534;16009
314875;201411;1760;6011;1715;5943;246;825;1390;4894;1636;5719
314880;201411;870;2499;767;2343;72;233;547;1692;619;1925
314890;201411;626;1896;442;1509;108;434;139;408;247;842
314900;201411;454;1407;363;1255;96;349;167;574;263;923
314910;201411;1831;6370;1591;5935;650;2654;417;1464;1067;4118
314915;201411;2628;8256;2301;7768;223;882;1775;5951;1998;6833
314920;201411;667;1935;503;1693;115;442;230;721;345;1163
314930;201411;5419;18532;4777;17105;1575;6165;1137;3976;2712;10141
314940;201411;426;1263;397;1210;99;330;211;609;310;939
314950;201411;406;1378;336;1240;92;377;80;290;172;667
314960;201411;862;2769;688;2407;213;805;167;544;380;1349
314970;201411;667;2286;578;2114;165;700;170;572;335;1272
314980;201411;2334;7166;2087;6747;870;2968;339;1045;1209;4013
314990;201411;3297;10659;2647;9190;971;3735;502;1547;1473;5282
314995;201411;1679;5170;1502;4919;196;767;1057;3407;1253;4174
315000;201411;1167;3380;945;3025;175;661;544;1710;719;2371
315010;201411;505;1615;415;1419;128;516;138;415;266;931
315015;201411;2013;6260;1827;6031;283;945;1317;4525;1600;5470
315020;201411;806;2521;610;2084;119;460;276;901;395;1361
315030;201411;1025;3138;878;2857;344;1184;212;678;556;1862
315040;201411;967;3003;884;2854;169;581;538;1715;707;2296
315050;201411;1704;5077;1399;4568;446;1593;519;1661;965;3254
315053;201411;1182;3504;1025;3257;250;947;433;1330;683;2277
315057;201411;1978;6681;1600;6094;267;1042;972;3839;1239;4881
315060;201411;1050;3440;798;2869;240;937;201;748;441;1685
315070;201411;774;2309;687;2187;197;699;364;1109;561;1808
315080;201411;3563;12161;3188;11362;857;3299;1445;5118;2302;8417
315090;201411;783;2838;695;2647;179;736;255;1005;434;1741
315100;201411;1245;4275;958;3595;268;1136;214;727;482;1863
315110;201411;1732;5356;1515;4957;401;1434;690;2230;1091;3664
315120;201411;14440;34796;10253;29344;1888;5700;5589;16766;7477;22466
315130;201411;1858;6213;1681;5858;584;2241;455;1531;1039;3772
315140;201411;2698;9035;2250;8056;644;2676;741;2370;1385;5046
315150;201411;5017;13809;3743;11563;891;3181;1406;4174;2297;7355
315160;201411;1431;4173;1246;3853;280;948;643;1924;923;2872
315170;201411;1402;4107;1173;3777;220;762;649;2263;869;3025
315180;201411;15608;47575;11116;37846;3011;11540;2564;8286;5575;19826
315190;201411;2439;6507;1995;5862;585;1826;957;2823;1542;4649
315200;201411;4715;15938;3911;14104;1243;4885;1058;3691;2301;8576
315210;201411;9297;28319;7696;25115;2458;8730;2688;8596;5146;17326
315213;201411;1165;3755;1111;3681;103;299;938;3203;1041;3502
315217;201411;2809;9444;2347;8645;381;1604;1373;5057;1754;6661
315220;201411;10412;30336;8804;27860;2407;7563;4512;14893;6919;22456
315230;201411;2707;7229;2377;6832;160;366;2074;6132;2234;6498
315240;201411;3520;11043;3126;10423;643;2317;1885;6259;2528;8576
315250;201411;10420;33264;7864;28274;2542;10209;2414;8583;4956;18792
315260;201411;1150;3744;897;3175;318;1253;174;557;492;1810
315270;201411;899;3215;777;2956;258;1057;197;722;455;1779
315280;201411;4096;12524;3182;10478;1093;3796;785;2444;1878;6240
315290;201411;1340;3821;1013;3285;364;1305;192;609;556;1914
315300;201411;553;1574;430;1422;211;727;143;463;354;1190
315310;201411;1286;4246;1127;3962;170;692;732;2517;902;3209
315320;201411;910;2937;751;2715;204;804;357;1343;561;2147
315330;201411;706;2536;447;1850;141;663;58;239;199;902
315340;201411;4370;12656;3650;11524;906;3095;1682;5405;2588;8500
315350;201411;1925;5417;1483;4786;290;956;890;2988;1180;3944
315360;201411;1762;5916;1425;5028;322;1246;491;1627;813;2873
315370;201411;615;1866;542;1755;131;463;302;970;433;1433
315380;201411;296;1038;252;925;91;366;42;139;133;505
315390;201411;1985;7112;1708;6440;615;2481;414;1529;1029;4010
315400;201411;4919;14984;4237;13659;1012;3544;2069;6634;3081;10178
315410;201411;1895;5194;1595;4729;262;961;991;2820;1253;3781
315415;201411;1242;4158;1141;3998;457;1599;491;1813;948;3412
315420;201411;1229;3948;909;3258;261;1013;163;558;424;1571
315430;201411;4191;11436;3134;9640;873;3021;900;2667;1773;5688
315440;201411;1005;3097;893;2923;182;675;472;1533;654;2208
315445;201411;2299;6473;1918;5953;276;976;1331;4110;1607;5086
315450;201411;2595;8212;2391;7907;512;1661;1498;5167;2010;6828
315460;201411;40710;137014;36258;127391;12976;48891;8984;30652;21960;79543
315470;201411;588;1798;500;1640;89;340;287;905;376;1245
315480;201411;1546;4818;1004;3562;222;891;181;597;403;1488
315490;201411;3431;9683;2841;8841;505;1833;1538;4667;2043;6500
315500;201411;467;1442;300;1045;59;253;107;308;166;561
315510;201411;1556;4436;1330;4071;84;286;1013;3120;1097;3406
315520;201411;1199;3674;984;3380;173;678;607;2029;780;2707
315530;201411;527;1859;495;1801;226;876;171;601;397;1477
315540;201411;1293;3956;1030;3509;231;963;372;1223;603;2186
315550;201411;1889;5466;1544;5004;547;1978;560;1804;1107;3782
315560;201411;7487;24378;6813;23468;917;3468;4719;16422;5636;19890
315570;201411;2439;7684;2272;7429;522;1928;1293;4163;1815;6091
315580;201411;2858;8760;2302;7713;666;2611;831;2560;1497;5171
315590;201411;935;2728;838;2579;145;520;505;1495;650;2015
315600;201411;2742;9636;2258;8781;421;1698;1267;5178;1688;6876
315610;201411;1063;3147;878;2750;190;746;330;864;520;1610
315620;201411;357;1259;338;1220;102;359;175;661;277;1020
315630;201411;1055;3382;888;3087;253;945;242;816;495;1761
315640;201411;840;2521;711;2278;212;760;272;821;484;1581
315645;201411;904;2888;778;2598;319;1171;196;624;515;1795
315650;201411;2083;5870;1771;5432;162;637;1331;4008;1493;4645
315660;201411;2781;7425;2407;6844;507;1494;1404;3988;1911;5482
315670;201411;12743;44985;11569;42565;4163;16369;3702;13402;7865;29771
315680;201411;2975;10360;2435;9306;939;3695;568;2285;1507;5980
315690;201411;3862;11524;2856;9671;903;3354;770;2646;1673;6000
315700;201411;7716;24404;6578;22096;1384;5309;3140;10110;4524;15419
315710;201411;1929;5643;1535;5010;186;740;960;3083;1146;3823
315720;201411;3081;9968;2816;9452;688;2715;1448;4589;2136;7304
315725;201411;1719;5274;1398;4850;396;1413;731;2591;1127;4004
315727;201411;685;2146;590;1949;146;526;263;842;409;1368
315730;201411;1019;3143;929;2974;207;716;522;1673;729;2389
315733;201411;1216;3915;1119;3725;459;1611;376;1234;835;2845
315737;201411;1400;4237;1109;3701;112;442;708;2391;820;2833
315740;201411;1124;3538;961;3215;207;824;488;1536;695;2360
315750;201411;1213;3759;1080;3560;118;473;797;2581;915;3054
315760;201411;1001;2757;963;2709;25;75;892;2515;917;2590
315765;201411;1598;4847;1475;4662;140;464;1153;3696;1293;4160
315770;201411;1753;5688;1572;5292;449;1643;527;1703;976;3346
315780;201411;24958;82590;22913;78071;7412;26952;7155;24366;14567;51318
315790;201411;3435;11699;3045;10879;389;1344;2050;7555;2439;8899
315800;201411;1592;6201;1269;5212;363;1668;271;1049;634;2717
315810;201411;1561;4425;1326;4054;219;726;861;2588;1080;3314
315820;201411;3079;10032;2612;9321;818;3028;1195;4402;2013;7430
315830;201411;1518;5109;1332;4688;337;1334;384;1239;721;2573
315840;201411;805;2133;595;1760;96;332;235;635;331;967
315850;201411;1342;4734;1288;4615;331;1238;579;2024;910;3262
315860;201411;489;1741;387;1536;113;524;81;303;194;827
315870;201411;487;1469;409;1350;132;481;130;392;262;873
315880;201411;1151;3145;953;2894;246;863;454;1363;700;2226
315890;201411;1763;6011;1590;5741;558;2117;727;2684;1285;4801
315895;201411;5384;16830;4927;15950;1287;4631;2273;7165;3560;11796
315900;201411;833;2614;782;2529;155;614;496;1480;651;2094
315910;201411;626;2218;584;2137;218;828;275;994;493;1822
315920;201411;1613;4696;1074;3548;296;1102;312;936;608;2038
315930;201411;1167;3252;934;2843;260;865;328;973;588;1838
315935;201411;1191;4036;1099;3835;350;1341;351;1186;701;2527
315940;201411;685;2178;612;2029;177;660;257;822;434;1482
315950;201411;1301;3993;1198;3790;272;859;731;2378;1003;3237
315960;201411;2882;9570;2137;8046;1015;4373;120;366;1135;4739
315970;201411;816;2299;656;2075;76;231;479;1569;555;1800
315980;201411;4581;11296;2953;8512;795;2628;879;2212;1674;4840
315990;201411;4543;13531;3975;12643;886;3281;2136;6737;3022;10018
316000;201411;628;2008;552;1893;232;870;178;578;410;1448
316010;201411;494;1754;430;1621;103;464;145;481;248;945
316020;201411;1209;3846;975;3435;178;736;561;1961;739;2697
316030;201411;3804;10704;2697;8879;394;1430;1421;4802;1815;6232
316040;201411;3662;11593;2620;9227;472;1931;361;963;833;2894
316045;201411;2218;7024;2044;6736;295;880;1466;5085;1761;5965
316050;201411;376;1198;307;1088;69;271;171;580;240;851
316060;201411;799;2407;650;2187;120;499;356;1131;476;1630
316070;201411;6524;21201;5702;19284;1613;6096;2334;7470;3947;13566
316080;201411;763;2850;685;2634;187;789;129;501;316;1290
316090;201411;685;2010;478;1564;119;444;128;383;247;827
316095;201411;1385;4550;1235;4270;265;938;797;2824;1062;3762
316100;201411;2771;9341;2110;7628;565;2335;433;1451;998;3786
316105;201411;986;2762;734;2347;186;656;312;1021;498;1677
316110;201411;12942;44832;11708;42571;1665;6637;7992;29755;9657;36392
316120;201411;1368;4601;1204;4213;395;1446;427;1441;822;2887
316130;201411;1568;3540;1016;2771;202;652;509;1346;711;1998
316140;201411;1115;3287;855;2873;124;467;514;1744;638;2211
316150;201411;1471;4413;1397;4297;322;1165;804;2406;1126;3571
316160;201411;1278;3847;1003;3291;154;588;540;1745;694;2333
316165;201411;1015;2783;853;2531;177;613;489;1414;666;2027
316170;201411;1462;4227;1094;3571;245;889;460;1427;705;2316
316180;201411;1344;4296;1013;3577;289;1186;262;818;551;2004
316190;201411;2813;8767;1382;4910;319;1186;208;622;527;1808
316200;201411;3961;12872;3043;10978;772;3211;891;3121;1663;6332
316210;201411;5544;17621;4828;16273;2190;7929;954;3209;3144;11138
316220;201411;707;2227;498;1816;122;529;65;244;187;773
316225;201411;1169;3364;1024;3158;146;544;708;2125;854;2669
316230;201411;469;1397;385;1249;80;280;196;664;276;944
316240;201411;6929;21272;5969;20017;682;2320;4576;15576;5258;17896
316245;201411;3272;11365;3045;10985;277;1261;2322;8325;2599;9586
316250;201411;9438;29070;7931;25936;2705;9710;2405;7405;5110;17115
316255;201411;2555;7913;2254;7551;354;1181;1649;5588;2003;6769
316257;201411;1471;4133;1122;3499;266;916;412;1248;678;2164
316260;201411;1945;5519;1445;4774;268;983;806;2714;1074;3697
316265;201411;1339;3714;980;2979;112;414;594;1724;706;2138
316270;201411;5233;16795;4822;15939;1374;4785;2150;7194;3524;11979
316280;201411;3480;11489;3137;10798;597;2262;1764;6098;2361;8360
316290;201411;3455;11243;3045;10440;777;3066;1326;4322;2103;7388
316292;201411;3875;12786;3526;12152;960;3631;1691;5557;2651;9188
316294;201411;864;2784;556;2042;126;541;66;226;192;767
316295;201411;2096;7411;1968;7151;448;1907;1081;3702;1529;5609
316300;201411;1040;3183;878;2888;86;289;606;2036;692;2325
316310;201411;693;2199;539;1880;131;523;193;657;324;1180
316320;201411;584;1961;517;1866;149;592;146;504;295;1096
316330;201411;1074;3252;845;2764;134;450;508;1678;642;2128
316340;201411;1187;3858;1016;3513;314;1250;334;1058;648;2308
316350;201411;1531;4781;1386;4531;293;954;709;2481;1002;3435
316360;201411;796;2070;617;1820;74;227;468;1387;542;1614
316370;201411;5279;17458;4663;16195;1650;6132;1059;3715;2709;9847
316380;201411;1576;4385;1284;3953;132;467;921;2842;1053;3309
316390;201411;955;2868;796;2592;261;923;342;1126;603;2049
316400;201411;1561;5175;1315;4733;350;1352;556;2007;906;3359
316410;201411;1244;4156;1163;4025;255;943;690;2403;945;3346
316420;201411;2108;6963;1922;6709;283;1158;1247;4344;1530;5502
316430;201411;1005;3070;811;2713;245;911;287;903;532;1814
316440;201411;706;2309;591;2143;243;1004;154;542;397;1546
316443;201411;743;2232;614;1981;156;551;253;787;409;1338
316447;201411;1588;5020;1475;4849;117;418;1265;4171;1382;4589
316450;201411;2346;8001;2069;7471;399;1516;1298;4798;1697;6314
316460;201411;931;3001;874;2905;269;965;478;1527;747;2492
316470;201411;8467;27891;6710;23981;2091;8530;2021;6853;4112;15383
316480;201411;253;870;228;825;65;245;70;245;135;490
316490;201411;382;1240;362;1192;127;439;152;481;279;920
316500;201411;1100;4022;739;2886;161;675;48;190;209;865
316510;201411;985;3581;877;3340;345;1365;241;911;586;2276
316520;201411;1263;3914;1048;3577;264;1017;405;1249;669;2266
316530;201411;1147;3757;953;3347;241;1052;352;1033;593;2085
316540;201411;1046;3421;940;3241;255;1044;362;1146;617;2190
316550;201411;1353;4527;1240;4347;267;1022;770;2705;1037;3727
316553;201411;2236;8079;1828;7077;625;2616;430;1597;1055;4213
316555;201411;3052;10344;2667;9912;246;888;2141;8171;2387;9059
316556;201411;592;1641;477;1436;36;147;363;1052;399;1199
316557;201411;743;2731;711;2674;339;1366;190;666;529;2032
316560;201411;383;1294;319;1150;92;388;76;232;168;620
316570;201411;1474;4686;1283;4282;259;945;679;2263;938;3208
316580;201411;294;860;223;716;62;238;73;209;135;447
316590;201411;1565;4360;1175;3694;211;787;683;2054;894;2841
316600;201411;1199;3914;1059;3628;373;1343;295;988;668;2331
316610;201411;637;2334;578;2221;139;594;336;1288;475;1882
316620;201411;2346;7370;2034;6748;457;1696;1104;3596;1561;5292
316630;201411;1585;5314;1388;4890;583;2140;426;1500;1009;3640
316640;201411;263;870;230;801;61;240;94;315;155;555
316650;201411;994;3751;868;3538;207;865;472;2047;679;2912
316660;201411;183;516;122;387;21;81;54;159;75;240
316670;201411;1851;5435;1478;4722;579;2044;349;1014;928;3058
316680;201411;2113;6124;1798;5648;240;740;1382;4434;1622;5174
316690;201411;1240;4249;1121;4007;388;1575;425;1470;813;3045
316695;201411;1267;3951;1125;3699;126;409;732;2519;858;2928
316700;201411;357;1211;333;1152;86;347;158;503;244;850
316710;201411;3534;13380;3063;12288;1073;4571;926;3877;1999;8448
316720;201411;19399;65329;16400;58536;5643;21461;4207;14741;9850;36202
316730;201411;450;1431;397;1329;102;400;204;628;306;1028
316740;201411;784;2690;704;2525;266;1029;222;770;488;1799
316750;201411;430;1491;382;1389;101;418;127;427;228;845
316760;201411;3739;12583;3159;11893;1805;6813;967;3847;2772;10660
316770;201411;1542;4529;1368;4294;202;691;950;3067;1152;3758
316780;201411;743;2560;679;2431;253;982;192;641;445;1623
316790;201411;891;2634;657;2212;188;705;228;757;416;1462
316800;201411;6030;20103;5474;19055;1161;4689;2786;9265;3947;13954
316805;201411;914;2489;854;2408;149;394;644;1878;793;2272
316810;201411;631;1964;553;1795;179;635;242;759;421;1394
316820;201411;420;1181;276;928;88;324;64;221;152;545
316830;201411;663;2337;639;2295;216;856;276;951;492;1807
316840;201411;3010;9151;2601;8390;705;2581;1086;3314;1791;5895
316850;201411;2280;7118;2047;6687;451;1619;1144;3735;1595;5354
316860;201411;25319;78045;22503;72752;6225;22261;9852;31334;16077;53595
316870;201411;7516;25042;6458;22465;2359;8833;1300;4393;3659;13226
316880;201411;961;3198;908;3099;350;1332;292;935;642;2267
316890;201411;1533;3917;1228;3501;474;1505;529;1432;1003;2937
316900;201411;2866;9048;2485;8270;788;2943;822;2477;1610;5420
316905;201411;507;1727;441;1576;190;707;132;463;322;1170
316910;201411;775;2637;608;2267;153;595;182;703;335;1298
316920;201411;1666;5020;1330;4492;263;935;648;2204;911;3139
316930;201411;9983;34516;8263;30500;2504;10158;1559;5397;4063;15555
316935;201411;5199;15643;3614;12395;1227;4676;732;2352;1959;7028
316940;201411;7248;24260;5991;21505;1640;6493;1561;5387;3201;11880
316950;201411;1646;4809;1416;4481;214;801;943;2968;1157;3769
316960;201411;5676;14554;4695;13283;1037;3167;2718;7689;3755;10856
316970;201411;3751;12149;3540;11787;1174;4467;1200;3677;2374;8144
316980;201411;1120;3335;812;2802;338;1285;200;690;538;1975
316990;201411;10610;35331;9293;32236;3716;13976;1185;3910;4901;17886
317000;201411;2823;9755;2717;9632;209;634;2179;8501;2388;9135
317005;201411;2703;8562;2458;8229;395;1340;1764;6016;2159;7356
317010;201411;34108;89549;21699;68891;6319;22144;5425;18040;11744;40184
317020;201411;58484;169903;37104;124047;9813;36156;9094;28359;18907;64515
317030;201411;908;2550;754;2319;121;437;429;1305;550;1742
317040;201411;13917;41840;11955;38184;4026;13404;4853;15773;8879;29177
317043;201411;889;2518;753;2338;155;502;473;1496;628;1998
317047;201411;1249;3272;924;2725;175;573;421;1227;596;1800
317050;201411;1940;6840;1615;6063;465;1893;599;2155;1064;4048
317052;201411;2571;8168;2280;7722;271;1022;1702;5810;1973;6832
317057;201411;1863;5329;1438;4595;204;785;791;2446;995;3231
317060;201411;416;1243;308;994;73;271;104;299;177;570
317065;201411;1270;4221;1157;4034;125;518;905;3129;1030;3647
317070;201411;9611;31649;7215;26042;2122;8468;1506;5460;3628;13928
317075;201411;1316;4106;1105;3707;378;1373;370;1188;748;2561
317080;201411;7531;21525;6728;20159;2069;6607;2616;7829;4685;14436
317090;201411;5066;17060;4724;16467;717;2564;3253;11562;3970;14126
317100;201411;3577;10320;2933;9229;983;3417;1163;3467;2146;6884
317103;201411;2060;7175;1741;6510;362;1677;787;2849;1149;4526
317107;201411;1416;4378;1220;3982;250;949;674;2063;924;3012
317110;201411;790;2088;539;1621;154;539;217;603;371;1142
317115;201411;1147;3683;994;3348;151;527;640;2184;791;2711
317120;201411;13903;47278;11804;42248;3871;14825;4397;15473;8268;30298
317130;201411;9352;29704;8294;27781;2287;8583;3659;11970;5946;20553
317140;201411;685;2348;645;2271;88;336;425;1496;513;1832
317150;201411;1102;3028;930;2832;106;368;690;2102;796;2470
317160;201411;3969;10520;2961;9213;389;1374;2032;6265;2421;7639
317170;201411;2106;6047;1823;5562;248;886;1083;3126;1331;4012
317180;201411;1896;6402;1485;5479;438;1772;468;1665;906;3437
317190;201411;1431;4103;1179;3757;174;568;823;2630;997;3198
317200;201411;5065;16525;4523;15408;1499;5609;1482;4825;2981;10434
317210;201411;1157;3514;956;3213;255;956;468;1585;723;2541
317220;201411;364;1293;353;1280;125;462;183;678;308;1140
320010;201411;6085;19123;5356;17491;1003;3507;2764;8987;3767;12494
320013;201411;2129;6291;1499;5092;237;849;798;2777;1035;3626
320016;201411;3649;10125;3072;9294;483;1448;2152;6650;2635;8098
320020;201411;4558;14490;4003;13319;1343;4756;1449;4778;2792;9534
320030;201411;1584;5084;1272;4391;392;1440;486;1623;878;3063
320035;201411;1991;5988;1780;5658;531;1880;850;2570;1381;4450
320040;201411;3299;11108;2670;9574;708;2786;760;2598;1468;5384
320050;201411;2006;5461;1728;4930;297;951;1048;2923;1345;3874
320060;201411;11829;37633;9121;31162;2325;8778;3146;10134;5471;18912
320070;201411;1750;5786;1469;5103;445;1686;374;1170;819;2856
320080;201411;5838;17152;4593;14632;1439;4895;1445;4547;2884;9442
320090;201411;9247;26548;7175;22462;1974;6606;3142;9536;5116;16142
320100;201411;3293;9963;2696;8763;679;2366;1265;4049;1944;6415
320110;201411;1577;4793;1423;4499;389;1317;506;1561;895;2878
320115;201411;1827;6547;1662;6201;891;3468;465;1746;1356;5214
320120;201411;19099;62914;15771;56102;5457;20816;4588;16475;10045;37291
320130;201411;43980;145824;40533;138411;11121;41259;19068;63646;30189;104905
320140;201411;4184;13438;2905;10336;778;3076;316;1040;1094;4116
320150;201411;18887;53515;13895;43810;4312;14684;2655;8216;6967;22900
320160;201411;5606;17153;4795;15725;1330;4919;1955;5923;3285;10842
320170;201411;1693;5522;1417;4891;392;1420;548;1926;940;3346
320180;201411;914;3007;815;2849;319;1145;290;1034;609;2179
320190;201411;4062;14020;3232;11919;998;3886;956;3455;1954;7341
320200;201411;1199;3845;1043;3533;306;1104;442;1529;748;2633
320210;201411;5043;14156;4342;12845;919;3106;2373;6674;3292;9780
320220;201411;3109;9478;2445;8277;735;2714;942;3216;1677;5930
320225;201411;1582;5514;1322;4850;486;1893;296;1135;782;3028
320230;201411;4441;14851;4099;14216;1423;5304;1475;5183;2898;10487
320240;201411;11187;33503;8526;28372;2483;8946;2306;7656;4789;16602
320245;201411;4210;14343;3894;13557;1292;4763;1357;4596;2649;9359
320250;201411;1900;5914;1409;4790;383;1456;307;929;690;2385
320255;201411;2097;7005;1818;6520;743;2867;649;2389;1392;5256
320260;201411;1132;3513;856;2807;234;860;282;782;516;1642
320265;201411;2594;8022;2199;7531;359;1263;1528;5398;1887;6661
320270;201411;2849;8698;2160;7295;565;2068;927;3076;1492;5144
320280;201411;7522;22948;6755;21464;1669;5768;3203;9941;4872;15709
320290;201411;1771;5861;1383;4863;499;1842;327;1053;826;2895
320300;201411;4461;15068;4075;14165;1313;4857;1233;4255;2546;9112
320305;201411;4902;16085;4407;14936;1137;4219;1969;6463;3106;10682
320310;201411;2084;6307;1822;5815;505;1725;790;2445;1295;4170
320313;201411;2477;7451;1757;5772;503;1903;302;886;805;2789
320316;201411;2394;7322;2086;6676;670;2247;848;2676;1518;4923
320320;201411;20517;65436;17091;58708;5185;19710;6332;21199;11517;40909
320330;201411;3172;9522;2723;8747;589;1849;1569;5254;2158;7103
320332;201411;5298;17967;4753;16926;1682;6303;1746;6375;3428;12678
320334;201411;1653;5465;1197;4430;400;1653;254;856;654;2509
320335;201411;2385;7208;1649;5484;548;2007;336;1053;884;3060
320340;201411;6057;17017;4821;14866;1184;4002;2244;6814;3428;10816
320350;201411;5727;15052;4160;12294;976;3128;1693;4912;2669;8040
320360;201411;1809;4845;1342;3946;265;892;630;1712;895;2604
320370;201411;3634;11919;3025;10622;947;3416;1151;4053;2098;7469
320380;201411;2976;8991;2648;8380;513;1774;1581;4907;2094;6681
320390;201411;7886;24107;6466;21129;2110;7594;2027;6244;4137;13838
320400;201411;4196;12119;3478;11024;1025;3660;1461;4303;2486;7963
320405;201411;4252;12605;3851;12039;1187;4005;2011;6160;3198;10165
320410;201411;6462;15937;4609;13771;920;2873;2792;8360;3712;11233
320420;201411;1608;5010;1153;4183;382;1512;216;766;598;2278
320425;201411;2495;6380;2021;5670;358;1102;1210;3377;1568;4479
320430;201411;2504;7313;2248;6802;470;1515;1195;3570;1665;5085
320435;201411;2703;9080;2291;8202;1080;4009;698;2603;1778;6612
320440;201411;1474;4946;1312;4491;388;1437;429;1396;817;2833
320450;201411;2594;8342;2189;7459;662;2430;900;2985;1562;5415
320455;201411;4719;16195;3475;13003;1145;4519;843;3105;1988;7624
320460;201411;3278;10594;2609;9162;753;2838;949;3206;1702;6044
320465;201411;1767;5573;1363;4599;341;1227;523;1701;864;2928
320470;201411;4929;15063;3464;11768;1105;4090;531;1600;1636;5690
320480;201411;2026;6130;1670;5419;426;1615;710;2177;1136;3792
320490;201411;15724;49150;12898;43437;4271;15476;3938;13361;8209;28837
320495;201411;1399;4403;1061;3631;475;1677;135;490;610;2167
320500;201411;49501;154139;43032;141617;12905;46183;19398;62201;32303;108384
320501;201411;4033;13036;3615;12316;1158;4429;1575;5186;2733;9615
320503;201411;1732;6025;1412;5261;471;1923;442;1489;913;3412
320506;201411;3538;11216;2343;8103;770;2834;182;550;952;3384
320510;201411;9423;29998;8183;27444;2501;9076;3429;11288;5930;20364
320515;201411;2244;6446;1936;5818;580;1827;666;1961;1246;3788
320517;201411;2396;7784;1952;6822;777;2920;429;1404;1206;4324
320520;201411;37854;119369;31577;106834;9938;36726;12468;41909;22406;78635
320530;201411;30593;94836;25800;85152;6771;25418;11575;36132;18346;61550
330010;201411;19692;61152;17862;57350;3617;12956;10518;32753;14135;45709
330015;201411;2057;5728;1777;5199;460;1508;678;1917;1138;3425
330020;201411;17827;53297;16233;50661;3730;12643;9256;28468;12986;41111
330022;201411;1749;5601;1539;5193;325;1284;832;2687;1157;3971
330023;201411;3642;11841;3376;11287;948;3436;1383;4413;2331;7849
330025;201411;4108;11610;3482;10696;866;2916;1974;5947;2840;8863
330030;201411;8391;28475;7384;26312;2009;7852;3309;11328;5318;19180
330040;201411;15227;44147;12874;40181;3420;11497;6343;19319;9763;30816
330045;201411;72772;207325;65754;196640;9541;30753;45708;135572;55249;166325
330050;201411;3048;9725;2707;9032;940;3494;802;2496;1742;5990
330060;201411;5957;17966;5301;17006;1318;4678;2969;9536;4287;14214
330070;201411;27158;83406;24342;78349;6683;22824;11230;36222;17913;59046
330080;201411;9888;28264;9333;27435;1744;4985;6365;19212;8109;24197
330090;201411;3393;9367;3127;8913;842;2580;1532;4294;2374;6874
330093;201411;2083;6207;1723;5475;432;1472;582;1755;1014;3227
330095;201411;1283;4420;1169;4154;429;1684;225;717;654;2401
330100;201411;58876;191739;53880;182736;12009;45191;27990;95332;39999;140523
330110;201411;2804;8872;2555;8400;806;2868;852;2788;1658;5656
330115;201411;2527;7511;2305;7137;665;2266;1086;3244;1751;5510
330120;201411;2647;7679;2406;7343;749;2483;1115;3277;1864;5760
330130;201411;4266;14034;3832;13194;1254;4634;1537;5285;2791;9919
330140;201411;3694;11271;3335;10756;931;3208;1664;5433;2595;8641
330150;201411;2695;8059;2079;6763;549;1945;516;1634;1065;3579
330160;201411;1469;5090;1362;4863;497;1907;510;1780;1007;3687
330170;201411;111134;336851;103520;324573;17004;56974;70449;220936;87453;277910
330180;201411;1947;5900;1691;5410;230;938;1063;3165;1293;4103
330185;201411;8630;27198;7817;25639;2109;7327;3902;12889;6011;20216
330187;201411;4593;13183;4052;12266;836;2760;2441;7406;3277;10166
330190;201411;30379;90340;28662;87474;6697;21538;17487;52851;24184;74389
330200;201411;14780;46644;13255;43743;3275;11012;7057;23726;10332;34738
330205;201411;2701;7334;2373;6766;582;1854;1194;3297;1776;5151
330210;201411;4541;11959;3290;9646;980;3110;819;2379;1799;5489
330220;201411;12268;38448;11062;35844;3651;12760;3316;10237;6967;22997
330225;201411;4267;13417;3997;13008;504;1904;2908;9573;3412;11477
330227;201411;19097;53575;16795;50307;4140;13149;9476;28045;13616;41194
330230;201411;1545;4592;1407;4344;413;1422;580;1677;993;3099
330240;201411;21418;66568;18958;61955;7590;26827;3784;12018;11374;38845
330245;201411;1332;4189;1087;3686;312;1149;260;886;572;2035
330250;201411;39317;115402;36207;110086;10863;33473;17358;53976;28221;87449
330260;201411;4176;13113;3750;12218;935;3331;1738;5444;2673;8775
330270;201411;15446;44050;12734;39817;3882;12919;4838;15251;8720;28170
330280;201411;2180;6748;1833;6024;387;1410;885;2754;1272;4164
330285;201411;20395;60021;18699;57522;3711;12192;11973;36877;15684;49069
330290;201411;3751;10612;3312;9972;684;2348;1961;5646;2645;7994
330300;201411;4246;13769;3938;13200;925;3332;2115;7091;3040;10423
330310;201411;2902;8386;2596;7846;624;1919;1314;3972;1938;5891
330320;201411;13361;39985;12501;38644;1936;6506;8940;27497;10876;34003
330330;201411;34029;97281;30999;92365;7041;22477;19021;55966;26062;78443
330340;201411;15909;48724;12847;42612;4146;14659;3698;12173;7844;26832
330350;201411;100014;311370;95376;304303;17830;57845;66480;214589;84310;272434
330360;201411;6026;18747;5878;18514;721;2470;4636;14523;5357;16993
330370;201411;4054;14873;3775;14219;1476;5792;1244;4715;2720;10507
330380;201411;5015;16105;4334;14822;1068;3937;2139;7230;3207;11167
330385;201411;4261;14762;3932;14083;1352;5140;1499;5326;2851;10466
330390;201411;25341;85171;22914;80138;5836;22697;11241;38344;17077;61041
330395;201411;3561;10559;3273;10046;594;2026;1980;6006;2574;8032
330400;201411;2732;9078;2489;8598;526;2111;1305;4172;1831;6283
330410;201411;3162;10076;2717;9176;618;2211;1384;4673;2002;6884
330411;201411;2717;8611;2371;7891;461;1805;1279;4000;1740;5805
330412;201411;1477;5058;1167;4448;314;1359;422;1512;736;2871
330414;201411;27186;76990;23301;71709;4320;13836;15064;46717;19384;60553
330415;201411;3877;12012;3385;11082;918;3224;1440;4732;2358;7956
330420;201411;9470;29145;6683;23457;1987;7648;1210;4157;3197;11805
330430;201411;8793;25792;7756;23914;1820;6133;3884;11791;5704;17924
330440;201411;2179;7259;1824;6512;643;2570;403;1285;1046;3855
330450;201411;1749;5912;1605;5639;493;1956;699;2408;1192;4364
330452;201411;11488;34817;9161;30128;2536;9208;3645;11531;6181;20739
330455;201411;509766;1479388;431866;1350460;113583;377954;217677;678033;331260;1055987
330460;201411;1444;4785;1317;4557;338;1353;632;2145;970;3498
330470;201411;5000;15904;4532;14991;1540;5599;1637;5169;3177;10768
330475;201411;8706;27325;7762;25676;2224;8012;3436;11342;5660;19354
330480;201411;6855;20304;6259;19357;1682;5572;3026;9264;4708;14836
330490;201411;107854;299284;99561;287112;12706;38378;76178;220658;88884;259036
330500;201411;7220;21982;6777;21094;1467;4892;3820;12108;5287;17000
330510;201411;44943;143392;41803;138083;13575;45635;20572;69450;34147;115085
330513;201411;1635;4898;1485;4614;526;1656;593;1872;1119;3528
330515;201411;3201;10108;2886;9500;941;3267;1016;3301;1957;6568
330520;201411;13758;41190;12459;38899;3264;10685;6341;19879;9605;30564
330530;201411;1614;4820;1458;4519;387;1293;658;1999;1045;3292
330540;201411;3635;10799;3079;9877;859;2972;1306;4126;2165;7098
330550;201411;9169;30210;8032;28031;3446;12681;1869;6531;5315;19212
330555;201411;10942;33049;9793;31299;1942;6356;6201;20205;8143;26561
330560;201411;4431;13473;4060;12834;906;3252;2102;6383;3008;9635
330570;201411;3773;10886;3191;9898;840;2678;1630;5137;2470;7815
330575;201411;5866;17293;5300;16316;1136;3831;3161;9395;4297;13226
330580;201411;18057;57928;15688;53019;5068;17994;5963;20417;11031;38411
330590;201411;2035;6113;1900;5879;533;1678;1013;3179;1546;4857
330600;201411;11025;31987;8914;28522;1377;5303;5295;16316;6672;21619
330610;201411;9554;30609;8801;29210;2053;7657;4674;15274;6727;22931
330615;201411;1756;6194;1587;5779;700;2673;453;1692;1153;4365
330620;201411;4230;14694;3848;13935;1418;5455;1077;4014;2495;9469
330630;201411;24328;76389;20849;69735;5188;19533;10526;33678;15714;53211
350010;201411;3066;9569;2361;8067;785;2815;450;1448;1235;4263
350020;201411;652;1858;492;1547;139;491;196;586;335;1077
350030;201411;5060;16028;4169;14028;1694;6206;989;3124;2683;9330
350040;201411;622;2217;524;1994;170;706;116;385;286;1091
350050;201411;1468;4749;1223;4262;345;1374;409;1313;754;2687
350055;201411;691;2226;653;2166;200;751;322;1000;522;1751
350060;201411;94;324;87;311;27;114;33;108;60;222
350070;201411;2731;8965;2065;7393;508;1995;411;1272;919;3267
350075;201411;579;1989;492;1829;172;711;133;444;305;1155
350080;201411;648;1893;494;1581;117;411;190;601;307;1012
350090;201411;608;1726;452;1448;125;434;128;365;253;799
350100;201411;2137;7176;1701;6166;570;2214;500;1745;1070;3959
350110;201411;512;1551;390;1270;90;334;151;450;241;784
350115;201411;1318;4198;1153;3799;234;891;573;1720;807;2611
350120;201411;549;1463;273;865;69;243;50;149;119;392
350130;201411;3973;12026;3564;11194;857;3020;1692;4959;2549;7979
350140;201411;708;2239;632;2091;154;580;274;864;428;1444
350150;201411;458;1561;411;1450;158;583;114;405;272;988
350160;201411;6814;21328;5149;17680;1520;5818;1962;6136;3482;11954
350170;201411;2351;8320;2075;7596;710;2719;501;1742;1211;4461
350180;201411;1487;3926;1226;3474;327;958;535;1492;862;2450
350190;201411;3562;11884;3046;10831;807;3398;1505;4843;2312;8241
350200;201411;408;1393;370;1327;126;510;133;459;259;969
350210;201411;7890;21972;6157;18953;2333;7767;2062;6032;4395;13799
350220;201411;3260;10442;2953;9877;1006;3816;952;2901;1958;6717
350230;201411;803;2713;733;2590;242;921;262;928;504;1849
350240;201411;613;1867;534;1740;127;466;298;939;425;1405
350250;201411;2864;10632;2766;10434;1122;4488;974;3649;2096;8137
350260;201411;1133;3014;923;2647;221;646;403;1174;624;1820
350270;201411;5542;16970;4825;15417;981;3392;2364;7448;3345;10840
350275;201411;2152;7220;1930;6855;559;2183;738;2470;1297;4653
350280;201411;24744;63612;15724;47315;4053;12936;3810;11485;7863;24421
350290;201411;2051;6944;1740;6238;521;1938;542;1996;1063;3934
350300;201411;547;1699;489;1584;146;488;206;674;352;1162
350310;201411;990;3321;891;3082;210;829;369;1218;579;2047
350315;201411;579;1820;471;1589;92;395;143;436;235;831
350320;201411;12251;38962;10482;35148;3150;11283;1631;5515;4781;16798
350330;201411;13451;39084;8725;27374;1917;6326;3223;9354;5140;15680
350335;201411;567;1672;521;1577;138;431;221;731;359;1162
350340;201411;1173;3639;886;3067;232;893;271;895;503;1788
350350;201411;780;2487;685;2327;174;692;250;843;424;1535
350360;201411;944;3325;814;3035;257;1005;294;1126;551;2131
350370;201411;745;2296;547;1832;118;445;113;319;231;764
350380;201411;4045;13086;3352;11927;1338;5184;856;2870;2194;8054
350390;201411;9062;29135;8006;27068;2337;8428;3560;11694;5897;20122
350395;201411;380;1127;239;832;62;233;53;177;115;410
350400;201411;8926;26104;7342;23190;2090;7225;2862;8642;4952;15867
350410;201411;8748;31087;7231;27569;2483;10242;1623;5943;4106;16185
350420;201411;967;3081;768;2694;373;1356;95;327;468;1683
350430;201411;887;2807;759;2575;207;823;372;1210;579;2033
350440;201411;1508;4861;1411;4669;461;1626;674;2144;1135;3770
350450;201411;8346;25262;6564;21639;1947;6964;1775;5524;3722;12488
350460;201411;1655;4873;1180;3830;340;1246;373;1090;713;2336
350470;201411;261;726;214;649;51;190;107;294;158;484
350480;201411;761;2352;508;1757;84;326;91;270;175;596
350490;201411;2139;6230;1818;5787;526;1925;794;2333;1320;4258
350500;201411;628;1853;547;1728;144;497;225;677;369;1174
350510;201411;1189;3756;954;3182;262;997;346;1042;608;2039
350520;201411;1021;3818;864;3453;276;1204;226;838;502;2042
350530;201411;2678;8079;2206;7034;794;2732;628;1830;1422;4562
350535;201411;1524;4567;1444;4429;100;378;1169;3548;1269;3926
350540;201411;2121;6001;1752;5323;511;1672;666;2006;1177;3678
350550;201411;11506;33743;9109;29497;2526;9140;3527;10811;6053;19951
350560;201411;3711;12375;3340;11566;648;2394;1725;6039;2373;8433
350570;201411;22432;77229;20398;72474;6700;25430;7380;25223;14080;50653
350580;201411;2074;6763;1610;5634;497;1918;247;738;744;2656
350590;201411;4247;13589;3230;11378;957;3765;1113;3547;2070;7312
350600;201411;42690;108669;29541;87037;5885;19149;14971;42445;20856;61594
350610;201411;9729;28365;7645;24729;2052;7402;3317;10356;5369;17758
350620;201411;505;1534;411;1383;106;401;170;535;276;936
350630;201411;1806;5543;1402;4717;420;1598;300;884;720;2482
350635;201411;5705;18104;4497;15734;1361;5059;1715;5983;3076;11042
350640;201411;706;2309;558;1907;149;547;148;474;297;1021
350650;201411;7057;21646;3758;13397;1126;4419;356;1255;1482;5674
350660;201411;3993;12420;3445;11446;804;2957;1860;6039;2664;8996
350670;201411;1963;6123;1826;5865;383;1346;1121;3476;1504;4822
350680;201411;1289;4010;1028;3467;296;1157;401;1285;697;2442
350690;201411;1137;3777;958;3399;296;1154;281;935;577;2089
350700;201411;2926;10014;2527;9096;980;3840;844;2719;1824;6559
350710;201411;2431;7673;2169;7235;344;1266;1445;4788;1789;6054
350715;201411;1123;3423;984;3158;309;1139;332;963;641;2102
350720;201411;146;442;131;409;44;153;46;123;90;276
350730;201411;462;1743;436;1672;131;560;146;524;277;1084
350740;201411;2555;7747;2197;6946;566;1942;920;2871;1486;4813
350745;201411;416;1287;309;1031;62;243;138;405;200;648
350750;201411;10597;32484;8132;27459;2291;8498;2069;6542;4360;15040
350760;201411;13178;41688;11682;38902;3585;13226;5091;16161;8676;29387
350770;201411;949;2795;687;2273;161;608;273;872;434;1480
350775;201411;711;2012;605;1832;153;534;281;829;434;1363
350780;201411;2237;6826;1659;5583;523;1941;231;730;754;2671
350790;201411;2300;7450;1795;6379;549;2107;401;1267;950;3374
350800;201411;3295;11151;3122;10852;662;2601;1885;6390;2547;8991
350810;201411;2692;7868;2342;7250;841;2820;728;2256;1569;5076
350820;201411;600;1642;442;1311;90;325;189;500;279;825
350830;201411;945;2983;674;2327;125;462;148;443;273;905
350840;201411;2502;8932;2057;7794;670;2795;410;1325;1080;4120
350850;201411;7069;23972;5880;21116;2128;8090;1464;5049;3592;13139
350860;201411;3541;11335;3384;11084;469;1760;2564;8322;3033;10082
350870;201411;2634;8794;2299;8271;664;2591;1289;4679;1953;7270
350880;201411;1768;5972;1513;5394;495;1871;321;1130;816;3001
350890;201411;712;2114;501;1630;111;426;132;340;243;766
350900;201411;4773;16084;3883;13984;1078;4210;994;3375;2072;7585
350910;201411;958;2889;861;2679;336;1087;301;909;637;1996
350920;201411;10611;31621;9660;29995;1826;6255;6187;18531;8013;24786
350925;201411;4587;14123;3853;12601;1018;3625;1618;4935;2636;8560
350930;201411;1656;4587;1370;4115;175;633;946;2731;1121;3364
350940;201411;2394;8002;2183;7648;495;2015;1291;4332;1786;6347
350945;201411;978;3248;859;2977;212;816;390;1291;602;2107
350950;201411;75985;243154;63876;217679;18398;68265;26175;86435;44573;154700
350960;201411;4938;17318;4358;15990;855;3620;2467;8697;3322;12317
350970;201411;4726;16946;4120;15452;1471;5964;1174;4160;2645;10124
350980;201411;736;2397;672;2286;316;1129;189;660;505;1789
350990;201411;1919;6644;1680;6174;585;2320;522;1851;1107;4171
350995;201411;876;3081;830;2988;202;853;450;1551;652;2404
351000;201411;3787;11494;3255;10462;514;1888;1850;5731;2364;7619
351010;201411;448;1342;320;1077;126;471;75;245;201;716
351015;201411;981;3271;847;3013;293;1152;305;1042;598;2194
351020;201411;8307;26828;7301;25206;1990;7363;3514;12253;5504;19616
351030;201411;1669;6002;1526;5675;411;1793;580;1987;991;3780
351040;201411;3920;12505;3608;11932;788;3052;2134;6654;2922;9706
351050;201411;10716;33812;8444;29305;2701;10206;2834;9729;5535;19935
351060;201411;38353;118709;31811;106228;9630;34412;12327;40518;21957;74930
351070;201411;1989;5607;1405;4553;491;1746;248;674;739;2420
351080;201411;2964;8918;2337;8110;680;2620;1071;3597;1751;6217
351090;201411;418;1448;324;1236;88;382;75;280;163;662
351100;201411;2238;7048;1876;6314;727;2521;583;1997;1310;4518
351110;201411;8730;22569;4808;15620;1330;4804;1234;3696;2564;8500
351120;201411;661;1982;537;1707;72;265;270;773;342;1038
351130;201411;935;2609;489;1673;93;384;122;376;215;760
351140;201411;2084;7222;1896;6806;704;2739;590;2056;1294;4795
351150;201411;2378;8262;1882;6900;552;2209;435;1444;987;3653
351160;201411;1617;5665;1450;5274;478;1924;501;1743;979;3667
351170;201411;1705;5649;1376;4869;357;1378;572;1878;929;3256
351190;201411;734;2376;592;2006;147;537;125;365;272;902
351200;201411;2446;7324;2045;6513;545;1962;740;2127;1285;4089
351210;201411;1168;3645;957;3215;295;1062;319;1005;614;2067
351220;201411;3694;12453;3262;11547;856;3276;1507;5288;2363;8564
351230;201411;2070;6811;1838;6362;511;1959;953;3209;1464;5168
351240;201411;1055;3350;754;2647;211;820;190;571;401;1391
351250;201411;911;2623;663;2115;132;456;301;923;433;1379
351260;201411;1218;3601;1086;3321;279;934;454;1322;733;2256
351270;201411;423;1492;385;1412;117;491;141;462;258;953
351280;201411;5616;16963;4127;13564;1081;3799;1341;4009;2422;7808
351290;201411;1182;3468;936;2984;285;945;327;968;612;1913
351300;201411;11825;42219;9696;37232;2913;12123;3367;12802;6280;24925
351310;201411;3586;11220;2983;10111;744;2896;1401;4423;2145;7319
351320;201411;1056;3719;916;3387;311;1247;234;763;545;2010
351330;201411;306;872;258;784;109;336;63;188;172;524
351340;201411;6962;24169;6255;22687;1840;7019;2944;10708;4784;17727
351350;201411;8323;27329;7286;25055;2243;8125;2554;8384;4797;16509
351360;201411;5004;15343;4668;14721;1269;4344;2124;6500;3393;10844
351370;201411;2329;7414;1847;6377;547;2143;590;1845;1137;3988
351380;201411;38649;120604;35465;114188;9257;32407;16690;51592;25947;83999
351385;201411;254;797;247;786;85;276;103;319;188;595
351390;201411;1347;4479;1165;4096;408;1573;456;1498;864;3071
351400;201411;1253;4078;1177;3893;465;1632;348;1167;813;2799
351410;201411;3117;9410;2753;8752;630;2159;1473;4567;2103;6726
351420;201411;459;1372;334;1095;99;330;65;210;164;540
351430;201411;921;2941;842;2797;136;477;599;2003;735;2480
351440;201411;4913;15052;4101;13227;1482;4917;1027;3126;2509;8043
351450;201411;1906;5423;1659;5071;531;1675;790;2485;1321;4160
351460;201411;863;2716;731;2459;355;1267;211;673;566;1940
351470;201411;1147;3522;1018;3270;371;1299;336;1042;707;2341
351480;201411;3099;10051;2811;9557;628;2520;1450;4764;2078;7284
351490;201411;2090;7074;1871;6593;368;1498;1042;3521;1410;5019
351492;201411;195;617;136;474;26;106;59;195;85;301
351495;201411;164;561;130;473;42;164;43;144;85;308
351500;201411;22980;73093;19771;66480;6310;23226;7579;24463;13889;47689
351510;201411;8375;26845;7026;24249;1790;6691;3458;11803;5248;18494
351512;201411;461;1358;387;1216;91;302;187;578;278;880
351515;201411;2330;7494;1719;6092;522;2011;477;1570;999;3581
351518;201411;1841;6193;1316;5186;393;1750;302;1092;695;2842
351519;201411;902;2826;739;2457;217;854;277;810;494;1664
351520;201411;833;2330;410;1462;81;330;68;211;149;541
351530;201411;392;1206;292;965;41;147;99;283;140;430
351535;201411;2725;7033;2181;6249;250;817;1540;4360;1790;5177
351540;201411;2284;7242;2001;6710;886;3160;422;1385;1308;4545
351550;201411;4366;12767;3107;10245;746;2812;1147;3632;1893;6444
351560;201411;456;1476;396;1336;123;444;79;262;202;706
351565;201411;252;849;233;800;73;286;98;306;171;592
351570;201411;13833;44486;12007;40705;3392;12243;5804;19344;9196;31587
351580;201411;415;1160;305;930;58;176;105;312;163;488
351590;201411;541;1498;418;1244;121;385;100;279;221;664
351600;201411;2013;5743;1789;5356;382;1306;872;2438;1254;3744
351610;201411;712;1961;566;1703;97;335;284;805;381;1140
351620;201411;18068;58758;13679;49174;3497;13943;3529;11207;7026;25150
351630;201411;17534;57896;16057;55330;3963;14280;9283;32043;13246;46323
351640;201411;9407;30041;7818;27166;1822;6944;4093;13954;5915;20898
351650;201411;435;1309;249;832;71;254;39;122;110;376
351660;201411;771;2427;565;1906;138;492;168;508;306;1000
351670;201411;4099;12772;3391;11250;681;2628;1697;5254;2378;7882
351680;201411;691;2119;427;1433;98;350;71;208;169;558
351685;201411;469;1434;380;1272;102;350;158;542;260;892
351690;201411;1416;4217;1083;3435;426;1351;302;910;728;2261
351700;201411;1567;4669;1406;4354;471;1515;514;1546;985;3061
351710;201411;822;2575;691;2279;173;594;225;685;398;1279
351720;201411;1819;5701;1321;4399;323;1178;440;1347;763;2525
351730;201411;1197;3515;1003;3247;405;1452;343;1046;748;2498
351740;201411;4899;13915;4025;12078;1074;3447;1342;3800;2416;7247
351750;201411;1623;5343;1365;4786;448;1752;387;1239;835;2991
351760;201411;3969;12650;3441;11467;960;3428;1406;4484;2366;7912
351770;201411;2472;7899;2119;7258;628;2289;1056;3553;1684;5842
351780;201411;1652;4689;1044;3327;274;955;245;720;519;1675
351790;201411;1209;3598;1041;3357;373;1257;438;1397;811;2654
351800;201411;431;959;320;807;40;109;198;484;238;593
351810;201411;1239;3735;1163;3639;278;1002;750;2250;1028;3252
351820;201411;1952;6227;1579;5535;524;1949;193;651;717;2600
351830;201411;4709;15061;3811;12879;901;3314;1792;5831;2693;9145
351840;201411;9416;32544;8338;30264;2850;10981;2846;10147;5696;21128
351850;201411;1597;5076;1279;4399;348;1394;427;1276;775;2670
351860;201411;3788;12268;3401;11458;1009;3698;1473;4726;2482;8424
351870;201411;36768;113521;32961;106490;8610;29513;17364;55954;25974;85467
351880;201411;107029;347337;93114;316555;29177;104989;27905;93333;57082;198322
351885;201411;668;2427;621;2318;185;753;279;994;464;1747
351890;201411;869;2631;700;2269;221;774;177;542;398;1316
351900;201411;1467;4527;1265;4207;377;1329;493;1644;870;2973
351905;201411;464;1579;393;1449;93;415;201;678;294;1093
351907;201411;16614;51882;14314;47442;2900;10984;7811;24812;10711;35796
351910;201411;1248;3950;1143;3771;286;1077;452;1399;738;2476
351920;201411;1230;3534;1141;3388;269;900;659;1911;928;2811
351925;201411;1056;3150;954;2953;158;583;576;1668;734;2251
351930;201411;3296;11161;3065;10671;863;3499;1470;4651;2333;8150
351940;201411;1066;3271;982;3121;282;978;565;1720;847;2698
351950;201411;1472;4078;1072;3309;193;674;551;1627;744;2301
351960;201411;4347;13016;3332;11152;952;3372;1540;5147;2492;8519
351970;201411;7197;27244;6503;25708;2356;9737;2175;8659;4531;18396
351980;201411;1005;3061;805;2660;187;696;317;930;504;1626
351990;201411;1683;4855;1342;4179;403;1438;335;909;738;2347
352000;201411;2592;8337;2355;7847;648;2322;1030;3256;1678;5578
352010;201411;2358;7952;2110;7344;733;2662;447;1537;1180;4199
352020;201411;1664;5335;1464;4919;443;1585;534;1742;977;3327
352030;201411;5014;15196;4369;14263;1111;3828;2395;7924;3506;11752
352040;201411;2115;7305;1768;6425;487;1913;426;1440;913;3353
352042;201411;2678;7534;1927;5934;442;1491;964;2903;1406;4394
352044;201411;1470;4982;1119;4079;262;1024;212;701;474;1725
352050;201411;7162;23098;4867;17820;1464;5932;977;3085;2441;9017
352060;201411;872;2578;757;2379;199;749;311;894;510;1643
352070;201411;765;2066;705;1972;269;791;259;770;528;1561
352080;201411;610;1829;484;1596;145;543;169;502;314;1045
352090;201411;1803;5858;1418;5009;377;1500;373;1156;750;2656
352100;201411;2587;8080;1866;6618;531;2099;642;2073;1173;4172
352110;201411;508;1880;453;1743;141;580;163;602;304;1182
352115;201411;425;1396;363;1258;90;361;162;512;252;873
352120;201411;898;2754;772;2542;144;536;429;1395;573;1931
352130;201411;1937;5608;1350;4404;397;1392;441;1316;838;2708
352140;201411;1776;5502;1238;4299;330;1239;521;1765;851;3004
352150;201411;726;2202;554;1859;154;523;243;792;397;1315
352160;201411;1314;3677;1188;3506;270;849;698;2072;968;2921
352170;201411;2664;8125;2402;7624;555;1971;1301;3899;1856;5870
352180;201411;3762;10771;3224;9769;896;2983;1325;3784;2221;6767
352190;201411;1219;3752;1115;3567;245;902;591;1792;836;2694
352200;201411;469;1619;386;1452;83;337;192;748;275;1085
352210;201411;16508;44393;13074;39264;2422;7640;7963;24372;10385;32012
352215;201411;584;1831;528;1750;76;300;318;1043;394;1343
352220;201411;15446;51487;14138;48748;4897;17913;5131;17557;10028;35470
352230;201411;14197;48646;12430;45217;3919;15500;4736;16918;8655;32418
352240;201411;10739;33314;9190;30431;3017;11207;3529;10979;6546;22186
352250;201411;22119;71649;19464;66057;5527;20222;7409;24833;12936;45055
352260;201411;6261;18821;4159;14278;1031;3928;1424;4512;2455;8440
352265;201411;939;2975;790;2728;123;511;475;1574;598;2085
352270;201411;2595;8921;2218;8031;855;3198;517;1810;1372;5008
352280;201411;2572;7944;2142;7192;593;2223;701;2237;1294;4460
352290;201411;1370;4402;1186;3993;300;1158;389;1183;689;2341
352300;201411;1053;3152;859;2791;251;898;387;1199;638;2097
352310;201411;33726;106856;29571;99638;7529;27202;17221;57568;24750;84770
352320;201411;5759;17853;4965;16293;1486;5332;1709;5074;3195;10406
352330;201411;1949;6422;1698;6071;591;2261;560;1990;1151;4251
352340;201411;6083;20702;4919;17884;1601;6274;962;3195;2563;9469
352350;201411;1869;6832;1697;6434;490;1996;607;2222;1097;4218
352360;201411;1251;4094;1111;3817;291;1203;642;2051;933;3254
352370;201411;943;3218;857;3023;207;828;398;1351;605;2179
352380;201411;1058;3370;929;3142;337;1266;266;866;603;2132
352390;201411;16713;46949;11226;36030;2256;8409;5424;16183;7680;24592
352400;201411;3281;9613;2145;7310;596;2203;692;2176;1288;4379
352410;201411;3893;11420;2994;9848;962;3434;957;3001;1919;6435
352420;201411;1333;3809;1229;3629;427;1400;508;1476;935;2876
352430;201411;6698;20996;5879;19628;2231;8075;2008;6575;4239;14650
352440;201411;16752;52769;13685;46570;3885;14276;5039;16654;8924;30930
352450;201411;688;2015;465;1573;123;472;110;325;233;797
352460;201411;2309;7665;1971;7020;662;2629;592;1934;1254;4563
352470;201411;4514;12436;2554;8249;455;1639;959;2907;1414;4546
352480;201411;5658;15987;4578;13966;1140;3994;1932;5415;3072;9409
352490;201411;776;2752;655;2450;160;664;146;501;306;1165
352500;201411;9004;28646;8409;27636;4019;14261;2565;7652;6584;21913
352510;201411;3629;12422;2981;11028;1130;4509;724;2592;1854;7101
352520;201411;2533;8972;2245;8279;619;2439;1116;4048;1735;6487
352530;201411;7190;23255;5228;18723;1569;6070;825;2672;2394;8742
352540;201411;488;1593;366;1308;62;259;107;370;169;629
352550;201411;906;3028;624;2329;168;707;117;375;285;1082
352560;201411;690;2045;515;1654;109;386;200;587;309;973
352570;201411;1603;5280;1159;4192;272;1124;280;897;552;2021
352580;201411;969;2892;828;2646;264;946;371;1113;635;2059
352585;201411;237;779;187;671;65;248;42;150;107;398
352590;201411;11784;37686;10276;34640;2322;8722;5728;18590;8050;27312
352600;201411;2063;6567;1871;6188;619;2171;741;2368;1360;4539
352610;201411;3721;11633;3181;10667;1117;4065;1014;3237;2131;7302
352620;201411;5770;18251;5443;17809;1200;4238;3499;11417;4699;15655
352630;201411;881;2914;833;2794;265;956;371;1222;636;2178
352640;201411;3245;10320;2669;9037;569;2139;1224;4013;1793;6152
352650;201411;890;2634;667;2167;152;544;223;672;375;1216
352660;201411;1107;3847;893;3319;257;1043;227;795;484;1838
352670;201411;11343;34946;6971;24887;2161;8143;1318;4528;3479;12671
352680;201411;3481;12133;2681;10135;649;2707;696;2339;1345;5046
352690;201411;29661;85792;21361;68667;5077;17995;9424;29130;14501;47125
352700;201411;810;2391;643;2132;198;744;285;889;483;1633
352710;201411;5596;16638;4108;13566;1100;4017;1571;4946;2671;8963
352720;201411;9453;31528;8703;29906;2904;10419;3401;11609;6305;22028
352725;201411;439;1288;288;947;57;220;99;297;156;517
352730;201411;2834;9776;2488;8823;690;2717;803;2540;1493;5257
352740;201411;2368;7039;2001;6397;506;1880;984;2926;1490;4806
352750;201411;447;1359;317;1056;96;345;69;196;165;541
352760;201411;1069;3762;956;3524;302;1187;461;1634;763;2821
352770;201411;967;2982;902;2864;291;985;325;1028;616;2013
352780;201411;651;2208;565;2001;145;581;181;581;326;1162
352790;201411;625;1802;447;1451;101;352;105;327;206;679
352800;201411;1262;4673;992;3895;320;1309;210;716;530;2025
352810;201411;1146;3053;797;2369;159;561;267;742;426;1303
352820;201411;642;1890;516;1689;207;713;118;392;325;1105
352830;201411;494;1406;344;1088;79;277;70;179;149;456
352840;201411;3892;13523;3406;12432;1082;4191;1047;3787;2129;7978
352850;201411;10506;33928;9149;31462;2795;10160;3370;11645;6165;21805
352860;201411;1087;3604;1009;3425;392;1384;303;967;695;2351
352870;201411;1151;2922;878;2396;147;505;464;1163;611;1668
352880;201411;2554;7550;1943;6197;509;1725;538;1575;1047;3300
352885;201411;320;1089;305;1056;93;350;137;446;230;796
352890;201411;838;2310;676;1988;157;516;279;741;436;1257
352900;201411;19210;57101;14043;46168;3329;11969;5564;17364;8893;29333
352910;201411;287;924;247;832;88;302;34;106;122;408
352920;201411;3463;10654;2922;9559;977;3476;1042;3150;2019;6626
352930;201411;7111;22840;5818;19900;1759;6505;1083;3492;2842;9997
352940;201411;26451;88443;22394;78566;8089;29873;3987;13297;12076;43170
352950;201411;337;1058;241;850;65;273;68;204;133;477
352960;201411;631;1972;417;1455;78;301;75;241;153;542
352965;201411;387;1106;314;967;86;288;56;164;142;452
352970;201411;3464;9108;3047;8519;496;1437;2087;5921;2583;7358
352980;201411;1593;4785;1355;4404;400;1323;651;2221;1051;3544
352990;201411;3761;12288;3366;11564;1047;4036;1272;4151;2319;8187
353000;201411;571;1610;395;1219;91;303;90;249;181;552
353010;201411;3046;8619;2250;7009;615;2150;769;2193;1384;4343
353020;201411;4632;12776;3141;9492;542;1853;1281;3504;1823;5357
353030;201411;4057;11960;3321;10510;1012;3473;877;2591;1889;6064
353040;201411;748;2150;642;1979;199;666;247;744;446;1410
353050;201411;5804;19962;4939;18117;1740;6890;1618;5663;3358;12553
353060;201411;36023;115364;33585;111360;5304;20853;23487;74959;28791;95812
353070;201411;9469;32091;7396;27287;2516;9819;1986;7294;4502;17113
353080;201411;5530;18436;4192;15356;1323;5262;1178;3990;2501;9252
353090;201411;619;2066;548;1915;96;400;273;870;369;1270
353100;201411;311;903;221;702;102;335;52;164;154;499
353110;201411;8193;25566;7322;23973;1913;6639;3896;12863;5809;19502
353120;201411;490;1623;412;1452;137;539;104;312;241;851
353130;201411;3144;9761;2727;9047;1044;3771;981;3106;2025;6877
353140;201411;2818;7898;2246;6748;721;2379;747;2025;1468;4404
353150;201411;2050;6435;1704;5784;604;2164;466;1593;1070;3757
353160;201411;711;2073;534;1698;168;546;97;278;265;824
353170;201411;529;1859;479;1765;169;703;194;685;363;1388
353180;201411;5777;17985;5010;16534;761;2868;3115;10034;3876;12902
353190;201411;3842;12175;3303;10930;768;2840;1557;4774;2325;7614
353200;201411;884;3047;748;2705;237;930;227;797;464;1727
353205;201411;554;1785;460;1573;106;367;169;578;275;945
353210;201411;1156;3055;918;2629;115;397;601;1665;716;2062
353215;201411;592;1844;512;1665;108;392;158;482;266;874
353220;201411;880;2711;746;2411;209;704;224;729;433;1433
353230;201411;972;3096;888;2952;243;902;267;816;510;1718
353240;201411;2362;7809;2143;7354;622;2377;972;3128;1594;5505
353250;201411;1314;3720;1082;3298;302;976;417;1212;719;2188
353260;201411;1252;3629;1064;3321;326;1101;424;1239;750;2340
353270;201411;709;2144;612;1953;183;634;188;553;371;1187
353280;201411;640;2103;556;1945;197;750;152;503;349;1253
353282;201411;1837;6033;1770;5915;365;1359;1063;3425;1428;4784
353284;201411;312;861;203;638;45;142;57;187;102;329
353286;201411;149;440;100;322;28;90;13;43;41;133
353290;201411;526;1772;445;1631;159;638;182;630;341;1268
353300;201411;1828;5787;1563;5188;479;1755;567;1668;1046;3423
353310;201411;359;1102;326;1038;148;490;94;279;242;769
353320;201411;590;1665;506;1528;114;386;257;742;371;1128
353325;201411;616;2110;508;1855;129;512;83;276;212;788
353330;201411;621;1823;429;1383;98;369;192;554;290;923
353340;201411;3308;10694;2807;9696;999;3661;985;3344;1984;7005
353350;201411;3699;11203;3201;10305;1132;3896;1359;4252;2491;8148
353360;201411;473;1644;418;1513;107;446;232;796;339;1242
353370;201411;738;2412;667;2227;158;555;350;1156;508;1711
353380;201411;417;1368;369;1280;101;404;158;519;259;923
353390;201411;5688;15301;3962;12133;847;2939;1509;4186;2356;7125
353400;201411;645;2010;536;1780;144;515;145;410;289;925
353410;201411;716;2201;608;2027;177;666;312;1008;489;1674
353420;201411;722;2143;561;1756;183;603;176;516;359;1119
353430;201411;2602;9053;1876;6927;522;2012;190;617;712;2629
353440;201411;64184;210621;55969;190760;17290;61954;18708;62110;35998;124064
353450;201411;486;1469;415;1332;116;421;160;498;276;919
353460;201411;3741;10481;3143;9431;567;1850;1682;5049;2249;6899
353470;201411;11880;37551;9352;32230;3028;11276;2355;7809;5383;19085
353475;201411;1787;5159;1271;4018;292;1010;379;1091;671;2101
353480;201411;1592;4768;1417;4438;314;1093;791;2386;1105;3479
353490;201411;1678;4796;1392;4220;410;1389;410;1115;820;2504
353500;201411;1262;3643;1137;3422;484;1531;409;1177;893;2708
353510;201411;1419;4587;1173;3946;349;1293;341;993;690;2286
353520;201411;1302;3872;1053;3420;342;1192;357;1160;699;2352
353530;201411;2880;8625;2579;8066;630;2210;1247;3743;1877;5953
353540;201411;2227;6791;1978;6349;620;2068;849;2746;1469;4814
353550;201411;7018;20235;6171;18856;1120;4021;3569;10254;4689;14275
353560;201411;2154;7145;1785;6458;457;1843;658;2323;1115;4166
353570;201411;556;1749;448;1519;101;387;242;745;343;1132
353580;201411;2584;8390;2412;8083;675;2528;1368;4452;2043;6980
353590;201411;846;2421;690;2136;255;854;173;541;428;1395
353600;201411;2007;5738;1813;5387;410;1338;934;2757;1344;4095
353610;201411;642;2250;543;2035;148;643;150;525;298;1168
353620;201411;2267;7577;1966;6972;593;2254;655;2190;1248;4444
353625;201411;405;1105;280;887;107;372;79;233;186;605
353630;201411;1745;5973;1335;4914;311;1238;229;725;540;1963
353640;201411;1714;4925;1476;4426;359;1117;683;2075;1042;3192
353650;201411;6975;21360;5048;17046;1162;4248;1780;5682;2942;9930
353657;201411;360;1138;321;1055;61;234;131;405;192;639
353660;201411;1468;3748;1052;3089;445;1432;194;433;639;1865
353670;201411;5055;16673;4390;15172;1485;5636;1379;4436;2864;10072
353680;201411;722;2521;670;2427;311;1193;221;780;532;1973
353690;201411;584;1557;382;1217;94;356;145;415;239;771
353700;201411;2524;7996;2200;7304;520;1909;819;2556;1339;4465
353710;201411;3527;9541;1832;6558;562;2183;525;1854;1087;4037
353715;201411;505;1493;418;1327;89;303;175;541;264;844
353720;201411;2199;6805;1877;6315;365;1353;1080;3618;1445;4971
353730;201411;4647;14477;3718;12306;950;3397;1079;3280;2029;6677
353740;201411;2334;7124;1870;6119;649;2202;532;1675;1181;3877
353750;201411;845;2926;660;2466;183;752;191;709;374;1461
353760;201411;8329;24528;6734;21839;1574;5553;3452;11114;5026;16667
353770;201411;839;2599;530;1815;121;449;52;111;173;560
353780;201411;6151;21799;5546;20547;2480;9413;1528;5879;4008;15292
353790;201411;1836;6489;1504;5744;460;1983;358;1322;818;3305
353800;201411;15449;49319;12211;42999;3441;13350;4773;16241;8214;29591
353810;201411;1225;4062;1068;3693;325;1216;393;1315;718;2531
353820;201411;1346;4720;1247;4469;370;1503;557;1852;927;3355
353830;201411;826;2247;644;1917;130;420;276;805;406;1225
353850;201411;1941;6353;1803;6104;431;1600;882;2850;1313;4450
353860;201411;2462;8331;2020;7255;580;2238;568;1975;1148;4213
353870;201411;24451;75756;18147;62412;4347;16694;5989;18544;10336;35238
353880;201411;2409;7635;1996;6910;300;1250;1202;4070;1502;5320
353890;201411;2710;6936;1939;5645;460;1474;934;2592;1394;4066
353900;201411;1177;3680;874;2982;221;845;211;631;432;1476
353910;201411;2194;7746;2086;7457;670;2569;953;3403;1623;5972
353920;201411;2419;7213;1743;5731;423;1481;304;884;727;2365
353930;201411;4294;15055;3567;13398;1276;5082;844;3139;2120;8221
353940;201411;1557;5028;1322;4503;352;1361;516;1616;868;2977
353950;201411;3752;12131;3435;11560;558;2180;2206;7210;2764;9390
353960;201411;633;2021;491;1698;121;453;136;398;257;851
353970;201411;553;1636;479;1531;47;183;356;1119;403;1302
353980;201411;15162;45096;12634;40716;3093;10701;6478;20526;9571;31227
353990;201411;519;1630;475;1524;141;503;192;555;333;1058
354000;201411;2062;6089;1399;4748;349;1303;148;447;497;1750
354010;201411;406;1253;361;1178;137;455;142;474;279;929
354020;201411;4588;13985;4045;12756;1133;3921;1726;5024;2859;8945
354025;201411;1141;3242;901;2824;260;863;230;724;490;1587
354030;201411;667;1780;465;1462;123;430;175;506;298;936
354040;201411;823;2252;642;1906;93;321;365;1001;458;1322
354050;201411;1076;3521;946;3247;339;1276;283;935;622;2211
354060;201411;5322;16764;3804;13379;1028;3921;1410;4752;2438;8673
354070;201411;3831;12818;3318;11630;1122;4180;839;2910;1961;7090
354075;201411;2294;8595;2188;8401;708;2963;980;3722;1688;6685
354080;201411;1951;6021;1460;4820;441;1510;373;1094;814;2604
354085;201411;326;881;284;801;32;117;207;542;239;659
354090;201411;1309;3943;1237;3829;148;517;936;2878;1084;3395
354100;201411;17480;60029;14946;55027;4064;15872;6815;24938;10879;40810
354105;201411;963;3030;822;2761;203;803;378;1149;581;1952
354110;201411;849;2444;693;2208;208;756;219;631;427;1387
354120;201411;1980;5499;1534;4653;332;1144;631;1743;963;2887
354130;201411;5902;17604;4811;15391;1949;6619;1094;3178;3043;9797
354140;201411;24689;63121;15101;45001;3108;10200;5769;15950;8877;26150
354150;201411;4682;13010;3664;11167;1001;3389;1646;4776;2647;8165
354160;201411;4111;13613;3560;12371;1060;3959;1449;4886;2509;8845
354165;201411;421;1539;378;1434;141;579;103;390;244;969
354170;201411;1677;5395;1355;4612;305;1178;483;1437;788;2615
354180;201411;534;1619;508;1571;81;290;311;899;392;1189
354190;201411;1692;5689;1471;5182;506;1918;492;1654;998;3572
354200;201411;1212;3523;978;3072;202;725;403;1136;605;1861
354210;201411;889;3037;784;2823;183;773;334;1110;517;1883
354220;201411;3337;10367;2967;9640;955;3395;1242;3856;2197;7251
354230;201411;815;2702;768;2617;210;753;379;1281;589;2034
354240;201411;1447;4904;1152;4214;349;1377;277;948;626;2325
354250;201411;663;2005;482;1688;212;830;131;426;343;1256
354260;201411;7679;23657;6880;22298;2060;7311;2755;8737;4815;16048
354270;201411;1224;4301;1104;4037;333;1357;431;1562;764;2919
354280;201411;857;2569;791;2453;156;568;476;1434;632;2002
354290;201411;1366;4815;1263;4589;381;1472;427;1540;808;3012
354300;201411;3450;11679;3326;11435;884;3236;1756;5933;2640;9169
354310;201411;813;2698;645;2293;184;724;206;724;390;1448
354320;201411;877;2643;750;2384;222;793;241;691;463;1484
354323;201411;406;1168;314;989;81;277;93;256;174;533
354325;201411;1229;4155;1073;3787;244;996;432;1398;676;2394
354330;201411;8391;26214;7354;24095;1960;6892;3686;11670;5646;18562
354340;201411;32039;103728;26895;94053;9871;37033;9647;32857;19518;69890
354350;201411;1159;3481;1079;3331;286;965;580;1723;866;2688
354360;201411;472;1552;376;1357;108;419;40;136;148;555
354370;201411;1191;4034;1035;3705;154;673;665;2301;819;2974
354380;201411;1361;4098;1123;3659;429;1538;208;587;637;2125
354390;201411;12339;39236;9012;31829;2349;9070;2338;7862;4687;16932
354400;201411;2234;7942;1914;7158;535;2124;594;2113;1129;4237
354410;201411;6660;20267;5530;18370;1303;4649;2836;9396;4139;14045
354420;201411;1724;5120;1423;4465;449;1492;503;1507;952;2999
354425;201411;3577;10253;3083;9331;1079;3455;979;2990;2058;6445
354430;201411;1387;4564;1271;4371;345;1322;608;1996;953;3318
354440;201411;593;1741;463;1476;91;319;208;633;299;952
354450;201411;527;1533;328;1091;49;211;83;235;132;446
354460;201411;916;2666;766;2392;276;896;336;1032;612;1928
354470;201411;540;1544;419;1293;72;284;189;503;261;787
354480;201411;817;2423;714;2252;155;568;371;1086;526;1654
354490;201411;806;2727;638;2316;165;654;208;673;373;1327
354500;201411;2645;8966;2399;8490;968;3839;533;1785;1501;5624
354510;201411;790;2504;699;2331;167;614;384;1242;551;1856
354515;201411;364;1266;293;1095;71;302;94;323;165;625
354520;201411;7348;25242;4974;18420;1496;6215;1847;6498;3343;12713
354530;201411;2995;10787;2795;10380;803;3253;1427;5237;2230;8490
354540;201411;1355;4170;1130;3731;425;1550;287;889;712;2439
354550;201411;597;1911;528;1755;105;363;227;720;332;1083
354560;201411;1496;4454;1083;3514;259;852;393;1235;652;2087
354570;201411;759;2334;595;1947;185;638;118;359;303;997
354580;201411;9651;28128;7597;24183;1606;5754;3475;10442;5081;16196
354600;201411;1801;6179;1598;5760;469;1949;707;2387;1176;4336
354610;201411;496;1379;309;968;57;179;82;221;139;400
354620;201411;436;1484;361;1342;111;473;135;472;246;945
354625;201411;290;964;243;865;66;257;69;235;135;492
354630;201411;1954;6666;1755;6203;785;2822;499;1701;1284;4523
354640;201411;4338;14393;3610;12772;1076;4290;795;2553;1871;6843
354650;201411;1054;3243;949;3022;191;683;545;1691;736;2374
354660;201411;2249;6668;1762;5791;384;1404;908;2955;1292;4359
354670;201411;1693;5525;1361;4668;396;1491;360;1076;756;2567
354680;201411;5504;18527;5027;17459;1457;5374;2016;6841;3473;12215
354690;201411;887;2983;633;2347;133;517;186;638;319;1155
354700;201411;1208;3414;813;2568;138;529;353;944;491;1473
354710;201411;653;1923;555;1722;140;489;215;617;355;1106
354720;201411;217;617;168;518;62;189;41;123;103;312
354730;201411;7424;24801;5817;21256;1532;6122;2462;8692;3994;14814
354740;201411;279;852;200;702;53;188;49;176;102;364
354750;201411;2534;8054;2098;7336;712;2731;761;2572;1473;5303
354760;201411;2297;7630;1913;6742;640;2425;398;1306;1038;3731
354765;201411;313;828;201;625;47;172;29;82;76;254
354770;201411;2894;8486;2314;7524;1066;3681;445;1385;1511;5066
354780;201411;38178;117074;34284;108203;7674;27021;17318;51834;24992;78855
354790;201411;923;3020;807;2813;218;847;359;1151;577;1998
354800;201411;1802;5293;1601;5018;343;1204;1018;3187;1361;4391
354805;201411;995;3064;733;2465;116;431;141;429;257;860
354810;201411;683;2275;479;1750;143;579;97;311;240;890
354820;201411;1127;3965;992;3675;272;1154;290;974;562;2128
354830;201411;494;1476;409;1317;132;470;162;480;294;950
354840;201411;830;2435;741;2280;229;747;316;965;545;1712
354850;201411;15571;49694;11601;41242;2989;11800;4294;14176;7283;25976
354860;201411;1340;4378;1208;4149;298;1197;565;1828;863;3025
354870;201411;47726;152567;44062;144698;12885;45101;20615;66523;33500;111624
354880;201411;4415;13643;3113;10663;829;3154;797;2324;1626;5478
354890;201411;16176;49655;13837;44944;4023;14040;4807;15038;8830;29078
354900;201411;632;1797;502;1598;177;594;178;567;355;1161
354910;201411;6870;21011;3924;14208;886;3565;410;1374;1296;4939
354920;201411;521;1554;402;1339;116;429;110;351;226;780
354925;201411;382;1099;224;764;46;178;37;103;83;281
354930;201411;321;913;257;792;86;283;89;274;175;557
354940;201411;2273;8116;1745;6638;656;2635;248;862;904;3497
354950;201411;1583;5229;1412;4984;261;1061;858;2997;1119;4058
354960;201411;798;2537;696;2368;202;762;277;907;479;1669
354970;201411;4359;14468;3806;13293;775;3147;2027;6724;2802;9871
354980;201411;33773;84853;19448;59864;4413;15295;6699;18970;11112;34265
354990;201411;46050;146397;39143;131818;8642;32194;20230;66019;28872;98213
354995;201411;2038;6414;1911;6235;492;1723;1008;3294;1500;5017
355000;201411;1744;5851;1522;5419;558;2152;335;1113;893;3265
355010;201411;3931;12456;3217;10820;906;3320;1265;4174;2171;7494
355020;201411;2883;9902;2326;8766;1036;4203;580;2139;1616;6342
355030;201411;885729;2574455;782127;2364221;195807;645536;350724;1024120;546531;1669656
355040;201411;3135;10259;2819;9680;871;3311;1419;4676;2290;7987
355050;201411;1321;4155;1078;3653;378;1355;258;874;636;2229
355060;201411;5258;18011;4192;15574;1122;4663;1051;3578;2173;8241
355070;201411;6774;21307;6041;20046;1379;5350;3262;10130;4641;15480
355080;201411;1406;4997;1081;4162;328;1391;163;538;491;1929
355090;201411;1162;4142;980;3702;234;958;405;1480;639;2438
355100;201411;25392;80468;21774;74131;7076;25784;8275;28080;15351;53864
355110;201411;1365;4771;1237;4478;425;1663;420;1483;845;3146
355120;201411;684;2191;584;1996;169;635;251;827;420;1462
355130;201411;632;1705;374;1137;90;322;133;334;223;656
355140;201411;1147;4070;1100;3969;300;1191;538;1937;838;3128
355150;201411;3910;12747;3427;11848;1021;3740;1459;4852;2480;8592
355160;201411;1745;5891;1509;5485;627;2536;420;1378;1047;3914
355170;201411;10401;29853;7462;24519;2574;9120;1966;6356;4540;15476
355180;201411;2908;9026;2428;8103;657;2545;924;2822;1581;5367
355190;201411;1433;4940;1250;4545;524;1964;370;1308;894;3272
355200;201411;962;3526;902;3404;414;1651;226;818;640;2469
355210;201411;3042;10431;2764;9820;781;3137;1229;4054;2010;7191
355220;201411;33759;112971;30078;105277;12341;44763;8855;31490;21196;76253
355230;201411;1386;3970;774;2543;145;513;184;530;329;1043
355240;201411;25999;76677;18387;60478;4258;15434;6999;21558;11257;36992
355250;201411;26692;89325;23786;83408;7351;27293;10069;34931;17420;62224
355255;201411;959;2652;678;2069;145;488;188;518;333;1006
355260;201411;1680;4915;1505;4601;425;1479;596;1660;1021;3139
355270;201411;1777;5473;1690;5335;241;913;1213;3697;1454;4610
355280;201411;25538;76919;21646;69282;5212;18724;9610;29224;14822;47948
355290;201411;914;2956;828;2799;190;684;370;1214;560;1898
355300;201411;963;3155;770;2723;188;723;258;867;446;1590
355310;201411;1143;3457;971;3148;230;768;468;1562;698;2330
355320;201411;772;2472;675;2245;201;761;235;664;436;1425
355330;201411;2033;6772;1499;5661;504;2126;455;1637;959;3763
355340;201411;3239;8761;2998;8349;674;2101;1759;4694;2433;6795
355350;201411;1485;5154;1304;4765;434;1718;398;1401;832;3119
355360;201411;1296;4493;1195;4285;260;1008;793;2867;1053;3875
355365;201411;323;1027;273;927;79;302;73;238;152;540
355370;201411;7676;19909;5585;17324;1829;6178;2330;7275;4159;13453
355380;201411;3747;11423;2891;9394;833;2990;618;1687;1451;4677
355385;201411;1040;3359;972;3239;429;1551;278;853;707;2404
355390;201411;1455;4073;1241;3657;349;1129;468;1312;817;2441
355395;201411;1938;5931;1449;4773;283;1038;592;1760;875;2798
355400;201411;9886;33698;8798;31432;3104;12038;3193;10987;6297;23025
355410;201411;15466;54703;13435;50189;5029;20097;3612;13615;8641;33712
355420;201411;847;3068;794;2934;296;1168;266;996;562;2164
355430;201411;3981;11617;3383;10551;756;2615;1745;5264;2501;7879
355440;201411;988;3292;791;2762;211;781;232;714;443;1495
355450;201411;2793;9322;2281;8143;670;2616;748;2516;1418;5132
355460;201411;603;1683;452;1411;111;428;163;424;274;852
355465;201411;460;1421;393;1293;120;420;102;330;222;750
355470;201411;1004;3078;803;2717;252;940;296;951;548;1891
355475;201411;134;513;118;464;36;142;42;175;78;317
355480;201411;3373;12371;3170;11919;990;3938;1427;5279;2417;9217
355490;201411;885;2636;681;2199;176;594;139;448;315;1042
355495;201411;782;2611;722;2495;195;753;289;980;484;1733
355500;201411;9124;27111;6048;20203;1456;5372;1354;4139;2810;9511
355510;201411;2278;6278;1474;4652;344;1236;435;1255;779;2491
355520;201411;474;1192;287;817;62;199;95;237;157;436
355530;201411;303;716;126;388;14;45;39;126;53;171
355535;201411;704;2163;556;1874;166;640;149;419;315;1059
355540;201411;10576;34322;10014;33356;2947;10530;4946;16067;7893;26597
355550;201411;837;2508;734;2346;188;661;362;1120;550;1781
355560;201411;1456;4379;1062;3520;277;1039;218;568;495;1607
355570;201411;215;694;167;580;35;124;32;88;67;212
355580;201411;1356;4051;1120;3588;391;1372;425;1322;816;2694
355590;201411;265;748;235;687;53;179;117;337;170;516
355600;201411;1145;3678;959;3248;398;1466;231;746;629;2212
355610;201411;1570;4591;1336;4211;359;1269;606;1830;965;3099
355620;201411;4145;13295;3292;11298;732;2863;1388;4355;2120;7218
355630;201411;3501;10175;2172;7329;482;1824;667;2045;1149;3869
355635;201411;1036;3446;903;3211;146;584;598;2120;744;2704
355640;201411;4012;13244;3247;11482;1120;4112;630;2158;1750;6270
355645;201411;3529;12584;3289;12136;649;2626;2005;7389;2654;10015
355650;201411;6882;21635;5987;19846;1094;4348;3627;11246;4721;15594
355660;201411;1431;4620;1188;4123;363;1441;483;1557;846;2998
355670;201411;2554;8190;1789;6348;469;1925;657;2037;1126;3962
355680;201411;1837;6303;1476;5417;553;2130;330;1142;883;3272
355690;201411;442;1409;333;1216;207;811;29;77;236;888
355695;201411;380;1141;245;803;32;107;22;48;54;155
355700;201411;6950;24468;6119;22470;1835;7278;2515;8923;4350;16201
355710;201411;13223;33887;8244;24761;2693;8582;2192;6274;4885;14856
355715;201411;275;850;178;632;43;168;36;109;79;277
355720;201411;1570;5174;1271;4489;398;1544;384;1204;782;2748
355730;201411;814;2874;722;2655;277;1058;166;617;443;1675
410010;201411;1677;5382;1500;5010;423;1524;476;1564;899;3088
410020;201411;1311;4429;1196;4184;362;1337;446;1532;808;2869
410030;201411;1086;3739;895;3257;273;1048;169;604;442;1652
410040;201411;13636;45610;12388;43028;4401;16288;3771;12987;8172;29275
410045;201411;982;2811;686;2211;185;654;215;635;400;1289
410050;201411;2221;6347;1408;4646;399;1380;313;979;712;2359
410060;201411;2146;6797;1911;6332;548;1993;783;2561;1331;4554
410070;201411;2264;6463;1838;5594;701;2296;413;1121;1114;3417
410080;201411;1551;4642;1284;4142;321;1108;609;1887;930;2995
410090;201411;1172;3719;1066;3502;348;1277;377;1171;725;2448
410100;201411;2406;7384;1698;5704;521;1974;248;775;769;2749
410105;201411;481;1538;352;1224;76;300;43;110;119;410
410110;201411;2452;7406;2013;6533;425;1603;738;2268;1163;3871
410115;201411;642;1783;508;1514;119;388;179;504;298;892
410120;201411;3014;10371;2848;10120;1047;3896;1223;4468;2270;8364
410130;201411;1468;4881;1326;4548;431;1472;562;1949;993;3421
410140;201411;16851;46338;11754;36861;3244;11245;4002;12373;7246;23618
410150;201411;16738;41428;7845;23463;1726;5686;1646;4378;3372;10064
410160;201411;3495;11092;3172;10543;1041;3792;1150;3854;2191;7646
410165;201411;722;2130;572;1798;144;486;252;750;396;1236
410170;201411;1986;6094;1671;5410;607;2144;496;1555;1103;3699
410180;201411;9557;30776;8258;27882;2076;7936;3570;11199;5646;19135
410185;201411;686;1876;595;1708;136;414;293;832;429;1246
410190;201411;2381;7112;2027;6293;649;2157;524;1528;1173;3685
410200;201411;3727;10574;2613;8235;664;2329;367;1051;1031;3380
410210;201411;2839;8702;2213;7307;534;1967;491;1373;1025;3340
410220;201411;625;1812;442;1425;92;335;135;408;227;743
410230;201411;1761;5720;1572;5374;575;2169;590;1946;1165;4115
410240;201411;5439;16905;4951;15854;1672;5780;1675;5205;3347;10985
410250;201411;2472;6974;1656;5233;495;1734;335;946;830;2680
410260;201411;1724;5341;1480;4881;443;1581;557;1795;1000;3376
410270;201411;591;1721;481;1503;122;423;191;580;313;1003
410275;201411;960;2879;665;2230;119;423;325;1096;444;1519
410280;201411;3005;8979;2129;7069;500;1896;430;1313;930;3209
410290;201411;3285;9989;2787;9014;686;2400;1246;4028;1932;6428
410300;201411;677;1929;593;1741;87;304;300;785;387;1089
410302;201411;357;965;243;773;29;104;142;450;171;554
410304;201411;1508;4869;1369;4577;419;1443;560;1952;979;3395
410305;201411;2300;6114;1955;5598;538;1621;1112;3235;1650;4856
410310;201411;2541;8375;2301;7911;656;2451;893;3088;1549;5539
410315;201411;693;2047;467;1598;111;390;148;478;259;868
410320;201411;1283;3797;790;2668;151;576;68;190;219;766
410322;201411;626;1859;447;1460;130;430;121;379;251;809
410330;201411;1579;4424;1349;3992;395;1252;465;1349;860;2601
410335;201411;1016;3020;862;2742;199;715;346;1035;545;1750
410337;201411;867;2309;676;1945;138;467;269;691;407;1158
410340;201411;611;1836;465;1454;89;324;148;390;237;714
410345;201411;1903;5599;1449;4630;431;1504;397;1172;828;2676
410347;201411;642;1771;408;1324;68;264;158;499;226;763
410350;201411;915;2810;611;2152;158;641;115;357;273;998
410360;201411;3880;11583;3355;10627;1006;3441;1257;3919;2263;7360
410370;201411;13865;40924;10383;33129;2736;9858;3059;8899;5795;18757
410380;201411;1488;4728;1354;4433;346;1229;614;1915;960;3144
410390;201411;2890;8432;2316;7359;855;2937;625;1798;1480;4735
410395;201411;915;3074;813;2846;200;807;385;1334;585;2141
410400;201411;5593;18075;4913;16706;1482;5671;1647;5370;3129;11041
410405;201411;1022;2996;814;2576;204;757;331;997;535;1754
410410;201411;1393;4681;1324;4569;492;1901;410;1323;902;3224
410420;201411;9689;31762;8380;28704;2861;10575;2028;6433;4889;17008
410425;201411;3377;10836;2374;8471;539;2123;326;1094;865;3217
410430;201411;16775;46015;12408;37741;3381;11228;3959;11944;7340;23172
410440;201411;3716;11713;3333;10963;869;3108;1556;5093;2425;8201
410442;201411;3083;10623;2773;9887;931;3513;876;3095;1807;6608
410445;201411;2257;7576;1934;6971;562;2229;715;2658;1277;4887
410450;201411;2668;7714;2122;6650;680;2239;395;1124;1075;3363
410460;201411;2436;7323;2017;6472;559;1908;738;2246;1297;4154
410465;201411;2184;7722;1859;6955;606;2433;681;2356;1287;4789
410470;201411;1487;4819;1205;4143;331;1288;369;1241;700;2529
410480;201411;32338;94777;24803;79074;8550;29642;5875;17805;14425;47447
410490;201411;11995;38744;9662;33537;2937;11166;2928;9818;5865;20984
410500;201411;1626;5129;1320;4449;485;1786;389;1289;874;3075
410510;201411;2544;6786;1803;5273;405;1271;736;1969;1141;3240
410520;201411;3341;11680;3157;11279;1162;4382;1166;4148;2328;8530
410530;201411;1793;5132;1470;4482;355;1236;611;1746;966;2982
410540;201411;3764;10964;2535;8469;667;2382;807;2659;1474;5041
410550;201411;7407;22427;5334;17757;1634;5991;887;2697;2521;8688
410560;201411;1389;4425;1092;3686;308;1149;284;762;592;1911
410570;201411;3004;9779;2725;9271;864;3055;1029;3766;1893;6821
410580;201411;27447;86340;23576;78171;8018;29024;6943;21665;14961;50689
410590;201411;1277;4041;769;2586;134;470;184;549;318;1019
410600;201411;2118;6248;1753;5515;460;1503;756;2394;1216;3897
410610;201411;851;2586;712;2322;155;574;314;981;469;1555
410620;201411;1508;5395;1233;4634;381;1523;226;800;607;2323
410630;201411;2614;7841;1971;6387;549;1953;514;1511;1063;3464
410640;201411;5363;15646;4204;13392;1447;5225;951;2831;2398;8056
410645;201411;1322;4671;1262;4557;561;2187;379;1356;940;3543
410650;201411;2568;7865;2065;6794;740;2558;473;1486;1213;4044
410655;201411;972;2942;793;2582;216;774;267;840;483;1614
410657;201411;743;2185;552;1787;158;567;208;602;366;1169
410660;201411;3357;9731;2435;7628;765;2544;541;1538;1306;4082
410670;201411;1033;2936;775;2416;226;762;201;574;427;1336
410680;201411;2633;9097;2181;7918;653;2354;726;2780;1379;5134
410685;201411;733;2167;649;2018;99;307;460;1446;559;1753
410690;201411;109758;320376;74616;245104;18408;66836;18021;53310;36429;120146
410700;201411;2456;7779;2279;7421;723;2562;940;2946;1663;5508
410710;201411;1143;3546;885;2937;281;1019;238;701;519;1720
410712;201411;839;2575;722;2347;298;1063;219;731;517;1794
410715;201411;1130;3538;934;3100;247;883;356;1137;603;2020
410720;201411;3433;10247;2499;8235;659;2424;707;2133;1366;4557
410725;201411;1086;3114;766;2456;162;553;162;449;324;1002
410730;201411;751;2276;680;2119;285;954;188;564;473;1518
410740;201411;864;2564;595;2001;112;440;282;936;394;1376
410750;201411;2019;6002;1700;5326;511;1743;516;1510;1027;3253
410752;201411;302;880;215;686;50;191;87;248;137;439
410753;201411;492;1479;337;1101;77;297;112;330;189;627
410754;201411;987;3059;857;2841;95;349;578;1972;673;2321
410755;201411;865;2236;671;1925;98;334;404;1109;502;1443
410760;201411;2743;8770;2535;8366;893;3095;1012;3251;1905;6346
410765;201411;16228;48726;11786;39418;2840;10643;1691;5256;4531;15899
410770;201411;991;2817;769;2368;252;846;232;683;484;1529
410773;201411;1407;4134;1188;3764;284;1039;626;1881;910;2920
410775;201411;1896;5543;1784;5367;508;1533;967;2967;1475;4500
410780;201411;501;1431;385;1232;115;368;163;581;278;949
410785;201411;684;2219;555;1888;228;823;131;454;359;1277
410790;201411;601;1889;501;1646;140;511;107;281;247;792
410800;201411;2976;7839;2352;6812;802;2609;850;2282;1652;4891
410810;201411;303;950;243;809;35;134;110;367;145;501
410820;201411;1115;3380;893;2842;282;954;203;618;485;1572
410830;201411;33432;99236;27303;88082;8561;30293;9423;29679;17984;59972
410832;201411;1227;3700;1096;3457;242;889;549;1625;791;2514
410840;201411;6650;19795;4379;14763;1326;4844;617;1821;1943;6665
410845;201411;1598;4728;1341;4175;289;981;616;1862;905;2843
410850;201411;2890;8561;2566;8055;594;2152;1380;4308;1974;6460
410855;201411;782;2187;616;1826;181;577;214;602;395;1179
410860;201411;4143;11861;3474;10580;798;2588;1638;5023;2436;7611
410865;201411;1770;6033;1605;5715;403;1542;864;3137;1267;4679
410870;201411;1454;4420;1358;4261;650;2186;441;1343;1091;3529
410880;201411;4648;14026;3717;12196;932;3460;891;2604;1823;6064
410890;201411;1127;3518;826;2917;224;854;76;230;300;1084
410895;201411;1067;3728;951;3472;362;1423;291;1004;653;2427
410900;201411;967;2728;722;2313;160;595;229;675;389;1270
410910;201411;400;1151;336;1033;61;220;175;513;236;733
410920;201411;912;2798;749;2496;218;804;246;764;464;1568
410930;201411;1815;5425;1520;4881;386;1485;638;1989;1024;3474
410940;201411;22101;74037;19525;69081;6401;24631;7450;26523;13851;51154
410950;201411;1922;6393;1751;6077;363;1317;1073;3775;1436;5092
410960;201411;7306;20431;4809;15676;1553;5524;1333;4242;2886;9766
410965;201411;1151;3603;1015;3313;349;1186;395;1283;744;2469
410970;201411;5306;16113;4320;14099;1530;5595;894;2871;2424;8466
410975;201411;1590;4638;1299;4123;239;885;610;1919;849;2804
410980;201411;5692;16243;3390;11392;795;2936;638;2023;1433;4959
410990;201411;848;2488;511;1712;168;621;94;253;262;874
411000;201411;454;1384;308;1039;70;272;50;134;120;406
411005;201411;540;1586;361;1142;102;325;60;167;162;492
411007;201411;2131;6887;1888;6318;547;1927;738;2473;1285;4400
411010;201411;4240;14572;3836;13650;1397;5479;968;3196;2365;8675
411020;201411;2607;8293;2345;7831;800;2990;804;2664;1604;5654
411030;201411;902;2450;745;2155;242;768;217;581;459;1349
411040;201411;590;1769;340;1129;102;363;79;249;181;612
411050;201411;2205;7839;1946;7235;645;2592;332;1146;977;3738
411060;201411;2182;6901;1870;6209;578;2067;322;976;900;3043
411065;201411;405;1244;327;1088;67;234;121;383;188;617
411070;201411;5201;16267;3771;13104;1119;4293;592;1835;1711;6128
411080;201411;2158;6625;1912;6129;556;1979;612;1871;1168;3850
411090;201411;714;1788;545;1525;117;401;145;356;262;757
411095;201411;1691;4894;1290;4082;296;1057;351;1026;647;2083
411100;201411;1538;4446;1137;3655;268;973;238;674;506;1647
411110;201411;974;2952;720;2368;219;768;124;353;343;1121
411120;201411;1973;6048;1572;5176;471;1676;481;1523;952;3199
411125;201411;4896;16066;4733;15726;1602;5644;2084;6793;3686;12437
411130;201411;816;2448;663;2124;194;639;214;702;408;1341
411140;201411;2050;7346;1753;6606;626;2457;497;1942;1123;4399
411150;201411;6124;17329;4939;14926;1446;4714;1261;3471;2707;8185
411155;201411;1292;3752;1091;3351;346;1168;429;1230;775;2398
411160;201411;342;1022;304;942;107;342;105;320;212;662
411170;201411;860;2891;749;2622;227;837;244;848;471;1685
411180;201411;6630;20112;5684;18322;1708;6046;1839;5854;3547;11900
411190;201411;1912;5612;1628;5077;492;1722;489;1422;981;3144
411200;201411;4638;14069;3810;12646;1163;4281;1489;4768;2652;9049
411210;201411;2433;7031;1914;6041;753;2526;327;988;1080;3514
411220;201411;1228;3554;1001;3120;257;936;433;1213;690;2149
411230;201411;1309;3737;844;2747;262;947;194;558;456;1505
411240;201411;1276;3036;678;2052;161;516;224;636;385;1152
411250;201411;2611;7713;2164;6834;618;2103;664;2062;1282;4165
411260;201411;317;879;206;672;38;139;93;293;131;432
411270;201411;2147;6854;1960;6489;595;2176;848;2734;1443;4910
411275;201411;1621;4923;1381;4356;418;1381;398;1205;816;2586
411280;201411;1844;5668;1421;4758;434;1608;244;734;678;2342
411290;201411;1048;2913;866;2550;250;766;297;895;547;1661
411295;201411;1130;3340;1031;3161;247;821;424;1278;671;2099
411300;201411;1131;2940;814;2313;77;249;383;1009;460;1258
411310;201411;884;2526;673;2153;121;439;275;864;396;1303
411320;201411;5860;17396;4340;14303;1259;4378;1008;3144;2267;7522
411325;201411;1597;5067;1418;4724;262;971;847;2808;1109;3779
411330;201411;3834;12336;3345;11381;1278;4745;979;3212;2257;7957
411340;201411;1017;2975;669;2158;148;532;264;827;412;1359
411342;201411;903;2598;740;2244;210;696;221;605;431;1301
411345;201411;1122;3576;1029;3393;315;1126;483;1591;798;2717
411350;201411;3053;9282;2124;7292;642;2396;250;789;892;3185
411360;201411;594;1507;372;1080;52;202;166;397;218;599
411370;201411;46954;135932;35704;114053;7497;28002;13385;39139;20882;67141
411373;201411;1498;4742;1246;4234;355;1348;348;1146;703;2494
411375;201411;1199;3363;930;2822;243;778;335;959;578;1737
411380;201411;1322;3576;814;2492;154;511;242;699;396;1210
411390;201411;1921;5887;1674;5441;453;1631;706;2168;1159;3799
411400;201411;1911;5664;1456;4608;328;1167;423;1222;751;2389
411410;201411;2705;8362;2192;7143;693;2548;573;1610;1266;4158
411420;201411;4755;13879;3531;11090;906;3163;715;1865;1621;5028
411430;201411;3089;9915;2620;9054;792;2978;1135;3842;1927;6820
411435;201411;394;1290;321;1095;90;340;133;422;223;762
411440;201411;2703;8801;2436;8271;889;3184;731;2593;1620;5777
411450;201411;2232;6837;2027;6460;456;1503;1192;3842;1648;5345
411460;201411;4637;14388;3130;10698;1102;4019;570;1820;1672;5839
411470;201411;874;2645;582;1917;118;430;111;309;229;739
411480;201411;5237;15993;4094;13680;1584;5756;914;2928;2498;8684
411490;201411;1640;5103;1428;4701;494;1835;408;1194;902;3029
411500;201411;1785;4994;1252;3981;348;1209;323;999;671;2208
411510;201411;2523;7400;1986;6329;667;2330;450;1267;1117;3597
411520;201411;25932;71385;15502;48925;3686;12828;3644;10693;7330;23521
411530;201411;954;2761;646;2178;231;869;110;307;341;1176
411535;201411;492;1475;222;799;41;174;27;71;68;245
411540;201411;2791;7549;2084;6231;320;1052;1079;3170;1399;4222
411545;201411;1066;3664;981;3496;199;760;638;2298;837;3058
411550;201411;764;2145;620;1901;250;838;149;435;399;1273
411560;201411;2751;8324;2163;6898;615;2137;462;1334;1077;3471
411570;201411;6605;18254;4868;15281;1404;4874;1172;3767;2576;8641
411573;201411;1032;3106;973;3000;210;684;564;1767;774;2451
411575;201411;1583;5124;1347;4587;347;1266;510;1719;857;2985
411580;201411;3598;10474;2492;8124;550;2137;412;1053;962;3190
411585;201411;605;2083;417;1518;116;450;74;250;190;700
411590;201411;596;1782;528;1647;140;489;187;567;327;1056
411600;201411;379;1154;308;1016;88;345;85;284;173;629
411605;201411;2406;6724;1746;5432;453;1537;676;2030;1129;3567
411610;201411;2480;7045;2210;6642;467;1515;1454;4324;1921;5839
411620;201411;2976;9671;2788;9340;854;3048;1256;4287;2110;7335
411630;201411;515;1339;297;992;67;272;61;182;128;454
411640;201411;615;1915;507;1686;151;541;189;586;340;1127
411650;201411;184;617;162;578;41;171;61;201;102;372
411660;201411;903;2550;727;2204;184;591;313;945;497;1536
411670;201411;1735;5077;1524;4643;493;1672;546;1548;1039;3220
411680;201411;1781;5442;1551;5047;379;1200;919;3148;1298;4348
411690;201411;3666;11041;3000;9723;953;3242;793;2633;1746;5875
411695;201411;727;2358;577;2027;139;531;210;747;349;1278
411700;201411;2001;5811;1421;4647;341;1236;381;1152;722;2388
411705;201411;2372;8069;2063;7449;485;1781;1138;4233;1623;6014
411710;201411;2256;6881;1827;5930;542;1888;472;1423;1014;3311
411720;201411;764;2264;566;1802;103;358;150;435;253;793
411721;201411;733;2225;613;1974;202;714;120;349;322;1063
411722;201411;753;2281;574;1869;140;523;165;470;305;993
411725;201411;1363;4415;833;3027;205;791;189;675;394;1466
411727;201411;2346;6772;1896;5816;464;1543;790;2289;1254;3832
411729;201411;523;1452;376;1178;116;410;114;313;230;723
411730;201411;5333;15607;4494;14002;1980;6353;1287;4085;3267;10438
411740;201411;621;1816;428;1368;97;344;157;472;254;816
411745;201411;964;2969;783;2565;210;718;215;679;425;1397
411750;201411;4791;14874;3647;12095;1066;3927;734;2225;1800;6152
411760;201411;9140;27122;8135;25372;3048;10150;2499;7896;5547;18046
411770;201411;3871;13451;3344;12156;1285;4939;727;2649;2012;7588
411780;201411;3136;10226;3011;10081;400;1242;2258;8010;2658;9252
411790;201411;2761;7969;2019;6471;605;2245;671;2043;1276;4288
411800;201411;1486;4313;896;2942;157;596;169;444;326;1040
411810;201411;1648;5044;1417;4549;394;1445;460;1298;854;2743
411820;201411;17261;54460;14334;48838;5137;18023;4346;15401;9483;33424
411830;201411;429;1165;334;1022;153;469;35;116;188;585
411840;201411;9651;28685;7472;24347;2163;7662;1983;6193;4146;13855
411845;201411;600;1871;425;1434;96;358;106;331;202;689
411850;201411;6235;18963;5173;16765;1416;4915;1538;4947;2954;9862
411860;201411;944;3012;779;2649;222;788;230;750;452;1538
411870;201411;1073;3768;825;3088;152;601;212;766;364;1367
411880;201411;2082;6118;1679;5361;512;1873;475;1297;987;3170
411885;201411;779;2132;603;1790;138;527;239;611;377;1138
411890;201411;1394;4317;981;3319;277;1004;187;563;464;1567
411900;201411;961;3103;675;2368;197;692;119;423;316;1115
411910;201411;1265;4335;1075;3887;347;1381;321;1087;668;2468
411915;201411;13148;37270;8504;27400;1939;6880;2117;6247;4056;13127
411920;201411;1099;3842;965;3502;284;1141;222;750;506;1891
411925;201411;579;1652;390;1302;107;371;118;379;225;750
411930;201411;6523;21490;5733;19860;1885;6956;2021;7037;3906;13993
411940;201411;3731;12584;3300;11647;1104;4075;861;2954;1965;7029
411950;201411;10615;34135;8842;30495;2358;8901;4055;13714;6413;22615
411960;201411;4974;15126;4555;14295;1158;4080;2133;6499;3291;10579
411965;201411;629;1845;469;1585;100;382;168;576;268;958
411970;201411;806;2283;616;1979;202;722;168;502;370;1224
411980;201411;1434;4510;1210;4001;209;749;518;1705;727;2454
411990;201411;32086;108954;27644;99123;9663;37079;8003;28670;17666;65749
411995;201411;3248;10185;2874;9404;1159;4112;753;2400;1912;6512
412000;201411;2046;5492;1647;4791;321;1093;833;2189;1154;3282
412010;201411;743;2515;609;2186;167;623;142;475;309;1098
412015;201411;682;2077;546;1774;113;393;272;876;385;1269
412020;201411;451;1323;318;1033;110;386;123;375;233;761
412030;201411;661;2085;438;1536;94;387;126;395;220;782
412033;201411;795;2431;555;1852;140;507;122;362;262;869
412035;201411;1055;2972;788;2482;196;675;320;955;516;1630
412040;201411;793;2609;709;2387;252;879;235;775;487;1654
412050;201411;1670;5021;1285;4180;332;1228;275;843;607;2071
412060;201411;7126;24978;6452;23456;2000;7758;2510;9120;4510;16878
412065;201411;1020;3132;837;2732;246;911;244;735;490;1646
412070;201411;1282;3570;1061;3128;229;713;396;1144;625;1857
412080;201411;1464;4507;866;3072;160;648;65;166;225;814
412085;201411;383;1106;177;590;45;176;49;142;94;318
412090;201411;4972;16224;4748;15804;1041;3688;2956;9954;3997;13642
412100;201411;2282;7194;1992;6663;665;2351;684;2223;1349;4574
412110;201411;1164;3352;793;2544;235;811;230;717;465;1528
412120;201411;1910;6517;1679;5966;439;1759;759;2528;1198;4287
412125;201411;999;3111;888;2921;250;869;361;1208;611;2077
412130;201411;618;1836;462;1512;100;361;123;387;223;748
412135;201411;568;1637;408;1304;104;368;148;427;252;795
412140;201411;1444;4429;1183;3850;310;1070;360;1163;670;2233
412150;201411;3050;9001;2639;8183;403;1431;1581;4759;1984;6190
412160;201411;1002;3245;659;2355;185;775;203;685;388;1460
412170;201411;4701;15371;3917;13799;1351;5122;1421;4893;2772;10015
412175;201411;1510;5195;1350;4829;384;1493;561;1992;945;3485
412180;201411;1850;5854;1422;5039;486;1899;419;1407;905;3306
412190;201411;3283;9681;2588;8474;858;2999;695;2303;1553;5302
412200;201411;2369;7830;1669;5930;405;1577;524;1833;929;3410
412210;201411;781;2218;458;1518;115;432;71;221;186;653
412215;201411;3705;11663;3369;11050;618;2042;2165;7311;2783;9353
412217;201411;1261;3697;1173;3543;219;771;761;2172;980;2943
412220;201411;5158;17329;4930;16874;1513;5435;2704;9238;4217;14673
412230;201411;3114;10552;2699;9688;771;3073;853;2950;1624;6023
412240;201411;9922;26073;5646;17817;1299;4589;1001;2830;2300;7419
412250;201411;2235;6816;1956;6193;644;2220;554;1627;1198;3847
412260;201411;1418;4162;958;3159;201;771;317;922;518;1693
412265;201411;1258;3938;1128;3693;279;1047;549;1764;828;2811
412270;201411;884;2846;664;2333;156;620;133;437;289;1057
412280;201411;604;1922;445;1573;250;921;49;168;299;1089
412290;201411;1219;3471;970;2968;201;701;370;1038;571;1739
412300;201411;1846;5575;1532;4949;473;1707;410;1251;883;2958
412310;201411;1242;3517;1101;3323;197;514;743;2479;940;2993
412320;201411;736;2042;538;1691;133;465;187;594;320;1059
412330;201411;2006;5506;1543;4670;347;1118;748;2253;1095;3371
412340;201411;816;2580;537;1849;87;322;99;321;186;643
412350;201411;2739;8712;2228;7543;734;2639;353;1075;1087;3714
412360;201411;352;1118;271;903;51;198;86;238;137;436
412370;201411;1160;3645;913;3152;327;1207;266;893;593;2100
412380;201411;2086;6381;1790;5705;551;1848;520;1625;1071;3473
412382;201411;711;2042;482;1536;100;339;149;439;249;778
412385;201411;2515;7951;2275;7406;735;2539;742;2405;1477;4944
412390;201411;2559;7610;2322;7200;786;2609;906;2830;1692;5439
412395;201411;988;2755;790;2436;121;392;479;1477;600;1869
412400;201411;1200;3733;1051;3437;331;1113;396;1347;727;2460
412402;201411;2130;6486;1707;5566;529;1924;460;1290;989;3214
412405;201411;4299;12512;2803;9240;753;2764;383;1174;1136;3938
412410;201411;6570;21176;5873;19767;2466;9104;1320;4323;3786;13427
412420;201411;559;1656;439;1398;134;464;138;374;272;838
412430;201411;513;1495;420;1303;109;376;170;481;279;857
412440;201411;4132;12389;3488;11242;727;2563;1340;4471;2067;7034
412450;201411;316;1013;240;816;43;156;39;88;82;244
412460;201411;1033;2963;739;2398;186;707;171;505;357;1212
412470;201411;1897;6492;1674;5931;556;2061;576;2085;1132;4146
412480;201411;1342;3958;915;2986;218;768;142;376;360;1144
412490;201411;1314;3886;1157;3512;318;1018;347;1021;665;2039
412500;201411;2109;6256;1797;5636;504;1804;487;1336;991;3140
412510;201411;2821;9546;2478;8654;752;2818;940;3268;1692;6086
412520;201411;1908;5335;1422;4474;445;1499;447;1363;892;2862
412530;201411;824;2469;689;2165;202;638;214;672;416;1310
412535;201411;535;1618;339;1118;90;330;80;220;170;550
412540;201411;1166;3417;870;2771;153;557;321;1009;474;1566
412545;201411;966;2779;782;2375;146;509;305;834;451;1343
412550;201411;25349;76969;17046;57734;4728;17328;3595;11360;8323;28688
412555;201411;356;1086;244;805;58;214;46;124;104;338
412560;201411;5059;16258;3981;13977;1042;4187;1010;3248;2052;7435
412570;201411;4144;12583;2925;9744;714;2726;617;1931;1331;4657
412575;201411;885;2740;705;2307;171;637;222;671;393;1308
412580;201411;1491;4148;1082;3418;272;893;334;1018;606;1911
412590;201411;513;1560;404;1349;134;479;123;425;257;904
412600;201411;1597;4991;1354;4484;432;1579;432;1333;864;2912
412610;201411;845;2694;669;2269;230;885;184;536;414;1421
412620;201411;1319;4349;1091;3851;360;1376;234;792;594;2168
412625;201411;14515;41496;11830;36224;4256;13855;2754;8285;7010;22140
412627;201411;1067;3280;736;2536;265;979;81;259;346;1238
412630;201411;3656;11693;3132;10521;852;3021;1028;3349;1880;6370
412635;201411;560;1713;394;1326;99;357;53;165;152;522
412640;201411;879;2672;589;1968;136;483;92;264;228;747
412650;201411;2377;6851;1962;6064;535;1867;674;1854;1209;3721
412660;201411;3226;9711;2610;8395;677;2420;614;1831;1291;4251
412665;201411;748;2008;459;1475;166;581;129;388;295;969
412667;201411;1481;4448;1176;3820;309;1153;323;979;632;2132
412670;201411;699;2213;474;1653;108;426;84;226;192;652
412680;201411;1705;5397;1268;4393;342;1272;334;1041;676;2313
412690;201411;808;2554;637;2171;241;881;124;409;365;1290
412700;201411;1893;6105;1639;5677;642;2446;552;1865;1194;4311
412710;201411;9035;28434;7567;25340;2208;8073;2027;6475;4235;14548
412720;201411;1745;5556;1210;4125;298;1092;160;440;458;1532
412730;201411;2924;8853;1991;6778;636;2323;273;817;909;3140
412740;201411;2241;7353;1951;6686;788;2831;340;1196;1128;4027
412750;201411;3686;11814;3283;11136;593;2334;2160;7133;2753;9467
412760;201411;2479;8233;2361;8024;691;2644;1083;3503;1774;6147
412770;201411;13086;38109;8230;27219;1921;7075;1853;5573;3774;12648
412780;201411;1528;5005;1341;4563;406;1483;430;1388;836;2871
412785;201411;2559;7489;1857;5995;461;1638;884;2771;1345;4409
412788;201411;1461;4727;1319;4437;335;1292;489;1472;824;2764
412790;201411;1278;3930;1026;3398;271;964;283;857;554;1821
412795;201411;1083;3169;931;2888;288;927;334;1010;622;1937
412796;201411;2783;8729;2550;8247;717;2622;1049;3163;1766;5785
412800;201411;3768;11154;2956;9497;827;2938;908;2739;1735;5677
412810;201411;11065;31174;6536;21030;1630;5676;1480;4232;3110;9908
412820;201411;6998;21068;5168;17430;1466;5406;1174;3988;2640;9394
412830;201411;414;1332;350;1193;95;380;98;288;193;668
412840;201411;2247;6452;1851;5634;515;1707;476;1392;991;3099
412850;201411;2476;7554;2108;6944;395;1561;1046;3229;1441;4790
412853;201411;1547;4482;1363;4121;154;618;843;2342;997;2960
412855;201411;1718;4939;1342;4135;422;1497;365;979;787;2476
412860;201411;1358;4084;1137;3648;304;1097;476;1463;780;2560
412862;201411;879;2374;646;1914;165;535;244;673;409;1208
412863;201411;1269;4271;1216;4175;193;706;834;2850;1027;3556
412865;201411;699;2193;517;1744;113;405;203;704;316;1109
412870;201411;1047;3040;878;2757;306;1021;274;852;580;1873
412880;201411;1611;4459;1360;4038;421;1364;348;986;769;2350
420005;201411;550;1656;363;1222;81;297;133;423;214;720
420010;201411;3582;10734;2990;9773;495;1710;2016;6760;2511;8470
420020;201411;817;2674;471;1730;80;348;61;168;141;516
420030;201411;630;1801;348;1241;97;394;61;208;158;602
420040;201411;1001;3112;655;2405;203;814;128;398;331;1212
420050;201411;852;2663;680;2259;209;725;270;866;479;1591
420055;201411;322;1025;217;766;54;200;43;131;97;331
420060;201411;387;1378;288;1098;84;350;40;136;124;486
420070;201411;1433;4594;1139;3884;189;705;624;2163;813;2868
420075;201411;210;616;117;399;31;127;35;103;66;230
420080;201411;651;2126;532;1874;189;717;130;446;319;1163
420090;201411;696;2478;538;2100;162;652;96;373;258;1025
420100;201411;1554;4986;1430;4814;391;1356;820;2794;1211;4150
420110;201411;463;1591;420;1496;116;424;196;707;312;1131
420120;201411;343;1212;287;1085;108;451;62;213;170;664
420125;201411;400;1630;369;1555;154;686;112;440;266;1126
420127;201411;621;1924;283;1060;91;355;43;161;134;516
420130;201411;2620;8960;2255;8200;691;2729;790;2659;1481;5388
420140;201411;5386;15839;3728;12617;1044;3964;714;2214;1758;6178
420150;201411;857;2520;567;1880;167;613;180;538;347;1151
420160;201411;329;979;203;693;37;145;53;170;90;315
420165;201411;243;780;158;555;38;157;36;119;74;276
420170;201411;252;823;174;662;68;302;20;50;88;352
420180;201411;478;1507;286;1034;82;311;61;206;143;517
420190;201411;614;1960;367;1364;125;508;62;209;187;717
420195;201411;1468;4231;1176;3813;288;996;574;1928;862;2924
420200;201411;3051;9967;1912;7236;606;2544;327;1102;933;3646
420205;201411;1153;3823;1027;3594;289;1078;478;1671;767;2749
420207;201411;1521;4499;1067;3524;327;1231;312;922;639;2153
420208;201411;532;1587;356;1240;130;499;104;344;234;843
420209;201411;380;1213;236;850;45;173;72;246;117;419
420210;201411;1902;6144;1300;4957;400;1776;195;645;595;2421
420213;201411;957;3470;907;3351;201;763;576;2154;777;2917
420215;201411;532;1731;384;1343;120;437;69;221;189;658
420220;201411;438;1707;410;1644;174;744;110;395;284;1139
420230;201411;4897;15080;3719;12811;946;3685;1722;5738;2668;9423
420240;201411;14684;42725;9225;32159;2111;8741;3654;11511;5765;20252
420243;201411;606;1883;489;1628;119;460;176;558;295;1018
420245;201411;1295;4042;891;3173;253;1008;196;605;449;1613
420250;201411;844;2712;784;2614;267;978;341;1142;608;2120
420253;201411;686;1806;557;1621;128;384;271;865;399;1249
420257;201411;447;1372;335;1155;91;327;156;530;247;857
420260;201411;1447;4713;1236;4330;341;1305;574;2011;915;3316
420270;201411;627;2016;257;944;49;184;34;107;83;291
420280;201411;2420;6536;1447;4736;318;1259;548;1585;866;2844
420285;201411;163;486;56;214;7;30;2;9;9;39
420287;201411;667;2054;570;1866;158;533;202;664;360;1197
420290;201411;7087;21211;4528;15199;1058;3898;1467;4577;2525;8475
420300;201411;6298;19473;4120;14692;1059;4274;861;3023;1920;7297
420310;201411;909;2760;866;2689;186;615;548;1664;734;2279
420315;201411;997;3251;794;2827;236;927;312;1099;548;2026
420320;201411;5249;16389;4312;14688;1265;4787;1766;5837;3031;10624
420325;201411;468;1512;444;1453;133;471;166;532;299;1003
420330;201411;1341;4686;1053;3879;351;1379;253;817;604;2196
420340;201411;1542;4833;1179;3961;286;1059;288;905;574;1964
420350;201411;1707;5491;1449;4949;421;1518;623;2139;1044;3657
420360;201411;3955;12630;2905;10189;1052;4050;518;1635;1570;5685
420370;201411;2135;6003;1763;5413;224;701;1391;4262;1615;4963
420380;201411;5750;19179;4705;16659;1516;5761;1294;4567;2810;10328
420390;201411;2195;6579;1336;4720;398;1508;339;1140;737;2648
420395;201411;2130;6661;1581;5385;374;1416;326;969;700;2385
420400;201411;1553;4640;1139;3823;345;1342;329;1003;674;2345
420410;201411;870;2422;613;1985;161;589;314;992;475;1581
420415;201411;534;1710;413;1402;138;504;127;414;265;918
420417;201411;826;2666;697;2352;141;513;350;1171;491;1684
420419;201411;468;1488;321;1192;137;554;80;298;217;852
420420;201411;11804;35681;8903;29615;2730;10177;2823;8902;5553;19079
420425;201411;1321;3658;806;2580;95;373;350;1017;445;1390
420430;201411;4323;13627;2967;10376;888;3375;865;2971;1753;6346
420435;201411;299;952;212;739;50;208;103;339;153;547
420440;201411;1510;4426;917;3153;360;1328;170;542;530;1870
420445;201411;447;1298;352;1128;79;254;176;580;255;834
420450;201411;1335;3954;792;2791;197;785;158;463;355;1248
420455;201411;2371;7343;2103;6858;552;2050;946;3016;1498;5066
420460;201411;10454;32893;8353;28823;2425;9416;3089;10183;5514;19599
420470;201411;1301;3593;841;2703;248;894;241;731;489;1625
420475;201411;184;598;121;441;41;154;31;115;72;269
420480;201411;6230;18595;5122;16633;2048;7381;931;2971;2979;10352
420490;201411;966;2859;634;2246;206;776;153;523;359;1299
420500;201411;2172;6690;1760;5895;550;2000;832;2757;1382;4757
420510;201411;199;838;184;799;77;344;51;203;128;547
420515;201411;164;591;131;514;40;169;26;104;66;273
420517;201411;983;3054;896;2888;173;599;569;1834;742;2433
420519;201411;477;1334;348;1075;65;212;132;403;197;615
420520;201411;840;2361;660;2105;185;657;319;978;504;1635
420530;201411;1454;5012;1154;4255;362;1460;300;973;662;2433
420535;201411;291;856;180;622;61;234;29;81;90;315
420540;201411;24275;70990;16721;54426;5076;17975;4836;14621;9912;32596
420543;201411;507;1361;359;1117;48;178;212;690;260;868
420545;201411;1755;5665;1444;4966;399;1546;486;1557;885;3103
420550;201411;5125;16561;4044;14057;1142;4518;1067;3499;2209;8017
420555;201411;472;1517;397;1351;128;479;130;420;258;899
420560;201411;604;1782;505;1572;91;310;260;807;351;1117
420570;201411;2166;7136;1739;6080;513;2025;570;1868;1083;3893
420580;201411;1336;4352;1096;3916;319;1264;486;1730;805;2994
420590;201411;3642;11469;2562;8939;704;2662;502;1586;1206;4248
420600;201411;1014;3512;915;3277;240;923;393;1435;633;2358
420610;201411;656;2142;447;1651;146;588;80;263;226;851
420620;201411;1230;3864;1087;3594;393;1379;294;962;687;2341
420630;201411;1256;3981;905;3128;247;916;284;874;531;1790
420640;201411;721;2257;343;1300;91;394;26;76;117;470
420650;201411;2223;6768;1276;4503;272;1101;232;683;504;1784
420660;201411;696;2072;559;1815;129;475;265;841;394;1316
420665;201411;867;2507;552;1848;118;435;174;519;292;954
420670;201411;1867;5897;1384;4812;331;1316;286;866;617;2182
420675;201411;257;808;180;624;44;168;62;203;106;371
420680;201411;525;1281;313;950;63;217;108;304;171;521
420690;201411;871;3017;631;2328;125;501;193;648;318;1149
420700;201411;3792;11003;2856;9079;691;2573;919;2759;1610;5332
420710;201411;834;2991;693;2697;267;1128;198;732;465;1860
420720;201411;1989;6154;1719;5783;468;1642;969;3277;1437;4919
420730;201411;4942;15385;4248;14069;1444;5130;1639;5316;3083;10446
420740;201411;847;2760;798;2681;189;656;525;1770;714;2426
420750;201411;2651;8663;1856;6706;436;1808;568;1783;1004;3591
420757;201411;146;429;96;355;33;137;28;94;61;231
420760;201411;477;1540;349;1194;85;322;89;281;174;603
420765;201411;711;2350;415;1571;112;463;90;325;202;788
420768;201411;1332;4632;1078;4044;356;1404;393;1484;749;2888
420770;201411;953;2966;589;2133;189;742;144;493;333;1235
420775;201411;719;2297;454;1558;142;489;98;316;240;805
420780;201411;1720;5297;1144;3875;312;1138;277;868;589;2006
420785;201411;326;996;227;739;44;159;76;219;120;378
420790;201411;1438;5100;1159;4355;344;1424;457;1620;801;3044
420800;201411;984;2885;569;1925;184;683;123;385;307;1068
420810;201411;2718;9450;2182;8177;778;3233;574;2087;1352;5320
420820;201411;9176;30335;7109;26424;2378;9789;2254;8412;4632;18201
420830;201411;2983;10026;2558;9199;950;3698;870;3030;1820;6728
420840;201411;1045;3072;578;2105;161;659;164;545;325;1204
420845;201411;1446;4788;1148;4193;421;1740;255;833;676;2573
420850;201411;2159;7100;1425;5470;487;2006;297;1139;784;3145
420860;201411;689;2011;460;1585;161;620;184;624;345;1244
420870;201411;1453;4191;1138;3719;430;1557;364;1111;794;2668
420880;201411;1516;5106;1227;4334;353;1306;229;749;582;2055
420890;201411;13550;32823;6029;19174;1196;4362;1960;5437;3156;9799
420895;201411;240;661;116;380;35;122;27;80;62;202
420900;201411;2499;7198;1606;5393;449;1630;417;1315;866;2945
420910;201411;24099;73464;15640;55237;3676;14810;4404;14439;8080;29249
420915;201411;723;2827;623;2548;197;820;264;1095;461;1915
420917;201411;472;1472;251;810;60;229;89;237;149;466
420920;201411;213;624;109;382;47;176;17;62;64;238
420930;201411;21902;65270;17915;58370;5397;19256;6567;21122;11964;40378
420940;201411;4693;14261;3895;12490;1086;3871;1148;3323;2234;7194
420945;201411;242;755;158;547;50;193;41;134;91;327
420950;201411;674;1955;313;1173;69;301;49;156;118;457
420960;201411;1513;4708;1307;4337;414;1564;511;1560;925;3124
420970;201411;2782;8787;2431;8191;704;2591;1142;3897;1846;6488
420980;201411;486;1578;398;1415;126;450;185;717;311;1167
420985;201411;627;1866;358;1271;104;404;101;340;205;744
420990;201411;967;2856;653;2299;175;683;190;617;365;1300
421000;201411;706;2559;502;2009;156;683;69;222;225;905
421003;201411;728;2073;301;1045;64;253;58;156;122;409
421005;201411;265;854;219;771;72;273;103;354;175;627
421010;201411;7246;21981;5376;18296;1755;6517;1587;5086;3342;11603
421020;201411;513;1642;387;1391;67;241;206;780;273;1021
421030;201411;1040;3823;964;3632;344;1372;328;1249;672;2621
421040;201411;966;2905;780;2568;247;885;302;921;549;1806
421050;201411;2118;5628;1168;3882;324;1235;279;782;603;2017
421055;201411;293;945;190;687;61;240;48;141;109;381
421060;201411;604;2212;489;1882;118;492;150;556;268;1048
421070;201411;813;2552;533;1874;144;580;134;450;278;1030
421080;201411;727;2336;643;2162;189;672;311;1031;500;1703
421085;201411;610;1648;330;1133;79;295;89;325;168;620
421090;201411;511;1438;341;1065;85;285;135;404;220;689
421100;201411;1112;3381;773;2628;225;805;176;529;401;1334
421105;201411;1584;4999;1345;4555;342;1261;539;1862;881;3123
421110;201411;1692;5572;1469;5183;544;2073;462;1522;1006;3595
421120;201411;1750;5641;1260;4461;296;1217;380;1198;676;2415
421125;201411;472;1399;352;1174;106;395;129;405;235;800
421130;201411;3507;11555;2896;10389;1038;4137;957;3412;1995;7549
421140;201411;448;1406;356;1201;94;355;136;430;230;785
421145;201411;616;2034;450;1574;78;303;201;680;279;983
421150;201411;606;1955;459;1675;125;492;186;676;311;1168
421160;201411;1180;3574;676;2356;158;623;231;734;389;1357
421165;201411;338;1201;270;987;63;237;118;433;181;670
421170;201411;2060;6417;1637;5473;439;1555;852;2806;1291;4361
421175;201411;1488;4449;1166;3905;343;1358;435;1300;778;2658
421180;201411;645;1826;356;1199;99;382;123;367;222;749
421185;201411;496;1403;362;1133;75;226;171;559;246;785
421187;201411;354;1104;274;939;77;279;120;395;197;674
421189;201411;544;1664;488;1554;123;404;191;603;314;1007
421190;201411;12092;37701;8281;29392;2417;9186;2266;7904;4683;17090
421200;201411;1119;3719;961;3373;260;998;348;1178;608;2176
421205;201411;244;766;182;627;43;177;46;130;89;307
421210;201411;2201;6842;1805;5850;616;2102;554;1726;1170;3828
421220;201411;2560;8756;2241;8058;794;3111;622;2203;1416;5314
421223;201411;787;2241;493;1713;137;504;220;749;357;1253
421225;201411;1283;3975;1065;3514;283;996;444;1469;727;2465
421227;201411;973;3210;865;3042;220;768;508;1848;728;2616
421230;201411;770;2609;690;2421;203;761;247;835;450;1596
421240;201411;574;1894;359;1266;81;298;71;219;152;517
421250;201411;2129;6517;1424;5205;517;2055;362;1287;879;3342
421260;201411;405;1226;160;621;46;176;31;116;77;292
421265;201411;451;1521;393;1391;98;363;145;512;243;875
421270;201411;818;2251;468;1577;149;535;124;456;273;991
421280;201411;1802;5721;1458;5152;494;1934;471;1665;965;3599
421290;201411;2119;5982;1324;4382;422;1515;318;945;740;2460
421300;201411;343;1067;285;942;100;378;110;339;210;717
421310;201411;542;1848;458;1621;157;562;118;401;275;963
421315;201411;404;1212;233;843;51;189;38;143;89;332
421320;201411;605;2076;407;1522;82;340;70;211;152;551
421330;201411;654;2287;565;2100;230;957;84;301;314;1258
421335;201411;591;1953;469;1704;127;505;104;386;231;891
421340;201411;2121;6555;1800;6008;405;1542;1007;3325;1412;4867
421350;201411;1163;3969;965;3526;316;1289;291;1008;607;2297
421360;201411;3401;10128;2233;7811;536;2133;717;2320;1253;4453
421370;201411;1168;4117;983;3672;336;1382;298;1060;634;2442
421380;201411;1129;3268;905;2830;180;619;442;1380;622;1999
421390;201411;201;657;153;529;28;95;39;148;67;243
421400;201411;431;1632;350;1440;140;613;87;335;227;948
421410;201411;402;1203;298;1000;63;218;149;504;212;722
421415;201411;445;1400;211;791;67;267;54;186;121;453
421420;201411;1432;4478;1075;3603;249;885;233;714;482;1599
421430;201411;309;1012;241;873;76;314;46;156;122;470
421440;201411;905;2715;619;2156;170;639;229;756;399;1395
421450;201411;664;2152;455;1686;148;605;89;308;237;913
421460;201411;795;2423;488;1801;128;527;119;412;247;939
421470;201411;555;2032;466;1827;136;549;182;719;318;1268
421480;201411;2791;8257;1678;6015;449;1844;417;1322;866;3166
421490;201411;365;1191;192;751;70;295;51;194;121;489
421500;201411;2824;10005;2457;9212;1001;4188;552;2002;1553;6190
421505;201411;440;1500;391;1377;113;419;163;567;276;986
421507;201411;733;2349;510;1830;116;431;193;698;309;1129
421510;201411;314;1183;287;1128;93;425;124;422;217;847
421520;201411;841;2267;548;1658;59;231;289;797;348;1028
421530;201411;535;1791;339;1330;88;392;116;439;204;831
421535;201411;711;2149;407;1486;80;316;204;710;284;1026
421540;201411;430;1256;362;1130;88;299;148;444;236;743
421545;201411;1311;4520;1050;3963;337;1420;232;827;569;2247
421550;201411;2360;7906;2071;7343;732;2884;617;2103;1349;4987
421555;201411;341;1039;131;466;24;96;22;71;46;167
421560;201411;246;751;102;366;25;98;23;80;48;178
421565;201411;1129;3582;1032;3412;434;1550;374;1192;808;2742
421567;201411;986;3671;849;3310;414;1656;179;694;593;2350
421568;201411;513;1662;390;1377;108;396;114;402;222;798
421569;201411;218;706;132;493;29;118;35;121;64;239
421570;201411;1383;4490;848;3152;296;1210;193;676;489;1886
421575;201411;638;2144;568;2001;117;439;326;1152;443;1591
421580;201411;4414;14704;3491;12578;1250;5044;891;2893;2141;7937
421590;201411;268;856;216;744;45;164;108;354;153;518
421600;201411;600;1807;438;1453;131;480;109;335;240;815
421605;201411;723;2255;511;1813;129;522;142;473;271;995
421610;201411;1895;4935;1478;4319;204;651;942;2734;1146;3385
421620;201411;5483;16909;3875;13448;1290;4828;1268;4413;2558;9241
421625;201411;449;1411;257;932;66;269;90;313;156;582
421630;201411;2914;8798;1754;6103;533;2035;314;1023;847;3058
421635;201411;372;1230;263;968;66;267;100;331;166;598
421640;201411;1232;3838;996;3393;211;725;585;2043;796;2768
421650;201411;2467;8272;2113;7443;824;3198;368;1184;1192;4382
421660;201411;10287;34410;8291;30270;2722;10999;2641;9054;5363;20053
421670;201411;1322;4297;958;3437;302;1186;276;981;578;2167
421680;201411;1534;5025;1342;4559;525;1879;270;887;795;2766
421690;201411;2123;7020;1648;5855;462;1802;268;874;730;2676
421700;201411;752;2340;456;1644;143;584;138;417;281;1001
421710;201411;370;1316;260;997;102;403;70;258;172;661
421715;201411;318;906;192;641;56;199;58;185;114;384
421720;201411;1740;5349;1174;4166;445;1752;339;1117;784;2869
421725;201411;136;480;128;462;52;205;36;131;88;336
421730;201411;669;2069;342;1252;90;359;72;208;162;567
421740;201411;719;2221;482;1639;119;489;115;288;234;777
421750;201411;1539;4613;1171;3838;325;1161;471;1420;796;2581
421755;201411;472;1487;337;1145;103;387;98;299;201;686
421760;201411;624;2079;346;1278;91;382;124;430;215;812
421770;201411;3955;12045;3160;10406;1211;4146;921;3127;2132;7273
421775;201411;602;1769;393;1381;91;334;122;414;213;748
421780;201411;1860;6421;1452;5481;544;2223;442;1575;986;3798
421790;201411;1076;3034;654;2314;209;839;166;532;375;1371
421795;201411;420;1289;282;938;53;201;86;278;139;479
421800;201411;3012;9660;2321;8265;632;2541;863;2799;1495;5340
421810;201411;702;2272;510;1823;154;578;91;322;245;900
421820;201411;1355;4165;944;3319;219;902;251;777;470;1679
421825;201411;1491;4947;1381;4682;227;910;880;2853;1107;3763
421830;201411;3324;11298;3080;10798;780;2910;1559;5562;2339;8472
421835;201411;200;619;153;540;48;202;74;237;122;439
421840;201411;537;1921;469;1750;164;674;173;611;337;1285
421850;201411;613;1818;426;1431;139;502;121;410;260;912
421860;201411;401;1278;256;946;57;231;52;172;109;403
421870;201411;5565;16408;3935;13005;1246;4448;766;2416;2012;6864
421875;201411;447;1337;206;761;55;234;45;145;100;379
421880;201411;1144;3744;912;3197;281;1120;242;780;523;1900
421885;201411;383;1317;333;1215;86;320;135;491;221;811
421890;201411;1123;3847;966;3503;336;1361;299;1037;635;2398
421895;201411;446;1520;411;1450;113;401;223;814;336;1215
421900;201411;914;2980;757;2598;221;799;265;837;486;1636
421910;201411;566;1781;404;1397;97;378;124;372;221;750
421915;201411;641;1959;484;1597;116;411;160;489;276;900
421917;201411;642;1999;505;1758;164;680;185;582;349;1262
421920;201411;903;2658;633;2282;283;1063;209;752;492;1815
421930;201411;4286;12082;2881;9474;920;3381;502;1551;1422;4932
421935;201411;917;3180;720;2724;197;831;265;969;462;1800
421940;201411;371;1348;260;1018;75;331;60;205;135;536
421950;201411;4734;13490;2575;8830;789;2869;568;1964;1357;4833
421960;201411;267;855;214;733;57;216;61;198;118;414
421970;201411;2425;7239;1672;5542;611;2194;332;974;943;3168
421985;201411;546;1455;299;948;57;204;92;298;149;502
422000;201411;825;2450;655;2126;150;528;308;1036;458;1564
430003;201411;914;2660;722;2319;209;744;228;711;437;1455
430005;201411;328;1088;276;974;61;230;148;504;209;734
430010;201411;2365;6690;1796;5618;537;1738;713;2251;1250;3989
430020;201411;1137;3041;987;2816;225;742;573;1558;798;2300
430030;201411;1629;4408;1332;3867;508;1589;298;803;806;2392
430040;201411;13126;34542;10864;30717;3389;9981;3830;10791;7219;20772
430045;201411;780;2170;622;1844;115;386;349;1009;464;1395
430047;201411;282;708;170;514;34;98;76;229;110;327
430050;201411;1168;3205;761;2426;163;602;285;852;448;1454
430055;201411;310;889;196;621;36;127;100;312;136;439
430057;201411;85;222;41;131;7;25;13;30;20;55
430060;201411;16852;54806;14755;50994;4346;15672;7163;25267;11509;40939
430063;201411;1127;3340;913;2873;248;790;434;1413;682;2203
430064;201411;1740;5191;1446;4687;425;1405;635;2131;1060;3536
430066;201411;181;465;133;388;27;91;73;196;100;287
430070;201411;720;2128;403;1390;107;410;118;363;225;773
430080;201411;683;2216;533;1867;144;558;158;512;302;1070
430085;201411;764;2146;537;1742;155;577;212;650;367;1227
430087;201411;1019;3114;967;3017;115;397;742;2290;857;2687
430090;201411;871;2315;304;1015;43;168;65;216;108;384
430100;201411;1197;3669;869;2973;302;1146;225;645;527;1791
430105;201411;883;2790;672;2364;206;805;177;581;383;1386
430107;201411;274;928;215;750;43;165;86;283;129;448
430110;201411;2378;6892;2126;6476;690;2218;942;2865;1632;5083
430120;201411;1890;5755;1489;4898;339;1179;809;2601;1148;3780
430130;201411;4692;12078;4187;11338;840;2444;2432;6601;3272;9045
430140;201411;1294;4140;986;3405;309;1102;332;1116;641;2218
430150;201411;994;2664;646;2007;164;553;179;540;343;1093
430155;201411;568;1723;403;1370;89;295;196;675;285;970
430160;201411;19340;56881;17842;54399;3900;12886;10058;31383;13958;44269
430163;201411;2037;6118;1746;5575;393;1404;862;2775;1255;4179
430165;201411;460;1371;248;918;96;379;65;226;161;605
430170;201411;806;2363;367;1291;74;283;70;212;144;495
430175;201411;970;3075;763;2579;181;572;356;1289;537;1861
430180;201411;1173;3196;991;2890;256;836;474;1343;730;2179
430185;201411;783;1968;405;1234;65;221;136;373;201;594
430187;201411;760;2338;601;1989;176;666;201;618;377;1284
430190;201411;2455;7303;2138;6671;538;1915;1029;3183;1567;5098
430192;201411;207;638;106;334;15;46;31;94;46;140
430195;201411;299;912;78;282;10;36;13;39;23;75
430200;201411;1697;5481;1411;4852;437;1586;393;1331;830;2917
430205;201411;537;1553;409;1311;60;224;261;810;321;1034
430210;201411;7091;19819;3937;13001;1042;3714;837;2529;1879;6243
430215;201411;381;1104;272;870;60;211;117;359;177;570
430220;201411;733;1919;346;1148;68;249;65;205;133;454
430222;201411;327;997;252;833;53;214;112;347;165;561
430223;201411;364;1082;318;1010;70;230;202;646;272;876
430225;201411;60;174;36;115;7;19;9;23;16;42
430230;201411;2175;6921;2051;6791;344;1003;1614;5553;1958;6556
430235;201411;289;950;229;797;70;263;58;187;128;450
430237;201411;511;1385;383;1152;49;191;250;716;299;907
430240;201411;1175;3319;839;2722;262;964;293;871;555;1835
430245;201411;993;3153;764;2638;203;721;344;1218;547;1939
430250;201411;1662;4593;1482;4269;621;1845;423;1239;1044;3084
430258;201411;184;529;128;419;21;76;52;169;73;245
430260;201411;871;2465;577;1849;78;278;318;1023;396;1301
430265;201411;350;1090;280;931;87;284;44;132;131;416
430270;201411;3722;10527;3324;9843;781;2633;1781;5179;2562;7812
430280;201411;5618;15806;4727;14156;1343;4273;2086;6210;3429;10483
430290;201411;2664;7269;2492;7054;290;812;2070;5971;2360;6783
430300;201411;10852;32778;9074;29302;3110;10522;3733;12291;6843;22813
430310;201411;9426;29408;8127;26847;2590;9187;3393;10856;5983;20043
430320;201411;887;2609;603;2021;104;311;311;1097;415;1408
430330;201411;1042;2845;871;2517;264;799;353;948;617;1747
430340;201411;791;1990;441;1462;102;390;209;680;311;1070
430350;201411;6581;20874;5569;18614;2041;7189;1948;6372;3989;13561
430355;201411;344;881;150;475;33;119;30;83;63;202
430360;201411;1187;3192;998;2820;200;638;537;1460;737;2098
430367;201411;370;1021;241;785;45;154;66;210;111;364
430370;201411;509;1483;376;1214;113;404;105;304;218;708
430380;201411;899;2319;502;1590;135;456;178;581;313;1037
430390;201411;4757;13815;3426;11035;891;3098;980;3000;1871;6098
430400;201411;1413;3398;973;2728;295;928;429;1099;724;2027
430410;201411;737;1991;565;1704;106;349;289;873;395;1222
430420;201411;4844;14071;3886;11862;1159;3628;1585;4833;2744;8461
430430;201411;857;2368;545;1766;173;612;152;472;325;1084
430435;201411;2187;5922;1741;5100;412;1269;911;2693;1323;3962
430440;201411;5182;16100;4142;13889;883;3111;1937;6791;2820;9902
430450;201411;9322;26786;7404;22804;2850;9212;2058;6313;4908;15525
430460;201411;29557;89474;23629;78426;7403;26317;8429;28011;15832;54328
430461;201411;496;1382;170;556;33;120;46;144;79;264
430462;201411;372;1090;293;949;122;437;81;240;203;677
430463;201411;4263;13771;3721;12692;923;3421;1851;6318;2774;9739
430465;201411;683;1855;579;1675;121;402;381;1065;502;1467
430466;201411;4751;13670;4392;13077;1152;3730;2340;6934;3492;10664
430467;201411;623;1879;547;1751;136;481;265;812;401;1293
430468;201411;1547;4484;1345;4159;515;1712;429;1313;944;3025
430469;201411;232;659;66;251;8;39;18;65;26;104
430470;201411;7923;21327;5697;17439;1902;6241;1439;4317;3341;10558
430471;201411;929;3067;826;2844;299;1072;218;753;517;1825
430480;201411;970;2635;524;1698;90;317;134;378;224;695
430485;201411;263;802;141;506;30;105;54;197;84;302
430490;201411;556;1646;398;1344;120;416;140;492;260;908
430495;201411;446;1329;297;1001;63;231;82;257;145;488
430500;201411;1685;4740;1423;4281;450;1474;612;1819;1062;3293
430510;201411;26446;80891;20699;67916;7179;25742;6041;18825;13220;44567
430511;201411;482;1464;221;753;40;152;42;118;82;270
430512;201411;1387;3617;1215;3330;350;975;465;1336;815;2311
430513;201411;760;2097;485;1500;81;259;235;729;316;988
430515;201411;633;1856;495;1555;102;314;220;717;322;1031
430517;201411;1519;4943;1303;4479;272;988;792;2715;1064;3703
430520;201411;1891;5485;1449;4536;461;1548;536;1616;997;3164
430530;201411;986;2772;516;1668;90;341;147;430;237;771
430535;201411;2651;8398;2160;7325;597;2256;729;2403;1326;4659
430537;201411;642;1847;446;1510;48;165;341;1171;389;1336
430540;201411;816;1945;589;1642;136;412;335;913;471;1325
430543;201411;616;1618;554;1555;122;365;386;1092;508;1457
430544;201411;809;2612;669;2283;141;523;347;1151;488;1674
430545;201411;1503;4845;1309;4596;440;1551;679;2532;1119;4083
430550;201411;738;2185;495;1660;109;390;190;638;299;1028
430558;201411;120;359;73;247;32;122;10;25;42;147
430560;201411;414;1035;239;709;34;121;84;236;118;357
430570;201411;1285;3326;877;2567;239;786;410;1103;649;1889
430580;201411;1228;3356;755;2442;249;840;193;644;442;1484
430583;201411;156;426;49;162;7;25;4;11;11;36
430585;201411;372;993;242;714;74;243;103;271;177;514
430587;201411;302;940;257;845;95;324;79;262;174;586
430590;201411;1567;4414;1484;4281;299;956;952;2720;1251;3676
430593;201411;36;138;32;125;10;49;11;35;21;84
430595;201411;274;784;108;388;36;148;18;53;54;201
430597;201411;414;1262;311;1011;59;210;124;383;183;593
430600;201411;2321;6376;1379;4258;304;996;467;1406;771;2402
430605;201411;1427;4432;1124;3778;284;1044;466;1594;750;2638
430607;201411;801;2088;635;1814;106;330;391;1122;497;1452
430610;201411;8748;23642;6763;20367;1786;5904;2737;8208;4523;14112
430613;201411;266;661;115;351;26;77;28;73;54;150
430620;201411;1015;3094;826;2663;248;882;329;999;577;1881
430630;201411;517;1562;297;995;93;321;55;170;148;491
430632;201411;777;2158;456;1431;91;331;233;676;324;1007
430635;201411;714;1978;507;1569;118;389;246;755;364;1144
430637;201411;563;1608;501;1480;85;294;321;906;406;1200
430640;201411;2086;5840;1064;3508;245;846;215;587;460;1433
430642;201411;521;1376;316;996;65;221;127;389;192;610
430645;201411;199;584;110;379;26;95;27;90;53;185
430650;201411;2200;7205;1907;6584;431;1512;1042;3723;1473;5235
430655;201411;317;955;276;866;71;243;102;267;173;510
430660;201411;6428;18809;5100;16349;1540;5436;2098;6642;3638;12078
430670;201411;513;1506;465;1411;45;132;346;1088;391;1220
430673;201411;820;1999;449;1365;122;385;187;565;309;950
430675;201411;288;856;131;435;30;115;48;145;78;260
430676;201411;4898;14787;4358;13839;1353;4551;1722;5654;3075;10205
430680;201411;1283;3820;928;3022;198;741;349;1025;547;1766
430690;201411;4744;13703;3856;11936;1241;3995;1386;4389;2627;8384
430692;201411;315;1072;227;892;28;109;142;565;170;674
430693;201411;1859;5237;1340;4089;309;1045;384;1097;693;2142
430695;201411;514;1495;388;1245;82;307;178;533;260;840
430697;201411;498;1412;377;1200;115;359;149;514;264;873
430700;201411;9607;25181;4316;14385;925;3410;417;1336;1342;4746
430705;201411;421;1327;389;1271;124;436;166;548;290;984
430710;201411;1928;4962;1485;4207;337;1029;672;1968;1009;2997
430720;201411;953;2376;629;1891;181;592;246;744;427;1336
430730;201411;1986;5338;1492;4519;358;1054;785;2513;1143;3567
430740;201411;642;1806;385;1256;117;407;72;215;189;622
430745;201411;550;1572;324;1017;68;225;95;305;163;530
430750;201411;1948;5511;1606;4920;386;1304;814;2391;1200;3695
430755;201411;681;1908;476;1460;100;363;214;590;314;953
430760;201411;3882;9977;2987;8725;752;2346;1506;4534;2258;6880
430770;201411;7541;22408;6177;19889;1418;4969;3160;10059;4578;15028
430780;201411;2800;7873;1849;5963;525;1852;675;2080;1200;3932
430781;201411;680;2007;485;1593;139;472;157;504;296;976
430783;201411;628;1589;452;1299;97;317;211;558;308;875
430786;201411;131;427;102;351;34;121;24;83;58;204
430790;201411;4494;12411;2968;9239;629;2263;1276;3640;1905;5903
430800;201411;875;2624;612;1988;146;501;210;648;356;1149
430805;201411;511;1449;369;1188;47;148;222;746;269;894
430807;201411;362;1080;250;815;58;223;79;234;137;457
430810;201411;777;2173;381;1281;73;276;73;216;146;492
430820;201411;1191;3803;865;2962;246;898;258;815;504;1713
430825;201411;475;1338;243;771;48;162;79;222;127;384
430830;201411;2745;8033;2530;7703;365;1109;1646;5319;2011;6428
430840;201411;1060;3272;956;3052;244;800;447;1480;691;2280
430843;201411;131;389;78;255;16;50;34;107;50;157
430845;201411;366;1115;291;952;117;409;40;127;157;536
430850;201411;3498;10649;3090;9895;839;2840;1397;4480;2236;7320
430860;201411;937;2549;552;1883;180;707;147;454;327;1161
430865;201411;761;2066;694;1950;227;667;331;920;558;1587
430870;201411;744;2100;439;1464;128;440;112;346;240;786
430880;201411;1486;4257;1164;3627;437;1413;340;1096;777;2509
430885;201411;228;675;167;573;51;190;62;203;113;393
430890;201411;1834;4848;1277;3737;88;310;688;1934;776;2244
430900;201411;3530;9340;3124;8689;752;2273;1669;4522;2421;6795
430905;201411;1206;3542;805;2643;248;896;208;651;456;1547
430910;201411;1946;6090;1512;5200;535;1977;551;1816;1086;3793
430912;201411;630;1760;481;1514;75;274;275;843;350;1117
430915;201411;494;1605;333;1260;103;417;98;391;201;808
430920;201411;18434;57690;16662;54294;4780;16557;9413;30328;14193;46885
430925;201411;95;271;71;223;23;84;34;99;57;183
430930;201411;10737;32640;8044;27191;2461;8835;2811;9833;5272;18668
430940;201411;1395;4352;967;3325;247;941;271;871;518;1812
430950;201411;1675;4707;1262;3840;392;1266;402;1172;794;2438
430955;201411;161;504;88;302;30;109;22;71;52;180
430957;201411;331;1116;266;972;71;278;116;429;187;707
430960;201411;1891;5414;1649;4987;603;1943;585;1788;1188;3731
430965;201411;1492;4393;1283;4023;96;359;1048;3265;1144;3624
430970;201411;565;1583;326;1054;75;264;95;295;170;559
430975;201411;668;2170;513;1787;85;320;279;964;364;1284
430980;201411;616;1469;349;1063;95;328;140;383;235;711
430990;201411;711;2291;536;1845;176;621;146;490;322;1111
430995;201411;765;2271;666;2073;229;749;247;757;476;1506
431000;201411;1773;4674;920;2871;199;700;125;317;324;1017
431010;201411;3026;8844;2002;6729;520;1913;622;1944;1142;3857
431020;201411;15265;37853;10402;28975;2848;8145;3338;9554;6186;17699
431030;201411;395;1180;214;756;55;207;49;163;104;370
431033;201411;2925;8491;2661;8081;671;2108;1451;4608;2122;6716
431036;201411;247;663;113;385;18;63;25;72;43;135
431040;201411;1109;3171;887;2797;251;884;447;1364;698;2248
431041;201411;613;1684;546;1588;165;496;238;723;403;1219
431043;201411;438;1438;325;1170;153;601;104;335;257;936
431046;201411;133;396;98;319;24;90;34;105;58;195
431050;201411;1959;4942;1533;4213;358;1056;838;2270;1196;3326
431053;201411;665;2198;552;1943;177;674;172;620;349;1294
431055;201411;720;1992;666;1895;72;209;490;1401;562;1610
431057;201411;392;1154;228;798;54;192;91;318;145;510
431060;201411;6530;19240;6089;18648;1718;5119;3442;11034;5160;16153
431065;201411;538;1539;456;1388;53;173;300;912;353;1085
431070;201411;788;2296;465;1558;98;336;120;369;218;705
431075;201411;297;909;199;691;38;143;64;230;102;373
431080;201411;760;2484;620;2172;173;649;136;456;309;1105
431085;201411;991;2629;789;2272;139;432;477;1360;616;1792
431087;201411;650;1876;567;1711;81;237;368;1117;449;1354
431090;201411;592;1495;305;947;103;336;65;184;168;520
431100;201411;4908;13658;4089;12214;1217;3841;1659;5068;2876;8909
431110;201411;1705;4550;1277;3688;300;931;633;1762;933;2693
431112;201411;672;2117;638;2054;204;664;305;979;509;1643
431113;201411;701;2072;519;1660;151;497;143;459;294;956
431115;201411;1617;4747;1434;4421;297;959;856;2636;1153;3595
431120;201411;2985;9386;2488;8390;777;2863;1007;3286;1784;6149
431123;201411;603;1803;455;1513;110;401;241;807;351;1208
431125;201411;1456;4469;1097;3694;334;1105;367;1336;701;2441
431127;201411;193;498;60;195;9;25;4;10;13;35
431130;201411;4164;11997;3303;10453;893;3062;1378;4362;2271;7424
431140;201411;4353;10972;2337;7458;459;1688;560;1532;1019;3220
431142;201411;577;1730;517;1616;70;220;336;1072;406;1292
431150;201411;1387;4190;1116;3657;306;1053;414;1365;720;2418
431160;201411;1042;3091;869;2723;174;550;426;1437;600;1987
431162;201411;480;1287;227;773;33;141;38;104;71;245
431164;201411;161;450;45;166;16;63;1;4;17;67
431170;201411;1003;2906;773;2452;274;897;217;682;491;1579
431171;201411;931;2775;798;2503;291;959;210;629;501;1588
431173;201411;532;1562;475;1458;112;356;279;862;391;1218
431175;201411;1349;3752;1158;3459;389;1220;465;1390;854;2610
431177;201411;1112;3569;923;3174;322;1211;388;1317;710;2528
431179;201411;342;733;89;265;12;47;24;58;36;105
431180;201411;2334;6782;1674;5340;402;1390;437;1320;839;2710
431190;201411;835;2285;465;1526;121;436;127;407;248;843
431198;201411;404;1317;354;1213;164;598;82;274;246;872
431200;201411;342;969;107;356;25;90;10;29;35;119
431205;201411;382;1211;236;827;56;194;87;300;143;494
431210;201411;828;2312;712;2085;192;565;382;1127;574;1692
431213;201411;313;971;258;864;80;297;90;289;170;586
431215;201411;343;1015;170;580;34;115;17;45;51;160
431217;201411;249;750;193;620;63;219;49;168;112;387
431220;201411;1201;3122;834;2399;126;417;426;1161;552;1578
431225;201411;1433;4233;1236;3891;299;983;674;2148;973;3131
431230;201411;997;2930;775;2462;127;431;421;1322;548;1753
431235;201411;75;179;35;106;9;30;11;31;20;61
431237;201411;462;1503;405;1419;123;483;183;624;306;1107
431238;201411;54;172;44;147;10;36;15;49;25;85
431240;201411;2868;8686;2440;7940;880;3104;732;2312;1612;5416
431242;201411;451;1430;414;1358;163;579;67;211;230;790
431244;201411;512;1246;346;966;72;238;163;419;235;657
431245;201411;1228;3337;992;2918;185;577;612;1806;797;2383
431247;201411;243;762;192;660;79;292;68;222;147;514
431250;201411;1987;6219;1751;5877;543;1961;761;2609;1304;4570
431260;201411;434;1263;290;968;81;308;69;209;150;517
431261;201411;233;807;198;723;40;164;68;238;108;402
431262;201411;408;1117;167;556;25;107;71;231;96;338
431265;201411;1473;3941;819;2525;197;692;226;581;423;1273
431267;201411;210;628;176;563;45;164;84;250;129;414
431270;201411;2794;7462;2127;6416;584;1847;960;2985;1544;4832
431275;201411;254;797;149;531;45;157;30;94;75;251
431280;201411;283;802;116;395;23;92;26;71;49;163
431290;201411;384;1244;297;1022;84;337;74;242;158;579
431295;201411;231;740;138;468;25;93;39;115;64;208
431300;201411;323;891;90;340;26;98;5;21;31;119
431301;201411;257;834;165;585;47;163;29;90;76;253
431303;201411;812;2184;526;1583;125;448;175;482;300;930
431306;201411;2287;6332;1713;5257;320;1176;604;1662;924;2838
431308;201411;56;193;52;182;34;119;13;48;47;167
431310;201411;819;2496;503;1744;107;387;158;562;265;949
431320;201411;1026;3003;613;2135;179;691;150;497;329;1188
431330;201411;2557;6519;1245;3989;389;1373;176;530;565;1903
431333;201411;471;1255;213;644;43;140;68;170;111;310
431335;201411;97;289;81;249;19;56;31;92;50;148
431337;201411;2750;8483;2083;7000;571;2022;514;1641;1085;3663
431339;201411;738;2055;509;1549;108;340;240;726;348;1066
431340;201411;29260;78370;21107;64045;5349;17810;7151;21082;12500;38892
431342;201411;654;1706;551;1531;160;478;293;782;453;1260
431344;201411;413;1131;306;940;29;89;202;635;231;724
431346;201411;349;921;198;583;57;168;58;170;115;338
431349;201411;696;2016;463;1442;106;339;157;481;263;820
431350;201411;4245;12678;3661;11630;744;2715;2003;6141;2747;8856
431360;201411;870;2316;626;1899;162;514;247;765;409;1279
431365;201411;1538;4637;1328;4277;482;1665;529;1731;1011;3396
431370;201411;5556;16009;4518;14177;1323;4460;1689;5332;3012;9792
431380;201411;1109;3412;1034;3244;174;586;713;2205;887;2791
431390;201411;3865;10916;2607;8448;801;2946;772;2279;1573;5225
431395;201411;1717;5087;1497;4709;447;1500;608;1902;1055;3402
431400;201411;258;838;150;550;48;184;17;44;65;228
431402;201411;1394;3391;818;2344;178;531;394;1098;572;1629
431403;201411;331;991;245;830;79;291;54;181;133;472
431405;201411;4964;14142;3967;12632;962;3541;1904;5815;2866;9356
431406;201411;866;2677;650;2181;210;736;277;910;487;1646
431407;201411;699;2084;469;1575;141;483;113;355;254;838
431410;201411;17478;53520;13538;45519;4922;17653;3171;11057;8093;28710
431413;201411;215;528;102;318;12;42;42;122;54;164
431415;201411;980;2805;788;2436;200;672;350;1028;550;1700
431417;201411;714;1814;572;1600;94;270;322;924;416;1194
431420;201411;1666;4627;1459;4289;342;1039;794;2435;1136;3474
431430;201411;629;1723;447;1390;113;382;158;454;271;836
431440;201411;34458;100166;30153;92994;9882;31368;13249;42818;23131;74186
431442;201411;219;693;170;566;58;214;27;65;85;279
431445;201411;519;1424;313;955;56;180;130;381;186;561
431446;201411;522;1537;383;1243;97;321;163;532;260;853
431447;201411;866;2486;610;1898;137;459;259;820;396;1279
431449;201411;969;2748;785;2421;120;407;445;1395;565;1802
431450;201411;2426;6299;2186;5935;469;1353;1443;3875;1912;5228
431455;201411;735;1881;412;1177;128;371;117;318;245;689
431460;201411;3796;10688;3254;9636;992;3011;1197;3654;2189;6665
431470;201411;1928;5695;1535;4823;423;1317;663;2176;1086;3493
431475;201411;194;574;55;214;10;43;4;15;14;58
431477;201411;765;2083;528;1608;82;276;308;906;390;1182
431478;201411;261;683;101;303;19;56;39;112;58;168
431480;201411;3094;8801;2390;7501;709;2460;929;2787;1638;5247
431490;201411;122258;341144;106599;317182;17933;60580;71313;208192;89246;268772
431500;201411;1233;3230;972;2732;268;744;390;1116;658;1860
431505;201411;481;1251;403;1135;47;125;304;886;351;1011
431507;201411;469;1153;370;967;71;182;229;605;300;787
431510;201411;2292;6328;1879;5578;398;1296;930;2654;1328;3950
431513;201411;286;784;126;405;29;100;58;186;87;286
431514;201411;115;299;43;147;6;26;3;9;9;35
431515;201411;806;2389;563;1769;119;425;224;609;343;1034
431517;201411;98;317;90;297;37;132;28;78;65;210
431520;201411;501;1503;317;1033;62;224;88;272;150;496
431530;201411;4879;11762;3740;10443;1157;3282;1765;5220;2922;8502
431531;201411;316;887;214;681;55;183;82;260;137;443
431532;201411;594;1675;518;1516;154;486;220;634;374;1120
431535;201411;458;1296;279;873;66;227;77;217;143;444
431540;201411;2306;7432;2054;7063;281;895;1376;5064;1657;5959
431545;201411;256;722;57;201;6;22;9;42;15;64
431550;201411;2633;7780;2370;7303;526;1836;1197;3619;1723;5455
431555;201411;842;2187;703;1960;155;427;392;1101;547;1528
431560;201411;26405;80765;21295;70229;8134;27330;6621;22856;14755;50186
431570;201411;5884;16621;5236;15576;1536;4667;2753;8288;4289;12955
431575;201411;496;1319;352;1064;72;254;111;297;183;551
431580;201411;855;2595;606;2022;175;655;192;574;367;1229
431590;201411;1043;2900;710;2208;103;333;331;1027;434;1360
431595;201411;657;1843;533;1575;136;416;207;610;343;1026
431600;201411;2449;7184;1789;5820;475;1768;384;1094;859;2862
431610;201411;1803;5090;1314;4185;311;1032;612;1959;923;2991
431620;201411;466;1418;262;859;75;264;111;332;186;596
431630;201411;1565;4199;1104;3255;298;908;499;1484;797;2392
431640;201411;6547;19270;5908;18244;1432;4889;3369;10245;4801;15134
431642;201411;582;1670;481;1474;81;291;248;722;329;1013
431643;201411;230;622;196;559;28;91;117;312;145;403
431645;201411;1912;5656;1706;5281;374;1223;975;3053;1349;4276
431647;201411;190;549;129;401;39;127;33;89;72;216
431650;201411;279;870;192;683;34;134;47;141;81;275
431660;201411;1623;4772;1164;3808;362;1236;411;1288;773;2524
431670;201411;1491;4103;1173;3516;317;1056;518;1479;835;2535
431673;201411;257;748;157;523;42;157;44;141;86;298
431675;201411;653;1828;230;788;57;202;61;182;118;384
431680;201411;11090;30799;8397;25927;2522;8393;2758;8553;5280;16946
431690;201411;28184;80192;22662;71259;6854;23074;9398;30059;16252;53133
431695;201411;161;552;117;436;29;109;31;84;60;193
431697;201411;536;1516;474;1400;135;403;212;648;347;1051
431700;201411;1732;4883;1470;4376;283;901;784;2291;1067;3192
431710;201411;13737;40197;11211;35779;3583;12078;3982;13027;7565;25105
431720;201411;7710;21736;6210;18823;1449;4926;3009;8912;4458;13838
431725;201411;34;119;32;115;13;48;11;39;24;87
431730;201411;4122;12547;3299;10962;972;3551;1054;3570;2026;7121
431740;201411;6307;18352;5395;16626;1964;6524;1463;4288;3427;10812
431750;201411;11032;31408;9414;28743;2074;6840;4897;15245;6971;22085
431755;201411;321;876;68;250;13;54;16;52;29;106
431760;201411;4406;13202;3620;11688;1017;3590;1203;3700;2220;7290
431770;201411;2451;6691;2060;6056;484;1489;1132;3307;1616;4796
431775;201411;253;700;182;566;76;248;43;116;119;364
431780;201411;2484;6648;1869;5479;535;1690;535;1481;1070;3171
431790;201411;1360;4257;1172;3890;274;960;636;2131;910;3091
431795;201411;502;1469;340;1062;66;220;129;408;195;628
431800;201411;10022;29652;8255;26269;2802;9596;2284;7096;5086;16692
431805;201411;318;773;88;304;12;47;16;55;28;102
431810;201411;3781;10458;3042;8943;659;2067;1425;4141;2084;6208
431820;201411;3011;9488;2621;8697;725;2565;1011;3299;1736;5864
431830;201411;12488;31732;10004;27939;3165;9487;3954;11183;7119;20670
431840;201411;3755;11178;3285;10291;985;3195;1494;4763;2479;7958
431842;201411;785;2001;397;1198;79;268;129;357;208;625
431843;201411;389;1134;340;1045;66;219;189;568;255;787
431844;201411;212;589;133;447;35;137;45;141;80;278
431845;201411;575;1713;503;1562;56;179;340;1071;396;1250
431846;201411;549;1619;471;1479;93;337;279;873;372;1210
431848;201411;200;547;107;360;23;92;21;65;44;157
431849;201411;429;1057;108;323;27;84;28;70;55;154
431850;201411;5320;15529;4638;14165;1179;3832;2070;6254;3249;10086
431860;201411;1016;2835;781;2410;160;566;416;1219;576;1785
431861;201411;101;309;62;217;14;47;7;20;21;67
431862;201411;514;1730;412;1500;145;572;105;365;250;937
431870;201411;27618;78194;22785;69396;6281;20894;9584;28374;15865;49268
431880;201411;5212;16265;4257;14088;1225;4430;1730;5547;2955;9977
431890;201411;6483;17952;5258;15764;1901;5979;1720;5294;3621;11273
431900;201411;1103;3240;791;2622;237;889;304;903;541;1792
431910;201411;1027;2456;489;1418;98;316;183;477;281;793
431912;201411;646;1864;499;1571;167;510;169;564;336;1074
431915;201411;1475;4011;1102;3332;282;922;439;1325;721;2247
431920;201411;1578;4405;1434;4201;195;523;1106;3337;1301;3860
431930;201411;1388;3825;1056;3285;168;494;627;2085;795;2579
431935;201411;124;448;109;417;45;195;31;96;76;291
431936;201411;491;1408;400;1209;77;220;218;725;295;945
431937;201411;364;976;216;666;57;195;43;117;100;312
431940;201411;2942;8028;1927;6022;519;1731;548;1671;1067;3402
431950;201411;2047;6491;1828;6092;496;1800;768;2455;1264;4255
431960;201411;3880;11442;3530;10760;1058;3393;1296;3975;2354;7368
431970;201411;525;1447;267;862;41;153;78;233;119;386
431971;201411;141;406;111;351;22;71;39;112;61;183
431973;201411;515;1770;455;1645;61;223;281;1064;342;1287
431975;201411;32;92;15;60;3;16;4;16;7;32
431980;201411;1649;4763;1417;4281;374;1251;539;1517;913;2768
431990;201411;9196;25444;7012;21800;1563;5567;2784;8156;4347;13723
432000;201411;12002;34830;9672;30679;3115;10335;3960;12584;7075;22919
432010;201411;2702;7927;2282;7122;560;1948;1047;3164;1607;5112
432020;201411;2530;6299;2039;5657;304;922;1386;3821;1690;4743
432023;201411;580;1675;401;1277;104;375;139;404;243;779
432026;201411;1396;4183;1043;3435;208;706;553;1828;761;2534
432030;201411;456;1344;357;1124;90;290;160;486;250;776
432032;201411;591;1545;396;1177;67;230;220;620;287;850
432035;201411;915;2879;815;2686;175;602;489;1601;664;2203
432040;201411;1066;2697;577;1884;155;565;140;369;295;934
432045;201411;263;808;175;634;47;179;66;245;113;424
432050;201411;836;2406;736;2212;142;454;427;1306;569;1760
432055;201411;889;2729;743;2418;162;580;436;1369;598;1949
432057;201411;486;1266;379;1066;53;166;236;622;289;788
432060;201411;488;1374;207;716;55;209;54;165;109;374
432065;201411;250;731;193;625;49;172;88;267;137;439
432067;201411;1121;3566;817;2871;217;785;390;1364;607;2149
432070;201411;2684;7279;1885;5667;577;1944;584;1651;1161;3595
432080;201411;4528;13181;3920;12070;1238;4006;1601;4867;2839;8873
432085;201411;316;969;253;852;69;269;119;384;188;653
432090;201411;1897;5811;1576;5107;597;2068;498;1460;1095;3528
432100;201411;1316;3892;718;2478;204;742;113;313;317;1055
432110;201411;3257;9779;2561;8272;832;2944;439;1316;1271;4260
432120;201411;5747;17275;4945;15780;1855;6298;1655;5269;3510;11567
432130;201411;2572;7251;2073;6591;676;2359;948;3014;1624;5373
432132;201411;506;1467;271;927;38;142;100;313;138;455
432135;201411;815;2473;774;2402;122;406;543;1676;665;2082
432140;201411;3027;8891;2449;7819;690;2265;970;3392;1660;5657
432143;201411;1494;4509;1283;4152;310;1034;707;2358;1017;3392
432145;201411;1252;3979;850;3013;269;1044;161;513;430;1557
432146;201411;288;909;209;714;70;253;52;171;122;424
432147;201411;850;2691;682;2319;203;704;272;948;475;1652
432149;201411;387;1149;240;793;64;224;95;303;159;527
432150;201411;4252;12251;3210;10268;1013;3558;1033;3156;2046;6714
432160;201411;5062;16330;4502;15352;1543;5525;1808;6400;3351;11925
432162;201411;396;982;99;320;23;82;27;74;50;156
432163;201411;408;1076;108;341;15;46;24;78;39;124
432166;201411;842;2524;688;2199;139;514;336;1000;475;1514
432170;201411;969;3167;640;2415;149;580;128;459;277;1039
432180;201411;3076;8167;2142;6558;634;2077;642;1928;1276;4005
432183;201411;477;1527;396;1361;176;629;95;324;271;953
432185;201411;1020;2798;642;2073;136;494;277;878;413;1372
432190;201411;3845;10622;2766;8202;784;2412;865;2414;1649;4826
432195;201411;1408;3941;1211;3631;203;654;773;2297;976;2951
432200;201411;3549;10772;2852;9529;762;2743;1363;4658;2125;7401
432210;201411;507;1449;403;1279;109;406;191;555;300;961
432215;201411;954;2958;824;2742;151;476;512;1804;663;2280
432218;201411;334;916;254;762;48;154;114;314;162;468
432220;201411;4267;11348;3518;10150;436;1475;2326;6588;2762;8063
432225;201411;68;222;57;201;25;89;15;52;40;141
432230;201411;1264;3569;859;2678;262;901;307;850;569;1751
432232;201411;615;1815;484;1558;123;444;224;701;347;1145
432234;201411;564;1558;409;1194;102;305;173;484;275;789
432235;201411;79;244;47;169;14;63;8;28;22;91
432237;201411;522;1453;472;1372;34;134;369;1041;403;1175
432240;201411;16549;54315;14372;51320;3084;12208;8613;31452;11697;43660
432250;201411;5968;20607;5511;19682;2266;8748;1632;5858;3898;14606
432252;201411;517;1505;423;1328;130;430;193;620;323;1050
432253;201411;1404;4507;999;3499;320;1160;300;1057;620;2217
432254;201411;765;2071;224;729;47;164;37;100;84;264
432255;201411;225;577;127;418;35;123;41;130;76;253
432260;201411;7881;20070;5456;15948;1349;4118;2353;7008;3702;11126
432270;201411;2956;9014;2539;8284;788;2631;1102;3683;1890;6314
432280;201411;1299;3684;693;2310;145;519;170;515;315;1034
432285;201411;188;600;69;235;24;89;12;32;36;121
432290;201411;628;1890;414;1390;101;368;155;502;256;870
432300;201411;26035;79105;23404;74499;5788;19616;12839;40788;18627;60404
432310;201411;903;2729;746;2455;158;595;413;1322;571;1917
432320;201411;302;826;175;562;50;161;57;188;107;349
432330;201411;313;838;119;405;17;59;14;41;31;100
432335;201411;221;646;95;331;26;99;12;32;38;131
432340;201411;344;883;166;511;38;126;57;167;95;293
432345;201411;794;2249;736;2156;158;556;409;1108;567;1664
432350;201411;508;1410;312;1025;80;282;85;257;165;539
432360;201411;173;527;39;141;13;55;12;36;25;91
432370;201411;507;1436;398;1216;43;127;252;796;295;923
432375;201411;922;2349;725;2022;121;353;437;1233;558;1586
432377;201411;160;515;44;148;7;31;16;45;23;76
432380;201411;956;3313;862;3130;330;1350;350;1201;680;2551
500020;201411;2177;6658;1609;5544;413;1648;588;1875;1001;3523
500025;201411;1157;2861;744;2129;127;383;404;1128;531;1511
500060;201411;6777;19919;5420;17696;806;2673;3569;12106;4375;14779
500070;201411;4343;12839;3678;11681;902;3240;1679;5244;2581;8484
500080;201411;1815;5381;1365;4559;447;1638;456;1556;903;3194
500085;201411;2242;5965;1652;5059;216;735;1017;3010;1233;3745
500090;201411;2515;7288;1911;6185;425;1437;947;3147;1372;4584
500100;201411;2696;8158;2466;7787;778;2785;1146;3467;1924;6252
500110;201411;8497;24993;6944;22618;1153;4031;4016;13793;5169;17824
500124;201411;2008;6425;1708;5915;312;1061;1005;3764;1317;4825
500150;201411;1591;4092;1202;3444;291;953;552;1434;843;2387
500190;201411;5418;14055;4210;12537;908;2926;2386;7408;3294;10334
500200;201411;2832;7244;2065;6046;381;1273;1196;3404;1577;4677
500210;201411;5183;15355;4416;14169;1008;3416;2308;7573;3316;10989
500215;201411;1663;5130;1343;4491;263;990;567;1810;830;2800
500220;201411;2936;9270;2397;8266;575;2128;929;3282;1504;5410
500230;201411;2826;7386;2171;6398;654;2073;906;2712;1560;4785
500240;201411;5204;16047;3795;13165;759;2830;1510;5556;2269;8386
500260;201411;2755;7348;2138;6334;404;1311;1040;2919;1444;4230
500270;201411;119446;310905;78402;239735;21992;72904;20692;62940;42684;135844
500280;201411;1479;4200;1257;3895;178;578;884;2809;1062;3387
500290;201411;4375;10872;2750;8247;804;2779;855;2326;1659;5105
500295;201411;2740;8332;1849;6140;434;1626;490;1410;924;3036
500310;201411;888;2374;759;2180;187;577;356;986;543;1563
500315;201411;3348;10469;2859;9735;553;1889;1825;6506;2378;8395
500320;201411;15296;50543;13135;46536;4263;15955;4954;18601;9217;34556
500325;201411;4414;11620;3322;9868;874;2848;1582;4577;2456;7425
500330;201411;6485;17726;4990;14925;1185;3828;2479;7326;3664;11154
500345;201411;2678;7600;2197;6805;516;1800;1159;3472;1675;5272
500348;201411;2642;7567;2349;7085;252;859;1744;5239;1996;6098
500350;201411;1282;3911;805;2813;142;540;251;891;393;1431
500370;201411;24892;77359;19322;66479;5061;19331;6645;22922;11706;42253
500375;201411;2914;7953;2113;6454;536;1780;862;2690;1398;4470
500380;201411;3133;9020;2633;8104;914;2912;908;2803;1822;5715
500390;201411;626;1347;406;1034;50;160;284;677;334;837
500400;201411;1450;4496;1113;3676;293;1074;350;1060;643;2134
500410;201411;2299;6454;1825;5737;473;1659;853;2659;1326;4318
500430;201411;2924;8448;2323;7580;557;1985;1051;3535;1608;5520
500440;201411;1513;4250;1181;3702;268;935;604;1849;872;2784
500450;201411;2251;6992;1762;5994;461;1756;375;1144;836;2900
500460;201411;3948;11738;3048;10219;936;3488;826;2723;1762;6211
500470;201411;3003;8941;2110;6957;605;2157;344;1034;949;3191
500480;201411;2067;6615;1914;6390;198;642;1532;5274;1730;5916
500490;201411;1150;3243;936;2864;302;1020;311;957;613;1977
500500;201411;3766;11715;3001;10513;1164;4574;932;3216;2096;7790
500510;201411;942;2490;604;1894;119;432;260;733;379;1165
500515;201411;2017;5320;1607;4773;284;798;976;3171;1260;3969
500520;201411;3003;10278;2681;9836;524;2056;1715;6475;2239;8531
500525;201411;1250;3999;1023;3553;226;834;509;1867;735;2701
500540;201411;5944;16909;3596;12245;1143;4461;673;2087;1816;6548
500560;201411;5106;16621;4573;15833;859;3165;3125;10940;3984;14105
500568;201411;4146;10673;3034;9027;712;2281;1513;4487;2225;6768
500570;201411;8313;22779;5742;18063;1783;6035;1871;5809;3654;11844
500580;201411;3683;10669;2942;9367;399;1396;1996;6353;2395;7749
500600;201411;3651;10029;2572;8060;662;2252;1031;3213;1693;5465
500620;201411;8449;23575;6130;19507;1331;4731;2993;9554;4324;14285
500625;201411;766;2321;472;1652;105;400;159;540;264;940
500627;201411;465;1349;351;1126;76;250;107;365;183;615
500630;201411;6453;18012;5099;15946;1671;5714;1698;5269;3369;10983
500635;201411;2628;10106;2189;9391;346;1374;1368;6449;1714;7823
500640;201411;1719;4208;1349;3682;131;400;996;2693;1127;3093
500660;201411;18628;54340;14794;47763;4157;15153;5924;18838;10081;33991
500690;201411;3103;8834;2517;8088;899;2949;973;3392;1872;6341
500710;201411;4003;12016;3448;11071;853;2980;1709;5471;2562;8451
500720;201411;6150;16702;4036;12880;1230;4284;1177;3643;2407;7927
500730;201411;1040;2964;784;2448;183;628;320;967;503;1595
500740;201411;3883;10953;2831;9029;582;2138;1345;4109;1927;6247
500750;201411;888;2591;812;2492;178;579;514;1612;692;2191
500755;201411;1300;3840;943;3111;234;868;335;1004;569;1872
500769;201411;5042;13673;3198;9827;697;2378;881;2365;1578;4743
500770;201411;1853;5489;1392;4591;417;1513;471;1556;888;3069
500780;201411;1145;3541;976;3207;298;1075;404;1267;702;2342
500790;201411;9291;26187;7756;23466;1506;5322;4273;12354;5779;17676
500793;201411;2397;6942;1895;6102;374;1369;900;2742;1274;4111
500795;201411;2599;7566;2229;7044;302;829;1639;5517;1941;6346
500797;201411;1026;2746;741;2264;147;476;337;1031;484;1507
500800;201411;2806;7882;2212;7036;859;3085;737;2358;1596;5443
500830;201411;17939;51695;13025;41754;3737;12969;4091;12665;7828;25634
500840;201411;1528;4330;1092;3463;196;668;509;1576;705;2244
510010;201411;1378;4216;1204;3926;384;1287;547;1829;931;3116
510020;201411;3277;9516;2212;7350;595;2108;661;2101;1256;4209
510025;201411;9654;28834;8255;26388;2382;8383;3576;11068;5958;19451
510030;201411;2190;5949;1816;5358;541;1690;803;2323;1344;4013
510035;201411;928;2745;772;2501;152;500;452;1524;604;2024
510040;201411;1815;5063;1424;4478;314;1114;735;2305;1049;3419
510050;201411;1913;5629;1396;4648;379;1382;514;1671;893;3053
510060;201411;1421;4128;1056;3438;256;897;394;1246;650;2143
510080;201411;1151;3586;923;3160;294;1125;246;765;540;1890
510100;201411;694;1853;476;1418;77;249;205;571;282;820
510120;201411;310;646;176;471;20;56;112;299;132;355
510125;201411;3267;8658;2557;7430;506;1790;1210;3302;1716;5092
510130;201411;2200;6059;1853;5501;537;1663;784;2367;1321;4030
510140;201411;3077;9894;2460;8900;1008;4022;620;2062;1628;6084
510160;201411;1366;4591;1267;4460;122;487;1014;3566;1136;4053
510170;201411;6199;19034;5195;17194;1161;4257;2555;8198;3716;12455
510180;201411;12252;32981;8872;27468;2693;8753;3168;10728;5861;19481
510185;201411;1535;4478;1269;4127;214;664;835;2984;1049;3648
510190;201411;2139;6606;1514;5588;410;1673;598;2294;1008;3967
510250;201411;14762;45883;12670;42861;3787;13699;6014;20864;9801;34563
510260;201411;2597;10073;2320;9457;738;3180;973;4247;1711;7427
510263;201411;4640;12837;3418;10771;985;3357;1132;3439;2117;6796
510267;201411;5578;16165;4022;12801;975;3355;1332;4066;2307;7421
510268;201411;925;2721;793;2529;209;712;414;1327;623;2039
510269;201411;984;3017;775;2628;237;848;320;1102;557;1950
510270;201411;2639;8303;2352;7785;423;1471;1323;4502;1746;5973
510279;201411;2139;6758;1896;6303;618;2255;678;2076;1296;4331
510285;201411;1427;4265;1119;3696;297;1080;424;1325;721;2405
510300;201411;3419;10319;2954;9648;342;1235;2241;7365;2583;8600
510305;201411;1675;5299;1352;4666;413;1533;394;1338;807;2871
510310;201411;1120;3257;890;2875;307;1068;304;960;611;2028
510320;201411;3804;11168;2904;9386;877;3255;619;1789;1496;5044
510325;201411;5639;17913;4816;16749;962;3456;3312;11805;4274;15261
510330;201411;2920;9524;2478;8692;660;2557;972;3402;1632;5959
510335;201411;4830;14925;4094;13942;714;2395;2814;10089;3528;12484
510336;201411;626;1919;499;1660;124;453;234;759;358;1212
510337;201411;2316;7636;1963;6948;802;2860;571;2206;1373;5066
510340;201411;68474;198961;53584;175203;20854;74315;12225;41659;33079;115974
510343;201411;1173;3495;1045;3324;134;424;818;2669;952;3093
510345;201411;1724;5127;1418;4562;358;1248;519;1578;877;2826
510350;201411;3745;10578;2972;9496;797;2715;1442;4748;2239;7463
510360;201411;2001;5160;1406;4417;252;873;936;2877;1188;3750
510370;201411;1012;3587;907;3418;216;853;539;2072;755;2925
510380;201411;519;1635;381;1355;151;596;68;221;219;817
510385;201411;1048;3838;790;3206;149;627;371;1605;520;2232
510390;201411;1220;3725;1126;3617;298;834;687;2425;985;3259
510395;201411;924;2303;686;1990;126;385;368;1153;494;1538
510410;201411;4442;14488;4100;13819;1108;3970;2153;7343;3261;11313
510420;201411;2418;6333;1806;5282;266;931;979;2827;1245;3758
510450;201411;601;1656;442;1418;115;424;182;554;297;978
510452;201411;614;2014;436;1586;97;397;188;654;285;1051
510454;201411;922;2939;796;2734;151;537;505;1796;656;2333
510455;201411;1011;3104;758;2593;191;752;264;864;455;1616
510460;201411;2289;6331;1866;5717;284;1036;1217;3621;1501;4657
510480;201411;4515;12191;3263;9823;886;2814;870;2464;1756;5278
510490;201411;1515;4956;1354;4711;298;1202;815;2749;1113;3951
510500;201411;1569;4711;1077;3727;283;1128;466;1552;749;2680
510510;201411;3222;11365;2838;10702;1044;4213;1107;4165;2151;8378
510515;201411;6098;18933;4721;15831;1140;4270;1282;4055;2422;8325
510517;201411;1935;5736;1655;5287;529;1729;781;2587;1310;4316
510520;201411;2328;5826;1745;5018;132;448;1231;3591;1363;4039
510523;201411;1118;3378;954;3096;191;660;583;1910;774;2570
510525;201411;8274;21559;5533;17182;1359;4554;2128;6538;3487;11092
510530;201411;585;1655;499;1526;93;350;283;839;376;1189
510550;201411;2871;9423;2404;8583;721;2680;992;3605;1713;6285
510558;201411;2309;6518;1813;5799;486;1688;856;2758;1342;4446
510560;201411;1757;5668;1233;4719;401;1650;332;1303;733;2953
510562;201411;5493;16593;4655;14951;1548;5451;1558;5055;3106;10506
510590;201411;3229;8664;2586;7831;684;2137;1292;4052;1976;6189
510600;201411;1511;3925;987;3045;186;644;428;1210;614;1854
510610;201411;2939;8607;2565;8090;246;891;2022;6376;2268;7267
510615;201411;2237;6988;1902;6444;575;2094;893;3059;1468;5153
510617;201411;666;1984;558;1794;71;229;419;1395;490;1624
510618;201411;1464;4255;1036;3416;238;921;475;1494;713;2415
510619;201411;807;2217;506;1645;94;345;124;375;218;720
510620;201411;1423;3624;821;2689;255;972;193;572;448;1544
510621;201411;1048;3656;923;3391;276;1106;316;1100;592;2206
510622;201411;3860;11906;2638;9133;767;2884;421;1227;1188;4111
510623;201411;3933;11319;3225;10097;981;3270;1367;4217;2348;7487
510624;201411;1396;4252;1018;3504;244;940;365;1149;609;2089
510625;201411;2295;6766;1837;5944;553;1974;471;1448;1024;3422
510626;201411;1410;4292;1086;3797;351;1366;499;1752;850;3118
510627;201411;809;2350;555;1819;158;572;165;532;323;1104
510628;201411;1675;4230;1242;3642;142;458;901;2629;1043;3087
510629;201411;1819;5925;1506;5222;456;1754;520;1728;976;3482
510630;201411;2607;8778;2088;7752;639;2669;525;1950;1164;4619
510631;201411;414;1189;371;1121;64;193;255;773;319;966
510637;201411;2956;8687;2569;8031;716;2413;1294;3993;2010;6406
510642;201411;5004;16294;4258;15272;1283;4918;2080;7772;3363;12690
510645;201411;938;2186;631;1772;204;584;227;681;431;1265
510650;201411;6162;20896;5684;20305;1227;4555;3689;13777;4916;18332
510665;201411;1347;3693;918;2899;287;961;289;872;576;1833
510670;201411;403;929;219;664;40;148;92;261;132;409
510675;201411;6993;22375;5677;19759;1876;7324;1457;4813;3333;12137
510677;201411;2592;6580;1917;5701;295;883;1355;4204;1650;5087
510680;201411;848;2637;697;2348;164;608;263;823;427;1431
510682;201411;2489;7756;1956;6752;543;2058;580;1945;1123;4003
510685;201411;1011;2710;858;2507;104;342;619;1789;723;2131
510700;201411;4280;11499;3068;9679;673;2279;1734;5560;2407;7839
510704;201411;9310;25636;7648;22891;1831;6148;3992;11644;5823;17792
510706;201411;1986;6104;1487;5293;408;1487;732;2677;1140;4164
510710;201411;3701;10469;2747;8515;793;2636;807;2250;1600;4886
510715;201411;697;1780;453;1361;112;371;193;532;305;903
510718;201411;2021;5644;1604;5155;659;2173;611;2070;1270;4243
510719;201411;467;1071;284;829;38;153;126;331;164;484
510720;201411;1341;3154;1006;2765;125;350;741;2079;866;2429
510724;201411;859;2630;721;2368;172;632;374;1167;546;1799
510726;201411;684;1856;552;1634;143;438;209;591;352;1029
510729;201411;802;2106;556;1694;142;474;244;747;386;1221
510730;201411;2506;7772;2162;7134;568;2105;1023;3228;1591;5333
510735;201411;1149;3873;932;3510;242;985;478;1798;720;2783
510740;201411;1168;2885;866;2454;221;622;473;1393;694;2015
510757;201411;719;2455;632;2286;179;678;313;1130;492;1808
510760;201411;30856;85443;23335;72408;7847;26117;7662;23703;15509;49820
510770;201411;4793;12640;4218;11962;636;1738;2737;8707;3373;10445
510774;201411;453;1245;380;1126;87;303;180;538;267;841
510775;201411;857;2413;681;2138;246;831;243;756;489;1587
510776;201411;474;1346;393;1203;104;359;186;548;290;907
510777;201411;1651;4888;1234;4322;189;740;909;3196;1098;3936
510779;201411;722;2101;530;1746;102;370;231;762;333;1132
510780;201411;4105;12095;3471;11155;838;2790;1785;5998;2623;8788
510785;201411;2009;5904;1592;5192;542;1858;545;1800;1087;3658
510787;201411;2336;7135;1947;6464;726;2586;595;1890;1321;4476
510788;201411;492;1325;377;1147;155;463;114;384;269;847
510790;201411;16317;47827;10917;37295;3106;12064;1449;4782;4555;16846
510792;201411;6809;21133;4826;17114;1177;4801;1143;3721;2320;8522
510794;201411;1407;4334;1117;3870;473;1770;281;885;754;2655
510795;201411;10138;31953;7744;27146;2530;9579;2074;7349;4604;16928
510800;201411;1896;5394;1574;4953;455;1571;751;2247;1206;3818
510805;201411;2092;5823;1691;5244;191;620;1278;4000;1469;4620
510810;201411;720;1759;561;1541;159;466;279;736;438;1202
510820;201411;869;2124;629;1768;149;494;259;661;408;1155
510830;201411;613;2054;530;1916;163;618;267;1039;430;1657
510835;201411;749;2267;538;1843;170;632;182;567;352;1199
510840;201411;54256;136092;43290;122088;10593;31342;22900;66846;33493;98188
510850;201411;1725;5043;1348;4427;524;1933;261;705;785;2638
510860;201411;2697;8817;2053;7400;718;2843;311;1032;1029;3875
510880;201411;855;2851;737;2637;248;942;304;1111;552;2053
510885;201411;599;1694;468;1503;81;305;220;701;301;1006
510890;201411;961;3138;809;2867;283;1141;256;802;539;1943
510895;201411;1196;3775;1028;3446;303;1162;422;1329;725;2491
520005;201411;1351;4370;1242;4195;395;1398;573;1963;968;3361
520010;201411;1952;6729;1720;6253;721;2917;388;1279;1109;4196
520013;201411;4073;11350;3059;9509;778;2555;1291;4037;2069;6592
520015;201411;579;1604;465;1434;120;393;192;612;312;1005
520017;201411;1133;3479;971;3211;265;971;422;1336;687;2307
520020;201411;433;1174;338;1021;84;263;165;514;249;777
520025;201411;25676;81706;24808;80679;2872;9778;20479;66987;23351;76765
520030;201411;4923;15752;4305;14742;1231;4533;1947;6744;3178;11277
520050;201411;378;1092;331;1009;62;207;217;649;279;856
520055;201411;872;2591;724;2304;151;469;372;1230;523;1699
520060;201411;1738;5312;1508;4864;359;1286;628;2041;987;3327
520080;201411;1718;5250;1489;4911;367;1188;817;2843;1184;4031
520082;201411;740;2369;687;2278;146;455;421;1448;567;1903
520085;201411;1045;3280;917;3001;236;818;326;1060;562;1878
520090;201411;1051;2488;794;2143;177;425;429;1244;606;1669
520110;201411;44190;130770;34405;115959;13531;50549;8790;29730;22321;80279
520120;201411;262;684;153;488;39;141;34;113;73;254
520130;201411;3939;11509;3623;11032;777;2512;2219;6776;2996;9288
520140;201411;45377;149805;40077;139400;14736;55487;10741;36972;25477;92459
520145;201411;556;1432;402;1194;99;317;158;467;257;784
520150;201411;681;1837;562;1696;153;497;299;893;452;1390
520160;201411;921;2706;781;2494;254;852;303;980;557;1832
520170;201411;4416;10527;3523;9540;524;1494;2617;7250;3141;8744
520180;201411;1965;5902;1634;5353;415;1547;683;2181;1098;3728
520215;201411;1947;5035;1626;4547;258;748;1019;2894;1277;3642
520235;201411;861;2308;665;2019;193;642;297;871;490;1513
520250;201411;1311;4117;1101;3767;335;1228;515;1792;850;3020
520260;201411;795;2063;555;1612;89;286;262;736;351;1022
520280;201411;586;1718;539;1650;269;873;142;480;411;1353
520310;201411;1133;2806;872;2439;213;573;437;1352;650;1925
520320;201411;1781;5655;1444;4985;176;652;926;3270;1102;3922
520330;201411;2928;9157;2248;7943;742;2889;473;1562;1215;4451
520340;201411;1979;5000;1553;4491;211;534;1179;3574;1390;4108
520350;201411;3345;9844;2832;8857;892;3055;1320;3978;2212;7033
520355;201411;1241;4198;1148;4050;415;1562;487;1695;902;3257
520357;201411;915;2511;769;2290;80;260;537;1586;617;1846
520360;201411;653;1860;578;1728;131;402;287;881;418;1283
520380;201411;1288;3527;890;2765;180;615;417;1289;597;1904
520390;201411;1269;3361;881;2812;299;1101;330;955;629;2056
520393;201411;596;1558;521;1443;85;246;348;963;433;1209
520396;201411;773;2452;664;2238;96;358;451;1542;547;1900
520400;201411;1850;5214;1583;4857;288;953;1016;3129;1304;4082
520410;201411;1669;4369;1287;3857;341;1103;677;2021;1018;3124
520420;201411;347;969;246;769;55;186;75;206;130;392
520425;201411;1521;4229;1381;3986;432;1338;673;1901;1105;3239
520430;201411;2192;5803;1486;4498;342;1162;569;1617;911;2779
520440;201411;3802;10039;2698;8150;948;3131;764;2288;1712;5419
520450;201411;10450;29750;7555;24247;2086;7375;1265;3739;3351;11114
520455;201411;719;2140;581;1910;215;767;176;578;391;1345
520460;201411;939;2692;748;2364;177;630;342;1041;519;1671
520465;201411;866;2376;753;2229;163;559;420;1198;583;1757
520470;201411;1871;6050;1694;5778;372;1264;1100;3927;1472;5191
520480;201411;1035;3011;844;2702;194;653;462;1483;656;2136
520485;201411;1364;4375;1177;4053;379;1398;597;2062;976;3460
520490;201411;4531;13961;3594;12509;1229;4556;1478;5261;2707;9817
520495;201411;1461;3890;1184;3547;98;311;1002;3035;1100;3346
520500;201411;2088;5561;1844;5232;593;1765;828;2516;1421;4281
520505;201411;911;2591;789;2410;190;608;475;1473;665;2081
520510;201411;11606;32835;7936;26635;2524;9185;2159;7335;4683;16520
520520;201411;1115;3230;919;2940;327;1102;369;1198;696;2300
520530;201411;2404;7502;2054;6921;508;1674;1004;3752;1512;5426
520540;201411;3279;9752;2681;8706;846;2891;964;3149;1810;6040
520545;201411;1384;4273;1179;3872;355;1263;370;1183;725;2446
520547;201411;861;2711;709;2452;285;1042;210;687;495;1729
520549;201411;10029;29490;8334;27368;2650;9144;4019;13428;6669;22572
520551;201411;3976;11930;3763;11668;1055;3484;2198;6976;3253;10460
520552;201411;774;2500;741;2456;120;446;517;1698;637;2144
520570;201411;595;1727;450;1499;199;708;115;384;314;1092
520580;201411;2844;7748;2088;6609;760;2628;693;2163;1453;4791
520590;201411;1572;4440;1267;3931;336;1082;415;1234;751;2316
520620;201411;7323;23399;6615;22331;1437;5201;4063;13846;5500;19047
520630;201411;779;2120;615;1878;149;463;298;922;447;1385
520640;201411;2953;8532;2525;7826;816;2643;1043;3322;1859;5965
520650;201411;942;2620;756;2255;243;776;339;1010;582;1786
520660;201411;418;1272;355;1172;126;441;109;357;235;798
520670;201411;865;2657;806;2564;63;170;696;2263;759;2433
520680;201411;661;1927;555;1787;172;590;242;782;414;1372
520690;201411;389;992;266;810;52;138;130;428;182;566
520710;201411;510;1311;328;961;11;36;197;571;208;607
520725;201411;1880;4855;1453;4222;344;1095;801;2317;1145;3412
520735;201411;801;2331;604;1951;192;689;196;614;388;1303
520740;201411;1782;5158;1493;4758;391;1334;719;2266;1110;3600
520750;201411;762;2004;570;1736;145;472;307;966;452;1438
520753;201411;1343;3851;1256;3718;172;464;929;2896;1101;3360
520760;201411;1198;3301;1035;3090;272;844;622;1891;894;2735
520780;201411;2138;5247;1777;4763;221;542;1341;3683;1562;4225
520790;201411;2837;7684;2397;7062;363;1034;1688;5185;2051;6219
520800;201411;18369;53508;16206;50905;3768;11529;9766;33193;13534;44722
520810;201411;987;2678;877;2542;149;429;647;1952;796;2381
520815;201411;528;1728;396;1451;188;790;26;68;214;858
520830;201411;1747;4458;1366;4059;54;123;1234;3763;1288;3886
520840;201411;1852;6121;1606;5641;546;2047;504;1801;1050;3848
520850;201411;840;2468;648;2183;199;717;277;909;476;1626
520860;201411;7436;21020;5471;18297;1613;5846;2367;8119;3980;13965
520870;201411;113191;309321;76856;244910;23111;80866;20600;63215;43711;144081
520880;201411;7183;20406;5089;17077;1552;5848;817;2622;2369;8470
520890;201411;4149;11887;3494;10779;756;2464;1807;5602;2563;8066
520910;201411;3607;10807;2685;8916;866;3111;575;1828;1441;4939
520915;201411;947;2730;705;2259;155;530;290;896;445;1426
520920;201411;3570;9471;2451;7670;639;2154;769;2494;1408;4648
520929;201411;488;1394;422;1304;128;394;207;657;335;1051
520940;201411;1105;3216;935;2965;111;393;670;2112;781;2505
520945;201411;714;1754;588;1557;178;440;286;776;464;1216
520960;201411;919;2670;745;2388;137;446;416;1369;553;1815
520970;201411;3177;9416;2602;8360;608;2125;1042;3276;1650;5401
520980;201411;1021;2803;924;2664;274;890;519;1434;793;2324
520990;201411;2898;9608;2750;9390;539;1923;1790;6294;2329;8217
520993;201411;1223;3329;982;2933;131;434;636;1891;767;2325
520995;201411;2713;7449;2432;7076;373;1106;1743;5122;2116;6228
521000;201411;8294;24905;6991;22686;1826;6576;3112;9953;4938;16529
521010;201411;4107;12649;3429;11354;969;3413;1330;4469;2299;7882
521015;201411;740;2050;618;1856;144;420;349;1088;493;1508
521020;201411;3894;11098;2739;8707;848;2922;501;1382;1349;4304
521030;201411;828;2175;695;1971;168;500;372;1062;540;1562
521040;201411;6033;17171;5385;16185;1872;5670;2601;8286;4473;13956
521056;201411;1020;3108;853;2836;296;1028;357;1240;653;2268
521060;201411;1149;3234;999;2991;277;784;432;1345;709;2129
521080;201411;1292;3173;824;2397;173;601;315;770;488;1371
521090;201411;3377;9835;2830;9090;988;3345;1112;3692;2100;7037
521100;201411;1531;3933;1367;3746;260;698;942;2677;1202;3375
521120;201411;5068;14338;4445;13390;1206;3695;2284;7079;3490;10774
521130;201411;1194;3344;933;2851;191;685;488;1467;679;2152
521140;201411;1022;3305;885;3011;304;1104;241;811;545;1915
521150;201411;13539;35365;8614;25662;3112;9970;2338;6822;5450;16792
521160;201411;881;2146;543;1524;107;333;263;699;370;1032
521170;201411;1427;3440;1166;3083;313;776;668;1803;981;2579
521180;201411;6755;22541;6102;21313;2279;8482;1888;6562;4167;15044
521190;201411;9708;28509;6900;23432;2236;8115;2036;6884;4272;14999
521200;201411;885;2340;793;2208;124;369;526;1460;650;1829
521205;201411;584;1735;460;1507;59;221;268;881;327;1102
521210;201411;945;2690;670;2141;242;890;244;682;486;1572
521220;201411;4029;11267;3304;10271;1078;3578;1378;4274;2456;7852
521225;201411;416;1036;326;925;49;146;214;632;263;778
521230;201411;1399;4415;1287;4176;450;1546;613;1941;1063;3487
521250;201411;28658;93411;26356;89844;10524;38059;9750;34059;20274;72118
521260;201411;829;2023;660;1727;113;368;384;943;497;1311
521270;201411;1888;5848;1726;5595;171;442;1333;4557;1504;4999
521280;201411;1913;5919;1601;5331;500;1801;593;1952;1093;3753
521290;201411;547;1569;401;1329;122;473;144;455;266;928
521295;201411;1194;3251;1072;3086;150;427;862;2516;1012;2943
521300;201411;1884;5528;1736;5298;371;1111;1091;3448;1462;4559
521305;201411;865;2348;713;2126;145;405;445;1402;590;1807
521308;201411;5352;15734;4112;13490;963;3359;1986;6496;2949;9855
521310;201411;8053;24306;6212;20733;2022;7172;1569;5012;3591;12184
521340;201411;272;814;247;777;42;152;157;477;199;629
521350;201411;2259;5841;1854;5286;257;736;1236;3752;1493;4488
521370;201411;1034;3315;917;3092;325;1180;306;985;631;2165
521375;201411;1432;4185;1219;3799;322;1095;604;1814;926;2909
521377;201411;1118;3060;1063;2995;110;258;898;2625;1008;2883
521380;201411;4810;13606;3449;11027;724;2531;713;2343;1437;4874
521385;201411;625;1741;553;1644;165;518;273;804;438;1322
521390;201411;1126;2950;831;2535;244;850;289;849;533;1699
521400;201411;2453;6623;2088;6193;336;1105;1549;4569;1885;5674
521405;201411;1450;4166;1168;3652;390;1335;505;1576;895;2911
521410;201411;843;2633;764;2500;294;934;318;1107;612;2041
521440;201411;1536;4242;1491;4188;126;325;1300;3745;1426;4070
521450;201411;5213;15886;4338;14269;1346;4728;1310;4226;2656;8954
521460;201411;7583;23005;6806;21748;1778;6167;3544;11185;5322;17352
521470;201411;765;2167;570;1787;159;566;110;322;269;888
521480;201411;521;1518;385;1270;118;396;123;403;241;799
521483;201411;3210;8463;2562;7353;754;2298;977;2699;1731;4997
521486;201411;1796;4820;1586;4493;262;814;1132;3168;1394;3982
521487;201411;633;1632;448;1341;90;252;207;665;297;917
521490;201411;871;2477;686;2206;86;343;488;1559;574;1902
521500;201411;1432;4531;1140;3903;233;907;486;1522;719;2429
521520;201411;927;2202;737;1930;220;536;347;974;567;1510
521523;201411;11680;43561;10868;42111;4052;16866;2026;8593;6078;25459
521525;201411;1156;2999;1011;2802;141;445;701;1887;842;2332
521530;201411;2138;6368;1445;4941;516;1860;291;943;807;2803
521540;201411;1002;2729;685;2169;179;677;218;638;397;1315
521550;201411;1013;2606;893;2419;249;727;465;1214;714;1941
521560;201411;5055;15508;4042;14128;1594;6032;1280;4462;2874;10494
521565;201411;708;1841;603;1709;106;281;415;1216;521;1497
521570;201411;4918;13770;3458;10860;1091;3585;1138;3621;2229;7206
521580;201411;696;1653;486;1363;171;519;158;443;329;962
521590;201411;767;2163;625;1930;227;730;133;433;360;1163
521600;201411;639;1664;457;1358;125;397;153;404;278;801
521630;201411;1872;4917;1481;4340;540;1818;274;655;814;2473
521640;201411;2162;5835;1784;5289;610;2020;650;1956;1260;3976
521645;201411;678;2028;552;1738;99;345;270;789;369;1134
521680;201411;1510;4821;1269;4313;678;2452;212;682;890;3134
521690;201411;600;1770;538;1653;130;464;263;752;393;1216
521710;201411;2428;7583;2089;6872;479;1660;1004;3304;1483;4964
521720;201411;2244;6445;1980;6074;491;1507;1232;3843;1723;5350
521730;201411;4084;13511;3682;12722;1544;5876;1027;3274;2571;9150
521740;201411;3886;10599;3059;9531;1228;3972;1301;4271;2529;8243
521760;201411;12763;43270;11712;41518;2556;9994;6695;23977;9251;33971
521770;201411;2897;8709;2442;7814;1006;3419;723;2212;1729;5631
521800;201411;9214;26842;7708;24506;2567;8663;3190;10466;5757;19129
521805;201411;1004;2314;775;1973;214;481;426;1208;640;1689
521810;201411;848;2433;717;2228;175;594;372;1134;547;1728
521830;201411;5551;18557;5155;17944;1110;4162;3287;11462;4397;15624
521839;201411;745;2123;572;1785;129;461;212;622;341;1083
521850;201411;6327;17467;5139;15339;1177;3630;2171;6278;3348;9908
521860;201411;1951;5741;1637;5145;418;1444;616;1870;1034;3314
521870;201411;565;1980;516;1849;172;673;147;488;319;1161
521878;201411;733;2227;539;1800;148;557;223;707;371;1264
521880;201411;26956;71076;18294;56694;6073;19985;5677;17868;11750;37853
521890;201411;3849;11843;3134;10402;1195;4262;779;2536;1974;6798
521900;201411;1708;4563;1373;4106;362;1161;556;1571;918;2732
521910;201411;1258;3476;1088;3275;263;822;620;1953;883;2775
521920;201411;414;1252;365;1169;121;423;145;433;266;856
521925;201411;683;2078;596;1907;126;451;258;757;384;1208
521930;201411;4076;13159;3652;12333;1267;4578;1064;3589;2331;8167
521935;201411;695;2059;638;1950;184;580;327;977;511;1557
521940;201411;1204;3291;986;2923;319;975;390;1167;709;2142
521945;201411;714;2385;661;2316;131;424;457;1715;588;2139
521950;201411;611;1781;491;1583;128;450;228;741;356;1191
521960;201411;939;2746;786;2480;193;670;364;1111;557;1781
521970;201411;2524;7238;2277;6913;349;1069;1659;5166;2008;6235
521971;201411;1110;2987;825;2447;183;584;296;841;479;1425
521973;201411;950;3081;820;2814;250;900;260;871;510;1771
521975;201411;14661;40838;13738;39708;2428;7407;9568;27836;11996;35243
521980;201411;1973;5906;1801;5700;296;845;1373;4567;1669;5412
521990;201411;1146;3448;1002;3225;153;545;649;2089;802;2634
522000;201411;2217;6499;1927;6106;396;1322;1155;3790;1551;5112
522005;201411;405;1026;297;862;82;238;138;409;220;647
522010;201411;3073;9060;2558;8176;958;3187;608;1939;1566;5126
522015;201411;1050;3060;854;2758;233;794;414;1358;647;2152
522020;201411;5252;14095;4473;13045;982;3072;2722;7951;3704;11023
522026;201411;755;2159;562;1943;206;783;191;668;397;1451
522028;201411;552;1633;452;1409;89;288;281;864;370;1152
522040;201411;3272;8346;2466;7323;761;2366;1198;3600;1959;5966
522045;201411;14505;47271;12035;42102;3949;15244;2741;9326;6690;24570
522050;201411;1118;3231;882;2808;278;966;336;996;614;1962
522060;201411;2826;8581;2231;7643;643;2430;1071;3594;1714;6024
522068;201411;1621;5228;1513;5108;131;349;1259;4497;1390;4846
522070;201411;855;2566;764;2424;103;393;519;1639;622;2032
522100;201411;806;2258;715;2121;268;887;324;892;592;1779
522108;201411;974;2882;848;2690;88;295;631;2036;719;2331
522119;201411;1417;4272;1170;3935;241;836;665;2322;906;3158
522130;201411;521;1467;445;1379;135;437;234;735;369;1172
522140;201411;19058;53626;16173;48957;5092;16553;6310;18660;11402;35213
522145;201411;954;2667;878;2545;420;1295;280;795;700;2090
522150;201411;1279;3334;1054;3015;372;1128;382;1129;754;2257
522155;201411;894;2566;782;2406;175;524;478;1535;653;2059
522157;201411;729;2097;626;1940;71;241;488;1519;559;1760
522160;201411;6421;18044;4528;14694;1669;6043;673;2034;2342;8077
522170;201411;3180;8868;2623;8020;815;2518;999;3171;1814;5689
522180;201411;477;1348;356;1158;145;512;124;413;269;925
522185;201411;15934;48289;13967;45636;3263;11338;7967;26416;11230;37754
522190;201411;1030;2627;810;2271;143;410;451;1292;594;1702
522200;201411;1714;5666;1536;5296;534;1983;456;1508;990;3491
522205;201411;1348;3951;1121;3568;305;1037;521;1651;826;2688
522220;201411;1417;3866;1139;3518;282;888;567;1940;849;2828
522230;201411;1244;3695;1095;3454;160;565;740;2345;900;2910
530010;201411;264242;850555;235354;793888;72440;266341;85181;286044;157621;552385
110001;201410;4685;15206;4041;14174;1070;3884;2273;8105;3343;11989
110002;201410;14517;45394;12235;41288;3781;13801;5227;17604;9008;31405
110003;201410;1000;3231;912;3069;261;915;346;1141;607;2056
110004;201410;10358;33338;8636;29704;2933;10922;2363;8056;5296;18978
110005;201410;2437;8078;2254;7718;862;3038;911;3149;1773;6187
110006;201410;3455;9259;2169;7441;740;2674;649;2103;1389;4777
110007;201410;1609;4932;1480;4752;329;1159;786;2752;1115;3911
110008;201410;2626;8896;2460;8653;459;1516;1799;6636;2258;8152
110009;201410;5560;16012;4257;14026;1215;4372;1848;5926;3063;10298
110010;201410;8760;25135;7636;23723;1647;4751;4750;15995;6397;20746
110011;201410;11151;34051;9196;30660;3293;11523;3551;11845;6844;23368
110012;201410;17333;53375;14960;48819;5006;17088;5731;18772;10737;35860
110013;201410;5656;17646;4594;16003;1525;5575;1891;6712;3416;12287
110014;201410;4606;13431;3841;12308;789;2627;2389;7786;3178;10413
110015;201410;5690;17653;4402;15343;1518;5738;1489;5190;3007;10928
110018;201410;5435;15817;4374;14420;1359;5006;2016;6407;3375;11413
110020;201410;62159;178533;50242;162800;10997;37035;28923;96193;39920;133228
110025;201410;4724;13674;3874;12157;657;2191;2661;8338;3318;10529
110026;201410;870;2503;734;2337;201;650;437;1417;638;2067
110028;201410;8115;23677;5945;19892;1783;6535;1369;4440;3152;10975
110029;201410;1742;5082;1391;4483;436;1461;639;2091;1075;3552
110030;201410;12342;34901;9853;31530;2708;9316;4897;16102;7605;25418
110032;201410;4338;13957;3840;12844;1210;4210;1480;4909;2690;9119
110033;201410;5795;18516;5368;17854;1659;5360;2742;9775;4401;15135
110034;201410;4040;10513;3363;9688;588;1616;2514;7388;3102;9004
110037;201410;2188;7355;1886;6788;477;1767;1034;3769;1511;5536
110040;201410;3701;11874;3365;11267;1030;3738;1617;5330;2647;9068
110045;201410;5332;17726;4739;17009;1458;5609;2576;9221;4034;14830
110050;201410;1904;6038;1595;5612;517;1836;858;3099;1375;4935
110060;201410;1046;3544;925;3321;288;1115;415;1481;703;2596
110070;201410;2073;7050;1998;6884;415;1508;1309;4514;1724;6022
110080;201410;4013;12288;3757;11988;455;1307;3093;10200;3548;11507
110090;201410;977;2830;768;2500;227;854;348;1036;575;1890
110092;201410;1745;5638;1584;5428;337;1163;978;3526;1315;4689
110094;201410;3496;10744;3180;10291;822;2746;1871;6188;2693;8934
110100;201410;2729;8536;2330;7862;693;2474;1210;4085;1903;6559
110110;201410;1837;5836;1695;5663;726;2496;708;2443;1434;4939
110120;201410;1826;5916;1429;5018;466;1700;422;1491;888;3191
110130;201410;2863;8141;2117;6996;624;2153;923;3052;1547;5205
110140;201410;2722;9152;2456;8695;557;2038;1467;5292;2024;7330
110143;201410;1627;5143;1243;4472;310;1158;644;2312;954;3470
110145;201410;1071;3164;918;2922;189;644;571;1812;760;2456
110146;201410;487;1545;437;1467;96;327;255;876;351;1203
110147;201410;949;2787;729;2413;216;790;275;813;491;1603
110148;201410;1446;4298;1086;3549;327;1140;362;1138;689;2278
110149;201410;3934;11460;3065;10121;863;2910;1718;5822;2581;8732
110150;201410;2989;8658;2454;7873;315;1100;1658;5425;1973;6525
110155;201410;981;3185;918;3039;271;947;491;1604;762;2551
110160;201410;2222;6919;1792;6119;587;2062;822;2811;1409;4873
110170;201410;3267;9333;2488;7972;565;1919;1440;4594;2005;6513
110175;201410;1877;5715;1413;5109;210;821;914;3391;1124;4212
110180;201410;1744;5331;1470;4897;360;1243;862;2897;1222;4140
120001;201410;3072;10716;2930;10471;631;2414;1807;6554;2438;8968
120005;201410;1614;6450;1571;6373;169;632;1243;5245;1412;5877
120010;201410;4742;16605;4500;16189;836;2905;3116;11641;3952;14546
120013;201410;1919;7518;1867;7433;444;1738;1179;4949;1623;6687
120017;201410;2220;7865;2088;7616;581;2129;1011;4040;1592;6169
120020;201410;15003;65263;14574;64406;2441;10261;10566;48941;13007;59202
120025;201410;2898;9981;2814;9850;599;2239;1784;6330;2383;8569
120030;201410;6418;25166;6291;25010;451;1670;5491;22255;5942;23925
120032;201410;1421;6828;1362;6683;206;1166;982;4845;1188;6011
120033;201410;3702;14206;3666;14145;181;698;3329;13024;3510;13722
120034;201410;1922;7862;1866;7771;187;915;1575;6489;1762;7404
120035;201410;2901;13711;2864;13626;235;1092;2450;11955;2685;13047
120038;201410;3219;11705;3090;11437;834;3171;1743;6602;2577;9773
120039;201410;1559;8225;1528;8151;183;1030;1227;6625;1410;7655
120040;201410;48677;173830;44282;164881;12545;49233;21803;83040;34348;132273
120042;201410;2895;12432;2750;12089;407;1933;1982;8829;2389;10762
120043;201410;891;4226;858;4162;68;298;721;3628;789;3926
120045;201410;4699;16083;4633;15984;868;3041;3484;12190;4352;15231
120050;201410;8365;34351;7998;33541;1353;5459;5458;24153;6811;29612
120060;201410;7570;34005;7447;33767;674;3123;6247;28979;6921;32102
120070;201410;2924;10894;2849;10715;555;2003;1907;7475;2462;9478
120080;201410;3872;14558;3711;14292;578;2187;2784;11078;3362;13265
130002;201410;3005;12572;2829;12272;246;1144;2337;10267;2583;11411
130006;201410;1875;7981;1678;7603;284;1422;1143;5220;1427;6642
130008;201410;2076;8437;1985;8272;174;758;1613;6832;1787;7590
130010;201410;2895;9701;2540;9288;202;708;2195;8171;2397;8879
130014;201410;3577;11436;3081;10682;508;1884;2043;7173;2551;9057
130020;201410;2662;9421;2652;9409;32;108;2607;9273;2639;9381
130030;201410;7390;28284;7124;27941;708;2365;5945;24245;6653;26610
130040;201410;3734;11558;3376;11088;279;1029;2874;9476;3153;10505
130050;201410;6168;24506;5474;23413;645;2677;4075;18408;4720;21085
130060;201410;5954;26610;5587;26043;596;2815;4468;21264;5064;24079
130063;201410;3504;15476;3456;15401;285;1207;2984;13628;3269;14835
130068;201410;3136;13176;2875;12664;419;2017;1974;8763;2393;10780
130070;201410;6897;22624;6238;21786;647;2240;4979;17849;5626;20089
130080;201410;5215;23115;4996;22784;938;4415;3372;15932;4310;20347
130083;201410;2174;8580;2052;8388;305;1441;1485;6064;1790;7505
130090;201410;2651;9510;2530;9348;167;692;2212;8208;2379;8900
130100;201410;5660;21174;5433;20865;338;1427;4789;18543;5127;19970
130110;201410;7035;22404;6568;21846;631;1914;5495;18861;6126;20775
130115;201410;4275;15246;4097;15013;101;314;3906;14424;4007;14738
130120;201410;14336;54203;13687;53341;1258;4418;11526;46474;12784;50892
130130;201410;3658;15359;3555;15176;379;1680;2897;12581;3276;14261
130140;201410;6429;24862;6341;24759;156;398;6134;24250;6290;24648
130150;201410;3495;13333;3420;13236;212;913;3035;11798;3247;12711
130160;201410;4048;16683;3953;16557;267;1010;3586;15239;3853;16249
130165;201410;2849;11744;2743;11558;363;1595;2180;9306;2543;10901
130170;201410;9439;33819;8275;32358;1180;4625;6219;25188;7399;29813
130180;201410;3474;11181;3388;11054;133;379;3128;10307;3261;10686
130185;201410;10402;34727;9619;33821;1102;3561;7814;28623;8916;32184
130190;201410;18361;62875;16199;60123;3191;11607;10717;41836;13908;53443
130195;201410;1897;7854;1837;7766;111;470;1627;6980;1738;7450
130200;201410;2021;7289;1869;7041;483;1825;1120;4358;1603;6183
130210;201410;1210;4764;1143;4650;134;582;921;3809;1055;4391
130220;201410;2056;8396;1878;8043;346;1668;1111;4802;1457;6470
130230;201410;3667;16343;3465;16008;412;1838;2629;12740;3041;14578
130240;201410;8611;32733;7948;31756;492;2201;6825;27679;7317;29880
130250;201410;19053;67173;18148;65954;2197;7401;14368;54422;16565;61823
130255;201410;4187;14705;3957;14334;156;480;3600;13320;3756;13800
130260;201410;265787;859698;238877;815882;67775;239364;122233;429316;190008;668680
130270;201410;7601;31113;6855;29944;1034;4461;4977;22721;6011;27182
130280;201410;3359;13195;3280;13082;171;529;2970;12200;3141;12729
130290;201410;11164;39401;10888;39052;221;504;10382;37939;10603;38443
130300;201410;4608;17617;4311;17176;389;1708;3514;14159;3903;15867
130310;201410;5287;19691;4839;19130;469;1814;3951;16030;4420;17844
130320;201410;2997;10421;2726;10054;354;1337;2001;7566;2355;8903
130330;201410;3780;13628;3395;13103;214;939;2901;11326;3115;12265
130340;201410;18913;71211;17995;69923;3663;13386;12093;50055;15756;63441
130350;201410;3344;13479;3206;13313;304;1337;2662;11261;2966;12598
130353;201410;6135;18832;5343;17758;1297;4219;3246;11548;4543;15767
130356;201410;4719;16925;4512;16606;470;1455;3698;14298;4168;15753
130360;201410;3080;8725;2732;8333;45;79;2595;8109;2640;8188
130370;201410;5174;20255;4437;19254;294;1520;3664;16031;3958;17551
130380;201410;7053;29675;6756;29245;511;2290;5780;25391;6291;27681
130390;201410;4939;21873;4610;21282;494;2417;3541;16773;4035;19190
130395;201410;2097;7542;1848;7002;265;1054;1223;4691;1488;5745
130400;201410;2136;7999;2063;7894;160;650;1804;6974;1964;7624
130406;201410;10057;38275;8983;36614;2077;8523;5503;23437;7580;31960
130410;201410;4153;15752;3798;15096;1161;4930;1708;6959;2869;11889
130420;201410;10318;43571;9926;42878;2900;12163;5882;26787;8782;38950
130423;201410;3256;12597;3073;12348;287;1328;2581;10396;2868;11724
130426;201410;2118;9052;2028;8892;341;1448;1458;6695;1799;8143
130430;201410;3719;13045;3514;12759;517;1937;2508;9329;3025;11266
130440;201410;4072;14191;3753;13832;244;760;3337;12665;3581;13425
140002;201410;1694;5357;1582;5213;178;571;1204;4075;1382;4646
140005;201410;3072;8983;2905;8803;112;259;2726;8382;2838;8641
140010;201410;48366;153167;42662;143883;10563;38084;22292;76794;32855;114878
140015;201410;2929;9462;2782;9272;344;932;2205;7702;2549;8634
140017;201410;3346;10353;3054;9987;295;851;2454;8334;2749;9185
140020;201410;4524;15362;4197;14923;401;1316;3439;12574;3840;13890
140023;201410;2189;7401;1967;7042;258;942;1422;5211;1680;6153
140028;201410;2249;6130;2188;6061;81;143;2035;5781;2116;5924
140030;201410;3809;12020;3636;11803;450;1165;3029;10252;3479;11417
140040;201410;1564;7411;1510;7262;140;749;1169;5722;1309;6471
140045;201410;2553;9272;2358;8979;460;1565;1557;6483;2017;8048
140047;201410;5624;15663;5053;14885;1478;4466;2574;8002;4052;12468
140050;201410;1543;4759;1409;4574;218;741;981;3248;1199;3989
140060;201410;1484;4624;1331;4374;276;939;855;2891;1131;3830
140070;201410;1501;7559;1466;7437;85;483;1295;6582;1380;7065
150010;201410;34379;108930;32732;106728;2268;7622;27831;92088;30099;99710
150013;201410;1682;5044;1577;4920;161;468;1277;4070;1438;4538
150020;201410;12347;41406;11989;40894;1030;3484;10271;35523;11301;39007
150030;201410;6751;28891;6549;28575;676;2456;5460;24930;6136;27386
150034;201410;4520;12382;4237;12019;260;665;3802;10934;4062;11599
150040;201410;12931;43282;11274;41240;2333;7922;7570;29813;9903;37735
150050;201410;6187;23592;6020;23294;593;2416;4926;19299;5519;21715
150060;201410;17620;57236;16548;55608;3293;10684;11285;39293;14578;49977
150070;201410;5912;24314;5325;23646;421;1964;4601;20711;5022;22675
150080;201410;66081;178266;57520;167003;8830;24054;40150;120960;48980;145014
150085;201410;5168;18101;4915;17734;586;1838;3978;14937;4564;16775
150090;201410;10242;39470;9664;38670;999;3953;7833;32028;8832;35981
150095;201410;5377;18303;4970;17687;445;1505;4054;14861;4499;16366
150100;201410;3583;13266;3347;12904;272;1255;2729;10465;3001;11720
150110;201410;3305;16029;3293;15998;190;829;3010;14844;3200;15673
150120;201410;6116;23762;5964;23484;795;3075;4691;18785;5486;21860
150125;201410;832;2551;768;2455;154;535;514;1622;668;2157
150130;201410;21790;67560;20430;65601;1951;6152;16365;53644;18316;59796
150140;201410;158398;467217;152297;459434;17510;52128;124419;380645;141929;432773
150145;201410;4938;15486;4571;15023;654;2211;3461;11545;4115;13756
150150;201410;10728;34565;10060;33487;1811;6245;6959;23452;8770;29697
150157;201410;3103;9515;2756;9022;395;1403;2050;6788;2445;8191
150160;201410;3001;9935;2818;9668;679;2290;1739;6209;2418;8499
150170;201410;22492;83209;21291;81509;3838;14673;15355;59710;19193;74383
150172;201410;3146;10956;2816;10434;419;1582;2103;7962;2522;9544
150175;201410;2111;6450;2022;6351;152;391;1745;5732;1897;6123
150178;201410;11011;33822;9309;31765;833;2696;7763;27139;8596;29835
150180;201410;18512;74460;17835;73514;1692;7357;14761;61693;16453;69050
150190;201410;7295;23497;6861;22891;426;978;5952;20712;6378;21690
150195;201410;4948;16838;4603;16263;377;1398;3848;13726;4225;15124
150200;201410;5260;16952;5064;16715;154;462;4710;15762;4864;16224
150210;201410;23217;89344;22635;88490;2111;7693;18971;76388;21082;84081
150215;201410;6512;20991;5787;19853;1556;5616;2924;10216;4480;15832
150220;201410;12814;40744;11600;38808;2652;9085;6484;22202;9136;31287
150230;201410;11342;38242;10192;36595;926;3964;8079;28910;9005;32874
150240;201410;35528;107562;31846;101319;10281;33738;13047;43210;23328;76948
150250;201410;4201;16849;4059;16634;563;2248;3114;13241;3677;15489
150260;201410;2147;8617;2047;8423;417;1764;1274;5409;1691;7173
150270;201410;9739;29436;7534;26669;1548;5808;4841;17502;6389;23310
150275;201410;5986;21875;5655;21343;799;3038;4211;16243;5010;19281
150276;201410;2171;6525;1990;6278;383;1297;1461;4606;1844;5903
150277;201410;5078;15870;4424;15065;606;2072;3316;11646;3922;13718
150280;201410;5998;26372;5805;25923;1048;4605;4054;18712;5102;23317
150285;201410;2670;10743;2585;10577;453;1909;1772;7495;2225;9404
150290;201410;9601;29022;9252;28615;817;2103;7871;25323;8688;27426
150293;201410;9272;27185;7517;24641;2419;8264;3137;10942;5556;19206
150295;201410;6866;20994;5788;19714;1122;3625;3936;14329;5058;17954
150300;201410;1845;6467;1773;6380;125;405;1479;5511;1604;5916
150304;201410;4218;13165;3639;12361;573;1948;2543;8921;3116;10869
150307;201410;6798;22870;6316;22176;492;1696;5231;18851;5723;20547
150309;201410;7016;24445;6449;23688;1561;5661;4171;16104;5732;21765
150310;201410;5596;25319;5451;25070;681;3111;4304;20319;4985;23430
150320;201410;9170;23087;8717;22605;586;1303;7704;20449;8290;21752
150330;201410;13872;49011;13064;47791;1580;5584;10192;38451;11772;44035
150340;201410;2421;7990;2251;7736;375;1350;1587;5530;1962;6880
150345;201410;6621;22755;6164;22125;641;2291;5016;18391;5657;20682
150350;201410;7515;24698;7137;24168;1008;3148;5391;18811;6399;21959
150360;201410;22346;69853;19335;65964;3168;10833;13424;47505;16592;58338
150370;201410;10425;38331;9902;37631;1337;4475;7942;31530;9279;36005
150375;201410;2871;12146;2799;12038;324;1211;2328;10450;2652;11661
150380;201410;9867;29343;8737;27803;831;2808;7158;22973;7989;25781
150390;201410;8366;35799;7944;34970;1632;6905;5139;23694;6771;30599
150400;201410;5678;22905;5440;22399;590;2390;4209;17799;4799;20189
150405;201410;8580;26281;7673;25165;1427;4200;5365;18775;6792;22975
150410;201410;1751;6716;1700;6619;288;1201;1123;4445;1411;5646
150420;201410;36853;127983;32322;120435;9169;35931;15404;59990;24573;95921
150430;201410;6709;24252;6419;23759;782;3022;4875;18352;5657;21374
150440;201410;5483;19181;5289;18893;987;3398;3766;13888;4753;17286
150442;201410;22033;63937;20041;61246;3637;11358;13182;41489;16819;52847
150445;201410;5346;18658;4902;17965;647;2298;3729;14043;4376;16341
150450;201410;4410;21035;4246;20790;399;1942;3542;17739;3941;19681
150460;201410;6976;25475;5861;24287;371;1655;5173;21847;5544;23502
150470;201410;17940;55040;17345;54305;987;2512;15779;50434;16766;52946
150475;201410;1533;5292;1424;5148;184;636;1134;4251;1318;4887
150480;201410;14330;48985;13691;48021;1247;4360;11309;40545;12556;44905
150490;201410;6771;25955;6604;25721;294;1160;6019;23671;6313;24831
150495;201410;4963;18258;4847;18084;204;745;4486;16884;4690;17629
150497;201410;3302;11641;3002;11118;915;3513;1571;5947;2486;9460
150500;201410;3097;8799;2928;8548;426;1247;2176;6377;2602;7624
150503;201410;4192;13125;3622;12402;1318;4584;1811;6496;3129;11080
150506;201410;12625;44501;11616;43054;2428;8343;7900;31043;10328;39386
150510;201410;9990;39188;9283;37924;1483;6141;6472;27478;7955;33619
150520;201410;6712;26144;6621;26017;249;799;6221;24786;6470;25585
150530;201410;12175;42804;11055;41067;1331;4799;8407;32051;9738;36850
150540;201410;4735;14602;4260;13918;347;1193;3531;11549;3878;12742
150543;201410;5517;17316;4986;16551;1111;3814;3241;10982;4352;14796
150548;201410;8824;28320;8272;27609;445;1315;7464;25346;7909;26661
150549;201410;2284;7213;2145;7051;105;235;1960;6628;2065;6863
150550;201410;21387;68452;18989;64313;5746;20036;8809;30554;14555;50590
150553;201410;20316;72296;17551;66181;6882;27736;4485;16940;11367;44676
150555;201410;1803;5534;1584;5225;202;710;1173;3906;1375;4616
150560;201410;2026;6533;1927;6319;271;912;1375;4508;1646;5420
150563;201410;2872;9502;2663;9127;619;2270;1549;5304;2168;7574
150565;201410;3608;12627;3313;12162;247;1058;2655;9866;2902;10924
150570;201410;5648;21079;5543;20897;429;1612;4668;18027;5097;19639
150580;201410;10108;41493;9900;41234;800;2782;8639;37265;9439;40047
150590;201410;5686;22935;5541;22761;118;366;5295;22015;5413;22381
150600;201410;8089;30954;7843;30583;545;1968;6870;27424;7415;29392
150610;201410;2413;8317;2211;7900;276;1099;1547;5465;1823;6564
150611;201410;2743;9794;2578;9452;262;1039;1967;7250;2229;8289
150613;201410;12468;38213;10719;35691;3599;12294;5012;17444;8611;29738
150616;201410;3163;9430;2474;8470;645;2392;1188;3967;1833;6359
150618;201410;7407;25735;7063;25096;2237;8142;3565;13087;5802;21229
150619;201410;5417;18537;5054;18007;665;2584;3708;13285;4373;15869
150620;201410;6424;23186;5822;22419;808;3066;4536;18088;5344;21154
150630;201410;5672;17380;5408;17057;401;1235;4652;14972;5053;16207
150635;201410;4607;15109;4324;14568;911;3099;2619;9105;3530;12204
150640;201410;1700;5297;1657;5243;204;607;1340;4434;1544;5041
150650;201410;12597;38880;11364;36661;3131;10389;5602;18531;8733;28920
150655;201410;5441;18064;4998;17397;627;2284;3829;13498;4456;15782
150658;201410;4406;13972;4018;13407;716;2765;2702;9004;3418;11769
150660;201410;5926;18654;5384;17913;1347;4370;3205;11134;4552;15504
150670;201410;6770;19238;5735;17945;1582;5015;3365;11042;4947;16057
150680;201410;54875;208340;50660;200551;16686;66948;23123;97680;39809;164628
150690;201410;1963;6232;1789;5938;342;1078;1148;3964;1490;5042
150700;201410;6097;18882;5621;18258;1108;3610;3775;12569;4883;16179
150710;201410;4347;14398;3904;13697;455;1604;2997;10701;3452;12305
150715;201410;5133;16583;4554;15708;602;2184;3456;12060;4058;14244
150720;201410;6690;27169;6300;26468;995;4154;4538;19832;5533;23986
150730;201410;9627;33097;9025;32254;1077;3629;7338;26915;8415;30544
150740;201410;3765;12029;3420;11415;507;1790;2260;7629;2767;9419
150745;201410;5923;18675;5446;18023;1168;4012;3624;12110;4792;16122
150746;201410;1447;4735;1374;4604;206;745;944;3179;1150;3924
150747;201410;5097;16502;4596;15836;516;1592;3495;12701;4011;14293
150750;201410;3080;10373;2958;10218;162;486;2693;9450;2855;9936
150760;201410;11596;37649;10925;36760;2495;8294;6983;24403;9478;32697
150770;201410;5783;21961;5532;21590;691;2556;4361;17935;5052;20491
150775;201410;1210;3765;1075;3521;227;889;626;1979;853;2868
150780;201410;3260;10705;3221;10662;84;200;3060;10272;3144;10472
150790;201410;5327;17022;4942;16535;507;1524;4114;14198;4621;15722
150795;201410;15909;48948;14222;46517;2773;8809;9386;31937;12159;40746
150796;201410;2958;8980;2767;8757;352;1080;2178;7114;2530;8194
150797;201410;3843;12917;3613;12571;193;718;3146;11046;3339;11764
150800;201410;14406;48221;13104;46613;2724;8995;9143;34233;11867;43228
150803;201410;6986;25211;6644;24721;875;3306;4922;18811;5797;22117
150805;201410;2843;9868;2622;9534;376;1309;1943;7277;2319;8586
150808;201410;6056;20669;5175;19006;2220;8678;1170;4375;3390;13053
150810;201410;19982;62397;16739;58438;2462;8121;12041;44424;14503;52545
150812;201410;5422;16878;4971;16189;508;2080;3729;11734;4237;13814
150815;201410;9124;29235;8183;28062;1031;3401;6511;23055;7542;26456
150820;201410;11068;31867;10015;30710;651;1328;8828;28092;9479;29420
150830;201410;12838;49053;11905;47475;685;2948;10035;41068;10720;44016
150835;201410;2135;7772;1980;7414;545;2156;929;3504;1474;5660
150840;201410;8081;23234;6446;20916;1542;5478;3481;11147;5023;16625
160005;201410;771;2849;722;2764;99;454;505;1895;604;2349
160010;201410;1553;5200;1542;5188;121;304;1378;4780;1499;5084
160015;201410;1824;6693;1781;6619;186;601;1455;5645;1641;6246
160020;201410;2326;7689;2165;7464;299;1051;1594;5657;1893;6708
160021;201410;944;4043;922;4004;181;856;644;2836;825;3692
160023;201410;1063;4203;1046;4176;72;255;931;3788;1003;4043
160025;201410;1523;4210;1490;4175;18;53;1458;4087;1476;4140
160027;201410;8477;25748;7882;25090;2768;8388;4195;14386;6963;22774
160030;201410;45682;164890;41714;156968;9637;36217;25725;100200;35362;136417
160040;201410;4303;16742;4216;16612;152;684;3939;15531;4091;16215
160050;201410;3700;13753;3347;13233;1394;5442;1496;6300;2890;11742
160053;201410;2808;10880;2746;10787;609;2422;1869;7522;2478;9944
160055;201410;762;2926;749;2912;115;482;570;2234;685;2716
160060;201410;17834;60223;16849;59115;3745;12455;11624;42605;15369;55060
160070;201410;2418;9542;2355;9441;135;531;2103;8568;2238;9099
160080;201410;2768;10171;2752;10145;89;277;2621;9762;2710;10039
170025;201410;574;1939;518;1852;170;625;254;949;424;1574
170030;201410;1194;3932;1072;3706;325;1131;486;1726;811;2857
170035;201410;1580;4684;1303;4165;441;1489;446;1468;887;2957
170040;201410;1903;6278;1668;5929;292;1192;1130;4026;1422;5218
170070;201410;2107;5673;1699;5153;469;1531;885;2723;1354;4254
170100;201410;2584;7349;2275;6834;265;867;1765;5324;2030;6191
170105;201410;774;2454;627;2147;131;528;319;1043;450;1571
170110;201410;1193;3714;1039;3455;247;889;542;1783;789;2672
170130;201410;1464;4558;1266;4267;288;990;723;2539;1011;3529
170190;201410;1700;4889;1337;4325;548;1714;344;1274;892;2988
170200;201410;1665;4962;1220;4118;355;1311;394;1299;749;2610
170210;201410;31557;95063;26547;86392;8824;30669;9183;31095;18007;61764
170215;201410;1201;3785;1065;3577;127;455;810;2748;937;3203
170220;201410;6668;22191;6058;21132;1240;4616;3573;12701;4813;17317
170230;201410;1544;5025;1326;4617;320;1284;645;2157;965;3441
170240;201410;3050;8700;2428;7848;353;1281;1663;5392;2016;6673
170255;201410;3733;11845;3096;10797;920;3293;1380;5070;2300;8363
170270;201410;1068;2736;762;2308;111;381;506;1503;617;1884
170290;201410;3046;9081;2693;8654;196;514;2304;7713;2500;8227
170300;201410;2124;6573;1780;5999;292;1054;1141;3884;1433;4938
170305;201410;804;2485;662;2221;117;420;399;1361;516;1781
170307;201410;1118;3922;956;3607;205;831;503;1977;708;2808
170310;201410;1744;4803;1383;4221;327;976;716;2327;1043;3303
170320;201410;1107;3228;833;2727;209;728;386;1307;595;2035
170330;201410;866;2630;736;2466;130;473;508;1673;638;2146
170360;201410;458;1559;412;1481;107;414;176;608;283;1022
170370;201410;1462;4223;1166;3749;282;983;549;1771;831;2754
170380;201410;2109;6627;1705;6010;344;1389;927;3228;1271;4617
170382;201410;558;1864;478;1732;122;506;267;944;389;1450
170384;201410;1632;6670;1527;6481;392;1749;904;3908;1296;5657
170386;201410;944;2814;815;2632;216;771;422;1374;638;2145
170388;201410;655;1966;557;1798;116;455;235;734;351;1189
170389;201410;953;3153;872;3033;117;486;620;2122;737;2608
170390;201410;1376;4024;1175;3771;162;557;863;2840;1025;3397
170410;201410;506;1672;457;1574;62;265;304;1022;366;1287
170460;201410;537;1476;388;1218;107;366;132;409;239;775
170510;201410;819;2753;661;2475;110;483;349;1293;459;1776
170550;201410;6213;18618;4840;16123;1800;6570;1111;3687;2911;10257
170555;201410;1407;4109;1125;3673;273;946;597;1969;870;2915
170560;201410;1009;3402;808;3140;174;715;486;1958;660;2673
170600;201410;1385;3898;1202;3662;241;709;803;2547;1044;3256
170610;201410;1663;5011;1293;4426;159;620;810;2824;969;3444
170625;201410;437;1370;337;1169;66;247;103;367;169;614
170650;201410;1287;4118;1123;3829;281;1028;532;1859;813;2887
170700;201410;4136;13604;3449;12448;804;3182;1704;6378;2508;9560
170710;201410;1909;5616;1543;4987;257;881;951;3117;1208;3998
170720;201410;1893;5059;1604;4617;305;837;1113;3312;1418;4149
170730;201410;1126;3202;927;2911;264;916;443;1402;707;2318
170740;201410;2292;8090;2025;7615;306;1258;1400;5312;1706;6570
170755;201410;906;2825;759;2504;194;686;290;929;484;1615
170765;201410;1621;4351;1298;3831;350;1094;576;1735;926;2829
170770;201410;1863;6347;1723;6085;345;1280;1065;3827;1410;5107
170820;201410;4242;13554;3833;12907;1056;3729;1756;6072;2812;9801
170825;201410;837;2488;640;2105;147;537;266;854;413;1391
170830;201410;1428;4222;1272;3985;40;82;1151;3661;1191;3743
170900;201410;2959;10217;2800;9925;332;1177;2124;7769;2456;8946
170930;201410;4417;13356;3598;12083;1272;4521;1248;4170;2520;8691
170950;201410;13550;39098;9991;32833;3570;13129;2300;7299;5870;20428
170980;201410;522;1535;402;1330;95;363;210;660;305;1023
171050;201410;1404;4902;1304;4709;79;336;1113;4015;1192;4351
171070;201410;1746;5404;1607;5213;338;1116;1003;3354;1341;4470
171090;201410;994;2837;836;2596;94;307;612;1900;706;2207
171110;201410;672;1950;525;1707;133;470;289;926;422;1396
171150;201410;886;2587;644;2134;131;483;366;1219;497;1702
171180;201410;664;2042;489;1681;131;470;207;757;338;1227
171190;201410;1928;6947;1660;6398;399;1603;801;3233;1200;4836
171195;201410;891;3127;788;2933;140;550;424;1634;564;2184
171200;201410;709;2264;581;2022;136;538;282;923;418;1461
171215;201410;491;1445;376;1233;82;300;159;531;241;831
171240;201410;804;2745;744;2633;87;342;542;1953;629;2295
171245;201410;676;2233;561;1959;133;532;223;737;356;1269
171250;201410;1179;3403;976;3066;91;323;730;2269;821;2592
171270;201410;448;1819;415;1755;115;448;207;960;322;1408
171280;201410;947;2931;823;2728;201;674;427;1534;628;2208
171320;201410;4240;12832;3592;11809;1050;3597;1816;6023;2866;9620
171330;201410;2954;8790;2521;8124;645;2228;1351;4373;1996;6601
171360;201410;1580;5004;1328;4624;260;937;812;2879;1072;3816
171370;201410;794;2235;700;2089;145;482;375;1111;520;1593
171380;201410;1351;4453;1151;4064;425;1528;428;1545;853;3073
171395;201410;905;2749;728;2428;145;586;368;1201;513;1787
171420;201410;2297;6979;1827;6139;447;1592;824;2812;1271;4404
171430;201410;1064;3308;902;3044;209;714;520;1773;729;2487
171488;201410;2589;7837;2330;7477;605;1950;1298;4351;1903;6301
171500;201410;910;2802;790;2578;123;401;480;1602;603;2003
171510;201410;986;3425;887;3264;144;547;578;2197;722;2744
171515;201410;623;1771;474;1544;93;317;246;801;339;1118
171525;201410;619;2050;519;1865;107;442;290;1020;397;1462
171550;201410;348;1152;286;1027;106;406;46;176;152;582
171570;201410;1333;4086;1159;3780;191;645;813;2678;1004;3323
171575;201410;2113;5981;1624;5078;369;1163;755;2461;1124;3624
171610;201410;6500;21895;5802;20584;1933;7274;2024;7140;3957;14414
171620;201410;2568;7683;2267;7250;163;589;1880;6043;2043;6632
171630;201410;922;2986;754;2691;223;860;292;1030;515;1890
171650;201410;2551;7900;2045;6955;541;1982;855;2875;1396;4857
171660;201410;2635;7248;2072;6256;350;1126;1218;3715;1568;4841
171665;201410;1444;4314;1201;3926;190;681;772;2616;962;3297
171670;201410;2389;6470;1895;5746;469;1542;978;2882;1447;4424
171700;201410;1199;3874;1037;3572;164;634;660;2265;824;2899
171720;201410;751;2255;646;2061;219;736;264;852;483;1588
171750;201410;1355;4356;1168;3984;391;1389;434;1477;825;2866
171780;201410;1297;3521;936;3012;123;446;555;1817;678;2263
171790;201410;1749;5591;1446;5156;256;902;906;3398;1162;4300
171800;201410;739;2345;664;2236;106;379;452;1555;558;1934
171820;201410;10538;31646;9339;30130;1998;6916;5707;18630;7705;25546
171830;201410;1639;5959;1490;5637;419;1667;679;2575;1098;4242
171840;201410;845;2408;743;2267;71;217;575;1782;646;1999
171845;201410;824;2235;643;1929;106;347;374;1107;480;1454
171850;201410;1030;3655;915;3412;131;571;566;2094;697;2665
171855;201410;1296;4094;1168;3883;116;489;888;2873;1004;3362
171865;201410;500;1589;419;1468;109;429;207;709;316;1138
171870;201410;713;2201;580;1967;131;479;262;931;393;1410
171875;201410;1435;4479;1207;4135;178;696;857;2919;1035;3615
171880;201410;982;3526;960;3486;121;460;718;2691;839;3151
171884;201410;1001;2813;724;2389;155;605;258;910;413;1515
171886;201410;1567;5192;1332;4678;451;1693;437;1550;888;3243
171888;201410;733;2245;595;1983;89;306;353;1223;442;1529
171889;201410;506;1643;479;1592;90;291;309;1058;399;1349
171890;201410;1213;3865;1062;3648;160;616;693;2378;853;2994
171900;201410;513;1934;454;1803;141;566;215;871;356;1437
172000;201410;673;2160;562;1978;91;368;325;1129;416;1497
172010;201410;1224;4219;1147;4096;125;501;882;3167;1007;3668
172015;201410;366;1383;306;1283;60;259;175;767;235;1026
172020;201410;2462;8071;2211;7696;311;1137;1566;5556;1877;6693
172025;201410;783;2235;607;1932;90;325;336;1053;426;1378
172030;201410;1143;3847;1026;3634;129;545;720;2536;849;3081
172049;201410;1324;3571;1038;3055;130;388;795;2390;925;2778
172065;201410;1363;3852;1133;3567;106;369;948;2999;1054;3368
172080;201410;2655;8157;2231;7427;273;1070;1533;5026;1806;6096
172085;201410;537;1463;406;1216;95;308;143;411;238;719
172090;201410;3548;10540;2729;9386;606;2171;1555;5540;2161;7711
172093;201410;594;1872;464;1639;126;554;235;793;361;1347
172097;201410;731;2122;598;1913;156;542;240;763;396;1305
172100;201410;30224;98989;25303;89174;8560;33095;6988;24454;15548;57549
172110;201410;1717;6307;1560;6071;190;764;1170;4679;1360;5443
172120;201410;5697;17058;4674;15720;535;1827;3479;11994;4014;13821
172125;201410;334;1009;266;901;62;232;122;417;184;649
172130;201410;551;1555;454;1402;65;212;301;969;366;1181
172208;201410;2240;6850;2086;6604;405;1387;1200;3843;1605;5230
172210;201410;2499;7746;2275;7390;460;1628;1408;4497;1868;6125
210005;201410;22978;73226;20000;68503;6016;22014;9346;32299;15362;54313
210010;201410;1664;5901;1467;5595;152;594;1128;4394;1280;4988
210015;201410;3554;10998;3233;10517;267;609;2716;9311;2983;9920
210020;201410;7682;18793;7157;18144;455;1249;5949;15257;6404;16506
210030;201410;5959;19762;5623;19298;477;1998;4626;15776;5103;17774
210040;201410;2064;5769;1856;5526;162;496;1497;4486;1659;4982
210043;201410;6430;18948;5763;18071;531;1601;4572;14825;5103;16426
210047;201410;6936;26717;6420;25816;900;3890;4520;18425;5420;22315
210050;201410;2557;9008;2040;8230;673;2805;845;3559;1518;6364
210055;201410;1762;6016;1624;5810;202;741;1215;4398;1417;5139
210060;201410;7973;29545;7170;28253;775;3374;5327;21463;6102;24837
210070;201410;7209;21337;6734;20752;301;976;5968;18557;6269;19533
210080;201410;3819;13085;3720;12957;79;307;3522;12309;3601;12616
210083;201410;4343;14895;4091;14620;119;347;3861;14004;3980;14351
210087;201410;2784;8463;2585;8220;162;549;2246;7204;2408;7753
210090;201410;10429;33738;9976;33012;446;1722;8758;29045;9204;30767
210095;201410;6395;23748;6191;23435;591;2281;5083;19624;5674;21905
210100;201410;7715;22990;7231;22417;340;1211;6436;19960;6776;21171
210110;201410;3288;11308;3179;11168;230;841;2691;9635;2921;10476
210120;201410;26721;75824;22752;71042;2693;8236;17343;55849;20036;64085
210125;201410;3615;11587;3464;11421;252;703;3050;10294;3302;10997
210130;201410;4357;12962;4144;12673;356;1123;3429;10530;3785;11653
210135;201410;1700;4980;1498;4684;129;401;1229;3912;1358;4313
210140;201410;18662;58671;15692;54699;3059;10779;10151;36787;13210;47566
210150;201410;4783;12039;4347;11500;118;308;4002;10588;4120;10896
210160;201410;19350;61994;18013;60010;2151;6611;14259;49128;16410;55739
210170;201410;14548;52515;14263;52139;1029;3424;12560;46898;13589;50322
210173;201410;1883;7944;1828;7836;116;560;1600;6902;1716;7462
210177;201410;3084;9777;2913;9566;288;1055;2400;7828;2688;8883
210180;201410;1574;4803;1478;4666;94;330;1253;3962;1347;4292
210190;201410;5275;16905;4906;16265;389;1698;3725;12083;4114;13781
210193;201410;1474;4704;1346;4484;100;372;1098;3704;1198;4076
210197;201410;2006;6702;1850;6529;198;612;1517;5571;1715;6183
210200;201410;9484;31465;8715;30353;1172;3795;6476;23592;7648;27387
210203;201410;6694;21955;6282;21424;457;1340;5508;19191;5965;20531
210207;201410;3119;10317;2923;9960;393;1261;2137;7516;2530;8777
210210;201410;9038;30376;8656;29857;286;1006;7692;27104;7978;28110
210215;201410;1671;6587;1615;6490;172;733;1310;5314;1482;6047
210220;201410;6452;24576;6161;24105;524;2093;5015;20087;5539;22180
210230;201410;5451;18315;5064;17704;404;1494;4157;14688;4561;16182
210232;201410;12197;41156;10591;39164;1750;6491;7384;28924;9134;35415
210235;201410;3684;11329;3295;10844;254;890;2797;9296;3051;10186
210237;201410;2536;9404;2499;9357;52;142;2391;9066;2443;9208
210240;201410;3100;9756;2938;9526;223;693;2441;8050;2664;8743
210250;201410;4931;15849;4697;15555;128;518;4404;14587;4532;15105
210255;201410;2788;8984;2537;8550;522;1850;1583;5415;2105;7265
210260;201410;5335;17025;4850;16280;674;2225;3585;12345;4259;14570
210270;201410;5447;15528;4842;14683;154;547;4306;13154;4460;13701
210275;201410;3685;9217;3443;8955;111;232;3267;8597;3378;8829
210280;201410;6169;17971;5277;16834;412;1404;4329;13956;4741;15360
210290;201410;5879;19022;5395;18413;460;1483;4495;15750;4955;17233
210300;201410;38918;113468;32080;104852;2888;9894;25330;85259;28218;95153
210310;201410;2902;8361;2739;8126;134;358;2408;7206;2542;7564
210312;201410;2223;7162;2163;7065;116;452;1936;6328;2052;6780
210315;201410;2504;8691;2381;8516;141;572;2060;7410;2201;7982
210317;201410;4398;13135;4205;12893;269;788;3728;11592;3997;12380
210320;201410;19876;62774;18554;61173;1094;3504;16285;54714;17379;58218
210325;201410;3735;11713;3332;11109;384;1367;2533;8522;2917;9889
210330;201410;37702;91550;29589;82955;3887;8506;21612;67793;25499;76299
210340;201410;12183;37419;11115;36083;1479;3984;8242;28690;9721;32674
210350;201410;10756;33372;9911;32173;842;2708;8005;26550;8847;29258
210355;201410;4054;14473;3665;13948;168;455;3314;13066;3482;13521
210360;201410;17401;52846;16143;51041;1403;4617;12868;41297;14271;45914
210370;201410;9216;23043;8013;21753;286;616;7271;20223;7557;20839
210375;201410;3317;10081;2834;9492;614;2123;1828;6287;2442;8410
210380;201410;6533;18574;5837;17592;556;1512;4773;14775;5329;16287
210390;201410;2833;9999;2596;9598;131;610;2253;8356;2384;8966
210400;201410;5164;16159;4965;15920;305;907;4400;14340;4705;15247
210405;201410;9207;25245;7419;22814;2232;6783;3448;11706;5680;18489
210407;201410;2144;7526;1890;7119;211;769;1456;5701;1667;6470
210408;201410;2314;9045;2182;8891;94;352;1951;8264;2045;8616
210409;201410;4020;14541;3805;14202;296;1153;3085;11791;3381;12944
210410;201410;3661;11783;3418;11482;300;839;2939;10194;3239;11033
210420;201410;4296;14157;3975;13601;339;1161;3237;11294;3576;12455
210430;201410;2222;6823;2152;6738;139;464;1876;5904;2015;6368
210440;201410;4374;13545;4245;13358;242;713;3787;12089;4029;12802
210450;201410;2974;9383;2681;8948;201;763;2195;7314;2396;8077
210455;201410;4368;12876;3760;11971;660;2135;2572;8389;3232;10524
210460;201410;4133;13235;3849;12846;224;835;3298;11109;3522;11944
210462;201410;1822;6480;1714;6268;173;692;1322;4901;1495;5593
210465;201410;2768;8985;2590;8758;275;775;2117;7459;2392;8234
210467;201410;6502;21272;6078;20746;478;1393;5118;18125;5596;19518
210470;201410;2070;5733;1610;5060;106;349;1279;4070;1385;4419
210480;201410;14397;47611;12656;45251;3522;12421;7035;26925;10557;39346
210490;201410;3624;10659;3323;10219;285;928;2694;8290;2979;9218
210500;201410;6901;27035;6599;26508;774;2950;5098;21304;5872;24254
210510;201410;7043;23302;6742;22935;421;1024;5818;20728;6239;21752
210515;201410;3473;11473;3350;11321;142;416;3094;10612;3236;11028
210520;201410;2859;8877;2633;8557;206;655;2192;7274;2398;7929
210530;201410;42745;137214;35927;126797;10382;39647;17690;64114;28072;103761
210535;201410;3319;11598;3192;11402;172;621;2791;10092;2963;10713
210540;201410;13736;46513;12200;44073;2992;10526;6721;26269;9713;36795
210542;201410;6510;18783;5688;17882;346;883;4995;16165;5341;17048
210545;201410;2306;7602;2188;7399;93;434;1892;6360;1985;6794
210547;201410;3970;13811;3691;13373;309;1046;2970;11039;3279;12085
210550;201410;6525;18309;5674;17366;299;672;5165;16266;5464;16938
210560;201410;4317;13568;3849;12799;280;1048;3188;10586;3468;11634
210565;201410;1571;5412;1354;5090;132;590;1016;3845;1148;4435
210570;201410;13058;37118;11840;35711;1029;2536;9877;30940;10906;33476
210580;201410;3225;9784;2849;9308;373;1009;2172;7680;2545;8689
210590;201410;4496;13785;4196;13429;281;882;3649;11877;3930;12759
210592;201410;2571;8148;2472;7989;116;427;2169;7007;2285;7434
210594;201410;2845;8061;2339;7349;155;434;1934;6252;2089;6686
210596;201410;2930;10781;2752;10450;301;1196;2090;8076;2391;9272
210598;201410;2005;6208;1867;6036;118;459;1648;5287;1766;5746
210600;201410;3400;10068;3101;9644;299;988;2430;7566;2729;8554
210610;201410;2776;8832;2486;8478;204;791;2101;7160;2305;7951
210620;201410;1934;5971;1777;5770;49;141;1631;5368;1680;5509
210630;201410;3591;12906;3129;12027;476;1851;2017;8020;2493;9871
210632;201410;4864;16682;4448;16099;422;1582;3616;13259;4038;14841
210635;201410;1958;6931;1869;6796;79;282;1672;6181;1751;6463
210637;201410;2884;9630;2704;9371;165;579;2317;8165;2482;8744
210640;201410;4371;14895;4296;14810;18;51;4190;14557;4208;14608
210650;201410;7085;21552;6941;21380;134;369;6683;20732;6817;21101
210660;201410;7854;24112;7312;23291;265;770;6752;21624;7017;22394
210663;201410;2713;7975;2562;7777;174;572;2187;6684;2361;7256
210667;201410;1772;6300;1690;6173;88;367;1474;5427;1562;5794
210670;201410;4852;17878;4682;17589;439;1691;3700;14291;4139;15982
210675;201410;4951;13883;4617;13466;367;974;3913;11675;4280;12649
210680;201410;4656;13004;4136;12400;238;678;3579;10887;3817;11565
210690;201410;7282;24270;6862;23817;289;898;6238;22121;6527;23019
210700;201410;2727;7849;2419;7494;478;1234;1653;5766;2131;7000
210710;201410;4958;16182;4730;15810;201;772;4167;13968;4368;14740
210720;201410;2597;9408;2446;9186;152;677;2142;7992;2294;8669
210725;201410;1199;4394;1029;4076;168;724;596;2380;764;3104
210730;201410;1270;3901;1115;3719;110;318;924;3167;1034;3485
210735;201410;3996;14415;3697;13886;605;2306;2601;10082;3206;12388
210740;201410;5313;15020;4963;14667;241;643;4602;13787;4843;14430
210745;201410;3897;11733;3640;11383;298;787;3052;9712;3350;10499
210750;201410;20790;57366;18766;55040;2050;5915;15067;45120;17117;51035
210760;201410;6144;16851;5768;16442;85;251;5592;15975;5677;16226
210770;201410;6446;17393;5436;16242;222;704;4901;14711;5123;15415
210780;201410;8829;29290;8123;28009;997;3625;5804;20386;6801;24011
210790;201410;4804;14671;4141;13918;326;830;3504;12340;3830;13170
210800;201410;5228;14632;4719;14063;196;615;4060;12552;4256;13167
210805;201410;3799;16010;3676;15788;194;827;3174;13959;3368;14786
210810;201410;5956;17728;5370;17053;407;817;4679;15596;5086;16413
210820;201410;9249;26566;8583;25629;1578;4610;5844;17998;7422;22608
210825;201410;5654;19017;5426;18726;313;981;4787;16854;5100;17835
210830;201410;8814;26787;8404;26318;489;1254;7423;23911;7912;25165
210840;201410;3890;10711;3511;10140;273;711;2823;8214;3096;8925
210845;201410;5975;18567;5749;18315;253;646;5178;16972;5431;17618
210850;201410;6382;23027;5884;22159;843;3544;4202;15917;5045;19461
210860;201410;17882;54492;16472;52592;1568;5200;13120;42404;14688;47604
210870;201410;6843;22137;6102;21202;690;2291;4705;16851;5395;19142
210880;201410;4443;14295;4314;14104;223;712;3853;12757;4076;13469
210890;201410;5544;16562;5179;16107;471;1583;4241;13291;4712;14874
210900;201410;5068;16090;4492;15135;1544;5294;1885;6746;3429;12040
210905;201410;1864;5825;1738;5654;134;350;1463;4916;1597;5266
210910;201410;10760;33743;9987;32505;1878;6536;6618;21740;8496;28276
210920;201410;3372;11369;3251;11192;191;631;2811;9867;3002;10498
210923;201410;1572;5706;1481;5567;223;845;1046;4129;1269;4974
210927;201410;4821;15116;4650;14941;35;110;4572;14733;4607;14843
210930;201410;2701;9737;2576;9571;204;911;2145;7972;2349;8883
210940;201410;2977;11641;2918;11523;300;1124;2384;9599;2684;10723
210945;201410;6080;17949;5849;17712;229;277;5557;17311;5786;17588
210950;201410;5891;17878;5103;16703;602;2065;3788;12600;4390;14665
210955;201410;1998;6583;1771;6227;306;1100;1189;4323;1495;5423
210960;201410;9519;31265;9098;30651;2416;7936;5548;19786;7964;27722
210970;201410;1407;5053;1240;4803;175;807;897;3470;1072;4277
210975;201410;1802;6111;1717;5957;151;555;1370;4811;1521;5366
210980;201410;9981;24022;9711;23720;687;1365;8618;21516;9305;22881
210990;201410;17489;50765;13954;46432;2946;10116;8653;29712;11599;39828
211000;201410;16972;53844;15219;51683;1031;3446;13056;45354;14087;48800
211003;201410;5198;18195;4741;17504;516;2011;3547;13485;4063;15496
211010;201410;6841;23713;6631;23468;144;484;6186;22217;6330;22701
211020;201410;7562;23642;7345;23300;247;679;6806;21733;7053;22412
211023;201410;2512;8384;2426;8230;167;584;2037;7052;2204;7636
211027;201410;3114;11941;2995;11751;309;1104;2370;9712;2679;10816
211030;201410;4393;13289;3945;12781;746;1908;2930;10156;3676;12064
211040;201410;4339;16553;4209;16347;163;676;3702;14676;3865;15352
211050;201410;10671;28228;10490;28027;425;1031;9810;26408;10235;27439
211060;201410;6255;22154;6099;21905;586;1969;5068;18636;5654;20605
211065;201410;1804;6139;1644;5935;51;172;1540;5636;1591;5808
211070;201410;8926;30088;8290;28994;751;2633;6644;23720;7395;26353
211080;201410;1403;4255;1152;3904;106;509;906;2970;1012;3479
211085;201410;2102;6994;1808;6581;294;1044;1281;4817;1575;5861
211090;201410;3706;11302;3478;10993;198;746;2975;9338;3173;10084
211100;201410;6967;18141;6793;17935;94;337;6480;17061;6574;17398
211102;201410;3183;11735;3027;11521;285;1032;2549;9941;2834;10973
211105;201410;2916;9257;2552;8751;219;837;2073;7106;2292;7943
211107;201410;4636;14477;4217;13918;266;820;3602;12208;3868;13028
211110;201410;6767;20170;5352;18139;965;3145;3472;12404;4437;15549
211120;201410;33945;93970;29914;88967;4500;12632;21725;67248;26225;79880
211125;201410;2256;7227;2040;6893;152;553;1692;5758;1844;6311
211130;201410;153491;448217;143241;435085;28517;86139;97213;302793;125730;388932
211140;201410;5709;18130;5363;17588;295;1056;4601;15113;4896;16169
211150;201410;10343;30743;9638;29866;677;2166;8247;25836;8924;28002
211153;201410;3216;9567;2948;9258;428;1126;2324;7679;2752;8805
211157;201410;1277;4162;1088;3868;134;571;741;2732;875;3303
211160;201410;4339;14594;3703;13524;416;1835;2660;9634;3076;11469
211163;201410;1767;5839;1673;5711;76;243;1496;5218;1572;5461
211167;201410;1546;5189;1441;5020;46;177;1314;4600;1360;4777
211170;201410;6837;18080;6576;17761;170;520;6080;16402;6250;16922
211172;201410;2464;7190;2166;6749;153;584;1803;5516;1956;6100
211174;201410;2944;8582;2679;8251;122;460;2360;7235;2482;7695
211176;201410;5711;16600;4796;15538;600;1735;3655;12398;4255;14133
211178;201410;3571;10309;3491;10220;89;204;3336;9860;3425;10064
211180;201410;4606;16098;4298;15630;409;1597;3440;12731;3849;14328
211190;201410;2967;9816;2687;9423;122;521;2320;8212;2442;8733
211195;201410;1503;4713;1280;4440;107;333;1048;3771;1155;4104
211200;201410;2235;7688;1994;7351;272;930;1480;5750;1752;6680
211210;201410;7083;21686;6820;21321;434;1352;5898;18652;6332;20004
211220;201410;37184;109922;32462;103755;6907;22705;20629;67813;27536;90518
211223;201410;6131;17605;5644;16827;834;2529;3785;11861;4619;14390
211227;201410;1636;6003;1527;5841;138;620;1212;4658;1350;5278
211230;201410;9226;30715;8422;29355;1198;4230;6029;21497;7227;25727
211240;201410;8491;28685;8166;28288;327;1167;7495;26130;7822;27297
211245;201410;5634;16238;5565;16153;173;401;5250;15429;5423;15830
211250;201410;12413;43799;11774;43060;1301;3466;9746;37842;11047;41308
211260;201410;8391;26448;8213;26199;559;1774;7281;23396;7840;25170
211270;201410;10283;36428;9654;35583;674;2739;7987;29925;8661;32664
211280;201410;12736;37577;12072;36774;1033;2488;10380;32778;11413;35266
211285;201410;2012;7049;1730;6530;409;1645;853;3382;1262;5027
211290;201410;7839;25748;7594;25437;838;2462;6200;21432;7038;23894
211300;201410;9092;27583;8284;26421;532;1777;7093;22783;7625;24560
211400;201410;12967;37408;10721;34861;2496;7854;6215;22766;8711;30620
220005;201410;1756;5160;1637;4975;70;296;1400;4126;1470;4422
220010;201410;1787;4663;1331;4078;111;415;1044;3135;1155;3550
220020;201410;3824;11702;3597;11314;589;1989;2449;7671;3038;9660
220025;201410;2229;5504;1997;5154;51;154;1762;4502;1813;4656
220027;201410;1430;3869;1318;3726;92;236;1110;3184;1202;3420
220030;201410;3487;10043;3402;9907;251;828;2891;8389;3142;9217
220040;201410;8801;27095;8305;26288;1706;5627;5191;16497;6897;22124
220045;201410;1509;4786;1360;4533;132;512;990;3245;1122;3757
220050;201410;4883;14245;4274;13340;373;1365;3374;10406;3747;11771
220060;201410;2147;5575;2043;5452;90;236;1862;4981;1952;5217
220070;201410;2688;7802;2404;7389;198;641;1881;5819;2079;6460
220080;201410;844;2614;798;2537;111;436;573;1754;684;2190
220090;201410;1929;4966;1658;4597;130;449;1371;3708;1501;4157
220095;201410;712;1965;680;1914;31;100;632;1766;663;1866
220100;201410;1427;4288;1207;3921;126;435;896;2950;1022;3385
220105;201410;2165;7113;1967;6728;167;601;1471;5045;1638;5646
220110;201410;3664;10596;3237;9965;233;871;2666;8070;2899;8941
220115;201410;2372;8550;2280;8403;246;981;1869;6903;2115;7884
220117;201410;1452;3862;1185;3469;121;370;912;2671;1033;3041
220120;201410;13197;37633;12220;36404;404;1475;11190;33297;11594;34772
220130;201410;893;3158;791;3027;61;201;692;2709;753;2910
220140;201410;1704;4536;1537;4325;230;471;1238;3676;1468;4147
220150;201410;7361;23077;6993;22577;411;1515;6048;19529;6459;21044
220155;201410;1101;3428;917;3085;80;338;635;2079;715;2417
220157;201410;1097;2797;997;2654;44;116;850;2259;894;2375
220160;201410;2931;8759;2622;8227;198;747;2025;6298;2223;7045
220170;201410;1394;4376;1243;4125;104;422;993;3271;1097;3693
220173;201410;2139;6452;1759;5727;79;362;1424;4574;1503;4936
220177;201410;1766;5180;1734;5129;66;199;1618;4796;1684;4995
220180;201410;1200;3237;1057;3012;55;196;804;2233;859;2429
220190;201410;4681;15242;4102;14504;469;1621;3252;11706;3721;13327
220191;201410;1500;5055;1431;4930;211;724;1051;3657;1262;4381
220192;201410;1798;5132;1426;4473;156;528;994;3105;1150;3633
220194;201410;1769;5216;1600;4932;160;564;1205;3626;1365;4190
220196;201410;2109;6288;1967;6046;224;763;1485;4566;1709;5329
220198;201410;1351;3798;1074;3439;19;67;996;3224;1015;3291
220200;201410;4750;16158;4445;15699;751;2770;3121;11118;3872;13888
220202;201410;2137;6679;1931;6311;66;265;1698;5512;1764;5777
220205;201410;3020;7894;2663;7422;99;364;2336;6425;2435;6789
220207;201410;929;2869;808;2655;90;340;605;1974;695;2314
220208;201410;1788;5993;1623;5705;238;947;1138;3974;1376;4921
220209;201410;1632;5008;1470;4736;85;329;1136;3667;1221;3996
220210;201410;1956;5113;1693;4761;91;309;1349;3798;1440;4107
220211;201410;1709;5002;1621;4887;114;477;1354;4009;1468;4486
220213;201410;1888;5442;1746;5184;104;376;1386;4046;1490;4422
220217;201410;1890;6152;1815;6058;66;178;1672;5667;1738;5845
220220;201410;12068;34357;11034;32745;1355;3740;7896;24123;9251;27863
220225;201410;1054;3185;943;3029;48;201;808;2553;856;2754
220230;201410;6253;16349;5176;14905;225;630;4580;13265;4805;13895
220240;201410;2804;8913;2627;8606;213;775;2054;6703;2267;7478
220245;201410;1532;4125;1373;3901;72;213;1175;3393;1247;3606
220250;201410;3420;9340;3068;8865;70;182;2812;8233;2882;8415
220253;201410;1893;5574;1610;5084;141;513;1183;3776;1324;4289
220255;201410;1836;5162;1603;4768;95;372;1317;3808;1412;4180
220260;201410;5301;16886;4720;15796;471;1666;3497;11763;3968;13429
220265;201410;1294;4644;1211;4499;105;457;884;3290;989;3747
220270;201410;7060;22895;6851;22539;428;1899;5835;18758;6263;20657
220271;201410;1575;4428;1471;4276;73;199;1284;3787;1357;3986
220272;201410;1833;5609;1684;5368;108;438;1327;4187;1435;4625
220273;201410;1326;3796;1153;3519;120;397;876;2646;996;3043
220275;201410;2176;5744;1832;5301;90;285;1593;4607;1683;4892
220277;201410;2662;7205;2252;6587;157;506;1763;5192;1920;5698
220280;201410;1802;4728;1558;4361;132;479;1174;3194;1306;3673
220285;201410;1737;4651;1530;4356;100;314;1253;3652;1353;3966
220290;201410;6748;21859;5671;20454;593;2327;4335;15813;4928;18140
220300;201410;2005;6500;1758;6166;92;409;1486;5208;1578;5617
220310;201410;2683;8662;2240;8131;93;284;2024;7587;2117;7871
220320;201410;3507;10280;2915;9271;349;1212;2120;6733;2469;7945
220323;201410;1513;5415;1335;5160;143;627;1011;3937;1154;4564
220325;201410;1304;4134;1185;3895;167;595;790;2669;957;3264
220327;201410;1393;4458;1258;4226;69;333;1011;3349;1080;3682
220330;201410;3859;10839;3635;10542;244;738;3095;9075;3339;9813
220335;201410;2161;6235;1943;5970;104;361;1673;5192;1777;5553
220340;201410;1913;5359;1653;4986;137;463;1273;3797;1410;4260
220342;201410;1243;4035;1177;3929;122;464;862;3019;984;3483
220345;201410;3110;8143;2636;7394;77;228;2324;6505;2401;6733
220350;201410;4571;12140;4015;11390;338;1065;3146;8918;3484;9983
220360;201410;1513;4105;1200;3619;118;413;879;2628;997;3041
220370;201410;9427;27113;8568;25981;458;1365;7640;23268;8098;24633
220375;201410;1611;5050;1490;4890;71;258;1344;4415;1415;4673
220380;201410;1485;3979;1261;3669;82;276;998;2887;1080;3163
220385;201410;799;2127;661;1894;32;111;549;1537;581;1648
220390;201410;10459;32659;9458;30713;2638;8958;3833;12513;6471;21471
220400;201410;1533;3620;1295;3263;46;156;1114;2716;1160;2872
220410;201410;1407;4011;1183;3693;112;450;920;2794;1032;3244
220415;201410;911;2452;818;2329;83;232;616;1759;699;1991
220420;201410;2338;6767;2072;6240;142;434;1685;5091;1827;5525
220430;201410;3019;8694;2867;8487;368;1120;2234;6613;2602;7733
220435;201410;1691;4958;1553;4741;85;263;1289;3944;1374;4207
220440;201410;2822;8523;2335;7954;134;445;2059;7037;2193;7482
220450;201410;2776;8168;2375;7603;543;1844;1436;4596;1979;6440
220455;201410;1423;4386;1273;4182;48;154;1156;3845;1204;3999
220460;201410;1119;2987;1016;2857;68;211;882;2457;950;2668
220465;201410;2533;8384;2322;8067;572;2115;1394;4887;1966;7002
220470;201410;4182;12490;3767;11783;270;953;2889;8930;3159;9883
220480;201410;2516;7371;2279;7030;190;603;1828;5654;2018;6257
220490;201410;2522;7213;2346;6991;137;490;2001;5939;2138;6429
220500;201410;3501;9342;2912;8323;158;630;2369;6596;2527;7226
220510;201410;2991;8345;2208;7112;111;478;1686;5370;1797;5848
220515;201410;2037;5066;1793;4761;94;254;1507;4019;1601;4273
220520;201410;5345;14787;4949;14229;203;563;4387;12731;4590;13294
220525;201410;1492;4203;1381;4038;107;386;1120;3204;1227;3590
220527;201410;1515;4696;1366;4379;155;514;1014;3304;1169;3818
220530;201410;1262;3690;1144;3506;90;349;959;2856;1049;3205
220535;201410;875;2704;845;2662;80;277;677;2129;757;2406
220540;201410;3753;12330;3604;12096;278;1056;2992;10036;3270;11092
220545;201410;1462;5005;1402;4902;189;754;1014;3502;1203;4256
220550;201410;9674;31379;9092;30392;1374;4848;6379;21407;7753;26255
220551;201410;1489;4993;1379;4803;113;492;1088;3741;1201;4233
220552;201410;1718;5359;1466;4917;123;552;1085;3524;1208;4076
220553;201410;1673;4968;1400;4550;76;292;1152;3745;1228;4037
220554;201410;937;2601;810;2427;97;297;607;1843;704;2140
220555;201410;2527;7345;2363;7137;92;301;2043;6258;2135;6559
220556;201410;1553;4850;1400;4556;107;427;1055;3404;1162;3831
220557;201410;1690;5530;1528;5215;210;785;1001;3423;1211;4208
220558;201410;1092;3412;1000;3250;98;394;756;2409;854;2803
220559;201410;1610;4532;1465;4305;78;264;1238;3634;1316;3898
220560;201410;1794;4432;1481;4012;90;254;1240;3340;1330;3594
220570;201410;7765;24705;7245;23934;1249;4075;5085;17230;6334;21305
220580;201410;6737;21837;6569;21636;397;1236;5918;19744;6315;20980
220585;201410;2018;7338;1930;7178;140;558;1610;6014;1750;6572
220590;201410;1497;4590;1347;4370;253;845;879;2914;1132;3759
220595;201410;2574;7387;2363;7107;89;311;2113;6367;2202;6678
220600;201410;1380;3410;1156;3139;194;412;810;2324;1004;2736
220605;201410;2128;6222;1864;5808;111;366;1490;4650;1601;5016
220610;201410;2844;8751;2750;8617;163;632;2350;7306;2513;7938
220620;201410;8105;27336;7797;26884;415;1658;6828;23594;7243;25252
220630;201410;429;1306;366;1188;61;224;208;667;269;891
220635;201410;1911;6760;1765;6441;175;773;1145;4181;1320;4954
220640;201410;2931;8515;2747;8247;249;837;2198;6577;2447;7414
220650;201410;2539;7130;2262;6695;154;513;1827;5375;1981;5888
220660;201410;2810;8683;2269;7974;255;1096;1813;6227;2068;7323
220665;201410;1243;4240;1184;4146;49;204;1068;3726;1117;3930
220667;201410;1833;6135;1734;6003;84;323;1491;5172;1575;5495
220669;201410;1960;6361;1825;6110;285;1111;1242;4112;1527;5223
220670;201410;2229;6678;2057;6461;163;399;1765;5752;1928;6151
220672;201410;2488;7095;2373;6951;246;693;1979;5888;2225;6581
220675;201410;1401;4085;1306;3927;127;359;985;2997;1112;3356
220680;201410;2308;7481;2198;7329;224;746;1772;6014;1996;6760
220690;201410;1805;5076;1597;4740;123;424;1267;3735;1390;4159
220695;201410;947;2774;879;2660;65;237;679;2021;744;2258
220700;201410;9344;26929;8450;25593;794;2649;6494;19643;7288;22292
220710;201410;797;2393;683;2197;59;183;500;1631;559;1814
220720;201410;2213;5903;2090;5737;98;230;1849;5142;1947;5372
220730;201410;1417;3937;1212;3623;47;175;1018;3024;1065;3199
220735;201410;1119;2856;915;2508;63;204;695;1900;758;2104
220740;201410;1452;4616;1218;4302;160;552;940;3420;1100;3972
220750;201410;4130;12001;3868;11602;486;1265;2983;9294;3469;10559
220755;201410;1249;3582;1159;3432;75;230;959;2839;1034;3069
220760;201410;2755;9542;2550;9254;136;570;2203;8057;2339;8627
220770;201410;25023;83673;22625;78897;7585;27464;8907;32226;16492;59690
220775;201410;1284;3216;1252;3180;20;34;1217;3112;1237;3146
220777;201410;1772;4933;1611;4694;125;357;1292;3745;1417;4102
220779;201410;1266;3640;1227;3584;63;226;1101;3180;1164;3406
220780;201410;6504;16925;5818;15985;459;1230;4769;13250;5228;14480
220785;201410;1369;3667;1323;3575;65;169;1210;3270;1275;3439
220790;201410;9955;31731;9462;30857;1030;3604;7390;24002;8420;27606
220793;201410;953;2702;875;2576;62;209;718;2109;780;2318
220795;201410;1576;4388;1522;4307;110;337;1311;3715;1421;4052
220800;201410;18065;50569;16563;48378;1849;6216;12416;35719;14265;41935
220810;201410;3450;10099;2987;9282;200;781;2386;7328;2586;8109
220820;201410;5822;15970;5310;15295;318;987;4589;13269;4907;14256
220830;201410;7881;22383;7458;21694;846;2472;5763;16938;6609;19410
220840;201410;15467;49239;13947;46168;3662;12336;6630;22587;10292;34923
220850;201410;2943;10353;2807;10163;226;884;2387;8694;2613;9578
220855;201410;645;1995;566;1848;49;190;415;1335;464;1525
220860;201410;975;2676;883;2529;55;213;714;1998;769;2211
220865;201410;2736;7556;2212;6693;115;541;1785;5225;1900;5766
220870;201410;2520;8227;2205;7833;111;419;1963;6997;2074;7416
220880;201410;5570;14499;5069;13888;257;789;4474;12274;4731;13063
220885;201410;1374;4854;1207;4561;127;580;891;3368;1018;3948
220887;201410;1445;3682;1257;3422;44;149;1142;3100;1186;3249
220890;201410;1704;5912;1510;5581;141;491;1203;4604;1344;5095
220900;201410;2030;5854;1796;5378;120;353;1463;4417;1583;4770
220910;201410;1767;5217;1552;4897;81;265;1342;4291;1423;4556
220915;201410;1073;3099;934;2846;57;240;727;2151;784;2391
220920;201410;1398;5103;1299;4953;145;643;944;3575;1089;4218
220930;201410;1536;4938;1365;4712;94;373;1117;3883;1211;4256
220935;201410;1092;3330;970;3083;71;305;693;2103;764;2408
220937;201410;1635;4462;1375;4000;82;294;1078;3050;1160;3344
220940;201410;1488;4561;1372;4313;108;405;1049;3277;1157;3682
220945;201410;509;1803;467;1689;58;241;326;1175;384;1416
220950;201410;1309;3319;943;2690;41;160;724;1999;765;2159
220955;201410;1653;4554;1389;4133;107;341;1078;3196;1185;3537
220960;201410;919;2488;764;2220;47;179;594;1695;641;1874
220965;201410;1755;5224;1655;5080;79;328;1417;4295;1496;4623
220970;201410;2199;5884;1621;4924;166;510;1125;3448;1291;3958
220975;201410;670;2314;659;2297;50;185;591;2057;641;2242
220980;201410;1522;4530;1352;4224;148;523;897;2889;1045;3412
220985;201410;1379;3978;1306;3868;134;446;1003;2950;1137;3396
220987;201410;1540;4916;1417;4705;111;487;1076;3474;1187;3961
220990;201410;1881;5423;1629;4991;75;310;1267;3811;1342;4121
220995;201410;1281;3801;1008;3384;91;372;759;2559;850;2931
220997;201410;2202;6982;2100;6819;104;368;1912;6208;2016;6576
221000;201410;4576;14083;4234;13508;503;1829;3100;9783;3603;11612
221005;201410;1470;4675;1364;4474;456;1387;678;2361;1134;3748
221010;201410;1272;3422;1096;3189;72;209;917;2683;989;2892
221020;201410;1957;6058;1822;5812;126;540;1364;4281;1490;4821
221030;201410;1846;5143;1590;4766;115;471;1243;3668;1358;4139
221035;201410;1618;4360;1454;4161;93;237;1279;3723;1372;3960
221037;201410;642;1961;576;1842;35;157;452;1385;487;1542
221038;201410;659;1849;522;1616;42;137;351;1099;393;1236
221039;201410;978;2823;904;2711;62;217;774;2291;836;2508
221040;201410;5280;16148;4963;15637;382;1308;3926;12494;4308;13802
221050;201410;3876;11860;3571;11427;224;882;3027;9616;3251;10498
221060;201410;9408;25755;7954;23719;918;2818;5951;17859;6869;20677
221062;201410;1299;4601;1199;4423;33;128;1111;4112;1144;4240
221063;201410;1169;3780;1086;3624;308;992;628;2242;936;3234
221065;201410;2883;8194;2647;7823;281;841;2087;6159;2368;7000
221070;201410;4421;13544;3988;12865;271;1008;3179;10270;3450;11278
221080;201410;3644;9739;3224;9168;199;615;2679;7645;2878;8260
221090;201410;1409;3893;1216;3573;50;205;1004;2883;1054;3088
221093;201410;1848;5515;1750;5318;408;1319;941;2795;1349;4114
221095;201410;1038;2745;889;2531;30;81;785;2247;815;2328
221097;201410;832;2382;729;2204;65;261;551;1634;616;1895
221100;201410;129993;393912;121971;380588;25417;86283;78387;240108;103804;326391
221110;201410;10549;34434;10026;33784;676;2583;8528;28728;9204;31311
221120;201410;4642;15211;4444;14860;1009;3409;2912;9961;3921;13370
221130;201410;4841;14265;4212;12988;1249;3980;1998;6142;3247;10122
221135;201410;1534;4815;1428;4656;162;610;1128;3625;1290;4235
221140;201410;1460;3654;1338;3491;102;268;1134;2965;1236;3233
221150;201410;1272;3274;1052;2894;36;155;839;2271;875;2426
221160;201410;921;2411;858;2312;60;179;660;1791;720;1970
221170;201410;1172;3695;1090;3545;80;314;884;2835;964;3149
230010;201410;3486;9456;2853;8366;181;617;2286;6692;2467;7309
230015;201410;2777;9751;2595;9334;401;1691;1685;5922;2086;7613
230020;201410;14814;48588;14266;47599;872;3176;11922;40040;12794;43216
230030;201410;13072;38005;12059;36433;867;2926;9798;29580;10665;32506
230040;201410;4700;13162;3976;11914;309;1099;3086;9145;3395;10244
230050;201410;2567;8891;1992;7344;410;1619;877;3211;1287;4830
230060;201410;2174;6367;1893;5854;122;447;1453;4446;1575;4893
230070;201410;4439;12256;3832;11326;381;1219;2810;8410;3191;9629
230075;201410;9282;33327;8664;32035;811;3817;6699;24391;7510;28208
230080;201410;2455;6680;2042;6076;130;441;1653;4901;1783;5342
230090;201410;3677;11068;3259;10322;353;1266;2416;7619;2769;8885
230100;201410;18201;55585;16629;52563;3954;13184;8981;28643;12935;41827
230110;201410;14378;46860;13375;44733;2651;9475;7838;26155;10489;35630
230120;201410;8357;23032;7336;21597;845;2505;5450;16344;6295;18849
230125;201410;2965;8732;2457;7756;196;724;1806;5653;2002;6377
230130;201410;5810;19216;4905;17228;509;2120;3412;11770;3921;13890
230140;201410;3669;11788;3125;10789;466;1683;2048;7246;2514;8929
230150;201410;1808;5723;1573;5235;283;1075;979;3154;1262;4229
230160;201410;6665;19825;5786;18527;471;1753;4459;14242;4930;15995
230170;201410;6778;21370;5818;19582;548;2141;4229;14108;4777;16249
230180;201410;1988;5728;1736;5268;147;550;1216;3610;1363;4160
230185;201410;4359;14383;3974;13671;702;2422;2503;8957;3205;11379
230190;201410;13112;42622;11885;40173;2611;9859;6127;20391;8738;30250
230195;201410;5203;16105;4647;15200;322;1370;3667;11655;3989;13025
230200;201410;5911;17173;5303;15996;645;2073;3786;11385;4431;13458
230205;201410;4518;14180;4027;13350;321;1357;2938;9700;3259;11057
230210;201410;9654;27753;8429;25824;2061;6411;4702;14848;6763;21259
230220;201410;14267;41328;12904;38970;1657;5660;9044;26935;10701;32595
230230;201410;7798;25477;6969;23788;1032;3725;4456;15350;5488;19075
230240;201410;13946;40148;12393;37401;801;3050;9709;28697;10510;31747
230250;201410;10427;32257;10205;31925;506;1891;8671;27009;9177;28900
230260;201410;15393;51701;14264;49414;2927;10672;8141;28837;11068;39509
230270;201410;7080;21519;6191;19956;732;2567;4427;14359;5159;16926
230280;201410;19577;59240;17515;55650;2244;7224;12533;40168;14777;47392
230290;201410;4879;15133;4229;13804;579;1957;2888;9445;3467;11402
230300;201410;4990;15220;4752;14867;522;1884;3613;11166;4135;13050
230310;201410;5042;15105;4387;13991;363;1458;3242;10120;3605;11578
230320;201410;7631;24400;7060;23397;769;2891;5248;17410;6017;20301
230330;201410;4838;14425;4241;13260;348;1285;3067;9474;3415;10759
230340;201410;3561;12322;3316;11797;508;2036;2108;7344;2616;9380
230350;201410;18810;57833;16971;54654;2720;9417;10769;35221;13489;44638
230360;201410;3198;9364;2672;8371;322;1142;1836;5682;2158;6824
230365;201410;3174;8839;2760;8160;164;589;2193;6437;2357;7026
230370;201410;58508;191446;53512;182606;15790;55740;25550;90310;41340;146050
230380;201410;7288;21189;6201;19304;555;1944;4414;13752;4969;15696
230390;201410;3755;11782;3320;11054;374;1522;2330;7650;2704;9172
230393;201410;3450;11426;2943;10360;302;1411;2053;6949;2355;8360
230395;201410;5250;16282;4822;15497;765;2654;3113;10056;3878;12710
230400;201410;5394;16705;4658;15562;346;1506;3626;11867;3972;13373
230410;201410;15805;50147;14046;46695;2358;8426;8446;28083;10804;36509
230420;201410;25727;83958;23426;79189;5769;21116;11496;38649;17265;59765
230423;201410;4974;16075;4593;15333;528;1943;3187;10802;3715;12745
230425;201410;5658;18945;5150;17787;738;2724;3450;11905;4188;14629
230426;201410;2917;8138;2354;7084;156;638;1740;5092;1896;5730
230427;201410;1812;5503;1372;4554;151;578;918;2934;1069;3512
230428;201410;9538;30921;9169;30281;1751;6440;5818;19037;7569;25477
230430;201410;4707;15115;4393;14499;430;1720;3173;10270;3603;11990
230435;201410;5238;16979;4680;15988;993;3787;2494;8518;3487;12305
230440;201410;373360;1150516;347284;1103211;89032;301894;171052;546143;260084;848037
230445;201410;4849;13084;4085;11962;354;1021;3066;9156;3420;10177
230450;201410;3847;12231;3280;11207;453;1812;2138;7259;2591;9071
230460;201410;1977;6574;1780;6213;201;818;1268;4396;1469;5214
230465;201410;4343;12966;3547;11516;309;1309;2424;7671;2733;8980
230470;201410;11571;42250;11034;41142;1489;5805;7853;29820;9342;35625
230480;201410;1515;4887;1298;4467;196;719;840;2912;1036;3631
230490;201410;2914;8598;2521;7856;474;1656;1318;4016;1792;5672
230495;201410;5887;19788;5319;18826;884;3720;3121;11017;4005;14737
230500;201410;10874;37109;10374;36227;955;3679;7835;27916;8790;31595
230510;201410;1543;5542;1240;4754;328;1345;453;1805;781;3150
230520;201410;5151;15702;4512;14557;492;1862;3068;9823;3560;11685
230523;201410;14750;48633;12995;44532;3440;13001;3799;13229;7239;26230
230526;201410;4265;13074;3753;12182;392;1505;2712;8776;3104;10281
230530;201410;5554;18377;5050;17687;1022;3658;3398;12104;4420;15762
230533;201410;4116;11716;3665;10862;274;905;2853;8378;3127;9283
230535;201410;5558;16566;4818;15204;629;1982;3273;10594;3902;12576
230540;201410;19673;56282;17378;52830;1045;3879;14368;43310;15413;47189
230550;201410;19214;58509;17338;54809;3666;12508;9499;29824;13165;42332
230560;201410;6705;19496;5978;18187;273;1089;4825;14523;5098;15612
230565;201410;3298;9424;2642;8125;196;729;1926;5822;2122;6551
230570;201410;4091;11116;3616;10517;244;855;2988;8614;3232;9469
230580;201410;10756;32891;10126;31994;621;1995;8753;27961;9374;29956
230590;201410;8991;28503;7895;26404;649;2778;5913;19284;6562;22062
230600;201410;3599;10250;2713;8399;202;704;1815;5557;2017;6261
230610;201410;6348;20711;5917;20014;805;2914;4222;14424;5027;17338
230620;201410;2161;6163;1739;5254;165;589;1095;3191;1260;3780
230625;201410;8000;26329;7129;24331;2136;7801;2290;7877;4426;15678
230630;201410;11614;37535;10570;35550;2749;8811;5193;18697;7942;27508
230640;201410;27830;91845;25970;89040;3512;12872;19098;66026;22610;78898
230650;201410;5105;15819;4580;14795;365;1510;3503;11049;3868;12559
230655;201410;8942;33934;8583;33312;710;2858;7188;28285;7898;31143
230660;201410;6578;20503;5743;18974;529;2089;4169;13813;4698;15902
230670;201410;6124;16622;4941;14580;278;1071;3851;11012;4129;12083
230680;201410;2847;8382;2384;7504;365;1231;1456;4580;1821;5811
230690;201410;6276;20769;6156;20530;513;2148;4469;14595;4982;16743
230700;201410;9549;27658;8452;25677;841;3134;5942;17515;6783;20649
230710;201410;7745;25247;6812;23513;861;3025;4876;17148;5737;20173
230720;201410;2010;6318;1732;5781;234;823;1151;3904;1385;4727
230725;201410;3804;12888;3327;11712;762;2814;1570;5501;2332;8315
230730;201410;59372;181613;49609;165422;13846;50359;19434;66193;33280;116552
230740;201410;5758;17835;5300;17030;292;1270;4413;13950;4705;15220
230750;201410;9356;26801;7902;24475;678;2439;6025;18568;6703;21007
230760;201410;10027;30435;9403;29090;1016;3813;6841;20364;7857;24177
230763;201410;4383;13714;4009;12984;283;1304;3089;9652;3372;10956
230765;201410;42903;140408;39386;133105;12296;44468;14019;47967;26315;92435
230770;201410;24446;68683;22565;66006;2366;7628;16672;48788;19038;56416
230780;201410;6223;24212;5901;23470;1525;6139;2947;12444;4472;18583
230790;201410;2681;9000;2530;8744;303;1124;1924;6707;2227;7831
230800;201410;8135;29070;7403;27411;1777;7022;3514;13019;5291;20041
230810;201410;12897;41977;12230;40838;1306;4535;9488;32153;10794;36688
230820;201410;3574;12099;3130;11121;550;2206;1788;6341;2338;8547
230830;201410;8053;24447;7182;22856;787;2860;5023;15917;5810;18777
230835;201410;4280;11558;3588;10580;319;1062;2780;8149;3099;9211
230837;201410;3213;10951;2770;10039;338;1423;1889;6794;2227;8217
230840;201410;9675;31903;8843;30417;1073;3989;6379;22252;7452;26241
230850;201410;11563;35101;10690;33892;1361;4683;7849;24970;9210;29653
230860;201410;5270;15609;4771;14751;360;1328;3703;11377;4063;12705
230870;201410;19514;53563;17454;50191;1503;4931;13305;38001;14808;42932
230880;201410;1982;6861;1841;6571;249;1031;1216;4317;1465;5348
230890;201410;4112;14958;3755;14173;556;2485;2421;8946;2977;11431
230900;201410;3042;10219;2619;9330;563;1977;1360;4976;1923;6953
230910;201410;3125;9250;2511;8088;215;877;1815;5717;2030;6594
230920;201410;4909;14317;4516;13831;295;987;3828;11881;4123;12868
230930;201410;8006;24413;7149;22800;867;2945;4953;15865;5820;18810
230940;201410;7812;22458;6858;21021;451;1443;5550;17115;6001;18558
230945;201410;6173;18531;5283;17217;554;2070;3742;12370;4296;14440
230950;201410;7228;19734;6204;18362;418;1318;4912;14649;5330;15967
230960;201410;13330;42444;12196;40234;2640;9469;6171;20456;8811;29925
230970;201410;13999;44386;12559;41573;2748;10249;6039;19600;8787;29849
230980;201410;3034;9785;2637;9002;815;2829;1213;4304;2028;7133
230990;201410;1649;5117;1364;4525;153;639;902;2911;1055;3550
231000;201410;2929;7948;2312;6770;257;869;1485;4214;1742;5083
231010;201410;3294;9079;2807;8300;284;1024;2095;6093;2379;7117
231020;201410;8296;27763;7819;26795;1419;5043;4886;17078;6305;22121
231025;201410;8170;25535;7365;24116;1143;3895;4794;16060;5937;19955
231030;201410;8225;26959;6910;24190;1281;4856;3994;14061;5275;18917
231040;201410;3127;10217;2776;9486;243;1026;1992;6676;2235;7702
231050;201410;12648;36397;10838;33093;1037;3596;7924;24085;8961;27681
231060;201410;2499;8003;2281;7608;201;908;1637;5298;1838;6206
231070;201410;9602;30327;8779;28703;1623;5586;5261;17317;6884;22903
231080;201410;4413;13814;4026;13133;253;1156;3034;9559;3287;10715
231085;201410;4969;15894;4792;15620;719;2295;3503;11764;4222;14059
231090;201410;4165;11819;3388;10263;186;707;2469;7362;2655;8069
231095;201410;2290;7557;1970;6893;236;924;1316;4647;1552;5571
231100;201410;3136;9808;2627;8788;240;936;1896;6259;2136;7195
231110;201410;3833;12816;3744;12662;399;1521;2749;9314;3148;10835
231120;201410;2435;7961;2259;7644;392;1389;1453;4988;1845;6377
231123;201410;2257;6122;1901;5545;163;460;1500;4407;1663;4867
231126;201410;6880;19071;5564;17116;421;1587;4174;12676;4595;14263
231130;201410;20768;64780;18918;61554;4396;14689;10639;36031;15035;50720
231135;201410;4770;13976;3998;12759;407;1540;2928;9201;3335;10741
231140;201410;16309;52729;14714;49547;1466;6618;10027;32525;11493;39143
231150;201410;6119;17736;5199;15997;951;3211;2827;8501;3778;11712
231160;201410;6119;20741;5772;20070;1112;4103;3698;12894;4810;16997
231170;201410;4907;15667;4451;14721;516;2033;3014;9802;3530;11835
231180;201410;14347;43364;12954;40612;2213;7589;8040;24816;10253;32405
231190;201410;5158;14368;4306;13137;337;1208;3327;10027;3664;11235
231195;201410;4751;16067;4092;14758;426;1861;2935;10527;3361;12388
231200;201410;7912;27242;6893;25132;629;2984;4944;17636;5573;20620
231210;201410;5333;16415;4594;15366;323;1362;3559;12000;3882;13362
231220;201410;14497;41035;12308;37245;1229;4392;8212;24793;9441;29185
231230;201410;9138;31798;8503;30708;922;3903;6466;23268;7388;27171
231240;201410;12532;39807;11190;37254;2189;7812;6127;20714;8316;28526
231250;201410;2042;5966;1396;4395;347;1058;478;1482;825;2540
231260;201410;4100;11708;3686;11108;544;1648;2448;7578;2992;9226
231270;201410;7937;22145;6977;20595;646;2522;5107;14639;5753;17161
231280;201410;1778;5848;1653;5603;157;560;1227;4192;1384;4752
231290;201410;33205;115774;30035;108200;6859;27577;13339;46927;20198;74504
231300;201410;4772;13940;3869;12115;330;1264;2746;8345;3076;9609
231310;201410;7796;22414;6529;19815;1216;3842;3600;10794;4816;14636
231320;201410;6968;21643;5975;19690;365;1492;4436;14565;4801;16057
231325;201410;2648;8057;2346;7532;179;679;1758;5653;1937;6332
231330;201410;14471;44924;12154;40463;2024;6830;7502;25320;9526;32150
231335;201410;5347;15441;4629;14130;315;1228;3666;10965;3981;12193
231340;201410;18548;60826;17326;59075;1397;4612;14068;49283;15465;53895
231350;201410;13391;43903;13063;43411;1459;4586;10569;35881;12028;40467
231355;201410;4356;14286;4136;13910;277;1039;3357;11369;3634;12408
231360;201410;7545;24904;6869;23686;1594;5398;4102;14721;5696;20119
231370;201410;2479;6981;1976;6193;111;411;1507;4659;1618;5070
231375;201410;4139;14351;3902;13865;321;1447;3108;10869;3429;12316
231380;201410;5438;17718;5111;17255;793;2806;3494;12113;4287;14919
231390;201410;3525;11159;3309;10813;269;1119;2489;8025;2758;9144
231395;201410;4281;13810;3823;13058;734;2621;2312;8025;3046;10646
231400;201410;10687;31935;9699;30116;1001;3560;6757;21023;7758;24583
231410;201410;13888;47416;12935;45996;1194;4470;10122;36534;11316;41004
240010;201410;2582;7999;2236;7270;535;1936;1006;3135;1541;5071
240020;201410;12105;38064;10762;35487;2781;9744;5112;17137;7893;26881
240030;201410;2692;7847;2605;7706;216;759;2091;6094;2307;6853
240040;201410;847;2537;719;2280;50;228;518;1563;568;1791
240050;201410;3856;10483;3303;9542;232;800;2516;7172;2748;7972
240060;201410;1497;4464;1395;4282;132;483;1075;3215;1207;3698
240070;201410;2964;8582;2798;8273;495;1538;1799;5260;2294;6798
240080;201410;3210;8634;2796;8085;276;777;2137;6283;2413;7060
240090;201410;2338;6390;1973;5710;78;302;1567;4437;1645;4739
240100;201410;10731;30598;9829;28791;1287;4408;6157;17784;7444;22192
240110;201410;5299;16236;4692;15095;851;3070;2785;8650;3636;11720
240120;201410;3096;10317;2961;10063;541;1976;1887;6542;2428;8518
240130;201410;2929;7928;2516;7292;202;700;1967;5603;2169;6303
240140;201410;2321;7030;2030;6497;404;1482;1122;3505;1526;4987
240145;201410;6392;20060;5757;18936;1505;5466;2977;9794;4482;15260
240150;201410;1044;3149;856;2777;106;427;518;1609;624;2036
240160;201410;1433;4668;1265;4378;181;690;788;2797;969;3487
240165;201410;973;3080;847;2822;114;373;544;1870;658;2243
240170;201410;2600;7787;2308;7247;629;2158;1055;3287;1684;5445
240180;201410;3054;9561;2838;9177;727;2432;1469;4947;2196;7379
240185;201410;1536;5097;1477;4988;167;574;1121;3869;1288;4443
240190;201410;946;2896;857;2731;58;250;658;2036;716;2286
240200;201410;14203;36915;11804;33814;2497;7301;6643;19761;9140;27062
240210;201410;2876;8230;2649;7915;228;783;2182;6465;2410;7248
240220;201410;7464;24289;7078;23745;431;1897;6089;20201;6520;22098
240230;201410;5882;16234;5277;15231;427;1370;4189;11979;4616;13349
240240;201410;1914;5866;1381;4513;377;1356;295;844;672;2200
240250;201410;2948;8505;2786;8273;210;682;2259;6683;2469;7365
240260;201410;15191;50917;14450;49695;2548;9660;9315;32229;11863;41889
240270;201410;2533;8119;2336;7793;258;864;1738;5931;1996;6795
240280;201410;1707;4841;1528;4532;125;436;1141;3347;1266;3783
240290;201410;1455;4554;1251;4180;118;562;816;2624;934;3186
240300;201410;2224;6266;1587;4863;422;1379;548;1621;970;3000
240310;201410;10778;30617;9750;28942;2083;6727;5344;15854;7427;22581
240320;201410;2105;6296;1714;5478;113;483;1244;3839;1357;4322
240325;201410;39906;110392;31150;95846;10007;33116;9154;28776;19161;61892
240330;201410;1595;4818;1347;4323;156;622;853;2649;1009;3271
240340;201410;1827;5277;1563;4858;199;661;1117;3476;1316;4137
240350;201410;2215;6605;2071;6401;208;733;1686;5177;1894;5910
240360;201410;7565;22799;6601;21359;1282;4400;3989;13260;5271;17660
240370;201410;2102;5768;1781;5218;179;571;1234;3625;1413;4196
240375;201410;925;2463;815;2295;159;509;479;1308;638;1817
240380;201410;2746;8169;2190;6909;305;1006;1273;3973;1578;4979
240390;201410;995;2742;840;2441;73;267;610;1723;683;1990
240400;201410;1532;4109;1291;3723;153;523;933;2605;1086;3128
240410;201410;558;1807;509;1705;86;338;321;1066;407;1404
240420;201410;5007;19018;4780;18493;1320;5109;2495;10190;3815;15299
240430;201410;3716;10530;3410;10008;320;1072;2540;7372;2860;8444
240440;201410;2875;7614;2617;7177;677;1877;1368;3786;2045;5663
240450;201410;3644;10983;3250;10229;359;1451;2171;6589;2530;8040
240460;201410;3083;9558;2935;9352;279;1052;2353;7412;2632;8464
240470;201410;3699;11419;2974;9879;390;1425;1850;6100;2240;7525
240480;201410;476;1244;394;1072;41;113;240;640;281;753
240485;201410;2170;6666;1904;6151;376;1310;1086;3525;1462;4835
240490;201410;1764;4450;1512;4076;89;320;1200;3122;1289;3442
240500;201410;2239;6605;2093;6372;208;700;1587;4829;1795;5529
240510;201410;1894;5683;1750;5418;212;673;1326;4159;1538;4832
240520;201410;1488;4312;1298;4038;194;679;903;2747;1097;3426
240530;201410;2274;7220;2041;6849;294;1031;1432;4835;1726;5866
240540;201410;1872;5730;1789;5591;169;601;1360;4252;1529;4853
240550;201410;838;2384;726;2192;62;214;556;1641;618;1855
240560;201410;3348;9801;3168;9530;311;944;2565;7766;2876;8710
240570;201410;3191;9053;2557;7632;595;1964;1056;2858;1651;4822
240580;201410;8422;25885;7912;25007;1108;3744;5903;18570;7011;22314
240590;201410;851;2391;733;2179;57;212;533;1545;590;1757
240600;201410;1620;4778;1277;4071;173;658;737;2238;910;2896
240610;201410;5164;14499;4453;13191;631;1990;2733;7944;3364;9934
240615;201410;1078;3121;895;2767;153;487;502;1549;655;2036
240620;201410;1794;5728;1630;5446;207;758;1239;4147;1446;4905
240630;201410;2159;6566;2020;6327;213;581;1496;4922;1709;5503
240640;201410;969;2840;812;2576;93;374;545;1694;638;2068
240650;201410;3962;12082;3626;11588;292;1037;2908;9361;3200;10398
240660;201410;2585;8210;2449;7997;269;939;1864;6146;2133;7085
240670;201410;2814;8424;2365;7503;358;1262;1335;4149;1693;5411
240680;201410;1551;4568;1256;4032;147;530;783;2507;930;3037
240690;201410;1145;3185;992;2942;102;361;728;2130;830;2491
240700;201410;2711;8180;2259;7327;121;570;1743;5504;1864;6074
240710;201410;19086;49213;16875;46249;3214;8665;10489;29674;13703;38339
240720;201410;5935;16857;5589;16307;1724;5346;2643;7554;4367;12900
240725;201410;1091;3290;846;2747;87;310;490;1554;577;1864
240730;201410;2406;7257;2077;6650;216;765;1474;4699;1690;5464
240740;201410;2294;6857;2057;6425;266;902;1356;4228;1622;5130
240750;201410;2342;8694;2141;8315;483;2051;1170;4615;1653;6666
240760;201410;1343;3842;1232;3695;121;294;955;3054;1076;3348
240770;201410;3631;10420;3248;9867;328;1147;2462;7455;2790;8602
240780;201410;6118;16996;4912;15092;893;2902;2844;8913;3737;11815
240790;201410;886;2740;722;2443;53;224;527;1785;580;2009
240800;201410;42428;122682;38448;115837;10874;34308;16328;50101;27202;84409
240810;201410;101958;300417;95508;288864;28336;88432;45977;141090;74313;229522
240820;201410;7143;21299;6132;19680;1315;4589;3064;10241;4379;14830
240830;201410;9730;29720;9101;28811;692;2301;7509;24151;8201;26452
240840;201410;1337;3722;1151;3406;145;490;696;2031;841;2521
240850;201410;1323;3939;970;3168;186;674;496;1562;682;2236
240860;201410;1383;3897;1162;3519;99;344;860;2553;959;2897
240870;201410;1208;3361;1018;2994;131;454;659;1840;790;2294
240880;201410;1223;4172;1156;4071;143;595;847;2949;990;3544
240890;201410;5596;15802;4808;14377;990;3222;2407;7099;3397;10321
240895;201410;2863;9757;2588;9260;349;1319;1788;6521;2137;7840
240910;201410;2844;8886;2569;8374;225;872;1924;6206;2149;7078
240920;201410;878;2817;781;2596;215;787;332;1062;547;1849
240930;201410;3768;10079;3378;9577;307;886;2673;7695;2980;8581
240933;201410;1561;4506;1385;4208;210;718;871;2645;1081;3363
240940;201410;6856;19158;5731;17203;1076;3414;3223;9634;4299;13048
240950;201410;1219;3772;1149;3654;111;436;824;2615;935;3051
240960;201410;828;2578;733;2392;93;340;514;1674;607;2014
240970;201410;2001;5585;1665;5005;137;496;1222;3587;1359;4083
240980;201410;3409;11122;3169;10666;659;2395;1938;6502;2597;8897
240990;201410;3141;9367;2943;8970;550;1840;1809;5397;2359;7237
241000;201410;1124;3136;970;2868;80;278;710;2068;790;2346
241010;201410;2998;10071;2727;9559;387;1655;1923;6517;2310;8172
241020;201410;2201;6196;1798;5415;150;540;1152;3336;1302;3876
241025;201410;1581;4853;1422;4547;105;446;1029;3215;1134;3661
241030;201410;2623;8605;2353;8120;202;789;1810;6276;2012;7065
241040;201410;2280;7890;2079;7518;223;930;1506;5497;1729;6427
241050;201410;1398;4134;1247;3876;112;441;926;2805;1038;3246
241060;201410;1021;2931;925;2770;111;353;673;2020;784;2373
241070;201410;959;2722;835;2501;100;343;575;1675;675;2018
241080;201410;1230;3658;1045;3312;90;371;731;2247;821;2618
241090;201410;2195;6366;1874;5784;128;561;1503;4546;1631;5107
241100;201410;1227;3658;1047;3253;132;436;655;2008;787;2444
241105;201410;1225;3735;1145;3585;218;726;660;2134;878;2860
241110;201410;877;2792;733;2472;79;345;460;1518;539;1863
241120;201410;8041;24307;7329;23169;1493;4748;4735;15407;6228;20155
241140;201410;3589;9979;3156;9136;416;1276;2153;6157;2569;7433
241142;201410;716;2147;515;1704;134;512;150;443;284;955
241150;201410;6018;17859;5420;16846;838;2726;3634;11452;4472;14178
241160;201410;1141;3320;1071;3187;169;544;747;2216;916;2760
241170;201410;1407;4117;1286;3894;177;586;809;2551;986;3137
241180;201410;952;2678;768;2316;96;321;442;1284;538;1605
241190;201410;1188;3282;968;2840;83;306;632;1751;715;2057
241200;201410;21626;64429;19836;61513;5303;17263;9853;31165;15156;48428
241210;201410;1593;4596;1320;4038;276;926;642;1929;918;2855
241220;201410;8165;27378;7734;26541;1886;6729;4271;14975;6157;21704
241230;201410;3193;9435;2922;9040;223;846;2379;7284;2602;8130
241240;201410;1166;3430;870;2783;109;373;460;1521;569;1894
241250;201410;5775;18211;4928;16543;316;1548;3925;12840;4241;14388
241255;201410;1869;7123;1754;6876;453;1887;802;3241;1255;5128
241260;201410;5242;14165;4231;12596;329;1257;3059;8927;3388;10184
241270;201410;2123;6387;1862;5885;255;898;1130;3582;1385;4480
241280;201410;2185;6360;2025;6047;314;1012;1347;4044;1661;5056
241290;201410;3393;9338;2714;8253;446;1429;1692;5145;2138;6574
241300;201410;1490;4309;1319;4018;88;272;1008;3122;1096;3394
241310;201410;1603;4972;1500;4805;234;735;1034;3415;1268;4150
241320;201410;971;3227;891;3061;154;565;525;1821;679;2386
241330;201410;1570;4942;1451;4785;144;561;1182;3879;1326;4440
241335;201410;2741;8398;2574;8104;171;563;2185;6887;2356;7450
241340;201410;2000;6198;1769;5692;433;1518;859;2722;1292;4240
241350;201410;1974;6316;1823;6025;181;774;1362;4358;1543;5132
241355;201410;1357;3832;1159;3500;66;219;1015;3051;1081;3270
241360;201410;2225;6125;1917;5547;135;456;1395;3887;1530;4343
241370;201410;1369;4220;1107;3664;193;687;574;1869;767;2556
241380;201410;748;2147;639;1928;112;377;350;1062;462;1439
241390;201410;3047;10066;2848;9694;523;1900;1874;6468;2397;8368
241400;201410;3611;10791;3367;10443;379;1326;2603;8126;2982;9452
241410;201410;2818;8243;2523;7846;392;1319;1792;5587;2184;6906
241415;201410;1717;5232;1565;4966;124;491;1186;3696;1310;4187
241420;201410;2331;8074;2030;7543;693;2886;635;2309;1328;5195
241430;201410;544;1655;440;1414;48;182;283;875;331;1057
241440;201410;6173;22433;5774;21751;1127;4438;3880;14842;5007;19280
241445;201410;1093;3264;1021;3163;138;362;792;2593;930;2955
241450;201410;3350;9311;3006;8794;510;1609;1993;5774;2503;7383
241460;201410;3718;10818;3275;9956;277;1012;2346;7051;2623;8063
241470;201410;1394;3923;1175;3662;128;503;869;2655;997;3158
241475;201410;1281;3977;1122;3678;70;336;826;2642;896;2978
241480;201410;3370;10859;3039;10362;1071;3677;1151;4321;2222;7998
241490;201410;651;1746;536;1567;49;182;352;993;401;1175
241500;201410;760;2394;690;2293;35;143;602;1986;637;2129
250010;201410;2826;8809;2454;8140;226;928;1843;5982;2069;6910
250020;201410;1719;4925;1319;4204;107;463;880;2686;987;3149
250030;201410;8300;23404;7510;22302;870;2602;5751;17384;6621;19986
250040;201410;4641;15559;4280;14831;769;2836;2670;9318;3439;12154
250050;201410;3843;11914;3581;11548;459;1670;2583;8399;3042;10069
250053;201410;1377;4045;1268;3905;205;643;833;2606;1038;3249
250057;201410;707;2825;689;2804;35;98;612;2625;647;2723
250060;201410;5198;16217;4957;15845;639;2309;3792;11957;4431;14266
250070;201410;3893;12204;3637;11746;215;956;3026;9507;3241;10463
250073;201410;815;2464;726;2301;69;256;542;1708;611;1964
250077;201410;2359;6872;1963;6239;266;925;1173;3763;1439;4688
250080;201410;4873;14186;4701;13936;564;1741;3565;10613;4129;12354
250090;201410;2624;7787;2518;7614;126;443;2127;6335;2253;6778
250100;201410;4113;13694;3904;13329;445;1722;2990;10163;3435;11885
250110;201410;5938;17834;5649;17424;750;2621;4271;13057;5021;15678
250115;201410;553;1797;485;1633;40;202;288;904;328;1106
250120;201410;2274;6759;1952;6152;191;691;1446;4544;1637;5235
250130;201410;5826;17849;5485;17375;333;1126;4633;14894;4966;16020
250135;201410;1114;3386;1013;3205;113;386;711;2259;824;2645
250140;201410;2181;7039;2010;6811;220;821;1530;5251;1750;6072
250150;201410;5087;17194;4647;16350;469;1982;3386;11786;3855;13768
250153;201410;1604;4296;1438;4054;118;408;1121;3160;1239;3568
250157;201410;1791;6030;1644;5723;294;1069;1047;3693;1341;4762
250160;201410;3458;10637;3340;10454;212;744;2872;9064;3084;9808
250170;201410;1664;4898;1544;4706;292;920;997;3114;1289;4034
250180;201410;17290;53355;16665;52321;2327;8485;12022;36869;14349;45354
250190;201410;4134;12152;3808;11611;646;2073;2473;7442;3119;9515
250200;201410;2291;6313;1822;5672;137;506;1499;4630;1636;5136
250205;201410;1039;3389;944;3208;93;420;617;2141;710;2561
250210;201410;1677;5440;1550;5248;184;764;1123;3737;1307;4501
250215;201410;1464;4976;1421;4898;204;792;907;3137;1111;3929
250220;201410;834;2379;696;2203;46;173;591;1855;637;2028
250230;201410;1795;4516;1457;3962;129;409;1149;3040;1278;3449
250240;201410;2746;8730;2417;8216;205;732;1840;6334;2045;7066
250250;201410;4702;14107;4308;13577;371;1180;3530;11266;3901;12446
250260;201410;1937;5887;1682;5462;149;587;1249;4016;1398;4603
250270;201410;1364;4237;1213;4048;155;531;913;3113;1068;3644
250280;201410;3879;11619;3563;11114;655;2110;2335;7559;2990;9669
250290;201410;2155;5738;1773;5244;65;244;1557;4600;1622;4844
250300;201410;5638;16575;5333;16190;622;2523;4278;12433;4900;14956
250310;201410;1189;3762;1074;3567;148;567;785;2578;933;3145
250320;201410;8171;25628;7759;24790;1084;3940;5280;16411;6364;20351
250330;201410;2709;8397;2331;7880;254;997;1775;5963;2029;6960
250340;201410;1161;3375;1071;3232;52;172;917;2777;969;2949
250350;201410;4643;12661;4215;12139;192;622;3689;10751;3881;11373
250355;201410;2202;6725;1995;6418;151;640;1549;4909;1700;5549
250360;201410;2104;6266;1957;6062;115;428;1561;4857;1676;5285
250370;201410;13782;39152;11881;36877;1231;4025;9744;30408;10975;34433
250375;201410;1129;3557;1061;3443;62;252;897;2902;959;3154
250380;201410;1730;4913;1630;4785;97;335;1426;4173;1523;4508
250390;201410;1987;5330;1620;4717;225;660;1065;3149;1290;3809
250400;201410;75048;204789;63436;186327;15532;48070;32518;97405;48050;145475
250403;201410;1617;5282;1514;5139;209;809;1097;3693;1306;4502
250407;201410;1215;3478;1059;3216;73;224;824;2489;897;2713
250410;201410;689;2196;607;2049;68;284;462;1541;530;1825
250415;201410;1846;5785;1676;5457;138;531;1230;3938;1368;4469
250420;201410;1355;4195;1252;4034;100;401;1034;3262;1134;3663
250430;201410;6847;19114;6387;18444;496;1725;5234;14836;5730;16561
250435;201410;1685;5070;1497;4706;216;786;891;2848;1107;3634
250440;201410;4735;13834;4419;13395;297;914;3644;11141;3941;12055
250450;201410;2114;6006;1869;5685;101;343;1667;5082;1768;5425
250460;201410;6615;19904;6125;19239;747;2517;4621;14640;5368;17157
250470;201410;1639;4567;1470;4327;151;537;1051;3001;1202;3538
250480;201410;4131;12341;3727;11759;155;633;3228;10148;3383;10781
250485;201410;637;1659;536;1493;26;89;428;1152;454;1241
250490;201410;4281;13810;4176;13661;957;3297;2624;8643;3581;11940
250500;201410;1967;5936;1801;5662;388;1226;1050;3402;1438;4628
250510;201410;5037;14112;4450;13303;303;1090;3666;10923;3969;12013
250520;201410;1944;5979;1840;5800;326;1168;1104;3397;1430;4565
250523;201410;1843;5803;1746;5667;256;876;1267;4160;1523;5036
250527;201410;1529;4585;1439;4468;61;256;1296;3983;1357;4239
250530;201410;701;2130;616;2021;48;163;504;1687;552;1850
250535;201410;1351;4289;1284;4152;84;362;1019;3238;1103;3600
250540;201410;2521;7504;2360;7325;77;235;2181;6848;2258;7083
250550;201410;905;3048;832;2935;66;275;641;2238;707;2513
250560;201410;1829;5797;1786;5736;143;492;1522;4911;1665;5403
250570;201410;2580;8371;2292;7815;209;853;1718;5789;1927;6642
250580;201410;1209;3281;988;2930;101;421;714;2008;815;2429
250590;201410;1068;3253;961;3111;91;375;743;2360;834;2735
250600;201410;7267;21321;6863;20730;497;1436;5735;17561;6232;18997
250610;201410;3568;10423;3294;10010;400;1335;2361;7176;2761;8511
250620;201410;875;2544;809;2411;157;513;503;1474;660;1987
250625;201410;2329;7483;2293;7436;77;199;2141;7033;2218;7232
250630;201410;10738;34329;10173;33325;2295;7974;5832;19207;8127;27181
250640;201410;3959;11773;3702;11469;281;1054;3125;9583;3406;10637
250650;201410;975;2824;899;2682;129;451;535;1600;664;2051
250660;201410;2147;5364;1636;4751;29;71;1557;4556;1586;4627
250670;201410;2820;9362;2671;9088;267;1101;1997;6758;2264;7859
250680;201410;5091;14558;4846;14213;265;887;4201;12359;4466;13246
250690;201410;6534;17257;6260;16911;566;1679;5354;14337;5920;16016
250700;201410;5531;16435;5094;15791;821;2734;3477;10684;4298;13418
250710;201410;4781;15030;4382;14512;677;2288;3059;10405;3736;12693
250720;201410;2698;7985;2561;7756;144;568;2156;6478;2300;7046
250730;201410;3801;11710;3595;11411;443;1587;2677;8418;3120;10005
250740;201410;2108;6195;1847;5758;198;718;1349;4134;1547;4852
250750;201410;106091;311690;99627;301740;17451;57819;66165;198153;83616;255972
250760;201410;2342;6854;2162;6587;180;665;1710;5148;1890;5813
250770;201410;4124;14053;3904;13754;725;2776;2507;8886;3232;11662
250780;201410;1949;5757;1672;5239;203;786;1071;3234;1274;4020
250790;201410;2519;8218;2381;8022;552;1800;1523;5325;2075;7125
250800;201410;2873;8211;2504;7583;152;544;1945;5770;2097;6314
250810;201410;1405;4114;1216;3832;118;474;958;2957;1076;3431
250820;201410;2115;6427;2032;6309;125;413;1714;5387;1839;5800
250830;201410;6146;20249;5771;19496;771;3030;3966;13211;4737;16241
250840;201410;1054;3384;920;3112;116;437;590;2014;706;2451
250850;201410;2481;7172;2206;6723;215;834;1455;4584;1670;5418
250855;201410;1120;3402;1047;3290;96;357;811;2483;907;2840
250860;201410;3102;10296;2777;9685;672;2644;1101;3771;1773;6415
250870;201410;1217;3475;1056;3210;71;282;779;2287;850;2569
250880;201410;1469;4226;1323;4021;188;594;959;2917;1147;3511
250890;201410;10088;31423;9421;30498;1566;5852;6365;20219;7931;26071
250900;201410;3133;10222;2778;9553;355;1235;1927;6729;2282;7964
250905;201410;2157;6805;2059;6677;359;1203;1471;4834;1830;6037
250910;201410;5586;16165;5208;15601;495;1640;4077;12197;4572;13837
250915;201410;1747;5165;1607;4959;145;440;1332;4195;1477;4635
250920;201410;3669;10461;3435;10131;443;1238;2508;7686;2951;8924
250930;201410;2060;6679;1965;6529;334;1269;1366;4486;1700;5755
250933;201410;1212;3929;1164;3850;128;443;860;2885;988;3328
250937;201410;879;2726;783;2530;119;457;468;1509;587;1966
250939;201410;1770;5471;1600;5190;222;787;1072;3456;1294;4243
250940;201410;4101;12027;3796;11548;237;866;3029;9271;3266;10137
250950;201410;1158;3769;1090;3675;41;149;983;3336;1024;3485
250960;201410;1336;4144;1184;3940;111;447;921;3066;1032;3513
250970;201410;9349;25419;8303;23924;1214;3511;5791;16841;7005;20352
250980;201410;2780;8279;2528;7832;253;1002;1750;5209;2003;6211
250990;201410;2189;7497;2014;7149;299;1223;1365;4788;1664;6011
251000;201410;2624;7437;2151;6763;135;493;1726;5425;1861;5918
251010;201410;2906;8478;2640;8069;179;645;2116;6533;2295;7178
251020;201410;1765;5206;1619;5020;150;514;1344;4190;1494;4704
251030;201410;1360;3779;1233;3566;129;426;810;2367;939;2793
251040;201410;1964;6237;1766;5924;185;858;1262;4076;1447;4934
251050;201410;1178;3448;1035;3189;178;587;582;1845;760;2432
251060;201410;1072;2553;852;2278;82;283;653;1686;735;1969
251065;201410;601;1793;527;1682;72;263;327;1001;399;1264
251070;201410;648;1826;593;1746;64;254;458;1261;522;1515
251080;201410;21978;61391;20311;58559;5157;15530;10974;32060;16131;47590
251090;201410;3132;9871;2782;9220;283;1088;2011;6583;2294;7671
251100;201410;1040;3335;899;3059;187;723;490;1603;677;2326
251110;201410;2187;6339;1931;5877;222;731;1323;4038;1545;4769
251120;201410;6051;20870;5839;20499;760;3183;4505;15491;5265;18674
251130;201410;4100;10651;3683;10188;36;105;3562;9879;3598;9984
251140;201410;4655;14191;4311;13659;229;897;3421;10811;3650;11708
251150;201410;2934;9374;2681;9008;377;1421;1894;6406;2271;7827
251160;201410;1910;6331;1827;6215;98;389;1594;5429;1692;5818
251170;201410;1496;4568;1435;4493;123;460;1188;3675;1311;4135
251180;201410;2980;8904;2724;8568;581;1833;1629;5278;2210;7111
251190;201410;4532;12807;4377;12631;276;810;3915;11336;4191;12146
251200;201410;4264;13270;4060;13008;182;618;3628;11707;3810;12325
251203;201410;1389;4333;1297;4141;108;456;825;2733;933;3189
251207;201410;1242;3880;1076;3568;98;430;737;2363;835;2793
251210;201410;8359;23905;7291;22478;961;2918;5447;17183;6408;20101
251220;201410;1351;3627;1176;3360;183;553;768;2268;951;2821
251230;201410;5368;16057;4735;15310;424;1548;4009;12965;4433;14513
251240;201410;3288;10746;3205;10619;351;1275;2563;8484;2914;9759
251250;201410;10978;32727;10178;31497;1390;4840;7399;22635;8789;27475
251260;201410;565;1715;496;1620;41;134;366;1202;407;1336
251270;201410;4402;13668;4099;13292;159;622;3684;11982;3843;12604
251272;201410;1459;4365;1371;4242;128;422;1102;3445;1230;3867
251274;201410;1048;3268;985;3148;127;506;602;1961;729;2467
251275;201410;1452;4097;1377;3984;149;559;1019;2845;1168;3404
251276;201410;1538;4579;1453;4426;213;708;913;2872;1126;3580
251278;201410;662;2116;574;1911;90;335;344;1184;434;1519
251280;201410;2461;7660;2351;7479;255;895;1805;5707;2060;6602
251290;201410;6389;17989;6050;17566;875;2909;4410;12531;5285;15440
251300;201410;775;2673;718;2588;70;326;521;1837;591;2163
251310;201410;3402;9873;3130;9486;190;716;2527;7589;2717;8305
251315;201410;1768;6174;1707;6067;301;1105;1080;3930;1381;5035
251320;201410;2200;6157;1804;5517;152;516;1276;3959;1428;4475
251330;201410;2103;5462;1730;4975;114;457;1485;4141;1599;4598
251335;201410;1028;3526;965;3408;95;433;707;2423;802;2856
251340;201410;4048;11223;3409;10261;345;1274;2392;7034;2737;8308
251350;201410;1634;5003;1485;4786;202;716;1025;3282;1227;3998
251360;201410;1896;6136;1768;5980;118;475;1495;5096;1613;5571
251365;201410;920;2707;737;2330;57;222;482;1496;539;1718
251370;201410;24289;79385;23733;78554;3526;13430;17743;57430;21269;70860
251380;201410;1446;4477;1261;4161;93;394;1002;3234;1095;3628
251385;201410;896;2478;809;2339;85;263;556;1593;641;1856
251390;201410;6012;21134;5598;20414;1265;4862;3417;12560;4682;17422
251392;201410;1108;3266;1014;3116;97;308;754;2373;851;2681
251394;201410;646;1969;531;1751;44;171;373;1215;417;1386
251396;201410;894;2549;791;2368;112;358;542;1592;654;1950
251398;201410;1156;3353;964;2997;84;309;662;2041;746;2350
251400;201410;1393;3951;1260;3767;176;659;850;2444;1026;3103
251410;201410;1678;4353;1529;4111;178;547;1054;2883;1232;3430
251420;201410;2284;6489;1939;6101;196;688;1506;4712;1702;5400
251430;201410;1778;6257;1604;5972;123;546;1315;4894;1438;5440
251440;201410;1485;4430;1256;3981;145;516;900;2820;1045;3336
251445;201410;1684;5094;1595;4964;111;419;1348;4149;1459;4568
251450;201410;4963;15482;4434;14805;181;759;3840;12821;4021;13580
251455;201410;1226;3819;1082;3583;96;387;757;2514;853;2901
251460;201410;909;2765;868;2698;127;406;664;2094;791;2500
251465;201410;507;1574;460;1479;47;178;304;960;351;1138
251470;201410;1327;3822;1095;3392;133;477;647;2014;780;2491
251480;201410;1145;3106;1023;2907;63;231;818;2282;881;2513
251490;201410;2136;6273;1850;5886;320;1171;1163;3643;1483;4814
251500;201410;1828;5973;1771;5882;188;702;1399;4590;1587;5292
251510;201410;2722;8994;2498;8532;434;1590;1554;5355;1988;6945
251520;201410;1147;3108;1030;2925;152;462;574;1647;726;2109
251530;201410;12512;35902;11963;35113;713;2582;10278;29807;10991;32389
251540;201410;2938;9576;2705;9079;256;1023;2065;6900;2321;7923
251550;201410;4075;10182;3392;9304;187;641;2784;7472;2971;8113
251560;201410;760;2340;693;2224;104;413;420;1236;524;1649
251570;201410;1101;3213;924;2849;111;423;599;1885;710;2308
251580;201410;2235;6162;2052;5912;378;964;1436;4311;1814;5275
251590;201410;1774;5745;1731;5697;115;430;1498;4981;1613;5411
251593;201410;1088;3367;1003;3250;155;555;641;2022;796;2577
251597;201410;2040;6269;1962;6151;179;675;1549;4765;1728;5440
251600;201410;7637;22138;7202;21414;878;2631;5419;16399;6297;19030
251610;201410;3699;11082;3417;10704;359;1226;2624;8332;2983;9558
251615;201410;1225;3529;1040;3207;108;408;676;2126;784;2534
251620;201410;17937;50504;15738;47714;1872;5838;11883;36593;13755;42431
251630;201410;5478;13860;4739;12927;436;1238;3685;10168;4121;11406
251640;201410;2748;7904;2245;6995;224;840;1624;5006;1848;5846
251650;201410;4480;12739;4024;12160;334;1070;3297;10156;3631;11226
251660;201410;3698;12165;3375;11650;277;1262;2679;9044;2956;10306
251670;201410;4164;12391;3706;11759;82;272;3373;10793;3455;11065
251675;201410;779;2564;730;2489;170;616;410;1384;580;2000
251680;201410;2927;8176;2320;7249;133;547;1883;5784;2016;6331
251690;201410;3664;11172;3385;10662;310;1102;2471;7704;2781;8806
251700;201410;2221;7157;2090;6981;207;769;1689;5669;1896;6438
251710;201410;974;2538;724;2078;98;332;383;1065;481;1397
251720;201410;1452;4473;1317;4235;113;445;1016;3226;1129;3671
251740;201410;769;2162;617;1893;99;333;365;1127;464;1460
260005;201410;25783;63768;22554;59191;4852;12935;13624;35749;18476;48684
260010;201410;9878;26920;7922;24484;966;3181;5825;18083;6791;21264
260020;201410;6021;17505;5307;16430;525;1573;3975;12748;4500;14321
260030;201410;5506;16526;5072;15864;440;1586;4026;12475;4466;14061
260040;201410;10421;25155;8638;23125;708;1612;7020;19477;7728;21089
260050;201410;11344;35664;10519;34712;651;2288;9195;30648;9846;32936
260060;201410;4159;11534;3789;10924;356;1053;2953;8596;3309;9649
260070;201410;9917;29406;9418;28661;1861;6083;6167;18670;8028;24753
260080;201410;5530;15541;4886;14595;497;1685;3673;10802;4170;12487
260090;201410;5463;15132;5106;14629;1154;3178;3415;10108;4569;13286
260100;201410;3579;9567;3243;9111;251;856;2610;7417;2861;8273
260105;201410;4831;14233;4640;13876;733;2386;3216;9502;3949;11888
260110;201410;22585;65072;20739;62839;1380;4197;17817;54518;19197;58715
260120;201410;11437;35115;10589;33605;2813;9123;5598;18390;8411;27513
260130;201410;3216;9100;3044;8821;465;1295;2198;6521;2663;7816
260140;201410;13885;35345;11877;32873;1157;3488;9267;25985;10424;29473
260150;201410;3233;9258;2878;8748;219;805;2278;6947;2497;7752
260160;201410;6140;18724;5495;17953;518;1804;4495;14947;5013;16751
260170;201410;18164;49714;17355;48652;1620;4261;14075;40068;15695;44329
260180;201410;3581;10983;3251;10499;258;986;2621;8412;2879;9398
260190;201410;16655;39841;15626;38547;860;2273;13622;33599;14482;35872
260200;201410;11859;33293;10793;31754;1095;3437;8173;24700;9268;28137
260210;201410;11738;36003;10729;34545;890;3165;8622;28027;9512;31192
260220;201410;9696;29360;9410;28954;776;2985;7981;24045;8757;27030
260230;201410;10229;29496;9608;28658;700;2126;7875;23946;8575;26072
260240;201410;3022;9204;2620;8634;376;1326;1872;6209;2248;7535
260250;201410;2808;7523;2575;7231;191;572;2107;5958;2298;6530
260260;201410;11860;34422;11441;33832;1180;3763;9151;27600;10331;31363
260270;201410;3682;10993;3436;10629;363;1396;2654;8043;3017;9439
260280;201410;13361;43437;12250;41705;813;2987;10225;35320;11038;38307
260290;201410;35698;108158;34266;105701;6038;20625;22833;69489;28871;90114
260300;201410;8636;26139;7571;24562;555;2267;6047;19559;6602;21826
260310;201410;5272;15596;4934;15075;1569;4436;2505;8316;4074;12752
260320;201410;7153;23703;6641;22956;588;2056;5280;18640;5868;20696
260330;201410;3200;9910;2964;9521;299;1169;2023;6708;2322;7877
260340;201410;1951;5776;1831;5594;99;360;1597;4850;1696;5210
260345;201410;27382;88618;26030;85861;7771;27729;11868;37751;19639;65480
260350;201410;4428;12482;4184;12105;305;1006;3453;9921;3758;10927
260360;201410;2503;7692;2367;7464;451;1573;1491;4688;1942;6261
260370;201410;6244;19219;5643;18146;698;2478;4044;13123;4742;15601
260380;201410;5110;16624;4709;16085;495;1742;3595;12468;4090;14210
260390;201410;4853;15041;4186;13956;483;1800;2973;9761;3456;11561
260392;201410;3631;11372;3379;11043;149;568;3007;9837;3156;10405
260400;201410;14451;42191;13844;41183;2364;8004;9511;27620;11875;35624
260410;201410;64864;190674;61042;184318;20425;62172;27684;86542;48109;148714
260415;201410;4192;13227;3638;12136;500;2002;2281;7461;2781;9463
260420;201410;12561;29216;11465;28050;799;2054;9840;24152;10639;26206
260430;201410;2815;9328;2534;8875;310;1257;1836;6353;2146;7610
260440;201410;3524;10707;3234;10124;594;2017;1938;5952;2532;7969
260450;201410;5438;16165;5100;15634;417;1401;4146;12731;4563;14132
260460;201410;5977;18455;5580;17824;986;3479;3539;11113;4525;14592
260470;201410;5282;15027;4962;14585;464;1443;4044;12064;4508;13507
260480;201410;4063;11852;3611;11177;603;2086;2447;7525;3050;9611
260490;201410;6236;16081;5437;14778;610;1990;3773;10252;4383;12242
260500;201410;6980;19140;6434;18342;730;2198;4717;13601;5447;15799
260510;201410;10793;28275;9985;27173;818;2248;7980;22441;8798;24689
260515;201410;4710;14616;3677;12445;358;1400;2322;7855;2680;9255
260520;201410;16779;45002;16224;44245;3298;8910;11075;30688;14373;39598
260530;201410;10321;30838;8991;28960;570;1811;7628;24966;8198;26777
260540;201410;6025;15500;5674;15114;688;1525;4589;12636;5277;14161
260545;201410;43;166;31;127;5;23;7;27;12;50
260550;201410;2929;9713;2572;8988;646;2512;1160;4011;1806;6523
260560;201410;6909;17696;6153;16625;309;893;5384;14544;5693;15437
260570;201410;6893;23356;6379;22477;946;3709;4511;15978;5457;19687
260580;201410;4033;11081;3804;10722;286;942;3188;8810;3474;9752
260590;201410;6022;15279;5763;14975;252;558;5258;13843;5510;14401
260600;201410;27623;84408;25922;81525;4046;13689;17584;55639;21630;69328
260610;201410;7215;21597;6856;21084;1209;3968;4791;14645;6000;18613
260620;201410;17888;54965;17163;53723;3343;11670;10861;33280;14204;44950
260630;201410;2394;7077;2061;6532;216;826;1541;4828;1757;5654
260640;201410;18033;49459;17007;48013;2505;7389;12025;34050;14530;41439
260650;201410;5639;17644;5234;16952;664;2128;3675;12625;4339;14753
260660;201410;8688;24017;7793;22877;534;1659;6589;19509;7123;21168
260670;201410;2512;6976;2109;6428;285;967;1424;4359;1709;5326
260680;201410;24014;66071;22377;63211;5012;14754;12477;34943;17489;49697
260690;201410;3765;10287;3226;9450;181;666;2658;7707;2839;8373
260700;201410;5843;17356;5702;17207;92;168;5527;16899;5619;17067
260710;201410;1374;4181;1247;3999;144;549;945;2982;1089;3531
260720;201410;17583;57758;16688;56176;4360;14996;9065;31328;13425;46324
260730;201410;7474;24428;6681;23227;943;3446;4798;16917;5741;20363
260740;201410;1334;4050;1164;3742;170;610;715;2298;885;2908
260750;201410;6842;21681;6335;20991;596;1837;5240;17776;5836;19613
260760;201410;4935;13583;4623;13179;485;1510;3622;10321;4107;11831
260765;201410;8420;29016;8115;28554;1409;5688;5517;19275;6926;24963
260770;201410;4413;11419;4005;10883;249;851;3194;8521;3443;9372
260775;201410;5445;15739;5145;15283;588;2106;3714;10686;4302;12792
260780;201410;4076;13318;3901;13019;933;3464;2265;7472;3198;10936
260790;201410;124428;319729;118956;311669;26644;71351;72493;190920;99137;262271
260795;201410;3110;9819;2865;9437;460;1622;1918;6383;2378;8005
260800;201410;4962;13402;4592;12894;223;923;4004;10914;4227;11837
260805;201410;4200;12228;3772;11564;515;1711;2601;7972;3116;9683
260810;201410;7502;21712;7309;21461;464;1477;6388;18801;6852;20278
260820;201410;4707;13340;4371;12884;1146;3437;2540;7519;3686;10956
260825;201410;3134;10020;2910;9682;312;1015;2301;7785;2613;8800
260830;201410;3852;12369;3524;11778;963;3086;1995;7004;2958;10090
260840;201410;4307;12430;3909;11848;292;1144;3223;9564;3515;10708
260845;201410;4379;12835;4071;12244;668;2121;2742;8278;3410;10399
260850;201410;5094;17232;4585;16118;1114;4371;2240;7697;3354;12068
260860;201410;3364;10691;3093;10220;291;1027;2360;7863;2651;8890
260870;201410;4316;11918;3940;11445;521;1398;2998;8949;3519;10347
260875;201410;7554;20242;6777;19032;1148;3261;4325;12516;5473;15777
260880;201410;9022;28517;8551;27840;746;2486;7096;23329;7842;25815
260890;201410;15354;43785;14484;42463;1654;5390;10696;31445;12350;36835
260900;201410;6231;19086;5297;17449;878;3152;3222;10636;4100;13788
260910;201410;3248;9576;2930;9111;241;855;2358;7377;2599;8232
260915;201410;4691;15596;4518;15350;122;412;4180;14406;4302;14818
260920;201410;3496;10625;3325;10396;482;1619;2472;7896;2954;9515
260930;201410;4285;13479;3765;12689;480;1683;2719;9281;3199;10964
260940;201410;15739;43116;14434;40884;2475;8214;8782;24380;11257;32594
260950;201410;6402;20373;6027;19628;894;3668;3747;11512;4641;15180
260960;201410;69076;192442;65170;186048;14184;42203;38008;109355;52192;151558
260970;201410;5512;17408;5121;16843;553;2151;3804;12454;4357;14605
260980;201410;4098;13113;3874;12820;259;873;3296;11150;3555;12023
260990;201410;18689;58056;17228;56106;1960;6179;13177;44574;15137;50753
261000;201410;16215;45053;13063;39959;2688;8696;7149;22395;9837;31091
261010;201410;2848;7841;2658;7600;221;459;2267;6782;2488;7241
261020;201410;6145;18273;5637;17500;460;1742;4548;13728;5008;15470
261030;201410;3595;11644;3394;11298;342;1260;2677;8876;3019;10136
261040;201410;5491;17583;4715;16269;515;2114;3405;11614;3920;13728
261050;201410;8955;25307;8337;24300;1115;3323;5794;16850;6909;20173
261060;201410;11919;36333;11385;35455;1519;5413;8442;25831;9961;31244
261070;201410;52137;133233;46837;125724;9498;26320;28610;77358;38108;103678
261080;201410;5973;17917;5620;17355;412;1206;4741;14887;5153;16093
261090;201410;17015;47210;15857;45650;1587;4643;12644;36796;14231;41439
261100;201410;7581;24319;6915;23192;995;3653;4713;15923;5708;19576
261110;201410;69161;198529;62959;189445;15778;47803;34453;109503;50231;157306
261120;201410;3808;10135;3430;9662;140;446;3048;8607;3188;9053
261130;201410;7364;19059;7030;18685;264;716;6466;17193;6730;17909
261140;201410;3344;9399;3062;8955;534;1727;1924;5538;2458;7265
261150;201410;5853;17269;5274;16423;687;2370;3831;11984;4518;14354
261153;201410;2021;5901;1693;5432;96;368;1368;4420;1464;4788
261160;201410;231174;602515;219520;586346;51728;139212;125772;346218;177500;485430
261170;201410;6253;17350;5770;16664;792;2323;4351;12684;5143;15007
261180;201410;9939;28068;9520;27461;1052;3074;7340;21356;8392;24430
261190;201410;5589;17579;5264;17153;778;3261;3646;11444;4424;14705
261200;201410;4036;9888;3717;9481;564;1419;2686;7000;3250;8419
261210;201410;2036;5339;1944;5223;135;352;1699;4636;1834;4988
261220;201410;13446;42981;11475;38625;2328;8419;5862;19780;8190;28199
261230;201410;4249;13031;3936;12627;179;643;3484;11221;3663;11864
261240;201410;5143;15020;4821;14457;795;2312;3363;10243;4158;12555
261245;201410;3965;12332;3423;11416;274;1138;2538;8502;2812;9640
261247;201410;3606;11013;3081;10040;372;1286;2187;7190;2559;8476
261250;201410;19908;53502;19098;52437;3484;9375;14032;39250;17516;48625
261255;201410;4473;13582;4002;12807;317;1132;3168;10279;3485;11411
261260;201410;12687;35946;11562;34615;699;1894;10066;30792;10765;32686
261270;201410;3874;11303;3567;10820;481;1590;2478;7457;2959;9047
261280;201410;2826;8620;2565;8238;265;940;1946;6263;2211;7203
261290;201410;3155;8909;2830;8503;217;736;2333;7074;2550;7810
261300;201410;10832;35729;9691;33731;1738;6801;5992;20704;7730;27505
261310;201410;8663;26166;8202;25396;2051;6486;4709;14709;6760;21195
261320;201410;6192;19190;5809;18485;582;1836;4479;14552;5061;16388
261330;201410;5677;16653;5460;16330;568;1714;4327;13031;4895;14745
261340;201410;4676;15224;4434;14834;667;2624;2859;9529;3526;12153
261350;201410;8317;27905;7852;27108;627;2607;6219;21296;6846;23903
261360;201410;9653;25033;8753;23817;1152;3245;6210;17211;7362;20456
261370;201410;21643;63970;20383;62005;4486;14247;12437;38092;16923;52339
261380;201410;4305;14714;3976;14106;631;2393;2671;9585;3302;11978
261390;201410;17729;54249;16147;51515;2796;9784;10006;31764;12802;41548
261400;201410;5047;17429;4579;16491;597;2429;3151;11413;3748;13842
261410;201410;8808;25366;8235;24503;1127;3404;6068;18355;7195;21759
261420;201410;8273;27624;7938;27138;2094;7782;4454;15451;6548;23233
261430;201410;3687;11407;3135;10657;392;1346;2316;8057;2708;9403
261440;201410;1717;5277;1576;5065;106;451;1285;4084;1391;4535
261450;201410;14631;41862;14219;41329;811;2448;12767;37204;13578;39652
261460;201410;8590;24793;8026;24005;805;2196;6088;19609;6893;21805
261470;201410;4057;10991;3724;10595;209;646;3231;9167;3440;9813
261480;201410;3610;13173;3359;12716;400;1703;2522;9395;2922;11098
261485;201410;5138;15857;4696;15064;937;3379;2728;8665;3665;12044
261500;201410;5986;16557;5260;15579;639;1700;4019;12424;4658;14124
261510;201410;2123;6699;1983;6489;180;584;1561;5195;1741;5779
261520;201410;2685;8714;2372;8143;179;737;1690;5845;1869;6582
261530;201410;12685;40901;11213;37996;2570;9489;5105;17309;7675;26798
261540;201410;7571;24424;7269;23879;1415;4605;4881;16376;6296;20981
261550;201410;3581;10634;3412;10387;411;1558;2690;7944;3101;9502
261560;201410;7191;23314;6563;22504;1246;4404;4543;15911;5789;20315
261570;201410;3703;11275;3257;10554;521;1756;2176;7100;2697;8856
261580;201410;5942;18732;5301;17693;478;1800;4188;14176;4666;15976
261590;201410;2929;8098;2556;7582;312;989;1839;5555;2151;6544
261600;201410;5385;14784;4600;13672;461;1397;3511;10564;3972;11961
261610;201410;2374;7064;2042;6571;124;506;1662;5234;1786;5740
261618;201410;2621;7437;2460;7223;250;801;1948;5666;2198;6467
261620;201410;4701;14404;4423;13963;646;2085;3057;9871;3703;11956
261630;201410;8261;24096;7095;21936;1256;4437;3980;11921;5236;16358
261640;201410;31144;80957;28735;77927;2083;5506;24125;66683;26208;72189
261650;201410;3898;12303;3649;11936;527;1855;2626;8629;3153;10484
270010;201410;4605;17384;4204;16569;518;2323;2910;11521;3428;13844
270020;201410;4119;12284;3858;11883;466;1643;2935;8911;3401;10554
270030;201410;47014;141853;44569;137950;11546;36286;25523;80694;37069;116980
270040;201410;10533;32548;9996;31920;1700;4863;7388;24635;9088;29498
270050;201410;4135;12002;3834;11610;405;1462;2975;8903;3380;10365
270060;201410;1780;5735;1677;5592;351;1265;1037;3499;1388;4764
270070;201410;4292;13285;3970;12850;203;896;3416;10892;3619;11788
270080;201410;1379;4281;1226;4030;224;827;780;2513;1004;3340
270090;201410;2125;6655;2044;6521;67;256;1859;5889;1926;6145
270100;201410;6551;20272;6258;19874;1297;4325;4140;13120;5437;17445
270110;201410;3512;9906;3221;9570;547;1618;2130;6786;2677;8404
270120;201410;3167;9181;2864;8777;149;514;2491;7701;2640;8215
270130;201410;5365;16652;5068;16306;521;1507;4172;13847;4693;15354
270135;201410;1808;5046;1718;4947;127;206;1538;4617;1665;4823
270140;201410;10047;24993;8862;23460;767;2940;7065;17588;7832;20528
270150;201410;2787;9484;2720;9396;192;725;2393;8290;2585;9015
270160;201410;5174;17280;4757;16762;295;1104;4053;14363;4348;15467
270170;201410;4151;13544;3833;13077;808;3201;2199;7395;3007;10596
270180;201410;2353;7763;2089;7424;157;732;1692;5957;1849;6689
270190;201410;1968;6421;1863;6262;145;585;1471;4971;1616;5556
270200;201410;2808;9435;2624;9135;275;1152;2000;6843;2275;7995
270210;201410;4670;14851;4485;14609;398;1591;3778;12162;4176;13753
270220;201410;1741;5456;1607;5195;321;1157;850;2790;1171;3947
270230;201410;11469;37103;10046;34832;1506;6215;6533;22256;8039;28471
270235;201410;6547;21242;6192;20652;409;1698;5117;16943;5526;18641
270240;201410;10023;29950;8729;28251;1690;5683;5450;17909;7140;23592
270250;201410;3602;9147;3272;8776;176;456;2961;7979;3137;8435
270255;201410;5194;15783;4248;14091;372;1534;3051;9980;3423;11514
270260;201410;6564;20989;6398;20701;858;3163;4812;15650;5670;18813
270270;201410;1243;3577;1143;3428;208;658;690;2031;898;2689
270280;201410;3825;11181;3556;10788;474;1622;2551;7645;3025;9267
270290;201410;8643;30155;8183;29346;884;3716;6340;22566;7224;26282
270300;201410;3460;11792;3253;11548;211;851;2782;9938;2993;10789
270310;201410;7675;23462;6871;22112;422;1898;5626;17669;6048;19567
270320;201410;6605;21165;6384;20798;1450;5368;3780;12307;5230;17675
270330;201410;4963;16309;4653;15892;486;1784;3701;12755;4187;14539
270340;201410;1842;5649;1659;5406;194;677;1255;4159;1449;4836
270350;201410;2132;5859;1972;5657;265;771;1357;4109;1622;4880
270360;201410;2130;6668;2076;6602;241;731;1712;5588;1953;6319
270370;201410;1753;5679;1610;5429;181;683;1090;3793;1271;4476
270375;201410;3096;9198;2822;8785;404;1530;1901;5669;2305;7199
270380;201410;6118;18640;5767;18157;633;2020;4466;14362;5099;16382
270390;201410;1394;3840;1244;3648;161;567;893;2507;1054;3074
270400;201410;6097;18750;5563;17942;498;1907;3995;12691;4493;14598
270410;201410;5182;15952;4907;15434;606;2083;3561;11120;4167;13203
270420;201410;5745;18713;5582;18483;300;1424;4675;15189;4975;16613
270430;201410;143560;419228;136703;409374;36871;111730;74199;229579;111070;341309
270440;201410;5155;15766;4845;15311;381;1398;3843;12253;4224;13651
270450;201410;6798;21106;6543;20781;590;2170;5249;16702;5839;18872
270460;201410;3725;10121;3350;9611;267;915;2733;7718;3000;8633
270470;201410;11491;36670;10819;35541;1699;5603;7163;24227;8862;29830
270480;201410;3196;9988;2862;9400;362;1434;1909;6036;2271;7470
270490;201410;1015;3258;956;3172;90;356;730;2401;820;2757
270500;201410;5484;18675;5227;18332;486;1774;4194;15066;4680;16840
270510;201410;6242;19115;5689;18325;890;3647;4057;12457;4947;16104
270520;201410;3843;12363;3598;11968;881;3187;1906;6417;2787;9604
270530;201410;1582;4635;1401;4401;210;663;957;3104;1167;3767
270540;201410;2112;7222;1936;6965;173;810;1537;5437;1710;6247
270550;201410;7323;21908;6484;20795;1058;3502;4380;14439;5438;17941
270560;201410;3149;9757;2965;9467;511;1912;2069;6406;2580;8318
270570;201410;4378;14144;3990;13532;463;1926;2782;9321;3245;11247
270580;201410;2139;6998;2056;6864;281;987;1547;5247;1828;6234
270590;201410;1465;4915;1374;4757;70;295;1220;4220;1290;4515
270600;201410;2984;9951;2680;9478;237;1157;2050;7057;2287;8214
270610;201410;3339;10535;3096;10175;315;1135;2454;8031;2769;9166
270620;201410;1541;5111;1403;4901;150;696;1085;3675;1235;4371
270630;201410;18707;52303;17409;50257;2557;7455;12433;36480;14990;43935
270640;201410;6195;18919;5545;18086;470;1897;4483;14373;4953;16270
270642;201410;2536;8686;2360;8407;371;1502;1610;5769;1981;7271
270644;201410;2509;7300;2257;7021;176;493;1944;6169;2120;6662
270650;201410;4196;13229;4025;12988;855;3328;2451;7622;3306;10950
270660;201410;2536;6460;1993;5654;148;522;1417;4001;1565;4523
270670;201410;16688;44422;14493;41807;1922;5496;10721;31977;12643;37473
270680;201410;4322;13029;4148;12826;205;573;3722;11653;3927;12226
270690;201410;9357;26257;8628;25391;2839;7988;4320;13629;7159;21617
270700;201410;808;2504;760;2427;140;528;476;1473;616;2001
270710;201410;6015;19894;5748;19538;642;2334;4570;15647;5212;17981
270720;201410;3476;11689;3195;11205;254;1169;2568;8896;2822;10065
270730;201410;6877;21012;6522;20577;937;2964;5029;16147;5966;19111
270740;201410;2509;7210;2355;6997;349;1194;1638;4776;1987;5970
270750;201410;5075;16176;4699;15600;528;1891;3608;12026;4136;13917
270760;201410;3690;11028;3324;10424;375;1253;2459;7751;2834;9004
270770;201410;18855;50870;16037;47422;3172;9592;9918;30256;13090;39848
270780;201410;1987;6409;1849;6194;257;933;1304;4405;1561;5338
270790;201410;1768;5527;1615;5281;353;1268;939;3017;1292;4285
270800;201410;11767;34905;10999;33870;1025;3442;8939;27522;9964;30964
270810;201410;3493;10726;2833;9512;370;1440;1788;6010;2158;7450
270820;201410;1928;6452;1742;6121;290;1155;1135;3974;1425;5129
270830;201410;5607;16879;5086;16223;1036;3717;3282;10497;4318;14214
270840;201410;7804;26148;7102;25256;460;2191;5976;20963;6436;23154
270850;201410;7789;25441;7602;25213;1423;5681;5239;16656;6662;22337
270860;201410;11814;35446;10992;34323;1724;6246;7872;24041;9596;30287
270870;201410;2366;6941;1919;6000;313;1029;1158;3630;1471;4659
270880;201410;8059;26251;7603;25584;589;2471;6243;20712;6832;23183
270890;201410;2740;8295;2538;7952;416;1529;1753;5359;2169;6888
270895;201410;3100;11404;2941;11194;253;1040;2443;9410;2696;10450
270900;201410;1962;5347;1592;4814;110;414;1206;3574;1316;3988
270910;201410;3360;11558;3271;11385;336;1516;2576;8694;2912;10210
270915;201410;10223;34502;9264;32774;1779;7205;5407;18913;7186;26118
270920;201410;6618;20450;6220;19895;287;1303;5490;17354;5777;18657
270930;201410;17800;48217;14765;44419;2733;8748;9065;27940;11798;36688
270940;201410;6021;20252;5748;19934;675;2635;4454;15491;5129;18126
280010;201410;736;2172;643;2022;73;292;416;1271;489;1563
280020;201410;5177;15338;4552;14205;876;2880;2816;8803;3692;11683
280030;201410;77193;204505;68096;190743;17610;51480;33869;96530;51479;148010
280040;201410;3298;10220;2938;9710;360;1198;2175;7404;2535;8602
280050;201410;4169;13359;3873;12879;1271;4383;1761;6050;3032;10433
280060;201410;4466;14851;4193;14385;894;3271;2478;8614;3372;11885
280067;201410;7872;22207;6697;20597;785;2516;4930;15251;5715;17767
280070;201410;1997;6745;1901;6598;354;1289;1310;4605;1664;5894
280100;201410;4130;12916;3690;12130;977;3299;1795;6081;2772;9380
280110;201410;1466;4426;1346;4231;83;320;1117;3489;1200;3809
280120;201410;7728;24725;7142;23786;1084;3342;5112;17841;6196;21183
280130;201410;7970;22625;7405;21789;1224;3999;4944;14461;6168;18460
280140;201410;5829;15858;5272;15102;579;1653;4082;11850;4661;13503
280150;201410;3580;10970;3288;10427;512;1872;2161;6636;2673;8508
280160;201410;1560;4439;1405;4206;174;592;1017;3031;1191;3623
280170;201410;4822;14357;4362;13711;506;1514;3383;10970;3889;12484
280190;201410;1203;3413;1065;3191;98;385;774;2215;872;2600
280200;201410;1151;3539;1053;3388;173;692;722;2224;895;2916
280210;201410;13787;42570;12704;41010;2557;8394;8181;27257;10738;35651
280220;201410;1634;4976;1535;4835;109;404;1300;4079;1409;4483
280230;201410;3938;11502;3525;10818;664;2041;2105;6650;2769;8691
280240;201410;3585;10622;3260;10114;280;843;2577;8108;2857;8951
280250;201410;861;2280;726;2072;140;467;436;1148;576;1615
280260;201410;2122;5585;1936;5355;119;319;1683;4695;1802;5014
280270;201410;2316;7180;2021;6698;139;550;1580;5163;1719;5713
280280;201410;4213;13812;3899;13294;956;2776;2176;8314;3132;11090
280290;201410;17656;55330;16021;52658;2694;9553;10471;34879;13165;44432
280300;201410;10356;31494;9551;30572;823;2765;7929;25766;8752;28531
280310;201410;1500;4223;1304;3915;115;435;889;2590;1004;3025
280320;201410;8250;27188;7608;26033;1472;5600;4167;14268;5639;19868
280330;201410;5017;14064;4622;13511;582;1880;3538;10300;4120;12180
280340;201410;3905;11466;3692;11182;335;1108;2931;9030;3266;10138
280350;201410;22473;64780;20731;62179;2814;8669;14803;45155;17617;53824
280360;201410;6065;19123;5719;18584;1172;4285;3437;11023;4609;15308
280370;201410;2029;5765;1827;5447;210;714;1340;3930;1550;4644
280380;201410;1042;3165;956;3052;108;417;741;2335;849;2752
280390;201410;3388;9907;2933;9078;596;1776;1786;5623;2382;7399
280400;201410;4637;13292;4223;12736;974;2779;2643;8396;3617;11175
280410;201410;2452;7935;2148;7331;400;1560;1181;3880;1581;5440
280420;201410;4417;12618;4084;12112;255;794;3531;10540;3786;11334
280430;201410;2324;6054;2143;5832;153;519;1790;4841;1943;5360
280440;201410;5212;15158;4858;14729;460;1367;4054;12480;4514;13847
280445;201410;2530;7224;2314;6853;105;400;1908;5557;2013;5957
280450;201410;9290;25089;8545;24197;747;1698;7145;21033;7892;22731
280460;201410;7394;19682;6586;18563;973;2867;4703;13484;5676;16351
280470;201410;1917;5704;1731;5425;215;685;1270;4035;1485;4720
280480;201410;32241;96482;30854;94456;5210;18102;20743;62283;25953;80385
280490;201410;3848;11771;3429;10981;377;1354;2469;7870;2846;9224
280500;201410;882;2383;830;2316;27;86;748;2071;775;2157
280510;201410;2807;8218;2419;7700;302;1093;1800;5765;2102;6858
280520;201410;1777;5066;1632;4875;189;486;1284;3999;1473;4485
280530;201410;2317;6795;2166;6604;224;735;1753;5401;1977;6136
280540;201410;9595;25871;8969;25037;353;1170;8001;22222;8354;23392
280550;201410;6797;18500;5910;17081;659;2105;4301;12338;4960;14443
280560;201410;8167;23988;7653;23168;602;1972;6222;18796;6824;20768
280570;201410;7037;19479;6314;18543;841;2778;4479;13121;5320;15899
280580;201410;5548;17189;4703;15715;897;3033;2886;9946;3783;12979
280590;201410;2446;7418;2228;7150;291;1222;1605;5056;1896;6278
280600;201410;4122;12602;3844;12143;426;1545;2785;8745;3211;10290
280610;201410;2561;7242;2364;6956;305;1045;1648;4748;1953;5793
280620;201410;5380;16300;4761;15114;817;2525;3096;10085;3913;12610
280630;201410;3878;12646;3692;12365;391;1167;2981;10356;3372;11523
280640;201410;2309;6696;2161;6525;104;235;1986;6123;2090;6358
280650;201410;1184;3661;1066;3451;166;592;714;2319;880;2911
280660;201410;2728;7893;2607;7716;381;1133;2053;6099;2434;7232
280670;201410;15398;40767;14446;39465;2168;6137;10250;28049;12418;34186
280680;201410;2922;7746;2489;7138;161;517;2076;5955;2237;6472
280690;201410;1036;2939;890;2728;134;434;598;1813;732;2247
280700;201410;1195;3504;1038;3270;106;322;755;2437;861;2759
280710;201410;11455;30979;10640;30009;805;2067;9044;25899;9849;27966
280720;201410;2448;6625;2156;6294;255;771;1595;4754;1850;5525
280730;201410;974;2922;928;2858;75;225;786;2466;861;2691
280740;201410;13363;36256;11567;33601;1847;5234;7750;23139;9597;28373
280750;201410;3641;11170;3322;10601;329;1255;2385;7549;2714;8804
280760;201410;5942;18282;5419;17584;730;2365;3951;13318;4681;15683
290010;201410;3100;6937;2217;5571;69;281;1774;4220;1843;4501
290020;201410;5012;15866;4575;15415;393;1104;3972;13765;4365;14869
290030;201410;3373;10617;3221;10382;457;1561;2406;7733;2863;9294
290035;201410;4794;12617;4268;11946;312;925;3485;9995;3797;10920
290040;201410;3910;11225;3515;10762;267;1024;2863;8648;3130;9672
290050;201410;2772;9017;2578;8717;240;920;1982;6727;2222;7647
290060;201410;1360;3462;1137;3189;204;652;812;2216;1016;2868
290070;201410;32071;83218;27594;77607;5965;16935;15150;44824;21115;61759
290080;201410;6155;18649;5371;17633;665;2199;4030;13621;4695;15820
290090;201410;2311;5068;1849;4585;201;480;1523;3858;1724;4338
290100;201410;10454;29830;9223;27823;1637;4954;5718;17919;7355;22873
290110;201410;5427;16332;5198;15950;881;2984;3536;10693;4417;13677
290115;201410;5093;15096;4457;14252;353;1200;3476;11316;3829;12516
290120;201410;7093;19085;6439;18281;419;1194;5566;15889;5985;17083
290130;201410;4647;12247;3981;11434;343;1118;3192;9066;3535;10184
290135;201410;5353;13623;4645;12514;445;1431;3189;8456;3634;9887
290140;201410;4165;13207;3627;12508;327;1192;3006;10437;3333;11629
290150;201410;2143;6377;2045;6234;170;532;1742;5340;1912;5872
290160;201410;3588;9704;3494;9589;278;519;3116;8820;3394;9339
290170;201410;2905;9685;2672;9318;247;978;2217;7740;2464;8718
290180;201410;3124;8926;2734;8342;283;967;2027;6220;2310;7187
290190;201410;4207;13915;4068;13679;448;1559;3086;10507;3534;12066
290195;201410;2255;6255;1922;5756;149;530;1516;4549;1665;5079
290200;201410;3933;12588;3584;11985;379;1327;2727;9187;3106;10514
290205;201410;3068;9493;2803;9075;364;1421;2015;6377;2379;7798
290210;201410;15772;43668;14661;42314;2820;7059;9927;30926;12747;37985
290220;201410;2486;7510;2374;7337;274;1012;1756;5297;2030;6309
290225;201410;3141;8318;2937;8101;179;355;2646;7514;2825;7869
290230;201410;2421;7966;2362;7889;218;771;1985;6691;2203;7462
290240;201410;3975;10484;3587;9942;372;1116;2712;7413;3084;8529
290250;201410;3913;12355;3325;11442;283;1009;2587;9047;2870;10056
290260;201410;5051;15009;4491;14160;449;1552;3500;11059;3949;12611
290265;201410;3509;11242;3276;10837;311;1193;2512;8307;2823;9500
290270;201410;12627;45484;11827;44258;1694;6646;8579;32690;10273;39336
290280;201410;5352;17537;5040;16981;510;1824;3776;12986;4286;14810
290290;201410;9898;31829;9021;30375;1624;5605;5944;20493;7568;26098
290300;201410;4468;12818;3184;10401;256;830;2198;7459;2454;8289
290310;201410;1592;4744;1431;4493;249;862;880;2732;1129;3594
290320;201410;27980;85019;24549;80382;5782;19991;13934;46491;19716;66482
290323;201410;4214;11195;3488;10415;219;741;2981;8868;3200;9609
290327;201410;4180;13285;3817;12596;646;2212;2504;8294;3150;10506
290330;201410;1987;5147;1870;5018;219;658;1543;4094;1762;4752
290340;201410;4865;15443;4530;14994;1211;3967;2579;8784;3790;12751
290350;201410;5098;15317;4215;14119;590;2009;2870;9890;3460;11899
290360;201410;4424;13748;3885;13004;218;778;3312;11235;3530;12013
290370;201410;4747;13873;4317;13345;453;1382;3535;11098;3988;12480
290380;201410;5688;16585;4991;15561;425;1409;3966;12440;4391;13849
290390;201410;15795;49466;14755;47761;3043;9614;9061;30705;12104;40319
290395;201410;2833;9141;2548;8646;228;944;1925;6517;2153;7461
290400;201410;3786;11377;3322;10728;375;1247;2516;8163;2891;9410
290405;201410;4578;14667;3980;13605;502;1766;2667;9396;3169;11162
290410;201410;6204;18365;5191;16865;592;2339;3718;11803;4310;14142
290420;201410;3422;10048;2834;9215;275;1015;2214;7163;2489;8178
290430;201410;3603;11244;3220;10642;666;2323;1976;6610;2642;8933
290440;201410;3169;8312;2546;7485;241;780;1991;5928;2232;6708
290450;201410;3688;10718;3220;10051;545;1741;2115;6719;2660;8460
290460;201410;13920;42060;12799;40170;3746;12445;5690;17767;9436;30212
290470;201410;4865;13428;3803;11989;864;3015;1988;6422;2852;9437
290475;201410;5077;17652;4605;16800;564;2342;3263;11923;3827;14265
290480;201410;2694;7036;2375;6606;386;1123;1576;4465;1962;5588
290485;201410;4986;15824;4423;14992;462;2017;3466;11592;3928;13609
290490;201410;8421;22418;8102;21997;735;2130;6673;18087;7408;20217
290500;201410;4696;14871;3945;13456;801;2962;1960;6634;2761;9596
290510;201410;3537;10276;3082;9646;237;870;2478;7786;2715;8656
290515;201410;3024;9198;2784;8846;261;819;2182;7100;2443;7919
290520;201410;11992;37117;9753;32985;1027;4191;6264;20998;7291;25189
290530;201410;5438;15620;4649;14490;422;1354;3698;11595;4120;12949
290540;201410;4030;11667;3831;11414;458;1276;3022;9248;3480;10524
290550;201410;4488;12147;3947;11491;171;501;3553;10418;3724;10919
290560;201410;6160;18326;5405;17216;1204;4074;3105;10100;4309;14174
290570;201410;41860;120764;39227;116816;5025;15944;28651;84839;33676;100783
290580;201410;7536;26023;7207;25522;1334;4672;4973;18162;6307;22834
290590;201410;7783;24433;6510;22292;467;1932;5104;17428;5571;19360
290600;201410;18789;57431;17356;55145;3183;9857;11146;37030;14329;46887
290610;201410;2466;8463;2084;7704;205;959;1515;5482;1720;6441
290620;201410;7314;21700;6527;20559;486;1643;5376;17020;5862;18663
290630;201410;8486;22712;7475;21637;843;2406;6070;17812;6913;20218
290640;201410;2783;8215;2309;7413;242;825;1650;5317;1892;6142
290650;201410;12188;35916;11440;34832;2801;8476;6929;21780;9730;30256
290660;201410;3838;10565;3139;9568;216;745;2479;7615;2695;8360
290670;201410;7213;22033;6542;20978;851;2649;4822;15969;5673;18618
290680;201410;10340;30677;9470;29636;597;2018;7944;25059;8541;27077
290682;201410;4630;13518;4162;12869;201;781;3468;10616;3669;11397
290685;201410;3408;8646;2518;7398;324;1026;1538;4616;1862;5642
290687;201410;8468;22812;6674;20559;1494;4832;3751;11855;5245;16687
290689;201410;3216;9203;2714;8416;251;822;2121;6673;2372;7495
290690;201410;5664;16446;5152;15794;548;1745;4093;12654;4641;14399
290700;201410;2295;7205;2191;7051;207;755;1728;5560;1935;6315
290710;201410;7977;25341;7378;24431;480;1565;6337;21250;6817;22815
290720;201410;19426;56732;17326;54159;1796;5123;14168;45625;15964;50748
290730;201410;7509;20936;6824;20046;1202;3458;4679;13966;5881;17424
290740;201410;968;2884;819;2640;119;400;527;1734;646;2134
290750;201410;10568;30213;9084;27525;1769;6147;4968;14287;6737;20434
290755;201410;2468;6928;2048;6224;132;477;1586;4795;1718;5272
290760;201410;4587;13454;3739;12165;414;1291;2670;8823;3084;10114
290770;201410;2674;9317;2478;9062;138;628;2025;7463;2163;8091
290780;201410;9186;23763;8120;22313;858;1978;6270;17889;7128;19867
290790;201410;4898;14459;4542;13955;421;1244;3613;11445;4034;12689
290800;201410;7636;16439;5854;14545;835;1827;4457;11562;5292;13389
290810;201410;5132;16299;4423;15169;332;1253;3350;11627;3682;12880
290820;201410;5591;15980;4997;15186;485;1649;3864;11766;4349;13415
290830;201410;4314;12082;4024;11630;284;1109;3224;9011;3508;10120
290840;201410;18346;51723;16673;49417;2732;7738;11495;35590;14227;43328
290850;201410;6964;20592;6812;20372;1134;3276;5123;15838;6257;19114
290860;201410;5056;17641;4722;17221;718;2639;3475;13072;4193;15711
290870;201410;4956;14780;4112;13582;442;1754;2986;9769;3428;11523
290880;201410;1454;4041;1196;3627;111;347;826;2529;937;2876
290890;201410;7130;18997;6214;17957;751;2152;4888;14337;5639;16489
290900;201410;2523;7326;1890;6262;298;1076;995;3275;1293;4351
290910;201410;5028;13741;4295;12688;263;843;3600;10688;3863;11531
290920;201410;4981;14600;4493;13932;326;916;3713;11727;4039;12643
290930;201410;7808;24792;7000;23396;702;2739;5208;17171;5910;19910
290940;201410;3635;11568;3385;11243;288;952;2867;9734;3155;10686
290950;201410;1596;4500;1433;4266;208;623;988;3010;1196;3633
290960;201410;6144;17365;5605;16652;401;1217;4561;13713;4962;14930
290970;201410;3799;12191;3434;11545;489;1626;2223;7728;2712;9354
290980;201410;10972;32398;9563;29681;2731;8905;3756;11568;6487;20473
290990;201410;9426;28294;8279;26421;949;3195;6193;19768;7142;22963
291000;201410;3327;9951;3054;9596;347;1114;2418;7723;2765;8837
291005;201410;14521;39933;13014;37789;2131;6480;8896;26185;11027;32665
291010;201410;3206;10277;2575;8872;317;1158;1643;5723;1960;6881
291020;201410;1446;3820;1113;3239;139;477;667;1855;806;2332
291030;201410;2312;6345;1734;5191;183;615;1080;3158;1263;3773
291040;201410;5823;17822;5296;17071;666;2343;3944;12734;4610;15077
291050;201410;8190;27164;7447;25741;2031;7633;3693;12661;5724;20294
291060;201410;6429;23526;6089;23061;893;3843;4352;16434;5245;20277
291070;201410;16852;49128;15367;47015;1726;5283;11543;35947;13269;41230
291072;201410;23036;70072;19407;62854;5934;20393;7535;25156;13469;45549
291075;201410;5413;15467;4903;14785;392;1077;3785;11804;4177;12881
291077;201410;1599;4615;1323;4177;165;595;868;2712;1033;3307
291080;201410;85266;263385;75856;245932;24298;81300;27635;88766;51933;170066
291085;201410;5899;15671;5120;14629;574;1705;3997;11515;4571;13220
291090;201410;1526;3801;1336;3559;107;408;1094;2809;1201;3217
291100;201410;2723;7117;2229;6607;122;463;1879;5565;2001;6028
291110;201410;5209;18527;4661;17673;662;2868;3235;12125;3897;14993
291120;201410;7764;20785;7215;20000;936;2652;5426;15154;6362;17806
291125;201410;1783;3811;1433;3441;146;359;1091;2696;1237;3055
291130;201410;3056;9372;2652;8690;246;959;1907;6169;2153;7128
291140;201410;4288;12775;3877;12019;579;1829;2642;8257;3221;10086
291150;201410;2041;5344;1943;5228;181;509;1513;4053;1694;4562
291160;201410;5671;17483;4942;16346;1255;4188;2706;9123;3961;13311
291165;201410;2549;7402;2011;6380;122;534;1453;4471;1575;5005
291170;201410;21417;55612;18432;51854;1142;3845;14704;41130;15846;44975
291180;201410;6642;17409;5360;15561;630;2043;3804;10950;4434;12993
291185;201410;3984;10817;3689;10420;322;971;3055;8608;3377;9579
291190;201410;7687;21197;6859;20183;794;2364;5322;15964;6116;18328
291200;201410;2797;8483;2312;7588;183;638;1687;5609;1870;6247
291210;201410;7749;18271;6691;17066;549;1460;5411;13846;5960;15306
291220;201410;4333;13795;4055;13321;571;2080;2892;9412;3463;11492
291230;201410;4129;10673;3715;10196;121;302;3399;9431;3520;9733
291240;201410;5015;13412;4233;12044;264;797;3398;9557;3662;10354
291250;201410;3844;11481;3025;10097;335;1157;2060;6973;2395;8130
291260;201410;1189;3487;1102;3364;113;390;848;2577;961;2967
291270;201410;4376;14538;4033;13909;1134;4079;2201;7731;3335;11810
291280;201410;2488;6499;1877;5669;471;1484;1032;3109;1503;4593
291290;201410;6072;17037;5428;16224;894;2672;3549;10932;4443;13604
291300;201410;4672;13610;3915;12348;485;1724;2699;8432;3184;10156
291310;201410;5610;15988;4876;14747;413;1303;3759;11388;4172;12691
291320;201410;6319;20117;5433;18409;1299;4838;2873;9589;4172;14427
291330;201410;1727;5215;1578;4979;221;804;1036;3160;1257;3964
291340;201410;4151;12001;3326;10818;281;1044;2608;8450;2889;9494
291345;201410;3604;11639;3388;11404;215;695;2987;10290;3202;10985
291350;201410;5927;17581;5284;16543;443;1489;3960;12539;4403;14028
291360;201410;36683;105224;33905;101116;8628;25429;19872;61427;28500;86856
291370;201410;9289;27001;8887;26466;961;2785;6880;21019;7841;23804
291380;201410;3923;12057;3386;11171;279;966;2495;8434;2774;9400
291390;201410;10815;29828;9846;28685;1422;3984;7427;22015;8849;25999
291400;201410;17475;45645;14251;41333;2416;6986;9120;27506;11536;34492
291410;201410;3402;8857;2516;7570;191;768;1903;5563;2094;6331
291420;201410;2294;6074;2021;5748;117;332;1793;5152;1910;5484
291430;201410;3480;10106;3065;9566;243;967;2409;7385;2652;8352
291440;201410;6335;19795;5418;18170;562;1973;4086;13861;4648;15834
291450;201410;7934;24223;7067;22937;348;1120;5897;19579;6245;20699
291460;201410;13888;41822;12350;39471;2234;7605;7952;25595;10186;33200
291465;201410;8634;24844;7827;23915;773;2551;6360;19485;7133;22036
291470;201410;16324;44816;14395;42421;1472;4224;10874;33206;12346;37430
291480;201410;36853;99030;32693;93295;5072;16095;21588;61273;26660;77368
291490;201410;4617;15066;4497;14906;461;1504;3733;12580;4194;14084
291500;201410;4311;12505;3696;11615;292;1068;2932;9182;3224;10250
291510;201410;3762;11374;3457;10968;150;475;3108;9968;3258;10443
291520;201410;4171;11189;3634;10457;528;1493;2403;7169;2931;8662
291530;201410;2177;6295;1850;5783;473;1576;958;3082;1431;4658
291535;201410;4480;12931;4026;12267;335;1058;3100;9765;3435;10823
291540;201410;2314;5527;1967;5164;179;371;1670;4532;1849;4903
291550;201410;5800;15582;5198;14752;1236;3451;2988;8668;4224;12119
291560;201410;18049;45390;13891;40649;1317;3882;10780;32368;12097;36250
291570;201410;2528;6714;2396;6556;170;390;2138;5979;2308;6369
291580;201410;5666;17395;5033;16454;624;2480;3612;11723;4236;14203
291590;201410;2049;6335;1840;5993;283;958;1225;4145;1508;5103
291600;201410;5682;15686;4238;13536;1033;3626;2036;6389;3069;10015
291610;201410;5317;15975;5152;15755;363;1177;4417;13625;4780;14802
291620;201410;3186;7542;2623;6943;192;482;2081;5723;2273;6205
291630;201410;3269;8156;2833;7655;298;782;2269;6241;2567;7023
291640;201410;18378;49952;15112;45551;4134;13221;6056;18619;10190;31840
291650;201410;8417;24853;7715;24015;687;1730;6473;20877;7160;22607
291660;201410;2522;6567;2163;6064;251;842;1478;3981;1729;4823
291670;201410;2543;7002;2341;6688;374;1075;1401;4276;1775;5351
291680;201410;5120;14460;4589;13607;1112;3626;2250;6909;3362;10535
291685;201410;4815;11968;4046;10980;565;1497;2881;8090;3446;9587
291690;201410;4142;11268;3403;10109;325;952;2414;7261;2739;8213
291700;201410;9768;30259;8936;28860;1060;3524;6607;21731;7667;25255
291710;201410;6281;16481;5406;15356;913;2702;3436;10227;4349;12929
291720;201410;4231;14237;3680;13102;409;1675;2626;9238;3035;10913
291730;201410;6268;19373;5767;18718;954;3270;4102;13586;5056;16856
291733;201410;2693;7876;2272;7315;315;1098;1532;4957;1847;6055
291735;201410;2562;7322;2178;6732;127;467;1769;5400;1896;5867
291740;201410;4138;11958;3303;10681;357;1299;2357;7612;2714;8911
291750;201410;22955;59708;17930;52108;4020;12150;9468;27993;13488;40143
291760;201410;12870;40218;11583;37927;4472;16159;4090;13267;8562;29426
291770;201410;8318;23936;7416;22380;1195;3924;4888;14552;6083;18476
291780;201410;4473;13678;4188;13161;451;1424;3248;10248;3699;11672
291790;201410;2609;8061;2465;7862;120;492;2137;6750;2257;7242
291800;201410;33487;95036;29901;89955;5975;18423;18310;56757;24285;75180
291810;201410;11317;31575;9567;29478;629;2240;7811;24186;8440;26426
291820;201410;3807;11275;3420;10712;301;967;2705;8557;3006;9524
291830;201410;4542;12195;4197;11698;493;1450;3187;8933;3680;10383
291835;201410;6407;19801;5179;17678;1313;4832;2917;9918;4230;14750
291840;201410;51122;139355;43334;130884;5588;16241;33020;102871;38608;119112
291845;201410;3091;8858;2767;8472;229;630;2412;7526;2641;8156
291850;201410;4923;13777;4103;12608;465;1365;3069;9735;3534;11100
291855;201410;1782;4639;1537;4319;185;642;1137;3083;1322;3725
291860;201410;2126;6264;1808;5646;181;649;1191;3673;1372;4322
291870;201410;1444;3853;1099;3237;125;423;688;2009;813;2432
291875;201410;2958;9367;2661;8904;231;965;1920;6300;2151;7265
291880;201410;4845;15394;4564;14952;346;1151;3816;12616;4162;13767
291890;201410;1453;3642;1228;3370;306;855;734;2087;1040;2942
291900;201410;1356;3794;1152;3476;108;378;889;2666;997;3044
291905;201410;3052;8036;2519;7171;215;685;1809;5194;2024;5879
291910;201410;2772;7450;2352;6943;178;639;1939;5683;2117;6322
291915;201410;7099;21707;6166;19953;506;1702;4985;16337;5491;18039
291920;201410;33430;97812;30755;93787;6335;19942;18385;57392;24720;77334
291930;201410;2662;7867;2390;7437;251;873;1764;5479;2015;6352
291940;201410;3641;10363;2694;8665;419;1533;1495;4630;1914;6163
291950;201410;9510;31860;8623;30400;1855;6528;4922;17932;6777;24460
291955;201410;9347;29307;8889;28648;2137;6835;5265;17687;7402;24522
291960;201410;3442;10169;2883;9348;336;1008;2078;7078;2414;8086
291970;201410;4455;13371;3964;12739;572;1949;2763;8983;3335;10932
291980;201410;11746;33822;8977;29820;974;3404;6418;21798;7392;25202
291990;201410;2354;7167;2135;6846;177;599;1652;5419;1829;6018
291992;201410;2934;9016;2860;8867;446;1468;2097;6450;2543;7918
291995;201410;2205;6473;1966;6123;245;808;1473;4640;1718;5448
292000;201410;2288;6707;2036;6341;317;1139;1430;4384;1747;5523
292010;201410;6585;16783;5024;14491;498;1448;3842;11150;4340;12598
292020;201410;4630;15475;4294;14931;696;2528;2996;10597;3692;13125
292030;201410;2261;6997;2010;6642;262;943;1253;4170;1515;5113
292040;201410;4789;13180;4212;12578;331;864;3575;11090;3906;11954
292045;201410;2836;9693;2792;9627;98;333;2627;9063;2725;9396
292050;201410;6540;20318;5715;18674;573;2264;3866;12447;4439;14711
292060;201410;11773;32153;11073;31264;1074;2941;9038;25736;10112;28677
292070;201410;4558;14365;4422;14192;411;1225;3748;12196;4159;13421
292080;201410;3813;9814;3257;9104;284;825;2619;7402;2903;8227
292090;201410;4382;11506;3737;10776;323;1067;3056;8860;3379;9927
292100;201410;11265;31060;9508;28612;2737;8543;4319;13586;7056;22129
292105;201410;3276;10003;2831;9355;224;882;2265;7468;2489;8350
292110;201410;7266;19122;5567;16584;1225;3699;3181;9769;4406;13468
292120;201410;8801;24475;7742;22614;1654;4870;4060;12594;5714;17464
292130;201410;3198;8589;2840;8081;557;1489;1865;5469;2422;6958
292140;201410;5625;14437;4853;13386;943;2526;3019;8734;3962;11260
292145;201410;2774;8464;2526;8078;210;658;1915;6400;2125;7058
292150;201410;13863;42069;12826;40426;910;3247;10082;32151;10992;35398
292160;201410;2843;8120;2447;7597;165;482;2085;6614;2250;7096
292170;201410;9367;27002;7957;24599;1146;3932;5014;15604;6160;19536
292180;201410;3633;10392;2900;9232;443;1394;1868;6079;2311;7473
292190;201410;3434;9646;2905;8884;585;1881;1821;5654;2406;7535
292200;201410;6563;21398;5753;19812;1683;6236;2451;8426;4134;14662
292205;201410;4123;12654;3718;12089;269;1006;3006;9774;3275;10780
292210;201410;6875;19074;5828;17672;550;1790;4551;14032;5101;15822
292220;201410;2013;5593;1854;5373;389;1072;1128;3314;1517;4386
292225;201410;3203;9904;2943;9521;189;681;2436;7955;2625;8636
292230;201410;6466;19450;6158;18966;553;2207;4749;14148;5302;16355
292240;201410;4528;14218;4139;13384;618;2134;2626;8396;3244;10530
292250;201410;5360;16503;4978;15791;1201;3927;2543;8108;3744;12035
292260;201410;3264;9955;3114;9732;297;987;2522;7904;2819;8891
292265;201410;2917;9400;2621;8872;192;772;1990;6686;2182;7458
292270;201410;4260;11049;3388;10033;247;890;2776;8210;3023;9100
292273;201410;2871;6968;2212;6148;291;752;1605;4717;1896;5469
292275;201410;1939;5042;1738;4734;209;615;1289;3489;1498;4104
292280;201410;2116;6280;1916;6062;201;486;1496;5084;1697;5570
292285;201410;2715;7500;2371;7007;208;688;1849;5539;2057;6227
292290;201410;7633;22632;6380;20949;467;1745;5008;16656;5475;18401
292300;201410;9044;27189;7783;25713;1944;6569;4740;16163;6684;22732
292303;201410;2949;9106;2743;8825;132;504;2369;7599;2501;8103
292305;201410;3256;8773;3082;8541;129;387;2766;7691;2895;8078
292310;201410;6209;18219;5656;17457;242;871;4798;14818;5040;15689
292320;201410;6528;19103;5673;17657;570;1949;4357;13556;4927;15505
292330;201410;2090;5813;1954;5623;191;616;1549;4401;1740;5017
292335;201410;5499;14364;4904;13583;522;1400;3961;11117;4483;12517
292340;201410;6773;19118;5738;17443;655;2042;4016;12322;4671;14364
292350;201410;2236;6744;2048;6496;234;859;1608;5083;1842;5942
292360;201410;5157;14615;4955;14079;182;513;4397;12747;4579;13260
292370;201410;9409;27348;8511;26024;1131;3266;6084;19462;7215;22728
292380;201410;7651;22202;7118;21362;564;1574;5867;17856;6431;19430
292390;201410;3831;8610;3371;8111;113;187;3146;7677;3259;7864
292400;201410;22604;67174;21517;65437;3309;10550;15170;46919;18479;57469
292405;201410;4683;12093;3973;11205;279;781;3285;9353;3564;10134
292410;201410;1991;5335;1883;5211;143;381;1645;4585;1788;4966
292420;201410;3922;12545;3757;12338;170;461;3416;11462;3586;11923
292430;201410;5748;17160;4515;15420;318;1295;3411;11609;3729;12904
292440;201410;8828;28941;8166;27968;305;1200;7165;24886;7470;26086
292450;201410;4486;13274;3637;11915;360;1248;2615;8727;2975;9975
292460;201410;5765;17168;5049;15898;979;3233;3122;9904;4101;13137
292465;201410;2545;7604;2126;6925;230;858;1508;4945;1738;5803
292467;201410;2091;6794;1980;6606;366;1310;1325;4472;1691;5782
292470;201410;3294;8733;2705;7796;238;794;2043;5828;2281;6622
292480;201410;6569;17289;5638;16029;338;1095;4795;13610;5133;14705
292490;201410;2407;6612;2011;6033;180;634;1560;4626;1740;5260
292500;201410;6782;20241;5869;18673;712;2429;4124;13307;4836;15736
292510;201410;13692;38896;12040;36545;1224;3928;9285;28660;10509;32588
292520;201410;6160;18451;5543;17472;1568;5012;2840;9088;4408;14100
292525;201410;5698;14859;4944;13972;368;1093;4059;11609;4427;12702
292530;201410;27358;80475;24578;76778;6108;19637;13633;44097;19741;63734
292540;201410;2996;8524;2688;8106;333;1138;2044;6165;2377;7303
292550;201410;6913;21996;6094;20838;826;3014;4395;15364;5221;18378
292560;201410;4287;11772;3655;10925;296;1084;2940;8637;3236;9721
292570;201410;4189;12365;4022;12188;159;447;3567;11183;3726;11630
292575;201410;6334;21390;6148;21080;913;3253;4654;15991;5567;19244
292580;201410;7230;21395;6677;20687;541;1674;5539;17397;6080;19071
292590;201410;7567;23428;7212;22849;822;2713;5527;17550;6349;20263
292593;201410;3345;8704;2822;7936;268;760;2201;6189;2469;6949
292595;201410;6259;17299;5443;16231;501;1592;4187;12606;4688;14198
292600;201410;10926;30870;10136;29859;974;2313;8289;25275;9263;27588
292610;201410;4492;12959;3650;11550;428;1410;2424;7862;2852;9272
292620;201410;6061;17794;5265;16862;219;711;4789;15474;5008;16185
292630;201410;10125;25614;8703;23491;854;2362;6506;17899;7360;20261
292640;201410;8583;27288;7626;26003;630;2289;5894;20549;6524;22838
292650;201410;5148;13888;4913;13577;500;987;4083;11950;4583;12937
292660;201410;11532;34592;10825;33572;1282;4098;8268;26123;9550;30221
292665;201410;2720;8113;2650;8010;65;158;2519;7689;2584;7847
292670;201410;4005;11277;3093;9732;310;1074;2028;6409;2338;7483
292680;201410;3773;11336;3507;10930;412;1218;2746;8663;3158;9881
292690;201410;3476;9339;2474;7762;294;989;1663;5330;1957;6319
292700;201410;9575;28467;8278;26585;1183;3544;5788;19448;6971;22992
292710;201410;2002;6570;1901;6423;84;311;1706;5794;1790;6105
292720;201410;9948;25432;8689;23998;701;1951;7305;20416;8006;22367
292730;201410;3670;11056;3527;10845;453;1400;2601;8132;3054;9532
292740;201410;375251;1038433;355288;1009311;80658;241192;216283;613823;296941;855015
292750;201410;6437;17363;5611;16226;396;1163;4592;13456;4988;14619
292760;201410;4316;13684;3940;13020;564;1988;2603;8729;3167;10717
292770;201410;6286;19095;5857;18411;1304;4113;3603;11689;4907;15802
292780;201410;1938;4682;1516;4154;180;612;1100;2957;1280;3569
292790;201410;3528;9174;3367;9001;233;488;2926;8124;3159;8612
292800;201410;9798;29296;9088;28138;846;2907;7146;22066;7992;24973
292805;201410;3295;9499;2996;9075;559;1816;2020;6124;2579;7940
292810;201410;10335;30953;8637;28646;1193;4089;6201;21075;7394;25164
292820;201410;7696;21882;5597;18855;401;1572;4462;15094;4863;16666
292830;201410;1954;5753;1775;5503;101;409;1487;4553;1588;4962
292840;201410;7760;24617;7274;23944;407;1528;6375;20922;6782;22450
292850;201410;3327;8820;2742;7951;303;945;1986;5703;2289;6648
292860;201410;15663;42512;14950;41556;1873;5359;11564;32332;13437;37691
292870;201410;20337;56145;17755;52144;2966;9552;10721;31141;13687;40693
292880;201410;12511;36520;11200;34550;1500;5033;7625;23341;9125;28374
292890;201410;5940;20124;5329;18983;972;3675;3169;11531;4141;15206
292895;201410;2823;7051;2249;6189;316;880;1608;4410;1924;5290
292900;201410;3155;9764;2977;9485;365;1438;2073;6372;2438;7810
292905;201410;4413;12689;3678;11751;266;742;3063;10076;3329;10818
292910;201410;5305;16182;4819;15292;838;2886;2985;9389;3823;12275
292920;201410;9030;26834;8545;26096;832;2886;6709;19985;7541;22871
292925;201410;5300;16276;4676;15395;470;1590;3571;11873;4041;13463
292930;201410;6644;21482;6329;20915;652;2714;4728;15271;5380;17985
292935;201410;2168;6145;1814;5758;121;304;1538;5082;1659;5386
292937;201410;3370;8584;2828;7905;312;984;2170;5999;2482;6983
292940;201410;3215;8823;2528;7864;313;986;1737;5609;2050;6595
292950;201410;8520;25775;8092;25029;984;3599;5877;17704;6861;21303
292960;201410;5148;13682;4506;12793;467;1438;3287;9273;3754;10711
292970;201410;4531;13570;4022;12909;199;803;3358;10812;3557;11615
292975;201410;3549;9624;3372;9368;368;990;2792;7861;3160;8851
292980;201410;3673;9897;2965;8995;390;1358;2061;6183;2451;7541
292990;201410;12489;35807;11265;33951;705;2262;9533;28764;10238;31026
293000;201410;3022;7872;2472;7177;124;420;2151;6234;2275;6654
293010;201410;19568;54825;17001;50748;3049;9905;10433;31017;13482;40922
293015;201410;8219;26458;6638;24016;1059;4229;4265;15371;5324;19600
293020;201410;9719;32043;9075;31129;618;2407;7495;25956;8113;28363
293030;201410;5815;16787;4649;15021;449;1501;3246;10935;3695;12436
293040;201410;3653;11994;3483;11657;184;665;3089;10323;3273;10988
293050;201410;21082;58961;18667;55866;2847;8694;12597;38625;15444;47319
293060;201410;4446;11393;3713;10232;424;1245;2554;7001;2978;8246
293070;201410;21513;64856;19596;61565;5330;16995;10014;32366;15344;49361
293075;201410;3489;11376;3158;10929;252;918;2564;8971;2816;9889
293076;201410;3854;10748;3557;10322;270;755;2980;8814;3250;9569
293077;201410;5148;15920;4465;15017;1058;3743;2486;8473;3544;12216
293080;201410;4931;15550;4501;14857;335;1454;3537;11442;3872;12896
293090;201410;3631;11390;2961;10426;303;1094;2224;7971;2527;9065
293100;201410;5961;18009;5082;16469;554;1911;3730;12238;4284;14149
293105;201410;3999;13329;3529;12424;499;1846;2404;8611;2903;10457
293110;201410;2068;6100;1879;5814;127;454;1543;4753;1670;5207
293120;201410;4156;13654;3850;13221;393;1298;3011;10590;3404;11888
293130;201410;4176;11699;3418;10841;187;664;3026;9731;3213;10395
293135;201410;31112;79412;23658;69077;4825;16299;11312;32548;16137;48847
293140;201410;2180;6360;2090;6228;220;774;1597;4652;1817;5426
293150;201410;5937;19492;5297;18236;1046;3723;3132;11135;4178;14858
293160;201410;3683;9868;3433;9580;471;945;2665;7927;3136;8872
293170;201410;3563;10703;3282;10281;476;1625;2310;7324;2786;8949
293180;201410;5509;15454;4508;13892;350;1271;3490;10607;3840;11878
293190;201410;14253;43239;13417;41975;587;2634;11606;35665;12193;38299
293200;201410;6672;19183;5860;18087;278;1017;4995;15441;5273;16458
293210;201410;5219;15197;4742;14415;467;1553;3544;10811;4011;12364
293220;201410;5370;16043;4764;15015;1205;3955;2400;7687;3605;11642
293230;201410;4111;12740;3762;12228;590;2086;2649;8643;3239;10729
293240;201410;4660;12251;3627;10709;188;587;2822;8314;3010;8901
293245;201410;4606;13139;4190;12490;508;1531;3024;9307;3532;10838
293250;201410;6057;16954;5545;16201;666;2044;4035;11797;4701;13841
293260;201410;4904;14566;4077;13362;377;1356;3022;10004;3399;11360
293270;201410;5933;16159;5613;15815;541;1336;4837;13968;5378;15304
293280;201410;5782;16146;4996;15113;460;1276;3864;12087;4324;13363
293290;201410;16831;56126;15841;54150;3763;13408;8533;29744;12296;43152
293300;201410;6896;16890;5899;15768;476;1210;4809;13043;5285;14253
293305;201410;4921;12258;4275;11372;276;778;3569;9503;3845;10281
293310;201410;2816;7201;2283;6332;235;704;1599;4388;1834;5092
293315;201410;5047;12707;4547;11968;738;1903;2904;8057;3642;9960
293317;201410;2635;7690;2355;7174;277;886;1551;4720;1828;5606
293320;201410;8240;27137;8047;26888;699;2541;6791;22729;7490;25270
293325;201410;1964;5696;1635;5188;249;854;1104;3541;1353;4395
293330;201410;56030;177577;50424;167998;11433;40933;27060;91179;38493;132112
293340;201410;2753;7842;2183;6857;313;1095;1464;4499;1777;5594
293345;201410;3677;10879;3085;10048;346;1125;2259;7603;2605;8728
293350;201410;6925;19299;6596;18915;415;1028;5869;17221;6284;18249
293360;201410;14187;42948;12888;41257;863;2715;11002;35898;11865;38613
310010;201410;1228;3325;885;2774;225;855;370;1051;595;1906
310020;201410;3908;12426;3252;10994;1122;4091;613;1879;1735;5970
310030;201410;2632;8522;2255;7844;644;2418;1121;3847;1765;6265
310040;201410;1054;2876;878;2629;88;304;663;1971;751;2275
310050;201410;1951;6783;1737;6279;331;1412;898;3197;1229;4609
310060;201410;3344;10987;2989;10511;378;1384;2258;8059;2636;9443
310070;201410;323;926;249;787;33;142;135;384;168;526
310080;201410;793;2436;645;2147;175;670;229;702;404;1372
310090;201410;5047;14942;4352;13731;672;2347;2694;8495;3366;10842
310100;201410;3471;10532;2884;9545;275;1103;2150;7062;2425;8165
310110;201410;6081;17142;5097;15652;1137;3974;2807;8514;3944;12488
310120;201410;612;1968;563;1883;210;839;242;691;452;1530
310130;201410;476;1490;435;1424;105;401;224;685;329;1086
310140;201410;267;932;233;869;82;343;53;174;135;517
310150;201410;5127;15842;4604;14876;1033;3743;2329;7477;3362;11220
310160;201410;7944;25248;6618;22848;1997;7606;2379;8154;4376;15760
310163;201410;869;2917;749;2669;206;811;293;1007;499;1818
310170;201410;10239;28976;9379;27693;1655;5029;6108;18647;7763;23676
310180;201410;1932;5596;1575;5093;410;1489;760;2378;1170;3867
310190;201410;2636;8873;2392;8460;759;2967;421;1550;1180;4517
310200;201410;1989;6664;1670;6002;485;1931;580;2048;1065;3979
310205;201410;1101;3277;904;2952;182;601;527;1770;709;2371
310210;201410;2654;8167;2432;7836;323;1170;1807;5808;2130;6978
310220;201410;1285;3669;1036;3343;227;805;589;1859;816;2664
310230;201410;3033;9873;2594;8896;750;2947;1035;3284;1785;6231
310240;201410;1055;3675;900;3383;161;670;453;1793;614;2463
310250;201410;993;3403;966;3357;225;892;553;1848;778;2740
310260;201410;3270;10480;2700;9265;676;2615;1017;3379;1693;5994
310270;201410;2557;7468;2250;7014;200;664;1765;5577;1965;6241
310280;201410;2276;6423;2009;6010;448;1651;1068;3020;1516;4671
310285;201410;2250;7885;2110;7676;299;1140;1585;5891;1884;7031
310290;201410;1353;4247;1261;4106;374;1384;600;1775;974;3159
310300;201410;1954;6636;1843;6410;524;1995;992;3403;1516;5398
310310;201410;398;1093;289;868;53;157;138;415;191;572
310320;201410;421;1379;359;1248;69;298;174;584;243;882
310330;201410;521;1314;376;1060;42;153;209;531;251;684
310340;201410;8839;27230;7574;25134;1536;5340;4249;14483;5785;19823
310350;201410;16271;46010;12457;39348;4192;14363;3511;11100;7703;25463
310360;201410;481;1506;465;1479;79;291;313;950;392;1241
310370;201410;1506;5317;1452;5217;424;1591;781;2819;1205;4410
310375;201410;1451;3919;974;3059;171;623;423;1264;594;1887
310380;201410;405;1144;320;1027;129;461;127;374;256;835
310390;201410;511;1837;436;1666;117;484;79;262;196;746
310400;201410;10683;32081;8523;28181;2688;9677;2583;8549;5271;18226
310410;201410;1074;3471;704;2864;247;1071;150;605;397;1676
310420;201410;5964;17251;3584;11806;823;3034;642;1890;1465;4924
310430;201410;1705;5800;1403;5174;457;1803;363;1309;820;3112
310440;201410;638;1856;544;1709;150;516;225;683;375;1199
310445;201410;1274;4155;1058;3746;163;639;660;2319;823;2958
310450;201410;4811;13798;3922;12499;701;2385;2507;8174;3208;10559
310460;201410;1687;5417;1453;4997;480;1805;335;1198;815;3003
310470;201410;3822;9852;3223;9098;314;1004;2536;7208;2850;8212
310480;201410;1195;3654;980;3224;237;912;413;1236;650;2148
310490;201410;3399;11476;2990;10685;1000;3928;1138;4018;2138;7946
310500;201410;1561;5407;1434;5141;426;1665;590;2086;1016;3751
310510;201410;2664;8712;2223;7684;783;2930;468;1544;1251;4474
310520;201410;1454;3892;1152;3396;88;268;779;2313;867;2581
310530;201410;898;2867;541;1913;114;453;111;363;225;816
310540;201410;3859;12694;3552;12226;1231;4448;1418;4957;2649;9405
310550;201410;1262;3772;1043;3384;286;1109;451;1328;737;2437
310560;201410;17001;53123;14556;48291;4588;16879;4910;15469;9498;32348
310570;201410;1296;4003;1213;3894;169;596;902;2898;1071;3494
310590;201410;4269;12539;3370;10812;648;2339;1325;4066;1973;6405
310600;201410;1660;5625;1544;5365;534;2077;531;1711;1065;3788
310610;201410;587;1974;536;1869;158;655;181;558;339;1213
310620;201410;194771;616915;160873;548334;43301;164322;62211;203220;105512;367542
310630;201410;4357;14088;4127;13667;775;2902;2774;8996;3549;11898
310640;201410;1488;4564;1193;4032;425;1549;288;899;713;2448
310650;201410;2976;9509;2414;8540;465;1801;1333;4825;1798;6626
310660;201410;1432;4302;1248;4039;174;594;922;2969;1096;3563
310665;201410;1261;3941;1149;3773;190;672;796;2648;986;3320
310670;201410;58491;184051;53639;173322;16066;54459;22769;72820;38835;127279
310680;201410;824;2402;741;2271;176;579;381;1152;557;1731
310690;201410;1360;4490;1093;3977;336;1397;308;1040;644;2437
310700;201410;549;1497;450;1354;128;439;223;637;351;1076
310710;201410;7487;24376;5899;21722;1615;6619;1672;6076;3287;12695
310720;201410;883;2705;804;2559;233;854;362;1071;595;1925
310730;201410;9987;31386;9053;29882;2026;7273;5382;17777;7408;25050
310740;201410;5495;18406;4607;16559;1569;6181;1101;3760;2670;9941
310750;201410;1697;4341;1361;3896;229;658;936;2719;1165;3377
310760;201410;653;2028;559;1860;139;503;237;770;376;1273
310770;201410;817;2950;786;2887;283;1157;350;1226;633;2383
310780;201410;3859;10986;3380;10147;600;1842;2076;6258;2676;8100
310790;201410;1921;6125;1714;5753;472;1647;840;2904;1312;4551
310800;201410;3170;10250;2507;8933;992;3880;388;1326;1380;5206
310810;201410;1542;4346;1396;4098;320;1026;700;1981;1020;3007
310820;201410;1561;4389;1112;3592;304;1086;351;1083;655;2169
310825;201410;2501;8495;2004;7606;167;862;1470;5503;1637;6365
310830;201410;1482;4934;1193;4350;393;1523;364;1263;757;2786
310840;201410;2416;7822;2033;7103;769;2952;556;1824;1325;4776
310850;201410;1609;4815;1372;4500;206;749;1000;3272;1206;4021
310855;201410;3284;10561;2906;9953;668;2443;1742;6071;2410;8514
310860;201410;8228;25385;7134;23490;1174;4118;4185;14141;5359;18259
310870;201410;1012;2880;829;2566;165;552;429;1315;594;1867
310880;201410;1269;3919;966;3351;205;825;456;1552;661;2377
310890;201410;2838;9013;2267;7950;675;2676;678;2240;1353;4916
310900;201410;4657;15533;3957;14099;1169;4613;1538;5295;2707;9908
310910;201410;2150;6156;1440;4796;401;1492;352;1108;753;2600
310920;201410;1992;6033;1585;5448;406;1585;768;2634;1174;4219
310925;201410;975;3229;885;3068;349;1330;291;1004;640;2334
310930;201410;5699;16574;4584;14854;839;2958;2699;8940;3538;11898
310940;201410;6515;18992;5486;17388;1096;3770;3000;9492;4096;13262
310945;201410;1381;3940;1138;3599;228;827;669;2032;897;2859
310950;201410;2114;6969;1635;5870;533;2139;482;1601;1015;3740
310960;201410;499;1694;427;1557;158;632;141;507;299;1139
310970;201410;1595;5479;1173;4396;385;1580;174;575;559;2155
310980;201410;481;1252;324;955;56;203;147;380;203;583
310990;201410;1241;4253;1060;3848;276;1126;337;1125;613;2251
311000;201410;3609;12446;3159;11466;905;3767;1138;3862;2043;7629
311010;201410;988;3190;881;2997;283;1021;422;1409;705;2430
311020;201410;958;2980;798;2697;193;743;324;1016;517;1759
311030;201410;1956;5825;1496;4879;459;1654;495;1456;954;3110
311040;201410;504;1702;435;1516;107;392;102;341;209;733
311050;201410;2690;8754;2303;7988;695;2653;922;3175;1617;5828
311060;201410;2565;8038;2045;6904;605;2200;496;1613;1101;3813
311070;201410;1769;6258;1556;5819;436;1839;505;1880;941;3719
311080;201410;1240;3382;1109;3182;181;595;705;2004;886;2599
311090;201410;1692;6322;1432;5768;501;2306;272;1022;773;3328
311100;201410;2466;8580;2148;7904;943;3679;502;1844;1445;5523
311110;201410;4182;10084;2981;8381;607;1894;1536;4244;2143;6138
311115;201410;1208;3612;1044;3358;125;505;671;2156;796;2661
311120;201410;7966;22694;6157;19341;1637;5752;1641;4772;3278;10524
311130;201410;2449;7479;1943;6792;547;2247;856;2856;1403;5103
311140;201410;1486;4143;1231;3818;175;639;852;2568;1027;3207
311150;201410;2451;8227;2265;7918;613;2228;1134;4031;1747;6259
311160;201410;5048;17017;4230;15577;1570;6217;1333;4853;2903;11070
311170;201410;768;2386;606;2069;81;275;326;1176;407;1451
311180;201410;1653;4626;1206;3737;372;1250;288;816;660;2066
311190;201410;1124;3377;949;3014;256;928;374;1085;630;2013
311200;201410;2153;6638;1773;5816;582;2113;407;1189;989;3302
311205;201410;1217;3949;1064;3637;262;1015;425;1479;687;2494
311210;201410;987;3193;898;3059;166;566;628;2206;794;2772
311220;201410;941;3018;752;2588;210;769;255;869;465;1638
311230;201410;9159;28150;7663;25389;1629;5912;3698;12515;5327;18427
311240;201410;1369;4209;1141;3832;370;1334;387;1307;757;2641
311250;201410;991;3246;887;3082;258;1033;310;926;568;1959
311260;201410;2990;8179;2266;6918;690;2314;718;2137;1408;4451
311265;201410;1356;3645;1044;3198;160;594;691;2101;851;2695
311270;201410;3589;11572;3176;10995;564;2300;2130;7203;2694;9503
311280;201410;1492;4197;1089;3407;306;1061;329;1000;635;2061
311290;201410;2374;7761;2202;7406;439;1471;1281;4444;1720;5915
311300;201410;5135;16897;4610;16020;718;2826;3028;10614;3746;13440
311310;201410;505;1794;481;1751;108;457;213;726;321;1183
311320;201410;4243;14265;3711;13054;944;3797;1332;4440;2276;8237
311330;201410;5654;17279;4859;16018;1726;6144;1764;5710;3490;11854
311340;201410;13019;41785;11665;39157;3828;13825;3682;12267;7510;26092
311350;201410;2429;7143;2013;6357;449;1660;908;2695;1357;4355
311360;201410;1374;3907;1090;3528;494;1662;280;931;774;2593
311370;201410;4744;14095;4169;13113;1102;4108;1709;5009;2811;9117
311380;201410;498;1630;422;1488;124;508;133;431;257;939
311390;201410;2036;7508;1911;7293;865;3673;609;2193;1474;5866
311400;201410;1761;5874;1604;5592;465;1844;720;2321;1185;4165
311410;201410;2093;7496;1940;7278;623;2507;1006;3817;1629;6324
311420;201410;2512;8634;2041;7451;726;2825;487;1599;1213;4424
311430;201410;4197;13106;3070;10562;749;2827;574;1918;1323;4745
311440;201410;2343;7892;1827;6877;681;2955;355;1267;1036;4222
311450;201410;1909;6730;1614;6003;504;2063;381;1296;885;3359
311455;201410;1646;4465;1400;4096;326;1063;759;2141;1085;3204
311460;201410;686;2251;526;1911;128;572;137;467;265;1039
311470;201410;626;1995;503;1725;147;600;158;490;305;1090
311480;201410;838;2321;791;2250;256;729;373;1026;629;1755
311490;201410;317;1240;297;1176;113;467;98;376;211;843
311500;201410;534;1607;439;1429;147;514;175;559;322;1073
311510;201410;3228;10080;2625;8912;1009;3887;704;2230;1713;6117
311520;201410;707;2413;663;2318;250;935;245;832;495;1767
311530;201410;11924;31428;8203;24969;2205;7990;2432;7083;4637;15073
311535;201410;771;2325;544;1855;133;531;98;306;231;837
311540;201410;716;2577;684;2529;228;892;347;1252;575;2144
311545;201410;2312;7177;2151;6966;312;1127;1529;4947;1841;6074
311547;201410;1693;4693;1428;4282;144;451;969;2944;1113;3395
311550;201410;3469;11288;2979;10262;843;3242;1014;3413;1857;6655
311560;201410;299;798;261;749;64;210;148;402;212;612
311570;201410;2186;5469;1743;4917;116;340;1411;4058;1527;4398
311580;201410;2494;5440;2037;4894;601;1355;1144;2897;1745;4252
311590;201410;415;1322;362;1251;114;467;108;367;222;834
311600;201410;1439;4249;1205;3962;299;958;696;2385;995;3343
311610;201410;3436;11910;3179;11487;1050;3795;1407;5440;2457;9235
311615;201410;2860;9287;2445;8574;299;1253;1725;6010;2024;7263
311620;201410;465;1494;420;1431;103;391;227;762;330;1153
311630;201410;1485;4427;1259;4027;291;926;671;2188;962;3114
311640;201410;898;2810;738;2544;146;552;452;1539;598;2091
311650;201410;2484;7088;2018;6330;307;1039;1175;3780;1482;4819
311660;201410;2767;9641;2345;8693;705;2915;403;1311;1108;4226
311670;201410;1486;4546;1268;4160;431;1558;526;1701;957;3259
311680;201410;2360;7333;1961;6747;466;1696;1111;3896;1577;5592
311690;201410;600;1625;499;1504;81;270;346;1032;427;1302
311700;201410;2337;6538;2025;6087;192;740;1564;4582;1756;5322
311710;201410;1783;5507;1394;4808;548;2061;406;1367;954;3428
311720;201410;416;1429;380;1355;69;278;236;822;305;1100
311730;201410;5724;14922;3517;10966;1063;3762;1223;3416;2286;7178
311740;201410;1018;2926;881;2754;363;1115;433;1412;796;2527
311750;201410;4025;13507;3645;12914;699;2761;2176;7700;2875;10461
311760;201410;814;2776;763;2670;206;843;342;1086;548;1929
311770;201410;2604;8231;2129;7374;576;2246;667;2215;1243;4461
311780;201410;1184;4408;1005;3948;375;1659;225;821;600;2480
311783;201410;2174;6947;1887;6394;186;741;1279;4437;1465;5178
311787;201410;638;2247;464;1725;90;358;101;329;191;687
311790;201410;1437;4490;1123;3868;327;1220;316;1037;643;2257
311800;201410;4066;13869;2959;10520;705;2692;233;681;938;3373
311810;201410;1057;3568;1000;3466;47;222;839;2884;886;3106
311820;201410;853;2805;718;2478;234;929;330;1050;564;1979
311830;201410;10537;37396;9313;34293;3633;14046;2050;7461;5683;21507
311840;201410;3542;10568;3062;9840;943;3386;1352;4203;2295;7589
311850;201410;327;980;281;903;76;260;138;440;214;700
311860;201410;52348;161725;45272;148349;11817;42676;20291;64290;32108;106966
311870;201410;2449;7311;1942;6343;509;1894;650;1952;1159;3846
311880;201410;7327;21510;6599;20622;1086;3300;4477;14655;5563;17955
311890;201410;1653;5204;1386;4636;402;1487;548;1769;950;3256
311900;201410;818;2553;738;2441;144;476;466;1636;610;2112
311910;201410;4883;14234;3963;12969;1132;3998;1688;5551;2820;9549
311920;201410;2141;6968;1833;6483;230;901;1218;4278;1448;5179
311930;201410;4968;14707;4401;13795;1803;5931;1356;4295;3159;10226
311940;201410;11943;36571;9865;32210;3023;10791;2364;7292;5387;18083
311950;201410;2360;6979;1994;6499;151;518;1536;5044;1687;5562
311960;201410;436;1444;400;1372;117;471;185;557;302;1028
311970;201410;470;1684;406;1544;127;541;76;276;203;817
311980;201410;801;2226;576;1856;140;487;211;686;351;1173
311990;201410;528;1614;469;1523;190;655;161;491;351;1146
311995;201410;1177;3628;777;2640;165;627;175;512;340;1139
312000;201410;711;2205;665;2134;132;470;375;1199;507;1669
312010;201410;1059;3426;944;3182;200;740;423;1408;623;2148
312015;201410;1617;4945;1394;4556;205;796;844;2769;1049;3565
312020;201410;1018;3307;904;3132;254;986;445;1529;699;2515
312030;201410;1864;5530;1670;5281;169;609;1327;4181;1496;4790
312040;201410;703;2669;605;2370;172;755;129;473;301;1228
312050;201410;1484;5148;1289;4738;393;1600;295;1041;688;2641
312060;201410;768;2362;677;2232;313;1098;201;596;514;1694
312070;201410;1009;3121;657;2331;166;641;236;824;402;1465
312080;201410;2737;7673;2121;6697;460;1735;1036;3014;1496;4749
312083;201410;979;2778;815;2535;128;463;496;1517;624;1980
312087;201410;2369;7229;2106;6861;309;1072;1491;4944;1800;6016
312090;201410;10219;33095;9248;31403;2962;11064;3793;12477;6755;23541
312100;201410;1396;4717;1222;4422;264;1050;669;2482;933;3532
312110;201410;1214;4306;1082;4014;402;1668;217;711;619;2379
312120;201410;951;3322;856;3112;273;1093;247;816;520;1909
312125;201410;1339;4331;1200;4049;329;1162;579;1991;908;3153
312130;201410;875;2661;712;2318;165;612;291;909;456;1521
312140;201410;1092;3460;896;2987;213;778;305;901;518;1679
312150;201410;567;1618;476;1419;39;136;325;939;364;1075
312160;201410;8392;28525;7635;26948;2406;9242;2742;9726;5148;18968
312170;201410;1027;3050;919;2843;135;436;546;1713;681;2149
312180;201410;1643;5069;1490;4801;415;1400;602;1896;1017;3296
312190;201410;705;2328;556;2032;230;927;109;369;339;1296
312200;201410;4974;14834;4321;13769;532;1824;3045;9722;3577;11546
312210;201410;1272;3449;984;3027;271;914;457;1361;728;2275
312220;201410;1983;6515;1782;6280;236;861;1360;4984;1596;5845
312230;201410;18652;62178;15706;56261;7289;27551;3326;12317;10615;39868
312235;201410;1795;5165;1505;4721;160;632;1032;3224;1192;3856
312240;201410;1137;3895;975;3552;290;1136;348;1273;638;2409
312245;201410;2456;7150;2128;6707;186;531;1707;5486;1893;6017
312247;201410;948;2799;720;2426;188;718;350;1202;538;1920
312250;201410;1221;3529;1012;3164;226;806;465;1394;691;2200
312260;201410;986;3107;805;2843;133;560;536;1876;669;2436
312270;201410;807;2519;677;2275;152;615;252;729;404;1344
312280;201410;481;1660;442;1571;199;753;58;194;257;947
312290;201410;868;2988;817;2914;331;1332;222;765;553;2097
312300;201410;1138;3809;949;3375;295;1117;148;470;443;1587
312310;201410;962;3661;877;3444;258;1096;355;1352;613;2448
312320;201410;2455;7018;1957;5985;556;1896;480;1212;1036;3108
312330;201410;1214;3630;1057;3397;262;963;599;1916;861;2879
312340;201410;327;848;291;801;43;157;220;573;263;730
312350;201410;385;1006;357;971;47;150;289;756;336;906
312352;201410;1698;5543;1559;5341;438;1503;935;3325;1373;4828
312360;201410;3807;12884;3301;11824;1081;4217;909;3209;1990;7426
312370;201410;1699;5518;1567;5300;575;2169;551;1745;1126;3914
312380;201410;2055;5974;1854;5668;247;777;1341;4219;1588;4996
312385;201410;1313;4034;1158;3772;155;648;786;2452;941;3100
312390;201410;2035;6783;1678;5984;522;1975;322;1056;844;3031
312400;201410;3545;11650;3070;10702;1126;4082;1079;3916;2205;7998
312410;201410;11121;37190;9979;34889;2971;11315;3738;12764;6709;24079
312420;201410;4238;13386;4023;13124;689;2264;2857;9563;3546;11827
312430;201410;8728;25782;7760;24333;1406;4454;5021;16261;6427;20715
312440;201410;686;2201;599;2050;141;531;307;1063;448;1594
312450;201410;1144;4061;1020;3825;434;1686;371;1393;805;3079
312460;201410;401;1215;357;1166;85;308;188;606;273;914
312470;201410;784;2233;539;1742;129;479;148;463;277;942
312480;201410;1405;4118;1156;3828;388;1391;530;1686;918;3077
312490;201410;2023;5424;1607;4827;228;817;990;2862;1218;3679
312500;201410;690;2247;624;2150;141;594;338;1116;479;1710
312510;201410;2895;9272;2372;8129;557;2214;992;3109;1549;5323
312520;201410;403;1384;353;1282;122;458;124;460;246;918
312530;201410;614;1988;575;1920;113;465;336;1053;449;1518
312540;201410;1501;4721;1166;4048;281;1046;587;2004;868;3050
312550;201410;646;2088;585;1960;59;227;393;1291;452;1518
312560;201410;2268;5949;1971;5563;209;667;1516;4306;1725;4973
312570;201410;2828;8538;2416;7802;763;2615;785;2471;1548;5086
312580;201410;542;1827;444;1627;106;465;173;593;279;1058
312590;201410;1878;6273;1648;5772;453;1822;587;1874;1040;3696
312595;201410;2112;7133;1874;6563;514;1935;885;3049;1399;4984
312600;201410;829;2994;754;2833;202;884;352;1232;554;2116
312610;201410;9059;27772;7486;24813;2713;9703;2190;7045;4903;16748
312620;201410;2131;6139;1627;5461;124;442;1301;4494;1425;4936
312630;201410;515;1734;477;1662;129;503;214;719;343;1222
312640;201410;612;1997;500;1761;131;541;194;618;325;1159
312650;201410;2407;7056;1706;5728;204;793;945;3129;1149;3922
312660;201410;1352;3733;1127;3395;138;498;773;2280;911;2778
312670;201410;6255;19082;5557;18076;1387;5058;2788;8933;4175;13991
312675;201410;1488;4682;1269;4232;210;766;720;2417;930;3183
312680;201410;1746;5327;1560;5028;250;891;949;3132;1199;4023
312690;201410;2435;6626;1996;6008;401;1403;1088;3136;1489;4539
312695;201410;928;3317;868;3230;182;665;573;2214;755;2879
312700;201410;2043;5950;1544;4986;241;876;799;2549;1040;3425
312705;201410;1474;4264;1262;3932;193;629;848;2647;1041;3276
312707;201410;1788;5518;1470;4984;239;982;811;2684;1050;3666
312710;201410;8561;23950;6181;19736;2233;7891;1430;4292;3663;12183
312720;201410;772;2633;698;2485;185;730;296;1001;481;1731
312730;201410;1972;4867;1437;4246;234;806;838;2462;1072;3268
312733;201410;1762;4732;1315;3891;120;441;927;2622;1047;3063
312735;201410;926;2715;820;2565;271;941;405;1213;676;2154
312737;201410;1055;2585;741;2155;245;734;296;906;541;1640
312738;201410;565;1786;431;1510;127;510;156;516;283;1026
312740;201410;516;1494;353;1284;124;492;98;358;222;850
312750;201410;1328;4785;1267;4662;323;1367;611;2191;934;3558
312760;201410;2462;7939;1919;6835;562;2210;439;1566;1001;3776
312770;201410;47176;130248;36610;113704;10901;36798;12204;37260;23105;74058
312780;201410;2889;10203;2590;9678;516;2091;1481;5682;1997;7773
312790;201410;391;1022;239;748;76;274;65;172;141;446
312800;201410;5422;18292;4632;16661;1525;5846;1419;5179;2944;11025
312810;201410;2320;7140;1677;5938;548;2144;375;1247;923;3391
312820;201410;2207;6479;1986;6115;254;951;1297;3861;1551;4812
312825;201410;1557;4238;1362;4004;137;433;1075;3156;1212;3589
312830;201410;2865;9268;2067;7595;572;2299;396;1452;968;3751
312840;201410;1233;4052;1040;3677;210;889;484;1640;694;2529
312850;201410;658;2155;542;1921;123;513;204;700;327;1213
312860;201410;1334;3888;999;3318;316;1224;295;859;611;2083
312870;201410;5825;18491;4462;15801;1216;4856;1309;4463;2525;9319
312880;201410;1318;3986;1136;3680;208;762;642;2061;850;2823
312890;201410;1575;4779;1102;3757;363;1385;369;1205;732;2590
312900;201410;1493;4806;1369;4632;357;1252;830;2855;1187;4107
312910;201410;1587;3565;1199;3037;290;852;583;1364;873;2216
312920;201410;1051;3435;925;3254;285;1117;410;1404;695;2521
312930;201410;2297;6783;2017;6376;467;1545;1026;3324;1493;4869
312940;201410;954;3195;854;3016;264;1086;250;820;514;1906
312950;201410;3601;10293;2897;9220;1001;3432;1048;3311;2049;6743
312960;201410;2048;6118;1849;5856;266;822;1367;4454;1633;5276
312965;201410;1845;5880;1565;5369;299;1106;902;3150;1201;4256
312970;201410;1206;4124;1043;3869;413;1728;199;707;612;2435
312980;201410;22239;77364;21120;74766;7942;30090;7905;27272;15847;57362
312990;201410;418;1281;316;1099;118;461;100;343;218;804
313000;201410;542;1820;443;1618;133;590;160;526;293;1116
313005;201410;2734;8830;2416;8290;449;1646;1431;4954;1880;6600
313010;201410;4279;14341;3789;13502;1187;4647;1554;5299;2741;9946
313020;201410;1064;3660;965;3434;323;1289;289;900;612;2189
313030;201410;1637;4589;1298;4125;351;1271;662;2001;1013;3272
313040;201410;1003;3511;861;3108;207;831;287;975;494;1806
313050;201410;1972;6391;1616;5868;541;2194;591;2042;1132;4236
313055;201410;1582;5202;1443;5001;138;512;1097;3855;1235;4367
313060;201410;1036;3540;898;3193;387;1435;151;516;538;1951
313065;201410;2043;6633;1786;6229;310;1227;1266;4383;1576;5610
313070;201410;1281;3799;1045;3357;267;983;509;1541;776;2524
313080;201410;487;1529;395;1343;113;451;129;360;242;811
313090;201410;5663;16669;5030;15653;843;2753;3332;10538;4175;13291
313100;201410;1193;3842;1111;3716;175;643;807;2678;982;3321
313110;201410;1789;5219;1378;4433;324;1210;521;1531;845;2741
313115;201410;2914;10235;2785;9975;850;3402;1335;4570;2185;7972
313120;201410;4029;11303;3506;10579;870;2813;2146;6463;3016;9276
313130;201410;22464;68774;19103;61642;4986;17709;7156;21826;12142;39535
313140;201410;714;1876;535;1597;44;163;361;1054;405;1217
313150;201410;1700;5322;1517;4999;686;2337;413;1404;1099;3741
313160;201410;1192;3626;1047;3381;215;805;614;1903;829;2708
313170;201410;9894;36103;8919;33699;3437;13535;2012;7630;5449;21165
313180;201410;2851;7456;2141;6508;641;2156;778;2285;1419;4441
313190;201410;3720;13562;3273;12266;952;3871;1059;3823;2011;7694
313200;201410;1528;4812;1355;4522;226;885;848;2865;1074;3750
313210;201410;4740;14742;4012;13742;936;3748;2155;7093;3091;10841
313220;201410;1287;3909;949;3163;255;988;271;793;526;1781
313230;201410;2602;9223;2421;8936;437;1675;1551;5929;1988;7604
313240;201410;8835;29496;7457;26936;2061;8235;3136;11260;5197;19495
313250;201410;7932;24716;7125;23342;1332;4459;4231;14256;5563;18715
313260;201410;648;2020;532;1789;128;497;159;499;287;996
313270;201410;5889;17353;5211;16302;876;2940;3419;10769;4295;13709
313280;201410;559;1816;432;1511;85;344;114;375;199;719
313290;201410;1052;3763;873;3406;292;1259;220;790;512;2049
313300;201410;2049;6987;1725;6178;557;2181;327;1039;884;3220
313310;201410;1096;3869;990;3637;281;1167;189;622;470;1789
313320;201410;2562;7634;2045;6763;421;1488;895;2979;1316;4467
313330;201410;4099;13205;3542;12166;731;2868;1831;6234;2562;9102
313340;201410;2368;5760;1812;4969;386;1106;1003;2734;1389;3840
313350;201410;3471;10894;2687;9114;697;2548;587;1827;1284;4375
313360;201410;1255;3809;967;3285;314;1236;426;1336;740;2572
313370;201410;1541;5386;1458;5156;302;1256;699;2301;1001;3557
313375;201410;2216;5946;1491;4844;392;1544;528;1632;920;3176
313380;201410;7021;24033;6111;22026;2297;8947;1909;6571;4206;15518
313390;201410;950;3426;917;3375;134;558;627;2298;761;2856
313400;201410;3887;11157;3572;10779;416;1324;2794;8601;3210;9925
313410;201410;1426;4074;1209;3773;268;916;710;2219;978;3135
313420;201410;21119;51463;13239;37644;3216;10274;3072;8372;6288;18646
313430;201410;1343;4369;1173;4018;345;1326;442;1432;787;2758
313440;201410;6978;16609;5065;14314;732;2275;3393;9604;4125;11879
313450;201410;746;2232;596;1913;152;587;208;599;360;1186
313460;201410;2556;9004;2287;8546;739;3018;708;2535;1447;5553
313470;201410;3545;9882;3340;9649;333;838;2816;8353;3149;9191
313480;201410;1161;3405;894;2929;158;597;392;1211;550;1808
313490;201410;1718;5567;1217;4689;506;1997;240;965;746;2962
313500;201410;453;1471;427;1418;104;402;214;678;318;1080
313505;201410;9251;27410;8585;26621;505;1117;7755;24826;8260;25943
313507;201410;1519;4247;1336;3985;248;852;799;2426;1047;3278
313510;201410;16802;48830;14791;46047;2686;8503;9447;30269;12133;38772
313520;201410;16849;50490;14206;45994;2122;7788;9095;29371;11217;37159
313530;201410;598;2008;514;1849;91;381;192;630;283;1011
313535;201410;2711;8022;2401;7498;326;1073;1611;5086;1937;6159
313540;201410;1149;3638;902;3011;279;980;220;669;499;1649
313545;201410;1435;5189;1263;4864;215;1027;777;2849;992;3876
313550;201410;2066;6906;1893;6564;534;1985;925;3108;1459;5093
313560;201410;2373;5823;2054;5461;310;752;1542;4284;1852;5036
313570;201410;847;3080;743;2878;282;1173;260;952;542;2125
313580;201410;6413;18098;5422;16737;806;2742;3787;11746;4593;14488
313590;201410;1111;3292;898;3038;419;1518;324;1071;743;2589
313600;201410;4037;12273;3524;11450;638;2256;2142;7068;2780;9324
313610;201410;1199;3716;1032;3391;274;983;456;1470;730;2453
313620;201410;7573;25398;7128;24451;2525;9196;2450;8270;4975;17466
313630;201410;9425;28424;7749;25788;2244;8267;3012;10373;5256;18640
313640;201410;928;2865;773;2630;270;1000;254;844;524;1844
313650;201410;2378;7757;2107;7304;304;1066;1529;5417;1833;6483
313652;201410;1038;3742;953;3570;174;701;569;2137;743;2838
313655;201410;1037;3364;843;3034;159;666;509;1776;668;2442
313657;201410;1291;4068;1131;3810;162;723;789;2441;951;3164
313660;201410;946;3233;871;3097;222;908;417;1403;639;2311
313665;201410;3347;11112;3092;10539;724;2784;1526;5006;2250;7790
313670;201410;50085;143039;34179;115149;9797;36689;10509;34330;20306;71019
313680;201410;1144;3449;993;3210;140;466;691;2267;831;2733
313690;201410;997;3597;891;3371;272;1052;346;1350;618;2402
313695;201410;1545;4983;1300;4584;167;666;885;3154;1052;3820
313700;201410;4019;13283;3392;12419;585;2202;2300;8637;2885;10839
313710;201410;1452;4103;1204;3732;346;1157;565;1709;911;2866
313720;201410;5645;18987;4854;17281;1328;5274;1523;4938;2851;10212
313730;201410;1341;3584;1024;3200;189;671;597;1857;786;2528
313740;201410;2164;7834;1797;6881;646;2777;235;825;881;3602
313750;201410;3063;9433;2659;8650;881;3055;820;2518;1701;5573
313753;201410;1955;5901;1607;5291;505;1788;645;2140;1150;3928
313760;201410;4552;14885;3748;13203;1151;4450;1123;3729;2274;8179
313770;201410;3899;12948;3612;12376;1253;4536;1253;4219;2506;8755
313780;201410;4193;11891;3378;10689;838;3070;1645;5084;2483;8154
313790;201410;566;1970;547;1941;131;465;307;1125;438;1590
313800;201410;1296;3694;1148;3460;194;656;734;2211;928;2867
313810;201410;1628;4814;1567;4727;181;527;1239;3825;1420;4352
313820;201410;14391;41343;12073;37351;3101;10798;5238;15982;8339;26780
313830;201410;453;1549;390;1410;120;493;120;418;240;911
313835;201410;1095;3592;1040;3509;258;925;576;1934;834;2859
313840;201410;8379;24622;6738;21780;1932;6987;2202;6861;4134;13848
313850;201410;1312;3668;1179;3438;298;988;610;1683;908;2671
313860;201410;2812;8730;2284;7555;652;2452;533;1612;1185;4064
313862;201410;1230;3270;850;2640;233;770;297;932;530;1702
313865;201410;2362;7374;2154;7034;319;1158;1505;4908;1824;6066
313867;201410;1146;3940;970;3575;350;1378;327;1225;677;2603
313868;201410;1636;5716;1444;5309;180;775;975;3568;1155;4343
313870;201410;938;2937;833;2784;261;1000;296;904;557;1904
313880;201410;2293;7381;2097;7112;526;2063;1046;3296;1572;5359
313890;201410;2071;5613;1737;5191;289;857;1132;3458;1421;4315
313900;201410;4942;18047;4597;17258;1702;7025;1345;5027;3047;12052
313910;201410;792;2706;677;2459;269;1059;117;396;386;1455
313920;201410;3976;12631;3492;11787;640;2183;2114;7423;2754;9606
313925;201410;2167;5733;1493;4454;131;431;951;2808;1082;3239
313930;201410;5528;18082;4608;16441;832;3238;2619;9561;3451;12799
313940;201410;7933;27096;6697;25084;2275;9281;2473;9581;4748;18862
313950;201410;5068;14723;4202;13302;1371;4897;1530;4614;2901;9511
313960;201410;6509;17296;5126;15378;1698;5658;1408;4129;3106;9787
313970;201410;1549;4523;1304;4247;225;805;868;2869;1093;3674
313980;201410;1298;4285;1115;3955;376;1474;365;1272;741;2746
313990;201410;2032;7678;1784;7073;639;2741;439;1619;1078;4360
314000;201410;8644;29231;8028;28032;2126;8542;4353;14704;6479;23246
314010;201410;1197;3412;986;3145;173;654;577;1790;750;2444
314015;201410;1636;6100;1498;5792;533;2176;474;1825;1007;4001
314020;201410;546;1704;427;1437;125;478;109;337;234;815
314030;201410;869;2829;690;2414;125;479;264;912;389;1391
314040;201410;673;1952;578;1787;185;608;291;886;476;1494
314050;201410;2034;6634;1667;5859;512;1994;515;1672;1027;3666
314053;201410;1555;5124;1434;4975;240;813;992;3584;1232;4397
314055;201410;2340;6970;2072;6595;183;621;1578;5113;1761;5734
314060;201410;1159;3662;952;3312;107;447;624;2162;731;2609
314070;201410;3921;12222;2954;10303;854;3260;746;2449;1600;5709
314080;201410;1973;6096;1367;4726;295;1155;336;1042;631;2197
314085;201410;1937;6678;1681;6308;528;2181;624;2312;1152;4493
314090;201410;3630;12403;3237;11620;1060;4121;1167;4251;2227;8372
314100;201410;3710;9884;3204;9177;380;1051;2462;7241;2842;8292
314110;201410;4640;15324;4088;14150;1039;4166;1543;4906;2582;9072
314120;201410;1096;2677;587;1864;179;643;150;450;329;1093
314130;201410;704;2063;385;1327;68;252;77;267;145;519
314140;201410;5293;16464;4599;15117;1017;3605;2136;7029;3153;10634
314150;201410;1833;4876;1421;4224;277;927;695;2024;972;2951
314160;201410;2548;6823;1999;6088;142;459;1618;5085;1760;5544
314170;201410;1153;3535;950;3086;167;638;500;1559;667;2197
314180;201410;6668;21040;5836;19783;1595;5897;2638;9134;4233;15031
314190;201410;876;2677;733;2445;229;887;283;888;512;1775
314200;201410;3174;10223;2827;9595;413;1625;1902;6343;2315;7968
314210;201410;2093;6426;1873;6019;329;1213;1112;3421;1441;4634
314220;201410;1806;5867;1493;5239;508;1995;362;1120;870;3115
314225;201410;1259;3785;1126;3602;79;237;972;3177;1051;3414
314230;201410;744;2584;683;2470;223;867;241;839;464;1706
314240;201410;1203;3833;1053;3608;205;661;703;2521;908;3182
314250;201410;557;1673;423;1394;93;354;154;454;247;808
314260;201410;1320;4792;1241;4621;428;1692;435;1606;863;3298
314270;201410;2934;9903;2641;9368;328;1324;1804;6454;2132;7778
314280;201410;3492;9992;2478;8019;753;2783;710;2020;1463;4803
314290;201410;5599;15586;4759;14243;1136;3758;2869;8413;4005;12171
314300;201410;2006;6770;1835;6347;626;2244;658;2230;1284;4474
314310;201410;6886;21929;6051;20219;2324;8285;1752;5657;4076;13942
314315;201410;989;3789;914;3641;173;779;539;2180;712;2959
314320;201410;3741;11108;2965;10053;1017;3736;1212;4091;2229;7827
314330;201410;58870;186536;53871;178164;16333;58786;23398;76619;39731;135405
314340;201410;2608;7289;1430;4801;387;1428;139;310;526;1738
314345;201410;1410;4700;1242;4432;379;1400;654;2376;1033;3776
314350;201410;1501;4399;1214;3925;498;1748;336;1057;834;2805
314360;201410;767;2414;516;1856;149;623;128;427;277;1050
314370;201410;580;2038;533;1962;160;646;263;956;423;1602
314380;201410;1270;3863;916;3176;332;1227;256;915;588;2142
314390;201410;16540;49411;12985;42559;3889;13882;3656;11423;7545;25305
314400;201410;5709;16243;4631;14722;1586;5163;2169;7200;3755;12363
314410;201410;2876;9261;2467;8406;802;3102;825;2632;1627;5734
314420;201410;806;2351;644;2124;88;367;447;1448;535;1815
314430;201410;8514;25269;7625;23532;2532;8351;2496;7829;5028;16180
314435;201410;1335;4307;1182;4033;167;703;762;2553;929;3256
314437;201410;1231;3243;1078;3018;92;256;851;2411;943;2667
314440;201410;768;2140;543;1826;208;767;106;322;314;1089
314450;201410;1848;5476;1574;5082;521;1891;726;2226;1247;4117
314460;201410;4591;15945;3958;14488;1340;5297;789;2842;2129;8139
314465;201410;2468;7845;2273;7507;210;853;1711;5540;1921;6393
314467;201410;1178;3333;1003;3032;141;415;669;2073;810;2488
314470;201410;2509;8180;1991;6979;561;2248;500;1500;1061;3748
314480;201410;6486;21944;4506;16497;918;3647;506;1628;1424;5275
314490;201410;1012;3000;809;2593;250;870;312;943;562;1813
314500;201410;3040;8564;2369;7284;717;2425;819;2530;1536;4955
314505;201410;1817;5626;1713;5451;341;1193;1064;3400;1405;4593
314510;201410;2078;5874;1451;4937;532;1993;387;1263;919;3256
314520;201410;4027;15266;3276;13317;1076;4797;626;2315;1702;7112
314530;201410;7343;25530;6766;24631;1298;4859;3968;15049;5266;19908
314535;201410;3065;8408;2595;7781;342;1133;1885;5649;2227;6782
314537;201410;1492;4447;1199;3922;243;907;610;2003;853;2910
314540;201410;468;1459;412;1336;123;468;139;415;262;883
314545;201410;1447;4567;1266;4283;246;926;752;2536;998;3462
314550;201410;642;1820;494;1622;123;503;174;514;297;1017
314560;201410;5512;19613;4821;17762;1244;5033;1272;4513;2516;9546
314570;201410;360;1116;309;999;88;310;146;456;234;766
314580;201410;506;1748;406;1512;116;486;87;316;203;802
314585;201410;877;2936;626;2366;175;737;178;676;353;1413
314587;201410;1819;5767;1614;5396;300;1006;883;3021;1183;4027
314590;201410;4417;15424;3285;12310;883;3508;456;1592;1339;5100
314600;201410;2167;7510;1772;6744;707;2961;371;1350;1078;4311
314610;201410;8765;31092;8153;29650;2615;10419;2929;10086;5544;20505
314620;201410;1916;5579;1699;5299;225;664;1277;4120;1502;4784
314625;201410;1584;5317;1543;5264;169;575;1247;4336;1416;4911
314630;201410;5368;15803;4701;14742;586;2043;3285;10442;3871;12485
314640;201410;850;2446;717;2210;255;829;199;570;454;1399
314650;201410;1369;4052;1058;3481;273;1029;413;1235;686;2264
314655;201410;1612;4844;1236;4133;261;917;634;2130;895;3047
314660;201410;233;645;179;538;24;86;104;296;128;382
314670;201410;1577;4370;1256;3807;239;796;709;2142;948;2938
314675;201410;2006;6114;1770;5696;229;837;1127;3645;1356;4482
314690;201410;2816;8946;2368;8145;677;2691;701;2241;1378;4932
314700;201410;10289;37444;8554;33535;3454;14444;1957;7779;5411;22223
314710;201410;9142;29108;6458;23065;1657;6631;985;3181;2642;9812
314720;201410;2762;9273;2312;8342;694;2769;897;3188;1591;5957
314730;201410;2629;8123;2170;7459;752;2833;719;2376;1471;5209
314740;201410;3242;10762;2904;10120;846;3271;1178;3917;2024;7188
314750;201410;352;1146;314;1059;70;275;142;457;212;732
314760;201410;1714;5897;1247;4680;270;1224;289;899;559;2123
314770;201410;1197;3771;712;2418;87;364;119;301;206;665
314780;201410;336;917;254;809;85;314;111;345;196;659
314790;201410;13970;42795;10721;37033;4287;16714;2372;7639;6659;24353
314795;201410;1571;4784;1360;4444;163;675;1014;3191;1177;3866
314800;201410;17812;54448;14496;47648;5814;19998;3029;10129;8843;30127
314810;201410;13525;40633;10574;35291;3440;12722;2633;8771;6073;21493
314820;201410;1154;3201;790;2645;275;1009;247;756;522;1765
314830;201410;1857;6156;1581;5663;557;2172;608;2225;1165;4397
314840;201410;1141;4032;896;3654;233;1103;477;1894;710;2997
314850;201410;2337;6635;1902;5876;368;1336;1080;3288;1448;4624
314860;201410;3397;11608;3098;11119;672;2686;1843;6616;2515;9302
314870;201410;5939;18961;5281;18068;755;2893;3777;13118;4532;16011
314875;201410;1759;6010;1715;5946;243;811;1395;4920;1638;5731
314880;201410;862;2486;764;2336;71;228;545;1690;616;1918
314890;201410;628;1905;445;1519;109;434;138;405;247;839
314900;201410;454;1410;364;1259;98;354;166;573;264;927
314910;201410;1825;6362;1592;5940;650;2655;416;1464;1066;4119
314915;201410;2624;8245;2298;7759;223;884;1774;5947;1997;6831
314920;201410;668;1940;505;1699;113;433;236;741;349;1174
314930;201410;5392;18466;4758;17050;1576;6175;1131;3966;2707;10141
314940;201410;425;1261;397;1206;98;329;212;610;310;939
314950;201410;405;1378;338;1246;91;380;82;294;173;674
314960;201410;861;2781;690;2424;219;832;167;544;386;1376
314970;201410;831;2930;741;2755;258;1073;198;688;456;1761
314980;201410;2317;7131;2086;6752;875;2981;349;1080;1224;4061
314990;201410;3287;10638;2638;9171;969;3726;501;1561;1470;5287
314995;201410;1671;5165;1501;4925;191;755;1061;3426;1252;4181
315000;201410;1158;3364;939;3014;179;669;540;1706;719;2375
315010;201410;505;1615;416;1423;127;509;140;422;267;931
315015;201410;2014;6248;1830;6026;291;966;1317;4511;1608;5477
315020;201410;797;2507;601;2072;119;463;275;904;394;1367
315030;201410;1025;3135;879;2857;344;1182;211;673;555;1855
315040;201410;968;3009;885;2860;170;585;539;1720;709;2305
315050;201410;1691;5048;1390;4547;451;1614;509;1632;960;3246
315053;201410;1184;3510;1025;3256;253;957;432;1322;685;2279
315057;201410;1960;6675;1586;6095;262;1041;965;3846;1227;4887
315060;201410;1048;3435;799;2872;245;954;200;742;445;1696
315070;201410;773;2310;688;2191;197;700;364;1109;561;1809
315080;201410;3551;12144;3179;11340;859;3313;1439;5095;2298;8408
315090;201410;782;2833;694;2643;181;738;251;994;432;1732
315100;201410;1238;4265;958;3599;275;1166;209;715;484;1881
315110;201410;1732;5353;1515;4955;401;1431;691;2236;1092;3667
315120;201410;14398;34709;10242;29303;1881;5673;5588;16780;7469;22453
315130;201410;1859;6238;1683;5886;583;2238;455;1553;1038;3791
315140;201410;2689;9007;2241;8030;644;2670;731;2335;1375;5005
315150;201410;5007;13803;3743;11577;890;3184;1411;4202;2301;7386
315160;201410;1421;4144;1244;3837;270;918;654;1952;924;2870
315170;201410;1403;4113;1174;3783;220;763;650;2268;870;3031
315180;201410;15102;46555;11191;38158;3116;12003;2649;8622;5765;20625
315190;201410;2434;6509;1991;5866;585;1833;955;2823;1540;4656
315200;201410;4690;15859;3896;14054;1233;4832;1058;3707;2291;8539
315210;201410;9255;28233;7676;25086;2470;8767;2689;8612;5159;17379
315213;201410;1161;3762;1109;3692;104;302;936;3213;1040;3515
315217;201410;2804;9460;2348;8671;381;1608;1373;5068;1754;6676
315220;201410;10374;30401;8860;28056;2425;7637;4553;15033;6978;22670
315230;201410;2691;7192;2372;6809;149;344;2077;6124;2226;6468
315240;201410;3502;11022;3122;10418;630;2273;1901;6320;2531;8593
315250;201410;10269;32891;7789;28073;2528;10171;2405;8595;4933;18766
315260;201410;1150;3744;903;3196;324;1286;173;548;497;1834
315270;201410;896;3213;774;2953;254;1041;202;749;456;1790
315280;201410;4088;12514;3185;10491;1087;3773;792;2472;1879;6245
315290;201410;1333;3804;1011;3278;363;1301;196;622;559;1923
315300;201410;551;1569;428;1417;209;722;142;456;351;1178
315310;201410;1282;4240;1128;3964;168;676;737;2543;905;3219
315320;201410;896;2912;743;2697;206;817;351;1326;557;2143
315330;201410;716;2582;470;1939;159;739;62;245;221;984
315340;201410;4353;12642;3652;11537;922;3150;1681;5405;2603;8555
315350;201410;1926;5415;1492;4802;286;937;925;3089;1211;4026
315360;201410;1768;5927;1433;5046;330;1279;496;1633;826;2912
315370;201410;617;1873;544;1762;131;463;304;977;435;1440
315380;201410;297;1045;253;932;92;371;42;141;134;512
315390;201410;1986;7121;1711;6456;611;2458;421;1563;1032;4021
315400;201410;4901;14967;4233;13665;992;3481;2121;6821;3113;10302
315410;201410;1885;5184;1593;4729;267;988;1002;2863;1269;3851
315415;201410;1234;4146;1136;3990;455;1589;493;1833;948;3422
315420;201410;1221;3926;905;3246;264;1017;162;557;426;1574
315430;201410;4186;11440;3134;9663;868;3006;911;2706;1779;5712
315440;201410;1003;3093;893;2922;180;668;473;1534;653;2202
315445;201410;2293;6462;1914;5944;279;993;1328;4098;1607;5091
315450;201410;2587;8214;2388;7915;509;1650;1500;5191;2009;6841
315460;201410;40556;136674;36163;127172;12935;48793;9037;30910;21972;79703
315470;201410;588;1806;501;1649;88;336;290;921;378;1257
315480;201410;1541;4847;1026;3643;224;887;199;655;423;1542
315490;201410;3421;9669;2846;8852;510;1853;1542;4672;2052;6525
315500;201410;470;1459;304;1064;61;256;106;306;167;562
315510;201410;1551;4427;1325;4063;90;309;1001;3083;1091;3392
315520;201410;1198;3677;984;3387;171;677;607;2028;778;2705
315530;201410;522;1844;490;1786;224;869;171;600;395;1469
315540;201410;1289;3945;1025;3498;231;966;372;1232;603;2198
315550;201410;1879;5448;1534;4984;541;1962;555;1798;1096;3760
315560;201410;7464;24340;6787;23428;911;3459;4701;16392;5612;19851
315570;201410;2431;7662;2267;7414;517;1902;1299;4192;1816;6094
315580;201410;2847;8762;2301;7736;665;2607;833;2580;1498;5187
315590;201410;928;2717;832;2569;142;503;505;1517;647;2020
315600;201410;2740;9631;2260;8785;422;1706;1274;5198;1696;6904
315610;201410;1058;3134;876;2744;188;734;331;870;519;1604
315620;201410;358;1265;340;1229;103;362;175;665;278;1027
315630;201410;1046;3363;890;3097;253;946;244;822;497;1768
315640;201410;838;2520;709;2277;214;773;268;808;482;1581
315645;201410;898;2881;776;2597;313;1154;198;633;511;1787
315650;201410;2082;5870;1772;5436;163;638;1333;4015;1496;4653
315660;201410;2770;7433;2411;6877;503;1477;1411;4028;1914;5505
315670;201410;12640;44728;11499;42379;4151;16332;3675;13336;7826;29668
315680;201410;2967;10347;2429;9297;935;3681;574;2311;1509;5992
315690;201410;3716;11335;2829;9692;919;3442;780;2701;1699;6143
315700;201410;7700;24406;6577;22127;1381;5307;3159;10199;4540;15506
315710;201410;1924;5628;1531;4996;186;739;954;3066;1140;3805
315720;201410;3092;10017;2828;9501;686;2696;1440;4577;2126;7273
315725;201410;1712;5262;1392;4839;392;1411;731;2590;1123;4001
315727;201410;680;2133;590;1952;143;521;263;842;406;1363
315730;201410;1019;3141;929;2972;207;716;523;1675;730;2391
315733;201410;1211;3915;1116;3726;460;1618;375;1233;835;2851
315737;201410;1404;4248;1112;3709;113;447;711;2397;824;2844
315740;201410;1118;3527;958;3210;206;818;487;1539;693;2357
315750;201410;1205;3742;1071;3542;115;465;792;2571;907;3036
315760;201410;998;2745;960;2697;25;75;889;2503;914;2578
315765;201410;1594;4836;1472;4650;141;466;1153;3693;1294;4159
315770;201410;1750;5697;1575;5318;455;1663;540;1766;995;3429
315780;201410;24769;82165;22817;77848;7416;26992;7128;24308;14544;51300
315790;201410;3429;11690;3043;10875;388;1335;2055;7563;2443;8898
315800;201410;1586;6202;1274;5245;373;1706;265;1043;638;2749
315810;201410;1556;4413;1321;4042;219;723;857;2580;1076;3303
315820;201410;3084;10062;2619;9356;816;3026;1211;4459;2027;7485
315830;201410;1497;5090;1351;4769;344;1366;396;1291;740;2657
315840;201410;803;2134;598;1774;99;345;236;643;335;988
315850;201410;1343;4738;1289;4619;330;1239;586;2043;916;3282
315860;201410;483;1728;384;1532;112;521;81;303;193;824
315870;201410;487;1466;410;1349;128;465;133;400;261;865
315880;201410;1154;3160;956;2909;251;878;456;1374;707;2252
315890;201410;1764;6005;1592;5740;558;2116;733;2699;1291;4815
315895;201410;5382;16841;4932;15978;1290;4642;2290;7238;3580;11880
315900;201410;828;2607;777;2522;158;625;486;1458;644;2083
315910;201410;627;2222;585;2141;218;829;275;994;493;1823
315920;201410;1603;4673;1075;3553;296;1104;315;944;611;2048
315930;201410;1167;3251;933;2837;261;866;332;983;593;1849
315935;201410;1189;4042;1098;3842;353;1361;350;1185;703;2546
315940;201410;686;2182;613;2033;178;663;256;820;434;1483
315950;201410;1294;3980;1195;3784;276;875;722;2353;998;3228
315960;201410;2869;9551;2141;8062;1021;4394;118;369;1139;4763
315970;201410;812;2289;653;2066;75;230;477;1561;552;1791
315980;201410;4555;11255;2950;8504;788;2610;883;2211;1671;4821
315990;201410;4533;13532;3966;12640;887;3290;2128;6729;3015;10019
316000;201410;628;2014;553;1900;232;873;179;581;411;1454
316010;201410;496;1766;433;1634;107;485;144;476;251;961
316020;201410;1206;3836;973;3426;178;736;559;1952;737;2688
316030;201410;3796;10703;2695;8890;394;1436;1422;4826;1816;6262
316040;201410;3647;11547;2608;9187;478;1945;354;940;832;2885
316045;201410;2208;7010;2040;6730;291;869;1466;5094;1757;5963
316050;201410;375;1196;306;1086;68;269;171;580;239;849
316060;201410;800;2410;651;2192;121;502;356;1134;477;1636
316070;201410;6480;21089;5682;19235;1611;6097;2335;7485;3946;13582
316080;201410;764;2860;687;2649;187;790;131;513;318;1303
316090;201410;692;2025;489;1597;126;465;129;382;255;847
316095;201410;1370;4508;1225;4241;266;938;793;2811;1059;3749
316100;201410;2759;9305;2112;7644;574;2376;434;1448;1008;3824
316105;201410;988;2773;739;2366;178;625;338;1105;516;1730
316110;201410;12912;44799;11694;42568;1667;6651;7987;29773;9654;36424
316120;201410;1362;4597;1206;4227;395;1446;431;1461;826;2907
316130;201410;1548;3494;1015;2756;205;660;507;1329;712;1989
316140;201410;1111;3283;856;2877;123;464;515;1750;638;2214
316150;201410;1469;4403;1395;4287;324;1173;802;2394;1126;3567
316160;201410;1279;3859;1004;3303;145;550;556;1805;701;2355
316165;201410;1010;2786;849;2535;176;605;485;1416;661;2021
316170;201410;1456;4218;1090;3565;249;909;457;1419;706;2328
316180;201410;1338;4280;1017;3584;288;1184;269;838;557;2022
316190;201410;2801;8722;1404;4979;330;1235;224;668;554;1903
316200;201410;3983;12967;3071;11079;782;3258;904;3165;1686;6423
316210;201410;5535;17593;4826;16260;2192;7934;959;3225;3151;11159
316220;201410;696;2193;486;1778;119;520;62;236;181;756
316225;201410;1165;3359;1024;3162;147;545;706;2126;853;2671
316230;201410;469;1401;385;1253;79;276;197;672;276;948
316240;201410;6876;21155;5919;19903;673;2310;4543;15483;5216;17793
316245;201410;3256;11315;3033;10943;279;1268;2318;8315;2597;9583
316250;201410;9348;28893;7892;25850;2705;9733;2395;7376;5100;17109
316255;201410;2528;7840;2231;7482;359;1200;1627;5520;1986;6720
316257;201410;1456;4096;1113;3475;268;926;414;1266;682;2192
316260;201410;1946;5524;1445;4779;270;991;806;2716;1076;3707
316265;201410;1288;3623;990;3023;107;398;627;1847;734;2245
316270;201410;5231;16804;4827;15962;1383;4825;2154;7203;3537;12028
316280;201410;3471;11470;3129;10780;599;2285;1754;6060;2353;8345
316290;201410;3417;11165;3034;10417;777;3063;1327;4331;2104;7394
316292;201410;3871;12773;3523;12139;972;3666;1655;5445;2627;9111
316294;201410;867;2797;558;2054;129;556;66;226;195;782
316295;201410;2097;7418;1968;7156;450;1914;1082;3716;1532;5630
316300;201410;1043;3192;883;2901;86;289;610;2046;696;2335
316310;201410;695;2208;541;1889;132;528;193;657;325;1185
316320;201410;584;1965;518;1871;152;606;145;499;297;1105
316330;201410;1072;3250;845;2766;134;447;507;1679;641;2126
316340;201410;1183;3849;1014;3508;317;1263;329;1039;646;2302
316350;201410;1531;4789;1387;4543;292;953;710;2490;1002;3443
316360;201410;799;2081;621;1833;73;225;472;1398;545;1623
316370;201410;5256;17406;4652;16163;1654;6152;1061;3728;2715;9880
316380;201410;1559;4363;1273;3940;133;473;911;2832;1044;3305
316390;201410;953;2863;794;2586;260;920;342;1127;602;2047
316400;201410;1550;5170;1322;4751;356;1373;556;2008;912;3381
316410;201410;1241;4153;1160;4022;258;951;685;2394;943;3345
316420;201410;2099;6950;1915;6699;283;1157;1245;4355;1528;5512
316430;201410;1002;3073;810;2719;246;916;286;904;532;1820
316440;201410;706;2305;593;2143;242;1000;162;561;404;1561
316443;201410;745;2238;619;1998;155;549;272;851;427;1400
316447;201410;1573;4988;1472;4833;119;423;1264;4157;1383;4580
316450;201410;2335;7988;2059;7460;396;1508;1292;4787;1688;6295
316460;201410;930;2999;873;2903;269;964;478;1529;747;2493
316470;201410;8448;27855;6690;23940;2094;8534;2015;6859;4109;15393
316480;201410;254;875;229;830;66;250;71;250;137;500
316490;201410;383;1237;364;1191;125;429;155;488;280;917
316500;201410;1096;4009;743;2906;165;699;46;180;211;879
316510;201410;984;3570;877;3333;345;1359;240;905;585;2264
316520;201410;1254;3905;1042;3573;270;1049;397;1233;667;2282
316530;201410;1149;3760;955;3350;239;1046;355;1038;594;2084
316540;201410;1047;3426;941;3246;257;1053;362;1142;619;2195
316550;201410;1351;4521;1238;4341;269;1030;767;2693;1036;3723
316553;201410;2345;8541;1939;7540;676;2833;452;1692;1128;4525
316555;201410;3029;10311;2647;9885;242;875;2127;8157;2369;9032
316556;201410;604;1678;489;1470;41;162;365;1053;406;1215
316557;201410;745;2735;714;2681;340;1368;191;669;531;2037
316560;201410;383;1299;318;1151;92;392;75;228;167;620
316570;201410;1469;4688;1282;4294;258;946;682;2281;940;3227
316580;201410;292;856;223;717;62;238;75;217;137;455
316590;201410;1561;4351;1172;3683;213;801;676;2027;889;2828
316600;201410;1202;3926;1062;3640;374;1346;298;999;672;2345
316610;201410;638;2329;581;2223;142;600;339;1294;481;1894
316620;201410;2325;7338;2023;6734;460;1716;1094;3567;1554;5283
316630;201410;1582;5301;1385;4879;577;2121;426;1502;1003;3623
316640;201410;263;870;229;796;61;238;93;310;154;548
316650;201410;995;3757;869;3544;207;866;473;2052;680;2918
316660;201410;157;467;125;401;27;101;57;173;84;274
316670;201410;1894;5547;1518;4833;594;2095;366;1056;960;3151
316680;201410;2100;6109;1795;5646;240;739;1379;4435;1619;5174
316690;201410;1233;4228;1115;3991;390;1580;416;1442;806;3022
316695;201410;1269;3950;1130;3705;130;418;732;2514;862;2932
316700;201410;359;1220;335;1161;87;348;159;511;246;859
316710;201410;3537;13396;3065;12301;1075;4580;926;3880;2001;8460
316720;201410;19298;65110;16340;58429;5656;21524;4224;14848;9880;36372
316730;201410;451;1434;399;1333;102;399;206;634;308;1033
316740;201410;782;2690;702;2525;269;1041;220;765;489;1806
316750;201410;432;1501;384;1399;104;429;128;431;232;860
316760;201410;3720;12539;3144;11851;1789;6756;969;3864;2758;10620
316770;201410;1541;4532;1368;4300;203;697;950;3073;1153;3770
316780;201410;740;2560;681;2441;251;978;197;660;448;1638
316790;201410;882;2619;650;2201;181;690;231;768;412;1458
316800;201410;6026;20107;5473;19069;1159;4684;2786;9277;3945;13961
316805;201410;916;2479;858;2401;149;391;645;1867;794;2258
316810;201410;631;1962;552;1793;180;640;242;760;422;1400
316820;201410;417;1182;280;941;91;333;64;218;155;551
316830;201410;661;2332;637;2290;216;852;275;951;491;1803
316840;201410;3006;9149;2602;8398;707;2596;1087;3317;1794;5913
316850;201410;2273;7116;2047;6695;454;1630;1136;3713;1590;5343
316860;201410;25200;77835;22448;72690;6201;22210;9895;31611;16096;53821
316870;201410;7482;24970;6443;22431;2362;8842;1302;4414;3664;13256
316880;201410;947;3176;909;3114;359;1364;298;957;657;2321
316890;201410;1517;3891;1215;3477;473;1504;515;1403;988;2907
316900;201410;2848;9018;2471;8236;783;2920;818;2473;1601;5393
316905;201410;506;1728;441;1580;192;720;128;447;320;1167
316910;201410;770;2627;605;2261;153;596;182;707;335;1303
316920;201410;1659;5005;1329;4486;260;933;648;2194;908;3127
316930;201410;9957;34434;8272;30523;2527;10267;1584;5459;4111;15726
316935;201410;5190;15632;3607;12376;1227;4684;734;2358;1961;7042
316940;201410;7217;24237;5976;21526;1643;6557;1559;5387;3202;11944
316950;201410;1642;4791;1415;4467;215;803;943;2956;1158;3759
316960;201410;5670;14564;4693;13297;1037;3176;2726;7729;3763;10905
316970;201410;3737;12129;3529;11772;1183;4494;1183;3645;2366;8139
316980;201410;1122;3340;813;2804;338;1285;206;711;544;1996
316990;201410;10555;35215;9278;32210;3750;14114;1188;3925;4938;18039
317000;201410;2819;9743;2715;9622;213;641;2174;8485;2387;9126
317005;201410;2665;8485;2437;8179;393;1340;1755;5995;2148;7335
317010;201410;33961;89283;21642;68782;6296;22083;5434;18113;11730;40196
317020;201410;57816;168351;36849;123372;9805;36149;9075;28393;18880;64542
317030;201410;911;2561;757;2330;120;434;432;1317;552;1751
317040;201410;13844;41704;11909;38098;4034;13446;4824;15714;8858;29160
317043;201410;873;2483;738;2304;159;517;455;1448;614;1965
317047;201410;1245;3272;925;2739;176;575;419;1227;595;1802
317050;201410;1934;6834;1622;6086;471;1918;600;2157;1071;4075
317052;201410;2564;8154;2274;7710;274;1027;1690;5782;1964;6809
317057;201410;1855;5313;1430;4578;205;791;785;2432;990;3223
317060;201410;417;1248;309;999;73;271;105;305;178;576
317065;201410;1262;4206;1148;4016;127;520;899;3124;1026;3644
317070;201410;9525;31417;7188;25961;2144;8561;1513;5479;3657;14040
317075;201410;1316;4112;1107;3718;381;1384;374;1205;755;2589
317080;201410;7472;21406;6689;20072;2050;6565;2623;7865;4673;14430
317090;201410;5044;17022;4705;16437;716;2554;3241;11548;3957;14102
317100;201410;3551;10266;2924;9207;974;3391;1169;3489;2143;6880
317103;201410;2056;7159;1737;6493;360;1672;788;2848;1148;4520
317107;201410;1409;4372;1214;3977;251;954;667;2053;918;3007
317110;201410;783;2086;535;1623;152;536;213;598;365;1134
317115;201410;1143;3668;994;3341;149;523;641;2178;790;2701
317120;201410;13932;47440;11867;42493;3907;14953;4438;15647;8345;30600
317130;201410;9304;29599;8264;27709;2278;8561;3641;11932;5919;20493
317140;201410;687;2355;647;2278;88;336;427;1503;515;1839
317150;201410;1104;3047;932;2851;104;365;694;2124;798;2489
317160;201410;3957;10513;2959;9219;392;1390;2025;6257;2417;7647
317170;201410;2098;6066;1825;5574;255;907;1085;3137;1340;4044
317180;201410;1894;6397;1483;5474;440;1781;463;1649;903;3430
317190;201410;1427;4091;1177;3749;174;566;819;2618;993;3184
317200;201410;5012;16441;4494;15374;1507;5659;1453;4760;2960;10419
317210;201410;1156;3525;957;3226;258;975;467;1581;725;2556
317220;201410;363;1291;352;1278;124;460;184;682;308;1142
320010;201410;6064;19110;5352;17505;1009;3541;2754;8964;3763;12505
320013;201410;2130;6299;1501;5102;239;861;800;2784;1039;3645
320016;201410;3648;10148;3076;9322;484;1459;2156;6669;2640;8128
320020;201410;4540;14447;3998;13311;1347;4769;1464;4823;2811;9592
320030;201410;1571;5051;1270;4383;392;1438;490;1640;882;3078
320035;201410;1972;5958;1762;5629;532;1883;821;2509;1353;4392
320040;201410;3304;11148;2697;9671;730;2867;763;2613;1493;5480
320050;201410;1996;5435;1718;4902;300;960;1033;2884;1333;3844
320060;201410;11800;37539;9115;31133;2317;8756;3179;10256;5496;19012
320070;201410;1895;6292;1624;5641;532;1966;420;1347;952;3313
320080;201410;5814;17121;4609;14695;1438;4904;1479;4661;2917;9565
320090;201410;9257;26588;7185;22501;1978;6615;3150;9568;5128;16183
320100;201410;3298;9988;2704;8791;680;2373;1271;4065;1951;6438
320110;201410;1579;4809;1427;4518;391;1326;508;1575;899;2901
320115;201410;1815;6525;1659;6194;890;3461;464;1744;1354;5205
320120;201410;18987;62643;15690;55901;5451;20851;4588;16499;10039;37350
320130;201410;43660;145027;40296;137786;11125;41321;18969;63390;30094;104711
320140;201410;4153;13374;2894;10317;783;3105;315;1038;1098;4143
320150;201410;18873;53557;13937;43984;4324;14723;2687;8343;7011;23066
320160;201410;5585;17088;4782;15687;1308;4835;1984;6046;3292;10881
320170;201410;1674;5481;1422;4917;395;1433;557;1960;952;3393
320180;201410;912;3010;818;2863;315;1145;314;1107;629;2252
320190;201410;4161;14409;3339;12328;1037;4022;1005;3646;2042;7668
320200;201410;1186;3802;1032;3499;302;1084;444;1543;746;2627
320210;201410;5017;14099;4332;12824;919;3102;2374;6687;3293;9789
320220;201410;3060;9374;2416;8216;731;2706;930;3193;1661;5899
320225;201410;1571;5480;1320;4841;492;1912;297;1142;789;3054
320230;201410;4379;14708;4077;14123;1426;5302;1437;5050;2863;10352
320240;201410;10990;33039;8439;28139;2468;8904;2294;7640;4762;16544
320245;201410;4210;14377;3896;13593;1288;4758;1374;4668;2662;9426
320250;201410;1891;5910;1404;4787;377;1424;313;962;690;2386
320255;201410;2091;7006;1815;6524;742;2861;650;2396;1392;5257
320260;201410;1138;3551;851;2808;235;872;293;829;528;1701
320265;201410;2561;7935;2176;7462;330;1153;1547;5479;1877;6632
320270;201410;2844;8697;2162;7312;569;2085;928;3083;1497;5168
320280;201410;7449;22764;6730;21386;1652;5700;3247;10092;4899;15792
320290;201410;1754;5808;1385;4854;506;1863;329;1053;835;2916
320300;201410;4451;15054;4073;14166;1307;4813;1258;4372;2565;9185
320305;201410;4921;16178;4442;15071;1135;4208;2016;6657;3151;10865
320310;201410;2073;6299;1825;5832;502;1718;807;2507;1309;4225
320313;201410;2467;7426;1757;5771;501;1898;307;902;808;2800
320316;201410;2395;7323;2089;6681;670;2246;852;2690;1522;4936
320320;201410;20367;65114;17052;58638;5168;19675;6391;21418;11559;41093
320330;201410;3153;9495;2711;8739;579;1831;1570;5272;2149;7103
320332;201410;5266;17885;4726;16854;1665;6237;1748;6400;3413;12637
320334;201410;1658;5487;1214;4477;412;1695;263;874;675;2569
320335;201410;2365;7166;1655;5511;555;2027;338;1069;893;3096
320340;201410;6025;16972;4817;14870;1186;4021;2253;6860;3439;10881
320350;201410;5722;15028;4168;12296;975;3095;1714;4993;2689;8088
320360;201410;1808;4838;1352;3963;267;901;636;1720;903;2621
320370;201410;3628;11929;3035;10676;962;3458;1156;4091;2118;7549
320380;201410;2961;8967;2634;8357;510;1762;1568;4883;2078;6645
320390;201410;8606;26174;7030;22935;2296;8236;2205;6828;4501;15064
320400;201410;4194;12128;3474;11026;1014;3632;1496;4406;2510;8038
320405;201410;4205;12490;3823;11966;1165;3944;2030;6242;3195;10186
320410;201410;6452;15911;4611;13767;907;2836;2819;8430;3726;11266
320420;201410;1601;5001;1152;4189;393;1556;210;742;603;2298
320425;201410;2498;6402;2026;5698;356;1100;1220;3413;1576;4513
320430;201410;2486;7272;2239;6775;466;1496;1190;3566;1656;5062
320435;201410;2687;9032;2280;8165;1071;3969;707;2640;1778;6609
320440;201410;1471;4941;1310;4489;388;1441;428;1394;816;2835
320450;201410;2593;8341;2192;7468;664;2432;905;3009;1569;5441
320455;201410;4687;16123;3475;13027;1149;4535;837;3090;1986;7625
320460;201410;3264;10563;2606;9152;761;2866;942;3195;1703;6061
320465;201410;1766;5573;1364;4606;346;1246;516;1676;862;2922
320470;201410;4885;14967;3446;11736;1109;4110;531;1612;1640;5722
320480;201410;2030;6163;1679;5463;430;1625;718;2211;1148;3836
320490;201410;15638;48968;12840;43323;4255;15473;3927;13345;8182;28818
320495;201410;1392;4401;1059;3636;476;1685;136;497;612;2182
320500;201410;49176;153348;42758;140928;12909;46243;19197;61709;32106;107952
320501;201410;3999;12949;3594;12255;1166;4456;1563;5143;2729;9599
320503;201410;1715;5985;1400;5231;463;1910;438;1465;901;3375
320506;201410;3516;11154;2340;8094;757;2780;186;558;943;3338
320510;201410;9346;29805;8137;27320;2506;9093;3399;11211;5905;20304
320515;201410;2230;6414;1938;5822;573;1812;677;1986;1250;3798
320517;201410;2381;7744;1944;6797;774;2911;428;1400;1202;4311
320520;201410;37421;118320;31296;106090;9892;36645;12436;41893;22328;78538
320530;201410;30333;94291;25665;84844;6761;25387;11508;36013;18269;61400
330010;201410;19437;60470;17706;56882;3540;12768;10545;32824;14085;45592
330015;201410;2046;5709;1765;5178;459;1508;669;1892;1128;3400
330020;201410;17716;53020;16136;50411;3718;12569;9210;28396;12928;40965
330022;201410;1751;5608;1541;5200;327;1291;832;2687;1159;3978
330023;201410;3631;11815;3368;11265;948;3445;1384;4417;2332;7862
330025;201410;4038;11481;3445;10616;845;2833;1971;5979;2816;8812
330030;201410;8304;28270;7337;26208;2009;7873;3282;11263;5291;19136
330040;201410;15172;44034;12850;40140;3422;11509;6369;19430;9791;30939
330045;201410;72216;206273;65343;195781;9558;30825;45339;134775;54897;165600
330050;201410;3043;9723;2706;9039;942;3506;800;2503;1742;6009
330060;201410;5918;17904;5278;16970;1314;4668;2961;9544;4275;14212
330070;201410;26961;83045;24277;78213;6664;22776;11244;36286;17908;59062
330080;201410;9859;28190;9324;27400;1750;4998;6378;19253;8128;24251
330090;201410;3385;9370;3127;8925;844;2592;1530;4297;2374;6889
330093;201410;2076;6190;1723;5478;433;1476;578;1744;1011;3220
330095;201410;1253;4345;1156;4121;431;1685;223;719;654;2404
330100;201410;58521;190973;53628;182166;11975;45077;27841;95078;39816;140155
330110;201410;2800;8864;2554;8404;801;2858;859;2814;1660;5672
330115;201410;2528;7524;2306;7150;671;2284;1084;3243;1755;5527
330120;201410;2627;7639;2393;7313;744;2471;1109;3271;1853;5742
330130;201410;4256;14008;3826;13177;1255;4637;1533;5270;2788;9907
330140;201410;3653;11196;3325;10732;934;3222;1656;5407;2590;8629
330150;201410;2683;8023;2071;6735;551;1950;510;1619;1061;3569
330160;201410;1463;5073;1356;4846;494;1890;505;1768;999;3658
330170;201410;110199;334495;102764;322561;16690;56011;70316;220764;87006;276775
330180;201410;1938;5880;1684;5388;231;940;1056;3148;1287;4088
330185;201410;8558;27022;7787;25556;2076;7180;3961;13150;6037;20330
330187;201410;4580;13145;4043;12237;835;2758;2432;7379;3267;10137
330190;201410;30065;89717;28434;86998;6654;21472;17357;52603;24011;74075
330200;201410;14667;46317;13165;43465;3233;10886;7037;23663;10270;34549
330205;201410;2691;7315;2368;6758;584;1868;1188;3276;1772;5144
330210;201410;4580;12069;3311;9721;987;3133;818;2381;1805;5514
330220;201410;12183;38259;11026;35776;3656;12753;3336;10342;6992;23095
330225;201410;4253;13379;3983;12971;509;1918;2895;9538;3404;11456
330227;201410;18859;53166;16698;50120;4092;13033;9509;28200;13601;41233
330230;201410;1543;4594;1408;4351;409;1412;579;1672;988;3084
330240;201410;21283;66216;18886;61756;7579;26801;3762;11966;11341;38767
330245;201410;1322;4180;1084;3693;314;1167;259;885;573;2052
330250;201410;39179;115109;36149;109967;10799;33279;17496;54423;28295;87702
330260;201410;4110;12983;3725;12164;944;3372;1730;5431;2674;8803
330270;201410;15146;43588;12565;39533;3803;12726;4794;15258;8597;27984
330280;201410;2163;6720;1818;5999;384;1408;872;2728;1256;4136
330285;201410;20298;59787;18616;57315;3699;12163;11931;36803;15630;48966
330290;201410;3746;10600;3308;9960;684;2346;1957;5627;2641;7973
330300;201410;4233;13747;3929;13184;933;3360;2107;7073;3040;10433
330310;201410;2888;8359;2589;7838;624;1926;1311;3967;1935;5893
330320;201410;13265;39705;12423;38393;1917;6447;8900;27361;10817;33808
330330;201410;33739;96667;30796;91905;7017;22437;18914;55767;25931;78204
330340;201410;15785;48438;12772;42422;4121;14603;3672;12110;7793;26713
330350;201410;99244;309898;94841;303216;17677;57391;66443;214997;84120;272388
330360;201410;5993;18683;5849;18458;719;2460;4644;14605;5363;17065
330370;201410;4016;14794;3751;14168;1462;5767;1241;4717;2703;10484
330380;201410;4964;15979;4300;14734;1065;3939;2149;7265;3214;11204
330385;201410;4236;14698;3913;14029;1336;5097;1491;5301;2827;10398
330390;201410;25294;85055;22890;80084;5803;22554;11276;38535;17079;61089
330395;201410;3538;10506;3256;10002;591;2010;1966;5975;2557;7985
330400;201410;2735;9099;2494;8624;523;2104;1315;4207;1838;6311
330410;201410;3153;10055;2713;9161;620;2217;1381;4664;2001;6881
330411;201410;2710;8593;2369;7883;465;1821;1279;4000;1744;5821
330412;201410;1462;5022;1159;4425;315;1365;413;1495;728;2860
330414;201410;27014;76683;23167;71446;4314;13871;14962;46465;19276;60336
330415;201410;3860;11990;3377;11076;912;3221;1435;4714;2347;7935
330420;201410;9342;28852;6633;23331;1979;7609;1206;4185;3185;11794
330430;201410;8765;25735;7737;23878;1827;6161;3873;11773;5700;17934
330440;201410;2175;7254;1817;6500;644;2582;402;1282;1046;3864
330450;201410;1741;5913;1601;5648;495;1963;695;2412;1190;4375
330452;201410;11261;34250;9027;29750;2501;9143;3646;11515;6147;20658
330455;201410;505829;1471010;429446;1344811;112906;376382;217030;677205;329936;1053587
330460;201410;1442;4787;1316;4561;335;1336;633;2167;968;3503
330470;201410;4954;15783;4496;14891;1532;5559;1629;5153;3161;10712
330475;201410;8669;27255;7746;25642;2197;7904;3475;11507;5672;19411
330480;201410;6817;20242;6236;19321;1687;5612;2999;9194;4686;14806
330490;201410;107020;297682;98916;285797;12640;38272;75795;219929;88435;258201
330500;201410;7174;21888;6731;21000;1482;4942;3749;11936;5231;16878
330510;201410;44730;142955;41644;137748;13524;45523;20513;69344;34037;114867
330513;201410;1633;4905;1484;4623;524;1654;594;1878;1118;3532
330515;201410;3198;10100;2885;9497;944;3281;1016;3301;1960;6582
330520;201410;13679;41016;12423;38821;3234;10576;6421;20189;9655;30765
330530;201410;1613;4824;1461;4533;392;1315;656;1992;1048;3307
330540;201410;3628;10799;3078;9881;864;2984;1301;4123;2165;7107
330550;201410;9157;30200;8035;28057;3420;12615;1923;6728;5343;19343
330555;201410;10888;32940;9754;31217;1922;6314;6200;20224;8122;26538
330560;201410;4416;13434;4051;12809;901;3250;2121;6451;3022;9701
330570;201410;3759;10857;3182;9872;832;2658;1627;5124;2459;7782
330575;201410;5844;17247;5284;16277;1141;3851;3147;9355;4288;13206
330580;201410;17980;57722;15632;52875;5075;18024;5927;20343;11002;38367
330590;201410;2027;6104;1892;5870;534;1684;1003;3162;1537;4846
330600;201410;10969;31836;8896;28455;1371;5296;5296;16315;6667;21611
330610;201410;9506;30489;8766;29117;2050;7658;4636;15171;6686;22829
330615;201410;1724;6141;1572;5750;701;2673;451;1698;1152;4371
330620;201410;4218;14678;3842;13928;1415;5443;1082;4048;2497;9491
330630;201410;23934;75673;20660;69351;5214;19711;10397;33375;15611;53086
350010;201410;3062;9561;2365;8076;790;2833;455;1462;1245;4295
350020;201410;651;1854;490;1541;142;501;193;576;335;1077
350030;201410;5036;15994;4152;14005;1654;6072;1004;3182;2658;9254
350040;201410;620;2217;526;2003;172;709;118;400;290;1109
350050;201410;1462;4737;1218;4259;346;1380;403;1299;749;2679
350055;201410;690;2217;652;2157;201;753;322;997;523;1750
350060;201410;95;330;88;317;27;114;34;114;61;228
350070;201410;2702;8899;2061;7360;505;1969;409;1267;914;3236
350075;201410;578;1988;492;1832;171;708;133;448;304;1156
350080;201410;644;1879;491;1568;117;411;187;590;304;1001
350090;201410;602;1713;449;1438;125;432;125;357;250;789
350100;201410;2140;7187;1704;6177;571;2221;501;1746;1072;3967
350110;201410;508;1543;387;1263;90;335;151;452;241;787
350115;201410;1313;4201;1154;3820;237;909;574;1727;811;2636
350120;201410;543;1450;269;855;70;243;48;144;118;387
350130;201410;3965;12035;3564;11221;858;3031;1690;4969;2548;8000
350140;201410;711;2250;637;2105;156;580;275;872;431;1452
350150;201410;439;1516;403;1434;159;588;107;390;266;978
350160;201410;6742;21140;5113;17573;1510;5787;1952;6117;3462;11904
350170;201410;2339;8285;2070;7581;707;2697;499;1737;1206;4434
350180;201410;1482;3914;1225;3470;328;965;536;1491;864;2456
350190;201410;3522;11799;3022;10778;800;3374;1493;4828;2293;8202
350200;201410;410;1399;372;1333;128;516;133;459;261;975
350210;201410;7870;21931;6152;18943;2334;7766;2053;6015;4387;13781
350220;201410;3253;10428;2948;9866;1012;3835;950;2899;1962;6734
350230;201410;801;2708;732;2587;242;923;264;932;506;1855
350240;201410;614;1869;535;1742;127;461;298;939;425;1400
350250;201410;2857;10611;2760;10416;1123;4487;976;3659;2099;8146
350260;201410;1128;3002;920;2640;220;644;402;1170;622;1814
350270;201410;5543;16987;4832;15448;985;3416;2374;7479;3359;10895
350275;201410;2143;7176;1922;6817;564;2206;732;2442;1296;4648
350280;201410;24602;63390;15707;47325;4067;12988;3804;11511;7871;24499
350290;201410;2038;6918;1736;6231;521;1938;546;2014;1067;3952
350300;201410;545;1696;487;1581;146;489;204;670;350;1159
350310;201410;988;3314;894;3092;211;831;368;1213;579;2044
350315;201410;579;1817;471;1585;90;386;145;442;235;828
350320;201410;12053;38572;10404;34997;3153;11298;1658;5622;4811;16920
350330;201410;13374;38811;8676;27170;1893;6252;3221;9323;5114;15575
350335;201410;569;1676;523;1581;138;431;222;732;360;1163
350340;201410;1163;3611;887;3071;234;900;272;892;506;1792
350350;201410;779;2480;684;2320;175;692;247;835;422;1527
350360;201410;934;3293;805;3005;254;996;289;1109;543;2105
350370;201410;743;2290;544;1821;118;444;110;307;228;751
350380;201410;4042;13074;3357;11938;1366;5286;863;2910;2229;8196
350390;201410;9034;29071;7977;27002;2334;8412;3548;11698;5882;20110
350395;201410;378;1124;242;839;67;249;57;192;124;441
350400;201410;8884;25990;7315;23107;2093;7236;2843;8583;4936;15819
350410;201410;8642;30799;7179;27417;2478;10254;1619;5958;4097;16212
350420;201410;958;3062;765;2686;373;1355;95;328;468;1683
350430;201410;886;2804;758;2573;206;821;374;1215;580;2036
350440;201410;1508;4870;1411;4678;463;1633;672;2141;1135;3774
350450;201410;8303;25177;6547;21624;1963;7039;1783;5546;3746;12585
350460;201410;1657;4881;1188;3860;348;1266;379;1117;727;2383
350470;201410;263;729;216;652;55;200;106;290;161;490
350480;201410;759;2352;504;1748;84;327;91;269;175;596
350490;201410;2132;6227;1814;5791;528;1936;797;2348;1325;4284
350500;201410;626;1849;545;1724;142;493;227;684;369;1177
350510;201410;1187;3757;953;3189;267;1022;341;1026;608;2048
350520;201410;1002;3761;846;3392;272;1197;223;830;495;2027
350530;201410;2674;8079;2203;7034;800;2754;623;1820;1423;4574
350535;201410;1523;4555;1452;4441;101;377;1185;3596;1286;3973
350540;201410;2124;6023;1769;5377;511;1669;682;2055;1193;3724
350550;201410;11456;33654;9093;29471;2530;9159;3520;10810;6050;19969
350560;201410;3695;12334;3328;11532;647;2389;1721;6030;2368;8419
350570;201410;22300;76896;20330;72290;6676;25344;7375;25235;14051;50579
350580;201410;2090;6829;1631;5707;511;1974;252;753;763;2727
350590;201410;4374;14081;3368;11901;1022;4044;1151;3666;2173;7710
350600;201410;42317;107869;29368;86651;5884;19167;14893;42295;20777;61462
350610;201410;9711;28318;7629;24683;2044;7373;3318;10372;5362;17745
350620;201410;506;1539;412;1388;106;401;172;542;278;943
350630;201410;1795;5514;1394;4694;421;1601;291;864;712;2465
350635;201410;5632;17955;4456;15643;1352;5037;1707;5984;3059;11021
350640;201410;708;2312;563;1917;153;560;151;481;304;1041
350650;201410;7012;21521;3742;13344;1127;4421;356;1260;1483;5681
350660;201410;3957;12321;3421;11365;802;2953;1848;6002;2650;8955
350670;201410;1952;6103;1815;5842;377;1329;1120;3482;1497;4811
350680;201410;1284;4007;1026;3468;296;1160;406;1309;702;2469
350690;201410;1133;3760;954;3381;294;1148;279;919;573;2067
350700;201410;2893;9916;2495;9003;968;3800;833;2700;1801;6500
350710;201410;2411;7619;2154;7186;342;1266;1428;4722;1770;5988
350715;201410;1125;3439;987;3177;303;1123;340;994;643;2117
350720;201410;147;447;132;414;45;158;46;123;91;281
350730;201410;457;1736;432;1668;132;568;144;519;276;1087
350740;201410;2546;7725;2198;6946;569;1957;931;2911;1500;4868
350745;201410;413;1293;312;1052;62;246;139;415;201;661
350750;201410;10522;32328;8075;27333;2288;8510;2076;6566;4364;15076
350760;201410;13068;41478;11645;38847;3584;13267;5133;16331;8717;29598
350770;201410;948;2794;687;2278;159;601;274;878;433;1479
350775;201410;706;1997;603;1823;150;525;281;828;431;1353
350780;201410;2224;6793;1648;5553;531;1975;225;703;756;2678
350790;201410;2294;7421;1794;6365;551;2106;395;1248;946;3354
350800;201410;3281;11115;3113;10826;663;2612;1884;6379;2547;8991
350810;201410;2685;7857;2342;7252;840;2819;732;2269;1572;5088
350820;201410;596;1634;439;1301;91;326;185;486;276;812
350830;201410;937;2961;674;2319;130;486;148;440;278;926
350840;201410;2493;8904;2055;7789;665;2779;413;1336;1078;4115
350850;201410;7043;23922;5863;21080;2108;8032;1470;5087;3578;13119
350860;201410;3519;11309;3362;11058;472;1770;2542;8298;3014;10068
350870;201410;2624;8779;2294;8263;665;2595;1283;4670;1948;7265
350880;201410;1764;5976;1508;5396;493;1868;318;1131;811;2999
350890;201410;712;2119;506;1650;111;423;132;345;243;768
350900;201410;4759;16039;3884;13979;1079;4203;1013;3440;2092;7643
350910;201410;953;2885;860;2682;334;1080;302;917;636;1997
350920;201410;10542;31435;9606;29843;1835;6280;6130;18391;7965;24671
350925;201410;4532;13987;3837;12569;1014;3622;1644;5038;2658;8660
350930;201410;1652;4581;1364;4105;174;632;946;2737;1120;3369
350940;201410;2386;7980;2176;7628;492;1999;1285;4314;1777;6313
350945;201410;977;3248;858;2977;212;819;390;1288;602;2107
350950;201410;75388;241645;63615;217074;18356;68218;26106;86392;44462;154610
350960;201410;4905;17220;4329;15901;849;3589;2448;8650;3297;12239
350970;201410;4702;16884;4118;15445;1488;6042;1174;4152;2662;10194
350980;201410;733;2390;669;2279;317;1137;184;639;501;1776
350990;201410;1903;6610;1666;6141;579;2298;523;1859;1102;4157
350995;201410;869;3069;825;2982;212;889;438;1516;650;2405
351000;201410;3778;11479;3251;10456;515;1885;1851;5749;2366;7634
351010;201410;449;1348;321;1083;127;477;75;245;202;722
351015;201410;980;3281;845;3022;297;1178;302;1035;599;2213
351020;201410;8279;26736;7294;25154;1989;7356;3546;12313;5535;19669
351030;201410;1660;5992;1528;5692;423;1849;584;2006;1007;3855
351040;201410;3892;12434;3580;11861;791;3066;2111;6592;2902;9658
351050;201410;10578;33523;8373;29139;2690;10203;2842;9796;5532;19999
351060;201410;38065;118020;31630;105763;9619;34433;12193;40151;21812;74584
351070;201410;1979;5605;1407;4572;502;1797;249;679;751;2476
351080;201410;2954;8892;2335;8096;678;2606;1074;3607;1752;6213
351090;201410;417;1447;321;1229;88;384;72;268;160;652
351100;201410;2241;7054;1880;6322;721;2513;588;2005;1309;4518
351110;201410;8657;22389;4782;15543;1333;4831;1228;3672;2561;8503
351120;201410;661;1985;540;1719;71;265;276;793;347;1058
351130;201410;932;2604;490;1675;93;383;121;370;214;753
351140;201410;2079;7224;1893;6811;707;2759;588;2053;1295;4812
351150;201410;2368;8231;1873;6873;550;2202;434;1450;984;3652
351160;201410;1613;5662;1450;5280;479;1939;504;1754;983;3693
351170;201410;1706;5653;1376;4871;359;1390;573;1883;932;3273
351190;201410;731;2379;592;2012;148;548;123;354;271;902
351200;201410;2441;7305;2042;6498;545;1966;737;2112;1282;4078
351210;201410;1167;3650;958;3223;294;1056;321;1018;615;2074
351220;201410;3685;12451;3256;11553;857;3273;1510;5324;2367;8597
351230;201410;2054;6791;1828;6349;514;1973;940;3184;1454;5157
351240;201410;1032;3294;738;2602;206;807;188;568;394;1375
351250;201410;909;2627;664;2125;129;451;306;941;435;1392
351260;201410;1213;3604;1082;3323;279;948;451;1309;730;2257
351270;201410;419;1481;383;1408;120;502;136;446;256;948
351280;201410;5592;16924;4111;13542;1068;3752;1331;4004;2399;7756
351290;201410;1180;3473;935;2990;287;955;329;979;616;1934
351300;201410;11648;41806;9641;37098;2912;12129;3378;12863;6290;24992
351310;201410;3576;11184;2978;10083;734;2861;1410;4447;2144;7308
351320;201410;1053;3714;913;3382;306;1230;235;765;541;1995
351330;201410;307;875;259;787;110;339;63;188;173;527
351340;201410;6908;24029;6217;22585;1820;6950;2959;10775;4779;17725
351350;201410;8264;27207;7262;25021;2240;8113;2570;8475;4810;16588
351360;201410;4992;15302;4662;14694;1279;4387;2137;6532;3416;10919
351370;201410;2305;7358;1831;6333;553;2166;569;1788;1122;3954
351380;201410;38183;119480;35107;113299;9223;32355;16717;51781;25940;84136
351385;201410;255;799;248;788;85;276;103;319;188;595
351390;201410;1350;4493;1168;4110;409;1582;458;1503;867;3085
351400;201410;1252;4073;1177;3891;460;1615;352;1181;812;2796
351410;201410;3108;9406;2744;8750;627;2152;1468;4576;2095;6728
351420;201410;460;1373;335;1096;99;330;65;210;164;540
351430;201410;924;2953;845;2809;137;481;602;2014;739;2495
351440;201410;4895;15014;4098;13228;1482;4932;1033;3146;2515;8078
351450;201410;1881;5387;1652;5064;529;1669;796;2511;1325;4180
351460;201410;864;2723;732;2465;356;1277;213;678;569;1955
351470;201410;1144;3514;1015;3262;371;1299;337;1047;708;2346
351480;201410;3069;9974;2788;9492;627;2526;1445;4754;2072;7280
351490;201410;2084;7059;1866;6580;366;1488;1033;3492;1399;4980
351492;201410;193;608;133;462;25;103;55;179;80;282
351495;201410;163;558;129;471;43;167;42;142;85;309
351500;201410;22705;72412;19609;66029;6248;23012;7608;24645;13856;47657
351510;201410;8327;26762;7007;24225;1788;6678;3453;11818;5241;18496
351512;201410;462;1368;389;1228;92;307;187;582;279;889
351515;201410;2287;7408;1713;6095;530;2053;476;1567;1006;3620
351518;201410;1827;6191;1325;5240;400;1786;304;1106;704;2892
351519;201410;893;2817;739;2465;216;848;280;830;496;1678
351520;201410;831;2319;408;1451;78;317;69;215;147;532
351530;201410;499;1584;393;1322;77;276;126;377;203;653
351535;201410;2707;7012;2170;6242;252;822;1527;4345;1779;5167
351540;201410;2276;7215;2000;6702;888;3167;423;1386;1311;4553
351550;201410;4327;12666;3083;10180;754;2842;1121;3554;1875;6396
351560;201410;457;1483;397;1343;124;448;79;265;203;713
351565;201410;252;849;234;803;73;287;98;304;171;591
351570;201410;13675;44142;11886;40447;3379;12206;5739;19251;9118;31457
351580;201410;415;1162;306;934;60;184;102;299;162;483
351590;201410;536;1487;413;1234;123;397;98;271;221;668
351600;201410;2001;5726;1782;5348;383;1313;870;2437;1253;3750
351610;201410;704;1949;559;1693;99;347;280;795;379;1142
351620;201410;17955;58452;13618;48989;3509;13994;3541;11264;7050;25258
351630;201410;17566;58216;16125;55741;4055;14572;9268;32217;13323;46789
351640;201410;9327;29813;7756;26963;1819;6925;4062;13853;5881;20778
351650;201410;431;1298;253;843;74;262;38;119;112;381
351660;201410;770;2415;574;1934;141;500;170;521;311;1021
351670;201410;4097;12762;3389;11247;673;2601;1704;5295;2377;7896
351680;201410;690;2117;428;1436;101;362;71;200;172;562
351685;201410;471;1441;383;1281;103;354;158;541;261;895
351690;201410;1415;4213;1082;3432;428;1356;304;917;732;2273
351700;201410;1566;4675;1405;4360;470;1510;517;1561;987;3071
351710;201410;824;2584;693;2288;173;597;227;692;400;1289
351720;201410;1810;5688;1325;4425;326;1190;447;1375;773;2565
351730;201410;1187;3501;997;3238;404;1448;344;1050;748;2498
351740;201410;4929;14040;4070;12231;1095;3517;1355;3843;2450;7360
351750;201410;1615;5323;1364;4783;452;1764;383;1233;835;2997
351760;201410;3954;12649;3441;11492;962;3452;1420;4539;2382;7991
351770;201410;2444;7860;2111;7249;626;2287;1054;3553;1680;5840
351780;201410;1649;4695;1054;3356;280;971;245;722;525;1693
351790;201410;1207;3593;1039;3352;376;1263;434;1383;810;2646
351800;201410;433;960;323;809;39;106;206;498;245;604
351810;201410;1233;3729;1157;3631;279;1011;745;2240;1024;3251
351820;201410;1974;6287;1601;5597;545;2016;195;648;740;2664
351830;201410;4685;15014;3815;12901;901;3324;1797;5859;2698;9183
351840;201410;9377;32464;8315;30210;2855;11005;2837;10138;5692;21143
351850;201410;1567;4998;1258;4345;352;1409;410;1224;762;2633
351860;201410;3780;12246;3397;11447;1003;3688;1480;4748;2483;8436
351870;201410;36585;113223;32942;106546;8481;29154;17639;56918;26120;86072
351880;201410;106805;347251;93037;316809;29223;105349;27738;93070;56961;198419
351885;201410;668;2433;620;2323;181;740;280;1003;461;1743
351890;201410;865;2619;697;2261;217;760;181;556;398;1316
351900;201410;1463;4519;1262;4201;377;1333;491;1638;868;2971
351905;201410;461;1574;391;1447;95;423;201;681;296;1104
351907;201410;16462;51593;14238;47302;2927;11087;7747;24673;10674;35760
351910;201410;1233;3907;1133;3743;279;1057;452;1402;731;2459
351920;201410;1233;3543;1144;3398;269;900;663;1926;932;2826
351925;201410;1049;3126;951;2939;158;589;583;1681;741;2270
351930;201410;3286;11146;3055;10656;865;3508;1453;4600;2318;8108
351940;201410;1067;3273;983;3123;284;985;568;1731;852;2716
351950;201410;1466;4066;1068;3302;199;698;545;1603;744;2301
351960;201410;4345;13018;3332;11154;953;3375;1540;5149;2493;8524
351970;201410;7165;27160;6474;25632;2356;9757;2169;8635;4525;18392
351980;201410;1003;3057;807;2668;185;697;322;945;507;1642
351990;201410;1683;4854;1340;4175;400;1425;338;917;738;2342
352000;201410;2592;8357;2355;7868;649;2330;1028;3263;1677;5593
352010;201410;2347;7945;2102;7339;741;2708;444;1536;1185;4244
352020;201410;1645;5281;1446;4867;444;1593;521;1706;965;3299
352030;201410;4974;15117;4342;14202;1087;3741;2399;7960;3486;11701
352040;201410;2088;7231;1755;6394;487;1927;426;1441;913;3368
352042;201410;2612;7350;1898;5835;445;1506;954;2859;1399;4365
352044;201410;1498;5050;1143;4128;272;1047;221;721;493;1768
352050;201410;7071;22846;4806;17618;1449;5881;965;3056;2414;8937
352060;201410;866;2567;751;2367;197;739;308;892;505;1631
352070;201410;766;2068;707;1977;270;793;261;776;531;1569
352080;201410;611;1831;485;1598;144;537;170;508;314;1045
352090;201410;1808;5885;1426;5043;378;1501;378;1177;756;2678
352100;201410;2595;8110;1879;6654;538;2128;646;2083;1184;4211
352110;201410;500;1857;446;1721;136;565;163;604;299;1169
352115;201410;424;1394;363;1259;95;379;160;509;255;888
352120;201410;906;2786;782;2582;149;549;435;1427;584;1976
352130;201410;1918;5559;1347;4400;394;1393;438;1298;832;2691
352140;201410;1767;5487;1235;4291;331;1243;522;1775;853;3018
352150;201410;718;2190;548;1850;157;527;235;778;392;1305
352160;201410;1308;3664;1184;3496;268;843;701;2077;969;2920
352170;201410;2659;8121;2400;7633;558;1981;1291;3881;1849;5862
352180;201410;3753;10770;3221;9774;887;2959;1353;3875;2240;6834
352190;201410;1208;3721;1104;3535;242;894;586;1780;828;2674
352200;201410;468;1623;386;1459;84;343;192;752;276;1095
352210;201410;16394;44132;13002;39069;2397;7573;7947;24331;10344;31904
352215;201410;577;1823;522;1743;79;312;313;1031;392;1343
352220;201410;15398;51394;14122;48728;4883;17882;5152;17644;10035;35526
352230;201410;14153;48576;12411;45204;3922;15509;4731;16932;8653;32441
352240;201410;10443;32675;9093;30184;3002;11186;3539;11055;6541;22241
352250;201410;23514;76311;20733;70565;5901;21718;8059;27038;13960;48756
352260;201410;6110;18531;4140;14290;1033;3970;1428;4538;2461;8508
352265;201410;938;2972;792;2731;123;513;475;1569;598;2082
352270;201410;2590;8902;2214;8019;855;3199;515;1804;1370;5003
352280;201410;2566;7932;2141;7190;589;2207;708;2260;1297;4467
352290;201410;1364;4398;1183;3993;301;1165;385;1172;686;2337
352300;201410;1044;3134;857;2791;250;894;383;1191;633;2085
352310;201410;33461;106329;29381;99244;7474;27080;17141;57438;24615;84518
352320;201410;5739;17814;4956;16278;1490;5346;1703;5060;3193;10406
352330;201410;2305;7431;1984;7008;711;2683;666;2344;1377;5027
352340;201410;6073;20705;4925;17914;1613;6324;973;3248;2586;9572
352350;201410;1871;6853;1701;6462;489;1998;610;2245;1099;4243
352360;201410;1252;4105;1113;3830;291;1204;638;2039;929;3243
352370;201410;944;3220;858;3025;210;839;395;1339;605;2178
352380;201410;1057;3372;931;3152;340;1277;268;874;608;2151
352390;201410;16360;46255;11088;35760;2245;8410;5350;16049;7595;24459
352400;201410;3258;9553;2130;7268;584;2166;699;2194;1283;4360
352410;201410;3885;11410;2985;9836;971;3464;947;2971;1918;6435
352420;201410;1335;3813;1233;3640;429;1409;512;1485;941;2894
352430;201410;6656;20899;5854;19562;2234;8096;2019;6605;4253;14701
352440;201410;16681;52642;13656;46525;3872;14226;5080;16832;8952;31058
352450;201410;688;2023;465;1581;124;476;111;328;235;804
352460;201410;2297;7644;1969;7016;674;2668;590;1930;1264;4598
352470;201410;4995;14224;3017;10001;630;2285;1181;3813;1811;6098
352480;201410;5648;15978;4577;13980;1130;3970;1944;5464;3074;9434
352490;201410;771;2739;651;2443;165;689;145;502;310;1191
352500;201410;8946;28516;8367;27525;3982;14160;2562;7656;6544;21816
352510;201410;3597;12356;2977;11021;1131;4487;733;2648;1864;7135
352520;201410;2528;8975;2244;8292;607;2396;1128;4105;1735;6501
352530;201410;7083;22931;5157;18507;1545;6009;806;2614;2351;8623
352540;201410;488;1599;369;1319;61;256;107;370;168;626
352550;201410;945;3138;658;2435;179;739;124;393;303;1132
352560;201410;670;2004;504;1627;104;376;199;585;303;961
352570;201410;1606;5261;1162;4182;274;1134;280;892;554;2026
352580;201410;967;2893;827;2648;267;956;368;1107;635;2063
352585;201410;234;775;186;672;62;236;45;166;107;402
352590;201410;11724;37554;10236;34565;2279;8604;5781;18791;8060;27395
352600;201410;2056;6545;1867;6173;618;2168;736;2347;1354;4515
352610;201410;3698;11559;3180;10650;1114;4048;1019;3239;2133;7287
352620;201410;5746;18209;5424;17773;1190;4219;3496;11408;4686;15627
352630;201410;881;2914;832;2790;263;949;372;1225;635;2174
352640;201410;3240;10321;2664;9040;574;2163;1214;4000;1788;6163
352650;201410;884;2624;662;2159;151;540;224;684;375;1224
352660;201410;1111;3865;898;3339;260;1053;228;802;488;1855
352670;201410;11323;34903;6962;24869;2164;8156;1318;4538;3482;12694
352680;201410;3483;12169;2689;10179;650;2712;695;2339;1345;5051
352690;201410;29253;84929;21192;68279;5068;17999;9297;28850;14365;46849
352700;201410;810;2396;648;2143;197;744;291;902;488;1646
352710;201410;5561;16567;4100;13547;1089;3974;1565;4932;2654;8906
352720;201410;9384;31359;8662;29806;2892;10383;3409;11655;6301;22038
352725;201410;437;1281;291;951;57;219;97;289;154;508
352730;201410;2833;9781;2487;8829;688;2710;805;2548;1493;5258
352740;201410;2365;7032;2000;6392;506;1879;985;2924;1491;4803
352750;201410;447;1361;317;1057;94;337;70;200;164;537
352760;201410;1057;3716;948;3486;302;1184;464;1651;766;2835
352770;201410;967;2983;902;2865;290;981;324;1026;614;2007
352780;201410;650;2210;566;2011;148;594;178;573;326;1167
352790;201410;624;1802;446;1451;103;361;101;313;204;674
352800;201410;1249;4635;983;3867;318;1301;206;709;524;2010
352810;201410;1139;3041;794;2368;158;559;269;755;427;1314
352820;201410;638;1886;514;1687;210;722;114;381;324;1103
352830;201410;495;1411;346;1096;81;279;70;186;151;465
352840;201410;3879;13494;3400;12422;1078;4174;1050;3814;2128;7988
352850;201410;10442;33819;9102;31391;2783;10126;3372;11709;6155;21835
352860;201410;1076;3582;1001;3416;396;1405;294;944;690;2349
352870;201410;1152;2924;883;2410;151;517;464;1158;615;1675
352880;201410;2540;7510;1939;6186;509;1733;531;1549;1040;3282
352885;201410;321;1091;306;1058;94;353;137;445;231;798
352890;201410;840;2317;678;1995;158;518;280;746;438;1264
352900;201410;19198;57429;14209;46875;3459;12453;5689;17871;9148;30324
352910;201410;288;929;252;846;88;294;35;105;123;399
352920;201410;3456;10644;2925;9573;995;3539;1045;3167;2040;6706
352930;201410;7116;22857;5822;19921;1765;6541;1094;3533;2859;10074
352940;201410;26340;88218;22344;78512;8091;29914;4016;13436;12107;43350
352950;201410;338;1063;242;855;65;273;69;209;134;482
352960;201410;627;1963;414;1447;79;308;74;238;153;546
352965;201410;386;1104;313;965;85;285;57;167;142;452
352970;201410;3454;9083;3041;8503;483;1402;2105;5963;2588;7365
352980;201410;1595;4793;1358;4415;404;1333;649;2217;1053;3550
352990;201410;3712;12193;3350;11533;1054;4058;1257;4115;2311;8173
353000;201410;569;1601;398;1228;93;311;95;260;188;571
353010;201410;3028;8585;2243;6994;615;2151;774;2213;1389;4364
353020;201410;4602;12718;3130;9484;536;1824;1292;3568;1828;5392
353030;201410;4040;11930;3310;10489;1018;3507;872;2584;1890;6091
353040;201410;746;2152;640;1981;203;681;245;743;448;1424
353050;201410;5780;19906;4922;18073;1737;6886;1613;5653;3350;12539
353060;201410;35762;114755;33347;110813;5330;20988;23246;74325;28576;95313
353070;201410;9355;31817;7344;27135;2515;9795;1974;7299;4489;17094
353080;201410;5492;18301;4197;15370;1331;5285;1190;4058;2521;9343
353090;201410;616;2066;546;1919;99;416;269;860;368;1276
353100;201410;295;869;222;706;103;336;52;166;155;502
353110;201410;8167;25527;7305;23948;1885;6545;3917;12971;5802;19516
353120;201410;489;1621;412;1453;140;553;103;311;243;864
353130;201410;3134;9732;2720;9027;1044;3773;984;3107;2028;6880
353140;201410;2808;7886;2240;6744;717;2360;741;2023;1458;4383
353150;201410;2049;6441;1701;5784;605;2168;464;1592;1069;3760
353160;201410;710;2074;535;1705;171;555;100;288;271;843
353170;201410;528;1857;476;1759;169;704;193;684;362;1388
353180;201410;5720;17825;4972;16410;737;2779;3127;10081;3864;12860
353190;201410;3815;12117;3288;10900;760;2818;1567;4809;2327;7627
353200;201410;884;3038;748;2697;237;944;257;892;494;1836
353205;201410;555;1789;461;1577;108;371;167;575;275;946
353210;201410;1154;3057;916;2629;116;405;604;1674;720;2079
353215;201410;590;1838;508;1655;106;385;157;486;263;871
353220;201410;958;2933;818;2627;227;766;259;823;486;1589
353230;201410;964;3079;887;2948;245;914;286;868;531;1782
353240;201410;2335;7733;2121;7289;631;2412;950;3054;1581;5466
353250;201410;1312;3719;1083;3304;302;976;414;1207;716;2183
353260;201410;1243;3621;1067;3331;329;1113;424;1241;753;2354
353270;201410;705;2133;608;1942;182;629;187;551;369;1180
353280;201410;617;2032;540;1891;190;727;147;488;337;1215
353282;201410;1839;6051;1774;5937;370;1377;1069;3453;1439;4830
353284;201410;310;857;206;647;47;147;58;189;105;336
353286;201410;150;443;101;325;29;93;13;43;42;136
353290;201410;523;1770;444;1631;159;638;182;632;341;1270
353300;201410;1823;5782;1559;5185;478;1752;562;1657;1040;3409
353310;201410;360;1107;327;1043;148;490;95;284;243;774
353320;201410;586;1653;503;1516;114;387;255;731;369;1118
353325;201410;611;2093;502;1837;131;523;81;264;212;787
353330;201410;617;1812;432;1395;99;370;193;562;292;932
353340;201410;3298;10659;2802;9670;990;3631;998;3382;1988;7013
353350;201410;3692;11184;3201;10295;1130;3882;1366;4273;2496;8155
353360;201410;471;1641;416;1507;109;454;228;782;337;1236
353370;201410;742;2424;671;2239;159;560;353;1163;512;1723
353380;201410;419;1378;371;1290;101;403;160;531;261;934
353390;201410;5663;15234;3958;12108;858;2976;1495;4141;2353;7117
353400;201410;642;2003;533;1772;141;502;144;410;285;912
353410;201410;715;2199;606;2024;177;668;310;1001;487;1669
353420;201410;718;2133;559;1749;183;603;175;512;358;1115
353430;201410;2596;9056;1868;6920;518;2007;187;607;705;2614
353440;201410;63842;209801;55832;190397;17316;62085;18554;61649;35870;123734
353450;201410;488;1478;417;1341;119;433;161;502;280;935
353460;201410;3732;10458;3136;9411;570;1867;1681;5035;2251;6902
353470;201410;11832;37439;9315;32148;3028;11295;2346;7778;5374;19073
353475;201410;1780;5145;1278;4037;298;1023;381;1095;679;2118
353480;201410;1596;4772;1421;4442;315;1092;793;2387;1108;3479
353490;201410;1678;4811;1395;4238;411;1398;411;1119;822;2517
353500;201410;1261;3643;1141;3435;486;1540;418;1202;904;2742
353510;201410;1426;4615;1182;3983;353;1313;344;1006;697;2319
353520;201410;1299;3866;1052;3420;347;1209;354;1153;701;2362
353530;201410;2866;8593;2568;8041;635;2221;1229;3694;1864;5915
353540;201410;2208;6735;1972;6318;618;2056;844;2730;1462;4786
353550;201410;7003;20213;6155;18830;1121;4030;3563;10243;4684;14273
353560;201410;2180;7189;1810;6504;455;1815;681;2387;1136;4202
353570;201410;555;1750;447;1520;100;384;244;751;344;1135
353580;201410;2579;8394;2412;8092;678;2538;1366;4454;2044;6992
353590;201410;846;2429;690;2145;257;860;170;542;427;1402
353600;201410;1995;5711;1799;5352;411;1337;933;2758;1344;4095
353610;201410;631;2216;540;2020;145;632;154;535;299;1167
353620;201410;2333;7860;2035;7263;630;2421;677;2270;1307;4691
353625;201410;400;1099;278;884;107;372;77;229;184;601
353630;201410;1741;5961;1335;4906;309;1228;233;741;542;1969
353640;201410;1702;4908;1474;4429;365;1134;671;2040;1036;3174
353650;201410;6964;21324;5038;17008;1162;4235;1787;5718;2949;9953
353657;201410;358;1139;317;1050;58;228;132;412;190;640
353660;201410;1464;3740;1047;3080;444;1431;194;433;638;1864
353670;201410;5026;16606;4376;15141;1486;5647;1379;4438;2865;10085
353680;201410;717;2517;667;2426;315;1206;216;769;531;1975
353690;201410;587;1574;388;1242;95;358;147;423;242;781
353700;201410;2496;7926;2175;7240;513;1897;804;2520;1317;4417
353710;201410;3525;9549;1827;6556;555;2171;530;1873;1085;4044
353715;201410;504;1490;418;1326;91;310;175;540;266;850
353720;201410;2197;6807;1877;6318;363;1339;1081;3632;1444;4971
353730;201410;4664;14561;3739;12402;960;3449;1066;3254;2026;6703
353740;201410;2330;7122;1870;6126;643;2188;534;1686;1177;3874
353750;201410;839;2913;654;2446;183;758;191;707;374;1465
353760;201410;8224;24295;6649;21630;1555;5503;3407;11004;4962;16507
353770;201410;836;2603;531;1826;121;453;55;124;176;577
353780;201410;6132;21740;5533;20497;2480;9409;1533;5903;4013;15312
353790;201410;1833;6501;1508;5779;470;2021;353;1315;823;3336
353800;201410;15343;49092;12162;42864;3424;13297;4773;16259;8197;29556
353810;201410;1218;4048;1065;3691;327;1223;390;1315;717;2538
353820;201410;1337;4682;1245;4457;374;1518;556;1849;930;3367
353830;201410;827;2251;646;1923;133;429;275;801;408;1230
353850;201410;1927;6339;1797;6104;434;1626;876;2827;1310;4453
353860;201410;2451;8311;2021;7276;595;2296;568;1986;1163;4282
353870;201410;24367;75682;18169;62621;4389;16892;5990;18595;10379;35487
353880;201410;2396;7587;1981;6859;298;1237;1197;4053;1495;5290
353890;201410;2743;7061;1977;5779;474;1530;953;2658;1427;4188
353900;201410;1171;3662;870;2971;221;843;209;625;430;1468
353910;201410;2195;7753;2087;7464;674;2587;948;3382;1622;5969
353920;201410;2469;7367;1794;5891;435;1511;317;918;752;2429
353930;201410;4262;14950;3552;13342;1274;5088;848;3151;2122;8239
353940;201410;1558;5035;1328;4521;349;1352;524;1641;873;2993
353950;201410;3755;12161;3442;11593;563;2203;2211;7229;2774;9432
353960;201410;631;2015;493;1710;123;463;138;407;261;870
353970;201410;553;1636;479;1530;47;184;357;1117;404;1301
353980;201410;15110;44950;12595;40594;3094;10705;6479;20540;9573;31245
353990;201410;520;1638;477;1534;142;507;192;557;334;1064
354000;201410;2050;6063;1397;4745;354;1316;149;451;503;1767
354010;201410;404;1246;361;1175;138;458;141;468;279;926
354020;201410;4577;13938;4055;12773;1122;3866;1752;5112;2874;8978
354025;201410;1142;3247;903;2830;257;858;232;730;489;1588
354030;201410;667;1782;466;1468;124;435;176;510;300;945
354040;201410;820;2233;640;1889;93;324;365;991;458;1315
354050;201410;1076;3519;946;3245;340;1276;286;944;626;2220
354060;201410;5235;16577;3796;13366;1026;3924;1429;4825;2455;8749
354070;201410;3801;12732;3300;11570;1124;4193;841;2917;1965;7110
354075;201410;2289;8585;2184;8393;707;2961;979;3719;1686;6680
354080;201410;2021;6264;1537;5082;447;1525;442;1333;889;2858
354085;201410;326;879;284;799;33;119;206;538;239;657
354090;201410;1294;3898;1223;3786;148;521;932;2862;1080;3383
354100;201410;17414;59873;14903;54916;4072;15910;6775;24843;10847;40753
354105;201410;963;3028;823;2760;205;808;377;1143;582;1951
354110;201410;848;2443;692;2207;209;759;215;621;424;1380
354120;201410;2171;6050;1708;5177;412;1421;666;1838;1078;3259
354130;201410;5808;17408;4780;15332;1918;6518;1119;3277;3037;9795
354140;201410;24375;62480;14954;44675;3040;10045;5752;15934;8792;25979
354150;201410;4678;13033;3660;11182;1010;3415;1633;4758;2643;8173
354160;201410;4102;13579;3560;12359;1058;3940;1449;4886;2507;8826
354165;201410;420;1542;378;1438;141;579;102;389;243;968
354170;201410;1673;5390;1354;4618;304;1179;480;1440;784;2619
354180;201410;534;1620;510;1575;80;287;319;921;399;1208
354190;201410;1694;5702;1473;5195;510;1935;492;1659;1002;3594
354200;201410;1208;3516;975;3065;204;733;398;1122;602;1855
354210;201410;885;3031;781;2819;182;771;330;1101;512;1872
354220;201410;3323;10335;2959;9618;956;3398;1233;3833;2189;7231
354230;201410;819;2716;771;2629;213;762;379;1282;592;2044
354240;201410;1437;4877;1148;4208;348;1375;281;967;629;2342
354250;201410;604;1891;478;1676;217;851;130;418;347;1269
354260;201410;8222;25066;7260;23495;2202;7816;2954;9337;5156;17153
354270;201410;1223;4297;1109;4048;336;1371;438;1584;774;2955
354280;201410;854;2566;789;2452;154;560;478;1446;632;2006
354290;201410;1360;4802;1258;4578;383;1488;421;1515;804;3003
354300;201410;3422;11619;3303;11384;866;3180;1753;5947;2619;9127
354310;201410;810;2687;644;2283;185;727;204;711;389;1438
354320;201410;876;2643;749;2384;219;783;243;700;462;1483
354323;201410;404;1173;315;999;80;280;88;243;168;523
354325;201410;1260;4273;1107;3912;256;1039;451;1467;707;2506
354330;201410;8369;26169;7351;24107;1960;6900;3695;11699;5655;18599
354340;201410;31912;103427;26833;93906;9857;37019;9644;32891;19501;69910
354350;201410;1204;3599;1125;3453;306;1022;608;1792;914;2814
354360;201410;468;1537;379;1365;115;446;43;143;158;589
354370;201410;1188;4024;1035;3702;152;665;666;2302;818;2967
354380;201410;1361;4097;1126;3663;430;1536;210;597;640;2133
354390;201410;12271;39217;9025;31967;2353;9125;2368;7978;4721;17103
354400;201410;2212;7888;1905;7133;536;2138;590;2104;1126;4242
354410;201410;6645;20228;5520;18344;1301;4640;2837;9410;4138;14050
354420;201410;1723;5129;1429;4481;450;1493;512;1540;962;3033
354425;201410;3579;10267;3085;9344;1072;3442;994;3048;2066;6490
354430;201410;1383;4549;1269;4360;342;1311;614;2017;956;3328
354440;201410;592;1743;461;1474;90;313;205;629;295;942
354450;201410;528;1539;329;1095;49;211;85;241;134;452
354460;201410;908;2646;762;2378;271;880;345;1061;616;1941
354470;201410;539;1541;418;1290;75;299;186;494;261;793
354480;201410;808;2402;707;2234;156;572;360;1053;516;1625
354490;201410;808;2738;641;2331;166;656;209;679;375;1335
354500;201410;2640;8955;2399;8498;968;3851;543;1821;1511;5672
354510;201410;786;2500;696;2328;169;621;375;1223;544;1844
354515;201410;365;1275;294;1104;73;314;93;320;166;634
354520;201410;7301;25118;4953;18371;1500;6230;1829;6452;3329;12682
354530;201410;2982;10742;2784;10340;792;3210;1432;5253;2224;8463
354540;201410;1352;4171;1132;3747;414;1512;318;1001;732;2513
354550;201410;599;1917;530;1761;106;369;229;724;335;1093
354560;201410;1488;4427;1085;3513;266;878;389;1217;655;2095
354570;201410;752;2324;591;1936;190;659;113;342;303;1001
354580;201410;9589;27954;7562;24067;1598;5731;3468;10423;5066;16154
354600;201410;1797;6167;1598;5762;471;1955;706;2387;1177;4342
354610;201410;494;1376;309;968;58;185;81;218;139;403
354620;201410;435;1471;361;1332;111;472;134;459;245;931
354625;201410;291;968;244;869;66;257;69;235;135;492
354630;201410;1941;6636;1742;6173;773;2788;505;1731;1278;4519
354640;201410;4286;14322;3616;12816;1093;4371;797;2563;1890;6934
354650;201410;1050;3235;945;3014;190;683;541;1681;731;2364
354660;201410;2218;6599;1742;5735;385;1411;888;2897;1273;4308
354670;201410;1689;5515;1356;4655;392;1471;362;1085;754;2556
354680;201410;5499;18528;5023;17463;1450;5361;2014;6829;3464;12190
354690;201410;886;2988;632;2352;131;510;186;640;317;1150
354700;201410;1205;3404;810;2561;138;530;346;922;484;1452
354710;201410;649;1915;552;1715;139;487;213;614;352;1101
354720;201410;218;620;169;521;61;186;42;126;103;312
354730;201410;7092;23905;5716;20915;1538;6152;2457;8706;3995;14858
354740;201410;276;845;198;698;53;190;47;170;100;360
354750;201410;2496;7963;2081;7295;703;2688;753;2564;1456;5252
354760;201410;2285;7611;1913;6742;639;2416;400;1316;1039;3732
354765;201410;313;826;200;622;48;180;30;86;78;266
354770;201410;2880;8479;2304;7528;1064;3697;434;1361;1498;5058
354780;201410;38266;118522;34472;109874;7891;28023;17289;52237;25180;80260
354790;201410;915;2987;800;2782;218;843;354;1135;572;1978
354800;201410;1785;5266;1587;4997;339;1200;1020;3195;1359;4395
354805;201410;990;3048;730;2456;116;430;142;433;258;863
354810;201410;718;2394;514;1876;163;653;99;322;262;975
354820;201410;1124;3970;996;3696;282;1195;285;957;567;2152
354830;201410;492;1472;408;1316;134;476;160;476;294;952
354840;201410;823;2429;741;2283;226;740;320;976;546;1716
354850;201410;15712;50182;11770;41800;3042;12018;4377;14390;7419;26408
354860;201410;1332;4369;1206;4149;298;1197;566;1835;864;3032
354870;201410;46777;150036;43187;142335;12775;44821;20434;66112;33209;110933
354880;201410;4243;13271;3035;10519;839;3195;746;2263;1585;5458
354890;201410;16044;49356;13764;44762;3988;13948;4783;14996;8771;28944
354900;201410;632;1795;507;1604;178;596;185;582;363;1178
354910;201410;6838;20938;3910;14178;891;3595;416;1393;1307;4988
354920;201410;521;1556;402;1341;115;426;110;350;225;776
354925;201410;380;1094;225;768;46;178;38;107;84;285
354930;201410;322;917;258;796;86;283;90;278;176;561
354940;201410;2276;8125;1748;6647;661;2648;246;853;907;3501
354950;201410;1579;5222;1410;4980;261;1060;860;3003;1121;4063
354960;201410;795;2539;693;2370;202;764;274;907;476;1671
354970;201410;4203;14030;3727;13047;786;3196;2026;6750;2812;9946
354980;201410;33687;84645;19376;59694;4424;15378;6629;18781;11053;34159
354990;201410;45312;144628;38718;130712;8586;32057;20008;65493;28594;97550
354995;201410;2032;6403;1906;6221;494;1725;1007;3295;1501;5020
355000;201410;1735;5837;1516;5415;562;2179;344;1156;906;3335
355010;201410;3882;12362;3212;10830;907;3331;1271;4201;2178;7532
355020;201410;3460;12312;2920;11219;1412;5731;782;3010;2194;8741
355030;201410;871394;2539927;772759;2340391;194046;640988;346353;1014438;540399;1655426
355040;201410;3113;10198;2800;9622;875;3321;1398;4621;2273;7942
355050;201410;1320;4162;1079;3666;376;1346;262;892;638;2238
355060;201410;5207;17889;4165;15502;1108;4619;1047;3580;2155;8199
355070;201410;6725;21180;6001;19934;1366;5320;3255;10124;4621;15444
355080;201410;1404;4987;1077;4148;330;1402;162;531;492;1933
355090;201410;1155;4134;978;3705;233;960;406;1488;639;2448
355100;201410;25313;80317;21750;74115;7090;25902;8249;28020;15339;53922
355110;201410;1362;4764;1235;4476;422;1655;425;1506;847;3161
355120;201410;682;2189;584;1998;170;638;251;829;421;1467
355130;201410;627;1693;375;1140;91;326;135;338;226;664
355140;201410;1150;4074;1089;3952;302;1201;531;1922;833;3123
355150;201410;3831;12623;3364;11744;1023;3763;1405;4745;2428;8508
355160;201410;1707;5798;1473;5393;613;2495;405;1346;1018;3841
355170;201410;10350;29734;7421;24417;2570;9129;1961;6340;4531;15469
355180;201410;2924;9083;2461;8200;672;2591;941;2886;1613;5477
355190;201410;1408;4871;1241;4508;524;1956;369;1308;893;3264
355200;201410;961;3533;901;3411;418;1673;225;819;643;2492
355210;201410;3026;10386;2752;9786;784;3155;1220;4015;2004;7170
355220;201410;33184;111705;29799;104592;12292;44696;8784;31350;21076;76046
355230;201410;1370;3940;769;2542;138;503;188;546;326;1049
355240;201410;25590;75895;18239;60216;4251;15482;6941;21443;11192;36925
355250;201410;26547;88997;23681;83167;7287;27120;10065;34987;17352;62107
355255;201410;957;2651;678;2068;139;460;202;575;341;1035
355260;201410;1683;4927;1508;4613;426;1483;597;1664;1023;3147
355270;201410;1769;5458;1683;5321;247;934;1201;3662;1448;4596
355280;201410;25260;76223;21487;68836;5200;18712;9553;29091;14753;47803
355290;201410;913;2954;828;2798;194;700;371;1218;565;1918
355300;201410;957;3138;765;2707;185;714;257;864;442;1578
355310;201410;1144;3466;974;3164;229;770;470;1570;699;2340
355320;201410;767;2467;671;2239;199;752;235;670;434;1422
355330;201410;2029;6758;1495;5649;507;2148;450;1617;957;3765
355340;201410;3229;8754;2989;8344;682;2129;1752;4682;2434;6811
355350;201410;1478;5159;1300;4776;431;1710;400;1419;831;3129
355360;201410;1299;4500;1198;4292;259;1005;798;2880;1057;3885
355365;201410;320;1020;271;921;80;305;73;236;153;541
355370;201410;7660;19888;5567;17297;1828;6175;2321;7273;4149;13448
355380;201410;3729;11381;2878;9366;822;2962;624;1717;1446;4679
355385;201410;1037;3352;969;3232;430;1555;277;852;707;2407
355390;201410;1455;4070;1246;3664;348;1123;478;1342;826;2465
355395;201410;1935;5936;1455;4810;281;1034;588;1766;869;2800
355400;201410;9805;33479;8750;31291;3076;11943;3197;11016;6273;22959
355410;201410;15247;54127;13333;49878;5017;20038;3608;13638;8625;33676
355420;201410;845;3070;795;2942;293;1159;269;1014;562;2173
355430;201410;3957;11571;3374;10527;769;2651;1724;5208;2493;7859
355440;201410;981;3275;787;2755;212;786;231;714;443;1500
355450;201410;2774;9273;2271;8115;676;2648;739;2501;1415;5149
355460;201410;600;1683;452;1414;115;440;160;420;275;860
355465;201410;463;1426;396;1298;124;432;100;323;224;755
355470;201410;1004;3082;804;2724;252;940;298;961;550;1901
355475;201410;135;518;119;469;37;147;42;175;79;322
355480;201410;3364;12351;3166;11911;995;3962;1415;5234;2410;9196
355490;201410;882;2624;691;2225;177;599;145;461;322;1060
355495;201410;766;2576;710;2466;193;754;290;984;483;1738
355500;201410;9112;27103;6036;20182;1460;5390;1343;4115;2803;9505
355510;201410;2281;6292;1478;4668;344;1236;437;1263;781;2499
355520;201410;473;1191;287;819;61;198;96;239;157;437
355530;201410;301;715;127;390;15;48;40;131;55;179
355535;201410;700;2152;553;1866;166;647;149;417;315;1064
355540;201410;10561;34254;10006;33313;2927;10478;4983;16158;7910;26636
355550;201410;818;2460;722;2307;187;662;358;1102;545;1764
355560;201410;1455;4373;1061;3517;281;1053;216;561;497;1614
355570;201410;217;706;169;592;35;124;35;100;70;224
355580;201410;1351;4052;1122;3602;393;1380;429;1342;822;2722
355590;201410;265;751;236;691;53;179;116;334;169;513
355600;201410;1140;3668;954;3238;393;1450;231;745;624;2195
355610;201410;1552;4551;1324;4182;356;1258;605;1833;961;3091
355620;201410;4163;13370;3322;11414;744;2922;1392;4351;2136;7273
355630;201410;3502;10185;2177;7347;486;1833;673;2069;1159;3902
355635;201410;1033;3439;899;3203;149;599;592;2100;741;2699
355640;201410;4000;13224;3256;11521;1129;4156;632;2162;1761;6318
355645;201410;3531;12599;3292;12152;654;2646;2006;7389;2660;10035
355650;201410;6987;22105;6100;20335;1153;4621;3661;11400;4814;16021
355660;201410;1430;4616;1188;4120;366;1449;478;1538;844;2987
355670;201410;2533;8136;1777;6326;469;1929;648;2023;1117;3952
355680;201410;1829;6277;1469;5396;553;2131;327;1133;880;3264
355690;201410;437;1398;331;1213;211;830;29;77;240;907
355695;201410;374;1121;243;795;32;105;20;46;52;151
355700;201410;6921;24421;6111;22472;1839;7309;2526;8974;4365;16283
355710;201410;13204;33849;8240;24757;2686;8561;2197;6302;4883;14863
355715;201410;275;853;178;635;44;176;36;112;80;288
355720;201410;1561;5139;1265;4464;398;1542;384;1206;782;2748
355730;201410;814;2871;722;2657;280;1066;171;632;451;1698
410010;201410;1665;5353;1498;5001;427;1535;473;1557;900;3092
410020;201410;1313;4440;1200;4200;367;1361;448;1543;815;2904
410030;201410;1078;3713;894;3250;278;1056;175;629;453;1685
410040;201410;13538;45409;12310;42876;4406;16332;3717;12834;8123;29166
410045;201410;975;2796;684;2207;185;655;212;623;397;1278
410050;201410;3015;8593;1966;6498;629;2222;438;1357;1067;3579
410060;201410;2129;6771;1904;6329;548;2012;775;2532;1323;4544
410070;201410;2251;6436;1829;5576;711;2321;398;1088;1109;3409
410080;201410;1544;4632;1276;4123;322;1113;608;1890;930;3003
410090;201410;1166;3710;1061;3491;350;1288;382;1184;732;2472
410100;201410;2406;7385;1697;5701;516;1960;258;807;774;2767
410105;201410;479;1539;348;1218;78;306;39;104;117;410
410110;201410;2550;7735;2114;6864;474;1768;779;2410;1253;4178
410115;201410;637;1770;504;1503;120;391;177;501;297;892
410120;201410;3012;10366;2845;10114;1048;3907;1226;4478;2274;8385
410130;201410;1459;4864;1319;4535;425;1448;565;1967;990;3415
410140;201410;16746;46109;11720;36801;3231;11214;4032;12499;7263;23713
410150;201410;16973;42097;7933;23738;1704;5624;1681;4482;3385;10106
410160;201410;3486;11078;3170;10543;1038;3782;1156;3877;2194;7659
410165;201410;713;2096;566;1771;136;455;254;752;390;1207
410170;201410;1976;6079;1661;5399;606;2147;500;1574;1106;3721
410180;201410;9465;30519;8197;27704;2048;7861;3605;11322;5653;19183
410185;201410;671;1842;592;1694;132;397;297;843;429;1240
410190;201410;2369;7083;2018;6269;650;2164;529;1547;1179;3711
410200;201410;3853;10943;2726;8590;726;2543;385;1089;1111;3632
410210;201410;2813;8640;2201;7277;535;1971;480;1346;1015;3317
410220;201410;629;1813;449;1431;93;337;142;421;235;758
410230;201410;1815;5894;1625;5549;604;2264;610;2017;1214;4281
410240;201410;5424;16916;4950;15891;1636;5688;1745;5451;3381;11139
410250;201410;2461;6939;1644;5197;493;1724;336;943;829;2667
410260;201410;1719;5340;1483;4899;445;1589;555;1782;1000;3371
410270;201410;589;1723;484;1513;126;442;197;601;323;1043
410275;201410;963;2891;670;2248;120;429;329;1106;449;1535
410280;201410;2990;8944;2126;7062;511;1927;417;1276;928;3203
410290;201410;3265;9961;2779;9008;684;2390;1241;4035;1925;6425
410300;201410;667;1904;588;1734;85;298;300;786;385;1084
410302;201410;359;972;248;789;32;114;142;450;174;564
410304;201410;1502;4873;1369;4595;418;1444;567;1981;985;3425
410305;201410;2291;6099;1952;5597;534;1609;1117;3260;1651;4869
410310;201410;2504;8282;2277;7843;651;2435;883;3064;1534;5499
410315;201410;695;2048;475;1617;113;395;148;475;261;870
410320;201410;1276;3764;784;2645;149;565;64;179;213;744
410322;201410;627;1865;449;1466;129;425;123;387;252;812
410330;201410;1575;4426;1345;3993;395;1260;461;1340;856;2600
410335;201410;1010;3021;858;2746;203;728;339;1022;542;1750
410337;201410;869;2312;679;1949;137;462;275;703;412;1165
410340;201410;608;1831;468;1464;91;328;147;391;238;719
410345;201410;1966;5837;1515;4877;495;1740;390;1155;885;2895
410347;201410;636;1759;407;1321;71;276;153;480;224;756
410350;201410;914;2811;604;2134;162;664;113;344;275;1008
410360;201410;3856;11546;3337;10601;1012;3452;1230;3858;2242;7310
410370;201410;13750;40612;10323;32969;2741;9892;3036;8848;5777;18740
410380;201410;1479;4700;1345;4405;342;1213;611;1906;953;3119
410390;201410;2954;8634;2384;7578;906;3103;638;1846;1544;4949
410395;201410;916;3086;816;2865;204;830;388;1344;592;2174
410400;201410;5560;18004;4892;16659;1489;5698;1635;5350;3124;11048
410405;201410;1026;3013;819;2594;205;757;332;1002;537;1759
410410;201410;1394;4699;1326;4588;496;1927;408;1314;904;3241
410420;201410;9689;31797;8406;28818;2871;10640;2059;6533;4930;17173
410425;201410;3345;10760;2363;8449;550;2167;332;1124;882;3291
410430;201410;16582;45664;12348;37650;3401;11331;3939;11913;7340;23244
410440;201410;3699;11669;3324;10936;866;3090;1564;5115;2430;8205
410442;201410;3070;10600;2761;9863;931;3528;867;3079;1798;6607
410445;201410;2364;7914;2027;7286;595;2337;760;2810;1355;5147
410450;201410;2654;7676;2113;6628;676;2230;397;1133;1073;3363
410460;201410;2434;7322;2025;6498;562;1924;748;2274;1310;4198
410465;201410;2188;7766;1868;7007;614;2463;693;2411;1307;4874
410470;201410;1473;4767;1203;4121;329;1266;372;1247;701;2513
410480;201410;32086;94191;24873;79300;8650;29993;6050;18415;14700;48408
410490;201410;11933;38588;9636;33483;2952;11221;2960;9943;5912;21164
410500;201410;1618;5124;1315;4453;488;1799;382;1281;870;3080
410510;201410;2537;6786;1802;5282;407;1284;747;2011;1154;3295
410520;201410;3335;11655;3152;11257;1168;4398;1168;4152;2336;8550
410530;201410;1775;5094;1465;4468;361;1254;616;1775;977;3029
410540;201410;3869;11324;2661;8863;715;2514;853;2818;1568;5332
410550;201410;7346;22274;5315;17700;1641;6021;873;2649;2514;8670
410560;201410;1374;4399;1078;3659;302;1120;274;759;576;1879
410570;201410;3004;9801;2729;9302;857;3026;1078;3960;1935;6986
410580;201410;27196;85747;23433;77816;8002;29002;6931;21704;14933;50706
410590;201410;1266;3996;765;2558;137;477;184;536;321;1013
410600;201410;2106;6232;1750;5515;462;1511;760;2416;1222;3927
410610;201410;847;2580;710;2320;158;583;310;971;468;1554
410620;201410;1666;5951;1383;5166;437;1717;283;1011;720;2728
410630;201410;2608;7834;1988;6443;558;1991;533;1568;1091;3559
410640;201410;5328;15570;4202;13383;1444;5204;970;2895;2414;8099
410645;201410;1327;4701;1267;4587;554;2161;387;1398;941;3559
410650;201410;2558;7837;2060;6783;738;2565;480;1504;1218;4069
410655;201410;971;2947;793;2590;217;781;261;825;478;1606
410657;201410;741;2186;552;1789;157;565;207;601;364;1166
410660;201410;3887;11349;2954;9234;1051;3452;662;1901;1713;5353
410670;201410;1030;2932;776;2423;223;754;202;580;425;1334
410680;201410;2601;8999;2161;7851;643;2318;726;2787;1369;5105
410685;201410;727;2156;646;2012;98;304;459;1445;557;1749
410690;201410;108711;317903;74204;244112;18334;66673;18070;53732;36404;120405
410700;201410;2451;7782;2277;7431;722;2565;941;2959;1663;5524
410710;201410;1139;3546;885;2949;284;1030;242;722;526;1752
410712;201410;839;2576;725;2353;299;1068;219;729;518;1797
410715;201410;1122;3512;927;3075;245;879;352;1121;597;2000
410720;201410;3381;10126;2479;8186;656;2403;708;2152;1364;4555
410725;201410;1078;3097;762;2450;160;547;164;447;324;994
410730;201410;747;2275;678;2121;284;950;188;567;472;1517
410740;201410;850;2525;582;1964;109;430;283;940;392;1370
410750;201410;2007;5977;1690;5307;511;1747;518;1515;1029;3262
410752;201410;290;856;216;689;51;193;89;255;140;448
410753;201410;487;1463;338;1105;78;300;115;343;193;643
410754;201410;986;3057;860;2846;95;347;582;1981;677;2328
410755;201410;866;2244;673;1938;101;344;405;1119;506;1463
410760;201410;2713;8695;2515;8312;897;3108;1015;3278;1912;6386
410765;201410;16457;49311;11944;39931;2913;10914;1816;5634;4729;16548
410770;201410;980;2778;775;2374;251;842;238;688;489;1530
410773;201410;1404;4135;1181;3755;284;1046;622;1878;906;2924
410775;201410;1874;5502;1768;5330;498;1490;983;3047;1481;4537
410780;201410;500;1426;385;1231;115;370;165;586;280;956
410785;201410;681;2204;554;1879;229;819;133;463;362;1282
410790;201410;628;1968;520;1714;143;524;111;299;254;823
410800;201410;2961;7804;2343;6784;811;2636;855;2296;1666;4932
410810;201410;305;958;245;817;33;128;113;376;146;504
410820;201410;1116;3387;900;2865;283;954;207;634;490;1588
410830;201410;33210;98847;27166;87854;8531;30197;9416;29794;17947;59991
410832;201410;1222;3678;1090;3433;244;894;544;1603;788;2497
410840;201410;6713;20102;4483;15153;1368;5017;668;1997;2036;7014
410845;201410;1600;4755;1343;4197;292;1001;614;1864;906;2865
410850;201410;2871;8511;2553;8015;580;2108;1388;4331;1968;6439
410855;201410;777;2184;615;1833;180;581;222;638;402;1219
410860;201410;4091;11750;3456;10543;793;2576;1651;5089;2444;7665
410865;201410;1760;6026;1596;5712;400;1535;855;3128;1255;4663
410870;201410;1447;4430;1354;4280;662;2236;422;1299;1084;3535
410880;201410;4634;13987;3706;12163;924;3438;889;2589;1813;6027
410890;201410;1125;3516;830;2933;227;865;79;238;306;1103
410895;201410;1064;3732;948;3477;361;1425;294;1021;655;2446
410900;201410;964;2729;720;2316;162;605;225;668;387;1273
410910;201410;377;1118;330;1034;65;228;174;530;239;758
410920;201410;903;2776;739;2472;216;796;246;768;462;1564
410930;201410;1811;5433;1520;4895;378;1454;649;2042;1027;3496
410940;201410;21988;73801;19463;68956;6377;24546;7466;26640;13843;51186
410950;201410;1917;6389;1746;6073;361;1309;1069;3775;1430;5084
410960;201410;7258;20336;4785;15622;1559;5555;1338;4268;2897;9823
410965;201410;1140;3577;1008;3294;348;1187;395;1283;743;2470
410970;201410;5302;16124;4318;14108;1532;5602;895;2880;2427;8482
410975;201410;1579;4608;1291;4104;245;911;620;1957;865;2868
410980;201410;5793;16633;3515;11832;838;3108;663;2104;1501;5212
410990;201410;834;2446;507;1699;166;619;96;263;262;882
411000;201410;450;1377;305;1030;70;272;49;133;119;405
411005;201410;541;1589;363;1151;103;328;60;166;163;494
411007;201410;2120;6862;1885;6306;552;1963;750;2510;1302;4473
411010;201410;4218;14514;3824;13618;1400;5503;972;3202;2372;8705
411020;201410;2597;8269;2338;7810;803;2988;805;2684;1608;5672
411030;201410;897;2438;742;2147;242;767;218;585;460;1352
411040;201410;567;1704;345;1144;101;362;85;266;186;628
411050;201410;2196;7828;1939;7235;657;2649;332;1152;989;3801
411060;201410;2167;6860;1858;6181;576;2061;318;971;894;3032
411065;201410;407;1252;330;1096;69;242;124;389;193;631
411070;201410;5101;16079;3725;12992;1110;4274;589;1847;1699;6121
411080;201410;2142;6592;1904;6111;552;1962;613;1884;1165;3846
411090;201410;709;1778;541;1517;119;408;144;356;263;764
411095;201410;1681;4882;1290;4091;298;1066;355;1043;653;2109
411100;201410;1538;4455;1138;3664;269;977;244;705;513;1682
411110;201410;970;2946;720;2372;220;772;126;361;346;1133
411120;201410;1955;6025;1577;5198;475;1685;488;1547;963;3232
411125;201410;4878;16020;4723;15698;1604;5652;2102;6848;3706;12500
411130;201410;814;2448;663;2131;190;623;217;718;407;1341
411140;201410;2028;7292;1738;6566;627;2461;487;1915;1114;4376
411150;201410;6121;17356;4946;14974;1465;4778;1278;3549;2743;8327
411155;201410;1290;3749;1092;3357;350;1184;428;1229;778;2413
411160;201410;336;1011;297;929;106;340;105;323;211;663
411170;201410;858;2894;747;2625;226;830;243;858;469;1688
411180;201410;6588;20044;5675;18317;1715;6061;1840;5879;3555;11940
411190;201410;1907;5609;1629;5091;494;1732;492;1437;986;3169
411200;201410;4610;14017;3792;12617;1170;4314;1480;4754;2650;9068
411210;201410;2493;7232;1970;6237;776;2607;351;1061;1127;3668
411220;201410;1233;3573;1005;3137;257;937;435;1221;692;2158
411230;201410;1312;3749;843;2750;264;959;195;561;459;1520
411240;201410;1267;3014;673;2034;163;519;218;619;381;1138
411250;201410;2604;7697;2165;6828;616;2102;670;2075;1286;4177
411260;201410;316;879;215;699;44;165;97;299;141;464
411270;201410;2146;6853;1958;6487;600;2197;850;2743;1450;4940
411275;201410;1612;4899;1372;4335;415;1370;394;1197;809;2567
411280;201410;1780;5553;1425;4778;447;1662;238;708;685;2370
411290;201410;1047;2917;870;2561;256;785;291;880;547;1665
411295;201410;1127;3340;1032;3167;247;817;428;1293;675;2110
411300;201410;1117;2903;803;2281;81;264;377;991;458;1255
411310;201410;878;2518;669;2149;122;444;275;867;397;1311
411320;201410;5827;17324;4323;14257;1251;4347;1030;3230;2281;7577
411325;201410;1603;5080;1428;4750;264;978;857;2834;1121;3812
411330;201410;3810;12293;3333;11364;1278;4748;976;3214;2254;7962
411340;201410;1013;2967;666;2150;148;529;264;831;412;1360
411342;201410;904;2608;742;2254;209;698;222;609;431;1307
411345;201410;1116;3550;1023;3366;310;1108;485;1589;795;2697
411350;201410;3024;9205;2107;7245;644;2405;249;777;893;3182
411360;201410;592;1498;373;1081;50;197;172;417;222;614
411370;201410;47086;136646;35927;114982;7666;28716;13347;39128;21013;67844
411373;201410;1486;4705;1235;4197;354;1347;346;1134;700;2481
411375;201410;1192;3342;925;2805;243;777;331;948;574;1725
411380;201410;1316;3556;819;2501;153;506;246;709;399;1215
411390;201410;1912;5859;1682;5462;448;1616;753;2322;1201;3938
411400;201410;1887;5625;1449;4608;326;1169;429;1254;755;2423
411410;201410;2678;8294;2188;7129;698;2576;575;1612;1273;4188
411420;201410;4733;13805;3524;11066;921;3215;708;1860;1629;5075
411430;201410;3056;9839;2602;8995;792;2979;1127;3812;1919;6791
411435;201410;601;1933;510;1703;146;534;184;586;330;1120
411440;201410;2686;8760;2423;8234;891;3183;735;2610;1626;5793
411450;201410;2210;6771;2014;6423;449;1491;1194;3841;1643;5332
411460;201410;4621;14355;3124;10675;1103;4014;570;1822;1673;5836
411470;201410;889;2706;604;1997;127;462;116;328;243;790
411480;201410;5210;15945;4070;13639;1580;5752;917;2954;2497;8706
411490;201410;1748;5441;1543;5053;552;2039;425;1251;977;3290
411500;201410;1782;4993;1252;3986;351;1216;322;1004;673;2220
411510;201410;2518;7388;1983;6317;671;2356;446;1259;1117;3615
411520;201410;26303;72912;16006;50778;3957;13894;3731;11016;7688;24910
411530;201410;953;2754;647;2174;233;874;108;297;341;1171
411535;201410;491;1477;229;821;41;174;26;65;67;239
411540;201410;3124;8506;2438;7223;458;1442;1233;3646;1691;5088
411545;201410;1067;3675;982;3507;201;768;636;2300;837;3068
411550;201410;764;2149;621;1908;250;842;151;441;401;1283
411560;201410;2745;8322;2168;6924;621;2158;468;1354;1089;3512
411570;201410;6570;18178;4854;15236;1416;4915;1155;3715;2571;8630
411573;201410;1028;3102;969;2998;207;677;562;1769;769;2446
411575;201410;1564;5069;1336;4553;347;1275;505;1710;852;2985
411580;201410;3700;10864;2604;8528;614;2364;424;1089;1038;3453
411585;201410;601;2073;411;1497;115;450;73;246;188;696
411590;201410;603;1794;534;1658;139;485;190;568;329;1053
411600;201410;376;1153;310;1021;89;347;85;284;174;631
411605;201410;2404;6727;1744;5434;457;1559;677;2035;1134;3594
411610;201410;2475;7036;2210;6639;466;1511;1455;4323;1921;5834
411620;201410;2960;9635;2775;9306;853;3042;1248;4279;2101;7321
411630;201410;510;1327;292;976;69;279;62;180;131;459
411640;201410;609;1907;507;1694;154;556;188;586;342;1142
411650;201410;196;655;172;613;46;185;61;200;107;385
411660;201410;900;2553;724;2208;187;603;308;940;495;1543
411670;201410;1729;5073;1522;4649;494;1681;546;1548;1040;3229
411680;201410;1776;5431;1546;5036;376;1194;917;3140;1293;4334
411690;201410;3644;10999;2999;9734;963;3285;795;2645;1758;5930
411695;201410;719;2339;574;2021;138;523;222;792;360;1315
411700;201410;1995;5792;1420;4641;344;1248;386;1176;730;2424
411705;201410;2368;8064;2062;7453;484;1778;1140;4250;1624;6028
411710;201410;2251;6883;1826;5939;541;1883;480;1452;1021;3335
411720;201410;758;2263;562;1801;107;375;149;438;256;813
411721;201410;732;2233;614;1984;198;703;126;368;324;1071
411722;201410;745;2265;568;1862;140;526;162;459;302;985
411725;201410;1383;4477;853;3090;209;800;189;676;398;1476
411727;201410;2347;6783;1893;5814;464;1547;796;2304;1260;3851
411729;201410;528;1463;380;1187;115;405;115;311;230;716
411730;201410;5308;15576;4474;13974;1957;6303;1297;4119;3254;10422
411740;201410;598;1760;422;1355;98;341;158;488;256;829
411745;201410;958;2961;780;2571;212;721;212;678;424;1399
411750;201410;4800;14937;3663;12166;1094;4013;724;2218;1818;6231
411760;201410;9102;27040;8112;25328;3043;10136;2514;7954;5557;18090
411770;201410;3999;13915;3474;12620;1365;5232;765;2769;2130;8001
411780;201410;3137;10238;3014;10095;400;1230;2263;8038;2663;9268
411790;201410;2731;7904;1996;6417;606;2257;656;2003;1262;4260
411800;201410;1466;4272;881;2914;159;601;168;448;327;1049
411810;201410;1632;5011;1407;4528;392;1444;458;1302;850;2746
411820;201410;17183;54260;14290;48713;5126;17991;4365;15511;9491;33502
411830;201410;426;1162;339;1030;151;460;47;146;198;606
411840;201410;9557;28504;7441;24290;2169;7704;1991;6251;4160;13955
411845;201410;606;1903;436;1482;103;384;108;345;211;729
411850;201410;6155;18767;5099;16578;1394;4852;1511;4886;2905;9738
411860;201410;940;3000;777;2641;222;797;231;747;453;1544
411870;201410;1076;3788;830;3110;152;601;217;788;369;1389
411880;201410;2061;6058;1677;5345;469;1726;586;1662;1055;3388
411885;201410;768;2102;595;1769;137;520;239;613;376;1133
411890;201410;1387;4302;980;3324;280;1020;191;579;471;1599
411900;201410;970;3142;693;2426;209;738;118;421;327;1159
411910;201410;1261;4328;1079;3904;347;1382;328;1116;675;2498
411915;201410;12968;36768;8443;27222;1957;6975;2091;6178;4048;13153
411920;201410;1096;3836;965;3505;283;1137;222;750;505;1887
411925;201410;599;1703;408;1349;113;394;127;402;240;796
411930;201410;6473;21369;5689;19748;1872;6946;1999;6948;3871;13894
411940;201410;3720;12551;3293;11615;1113;4104;862;2953;1975;7057
411950;201410;10748;34566;9023;31089;2493;9420;4109;13895;6602;23315
411960;201410;4956;15095;4549;14298;1149;4044;2161;6623;3310;10667
411965;201410;625;1850;466;1590;101;387;168;584;269;971
411970;201410;801;2275;613;1975;200;719;167;501;367;1220
411980;201410;1453;4553;1224;4041;213;754;530;1739;743;2493
411990;201410;31773;108157;27443;98582;9633;37029;7965;28597;17598;65626
411995;201410;3228;10165;2869;9414;1165;4130;753;2413;1918;6543
412000;201410;1998;5400;1615;4722;320;1098;813;2148;1133;3246
412010;201410;744;2526;621;2232;166;623;154;516;320;1139
412015;201410;681;2078;546;1776;110;386;274;882;384;1268
412020;201410;452;1332;320;1043;113;398;124;378;237;776
412030;201410;660;2083;436;1529;95;392;124;387;219;779
412033;201410;792;2425;558;1873;140;507;118;350;258;857
412035;201410;1049;2961;790;2487;198;681;323;965;521;1646
412040;201410;788;2593;706;2379;253;882;234;770;487;1652
412050;201410;1663;5010;1281;4173;328;1215;278;855;606;2070
412060;201410;7004;24643;6388;23239;1985;7705;2506;9108;4491;16813
412065;201410;1017;3125;834;2725;246;914;243;736;489;1650
412070;201410;1275;3551;1054;3106;229;720;395;1139;624;1859
412080;201410;1574;4890;971;3461;197;797;82;225;279;1022
412085;201410;384;1113;179;600;45;176;49;145;94;321
412090;201410;4966;16219;4743;15803;1033;3663;2970;10010;4003;13673
412100;201410;2271;7169;1990;6659;666;2352;683;2231;1349;4583
412110;201410;1167;3365;794;2555;239;830;231;720;470;1550
412120;201410;1881;6454;1683;5971;447;1801;767;2544;1214;4345
412125;201410;998;3117;886;2923;251;877;361;1215;612;2092
412130;201410;633;1871;467;1531;101;365;126;398;227;763
412135;201410;566;1632;407;1302;104;368;150;433;254;801
412140;201410;1437;4407;1180;3844;309;1064;365;1181;674;2245
412150;201410;3025;8944;2616;8127;403;1429;1568;4735;1971;6164
412160;201410;1002;3260;660;2364;191;800;203;685;394;1485
412170;201410;4658;15286;3904;13779;1356;5144;1412;4881;2768;10025
412175;201410;1504;5186;1347;4828;380;1483;563;2006;943;3489
412180;201410;1845;5841;1419;5032;486;1894;419;1414;905;3308
412190;201410;3257;9653;2583;8473;862;3025;694;2311;1556;5336
412200;201410;2342;7769;1662;5915;401;1567;526;1841;927;3408
412210;201410;780;2213;457;1514;114;426;72;224;186;650
412215;201410;3606;11449;3274;10840;604;2021;2092;7141;2696;9162
412217;201410;1259;3695;1172;3542;220;777;759;2165;979;2942
412220;201410;5142;17299;4916;16848;1507;5426;2694;9214;4201;14640
412230;201410;3110;10558;2698;9705;782;3125;849;2952;1631;6077
412240;201410;9808;25720;5632;17795;1295;4576;984;2793;2279;7369
412250;201410;2238;6838;1969;6238;653;2254;558;1635;1211;3889
412260;201410;1418;4184;962;3186;204;790;320;933;524;1723
412265;201410;1245;3920;1127;3694;282;1061;551;1771;833;2832
412270;201410;878;2836;661;2329;154;614;131;433;285;1047
412280;201410;607;1939;451;1594;254;939;53;182;307;1121
412290;201410;1209;3443;967;2956;200;702;367;1032;567;1734
412300;201410;1844;5576;1534;4957;478;1724;409;1251;887;2975
412310;201410;1240;3518;1100;3324;195;503;747;2495;942;2998
412320;201410;735;2044;540;1702;132;465;191;601;323;1066
412330;201410;2033;5579;1564;4742;356;1154;750;2271;1106;3425
412340;201410;811;2571;541;1862;91;338;97;310;188;648
412350;201410;2714;8632;2215;7497;734;2638;360;1106;1094;3744
412360;201410;356;1129;276;916;53;203;91;252;144;455
412370;201410;1156;3628;913;3146;327;1204;268;902;595;2106
412380;201410;2099;6415;1803;5739;554;1853;530;1659;1084;3512
412382;201410;707;2034;480;1532;102;344;149;441;251;785
412385;201410;2510;7943;2271;7404;737;2551;740;2401;1477;4952
412390;201410;2541;7580;2308;7177;791;2631;892;2791;1683;5422
412395;201410;988;2762;790;2442;123;401;479;1479;602;1880
412400;201410;1196;3723;1051;3441;326;1093;410;1404;736;2497
412402;201410;2118;6452;1705;5558;528;1920;471;1326;999;3246
412405;201410;4285;12473;2797;9222;752;2769;377;1150;1129;3919
412410;201410;6551;21164;5865;19776;2475;9132;1314;4326;3789;13458
412420;201410;560;1656;439;1397;133;462;138;372;271;834
412430;201410;510;1489;419;1302;110;380;170;481;280;861
412440;201410;4120;12389;3502;11283;731;2567;1352;4525;2083;7092
412450;201410;313;1011;239;816;43;156;38;87;81;243
412460;201410;1032;2959;738;2394;185;705;173;513;358;1218
412470;201410;1896;6479;1673;5918;557;2059;577;2093;1134;4152
412480;201410;1335;3943;918;3004;221;780;144;383;365;1163
412490;201410;1312;3886;1154;3513;320;1021;344;1020;664;2041
412500;201410;2104;6257;1795;5645;506;1820;480;1314;986;3134
412510;201410;2816;9535;2474;8646;751;2830;938;3241;1689;6071
412520;201410;1903;5343;1422;4495;448;1516;453;1394;901;2910
412530;201410;819;2459;687;2159;202;638;210;660;412;1298
412535;201410;512;1565;333;1092;81;295;84;238;165;533
412540;201410;1158;3394;863;2752;151;547;316;996;467;1543
412545;201410;965;2782;784;2388;149;515;305;838;454;1353
412550;201410;25071;76280;16967;57543;4724;17330;3580;11347;8304;28677
412555;201410;355;1089;244;807;59;218;46;124;105;342
412560;201410;4973;16028;3939;13867;1057;4251;997;3203;2054;7454
412570;201410;4358;13145;3171;10396;819;3013;686;2111;1505;5124
412575;201410;880;2729;706;2314;169;636;225;681;394;1317
412580;201410;1494;4158;1082;3419;271;892;337;1026;608;1918
412590;201410;513;1560;404;1349;133;475;124;431;257;906
412600;201410;1585;4986;1344;4479;435;1595;438;1363;873;2958
412610;201410;839;2694;667;2282;228;885;182;538;410;1423
412620;201410;1310;4338;1093;3867;365;1392;239;815;604;2207
412625;201410;14443;41319;11873;36324;4294;14006;2779;8364;7073;22370
412627;201410;1067;3282;737;2542;264;977;81;261;345;1238
412630;201410;3648;11666;3138;10537;854;3023;1039;3381;1893;6404
412635;201410;559;1716;395;1333;102;366;53;165;155;531
412640;201410;877;2668;589;1970;136;486;93;267;229;753
412650;201410;2365;6817;1952;6036;532;1849;674;1858;1206;3707
412660;201410;3179;9623;2600;8382;679;2431;622;1877;1301;4308
412665;201410;749;2011;463;1484;170;594;131;392;301;986
412667;201410;1515;4521;1204;3887;314;1162;339;1017;653;2179
412670;201410;698;2209;474;1651;109;430;82;215;191;645
412680;201410;1688;5344;1266;4382;347;1295;335;1044;682;2339
412690;201410;796;2526;631;2154;241;882;122;404;363;1286
412700;201410;1884;6103;1635;5683;635;2444;569;1923;1204;4367
412710;201410;9004;28380;7552;25314;2210;8058;2032;6523;4242;14581
412720;201410;1743;5540;1217;4144;301;1106;159;433;460;1539
412730;201410;2914;8832;2002;6823;643;2345;275;826;918;3171
412740;201410;2240;7358;1953;6695;796;2860;340;1198;1136;4058
412750;201410;3624;11691;3259;11073;599;2365;2142;7071;2741;9436
412760;201410;2466;8209;2349;8001;687;2633;1075;3490;1762;6123
412770;201410;13024;38022;8238;27280;1933;7128;1866;5625;3799;12753
412780;201410;1528;5008;1340;4564;410;1495;429;1387;839;2882
412785;201410;2560;7490;1858;5992;466;1660;889;2781;1355;4441
412788;201410;1446;4696;1311;4421;336;1306;488;1465;824;2771
412790;201410;1270;3919;1025;3391;268;947;282;857;550;1804
412795;201410;1075;3149;928;2880;293;940;330;1007;623;1947
412796;201410;2761;8710;2538;8241;711;2605;1053;3196;1764;5801
412800;201410;3743;11117;2956;9513;837;2963;908;2758;1745;5721
412810;201410;10931;30844;6492;20878;1635;5680;1471;4227;3106;9907
412820;201410;6941;20971;5135;17373;1473;5464;1163;3975;2636;9439
412830;201410;411;1332;347;1193;99;397;93;273;192;670
412840;201410;2245;6462;1849;5643;514;1714;481;1410;995;3124
412850;201410;2700;8195;2297;7551;437;1701;1137;3523;1574;5224
412853;201410;1540;4476;1361;4131;158;640;850;2372;1008;3012
412855;201410;1711;4929;1344;4161;432;1527;365;988;797;2515
412860;201410;1350;4064;1130;3630;308;1116;474;1453;782;2569
412862;201410;880;2369;649;1921;168;546;244;669;412;1215
412863;201410;1266;4269;1213;4173;194;706;831;2847;1025;3553
412865;201410;695;2180;512;1727;114;409;201;694;315;1103
412870;201410;1048;3030;879;2747;306;1013;274;853;580;1866
412880;201410;1611;4469;1363;4055;420;1359;357;1017;777;2376
420005;201410;549;1651;363;1219;82;300;134;423;216;723
420010;201410;3566;10709;2980;9757;495;1722;2012;6746;2507;8468
420020;201410;810;2661;469;1733;84;359;60;170;144;529
420030;201410;596;1699;332;1180;95;382;59;204;154;586
420040;201410;1002;3117;661;2422;211;850;131;405;342;1255
420050;201410;850;2666;681;2270;205;715;278;896;483;1611
420055;201410;324;1038;219;779;56;215;43;129;99;344
420060;201410;388;1385;291;1115;86;361;40;136;126;497
420070;201410;1421;4568;1132;3866;188;699;619;2151;807;2850
420075;201410;209;613;116;396;31;125;35;103;66;228
420080;201410;650;2128;535;1884;192;728;129;445;321;1173
420090;201410;695;2480;539;2105;160;646;97;374;257;1020
420100;201410;1552;4986;1428;4814;387;1347;822;2802;1209;4149
420110;201410;465;1599;422;1504;118;430;197;713;315;1143
420120;201410;344;1216;288;1089;108;451;63;216;171;667
420125;201410;395;1608;365;1535;155;691;111;432;266;1123
420127;201410;621;1931;283;1068;94;376;43;161;137;537
420130;201410;2619;8960;2258;8210;691;2736;797;2691;1488;5427
420140;201410;5361;15786;3727;12606;1043;3968;719;2224;1762;6192
420150;201410;837;2499;567;1883;168;613;178;534;346;1147
420160;201410;327;973;204;695;39;150;51;164;90;314
420165;201410;242;777;159;555;38;157;36;120;74;277
420170;201410;250;818;172;657;66;297;21;52;87;349
420180;201410;478;1514;286;1037;81;309;64;220;145;529
420190;201410;614;1962;369;1373;126;513;64;216;190;729
420195;201410;1461;4220;1171;3807;288;1002;575;1930;863;2932
420200;201410;3109;10186;1984;7501;651;2716;353;1200;1004;3916
420205;201410;1134;3784;1010;3558;287;1072;468;1647;755;2719
420207;201410;1515;4497;1067;3530;324;1216;322;956;646;2172
420208;201410;524;1568;352;1228;130;498;104;345;234;843
420209;201410;378;1208;235;848;44;167;71;245;115;412
420210;201410;1891;6129;1297;4955;399;1771;194;643;593;2414
420213;201410;959;3477;910;3359;201;763;577;2155;778;2918
420215;201410;530;1734;388;1357;123;447;68;220;191;667
420220;201410;437;1706;410;1645;175;748;109;391;284;1139
420230;201410;4759;14740;3654;12643;940;3674;1723;5781;2663;9455
420240;201410;14613;42528;9182;32044;2112;8773;3636;11457;5748;20230
420243;201410;603;1871;487;1617;118;454;173;542;291;996
420245;201410;1297;4050;893;3181;255;1018;198;608;453;1626
420250;201410;843;2711;784;2614;268;981;341;1141;609;2122
420253;201410;690;1818;561;1633;133;393;269;866;402;1259
420257;201410;447;1375;336;1159;91;327;157;534;248;861
420260;201410;1449;4731;1240;4350;344;1315;574;2015;918;3330
420270;201410;621;2000;259;954;49;184;34;106;83;290
420280;201410;2412;6527;1447;4744;318;1255;553;1609;871;2864
420285;201410;162;480;55;207;7;31;1;2;8;33
420287;201410;669;2061;574;1878;158;532;204;671;362;1203
420290;201410;7036;21054;4486;15070;1049;3866;1463;4576;2512;8442
420300;201410;6210;19211;4079;14559;1043;4233;856;2995;1899;7228
420310;201410;909;2760;866;2690;186;615;548;1664;734;2279
420315;201410;995;3249;792;2822;235;924;314;1105;549;2029
420320;201410;5207;16305;4289;14636;1260;4779;1749;5794;3009;10573
420325;201410;469;1521;445;1462;136;484;167;535;303;1019
420330;201410;1337;4685;1050;3876;356;1396;249;807;605;2203
420340;201410;1542;4829;1184;3972;286;1057;305;961;591;2018
420350;201410;1695;5490;1451;4973;422;1532;628;2162;1050;3694
420360;201410;3940;12615;2905;10203;1055;4079;524;1656;1579;5735
420370;201410;2127;5972;1758;5384;223;695;1387;4241;1610;4936
420380;201410;5717;19113;4704;16683;1517;5766;1306;4630;2823;10396
420390;201410;2186;6561;1335;4725;394;1502;342;1154;736;2656
420395;201410;2130;6683;1591;5437;383;1462;325;975;708;2437
420400;201410;1546;4621;1137;3815;345;1348;328;995;673;2343
420410;201410;870;2429;616;1997;164;600;316;998;480;1598
420415;201410;531;1706;416;1414;134;490;136;447;270;937
420417;201410;828;2676;699;2362;142;518;350;1171;492;1689
420419;201410;471;1499;324;1203;140;564;82;305;222;869
420420;201410;11686;35337;8823;29368;2696;10065;2839;8985;5535;19050
420425;201410;1312;3634;805;2571;93;369;350;1013;443;1382
420430;201410;4303;13588;2963;10378;899;3423;859;2965;1758;6388
420435;201410;296;952;213;748;50;206;100;338;150;544
420440;201410;1513;4442;923;3175;362;1335;172;549;534;1884
420445;201410;443;1288;349;1119;82;262;177;584;259;846
420450;201410;1323;3923;794;2806;199;795;157;464;356;1259
420455;201410;2362;7326;2095;6845;556;2067;940;2999;1496;5066
420460;201410;10431;32854;8353;28837;2430;9429;3097;10225;5527;19654
420470;201410;1281;3556;839;2698;253;921;241;720;494;1641
420475;201410;185;602;122;445;41;154;32;119;73;273
420480;201410;6214;18589;5124;16671;2056;7417;925;2967;2981;10384
420490;201410;937;2824;632;2246;209;786;153;529;362;1315
420500;201410;2166;6700;1757;5911;552;2018;837;2788;1389;4806
420510;201410;201;847;186;808;77;344;53;212;130;556
420515;201410;165;595;132;518;41;173;26;104;67;277
420517;201410;977;3034;894;2877;158;533;586;1903;744;2436
420519;201410;478;1338;349;1079;66;215;132;405;198;620
420520;201410;833;2345;656;2092;185;654;313;960;498;1614
420530;201410;1446;5002;1152;4260;364;1472;296;962;660;2434
420535;201410;291;864;181;632;60;232;31;88;91;320
420540;201410;23911;70183;16526;53988;5033;17897;4772;14483;9805;32380
420543;201410;510;1370;362;1126;50;185;213;692;263;877
420545;201410;1746;5658;1435;4953;392;1521;486;1559;878;3080
420550;201410;5111;16550;4049;14090;1144;4531;1097;3626;2241;8157
420555;201410;468;1520;392;1353;132;495;125;418;257;913
420560;201410;604;1788;505;1578;94;325;259;803;353;1128
420570;201410;2139;7080;1721;6045;509;2012;561;1853;1070;3865
420580;201410;1314;4289;1083;3867;316;1258;486;1720;802;2978
420590;201410;3612;11392;2550;8905;707;2688;506;1605;1213;4293
420600;201410;1010;3510;912;3277;242;931;389;1430;631;2361
420610;201410;656;2141;447;1650;148;594;79;261;227;855
420620;201410;1224;3859;1083;3596;398;1398;297;976;695;2374
420630;201410;1257;3992;906;3139;248;916;286;891;534;1807
420640;201410;716;2249;339;1293;89;389;24;71;113;460
420650;201410;2202;6711;1256;4447;259;1040;235;700;494;1740
420660;201410;696;2071;558;1812;130;477;264;839;394;1316
420665;201410;864;2508;553;1855;119;442;178;531;297;973
420670;201410;1850;5849;1377;4788;334;1327;282;856;616;2183
420675;201410;259;818;182;634;46;182;69;226;115;408
420680;201410;526;1283;315;953;63;217;110;306;173;523
420690;201410;871;3022;635;2351;135;550;197;666;332;1216
420700;201410;3808;11091;2903;9242;708;2638;955;2884;1663;5522
420710;201410;834;2990;694;2700;268;1130;198;736;466;1866
420720;201410;1987;6159;1718;5789;464;1632;985;3335;1449;4967
420730;201410;4917;15346;4238;14058;1443;5141;1639;5333;3082;10474
420740;201410;830;2727;793;2675;180;627;540;1834;720;2461
420750;201410;2641;8639;1853;6694;443;1828;555;1750;998;3578
420757;201410;146;436;97;364;33;137;28;98;61;235
420760;201410;462;1491;339;1156;76;279;96;306;172;585
420765;201410;706;2343;425;1615;117;484;94;342;211;826
420768;201410;1322;4614;1080;4052;361;1421;394;1487;755;2908
420770;201410;951;2959;587;2125;187;731;144;496;331;1227
420775;201410;723;2314;463;1595;145;500;98;322;243;822
420780;201410;1722;5315;1149;3896;314;1148;288;907;602;2055
420785;201410;324;992;225;737;43;156;74;219;117;375
420790;201410;1414;5069;1153;4344;344;1443;454;1603;798;3046
420800;201410;977;2879;572;1940;185;694;122;381;307;1075
420810;201410;2709;9440;2175;8171;782;3258;571;2077;1353;5335
420820;201410;9043;30018;7082;26361;2380;9828;2274;8500;4654;18328
420830;201410;2952;9945;2534;9131;946;3694;883;3083;1829;6777
420840;201410;1037;3067;579;2114;162;665;164;551;326;1216
420845;201410;1427;4744;1139;4167;421;1738;248;807;669;2545
420850;201410;2151;7082;1424;5474;489;2018;301;1156;790;3174
420860;201410;690;2021;463;1597;162;627;187;631;349;1258
420870;201410;1452;4191;1140;3723;430;1555;365;1115;795;2670
420880;201410;1513;5095;1228;4332;353;1301;232;763;585;2064
420890;201410;13498;32700;6080;19306;1226;4467;2040;5684;3266;10151
420895;201410;240;661;116;380;35;122;27;80;62;202
420900;201410;2489;7173;1607;5398;446;1613;418;1325;864;2938
420910;201410;24109;73546;15676;55370;3695;14928;4388;14387;8083;29315
420915;201410;726;2839;625;2556;197;825;268;1111;465;1936
420917;201410;470;1467;251;810;59;224;89;236;148;460
420920;201410;216;634;113;395;50;186;18;65;68;251
420930;201410;21798;65090;17877;58304;5394;19275;6575;21151;11969;40426
420940;201410;4579;14045;3899;12537;1114;3976;1149;3334;2263;7310
420945;201410;244;762;160;554;51;197;42;137;93;334
420950;201410;675;1964;317;1193;75;326;53;177;128;503
420960;201410;1506;4697;1300;4326;415;1569;503;1542;918;3111
420970;201410;2767;8744;2430;8181;683;2505;1202;4111;1885;6616
420980;201410;486;1579;399;1418;128;453;186;724;314;1177
420985;201410;626;1864;359;1276;108;419;101;341;209;760
420990;201410;962;2855;654;2309;177;694;190;623;367;1317
421000;201410;700;2523;497;1975;153;662;69;221;222;883
421003;201410;720;2049;304;1048;65;251;60;160;125;411
421005;201410;267;861;221;778;72;273;105;361;177;634
421010;201410;7212;21930;5360;18280;1742;6471;1590;5117;3332;11588
421020;201410;512;1635;386;1387;68;245;205;775;273;1020
421030;201410;1041;3832;965;3641;346;1381;328;1249;674;2630
421040;201410;966;2904;781;2570;246;882;302;921;548;1803
421050;201410;2104;5610;1175;3918;322;1230;289;824;611;2054
421055;201410;293;948;190;690;60;240;49;144;109;384
421060;201410;601;2210;485;1879;118;495;147;551;265;1046
421070;201410;816;2570;537;1891;147;595;133;447;280;1042
421080;201410;715;2314;641;2155;189;670;307;1022;496;1692
421085;201410;602;1634;330;1138;80;301;89;326;169;627
421090;201410;511;1437;342;1068;85;284;137;410;222;694
421100;201410;1108;3377;772;2632;222;798;175;526;397;1324
421105;201410;1579;5001;1344;4570;339;1257;543;1883;882;3140
421110;201410;1686;5563;1466;5180;542;2069;466;1543;1008;3612
421120;201410;1749;5652;1264;4479;296;1218;384;1211;680;2429
421125;201410;473;1403;352;1175;107;399;130;408;237;807
421130;201410;3510;11575;2900;10413;1037;4138;967;3455;2004;7593
421140;201410;448;1407;356;1202;95;358;134;424;229;782
421145;201410;614;2030;452;1582;78;304;203;687;281;991
421150;201410;609;1971;463;1692;126;496;187;683;313;1179
421160;201410;1143;3492;674;2354;160;633;225;717;385;1350
421165;201410;340;1200;273;989;67;250;120;435;187;685
421170;201410;2057;6425;1635;5483;440;1562;847;2795;1287;4357
421175;201410;1488;4451;1169;3911;347;1373;433;1289;780;2662
421180;201410;632;1803;353;1192;96;368;126;385;222;753
421185;201410;495;1408;362;1143;76;231;176;577;252;808
421187;201410;348;1096;274;942;84;303;113;372;197;675
421189;201410;542;1657;487;1551;126;413;189;597;315;1010
421190;201410;11933;37305;8247;29261;2422;9194;2288;8001;4710;17195
421200;201410;1117;3724;959;3379;258;994;351;1201;609;2195
421205;201410;247;779;185;640;43;177;48;138;91;315
421210;201410;2201;6846;1816;5889;620;2126;563;1760;1183;3886
421220;201410;2558;8754;2244;8071;800;3134;628;2225;1428;5359
421223;201410;791;2262;497;1734;139;514;222;759;361;1273
421225;201410;1275;3962;1058;3497;286;1009;443;1462;729;2471
421227;201410;977;3229;869;3061;221;771;512;1868;733;2639
421230;201410;767;2605;688;2419;201;758;251;848;452;1606
421240;201410;576;1910;363;1286;84;312;71;222;155;534
421250;201410;2125;6506;1426;5210;519;2056;367;1303;886;3359
421260;201410;399;1209;159;616;46;176;31;115;77;291
421265;201410;420;1461;382;1360;98;362;135;485;233;847
421270;201410;799;2195;466;1572;152;553;119;441;271;994
421280;201410;1786;5677;1448;5123;487;1911;468;1663;955;3574
421290;201410;2112;5978;1330;4409;427;1541;319;941;746;2482
421300;201410;342;1072;284;947;101;383;114;356;215;739
421310;201410;543;1853;460;1630;159;572;118;400;277;972
421315;201410;399;1195;232;837;50;184;39;145;89;329
421320;201410;606;2080;410;1534;83;346;72;216;155;562
421330;201410;657;2296;569;2112;234;978;83;292;317;1270
421335;201410;589;1946;467;1697;126;501;104;385;230;886
421340;201410;2110;6534;1791;5989;407;1549;998;3303;1405;4852
421350;201410;1165;3982;968;3540;316;1289;292;1015;608;2304
421360;201410;3384;10113;2224;7809;534;2131;717;2339;1251;4470
421370;201410;1164;4102;984;3677;336;1388;298;1055;634;2443
421380;201410;1122;3254;900;2820;181;625;439;1373;620;1998
421390;201410;202;661;154;533;28;97;43;162;71;259
421400;201410;431;1629;350;1437;141;616;86;329;227;945
421410;201410;402;1205;299;1003;63;218;149;504;212;722
421415;201410;445;1402;211;792;68;273;54;187;122;460
421420;201410;1432;4482;1075;3607;249;887;235;725;484;1612
421430;201410;310;1017;243;882;78;322;47;160;125;482
421440;201410;893;2682;612;2133;169;637;226;746;395;1383
421450;201410;651;2139;452;1685;148;604;89;312;237;916
421460;201410;734;2310;482;1793;132;544;122;428;254;972
421470;201410;557;2038;470;1841;138;557;184;726;322;1283
421480;201410;2939;8907;1866;6734;552;2236;484;1575;1036;3811
421490;201410;350;1160;191;743;71;298;51;196;122;494
421500;201410;2824;10013;2457;9223;1004;4202;554;2019;1558;6221
421505;201410;438;1496;389;1373;116;430;158;552;274;982
421507;201410;733;2352;513;1840;117;437;196;706;313;1143
421510;201410;314;1180;287;1125;95;432;122;412;217;844
421520;201410;838;2267;545;1658;61;237;284;785;345;1022
421530;201410;536;1798;340;1337;88;392;117;446;205;838
421535;201410;708;2140;406;1478;82;323;203;705;285;1028
421540;201410;430;1267;367;1148;90;312;150;442;240;754
421545;201410;1310;4520;1051;3965;338;1423;232;828;570;2251
421550;201410;2347;7885;2062;7331;734;2908;619;2116;1353;5024
421555;201410;339;1030;134;477;23;92;25;81;48;173
421560;201410;246;751;102;366;24;96;23;79;47;175
421565;201410;1128;3582;1031;3412;436;1556;369;1175;805;2731
421567;201410;984;3666;848;3306;406;1627;181;699;587;2326
421568;201410;505;1647;387;1381;110;409;118;421;228;830
421569;201410;217;704;132;498;28;113;36;129;64;242
421570;201410;1344;4406;843;3146;294;1206;198;696;492;1902
421575;201410;638;2145;568;2002;117;439;326;1153;443;1592
421580;201410;4395;14687;3490;12600;1263;5112;885;2883;2148;7995
421590;201410;265;847;215;740;46;166;105;344;151;510
421600;201410;600;1803;438;1449;132;481;108;333;240;814
421605;201410;724;2257;512;1815;128;518;143;477;271;995
421610;201410;1884;4912;1470;4305;198;634;953;2777;1151;3411
421620;201410;5454;16834;3864;13407;1289;4812;1269;4424;2558;9236
421625;201410;446;1405;257;931;68;277;88;304;156;581
421630;201410;2898;8773;1773;6169;530;2007;343;1147;873;3154
421635;201410;371;1235;262;973;67;272;100;338;167;610
421640;201410;1177;3748;993;3409;214;741;590;2071;804;2812
421650;201410;2454;8249;2107;7438;831;3229;363;1178;1194;4407
421660;201410;10154;34055;8191;30007;2695;10932;2609;8989;5304;19921
421670;201410;1318;4287;957;3440;306;1203;276;983;582;2186
421680;201410;1533;5025;1342;4562;527;1886;271;893;798;2779
421690;201410;2113;7000;1644;5855;466;1815;271;897;737;2712
421700;201410;753;2347;462;1665;142;577;145;446;287;1023
421710;201410;368;1313;267;1016;105;410;71;260;176;670
421715;201410;319;910;193;645;56;199;59;189;115;388
421720;201410;1723;5282;1171;4131;443;1747;348;1127;791;2874
421725;201410;137;483;129;465;54;212;37;134;91;346
421730;201410;664;2068;342;1253;90;360;73;211;163;571
421740;201410;709;2196;485;1638;124;509;117;289;241;798
421750;201410;1527;4609;1172;3855;327;1178;470;1418;797;2596
421755;201410;473;1499;338;1157;104;393;97;297;201;690
421760;201410;592;1980;335;1245;87;362;123;433;210;795
421770;201410;3931;11992;3156;10391;1221;4186;912;3095;2133;7281
421775;201410;602;1775;393;1387;91;334;123;425;214;759
421780;201410;1848;6389;1450;5471;550;2248;432;1532;982;3780
421790;201410;1075;3029;654;2312;210;844;164;521;374;1365
421795;201410;421;1292;282;936;53;202;86;278;139;480
421800;201410;2997;9639;2314;8264;638;2570;855;2785;1493;5355
421810;201410;699;2261;507;1810;155;584;90;316;245;900
421820;201410;1340;4120;938;3295;216;890;259;809;475;1699
421825;201410;1483;4944;1374;4680;233;934;865;2820;1098;3754
421830;201410;3301;11245;3067;10770;784;2923;1553;5575;2337;8498
421835;201410;204;638;158;560;50;212;77;247;127;459
421840;201410;535;1909;469;1746;165;674;173;611;338;1285
421850;201410;625;1864;443;1498;145;522;132;453;277;975
421860;201410;402;1290;258;961;58;238;57;196;115;434
421870;201410;5529;16334;3914;12958;1236;4417;758;2400;1994;6817
421875;201410;445;1337;206;764;55;234;46;149;101;383
421880;201410;1143;3748;915;3209;281;1122;242;780;523;1902
421885;201410;382;1313;332;1211;84;311;136;496;220;807
421890;201410;1124;3846;967;3502;337;1360;299;1039;636;2399
421895;201410;447;1524;412;1454;112;398;227;828;339;1226
421900;201410;910;2970;754;2588;221;799;263;834;484;1633
421910;201410;569;1794;405;1405;101;392;123;374;224;766
421915;201410;645;1969;489;1608;119;419;164;502;283;921
421917;201410;639;1983;502;1746;162;666;189;602;351;1268
421920;201410;900;2655;635;2286;283;1063;211;757;494;1820
421930;201410;4263;12043;2877;9472;922;3395;501;1553;1423;4948
421935;201410;916;3181;720;2729;199;841;265;972;464;1813
421940;201410;369;1343;259;1020;79;349;60;208;139;557
421950;201410;4712;13441;2580;8856;794;2886;569;1974;1363;4860
421960;201410;267;858;214;736;58;218;61;198;119;416
421970;201410;2406;7202;1668;5552;608;2201;329;967;937;3168
421985;201410;546;1470;298;962;58;211;91;303;149;514
422000;201410;747;2207;593;1915;129;451;293;977;422;1428
430003;201410;918;2674;726;2333;213;760;229;710;442;1470
430005;201410;328;1097;277;985;59;223;151;521;210;744
430010;201410;2345;6651;1785;5595;545;1773;694;2194;1239;3967
430020;201410;1136;3044;987;2821;225;745;573;1560;798;2305
430030;201410;1631;4422;1338;3889;473;1468;355;978;828;2446
430040;201410;13121;34521;10890;30783;3380;9927;3918;11066;7298;20993
430045;201410;781;2173;623;1847;119;399;347;1000;466;1399
430047;201410;283;711;172;520;36;103;77;232;113;335
430050;201410;1155;3176;757;2407;161;595;287;853;448;1448
430055;201410;310;890;199;628;38;134;101;313;139;447
430057;201410;86;227;42;136;8;30;13;30;21;60
430060;201410;16709;54454;14673;50764;4311;15547;7175;25365;11486;40912
430063;201410;1119;3331;906;2867;250;800;427;1401;677;2201
430064;201410;1743;5199;1453;4704;425;1405;643;2149;1068;3554
430066;201410;181;465;134;390;27;88;75;205;102;293
430070;201410;717;2127;405;1405;111;421;117;363;228;784
430080;201410;675;2188;529;1846;143;553;160;512;303;1065
430085;201410;756;2139;539;1751;158;590;214;655;372;1245
430087;201410;1018;3115;967;3019;114;400;744;2291;858;2691
430090;201410;862;2301;303;1009;45;174;66;220;111;394
430100;201410;1190;3658;865;2970;300;1143;223;646;523;1789
430105;201410;879;2787;671;2364;205;804;175;579;380;1383
430107;201410;275;933;217;759;47;181;83;272;130;453
430110;201410;2367;6886;2123;6484;693;2230;941;2872;1634;5102
430120;201410;1887;5754;1486;4898;339;1189;807;2598;1146;3787
430130;201410;4684;12084;4183;11352;832;2424;2446;6662;3278;9086
430140;201410;1295;4146;987;3411;310;1105;333;1121;643;2226
430150;201410;992;2671;648;2023;166;561;183;560;349;1121
430155;201410;569;1726;405;1374;90;298;194;671;284;969
430160;201410;19222;56621;17760;54199;3903;12881;10026;31343;13929;44224
430163;201410;2024;6085;1732;5540;391;1396;855;2761;1246;4157
430165;201410;454;1347;248;918;96;381;64;222;160;603
430170;201410;804;2367;376;1327;76;289;74;223;150;512
430175;201410;970;3077;767;2594;184;586;359;1294;543;1880
430180;201410;1161;3177;990;2890;249;815;481;1368;730;2183
430185;201410;782;1967;405;1234;65;221;136;373;201;594
430187;201410;759;2342;605;2007;184;690;197;607;381;1297
430190;201410;2436;7264;2131;6664;539;1926;1032;3198;1571;5124
430192;201410;206;635;105;331;16;49;31;94;47;143
430195;201410;298;910;78;282;10;36;13;39;23;75
430200;201410;1817;5795;1501;5134;453;1636;391;1334;844;2970
430205;201410;531;1541;403;1293;59;211;253;796;312;1007
430210;201410;7075;19804;3939;13025;1054;3752;815;2470;1869;6222
430215;201410;379;1101;275;878;62;218;119;363;181;581
430220;201410;733;1922;345;1145;68;249;66;209;134;458
430222;201410;329;1003;254;839;55;220;113;350;168;570
430223;201410;363;1079;316;1004;64;208;207;665;271;873
430225;201410;61;177;37;118;7;19;9;23;16;42
430230;201410;2171;6909;2047;6779;346;1005;1608;5539;1954;6544
430235;201410;290;959;230;806;73;274;58;189;131;463
430237;201410;507;1380;382;1152;49;191;249;717;298;908
430240;201410;1243;3571;907;2970;296;1091;308;928;604;2019
430245;201410;988;3153;765;2653;209;744;345;1223;554;1967
430250;201410;1655;4581;1478;4265;627;1869;428;1261;1055;3130
430258;201410;189;532;129;417;21;74;52;167;73;241
430260;201410;864;2451;579;1852;79;278;318;1027;397;1305
430265;201410;351;1093;281;934;87;284;45;135;132;419
430270;201410;3705;10493;3310;9813;781;2623;1768;5153;2549;7776
430280;201410;5615;15803;4725;14153;1341;4259;2087;6223;3428;10482
430290;201410;2636;7211;2476;7014;294;822;2055;5937;2349;6759
430300;201410;10767;32622;9021;29206;3104;10533;3712;12263;6816;22796
430310;201410;9361;29266;8085;26758;2587;9182;3388;10889;5975;20071
430320;201410;882;2597;600;2011;99;291;312;1102;411;1393
430330;201410;1038;2842;870;2524;265;811;351;944;616;1755
430340;201410;790;1988;442;1466;104;396;209;681;313;1077
430350;201410;6540;20786;5542;18555;2033;7181;1940;6362;3973;13543
430355;201410;342;889;154;489;33;122;31;90;64;212
430360;201410;1185;3186;999;2825;198;632;538;1466;736;2098
430367;201410;365;1005;236;769;44;151;65;206;109;357
430370;201410;509;1483;376;1214;112;400;109;317;221;717
430380;201410;899;2317;503;1593;132;444;180;588;312;1032
430390;201410;4731;13770;3414;11018;892;3113;980;3013;1872;6126
430400;201410;1408;3396;967;2727;291;923;429;1106;720;2029
430410;201410;733;1986;565;1705;104;344;290;877;394;1221
430420;201410;4829;14056;3883;11877;1147;3598;1595;4879;2742;8477
430430;201410;859;2372;545;1767;174;616;152;470;326;1086
430435;201410;2171;5895;1736;5095;414;1276;917;2715;1331;3991
430440;201410;5100;15879;4117;13828;893;3145;1937;6814;2830;9959
430450;201410;9299;26759;7415;22847;2854;9249;2083;6363;4937;15612
430460;201410;29278;88772;23484;78000;7396;26341;8429;27982;15825;54323
430461;201410;497;1385;171;559;34;123;46;144;80;267
430462;201410;373;1093;296;957;124;442;82;244;206;686
430463;201410;4238;13756;3711;12706;918;3418;1857;6365;2775;9783
430465;201410;680;1849;577;1671;119;395;381;1068;500;1463
430466;201410;4709;13602;4361;13025;1152;3748;2319;6891;3471;10639
430467;201410;620;1880;545;1754;136;484;269;836;405;1320
430468;201410;1536;4457;1336;4142;520;1731;420;1288;940;3019
430469;201410;233;662;67;254;9;42;18;65;27;107
430470;201410;7887;21216;5686;17394;1887;6162;1459;4383;3346;10545
430471;201410;930;3071;827;2848;299;1072;219;757;518;1829
430480;201410;969;2628;523;1694;91;323;131;368;222;691
430485;201410;261;799;141;505;28;97;55;200;83;297
430490;201410;557;1651;397;1344;120;416;139;492;259;908
430495;201410;448;1332;298;1000;64;232;83;259;147;491
430500;201410;1684;4738;1424;4282;449;1474;617;1829;1066;3303
430510;201410;26617;81599;20770;68279;7165;25754;6087;19010;13252;44764
430511;201410;491;1497;234;796;45;167;43;120;88;287
430512;201410;1385;3620;1216;3339;351;978;471;1354;822;2332
430513;201410;754;2077;493;1517;80;258;234;721;314;979
430515;201410;630;1854;492;1552;99;299;219;725;318;1024
430517;201410;1516;4939;1303;4480;271;984;795;2726;1066;3710
430520;201410;1876;5469;1448;4536;463;1552;542;1641;1005;3193
430530;201410;988;2776;522;1682;91;343;152;441;243;784
430535;201410;2634;8360;2158;7320;602;2284;733;2405;1335;4689
430537;201410;642;1853;446;1517;50;170;341;1177;391;1347
430540;201410;802;1926;591;1641;139;425;339;917;478;1342
430543;201410;619;1626;558;1564;125;377;386;1087;511;1464
430544;201410;801;2603;667;2288;141;527;346;1153;487;1680
430545;201410;1508;4866;1314;4617;437;1539;685;2560;1122;4099
430550;201410;743;2195;500;1673;110;391;194;653;304;1044
430558;201410;121;363;74;251;32;122;10;25;42;147
430560;201410;406;1023;238;704;34;125;86;239;120;364
430570;201410;1276;3327;878;2583;237;792;417;1124;654;1916
430580;201410;1230;3370;761;2464;248;841;202;673;450;1514
430583;201410;154;421;48;159;6;22;4;11;10;33
430585;201410;373;998;243;719;76;250;103;271;179;521
430587;201410;303;938;257;842;97;331;79;258;176;589
430590;201410;1559;4401;1476;4268;302;957;940;2701;1242;3658
430593;201410;37;142;33;129;10;49;11;35;21;84
430595;201410;270;771;108;388;36;148;18;53;54;201
430597;201410;417;1274;314;1021;61;216;127;394;188;610
430600;201410;2304;6328;1373;4244;295;968;470;1420;765;2388
430605;201410;1426;4437;1126;3789;284;1043;468;1605;752;2648
430607;201410;791;2092;630;1824;99;310;397;1159;496;1469
430610;201410;8727;23626;6764;20389;1765;5848;2775;8340;4540;14188
430613;201410;266;664;116;356;27;78;27;76;54;154
430620;201410;1019;3107;831;2677;249;886;332;1005;581;1891
430630;201410;518;1562;301;1004;93;321;57;172;150;493
430632;201410;777;2165;458;1440;93;339;231;673;324;1012
430635;201410;711;1974;505;1566;119;394;244;749;363;1143
430637;201410;563;1608;501;1480;87;299;322;912;409;1211
430640;201410;2074;5829;1065;3517;250;865;210;578;460;1443
430642;201410;521;1379;317;1002;64;215;130;403;194;618
430645;201410;200;589;111;384;27;100;27;90;54;190
430650;201410;2203;7222;1909;6596;432;1512;1045;3739;1477;5251
430655;201410;318;958;277;869;72;246;103;270;175;516
430660;201410;6396;18746;5077;16303;1526;5392;2099;6655;3625;12047
430670;201410;512;1506;464;1411;43;127;346;1089;389;1216
430673;201410;821;2001;450;1367;122;385;188;567;310;952
430675;201410;288;859;132;441;29;111;50;156;79;267
430676;201410;4880;14738;4348;13807;1350;4541;1734;5707;3084;10248
430680;201410;1280;3814;933;3040;204;760;354;1043;558;1803
430690;201410;4724;13673;3847;11920;1233;3968;1397;4424;2630;8392
430692;201410;313;1069;226;891;30;118;140;562;170;680
430693;201410;1858;5230;1346;4094;311;1043;390;1118;701;2161
430695;201410;500;1465;402;1277;77;294;206;620;283;914
430697;201410;498;1413;378;1202;118;366;149;511;267;877
430700;201410;9589;25152;4321;14417;927;3426;421;1348;1348;4774
430705;201410;422;1331;390;1275;126;441;166;549;292;990
430710;201410;1931;4997;1501;4260;309;955;738;2168;1047;3123
430720;201410;950;2366;626;1881;181;591;244;736;425;1327
430730;201410;1985;5333;1498;4534;361;1056;797;2554;1158;3610
430740;201410;643;1818;389;1275;119;417;72;216;191;633
430745;201410;551;1576;325;1021;69;229;95;305;164;534
430750;201410;1939;5501;1607;4922;385;1300;822;2421;1207;3721
430755;201410;681;1912;478;1467;101;367;216;594;317;961
430760;201410;3865;9939;2982;8716;746;2333;1518;4567;2264;6900
430770;201410;7436;22202;6138;19814;1416;4985;3146;10036;4562;15021
430780;201410;2777;7847;1843;5964;515;1820;680;2111;1195;3931
430781;201410;677;1999;482;1585;139;472;154;496;293;968
430783;201410;627;1591;451;1301;99;323;208;554;307;877
430786;201410;132;434;103;358;35;126;24;85;59;211
430790;201410;4432;12268;2926;9133;611;2222;1271;3643;1882;5865
430800;201410;864;2603;614;1999;144;494;214;664;358;1158
430805;201410;514;1454;371;1192;51;162;221;743;272;905
430807;201410;347;1038;244;797;58;223;80;237;138;460
430810;201410;775;2172;379;1280;73;276;74;222;147;498
430820;201410;1181;3766;859;2941;247;900;259;820;506;1720
430825;201410;476;1337;243;768;49;166;79;218;128;384
430830;201410;2740;8027;2529;7700;366;1111;1644;5311;2010;6422
430840;201410;1056;3264;953;3046;249;816;445;1475;694;2291
430843;201410;125;375;78;255;16;50;34;107;50;157
430845;201410;376;1143;302;984;122;424;41;130;163;554
430850;201410;3498;10648;3093;9902;837;2833;1401;4493;2238;7326
430860;201410;934;2550;554;1897;181;714;149;466;330;1180
430865;201410;759;2067;689;1947;223;659;330;924;553;1583
430870;201410;741;2097;438;1464;127;437;111;344;238;781
430880;201410;1478;4252;1162;3629;440;1425;342;1107;782;2532
430885;201410;224;670;167;575;52;193;59;196;111;389
430890;201410;1820;4826;1302;3841;82;289;722;2046;804;2335
430900;201410;3513;9308;3110;8660;739;2228;1679;4573;2418;6801
430905;201410;1200;3539;804;2649;247;886;209;661;456;1547
430910;201410;1948;6118;1527;5265;541;2003;560;1866;1101;3869
430912;201410;626;1748;479;1505;72;262;276;846;348;1108
430915;201410;487;1597;331;1266;105;429;97;388;202;817
430920;201410;18826;59159;17104;55875;5007;17251;9671;31366;14678;48617
430925;201410;95;271;72;226;24;87;34;99;58;186
430930;201410;10627;32411;8041;27165;2431;8701;2889;10125;5320;18826
430940;201410;1386;4327;967;3323;246;936;276;884;522;1820
430950;201410;1675;4712;1264;3851;393;1268;400;1170;793;2438
430955;201410;162;506;89;304;30;109;23;72;53;181
430957;201410;330;1114;266;973;68;264;122;454;190;718
430960;201410;1875;5381;1635;4957;601;1942;572;1754;1173;3696
430965;201410;1485;4376;1278;4009;98;365;1041;3245;1139;3610
430970;201410;565;1589;327;1064;76;272;94;293;170;565
430975;201410;667;2167;514;1790;84;315;281;975;365;1290
430980;201410;616;1468;350;1066;95;328;140;384;235;712
430990;201410;705;2274;534;1846;179;631;144;490;323;1121
430995;201410;759;2258;665;2068;227;741;250;767;477;1508
431000;201410;1851;4982;1011;3212;244;877;142;377;386;1254
431010;201410;3018;8829;2005;6743;526;1940;632;1984;1158;3924
431020;201410;15165;37753;10426;29102;2853;8187;3402;9753;6255;17940
431030;201410;402;1206;221;783;56;212;51;170;107;382
431033;201410;2917;8476;2653;8065;662;2088;1459;4625;2121;6713
431036;201410;248;667;114;389;18;63;26;76;44;139
431040;201410;1097;3130;884;2774;248;872;448;1359;696;2231
431041;201410;614;1698;547;1602;167;503;237;730;404;1233
431043;201410;437;1439;325;1174;154;606;103;334;257;940
431046;201410;133;396;99;322;26;97;33;101;59;198
431050;201410;1954;4939;1529;4210;360;1059;833;2265;1193;3324
431053;201410;662;2198;551;1946;179;683;174;625;353;1308
431055;201410;720;1993;667;1898;73;211;490;1402;563;1613
431057;201410;392;1159;229;804;53;189;93;327;146;516
431060;201410;6506;19206;6081;18640;1706;5075;3468;11129;5174;16204
431065;201410;528;1513;452;1370;51;167;297;895;348;1062
431070;201410;792;2312;469;1574;101;350;121;372;222;722
431075;201410;299;914;199;691;38;143;65;233;103;376
431080;201410;759;2480;621;2175;173;650;136;452;309;1102
431085;201410;991;2629;794;2284;138;426;483;1377;621;1803
431087;201410;648;1868;565;1703;82;239;365;1106;447;1345
431090;201410;592;1497;306;951;104;338;66;190;170;528
431100;201410;4904;13642;4085;12200;1207;3809;1667;5093;2874;8902
431110;201410;1695;4541;1267;3675;299;936;636;1780;935;2716
431112;201410;674;2120;639;2055;206;672;306;976;512;1648
431113;201410;693;2051;515;1648;152;499;144;464;296;963
431115;201410;1614;4750;1433;4428;294;952;858;2651;1152;3603
431120;201410;2974;9369;2487;8396;776;2859;1015;3324;1791;6183
431123;201410;596;1786;450;1498;114;413;233;783;347;1196
431125;201410;1453;4451;1096;3682;347;1151;373;1355;720;2506
431127;201410;182;467;63;201;8;23;7;15;15;38
431130;201410;4144;11953;3293;10433;893;3065;1379;4371;2272;7436
431140;201410;4290;10803;2314;7375;460;1684;564;1543;1024;3227
431142;201410;577;1736;517;1622;71;223;336;1075;407;1298
431150;201410;1384;4192;1115;3661;311;1068;411;1360;722;2428
431160;201410;1042;3091;869;2724;173;545;427;1442;600;1987
431162;201410;474;1273;227;770;33;139;37;102;70;241
431164;201410;161;450;45;166;16;63;1;4;17;67
431170;201410;1003;2911;773;2457;271;895;221;696;492;1591
431171;201410;931;2780;797;2503;288;950;211;637;499;1587
431173;201410;532;1569;475;1465;111;355;278;864;389;1219
431175;201410;1350;3766;1162;3478;392;1231;469;1404;861;2635
431177;201410;1110;3565;924;3178;322;1212;389;1317;711;2529
431179;201410;340;734;90;268;13;50;24;58;37;108
431180;201410;2297;6671;1659;5280;395;1361;441;1328;836;2689
431190;201410;830;2278;466;1536;118;426;131;422;249;848
431198;201410;401;1310;351;1206;165;602;79;265;244;867
431200;201410;342;968;107;355;24;86;10;29;34;115
431205;201410;375;1198;236;826;56;193;88;303;144;496
431210;201410;827;2308;712;2082;191;560;382;1127;573;1687
431213;201410;316;978;262;873;81;300;93;296;174;596
431215;201410;345;1021;172;586;34;115;17;45;51;160
431217;201410;249;751;193;621;62;216;49;168;111;384
431220;201410;1202;3130;838;2414;126;417;427;1169;553;1586
431225;201410;1426;4226;1233;3889;297;982;673;2147;970;3129
431230;201410;996;2936;776;2472;131;448;419;1318;550;1766
431235;201410;76;183;36;110;9;30;12;35;21;65
431237;201410;463;1507;406;1423;124;487;183;624;307;1111
431238;201410;55;175;45;150;10;36;15;49;25;85
431240;201410;2873;8720;2442;7973;882;3117;734;2337;1616;5454
431242;201410;437;1414;414;1369;173;622;63;197;236;819
431244;201410;511;1245;347;969;72;239;163;419;235;658
431245;201410;1220;3323;987;2907;183;573;609;1801;792;2374
431247;201410;244;764;193;662;79;292;69;224;148;516
431250;201410;1983;6206;1749;5866;545;1973;758;2591;1303;4564
431260;201410;428;1251;291;967;81;303;71;218;152;521
431261;201410;233;809;198;725;40;164;68;238;108;402
431262;201410;406;1113;165;552;26;108;71;234;97;342
431265;201410;1463;3931;826;2550;203;718;234;603;437;1321
431267;201410;209;625;175;560;46;167;82;244;128;411
431270;201410;2782;7430;2124;6400;585;1850;958;2973;1543;4823
431275;201410;255;805;151;544;45;161;30;94;75;255
431280;201410;282;799;115;392;23;92;24;63;47;155
431290;201410;382;1246;297;1026;85;341;74;243;159;584
431295;201410;231;740;139;472;25;93;39;115;64;208
431300;201410;321;890;91;347;27;105;5;21;32;126
431301;201410;258;841;169;602;49;174;31;96;80;270
431303;201410;806;2163;528;1581;123;435;181;498;304;933
431306;201410;2253;6260;1700;5238;326;1204;601;1667;927;2871
431308;201410;57;197;53;186;34;119;14;52;48;171
431310;201410;815;2491;513;1782;109;397;166;583;275;980
431320;201410;1016;2978;616;2143;176;685;154;506;330;1191
431330;201410;2545;6490;1245;3983;382;1341;191;577;573;1918
431333;201410;469;1247;215;647;41;135;71;176;112;311
431335;201410;98;292;83;256;20;59;31;92;51;151
431337;201410;2736;8440;2080;6984;574;2043;520;1661;1094;3704
431339;201410;742;2071;514;1568;110;348;243;737;353;1085
431340;201410;29100;78002;21047;63888;5339;17775;7190;21218;12529;38993
431342;201410;655;1710;552;1535;162;484;292;779;454;1263
431344;201410;411;1128;304;937;31;99;197;621;228;720
431346;201410;347;915;198;581;59;173;56;163;115;336
431349;201410;687;1996;466;1455;105;337;155;474;260;811
431350;201410;4225;12636;3657;11622;736;2694;2021;6199;2757;8893
431360;201410;863;2306;629;1914;166;531;249;770;415;1301
431365;201410;1516;4583;1309;4229;476;1655;526;1722;1002;3377
431370;201410;5770;16590;4749;14796;1417;4726;1797;5639;3214;10365
431380;201410;1107;3405;1036;3247;176;593;716;2210;892;2803
431390;201410;3852;10887;2600;8428;800;2941;772;2289;1572;5230
431395;201410;1711;5080;1494;4708;443;1486;610;1916;1053;3402
431400;201410;255;831;151;555;49;191;18;48;67;239
431402;201410;1386;3381;817;2344;179;535;393;1096;572;1631
431403;201410;332;994;246;833;79;291;55;184;134;475
431405;201410;4918;14042;3935;12552;955;3524;1871;5729;2826;9253
431406;201410;835;2627;652;2187;209;724;279;922;488;1646
431407;201410;699;2091;470;1584;140;485;113;355;253;840
431410;201410;17507;53822;13667;46055;4999;17950;3299;11541;8298;29491
431413;201410;212;520;103;318;12;42;43;122;55;164
431415;201410;972;2797;788;2443;202;680;353;1038;555;1718
431417;201410;716;1825;575;1612;95;275;323;931;418;1206
431420;201410;1654;4596;1453;4266;344;1047;796;2425;1140;3472
431430;201410;625;1711;448;1390;113;386;160;460;273;846
431440;201410;34315;99964;30129;93022;9891;31428;13312;43038;23203;74466
431442;201410;219;693;171;570;59;218;27;65;86;283
431445;201410;520;1435;326;1001;61;196;134;397;195;593
431446;201410;522;1537;384;1244;97;321;164;532;261;853
431447;201410;867;2486;611;1896;139;468;260;819;399;1287
431449;201410;966;2739;782;2414;122;416;437;1373;559;1789
431450;201410;2391;6249;2175;5916;473;1357;1429;3852;1902;5209
431455;201410;736;1888;416;1189;130;376;119;325;249;701
431460;201410;3786;10664;3251;9625;990;3014;1205;3671;2195;6685
431470;201410;1930;5709;1537;4837;423;1317;665;2190;1088;3507
431475;201410;193;574;54;212;10;43;4;15;14;58
431477;201410;756;2060;520;1586;83;279;299;882;382;1161
431478;201410;262;687;103;309;20;59;40;115;60;174
431480;201410;3060;8729;2375;7464;707;2450;916;2756;1623;5206
431490;201410;120819;338250;105566;314993;17876;60562;70547;206569;88423;267131
431500;201410;1230;3222;971;2731;267;739;389;1115;656;1854
431505;201410;471;1237;398;1127;49;132;300;874;349;1006
431507;201410;469;1153;370;967;71;181;229;606;300;787
431510;201410;2291;6324;1882;5585;400;1305;934;2666;1334;3971
431513;201410;286;785;126;406;29;100;59;190;88;290
431514;201410;115;299;43;147;7;29;3;9;10;38
431515;201410;803;2388;562;1776;118;420;230;641;348;1061
431517;201410;100;321;92;303;37;130;29;82;66;212
431520;201410;503;1512;318;1038;62;221;89;280;151;501
431530;201410;4862;11759;3711;10424;1145;3247;1766;5245;2911;8492
431531;201410;311;884;216;690;56;188;85;274;141;462
431532;201410;595;1678;519;1519;155;489;222;641;377;1130
431535;201410;459;1302;281;881;67;231;78;221;145;452
431540;201410;2294;7393;2044;7028;288;918;1359;5006;1647;5924
431545;201410;235;664;58;203;6;22;10;45;16;67
431550;201410;2612;7751;2363;7299;529;1850;1185;3605;1714;5455
431555;201410;835;2179;710;1980;161;442;396;1114;557;1556
431560;201410;26161;80328;21290;70294;8163;27442;6690;23126;14853;50568
431570;201410;5871;16614;5234;15601;1547;4706;2786;8409;4333;13115
431575;201410;495;1316;352;1064;72;251;108;292;180;543
431580;201410;850;2594;606;2027;175;655;193;583;368;1238
431590;201410;1039;2896;711;2210;103;335;334;1033;437;1368
431595;201410;657;1844;531;1564;135;415;204;603;339;1018
431600;201410;2434;7164;1779;5799;475;1774;379;1074;854;2848
431610;201410;1797;5078;1309;4173;301;1013;641;2048;942;3061
431620;201410;464;1418;263;865;77;272;111;332;188;604
431630;201410;1560;4192;1104;3259;301;909;503;1501;804;2410
431640;201410;6527;19239;5891;18216;1432;4890;3362;10238;4794;15128
431642;201410;579;1662;478;1466;82;294;249;725;331;1019
431643;201410;231;625;197;562;28;92;117;312;145;404
431645;201410;1893;5632;1700;5277;377;1235;972;3042;1349;4277
431647;201410;192;552;132;405;41;132;34;87;75;219
431650;201410;273;857;186;670;34;134;44;137;78;271
431660;201410;1613;4757;1168;3825;367;1260;415;1299;782;2559
431670;201410;1480;4094;1169;3519;317;1064;517;1483;834;2547
431673;201410;255;745;158;529;43;161;44;141;87;302
431675;201410;635;1776;233;793;59;210;61;179;120;389
431680;201410;11061;30750;8399;25959;2521;8362;2817;8773;5338;17135
431690;201410;27950;79678;22556;70991;6878;23147;9349;29942;16227;53089
431695;201410;162;556;118;440;29;109;30;82;59;191
431697;201410;533;1506;471;1390;134;400;211;644;345;1044
431700;201410;1727;4876;1465;4362;284;914;787;2295;1071;3209
431710;201410;13673;40068;11175;35706;3542;11935;4051;13277;7593;25212
431720;201410;7674;21652;6203;18801;1448;4922;3028;8970;4476;13892
431725;201410;35;123;33;119;13;48;12;43;25;91
431730;201410;4092;12506;3294;10970;975;3564;1060;3597;2035;7161
431740;201410;6299;18354;5405;16661;1971;6533;1479;4344;3450;10877
431750;201410;11003;31348;9407;28721;2049;6768;4920;15310;6969;22078
431755;201410;318;867;70;259;14;60;16;54;30;114
431760;201410;4383;13149;3605;11651;1010;3564;1200;3694;2210;7258
431770;201410;2449;6689;2061;6063;492;1517;1125;3284;1617;4801
431775;201410;252;700;183;568;76;250;43;116;119;366
431780;201410;2475;6639;1863;5483;533;1681;536;1502;1069;3183
431790;201410;1354;4240;1168;3877;279;980;625;2084;904;3064
431795;201410;503;1475;353;1106;70;233;141;452;211;685
431800;201410;10042;29727;8292;26373;2803;9619;2332;7241;5135;16860
431805;201410;318;771;88;302;12;47;16;53;28;100
431810;201410;3777;10451;3045;8949;662;2071;1423;4133;2085;6204
431820;201410;2998;9465;2611;8679;730;2600;1005;3265;1735;5865
431830;201410;12427;31636;9968;27873;3156;9476;3942;11175;7098;20651
431840;201410;3738;11127;3272;10247;983;3182;1488;4750;2471;7932
431842;201410;785;2003;398;1201;79;264;129;362;208;626
431843;201410;387;1127;339;1043;67;224;191;576;258;800
431844;201410;199;564;134;447;36;141;44;134;80;275
431845;201410;568;1701;504;1571;56;179;340;1076;396;1255
431846;201410;549;1623;471;1483;93;337;278;872;371;1209
431848;201410;202;555;109;368;23;92;23;73;46;165
431849;201410;426;1052;109;328;27;85;29;74;56;159
431850;201410;5307;15494;4629;14144;1167;3805;2075;6268;3242;10073
431860;201410;1015;2830;780;2405;161;572;417;1218;578;1790
431861;201410;102;314;63;222;14;47;7;20;21;67
431862;201410;516;1741;417;1517;147;578;106;370;253;948
431870;201410;27503;77933;22758;69332;6269;20867;9628;28530;15897;49397
431880;201410;5181;16210;4241;14059;1225;4436;1723;5543;2948;9979
431890;201410;6459;17931;5248;15763;1900;5978;1728;5318;3628;11296
431900;201410;1099;3228;793;2628;239;896;303;897;542;1793
431910;201410;1032;2465;491;1425;103;335;187;487;290;822
431912;201410;646;1863;500;1573;170;514;169;564;339;1078
431915;201410;1478;4024;1106;3346;282;922;442;1335;724;2257
431920;201410;1576;4407;1433;4204;195;523;1105;3341;1300;3864
431930;201410;1382;3813;1056;3285;169;494;629;2091;798;2585
431935;201410;125;451;110;420;46;198;31;96;77;294
431936;201410;494;1413;406;1221;73;212;227;748;300;960
431937;201410;359;964;213;655;57;192;42;114;99;306
431940;201410;2928;8004;1924;6012;526;1749;549;1678;1075;3427
431950;201410;2034;6450;1816;6051;502;1818;759;2423;1261;4241
431960;201410;3865;11429;3520;10756;1066;3420;1287;3962;2353;7382
431970;201410;524;1438;272;876;41;154;83;249;124;403
431971;201410;142;406;115;362;25;79;43;124;68;203
431973;201410;514;1768;454;1643;68;246;273;1038;341;1284
431975;201410;29;93;16;65;4;21;4;16;8;37
431980;201410;1645;4753;1416;4277;372;1246;544;1533;916;2779
431990;201410;9168;25389;7025;21847;1578;5613;2811;8260;4389;13873
432000;201410;11918;34683;9621;30598;3101;10328;3975;12656;7076;22984
432010;201410;2706;7938;2290;7144;562;1960;1063;3209;1625;5169
432020;201410;2514;6272;2031;5644;301;918;1384;3816;1685;4734
432023;201410;578;1675;399;1275;103;371;144;425;247;796
432026;201410;1397;4190;1045;3445;209;711;553;1825;762;2536
432030;201410;455;1345;365;1147;92;297;166;505;258;802
432032;201410;590;1545;394;1174;66;227;218;618;284;845
432035;201410;911;2875;813;2684;179;614;484;1591;663;2205
432040;201410;1049;2657;571;1864;151;549;138;359;289;908
432045;201410;263;808;175;634;47;179;66;245;113;424
432050;201410;831;2402;732;2211;143;459;423;1300;566;1759
432055;201410;879;2715;737;2409;161;591;436;1367;597;1958
432057;201410;485;1263;378;1063;52;165;237;624;289;789
432060;201410;488;1378;208;721;56;215;54;165;110;380
432065;201410;252;731;195;625;48;169;91;270;139;439
432067;201410;1111;3562;813;2875;221;811;389;1370;610;2181
432070;201410;2711;7342;1929;5772;581;1946;608;1731;1189;3677
432080;201410;4498;13120;3903;12033;1239;4011;1594;4857;2833;8868
432085;201410;312;960;250;844;67;264;117;377;184;641
432090;201410;1887;5787;1571;5098;596;2072;495;1450;1091;3522
432100;201410;1319;3909;726;2508;202;729;122;351;324;1080
432110;201410;3250;9768;2561;8276;835;2961;455;1368;1290;4329
432120;201410;5724;17241;4925;15749;1844;6294;1654;5265;3498;11559
432130;201410;2553;7199;2059;6550;663;2316;949;3014;1612;5330
432132;201410;495;1451;267;919;37;137;102;327;139;464
432135;201410;817;2479;775;2407;124;412;543;1678;667;2090
432140;201410;3024;8891;2451;7829;693;2277;969;3394;1662;5671
432143;201410;1490;4492;1279;4135;310;1030;707;2355;1017;3385
432145;201410;1229;3910;837;2966;266;1033;163;516;429;1549
432146;201410;289;912;210;717;73;262;51;168;124;430
432147;201410;850;2690;682;2318;201;696;274;953;475;1649
432149;201410;386;1149;242;801;67;234;94;302;161;536
432150;201410;4226;12185;3200;10234;1013;3555;1030;3150;2043;6705
432160;201410;5025;16233;4481;15293;1529;5488;1812;6422;3341;11910
432162;201410;383;954;99;323;25;88;26;72;51;160
432163;201410;407;1073;108;341;15;46;24;78;39;124
432166;201410;840;2515;686;2190;141;521;334;993;475;1514
432170;201410;951;3139;641;2431;151;606;134;482;285;1088
432180;201410;3056;8115;2137;6526;641;2101;646;1924;1287;4025
432183;201410;478;1530;398;1366;174;616;97;333;271;949
432185;201410;1019;2793;641;2067;137;497;275;868;412;1365
432190;201410;3824;10578;2765;8207;776;2402;865;2407;1641;4809
432195;201410;1400;3921;1214;3644;208;671;773;2307;981;2978
432200;201410;3530;10725;2842;9501;756;2725;1369;4686;2125;7411
432210;201410;503;1445;399;1273;109;409;189;554;298;963
432215;201410;941;2941;823;2738;150;471;512;1806;662;2277
432218;201410;336;923;256;769;47;150;116;320;163;470
432220;201410;4253;11314;3511;10130;445;1512;2314;6542;2759;8054
432225;201410;68;224;58;205;26;93;15;52;41;145
432230;201410;1255;3545;863;2684;260;900;321;883;581;1783
432232;201410;608;1805;478;1547;119;432;223;707;342;1139
432234;201410;565;1563;411;1202;104;311;174;487;278;798
432235;201410;79;247;48;173;15;67;8;28;23;95
432237;201410;522;1454;472;1373;35;138;368;1038;403;1176
432240;201410;16476;54170;14325;51226;3101;12264;8601;31454;11702;43718
432250;201410;5925;20486;5480;19585;2277;8790;1608;5778;3885;14568
432252;201410;517;1504;422;1326;134;444;187;598;321;1042
432253;201410;1402;4512;1006;3532;326;1181;305;1080;631;2261
432254;201410;739;2021;224;723;50;178;41;113;91;291
432255;201410;224;574;127;419;35;123;41;131;76;254
432260;201410;7842;19985;5443;15918;1346;4122;2354;7009;3700;11131
432270;201410;2944;8995;2538;8283;790;2631;1104;3695;1894;6326
432280;201410;1375;3983;770;2591;177;644;181;549;358;1193
432285;201410;189;605;70;240;24;89;12;32;36;121
432290;201410;627;1892;416;1401;103;374;155;504;258;878
432300;201410;25796;78576;23248;74129;5783;19618;12742;40575;18525;60193
432310;201410;900;2731;751;2470;158;595;416;1330;574;1925
432320;201410;303;831;177;569;50;161;57;188;107;349
432330;201410;307;816;114;386;16;54;13;37;29;91
432335;201410;219;638;94;329;26;99;13;38;39;137
432340;201410;344;889;168;521;39;129;57;171;96;300
432345;201410;791;2250;733;2157;161;561;405;1109;566;1670
432350;201410;509;1413;314;1031;82;287;84;255;166;542
432360;201410;161;493;40;145;13;55;13;42;26;97
432370;201410;508;1438;399;1218;43;127;250;787;293;914
432375;201410;920;2348;726;2026;124;359;434;1228;558;1587
432377;201410;150;490;46;156;8;34;16;45;24;79
432380;201410;946;3290;854;3110;331;1356;342;1177;673;2533
500020;201410;2150;6596;1588;5491;414;1658;570;1820;984;3478
500025;201410;1134;2822;728;2098;127;387;387;1086;514;1473
500060;201410;6725;19751;5390;17564;789;2607;3571;12083;4360;14690
500070;201410;4312;12740;3653;11595;896;3214;1690;5282;2586;8496
500080;201410;1820;5395;1369;4572;449;1637;459;1577;908;3214
500085;201410;2209;5930;1648;5057;216;741;1013;3000;1229;3741
500090;201410;2517;7304;1915;6206;428;1449;950;3161;1378;4610
500100;201410;2661;8085;2449;7734;772;2764;1140;3450;1912;6214
500110;201410;8457;24907;6940;22583;1153;4033;4026;13810;5179;17843
500124;201410;1999;6420;1700;5911;312;1062;1004;3773;1316;4835
500150;201410;1593;4106;1206;3462;296;972;554;1445;850;2417
500190;201410;5341;13916;4170;12453;909;2930;2368;7361;3277;10291
500200;201410;2814;7202;2051;6013;378;1269;1192;3392;1570;4661
500210;201410;5165;15329;4409;14162;1007;3421;2303;7553;3310;10974
500215;201410;1662;5130;1351;4513;271;1023;570;1813;841;2836
500220;201410;2936;9280;2398;8280;577;2137;930;3291;1507;5428
500230;201410;2813;7366;2165;6387;660;2095;895;2674;1555;4769
500240;201410;5197;16066;3806;13225;763;2865;1527;5624;2290;8489
500260;201410;2734;7309;2135;6322;411;1332;1034;2900;1445;4232
500270;201410;118496;308902;78141;239084;21969;72892;20710;63068;42679;135960
500280;201410;1475;4207;1254;3903;179;584;878;2803;1057;3387
500290;201410;4341;10814;2758;8242;795;2758;892;2399;1687;5157
500295;201410;2711;8283;1844;6146;441;1652;486;1411;927;3063
500310;201410;890;2382;761;2188;187;577;357;990;544;1567
500315;201410;3314;10406;2834;9689;558;1890;1802;6478;2360;8368
500320;201410;15134;50102;13038;46215;4236;15839;4971;18676;9207;34515
500325;201410;4394;11606;3321;9882;875;2851;1589;4618;2464;7469
500330;201410;6426;17608;4955;14844;1189;3852;2449;7249;3638;11101
500345;201410;2667;7600;2188;6806;522;1829;1145;3443;1667;5272
500348;201410;2634;7578;2345;7100;255;881;1741;5242;1996;6123
500350;201410;1275;3901;807;2827;147;558;248;878;395;1436
500370;201410;24671;76921;19249;66297;5044;19281;6669;23027;11713;42308
500375;201410;2907;7940;2108;6446;538;1782;870;2715;1408;4497
500380;201410;3111;8963;2615;8052;923;2970;880;2691;1803;5661
500390;201410;629;1361;412;1055;49;157;291;699;340;856
500400;201410;1440;4481;1104;3664;296;1091;342;1043;638;2134
500410;201410;2291;6439;1826;5746;472;1651;856;2669;1328;4320
500430;201410;2905;8418;2313;7562;552;1970;1053;3551;1605;5521
500440;201410;1511;4255;1180;3710;270;943;606;1862;876;2805
500450;201410;2250;7003;1762;6004;463;1765;376;1147;839;2912
500460;201410;3927;11692;3045;10213;936;3488;840;2781;1776;6269
500470;201410;2997;8936;2111;6974;606;2156;347;1053;953;3209
500480;201410;2053;6585;1903;6362;193;634;1526;5254;1719;5888
500490;201410;1138;3217;932;2854;299;1011;314;971;613;1982
500500;201410;3759;11694;3000;10511;1148;4521;949;3275;2097;7796
500510;201410;955;2524;616;1931;127;460;263;739;390;1199
500515;201410;2018;5330;1605;4778;279;785;986;3206;1265;3991
500520;201410;2976;10225;2663;9793;529;2084;1695;6412;2224;8496
500525;201410;1241;3982;1015;3535;229;844;506;1862;735;2706
500540;201410;5914;16840;3592;12233;1140;4444;679;2101;1819;6545
500560;201410;5047;16491;4522;15708;866;3196;3074;10799;3940;13995
500568;201410;4132;10686;3034;9073;714;2288;1535;4576;2249;6864
500570;201410;8288;22746;5736;18086;1782;6050;1886;5871;3668;11921
500580;201410;3657;10614;2923;9322;402;1408;1976;6302;2378;7710
500600;201410;3574;9867;2553;8020;651;2219;1041;3253;1692;5472
500620;201410;8381;23459;6090;19443;1316;4690;2999;9614;4315;14304
500625;201410;755;2291;467;1642;104;399;158;535;262;934
500627;201410;459;1329;345;1106;75;247;104;355;179;602
500630;201410;6451;18031;5102;15977;1668;5718;1700;5286;3368;11004
500635;201410;2616;10068;2180;9352;343;1364;1364;6424;1707;7788
500640;201410;1701;4169;1340;3657;131;400;987;2667;1118;3067
500660;201410;18473;54016;14714;47574;4121;15023;5962;19006;10083;34029
500690;201410;3092;8812;2508;8073;899;2949;972;3393;1871;6342
500710;201410;3987;11973;3441;11050;857;3004;1717;5490;2574;8494
500720;201410;6134;16692;4029;12876;1232;4293;1163;3611;2395;7904
500730;201410;1039;2971;788;2469;182;626;323;979;505;1605
500740;201410;3879;10941;2826;9013;587;2143;1338;4087;1925;6230
500750;201410;875;2558;799;2459;174;562;504;1593;678;2155
500755;201410;1299;3836;954;3146;238;881;340;1022;578;1903
500769;201410;5025;13607;3204;9836;701;2375;889;2386;1590;4761
500770;201410;1852;5491;1393;4600;420;1518;472;1563;892;3081
500780;201410;1142;3547;973;3213;297;1082;404;1268;701;2350
500790;201410;9225;26029;7706;23329;1491;5291;4247;12277;5738;17568
500793;201410;2402;6966;1907;6140;371;1342;916;2814;1287;4156
500795;201410;2569;7524;2220;7027;302;835;1632;5494;1934;6329
500797;201410;1023;2747;738;2265;148;479;336;1037;484;1516
500800;201410;2796;7880;2206;7039;855;3083;735;2360;1590;5443
500830;201410;17741;51297;12923;41545;3716;12909;4064;12619;7780;25528
500840;201410;1495;4258;1080;3432;200;679;503;1567;703;2246
510010;201410;1381;4221;1205;3925;384;1287;548;1830;932;3117
510020;201410;3254;9464;2206;7337;598;2129;655;2084;1253;4213
510025;201410;9543;28601;8187;26235;2370;8380;3571;11101;5941;19481
510030;201410;2194;5966;1823;5383;549;1710;807;2338;1356;4048
510035;201410;926;2746;771;2504;150;494;454;1534;604;2028
510040;201410;1815;5074;1428;4494;318;1124;735;2309;1053;3433
510050;201410;1900;5603;1395;4644;376;1368;522;1696;898;3064
510060;201410;1391;4052;1037;3380;259;910;378;1198;637;2108
510080;201410;1166;3642;936;3213;303;1158;252;789;555;1947
510100;201410;685;1839;470;1409;81;264;197;552;278;816
510120;201410;308;639;175;465;20;56;111;293;131;349
510125;201410;3249;8617;2550;7406;506;1793;1217;3322;1723;5115
510130;201410;2190;6043;1850;5494;537;1669;785;2371;1322;4040
510140;201410;3065;9883;2465;8919;1006;3999;626;2104;1632;6103
510160;201410;1364;4587;1266;4460;121;486;1014;3567;1135;4053
510170;201410;6195;19035;5202;17215;1171;4292;2562;8226;3733;12518
510180;201410;12138;32765;8810;27318;2672;8710;3159;10694;5831;19404
510185;201410;1517;4435;1261;4096;213;661;833;2969;1046;3630
510190;201410;2069;6478;1480;5505;404;1655;588;2269;992;3924
510250;201410;14657;45667;12608;42703;3767;13631;6043;20973;9810;34604
510260;201410;2599;10072;2322;9456;739;3189;971;4223;1710;7412
510263;201410;4607;12743;3413;10743;983;3354;1142;3466;2125;6820
510267;201410;5548;16084;4005;12749;970;3347;1329;4052;2299;7399
510268;201410;919;2712;788;2524;208;710;409;1317;617;2027
510269;201410;973;2988;774;2620;236;845;326;1123;562;1968
510270;201410;2633;8270;2353;7768;423;1474;1335;4519;1758;5993
510279;201410;2122;6733;1896;6314;629;2303;685;2109;1314;4412
510285;201410;1419;4255;1121;3706;297;1080;421;1315;718;2395
510300;201410;3404;10269;2947;9618;347;1246;2245;7379;2592;8625
510305;201410;1665;5279;1350;4662;409;1517;399;1361;808;2878
510310;201410;1121;3261;892;2881;309;1081;303;954;612;2035
510320;201410;3785;11150;2894;9386;877;3263;615;1782;1492;5045
510325;201410;5544;17732;4781;16651;916;3282;3366;11995;4282;15277
510330;201410;2892;9459;2462;8652;651;2535;972;3407;1623;5942
510335;201410;4754;14788;4062;13865;718;2410;2798;10034;3516;12444
510336;201410;628;1933;502;1677;125;457;236;771;361;1228
510337;201410;2316;7655;1969;6975;803;2867;573;2217;1376;5084
510340;201410;67744;197224;53194;174242;20786;74175;12186;41683;32972;115858
510343;201410;1174;3498;1046;3326;135;426;822;2677;957;3103
510345;201410;1717;5124;1422;4577;361;1264;522;1582;883;2846
510350;201410;3650;10406;2924;9392;782;2692;1434;4724;2216;7416
510360;201410;1988;5145;1402;4411;253;878;932;2867;1185;3745
510370;201410;1011;3596;907;3429;220;866;534;2063;754;2929
510380;201410;519;1641;381;1364;152;601;68;226;220;827
510385;201410;1027;3794;789;3203;154;649;371;1611;525;2260
510390;201410;1222;3733;1128;3625;297;833;690;2434;987;3267
510395;201410;921;2296;677;1975;124;379;375;1169;499;1548
510410;201410;4390;14389;4064;13749;1101;3969;2139;7319;3240;11288
510420;201410;2402;6298;1799;5266;265;925;975;2820;1240;3745
510450;201410;599;1654;443;1421;116;427;182;554;298;981
510452;201410;656;2165;473;1723;120;478;185;648;305;1126
510454;201410;912;2912;791;2718;155;552;497;1772;652;2324
510455;201410;1005;3089;754;2581;190;753;259;848;449;1601
510460;201410;2240;6262;1875;5739;300;1076;1227;3650;1527;4726
510480;201410;4515;12194;3287;9883;903;2865;889;2527;1792;5392
510490;201410;1509;4952;1351;4712;296;1195;813;2754;1109;3949
510500;201410;1511;4584;1072;3713;285;1142;464;1540;749;2682
510510;201410;3197;11294;2822;10647;1042;4211;1104;4154;2146;8365
510515;201410;6048;18803;4699;15770;1150;4297;1292;4102;2442;8399
510517;201410;1917;5704;1651;5285;519;1689;801;2671;1320;4360
510520;201410;2312;5810;1741;5013;132;448;1232;3595;1364;4043
510523;201410;1118;3384;955;3106;191;660;582;1911;773;2571
510525;201410;8233;21473;5499;17117;1359;4560;2108;6497;3467;11057
510530;201410;586;1656;501;1530;91;340;282;840;373;1180
510550;201410;2859;9386;2405;8569;711;2636;1004;3646;1715;6282
510558;201410;2298;6503;1801;5779;487;1697;851;2743;1338;4440
510560;201410;1753;5666;1234;4730;401;1653;335;1313;736;2966
510562;201410;5441;16505;4648;14935;1556;5493;1565;5062;3121;10555
510590;201410;3206;8625;2575;7806;691;2154;1299;4077;1990;6231
510600;201410;1507;3915;991;3050;191;656;430;1211;621;1867
510610;201410;2932;8588;2561;8076;243;881;2022;6375;2265;7256
510615;201410;2230;6968;1896;6428;574;2092;889;3048;1463;5140
510617;201410;668;1987;560;1797;72;231;420;1396;492;1627
510618;201410;1458;4246;1036;3419;242;932;470;1485;712;2417
510619;201410;805;2216;513;1664;98;358;131;394;229;752
510620;201410;1424;3641;826;2715;258;985;193;580;451;1565
510621;201410;1050;3686;928;3426;280;1123;320;1123;600;2246
510622;201410;3840;11852;2628;9113;767;2884;417;1225;1184;4109
510623;201410;3904;11267;3204;10060;978;3257;1350;4207;2328;7464
510624;201410;1385;4233;1027;3532;246;946;375;1189;621;2135
510625;201410;2322;6851;1868;6034;569;2016;479;1474;1048;3490
510626;201410;1405;4279;1084;3786;347;1340;504;1779;851;3119
510627;201410;803;2342;557;1839;163;595;169;555;332;1150
510628;201410;1672;4224;1240;3637;143;462;898;2620;1041;3082
510629;201410;1818;5919;1507;5221;459;1761;517;1716;976;3477
510630;201410;2595;8757;2087;7754;645;2694;529;1974;1174;4668
510631;201410;408;1181;367;1116;64;193;253;775;317;968
510637;201410;2912;8623;2559;8021;713;2431;1299;3991;2012;6422
510642;201410;4979;16240;4251;15248;1280;4902;2071;7740;3351;12642
510645;201410;937;2180;633;1771;202;579;229;682;431;1261
510650;201410;6167;20915;5689;20324;1229;4560;3691;13788;4920;18348
510665;201410;1341;3677;915;2887;281;942;289;870;570;1812
510670;201410;401;927;220;665;41;150;92;261;133;411
510675;201410;6967;22311;5657;19702;1869;7284;1459;4833;3328;12117
510677;201410;2589;6573;1917;5698;295;884;1355;4200;1650;5084
510680;201410;848;2622;697;2337;162;600;271;842;433;1442
510682;201410;2491;7762;1964;6773;548;2070;591;1983;1139;4053
510685;201410;1007;2700;855;2499;104;341;616;1786;720;2127
510700;201410;4174;11378;3054;9654;671;2274;1729;5561;2400;7835
510704;201410;9205;25411;7549;22658;1819;6117;3922;11478;5741;17595
510706;201410;1979;6075;1483;5270;408;1494;731;2654;1139;4148
510710;201410;3682;10408;2751;8520;798;2656;824;2298;1622;4954
510715;201410;694;1786;451;1370;117;388;184;518;301;906
510718;201410;1996;5605;1601;5139;661;2177;614;2069;1275;4246
510719;201410;468;1073;285;831;39;155;126;331;165;486
510720;201410;1329;3126;992;2732;103;272;764;2161;867;2433
510724;201410;857;2631;724;2378;172;630;375;1176;547;1806
510726;201410;686;1868;557;1653;150;459;207;584;357;1043
510729;201410;803;2108;561;1710;142;476;250;765;392;1241
510730;201410;2492;7753;2163;7140;568;2116;1032;3247;1600;5363
510735;201410;1126;3815;919;3470;246;994;466;1766;712;2760
510740;201410;1163;2880;867;2461;223;628;473;1394;696;2022
510757;201410;718;2457;632;2289;177;668;315;1140;492;1808
510760;201410;30528;84842;23248;72202;7838;26097;7707;23889;15545;49986
510770;201410;4668;12438;4174;11861;641;1764;2730;8702;3371;10466
510774;201410;454;1243;381;1124;87;304;184;548;271;852
510775;201410;856;2419;681;2147;245;835;247;767;492;1602
510776;201410;467;1331;389;1195;105;364;184;542;289;906
510777;201410;1646;4887;1231;4324;190;747;902;3179;1092;3926
510779;201410;709;2073;523;1729;101;358;225;760;326;1118
510780;201410;4100;12089;3471;11158;838;2784;1799;6048;2637;8832
510785;201410;1996;5892;1590;5196;534;1830;565;1874;1099;3704
510787;201410;2336;7120;1958;6477;710;2526;638;2021;1348;4547
510788;201410;484;1306;374;1140;158;473;114;387;272;860
510790;201410;16270;47707;10937;37353;3144;12203;1473;4872;4617;17075
510792;201410;6725;20962;4791;17035;1175;4802;1132;3710;2307;8512
510794;201410;1406;4350;1112;3874;480;1803;277;875;757;2678
510795;201410;10089;31868;7721;27102;2520;9564;2077;7367;4597;16931
510800;201410;1901;5418;1584;4994;464;1615;769;2304;1233;3919
510805;201410;2074;5792;1682;5229;190;613;1272;3998;1462;4611
510810;201410;721;1766;563;1550;160;468;280;741;440;1209
510820;201410;867;2121;625;1761;147;490;260;668;407;1158
510830;201410;603;2037;525;1906;158;611;269;1041;427;1652
510835;201410;747;2261;536;1837;170;632;180;562;350;1194
510840;201410;53927;135470;43140;121694;10558;31230;22913;66904;33471;98134
510850;201410;1733;5072;1354;4451;526;1943;262;710;788;2653
510860;201410;2658;8749;2048;7396;711;2813;316;1063;1027;3876
510880;201410;851;2845;739;2642;247;938;310;1134;557;2072
510885;201410;587;1677;457;1487;83;314;214;688;297;1002
510890;201410;954;3124;805;2856;279;1126;253;797;532;1923
510895;201410;1193;3772;1026;3448;303;1168;420;1326;723;2494
520005;201410;1346;4350;1237;4172;389;1376;586;2010;975;3386
520010;201410;1942;6711;1715;6239;720;2916;384;1263;1104;4179
520013;201410;4074;11374;3069;9549;787;2583;1301;4082;2088;6665
520015;201410;580;1609;466;1439;121;396;192;612;313;1008
520017;201410;1128;3479;970;3215;261;962;425;1353;686;2315
520020;201410;430;1166;335;1013;85;265;161;505;246;770
520025;201410;25463;81247;24628;80259;2861;9746;20329;66631;23190;76377
520030;201410;4906;15717;4290;14711;1241;4567;1931;6707;3172;11274
520050;201410;372;1078;329;1000;62;207;216;644;278;851
520055;201410;872;2590;725;2309;148;469;379;1251;527;1720
520060;201410;1723;5299;1501;4870;366;1313;621;2036;987;3349
520080;201410;1710;5233;1484;4899;366;1186;815;2836;1181;4022
520082;201410;697;2244;650;2164;141;447;403;1378;544;1825
520085;201410;1049;3294;920;3012;237;820;329;1072;566;1892
520090;201410;1051;2488;795;2147;177;424;430;1249;607;1673
520110;201410;43526;129416;34028;115029;13450;50321;8751;29764;22201;80085
520120;201410;262;684;153;488;39;141;35;116;74;257
520130;201410;3918;11442;3612;10987;758;2454;2242;6828;3000;9282
520140;201410;45244;149590;40052;139384;14741;55474;10795;37219;25536;92693
520145;201410;556;1435;405;1209;100;323;158;468;258;791
520150;201410;679;1832;561;1692;154;499;300;901;454;1400
520160;201410;920;2698;780;2486;254;851;304;981;558;1832
520170;201410;4392;10474;3515;9516;525;1497;2611;7232;3136;8729
520180;201410;1959;5884;1633;5347;416;1556;691;2201;1107;3757
520215;201410;1934;5003;1636;4570;260;752;1037;2944;1297;3696
520235;201410;861;2309;666;2022;193;642;299;876;492;1518
520250;201410;1296;4085;1092;3747;333;1225;516;1798;849;3023
520260;201410;792;2063;557;1623;92;299;262;737;354;1036
520280;201410;586;1718;539;1650;269;873;141;477;410;1350
520310;201410;1137;2813;875;2446;208;560;447;1381;655;1941
520320;201410;1759;5600;1433;4951;179;665;917;3243;1096;3908
520330;201410;2924;9155;2253;7960;737;2865;475;1574;1212;4439
520340;201410;1981;5016;1555;4507;211;534;1182;3592;1393;4126
520350;201410;3330;9817;2820;8834;892;3053;1316;3979;2208;7032
520355;201410;1235;4183;1145;4041;414;1558;487;1696;901;3254
520357;201410;909;2491;762;2270;83;274;530;1562;613;1836
520360;201410;653;1855;580;1729;129;389;292;899;421;1288
520380;201410;1287;3524;895;2776;181;619;423;1311;604;1930
520390;201410;1268;3360;881;2814;298;1100;329;952;627;2052
520393;201410;597;1562;523;1448;86;249;348;963;434;1212
520396;201410;772;2452;665;2240;97;363;457;1562;554;1925
520400;201410;1843;5187;1580;4836;289;957;1013;3108;1302;4065
520410;201410;1667;4376;1288;3868;348;1131;676;2020;1024;3151
520420;201410;350;979;249;779;55;186;77;212;132;398
520425;201410;1512;4203;1374;3963;426;1315;674;1907;1100;3222
520430;201410;2184;5793;1484;4497;334;1133;582;1668;916;2801
520440;201410;3716;9853;2671;8086;944;3124;761;2281;1705;5405
520450;201410;10383;29625;7550;24236;2092;7400;1273;3766;3365;11166
520455;201410;721;2144;583;1914;215;767;178;582;393;1349
520460;201410;937;2689;747;2364;178;635;344;1049;522;1684
520465;201410;863;2371;751;2225;162;560;415;1185;577;1745
520470;201410;1857;6019;1683;5751;369;1255;1098;3924;1467;5179
520480;201410;1032;3007;844;2709;196;662;466;1499;662;2161
520485;201410;1331;4323;1168;4026;382;1405;593;2049;975;3454
520490;201410;4524;13946;3589;12496;1228;4562;1472;5232;2700;9794
520495;201410;1452;3870;1177;3533;99;313;996;3022;1095;3335
520500;201410;2084;5566;1845;5242;591;1763;834;2536;1425;4299
520505;201410;912;2599;791;2419;192;611;482;1503;674;2114
520510;201410;11568;32744;7898;26534;2515;9159;2137;7270;4652;16429
520520;201410;1110;3215;917;2931;325;1090;371;1205;696;2295
520530;201410;2405;7501;2057;6926;511;1681;1012;3776;1523;5457
520540;201410;3110;9430;2634;8608;852;2924;969;3187;1821;6111
520545;201410;1373;4249;1174;3856;352;1256;369;1177;721;2433
520547;201410;856;2703;707;2447;282;1039;208;675;490;1714
520549;201410;9954;29323;8278;27223;2633;9099;3980;13314;6613;22413
520551;201410;3950;11884;3750;11637;1046;3455;2199;6990;3245;10445
520552;201410;771;2493;738;2449;121;449;513;1688;634;2137
520570;201410;598;1732;454;1505;200;708;118;390;318;1098
520580;201410;2732;7416;2021;6377;736;2543;680;2112;1416;4655
520590;201410;1571;4438;1268;3933;335;1079;422;1255;757;2334
520620;201410;7314;23398;6609;22340;1422;5164;4068;13881;5490;19045
520630;201410;766;2095;612;1870;148;466;297;917;445;1383
520640;201410;2942;8499;2518;7801;812;2633;1046;3333;1858;5966
520650;201410;940;2613;754;2248;241;770;337;1005;578;1775
520660;201410;416;1264;353;1164;121;422;111;361;232;783
520670;201410;851;2624;797;2540;62;163;688;2240;750;2403
520680;201410;666;1938;560;1797;175;595;249;805;424;1400
520690;201410;386;984;264;804;52;138;129;425;181;563
520710;201410;513;1322;332;973;11;36;202;584;213;620
520725;201410;1870;4853;1451;4233;342;1092;802;2325;1144;3417
520735;201410;793;2311;603;1947;186;661;198;626;384;1287
520740;201410;1765;5117;1482;4726;390;1334;719;2265;1109;3599
520750;201410;763;2002;571;1736;145;473;309;969;454;1442
520753;201410;1335;3840;1250;3709;171;460;927;2899;1098;3359
520760;201410;1196;3302;1033;3091;274;858;616;1874;890;2732
520780;201410;2131;5226;1769;4741;226;552;1331;3656;1557;4208
520790;201410;2818;7650;2390;7044;368;1056;1676;5140;2044;6196
520800;201410;18297;53416;16175;50864;3746;11466;9787;33288;13533;44754
520810;201410;987;2682;877;2546;146;422;651;1966;797;2388
520815;201410;525;1722;395;1452;187;787;30;83;217;870
520830;201410;1746;4460;1367;4063;55;125;1239;3782;1294;3907
520840;201410;1854;6114;1608;5636;538;2007;542;1945;1080;3952
520850;201410;840;2473;650;2190;198;712;281;926;479;1638
520860;201410;7432;21013;5478;18311;1616;5859;2379;8156;3995;14015
520870;201410;112526;307823;76461;243832;22904;80192;20548;63176;43452;143368
520880;201410;7140;20283;5060;16975;1534;5776;811;2597;2345;8373
520890;201410;4143;11889;3491;10789;759;2487;1815;5635;2574;8122
520910;201410;3637;11042;2756;9207;884;3193;609;1970;1493;5163
520915;201410;947;2731;715;2286;165;568;301;939;466;1507
520920;201410;3542;9398;2436;7619;641;2150;757;2460;1398;4610
520929;201410;479;1375;421;1304;131;409;220;699;351;1108
520940;201410;1071;3154;929;2942;113;401;672;2108;785;2509
520945;201410;712;1752;587;1556;178;440;285;775;463;1215
520960;201410;917;2673;744;2395;142;467;421;1388;563;1855
520970;201410;3522;10447;2890;9294;716;2513;1111;3514;1827;6027
520980;201410;1020;2799;922;2661;272;884;520;1440;792;2324
520990;201410;3745;11606;3406;10999;719;2447;1842;6491;2561;8938
520993;201410;1218;3314;977;2918;129;428;632;1877;761;2305
520995;201410;2693;7401;2415;7033;370;1094;1739;5122;2109;6216
521000;201410;8257;24812;6967;22622;1807;6498;3142;10077;4949;16575
521010;201410;4093;12624;3425;11340;959;3380;1343;4514;2302;7894
521015;201410;732;2040;614;1852;140;412;349;1091;489;1503
521020;201410;3887;11089;2741;8718;859;2968;504;1388;1363;4356
521030;201410;827;2178;696;1979;167;500;376;1073;543;1573
521040;201410;5988;17109;5366;16166;1874;5688;2611;8324;4485;14012
521056;201410;1014;3094;849;2824;296;1029;354;1231;650;2260
521060;201410;1147;3226;997;2983;275;776;431;1341;706;2117
521080;201410;1280;3143;816;2374;175;608;313;761;488;1369
521090;201410;3369;9831;2829;9094;982;3328;1114;3701;2096;7029
521100;201410;1519;3915;1358;3731;256;690;940;2676;1196;3366
521120;201410;5049;14311;4440;13384;1208;3691;2286;7090;3494;10781
521130;201410;1188;3341;933;2861;191;691;490;1478;681;2169
521140;201410;1018;3304;884;3015;308;1118;240;810;548;1928
521150;201410;13460;35193;8603;25646;3087;9885;2370;6949;5457;16834
521160;201410;878;2141;543;1523;106;331;263;698;369;1029
521170;201410;1427;3439;1169;3087;315;783;672;1812;987;2595
521180;201410;6732;22517;6087;21308;2272;8463;1876;6550;4148;15013
521190;201410;9655;28405;6888;23406;2254;8178;2032;6881;4286;15059
521200;201410;886;2336;796;2208;123;366;527;1454;650;1820
521205;201410;579;1726;462;1513;59;219;270;888;329;1107
521210;201410;928;2662;662;2130;248;910;236;669;484;1579
521220;201410;4018;11249;3301;10266;1083;3593;1375;4266;2458;7859
521225;201410;416;1040;326;928;49;146;213;632;262;778
521230;201410;1393;4403;1282;4167;453;1557;607;1925;1060;3482
521250;201410;28403;92802;26189;89379;10343;37495;9927;34653;20270;72148
521260;201410;825;2013;656;1718;114;373;381;933;495;1306
521270;201410;1885;5845;1724;5593;175;453;1326;4540;1501;4993
521280;201410;1917;5933;1609;5355;503;1810;601;1975;1104;3785
521290;201410;540;1552;395;1312;122;473;143;453;265;926
521295;201410;1178;3210;1061;3055;141;403;861;2511;1002;2914
521300;201410;1887;5534;1740;5306;375;1123;1092;3446;1467;4569
521305;201410;866;2346;718;2140;145;400;454;1433;599;1833
521308;201410;5339;15725;4118;13519;956;3344;2002;6544;2958;9888
521310;201410;8002;24200;6205;20722;2030;7190;1577;5048;3607;12238
521340;201410;273;821;248;784;43;156;157;480;200;636
521350;201410;2254;5839;1850;5288;255;729;1238;3772;1493;4501
521370;201410;1037;3325;920;3102;325;1179;311;1001;636;2180
521375;201410;1425;4165;1216;3792;324;1105;602;1809;926;2914
521377;201410;1114;3068;1062;3006;108;256;899;2638;1007;2894
521380;201410;4781;13528;3447;11009;742;2566;702;2300;1444;4866
521385;201410;622;1733;550;1636;167;523;268;791;435;1314
521390;201410;1124;2944;830;2531;245;851;290;853;535;1704
521400;201410;2458;6646;2093;6216;336;1105;1556;4594;1892;5699
521405;201410;1436;4127;1158;3622;395;1355;492;1531;887;2886
521410;201410;835;2608;761;2483;287;917;318;1100;605;2017
521440;201410;1545;4266;1499;4209;126;325;1307;3764;1433;4089
521450;201410;5198;15835;4335;14249;1342;4711;1309;4227;2651;8938
521460;201410;7535;22952;6802;21773;1774;6151;3576;11316;5350;17467
521470;201410;763;2156;568;1778;159;561;108;318;267;879
521480;201410;522;1521;386;1273;117;395;126;410;243;805
521483;201410;3200;8485;2581;7416;768;2357;991;2742;1759;5099
521486;201410;1786;4816;1577;4477;269;836;1126;3161;1395;3997
521487;201410;637;1647;451;1354;88;249;211;678;299;927
521490;201410;870;2483;685;2211;83;323;493;1592;576;1915
521500;201410;1430;4511;1145;3912;234;910;495;1545;729;2455
521520;201410;933;2197;760;1955;235;556;340;953;575;1509
521523;201410;11664;43502;10863;42062;4038;16800;2084;8773;6122;25573
521525;201410;1146;2985;1000;2787;143;453;690;1867;833;2320
521530;201410;2124;6335;1438;4925;519;1876;291;945;810;2821
521540;201410;999;2727;687;2176;181;681;217;635;398;1316
521550;201410;1012;2601;892;2414;252;739;461;1197;713;1936
521560;201410;5042;15484;4041;14124;1596;6040;1283;4466;2879;10506
521565;201410;709;1846;604;1714;105;278;417;1224;522;1502
521570;201410;4896;13733;3456;10865;1094;3600;1137;3624;2231;7224
521580;201410;696;1656;486;1366;170;517;160;450;330;967
521590;201410;766;2159;625;1927;226;724;133;433;359;1157
521600;201410;640;1671;459;1365;123;392;156;417;279;809
521630;201410;1870;4919;1484;4347;541;1819;276;660;817;2479
521640;201410;2134;5783;1762;5245;593;1985;639;1922;1232;3907
521645;201410;677;2028;550;1737;100;345;273;807;373;1152
521680;201410;1503;4786;1264;4283;673;2426;214;682;887;3108
521690;201410;601;1772;539;1655;129;461;265;757;394;1218
521710;201410;2395;7488;2062;6797;464;1617;1021;3364;1485;4981
521720;201410;2240;6439;1979;6077;493;1516;1229;3841;1722;5357
521730;201410;4067;13487;3676;12718;1552;5901;1025;3275;2577;9176
521740;201410;3875;10569;3051;9507;1239;4011;1283;4205;2522;8216
521760;201410;12693;43108;11691;41438;2524;9889;6813;24332;9337;34221
521770;201410;2889;8691;2432;7792;1014;3447;714;2194;1728;5641
521800;201410;9177;26761;7683;24450;2566;8658;3188;10480;5754;19138
521805;201410;1005;2316;780;1981;214;480;428;1209;642;1689
521810;201410;843;2428;717;2232;172;589;376;1148;548;1737
521830;201410;5533;18547;5146;17949;1110;4159;3276;11450;4386;15609
521839;201410;735;2102;571;1785;132;473;212;625;344;1098
521850;201410;6434;17854;5276;15781;1121;3372;2513;7476;3634;10848
521860;201410;1948;5746;1640;5163;419;1447;615;1866;1034;3313
521870;201410;566;1981;517;1850;170;664;147;489;317;1153
521878;201410;718;2201;538;1807;153;588;219;686;372;1274
521880;201410;26877;70930;18254;56604;6070;19977;5659;17847;11729;37824
521890;201410;3842;11839;3137;10418;1198;4282;783;2562;1981;6844
521900;201410;1707;4560;1373;4104;367;1172;555;1572;922;2744
521910;201410;1261;3489;1093;3293;265;830;622;1959;887;2789
521920;201410;410;1247;363;1166;122;427;142;425;264;852
521925;201410;682;2081;595;1911;126;449;253;749;379;1198
521930;201410;4068;13142;3647;12323;1247;4501;1100;3705;2347;8206
521935;201410;696;2059;642;1957;185;583;331;985;516;1568
521940;201410;1159;3153;946;2793;313;959;359;1061;672;2020
521945;201410;711;2379;658;2310;129;417;459;1726;588;2143
521950;201410;610;1782;492;1586;129;454;227;737;356;1191
521960;201410;935;2736;786;2484;192;660;362;1109;554;1769
521970;201410;2526;7240;2281;6917;350;1063;1657;5163;2007;6226
521971;201410;1107;2984;827;2455;182;582;296;844;478;1426
521973;201410;936;3057;814;2802;250;909;263;880;513;1789
521975;201410;14616;40774;13705;39652;2428;7430;9511;27697;11939;35127
521980;201410;1964;5891;1801;5695;295;839;1372;4567;1667;5406
521990;201410;1147;3452;1002;3227;154;549;648;2087;802;2636
522000;201410;2206;6474;1925;6103;401;1339;1151;3777;1552;5116
522005;201410;407;1032;299;868;82;239;140;414;222;653
522010;201410;3050;8989;2540;8118;947;3153;600;1910;1547;5063
522015;201410;1053;3072;861;2779;235;806;417;1366;652;2172
522020;201410;5225;14053;4457;13018;978;3063;2733;7987;3711;11050
522026;201410;746;2135;554;1920;207;785;186;652;393;1437
522028;201410;549;1625;448;1400;88;286;280;861;368;1147
522040;201410;3260;8331;2461;7316;762;2370;1193;3591;1955;5961
522045;201410;14408;46996;11976;41924;3935;15183;2737;9322;6672;24505
522050;201410;1113;3198;881;2792;275;951;343;1018;618;1969
522060;201410;2812;8567;2230;7650;640;2419;1074;3613;1714;6032
522068;201410;1617;5217;1509;5097;130;346;1257;4492;1387;4838
522070;201410;856;2573;765;2431;106;404;520;1644;626;2048
522100;201410;806;2268;717;2134;270;896;326;900;596;1796
522108;201410;974;2870;852;2686;88;281;634;2048;722;2329
522119;201410;1400;4242;1159;3913;220;765;690;2411;910;3176
522130;201410;519;1466;444;1379;137;445;231;730;368;1175
522140;201410;18863;53244;16096;48797;5054;16462;6381;18933;11435;35395
522145;201410;955;2670;879;2548;420;1295;281;798;701;2093
522150;201410;1281;3341;1057;3027;380;1160;385;1136;765;2296
522155;201410;885;2545;774;2382;175;525;472;1514;647;2039
522157;201410;725;2098;623;1942;72;246;484;1517;556;1763
522160;201410;6396;17980;4516;14660;1673;6050;673;2036;2346;8086
522170;201410;3184;8880;2634;8047;814;2510;1020;3237;1834;5747
522180;201410;476;1343;354;1152;145;513;123;409;268;922
522185;201410;15817;48107;13929;45554;3215;11185;8020;26612;11235;37797
522190;201410;1028;2628;812;2280;141;400;455;1306;596;1706
522200;201410;1712;5666;1534;5296;534;1987;456;1515;990;3502
522205;201410;1345;3944;1119;3563;304;1028;520;1658;824;2686
522220;201410;1415;3870;1137;3522;282;890;566;1943;848;2833
522230;201410;1242;3707;1096;3471;160;566;742;2357;902;2923
530010;201410;262383;846746;234269;791442;72293;266305;84681;284940;156974;551245
110001;201409;4648;15009;4029;14013;1056;3790;2286;8083;3342;11873
110002;201409;14374;44978;12184;41041;3780;13752;5225;17574;9005;31326
110003;201409;997;3212;910;3056;258;902;346;1137;604;2039
110004;201409;10279;33073;8592;29522;2912;10812;2396;8171;5308;18983
110005;201409;2431;8032;2251;7679;856;3006;916;3151;1772;6157
110006;201409;3450;9224;2166;7413;736;2652;657;2122;1393;4774
110007;201409;1603;4906;1475;4727;320;1124;795;2779;1115;3903
110008;201409;2615;8837;2453;8599;459;1516;1794;6590;2253;8106
110009;201409;5546;15885;4263;13947;1199;4288;1884;5998;3083;10286
110010;201409;8631;24562;7552;23199;1613;4590;4729;15706;6342;20296
110011;201409;11116;33803;9173;30439;3281;11414;3540;11762;6821;23176
110012;201409;17293;52601;14942;48117;5001;16774;5703;18414;10704;35188
110013;201409;5603;17419;4554;15804;1510;5456;1900;6745;3410;12201
110014;201409;4585;13360;3832;12254;799;2644;2372;7727;3171;10371
110015;201409;5647;17507;4402;15289;1530;5772;1497;5195;3027;10967
110018;201409;5402;15698;4364;14344;1362;5008;2011;6374;3373;11382
110020;201409;61414;176723;49849;161433;10885;36641;28847;95837;39732;132478
110025;201409;4701;13567;3868;12085;662;2196;2655;8280;3317;10476
110026;201409;868;2483;731;2316;201;649;437;1407;638;2056
110028;201409;8076;23519;5939;19821;1802;6615;1414;4591;3216;11206
110029;201409;1741;5043;1391;4448;436;1453;636;2057;1072;3510
110030;201409;12274;34699;9821;31391;2606;8921;4998;16491;7604;25412
110032;201409;4329;13908;3837;12818;1213;4208;1480;4916;2693;9124
110033;201409;5726;18237;5309;17596;1619;5215;2735;9704;4354;14919
110034;201409;4012;10408;3344;9596;575;1577;2507;7335;3082;8912
110037;201409;2179;7308;1879;6745;479;1772;1027;3731;1506;5503
110040;201409;3689;11832;3359;11238;1018;3700;1627;5354;2645;9054
110045;201409;5509;18300;4928;17595;1504;5722;2712;9693;4216;15415
110050;201409;1892;5993;1586;5573;505;1791;859;3096;1364;4887
110060;201409;1044;3546;923;3324;280;1076;427;1542;707;2618
110070;201409;2061;6985;1988;6827;396;1423;1340;4616;1736;6039
110080;201409;3963;12175;3726;11895;442;1272;3081;10156;3523;11428
110090;201409;976;2830;772;2508;229;859;349;1036;578;1895
110092;201409;1750;5638;1588;5427;338;1162;981;3527;1319;4689
110094;201409;3458;10622;3152;10186;797;2666;1887;6226;2684;8892
110100;201409;2719;8490;2326;7827;688;2459;1211;4068;1899;6527
110110;201409;1831;5815;1697;5653;721;2456;727;2509;1448;4965
110120;201409;1803;5864;1418;4986;466;1701;425;1503;891;3204
110130;201409;2855;8096;2127;7003;609;2082;984;3265;1593;5347
110140;201409;2700;9092;2446;8655;554;2015;1476;5341;2030;7356
110143;201409;1621;5125;1241;4460;308;1151;644;2314;952;3465
110145;201409;1067;3157;920;2929;176;600;594;1893;770;2493
110146;201409;483;1528;437;1457;98;337;254;862;352;1199
110147;201409;933;2747;724;2390;216;788;268;792;484;1580
110148;201409;1435;4258;1085;3532;326;1133;365;1149;691;2282
110149;201409;3905;11339;3047;10026;837;2802;1739;5877;2576;8679
110150;201409;2985;8644;2453;7861;316;1093;1656;5416;1972;6509
110155;201409;980;3174;917;3028;277;965;482;1572;759;2537
110160;201409;2230;6923;1801;6129;590;2060;827;2821;1417;4881
110170;201409;3261;9281;2490;7937;552;1860;1468;4670;2020;6530
110175;201409;1854;5655;1396;5062;191;754;936;3480;1127;4234
110180;201409;1741;5315;1471;4886;361;1237;863;2898;1224;4135
120001;201409;3048;10653;2912;10418;637;2428;1799;6537;2436;8965
120005;201409;1607;6401;1564;6323;164;608;1242;5225;1406;5833
120010;201409;4735;16567;4504;16169;847;2947;3110;11586;3957;14533
120013;201409;1923;7528;1873;7445;440;1728;1189;4973;1629;6701
120017;201409;2209;7817;2080;7572;577;2101;1015;4046;1592;6147
120020;201409;14937;64987;14527;64160;2416;10145;10585;48961;13001;59106
120025;201409;2882;9864;2799;9735;592;2188;1780;6283;2372;8471
120030;201409;6358;25041;6237;24891;454;1680;5440;22140;5894;23820
120032;201409;1415;6791;1357;6650;200;1130;981;4845;1181;5975
120033;201409;3702;14214;3666;14153;188;724;3322;13007;3510;13731
120034;201409;1919;7833;1866;7751;185;902;1573;6462;1758;7364
120035;201409;2865;13609;2828;13524;235;1083;2408;11843;2643;12926
120038;201409;3225;11736;3097;11470;834;3172;1751;6637;2585;9809
120039;201409;1562;8227;1531;8153;184;1034;1229;6622;1413;7656
120040;201409;48085;171850;43820;163197;12492;48976;21559;82229;34051;131205
120042;201409;2872;12361;2727;12017;397;1872;1970;8826;2367;10698
120043;201409;889;4212;856;4148;67;295;723;3624;790;3919
120045;201409;4665;16056;4605;15965;880;3083;3441;12117;4321;15200
120050;201409;8342;34266;7990;33489;1343;5400;5463;24188;6806;29588
120060;201409;7545;33918;7421;33679;669;3082;6228;28930;6897;32012
120070;201409;2921;10886;2846;10707;556;2006;1902;7462;2458;9468
120080;201409;3857;14499;3696;14233;572;2164;2774;11041;3346;13205
130002;201409;2990;12542;2817;12246;249;1164;2321;10219;2570;11383
130006;201409;1875;7979;1680;7605;285;1423;1146;5230;1431;6653
130008;201409;2058;8395;1968;8232;171;748;1608;6836;1779;7584
130010;201409;2870;9617;2515;9205;199;690;2174;8110;2373;8800
130014;201409;3566;11375;3074;10627;503;1865;2037;7133;2540;8998
130020;201409;2654;9371;2644;9359;33;112;2598;9219;2631;9331
130030;201409;7311;28122;7062;27797;677;2274;5935;24234;6612;26508
130040;201409;3732;11536;3377;11070;281;1018;2869;9465;3150;10483
130050;201409;6114;24329;5425;23241;664;2761;4006;18156;4670;20917
130060;201409;5951;26542;5588;25986;591;2784;4487;21304;5078;24088
130063;201409;3482;15369;3440;15300;287;1214;2965;13513;3252;14727
130068;201409;3117;13132;2860;12628;419;2012;1957;8732;2376;10744
130070;201409;6862;22535;6207;21701;649;2263;4952;17756;5601;20019
130080;201409;5160;22876;4945;22556;924;4328;3343;15826;4267;20154
130083;201409;2143;8478;2022;8288;305;1428;1459;5983;1764;7411
130090;201409;2637;9476;2516;9313;169;706;2196;8159;2365;8865
130100;201409;5630;21091;5404;20785;336;1421;4758;18457;5094;19878
130110;201409;7012;22324;6548;21770;634;1925;5474;18780;6108;20705
130115;201409;4210;15063;4034;14832;98;305;3849;14262;3947;14567
130120;201409;14097;53507;13484;52695;1212;4321;11389;45976;12601;50297
130130;201409;3653;15345;3550;15162;383;1695;2890;12562;3273;14257
130140;201409;6426;24824;6339;24724;157;403;6130;24207;6287;24610
130150;201409;3496;13295;3421;13200;213;916;3034;11757;3247;12673
130160;201409;4002;16554;3916;16437;268;1011;3549;15119;3817;16130
130165;201409;2841;11697;2742;11527;379;1654;2169;9238;2548;10892
130170;201409;9340;33563;8198;32125;1180;4638;6139;24921;7319;29559
130180;201409;3455;11109;3369;10982;127;369;3115;10243;3242;10612
130185;201409;10204;34402;9486;33565;1119;3617;7687;28340;8806;31957
130190;201409;18297;62615;16156;59896;3180;11547;10694;41723;13874;53270
130195;201409;1880;7821;1821;7736;111;473;1609;6943;1720;7416
130200;201409;1999;7226;1853;6985;460;1748;1133;4403;1593;6151
130210;201409;1206;4743;1139;4629;136;588;914;3778;1050;4366
130220;201409;2051;8377;1882;8054;349;1671;1122;4845;1471;6516
130230;201409;3644;16195;3444;15864;413;1832;2609;12602;3022;14434
130240;201409;8569;32642;7908;31668;495;2215;6783;27574;7278;29789
130250;201409;18769;66618;17917;65469;2195;7463;14157;53909;16352;61372
130255;201409;4174;14672;3944;14301;156;474;3585;13288;3741;13762
130260;201409;263521;852182;237197;809495;67050;236309;122032;428613;189082;664922
130270;201409;7590;31079;6850;29919;1032;4450;4978;22732;6010;27182
130280;201409;3337;13105;3259;12993;167;519;2952;12115;3119;12634
130290;201409;10989;39035;10814;38794;229;517;10305;37682;10534;38199
130300;201409;4587;17558;4294;17122;393;1731;3499;14098;3892;15829
130310;201409;5238;19570;4805;19029;471;1825;3917;15919;4388;17744
130320;201409;2978;10359;2710;9996;353;1331;1992;7537;2345;8868
130330;201409;3763;13598;3379;13074;214;951;2884;11284;3098;12235
130340;201409;18514;70363;17818;69334;3645;13325;11950;49556;15595;62881
130350;201409;3321;13431;3184;13266;304;1328;2639;11216;2943;12544
130353;201409;6114;18754;5327;17687;1295;4206;3230;11485;4525;15691
130356;201409;4703;16863;4503;16554;469;1443;3689;14252;4158;15695
130360;201409;2967;8199;2620;7808;45;79;2483;7583;2528;7662
130370;201409;5140;20106;4409;19114;290;1494;3641;15922;3931;17416
130380;201409;6927;29376;6677;28993;502;2277;5709;25147;6211;27424
130390;201409;4898;21742;4575;21165;490;2401;3514;16695;4004;19096
130395;201409;2084;7507;1839;6981;265;1056;1213;4662;1478;5718
130400;201409;2128;7938;2058;7838;163;660;1794;6900;1957;7560
130406;201409;9988;37703;8928;36075;2044;8267;5479;23206;7523;31473
130410;201409;4141;15709;3791;15061;1130;4783;1764;7194;2894;11977
130420;201409;10290;43419;9902;42733;2904;12161;5851;26635;8755;38796
130423;201409;3252;12592;3072;12349;287;1332;2578;10387;2865;11719
130426;201409;2116;9046;2027;8888;342;1453;1457;6685;1799;8138
130430;201409;3710;13026;3504;12739;518;1938;2501;9318;3019;11256
130440;201409;4053;14168;3741;13814;234;723;3334;12687;3568;13410
140002;201409;1685;5329;1573;5186;174;568;1201;4060;1375;4628
140005;201409;3017;8876;2852;8698;113;260;2666;8261;2779;8521
140010;201409;47138;150319;41925;141791;10344;37433;22165;76510;32509;113943
140015;201409;2876;9358;2741;9183;315;826;2212;7775;2527;8601
140017;201409;3298;10249;3017;9894;286;827;2438;8298;2724;9125
140020;201409;4514;15331;4188;14894;396;1310;3439;12563;3835;13873
140023;201409;2167;7340;1954;6990;260;945;1410;5163;1670;6108
140028;201409;2243;6106;2181;6036;83;146;2027;5756;2110;5902
140030;201409;3789;11926;3617;11710;418;1069;3050;10275;3468;11344
140040;201409;1544;7340;1493;7194;140;747;1146;5621;1286;6368
140045;201409;2553;9192;2358;8898;452;1517;1566;6453;2018;7970
140047;201409;5611;15601;5047;14831;1483;4461;2561;7961;4044;12422
140050;201409;1541;4764;1410;4584;213;723;989;3280;1202;4003
140060;201409;1474;4602;1324;4358;278;947;848;2876;1126;3823
140070;201409;1490;7471;1458;7358;82;464;1300;6569;1382;7033
150010;201409;34202;108552;32575;106382;2253;7599;27687;91752;29940;99351
150013;201409;1670;5021;1572;4905;157;459;1277;4066;1434;4525
150020;201409;12265;41163;11919;40673;1059;3564;10177;35236;11236;38800
150030;201409;6725;28758;6524;28443;663;2388;5454;24887;6117;27275
150034;201409;4515;12336;4242;11991;249;624;3819;10950;4068;11574
150040;201409;12875;43241;11245;41232;2340;7930;7552;29830;9892;37760
150050;201409;6160;23469;5997;23176;603;2461;4897;19150;5500;21611
150060;201409;17331;56433;16299;54867;3295;10727;11053;38547;14348;49274
150070;201409;5860;24187;5288;23539;424;1979;4563;20588;4987;22567
150080;201409;64611;175092;56562;164566;8560;23354;39814;120091;48374;143445
150085;201409;5125;17967;4878;17607;581;1826;3949;14835;4530;16661
150090;201409;10203;39362;9627;38564;991;3921;7813;31984;8804;35905
150095;201409;5326;18157;4926;17552;444;1511;4014;14731;4458;16242
150100;201409;3584;13294;3351;12937;274;1262;2731;10488;3005;11750
150110;201409;3271;15832;3258;15798;189;819;2976;14658;3165;15477
150120;201409;6069;23632;5933;23373;804;3097;4646;18630;5450;21727
150125;201409;825;2532;764;2441;156;544;508;1601;664;2145
150130;201409;21587;67035;20271;65138;1927;6056;16260;53368;18187;59424
150140;201409;157193;464254;151274;456758;17292;51523;123924;379496;141216;431019
150145;201409;4915;15449;4556;14999;653;2210;3442;11502;4095;13712
150150;201409;10559;34139;9910;33089;1784;6193;6857;23168;8641;29361
150157;201409;3074;9467;2737;8987;391;1381;2053;6830;2444;8211
150160;201409;2985;9898;2807;9636;680;2286;1733;6196;2413;8482
150170;201409;22380;82952;21190;81279;3844;14721;15259;59449;19103;74170
150172;201409;3125;10872;2805;10367;409;1547;2110;7956;2519;9503
150175;201409;2118;6477;2031;6380;157;404;1750;5748;1907;6152
150178;201409;10936;33709;9287;31731;817;2626;7785;27245;8602;29871
150180;201409;18377;74006;17711;73069;1671;7285;14660;61327;16331;68612
150190;201409;7259;23401;6826;22798;427;988;5913;20606;6340;21594
150195;201409;4874;16709;4541;16147;383;1413;3783;13600;4166;15013
150200;201409;5231;16897;5038;16663;154;477;4687;15700;4841;16177
150210;201409;23001;88722;22483;87967;2101;7669;18873;75952;20974;83621
150215;201409;6386;20617;5689;19525;1535;5544;2887;10088;4422;15632
150220;201409;12746;40616;11557;38733;2620;9006;6526;22394;9146;31400
150230;201409;11319;38215;10182;36593;918;3928;8092;28981;9010;32909
150240;201409;35211;106761;31643;100747;10158;33351;13125;43469;23283;76820
150250;201409;4182;16779;4048;16577;563;2241;3101;13177;3664;15418
150260;201409;2128;8544;2030;8357;425;1793;1255;5332;1680;7125
150270;201409;9710;29362;7511;26601;1536;5786;4844;17503;6380;23289
150275;201409;5937;21738;5615;21217;799;3042;4173;16123;4972;19165
150276;201409;2166;6506;1987;6263;379;1287;1459;4595;1838;5882
150277;201409;5044;15781;4400;14987;592;2013;3314;11643;3906;13656
150280;201409;5975;26260;5786;25824;1018;4453;4087;18874;5105;23327
150285;201409;2635;10663;2583;10552;401;1682;1865;7839;2266;9521
150290;201409;9484;28793;9163;28417;822;2123;7778;25108;8600;27231
150293;201409;9141;26976;7478;24553;2417;8246;3165;11042;5582;19288
150295;201409;6919;21287;5867;20032;1157;3748;3966;14464;5123;18212
150300;201409;1819;6416;1766;6350;123;401;1478;5501;1601;5902
150304;201409;4215;13155;3645;12366;554;1874;2576;9029;3130;10903
150307;201409;6782;22869;6308;22190;492;1705;5221;18848;5713;20553
150309;201409;6949;24308;6401;23572;1563;5673;4136;16024;5699;21697
150310;201409;5454;24824;5318;24593;647;2966;4228;20053;4875;23019
150320;201409;9009;22826;8609;22398;569;1281;7617;20268;8186;21549
150330;201409;13720;48554;12953;47390;1542;5458;10150;38264;11692;43722
150340;201409;2401;7938;2239;7698;380;1372;1580;5505;1960;6877
150345;201409;6560;22656;6115;22048;639;2291;4979;18361;5618;20652
150350;201409;7356;24504;6999;24004;947;3101;5331;18707;6278;21808
150360;201409;22198;69460;19247;65656;3113;10656;13413;47424;16526;58080
150370;201409;10388;38292;9888;37621;1314;4411;7958;31594;9272;36005
150375;201409;2856;12070;2787;11975;319;1192;2325;10420;2644;11612
150380;201409;9848;29317;8732;27798;832;2821;7159;22977;7991;25798
150390;201409;8326;35680;7921;34882;1625;6872;5125;23657;6750;30529
150400;201409;5659;22877;5427;22384;593;2409;4197;17768;4790;20177
150405;201409;8533;26183;7650;25096;1420;4192;5356;18724;6776;22916
150410;201409;1742;6694;1692;6598;292;1208;1122;4457;1414;5665
150420;201409;36325;126845;32073;119788;8968;35161;15628;60953;24596;96114
150430;201409;6642;24153;6382;23698;767;2986;4870;18379;5637;21365
150440;201409;5436;19054;5244;18768;981;3390;3729;13772;4710;17162
150442;201409;21934;63640;19977;61010;3583;11190;13203;41529;16786;52719
150445;201409;5334;18646;4901;17984;651;2318;3734;14077;4385;16395
150450;201409;4398;21000;4237;20760;398;1942;3534;17712;3932;19654
150460;201409;6938;25355;5830;24173;371;1636;5145;21772;5516;23408
150470;201409;17819;54697;17236;53976;995;2538;15658;50077;16653;52615
150475;201409;1465;5056;1358;4914;180;624;1075;4032;1255;4656
150480;201409;14306;48906;13677;47953;1230;4273;11324;40597;12554;44870
150490;201409;6730;25848;6565;25618;297;1175;5979;23552;6276;24727
150495;201409;4938;18137;4823;17965;206;756;4457;16746;4663;17502
150497;201409;3302;11626;3004;11108;898;3430;1596;6040;2494;9470
150500;201409;3081;8772;2917;8528;427;1246;2166;6363;2593;7609
150503;201409;4125;12921;3563;12209;1272;4425;1799;6464;3071;10889
150506;201409;12558;44274;11555;42839;2402;8202;7875;31012;10277;39214
150510;201409;9921;38975;9233;37746;1475;6108;6458;27436;7933;33544
150520;201409;6644;26071;6556;25949;264;863;6141;24644;6405;25507
150530;201409;12095;42612;10989;40907;1347;4849;8331;31879;9678;36728
150540;201409;4701;14530;4240;13869;346;1183;3526;11550;3872;12733
150543;201409;5445;17126;4931;16387;1111;3793;3206;10890;4317;14683
150548;201409;8757;28104;8211;27399;451;1348;7401;25116;7852;26464
150549;201409;2276;7210;2144;7056;105;237;1960;6634;2065;6871
150550;201409;21332;68248;18976;64207;5701;19830;8891;30828;14592;50658
150553;201409;20936;74576;18232;68560;7185;28836;4590;17338;11775;46174
150555;201409;1803;5520;1586;5215;203;712;1174;3901;1377;4613
150560;201409;2028;6510;1932;6303;271;903;1381;4506;1652;5409
150563;201409;2867;9491;2660;9124;626;2292;1545;5292;2171;7584
150565;201409;3595;12598;3314;12164;253;1075;2654;9861;2907;10936
150570;201409;5588;20937;5486;20762;436;1626;4621;17938;5057;19564
150580;201409;10037;41178;9829;40920;793;2769;8573;36963;9366;39732
150590;201409;5661;22816;5515;22639;118;375;5268;21882;5386;22257
150600;201409;8056;30861;7820;30501;551;1975;6849;27352;7400;29327
150610;201409;2414;8324;2214;7913;279;1102;1549;5488;1828;6590
150611;201409;2722;9755;2563;9422;264;1054;1950;7199;2214;8253
150613;201409;12115;37333;10479;34990;3427;11721;5065;17690;8492;29411
150616;201409;3126;9305;2447;8370;633;2344;1195;4001;1828;6345
150618;201409;7376;25660;7043;25041;2219;8072;3587;13181;5806;21253
150619;201409;5404;18488;5046;17963;667;2594;3704;13250;4371;15844
150620;201409;6328;22908;5740;22160;814;3080;4442;17787;5256;20867
150630;201409;5600;17289;5350;16982;400;1234;4600;14900;5000;16134
150635;201409;4601;15077;4328;14562;892;3027;2660;9254;3552;12281
150640;201409;1675;5232;1634;5181;203;612;1322;4368;1525;4980
150650;201409;12478;38596;11284;36457;3108;10339;5583;18508;8691;28847
150655;201409;5412;18007;4975;17349;624;2284;3813;13462;4437;15746
150658;201409;4386;13963;4026;13446;542;2118;2907;9782;3449;11900
150660;201409;5881;18563;5355;17855;1334;4319;3217;11211;4551;15530
150670;201409;6594;18939;5647;17763;1603;5040;3257;10839;4860;15879
150680;201409;54160;206373;50152;198960;16528;66318;23129;97931;39657;164249
150690;201409;1940;6189;1773;5906;338;1067;1140;3962;1478;5029
150700;201409;6049;18793;5593;18195;1116;3627;3756;12534;4872;16161
150710;201409;4345;14353;3907;13665;455;1567;3012;10730;3467;12297
150715;201409;5113;16546;4552;15712;603;2187;3461;12086;4064;14273
150720;201409;6628;27040;6243;26344;993;4128;4482;19731;5475;23859
150730;201409;9515;32793;8924;31967;1060;3565;7272;26748;8332;30313
150740;201409;3750;11996;3412;11394;500;1761;2267;7668;2767;9429
150745;201409;5900;18660;5435;18026;1163;4007;3629;12145;4792;16152
150746;201409;1434;4690;1362;4560;206;742;932;3140;1138;3882
150747;201409;5062;16406;4588;15780;523;1616;3507;12726;4030;14342
150750;201409;3060;10318;2947;10176;152;437;2694;9461;2846;9898
150760;201409;11536;37498;10888;36639;2519;8386;6913;24165;9432;32551
150770;201409;5769;21904;5522;21538;699;2585;4344;17853;5043;20438
150775;201409;1203;3736;1071;3496;223;870;627;1981;850;2851
150780;201409;3236;10663;3197;10620;82;197;3039;10235;3121;10432
150790;201409;5289;16929;4906;16441;485;1419;4111;14243;4596;15662
150795;201409;15798;48634;14158;46276;2709;8576;9430;32056;12139;40632
150796;201409;2934;8952;2755;8740;355;1097;2172;7092;2527;8189
150797;201409;3833;12853;3607;12514;194;719;3137;10986;3331;11705
150800;201409;14339;47878;13060;46304;2750;9064;9084;33901;11834;42965
150803;201409;6961;25138;6623;24652;877;3312;4910;18768;5787;22080
150805;201409;2826;9824;2608;9496;378;1321;1931;7244;2309;8565
150808;201409;6020;20574;5159;18954;2217;8657;1182;4440;3399;13097
150810;201409;19886;62210;16680;58297;2468;8158;12007;44312;14475;52470
150812;201409;5415;16852;4968;16171;502;2056;3732;11750;4234;13806
150815;201409;9064;29096;8133;27938;1037;3410;6453;22916;7490;26326
150820;201409;10940;31609;9936;30504;645;1312;8769;27925;9414;29237
150830;201409;12781;48972;11882;47427;696;2996;9999;40965;10695;43961
150835;201409;2116;7713;1965;7363;543;2164;920;3457;1463;5621
150840;201409;8046;23154;6441;20902;1531;5430;3509;11235;5040;16665
160005;201409;765;2817;719;2737;105;492;494;1830;599;2322
160010;201409;1530;5166;1519;5154;123;308;1353;4743;1476;5051
160015;201409;1768;6508;1727;6439;193;633;1395;5435;1588;6068
160020;201409;2309;7629;2149;7406;315;1113;1558;5524;1873;6637
160021;201409;943;4028;921;3989;180;849;645;2833;825;3682
160023;201409;1059;4162;1042;4137;73;254;926;3750;999;4004
160025;201409;1505;4174;1472;4139;16;48;1442;4056;1458;4104
160027;201409;8418;25629;7837;24986;2760;8391;4162;14282;6922;22673
160030;201409;44559;161723;40845;154253;9305;35111;25401;99219;34706;134330
160040;201409;4304;16673;4217;16543;154;697;3937;15444;4091;16141
160050;201409;3670;13614;3322;13101;1346;5224;1524;6405;2870;11629
160053;201409;2806;10852;2745;10764;597;2374;1882;7555;2479;9929
160055;201409;763;2918;751;2905;117;488;570;2221;687;2709
160060;201409;17730;59918;16747;58813;3750;12441;11517;42317;15267;54758
160070;201409;2387;9472;2327;9375;136;530;2077;8511;2213;9041
160080;201409;2748;10107;2732;10081;89;277;2601;9698;2690;9975
170025;201409;572;1946;521;1864;173;635;255;953;428;1588
170030;201409;1192;3925;1073;3703;324;1125;490;1734;814;2859
170035;201409;1567;4653;1290;4132;439;1482;434;1433;873;2915
170040;201409;1903;6274;1667;5923;293;1190;1127;4019;1420;5209
170070;201409;2111;5709;1705;5193;473;1550;886;2742;1359;4292
170100;201409;2588;7359;2280;6845;265;869;1770;5333;2035;6202
170105;201409;773;2461;628;2155;132;528;321;1055;453;1583
170110;201409;1199;3737;1046;3480;247;888;546;1802;793;2690
170130;201409;1463;4556;1268;4269;274;941;745;2612;1019;3553
170190;201409;1700;4879;1335;4311;546;1707;351;1292;897;2999
170200;201409;1636;4903;1209;4102;354;1317;394;1302;748;2619
170210;201409;31363;94602;26499;86221;8832;30643;9222;31259;18054;61902
170215;201409;1197;3772;1066;3574;127;456;813;2750;940;3206
170220;201409;6641;22103;6046;21082;1186;4430;3638;12909;4824;17339
170230;201409;1550;5048;1333;4642;318;1271;650;2180;968;3451
170240;201409;3035;8662;2414;7817;359;1295;1644;5354;2003;6649
170255;201409;3733;11872;3103;10838;930;3330;1385;5088;2315;8418
170270;201409;1063;2723;758;2296;110;380;502;1490;612;1870
170290;201409;3038;9077;2686;8651;198;514;2295;7711;2493;8225
170300;201409;2118;6580;1781;6016;281;1012;1170;3996;1451;5008
170305;201409;800;2479;656;2213;116;422;394;1352;510;1774
170307;201409;1109;3901;951;3594;208;835;495;1958;703;2793
170310;201409;1739;4783;1383;4210;332;989;706;2289;1038;3278
170320;201409;1096;3192;826;2698;210;732;380;1281;590;2013
170330;201409;852;2593;724;2431;126;464;503;1657;629;2121
170360;201409;457;1558;412;1481;107;408;176;612;283;1020
170370;201409;1454;4215;1165;3753;289;1007;543;1759;832;2766
170380;201409;2110;6622;1707;6003;349;1401;928;3236;1277;4637
170382;201409;561;1869;481;1737;123;507;272;957;395;1464
170384;201409;1614;6620;1516;6446;374;1669;920;3992;1294;5661
170386;201409;940;2805;811;2623;215;770;419;1368;634;2138
170388;201409;653;1966;561;1814;114;441;239;751;353;1192
170389;201409;951;3153;872;3037;117;491;621;2125;738;2616
170390;201409;1377;4023;1178;3772;159;542;869;2854;1028;3396
170410;201409;502;1665;456;1571;63;268;304;1019;367;1287
170460;201409;537;1476;390;1222;110;373;133;411;243;784
170510;201409;804;2708;659;2458;117;506;350;1297;467;1803
170550;201409;6119;18445;4808;16060;1780;6498;1131;3784;2911;10282
170555;201409;1408;4112;1129;3681;274;941;607;1999;881;2940
170560;201409;1006;3398;807;3140;170;692;498;2014;668;2706
170600;201409;1377;3892;1196;3660;242;710;799;2551;1041;3261
170610;201409;1652;4975;1283;4391;159;615;807;2818;966;3433
170625;201409;436;1365;339;1170;72;262;101;356;173;618
170650;201409;1285;4109;1125;3827;284;1049;540;1872;824;2921
170700;201409;4114;13554;3439;12431;803;3180;1702;6390;2505;9570
170710;201409;1900;5595;1538;4972;258;883;948;3108;1206;3991
170720;201409;1884;5031;1600;4595;298;824;1116;3303;1414;4127
170730;201409;1125;3201;930;2915;265;919;444;1400;709;2319
170740;201409;2285;8063;2017;7588;307;1261;1391;5283;1698;6544
170755;201409;906;2825;759;2505;195;694;292;932;487;1626
170765;201409;1614;4340;1294;3823;351;1098;573;1729;924;2827
170770;201409;1862;6343;1724;6086;348;1285;1065;3824;1413;5109
170820;201409;4222;13488;3815;12843;1048;3713;1747;6023;2795;9736
170825;201409;835;2486;640;2108;148;540;264;852;412;1392
170830;201409;1424;4214;1273;3986;43;89;1150;3656;1193;3745
170900;201409;2953;10204;2799;9918;328;1160;2125;7766;2453;8926
170930;201409;4396;13331;3587;12075;1269;4514;1245;4173;2514;8687
170950;201409;13459;38853;9952;32685;3568;13128;2314;7350;5882;20478
170980;201409;527;1562;408;1359;93;348;229;741;322;1089
171050;201409;1399;4894;1303;4709;77;338;1114;4016;1191;4354
171070;201409;1748;5418;1610;5229;307;1017;1041;3479;1348;4496
171090;201409;991;2834;833;2593;90;293;616;1920;706;2213
171110;201409;674;1960;526;1716;132;470;291;935;423;1405
171150;201409;880;2574;645;2133;131;482;366;1214;497;1696
171180;201409;661;2040;492;1692;133;475;205;750;338;1225
171190;201409;1921;6921;1655;6380;400;1610;802;3231;1202;4841
171195;201409;887;3125;785;2940;141;563;425;1645;566;2208
171200;201409;708;2272;583;2037;137;540;283;935;420;1475
171215;201409;490;1444;375;1232;77;283;162;543;239;826
171240;201409;803;2751;750;2659;73;267;569;2080;642;2347
171245;201409;676;2239;562;1971;130;517;232;779;362;1296
171250;201409;1173;3388;996;3126;92;328;768;2395;860;2723
171270;201409;446;1801;414;1737;113;436;207;950;320;1386
171280;201409;938;2913;818;2714;199;667;422;1520;621;2187
171320;201409;4223;12791;3585;11790;1053;3621;1808;5993;2861;9614
171330;201409;2938;8734;2517;8094;645;2224;1371;4432;2016;6656
171360;201409;1572;4968;1323;4595;276;989;783;2764;1059;3753
171370;201409;794;2229;702;2089;144;476;379;1121;523;1597
171380;201409;1349;4445;1149;4057;415;1491;436;1578;851;3069
171395;201409;901;2741;726;2426;147;595;366;1192;513;1787
171420;201409;2296;6980;1829;6146;449;1601;827;2823;1276;4424
171430;201409;1057;3286;900;3035;210;715;518;1770;728;2485
171488;201409;2574;7789;2323;7435;602;1927;1292;4326;1894;6253
171500;201409;908;2785;790;2565;123;401;483;1601;606;2002
171510;201409;982;3409;885;3251;146;549;572;2178;718;2727
171515;201409;622;1771;475;1547;93;317;247;804;340;1121
171525;201409;614;2039;514;1854;105;442;289;1018;394;1460
171550;201409;349;1156;288;1033;111;434;46;172;157;606
171570;201409;1317;4052;1150;3756;195;660;801;2639;996;3299
171575;201409;2101;5952;1620;5066;379;1194;741;2423;1120;3617
171610;201409;6455;21781;5779;20506;1932;7261;2021;7152;3953;14413
171620;201409;2537;7619;2247;7199;167;611;1858;5978;2025;6589
171630;201409;916;2967;751;2677;219;852;292;1027;511;1879
171650;201409;2531;7864;2038;6947;545;2007;859;2889;1404;4896
171660;201409;2632;7240;2069;6247;356;1147;1212;3694;1568;4841
171665;201409;1457;4348;1214;3958;191;683;785;2645;976;3328
171670;201409;2390;6465;1897;5743;469;1532;981;2897;1450;4429
171700;201409;1194;3859;1037;3567;166;638;655;2245;821;2883
171720;201409;749;2265;647;2078;210;712;281;916;491;1628
171750;201409;1359;4377;1175;4019;387;1373;441;1511;828;2884
171780;201409;1300;3531;937;3019;127;459;554;1816;681;2275
171790;201409;1744;5582;1441;5146;257;907;900;3384;1157;4291
171800;201409;737;2338;663;2231;106;378;452;1552;558;1930
171820;201409;10434;31371;9264;29912;1986;6873;5685;18574;7671;25447
171830;201409;1638;5943;1491;5628;418;1652;680;2578;1098;4230
171840;201409;840;2404;739;2264;69;207;570;1778;639;1985
171845;201409;826;2240;645;1935;104;342;377;1116;481;1458
171850;201409;1029;3661;915;3419;132;583;568;2098;700;2681
171855;201409;1277;4036;1150;3827;112;478;876;2835;988;3313
171865;201409;500;1589;418;1467;109;428;207;710;316;1138
171870;201409;711;2197;581;1970;129;476;261;925;390;1401
171875;201409;1430;4469;1204;4130;179;702;855;2915;1034;3617
171880;201409;979;3528;959;3492;121;460;717;2698;838;3158
171884;201409;993;2777;718;2356;153;585;261;918;414;1503
171886;201409;1565;5187;1334;4682;454;1704;441;1560;895;3264
171888;201409;731;2233;599;1982;91;314;356;1221;447;1535
171889;201409;505;1639;477;1584;92;296;309;1061;401;1357
171890;201409;1208;3859;1060;3647;161;616;692;2381;853;2997
171900;201409;512;1928;453;1797;140;561;215;871;355;1432
172000;201409;672;2160;565;1988;90;366;327;1137;417;1503
172010;201409;1214;4189;1137;4065;122;493;877;3152;999;3645
172015;201409;364;1369;310;1281;60;257;180;777;240;1034
172020;201409;2458;8045;2207;7669;314;1159;1567;5547;1881;6706
172025;201409;776;2229;604;1930;94;330;329;1048;423;1378
172030;201409;1137;3830;1021;3618;128;543;714;2517;842;3060
172049;201409;1301;3513;1040;3049;129;379;794;2380;923;2759
172065;201409;1333;3767;1105;3483;108;375;920;2912;1028;3287
172080;201409;2641;8112;2219;7390;278;1090;1518;4975;1796;6065
172085;201409;537;1459;411;1224;96;312;144;410;240;722
172090;201409;3548;10521;2732;9373;609;2179;1557;5528;2166;7707
172093;201409;593;1869;464;1639;127;559;233;782;360;1341
172097;201409;726;2108;595;1901;155;538;238;757;393;1295
172100;201409;29778;98027;25069;88577;8527;33018;6922;24310;15449;57328
172110;201409;1721;6302;1564;6066;185;738;1183;4717;1368;5455
172120;201409;5687;17002;4673;15685;533;1817;3484;11981;4017;13798
172125;201409;335;1008;267;903;62;232;124;423;186;655
172130;201409;547;1551;456;1409;68;221;306;986;374;1207
172208;201409;2224;6827;2075;6587;404;1388;1197;3838;1601;5226
172210;201409;2482;7677;2262;7326;444;1578;1431;4551;1875;6129
210005;201409;22507;72350;19826;68098;5931;21716;9472;32804;15403;54520
210010;201409;1663;5896;1466;5589;150;582;1129;4401;1279;4983
210015;201409;3546;10972;3232;10502;275;624;2704;9271;2979;9895
210020;201409;7659;18756;7135;18108;455;1252;5931;15223;6386;16475
210030;201409;5960;19780;5626;19320;472;1967;4639;15845;5111;17812
210040;201409;2006;5691;1824;5474;163;498;1462;4426;1625;4924
210043;201409;6401;18883;5756;18029;522;1567;4601;14877;5123;16444
210047;201409;6909;26693;6411;25816;902;3901;4503;18393;5405;22294
210050;201409;2552;9010;2037;8231;666;2779;856;3605;1522;6384
210055;201409;1756;5983;1620;5780;203;738;1216;4393;1419;5131
210060;201409;7952;29428;7156;28152;773;3370;5314;21375;6087;24745
210070;201409;7168;21235;6699;20653;300;975;5938;18462;6238;19437
210080;201409;3790;13002;3692;12875;80;309;3493;12227;3573;12536
210083;201409;4317;14771;4074;14505;124;363;3837;13865;3961;14228
210087;201409;2779;8446;2581;8204;163;552;2243;7188;2406;7740
210090;201409;10342;33527;9898;32812;451;1744;8683;28840;9134;30584
210095;201409;6319;23602;6124;23302;586;2268;5032;19529;5618;21797
210100;201409;7713;22964;7235;22399;342;1221;6438;19934;6780;21155
210110;201409;3282;11292;3173;11152;230;841;2684;9614;2914;10455
210120;201409;26687;75788;22725;71010;2671;8215;17339;55845;20010;64060
210125;201409;3547;11434;3402;11274;249;698;2992;10152;3241;10850
210130;201409;4289;12832;4081;12552;359;1135;3366;10404;3725;11539
210135;201409;1696;4976;1496;4683;129;401;1229;3915;1358;4316
210140;201409;18571;58403;15627;54461;3050;10788;10088;36532;13138;47320
210150;201409;4754;11989;4322;11455;120;315;3973;10529;4093;10844
210160;201409;19266;61793;17939;59819;2158;6652;14188;48920;16346;55572
210170;201409;14455;52395;14173;52022;1029;3421;12478;46815;13507;50236
210173;201409;1874;7914;1821;7810;116;560;1593;6875;1709;7435
210177;201409;3066;9728;2901;9525;286;1050;2386;7785;2672;8835
210180;201409;1567;4801;1473;4668;93;327;1250;3962;1343;4289
210190;201409;5267;16889;4902;16251;394;1719;3720;12063;4114;13782
210193;201409;1468;4696;1345;4484;99;365;1096;3706;1195;4071
210197;201409;1991;6648;1836;6476;191;599;1511;5537;1702;6136
210200;201409;9445;31379;8682;30276;1170;3794;6442;23501;7612;27295
210203;201409;6670;21932;6269;21413;452;1336;5503;19190;5955;20526
210207;201409;3109;10287;2915;9938;392;1267;2129;7480;2521;8747
210210;201409;9001;30302;8635;29795;286;1000;7670;27045;7956;28045
210215;201409;1672;6607;1618;6513;174;744;1312;5331;1486;6075
210220;201409;6431;24528;6145;24070;523;2093;5006;20060;5529;22153
210230;201409;5421;18282;5040;17681;407;1506;4132;14654;4539;16160
210232;201409;12191;41206;10606;39252;1759;6527;7409;29026;9168;35553
210235;201409;3674;11295;3288;10815;258;904;2785;9247;3043;10151
210237;201409;2533;9361;2496;9314;54;150;2389;9024;2443;9174
210240;201409;3086;9738;2928;9513;225;697;2427;8025;2652;8722
210250;201409;5191;16407;4946;16101;161;596;4591;14995;4752;15591
210255;201409;2757;8911;2510;8490;515;1841;1560;5357;2075;7198
210260;201409;5321;16961;4838;16221;677;2224;3570;12285;4247;14509
210270;201409;5432;15513;4831;14679;153;548;4298;13152;4451;13700
210275;201409;3671;9191;3430;8930;112;236;3253;8568;3365;8804
210280;201409;6125;17870;5242;16749;409;1393;4305;13906;4714;15299
210290;201409;5832;18921;5352;18322;458;1497;4449;15627;4907;17124
210300;201409;38758;113297;31988;104760;2894;9921;25246;85133;28140;95054
210310;201409;2907;8372;2746;8139;135;367;2412;7206;2547;7573
210312;201409;2218;7146;2160;7051;116;454;1934;6315;2050;6769
210315;201409;2502;8677;2380;8503;142;575;2057;7392;2199;7967
210317;201409;4391;13100;4199;12857;270;789;3721;11552;3991;12341
210320;201409;19815;62555;18498;60965;1086;3491;16242;54534;17328;58025
210325;201409;3712;11641;3317;11054;360;1278;2545;8556;2905;9834
210330;201409;37684;91564;29605;83005;3885;8499;21640;67871;25525;76370
210340;201409;12144;37337;11090;36018;1446;3924;8267;28721;9713;32645
210350;201409;10711;33283;9874;32096;839;2699;7969;26480;8808;29179
210355;201409;4041;14402;3658;13889;164;419;3317;13063;3481;13482
210360;201409;17347;52788;16116;51018;1398;4617;12842;41271;14240;45888
210370;201409;9085;22868;7911;21608;282;617;7184;20085;7466;20702
210375;201409;3276;9993;2816;9430;515;1807;1934;6613;2449;8420
210380;201409;6510;18556;5825;17588;564;1545;4753;14737;5317;16282
210390;201409;2835;10007;2600;9609;132;617;2258;8365;2390;8982
210400;201409;5146;16125;4952;15892;309;917;4381;14292;4690;15209
210405;201409;9148;25119;7381;22716;2212;6728;3466;11768;5678;18496
210407;201409;2133;7495;1887;7103;206;753;1456;5697;1662;6450
210408;201409;2291;8975;2161;8824;93;353;1932;8198;2025;8551
210409;201409;4018;14534;3805;14200;299;1164;3085;11786;3384;12950
210410;201409;3646;11731;3406;11433;298;848;2931;10143;3229;10991
210420;201409;4296;14149;3976;13595;341;1163;3240;11296;3581;12459
210430;201409;2212;6799;2142;6714;141;477;1869;5878;2010;6355
210440;201409;4370;13539;4242;13354;227;676;3799;12123;4026;12799
210450;201409;2963;9339;2672;8908;198;763;2191;7281;2389;8044
210455;201409;4345;12822;3741;11924;650;2110;2559;8353;3209;10463
210460;201409;4113;13195;3836;12821;223;832;3285;11083;3508;11915
210462;201409;1812;6459;1711;6264;173;690;1321;4909;1494;5599
210465;201409;2765;8978;2591;8757;277;783;2125;7477;2402;8260
210467;201409;6460;21179;6037;20655;477;1401;5084;18046;5561;19447
210470;201409;2062;5717;1611;5056;106;348;1278;4061;1384;4409
210480;201409;14338;47441;12612;45111;3547;12485;6968;26708;10515;39193
210490;201409;3603;10624;3302;10179;289;934;2674;8257;2963;9191
210500;201409;6868;26952;6567;26424;777;2982;5071;21213;5848;24195
210510;201409;7024;23224;6727;22863;416;996;5824;20738;6240;21734
210515;201409;3465;11422;3350;11282;142;416;3096;10572;3238;10988
210520;201409;2792;8774;2598;8489;205;651;2166;7225;2371;7876
210530;201409;42560;136855;35895;126693;10377;39545;17721;64285;28098;103830
210535;201409;3311;11567;3185;11372;173;630;2783;10052;2956;10682
210540;201409;13610;46286;12095;43882;2976;10518;6639;26077;9615;36595
210542;201409;6500;18768;5681;17869;349;894;4989;16148;5338;17042
210545;201409;2307;7606;2190;7406;94;440;1892;6360;1986;6800
210547;201409;3949;13743;3680;13324;308;1042;2971;11036;3279;12078
210550;201409;6489;18230;5647;17296;299;671;5144;16205;5443;16876
210560;201409;4302;13543;3844;12796;284;1073;3181;10569;3465;11642
210565;201409;1562;5392;1349;5076;136;615;1006;3812;1142;4427
210570;201409;13021;37022;11814;35628;1017;2494;9866;30908;10883;33402
210580;201409;3215;9741;2842;9270;371;999;2167;7648;2538;8647
210590;201409;4480;13752;4187;13405;281;890;3640;11853;3921;12743
210592;201409;2567;8135;2467;7975;116;426;2164;6994;2280;7420
210594;201409;2829;8033;2342;7361;153;426;1941;6276;2094;6702
210596;201409;2927;10783;2753;10458;305;1220;2086;8067;2391;9287
210598;201409;2001;6195;1864;6024;117;461;1647;5276;1764;5737
210600;201409;3397;10062;3102;9644;299;983;2435;7584;2734;8567
210610;201409;2763;8793;2474;8439;207;801;2087;7112;2294;7913
210620;201409;1929;5945;1769;5739;50;146;1628;5352;1678;5498
210630;201409;3582;12914;3125;12041;474;1822;2009;8033;2483;9855
210632;201409;4853;16654;4438;16072;423;1590;3609;13235;4032;14825
210635;201409;1959;6923;1870;6788;78;269;1673;6184;1751;6453
210637;201409;2875;9614;2699;9358;165;580;2317;8162;2482;8742
210640;201409;4386;14863;4304;14771;18;51;4196;14510;4214;14561
210650;201409;7083;21534;6941;21364;134;368;6683;20717;6817;21085
210660;201409;7832;24060;7294;23243;269;786;6734;21569;7003;22355
210663;201409;2706;7963;2557;7767;171;565;2186;6684;2357;7249
210667;201409;1764;6285;1683;6160;87;377;1468;5404;1555;5781
210670;201409;4820;17817;4652;17530;448;1723;3663;14203;4111;15926
210675;201409;4929;13829;4605;13424;361;953;3909;11662;4270;12615
210680;201409;4636;12975;4123;12379;233;668;3572;10869;3805;11537
210690;201409;7241;24177;6836;23741;295;914;6211;22031;6506;22945
210700;201409;2715;7814;2410;7463;444;1140;1679;5826;2123;6966
210710;201409;4951;16140;4727;15778;198;740;4164;13957;4362;14697
210720;201409;2575;9336;2426;9116;150;666;2124;7933;2274;8599
210725;201409;1201;4403;1031;4084;169;726;595;2380;764;3106
210730;201409;1262;3884;1109;3704;111;325;918;3148;1029;3473
210735;201409;3986;14403;3694;13884;609;2318;2595;10068;3204;12386
210740;201409;5280;14840;4931;14488;241;643;4572;13619;4813;14262
210745;201409;3873;11681;3626;11341;304;802;3036;9665;3340;10467
210750;201409;20625;57072;18682;54839;2032;5901;15032;45001;17064;50902
210760;201409;6131;16806;5761;16403;84;247;5583;15933;5667;16180
210770;201409;6396;17331;5401;16196;227;721;4859;14641;5086;15362
210780;201409;8788;29222;8100;27972;995;3607;5790;20387;6785;23994
210790;201409;4803;14595;4140;13840;330;829;3506;12290;3836;13119
210800;201409;5196;14581;4708;14036;198;617;4046;12527;4244;13144
210805;201409;3785;15952;3664;15732;192;819;3162;13910;3354;14729
210810;201409;5917;17647;5336;16977;404;820;4655;15522;5059;16342
210820;201409;9215;26468;8557;25548;1573;4585;5829;17958;7402;22543
210825;201409;5635;18953;5413;18670;310;972;4775;16801;5085;17773
210830;201409;8785;26793;8381;26331;441;1137;7465;24072;7906;25209
210840;201409;3881;10681;3506;10121;273;711;2820;8200;3093;8911
210845;201409;5934;18362;5710;18113;254;652;5134;16755;5388;17407
210850;201409;6353;22952;5863;22098;840;3542;4191;15897;5031;19439
210860;201409;17792;54239;16430;52411;1524;5089;13123;42335;14647;47424
210870;201409;6808;22041;6097;21145;685;2269;4712;16846;5397;19115
210880;201409;4403;14186;4275;13996;219;698;3824;12674;4043;13372
210890;201409;5532;16547;5168;16093;461;1561;4243;13305;4704;14866
210900;201409;4964;15933;4453;15075;1531;5282;1883;6740;3414;12022
210905;201409;1861;5824;1738;5658;132;350;1465;4918;1597;5268
210910;201409;10732;33669;9969;32449;1873;6506;6616;21739;8489;28245
210920;201409;3373;11338;3255;11168;187;622;2824;9873;3011;10495
210923;201409;1572;5705;1483;5569;225;850;1049;4132;1274;4982
210927;201409;4828;15132;4658;14958;35;110;4580;14751;4615;14861
210930;201409;2694;9729;2570;9566;203;909;2142;7974;2345;8883
210940;201409;2969;11625;2911;11509;300;1128;2378;9586;2678;10714
210945;201409;6078;17901;5850;17667;221;267;5567;17281;5788;17548
210950;201409;5854;17790;5087;16650;597;2041;3782;12586;4379;14627
210955;201409;1987;6542;1764;6190;309;1100;1192;4309;1501;5409
210960;201409;9503;31221;9097;30631;2402;7872;5591;19924;7993;27796
210970;201409;1403;5034;1236;4785;171;783;896;3475;1067;4258
210975;201409;1777;6067;1691;5913;158;576;1338;4744;1496;5320
210980;201409;9883;23852;9623;23562;677;1339;8548;21397;9225;22736
210990;201409;17350;50313;13834;46022;2883;9908;8673;29762;11556;39670
211000;201409;16893;53705;15176;51591;1023;3453;13030;45273;14053;48726
211003;201409;5207;18204;4752;17518;516;1997;3560;13507;4076;15504
211010;201409;6837;23542;6630;23302;144;481;6189;22062;6333;22543
211020;201409;7550;23556;7346;23235;209;542;6889;21934;7098;22476
211023;201409;2497;8354;2415;8208;161;567;2030;7043;2191;7610
211027;201409;3061;11877;2945;11696;295;1092;2337;9671;2632;10763
211030;201409;4373;13245;3927;12739;736;1893;2924;10136;3660;12029
211040;201409;4304;16465;4181;16269;160;668;3675;14601;3835;15269
211050;201409;10591;28020;10414;27822;427;1044;9730;26187;10157;27231
211060;201409;6193;22040;6042;21793;596;2007;5000;18485;5596;20492
211065;201409;1796;6117;1637;5914;53;182;1529;5599;1582;5781
211070;201409;8913;30023;8286;28947;754;2643;6638;23668;7392;26311
211080;201409;1400;4250;1150;3900;106;513;905;2967;1011;3480
211085;201409;2086;6957;1800;6558;295;1043;1280;4818;1575;5861
211090;201409;3691;11285;3466;10983;199;748;2961;9320;3160;10068
211100;201409;6966;18137;6794;17934;94;337;6480;17057;6574;17394
211102;201409;3172;11720;3025;11520;285;1028;2547;9947;2832;10975
211105;201409;2907;9239;2545;8735;219;837;2070;7105;2289;7942
211107;201409;4598;14337;4188;13788;262;808;3583;12108;3845;12916
211110;201409;6736;20103;5334;18098;931;3018;3504;12526;4435;15544
211120;201409;33715;93337;29686;88340;4438;12449;21555;66795;25993;79244
211125;201409;2247;7204;2038;6879;152;547;1688;5741;1840;6288
211130;201409;152375;445993;142486;433318;28204;85227;97168;302944;125372;388171
211140;201409;5705;18132;5361;17592;297;1061;4606;15146;4903;16207
211150;201409;10305;30672;9615;29812;693;2207;8217;25769;8910;27976
211153;201409;3212;9561;2943;9249;421;1105;2329;7694;2750;8799
211157;201409;1272;4150;1084;3857;136;578;739;2728;875;3306
211160;201409;4322;14561;3700;13514;422;1855;2652;9608;3074;11463
211163;201409;1755;5806;1664;5682;74;237;1490;5197;1564;5434
211167;201409;1540;5178;1435;5009;45;172;1309;4594;1354;4766
211170;201409;6827;18076;6567;17759;170;521;6073;16404;6243;16925
211172;201409;2464;7185;2166;6747;154;589;1801;5508;1955;6097
211174;201409;2934;8571;2673;8245;122;466;2355;7225;2477;7691
211176;201409;5708;16587;4798;15533;601;1735;3661;12408;4262;14143
211178;201409;3525;10276;3446;10188;88;202;3290;9824;3378;10026
211180;201409;4597;16080;4289;15611;408;1599;3432;12703;3840;14302
211190;201409;2931;9735;2653;9345;121;523;2293;8143;2414;8666
211195;201409;1496;4703;1274;4431;107;333;1045;3768;1152;4101
211200;201409;2224;7660;1987;7328;267;917;1480;5744;1747;6661
211210;201409;7041;21609;6792;21260;435;1362;5864;18567;6299;19929
211220;201409;37027;109549;32360;103455;6869;22571;20613;67802;27482;90373
211223;201409;6095;17524;5617;16760;828;2505;3771;11843;4599;14348
211227;201409;1628;5967;1519;5804;136;613;1206;4624;1342;5237
211230;201409;9212;30711;8409;29353;1200;4236;6023;21519;7223;25755
211240;201409;8496;28656;8177;28267;330;1176;7513;26138;7843;27314
211245;201409;5617;16179;5548;16094;172;401;5235;15371;5407;15772
211250;201409;12358;43815;11727;43084;1283;3468;9733;37896;11016;41364
211260;201409;8379;26387;8203;26140;551;1740;7280;23387;7831;25127
211270;201409;10258;36339;9634;35501;673;2715;7978;29900;8651;32615
211280;201409;12655;37310;12013;36535;1022;2441;10342;32612;11364;35053
211285;201409;2004;7009;1726;6502;405;1626;854;3385;1259;5011
211290;201409;7827;25727;7585;25418;825;2420;6208;21466;7033;23886
211300;201409;9051;27477;8253;26334;545;1819;7049;22652;7594;24471
211400;201409;12875;37277;10704;34820;2490;7851;6254;22899;8744;30750
220005;201409;1750;5140;1633;4958;67;287;1399;4117;1466;4404
220010;201409;1783;4656;1328;4071;112;418;1043;3135;1155;3553
220020;201409;3841;11737;3613;11347;598;2011;2454;7678;3052;9689
220025;201409;2230;5494;1998;5144;51;154;1762;4491;1813;4645
220027;201409;1429;3864;1318;3722;91;234;1112;3185;1203;3419
220030;201409;3476;10047;3391;9911;253;832;2881;8397;3134;9229
220040;201409;8756;26985;8273;26196;1682;5559;5198;16535;6880;22094
220045;201409;1507;4778;1358;4526;133;511;988;3243;1121;3754
220050;201409;4873;14202;4263;13299;374;1371;3364;10357;3738;11728
220060;201409;2128;5549;2027;5429;90;240;1848;4958;1938;5198
220070;201409;2675;7778;2392;7367;200;644;1869;5799;2069;6443
220080;201409;842;2614;797;2538;111;436;573;1759;684;2195
220090;201409;1916;4949;1648;4584;130;444;1360;3693;1490;4137
220095;201409;706;1958;676;1909;31;98;627;1759;658;1857
220100;201409;1431;4291;1211;3926;129;443;897;2949;1026;3392
220105;201409;2308;7520;2115;7154;207;743;1542;5244;1749;5987
220110;201409;3647;10544;3222;9920;239;895;2647;8010;2886;8905
220115;201409;2358;8516;2266;8369;255;1017;1850;6854;2105;7871
220117;201409;1447;3849;1183;3460;117;356;914;2676;1031;3032
220120;201409;13196;37629;12219;36401;402;1472;11193;33301;11595;34773
220130;201409;889;3146;786;3014;62;205;688;2696;750;2901
220140;201409;1690;4512;1527;4306;229;473;1229;3654;1458;4127
220150;201409;7364;23076;6998;22578;415;1532;6049;19514;6464;21046
220155;201409;1098;3416;916;3077;79;335;635;2076;714;2411
220157;201409;1096;2793;996;2650;44;116;849;2255;893;2371
220160;201409;2922;8728;2615;8204;199;751;2018;6274;2217;7025
220170;201409;1384;4354;1234;4105;104;422;983;3251;1087;3673
220173;201409;2135;6448;1756;5723;81;374;1418;4554;1499;4928
220177;201409;1764;5168;1733;5118;65;195;1617;4787;1682;4982
220180;201409;1192;3228;1050;3004;56;200;800;2230;856;2430
220190;201409;4797;15562;4221;14829;494;1685;3327;11928;3821;13613
220191;201409;1496;5048;1427;4923;211;727;1047;3646;1258;4373
220192;201409;1794;5126;1431;4485;162;544;992;3096;1154;3640
220194;201409;1764;5195;1595;4911;161;566;1198;3601;1359;4167
220196;201409;2104;6277;1963;6037;220;748;1487;4579;1707;5327
220198;201409;1350;3784;1075;3428;20;68;996;3213;1016;3281
220200;201409;4737;16148;4436;15693;750;2769;3107;11094;3857;13863
220202;201409;2133;6670;1928;6305;66;271;1696;5507;1762;5778
220205;201409;3009;7868;2653;7398;99;365;2325;6399;2424;6764
220207;201409;928;2865;808;2653;87;334;607;1976;694;2310
220208;201409;1767;5933;1602;5644;235;937;1129;3960;1364;4897
220209;201409;1629;5005;1469;4738;85;329;1134;3662;1219;3991
220210;201409;1944;5090;1685;4748;93;314;1342;3790;1435;4104
220211;201409;1705;4978;1617;4863;114;474;1351;3995;1465;4469
220213;201409;1884;5426;1743;5169;106;378;1380;4027;1486;4405
220217;201409;1865;6105;1792;6013;65;176;1646;5612;1711;5788
220220;201409;12040;34309;11017;32712;1354;3744;7872;24068;9226;27812
220225;201409;1049;3174;946;3027;43;184;816;2568;859;2752
220230;201409;6229;16301;5160;14865;228;639;4559;13211;4787;13850
220240;201409;2806;8914;2631;8611;214;771;2056;6713;2270;7484
220245;201409;1522;4114;1366;3896;71;205;1169;3390;1240;3595
220250;201409;3415;9319;3062;8843;71;185;2806;8214;2877;8399
220253;201409;1887;5556;1607;5072;144;523;1183;3775;1327;4298
220255;201409;1828;5154;1596;4761;96;376;1310;3801;1406;4177
220260;201409;5306;16908;4727;15822;470;1664;3508;11804;3978;13468
220265;201409;1285;4627;1204;4485;104;454;880;3282;984;3736
220270;201409;7036;22841;6833;22490;424;1888;5821;18722;6245;20610
220271;201409;1574;4414;1470;4262;73;198;1283;3775;1356;3973
220272;201409;1827;5587;1681;5353;110;449;1323;4168;1433;4617
220273;201409;1324;3797;1153;3522;120;396;874;2646;994;3042
220275;201409;2162;5720;1826;5286;93;291;1581;4583;1674;4874
220277;201409;2661;7194;2253;6578;158;507;1764;5187;1922;5694
220280;201409;1799;4721;1559;4358;131;471;1190;3250;1321;3721
220285;201409;1729;4654;1526;4367;103;324;1252;3675;1355;3999
220290;201409;6749;21860;5676;20461;595;2329;4339;15823;4934;18152
220300;201409;1986;6441;1742;6110;91;406;1471;5153;1562;5559
220310;201409;2664;8589;2222;8059;96;284;2002;7512;2098;7796
220320;201409;3506;10263;2917;9263;348;1186;2124;6747;2472;7933
220323;201409;1512;5407;1334;5152;143;624;1009;3926;1152;4550
220325;201409;1305;4136;1188;3901;168;596;791;2669;959;3265
220327;201409;1390;4449;1257;4226;72;345;1009;3344;1081;3689
220330;201409;3823;10791;3610;10507;247;752;3069;9028;3316;9780
220335;201409;2158;6222;1941;5959;105;361;1670;5182;1775;5543
220340;201409;1896;5344;1640;4976;137;462;1260;3785;1397;4247
220342;201409;1238;4024;1172;3921;123;467;857;3008;980;3475
220345;201409;3075;8117;2607;7382;76;223;2292;6482;2368;6705
220350;201409;4558;12103;4007;11360;331;1036;3146;8912;3477;9948
220360;201409;1508;4097;1196;3612;118;411;876;2623;994;3034
220370;201409;9406;27029;8552;25904;461;1363;7619;23181;8080;24544
220375;201409;1604;5020;1485;4862;71;260;1339;4386;1410;4646
220380;201409;1480;3974;1261;3669;83;277;996;2884;1079;3161
220385;201409;801;2119;664;1890;32;111;552;1535;584;1646
220390;201409;10434;32599;9442;30670;2640;8947;3827;12504;6467;21451
220400;201409;1522;3595;1285;3239;46;156;1108;2706;1154;2862
220410;201409;1403;3998;1181;3683;111;444;920;2795;1031;3239
220415;201409;908;2445;816;2324;84;236;615;1755;699;1991
220420;201409;2329;6738;2067;6221;141;429;1682;5078;1823;5507
220430;201409;3003;8688;2854;8486;368;1115;2221;6613;2589;7728
220435;201409;1691;4959;1553;4742;85;263;1288;3942;1373;4205
220440;201409;2820;8504;2333;7934;135;441;2056;7021;2191;7462
220450;201409;2765;8154;2373;7605;545;1853;1435;4597;1980;6450
220455;201409;1422;4386;1273;4183;48;154;1156;3847;1204;4001
220460;201409;1066;2921;1013;2847;70;212;878;2451;948;2663
220465;201409;2530;8359;2325;8047;564;2078;1406;4915;1970;6993
220470;201409;4173;12465;3766;11772;274;968;2889;8921;3163;9889
220480;201409;2485;7290;2257;6961;185;593;1812;5601;1997;6194
220490;201409;2511;7182;2335;6959;135;481;1998;5931;2133;6412
220500;201409;3494;9313;2908;8299;158;630;2365;6573;2523;7203
220510;201409;2989;8325;2210;7102;109;475;1690;5371;1799;5846
220515;201409;2033;5052;1790;4748;94;255;1503;4003;1597;4258
220520;201409;5315;14740;4928;14192;204;565;4363;12689;4567;13254
220525;201409;1489;4197;1380;4036;107;386;1118;3198;1225;3584
220527;201409;1508;4674;1363;4366;153;515;1014;3293;1167;3808
220530;201409;1255;3669;1138;3486;89;344;953;2837;1042;3181
220535;201409;874;2696;844;2654;80;277;676;2122;756;2399
220540;201409;3736;12302;3591;12074;282;1070;2971;9986;3253;11056
220545;201409;1462;5006;1402;4903;191;762;1012;3496;1203;4258
220550;201409;9641;31304;9070;30335;1384;4884;6343;21289;7727;26173
220551;201409;1488;4999;1379;4811;117;505;1085;3741;1202;4246
220552;201409;1709;5352;1463;4921;121;549;1081;3516;1202;4065
220553;201409;1668;4966;1419;4590;88;330;1156;3746;1244;4076
220554;201409;936;2608;810;2435;99;303;604;1840;703;2143
220555;201409;2527;7343;2362;7133;92;298;2041;6258;2133;6556
220556;201409;1538;4828;1388;4540;108;433;1043;3383;1151;3816
220557;201409;1683;5511;1523;5202;210;780;994;3406;1204;4186
220558;201409;1083;3384;991;3222;98;390;747;2384;845;2774
220559;201409;1608;4531;1464;4306;80;273;1237;3631;1317;3904
220560;201409;1792;4416;1480;3997;90;252;1239;3327;1329;3579
220570;201409;7712;24565;7199;23804;1200;3894;5112;17351;6312;21245
220580;201409;6710;21791;6542;21590;396;1253;5895;19693;6291;20946
220585;201409;2005;7315;1921;7159;143;569;1599;5989;1742;6558
220590;201409;1493;4581;1343;4361;258;868;870;2884;1128;3752
220595;201409;2574;7390;2363;7111;89;312;2115;6376;2204;6688
220600;201409;1378;3401;1154;3130;195;408;803;2309;998;2717
220605;201409;2120;6213;1858;5800;110;367;1484;4637;1594;5004
220610;201409;2847;8756;2753;8622;164;634;2352;7309;2516;7943
220620;201409;8082;27259;7778;26811;420;1666;6810;23527;7230;25193
220630;201409;428;1300;365;1183;60;222;209;668;269;890
220635;201409;1906;6744;1767;6441;177;776;1138;4151;1315;4927
220640;201409;2917;8475;2735;8211;250;837;2181;6539;2431;7376
220650;201409;2546;7167;2274;6740;157;529;1831;5391;1988;5920
220660;201409;2757;8586;2216;7877;261;1128;1759;6114;2020;7242
220665;201409;1241;4232;1182;4138;48;200;1067;3723;1115;3923
220667;201409;1817;6112;1723;5985;85;331;1482;5154;1567;5485
220669;201409;1951;6327;1816;6076;282;1098;1238;4100;1520;5198
220670;201409;2204;6643;2047;6444;165;405;1759;5741;1924;6146
220672;201409;2479;7076;2364;6930;246;696;1970;5867;2216;6563
220675;201409;1398;4078;1303;3920;125;356;984;2994;1109;3350
220680;201409;2300;7482;2194;7335;224;755;1764;5994;1988;6749
220690;201409;1799;5071;1595;4739;122;424;1269;3737;1391;4161
220695;201409;938;2752;871;2641;65;240;672;1999;737;2239
220700;201409;9303;26859;8425;25547;786;2634;6481;19628;7267;22262
220710;201409;794;2375;681;2181;65;199;496;1616;561;1815
220720;201409;2206;5890;2083;5724;98;230;1843;5130;1941;5360
220730;201409;1415;3927;1211;3614;46;174;1019;3020;1065;3194
220735;201409;1109;2838;908;2495;62;203;688;1887;750;2090
220740;201409;1449;4596;1218;4285;165;568;934;3385;1099;3953
220750;201409;4106;11957;3849;11568;491;1288;2961;9237;3452;10525
220755;201409;1245;3571;1155;3422;76;231;953;2825;1029;3056
220760;201409;2746;9511;2540;9222;136;567;2193;8029;2329;8596
220770;201409;24920;83418;22586;78804;7514;27233;9017;32627;16531;59860
220775;201409;1286;3214;1254;3178;20;34;1219;3110;1239;3144
220777;201409;1757;4924;1613;4704;126;363;1293;3750;1419;4113
220779;201409;1261;3619;1224;3568;64;224;1100;3178;1164;3402
220780;201409;6484;16842;5803;15911;465;1245;4750;13178;5215;14423
220785;201409;1366;3665;1320;3573;64;172;1208;3266;1272;3438
220790;201409;9888;31581;9411;30728;1023;3573;7358;23951;8381;27524
220793;201409;948;2688;872;2564;62;209;717;2102;779;2311
220795;201409;1571;4386;1517;4305;114;344;1301;3703;1415;4047
220800;201409;17975;50389;16492;48228;1850;6236;12355;35572;14205;41808
220810;201409;3440;10076;2976;9253;201;783;2374;7297;2575;8080
220820;201409;5774;15903;5273;15244;320;1002;4548;13195;4868;14197
220830;201409;7854;22321;7434;21636;840;2468;5749;16903;6589;19371
220840;201409;15430;49130;13926;46088;3638;12265;6646;22649;10284;34914
220850;201409;2934;10328;2799;10141;234;921;2371;8632;2605;9553
220855;201409;643;1996;565;1850;50;195;414;1334;464;1529
220860;201409;969;2669;878;2524;53;210;714;2003;767;2213
220865;201409;2711;7544;2194;6692;117;553;1761;5199;1878;5752
220870;201409;2501;8200;2190;7811;112;424;1945;6962;2057;7386
220880;201409;5551;14446;5056;13842;263;815;4451;12193;4714;13008
220885;201409;1372;4848;1206;4556;125;575;894;3373;1019;3948
220887;201409;1439;3678;1253;3423;46;155;1133;3090;1179;3245
220890;201409;1699;5896;1505;5565;144;508;1197;4585;1341;5093
220900;201409;2020;5839;1787;5367;120;353;1455;4408;1575;4761
220910;201409;1761;5192;1550;4878;82;268;1341;4275;1423;4543
220915;201409;1075;3105;938;2859;57;243;732;2167;789;2410
220920;201409;1395;5089;1297;4942;144;640;944;3572;1088;4212
220930;201409;1523;4907;1354;4683;95;376;1106;3853;1201;4229
220935;201409;1085;3321;965;3078;70;303;689;2096;759;2399
220937;201409;1634;4466;1375;4005;83;299;1077;3050;1160;3349
220940;201409;1484;4541;1369;4295;110;414;1045;3254;1155;3668
220945;201409;509;1798;467;1684;59;245;327;1174;386;1419
220950;201409;1300;3302;936;2677;40;158;718;1990;758;2148
220955;201409;1649;4546;1386;4132;106;341;1072;3182;1178;3523
220960;201409;913;2480;758;2212;47;181;590;1691;637;1872
220965;201409;1750;5228;1650;5084;79;331;1412;4295;1491;4626
220970;201409;2192;5864;1617;4906;168;513;1117;3419;1285;3932
220975;201409;662;2297;652;2282;51;190;583;2037;634;2227
220980;201409;1520;4516;1350;4210;148;520;895;2886;1043;3406
220985;201409;1373;3961;1300;3851;134;445;997;2934;1131;3379
220987;201409;1532;4901;1410;4691;114;498;1067;3458;1181;3956
220990;201409;1880;5416;1629;4985;75;310;1266;3803;1341;4113
220995;201409;1278;3796;1008;3384;90;369;764;2579;854;2948
220997;201409;2188;6944;2084;6775;106;374;1894;6158;2000;6532
221000;201409;4561;14072;4226;13507;505;1822;3089;9784;3594;11606
221005;201409;1468;4665;1361;4461;446;1367;689;2383;1135;3750
221010;201409;1277;3433;1101;3200;72;209;922;2696;994;2905
221020;201409;1955;6048;1821;5805;131;555;1362;4273;1493;4828
221030;201409;1847;5137;1594;4764;117;476;1247;3671;1364;4147
221035;201409;1607;4343;1452;4153;95;244;1278;3721;1373;3965
221037;201409;643;1962;577;1843;35;157;454;1389;489;1546
221038;201409;657;1837;520;1604;41;136;352;1097;393;1233
221039;201409;971;2806;899;2696;62;217;767;2270;829;2487
221040;201409;5289;16165;4971;15654;386;1321;3929;12497;4315;13818
221050;201409;3856;11817;3553;11388;226;884;3005;9569;3231;10453
221060;201409;9375;25643;7934;23637;915;2815;5940;17799;6855;20614
221062;201409;1298;4595;1198;4417;33;128;1110;4106;1143;4234
221063;201409;1164;3759;1081;3601;308;986;623;2225;931;3211
221065;201409;2861;8178;2637;7821;281;840;2071;6138;2352;6978
221070;201409;4424;13536;3991;12859;267;996;3183;10265;3450;11261
221080;201409;3631;9720;3222;9166;204;624;2673;7638;2877;8262
221090;201409;1400;3873;1208;3555;50;205;997;2867;1047;3072
221093;201409;1845;5509;1748;5313;406;1309;940;2798;1346;4107
221095;201409;1032;2736;885;2525;30;81;782;2244;812;2325
221097;201409;824;2361;725;2189;64;259;547;1620;611;1879
221100;201409;129190;391819;121407;378957;25163;85578;78504;240593;103667;326171
221110;201409;10467;34288;9973;33668;676;2579;8479;28620;9155;31199
221120;201409;4608;15147;4412;14800;1003;3396;2884;9900;3887;13296
221130;201409;4821;14236;4202;12979;1231;3947;2019;6212;3250;10159
221135;201409;1521;4794;1419;4641;161;609;1119;3609;1280;4218
221140;201409;1450;3640;1332;3483;104;273;1126;2954;1230;3227
221150;201409;1264;3262;1047;2887;36;155;833;2262;869;2417
221160;201409;918;2410;858;2316;60;182;659;1787;719;1969
221170;201409;1168;3688;1087;3541;78;312;885;2841;963;3153
230010;201409;3478;9431;2848;8352;182;623;2283;6685;2465;7308
230015;201409;2772;9721;2590;9303;400;1682;1682;5905;2082;7587
230020;201409;14774;48464;14237;47488;879;3202;11881;39897;12760;43099
230030;201409;13007;37894;12031;36385;871;2940;9763;29503;10634;32443
230040;201409;4666;13128;3952;11894;306;1104;3066;9121;3372;10225
230050;201409;2547;8849;2005;7408;398;1609;905;3312;1303;4921
230060;201409;2129;6295;1865;5806;126;463;1422;4377;1548;4840
230070;201409;4417;12247;3841;11375;374;1195;2849;8553;3223;9748
230075;201409;9256;33277;8649;32010;814;3817;6681;24372;7495;28189
230080;201409;2441;6673;2042;6094;126;435;1654;4918;1780;5353
230090;201409;3660;11034;3248;10299;342;1243;2429;7667;2771;8910
230100;201409;18018;55164;16476;52188;3972;13231;8830;28266;12802;41497
230110;201409;14311;46689;13324;44599;2637;9445;7819;26129;10456;35574
230120;201409;8333;22961;7328;21547;848;2525;5449;16295;6297;18820
230125;201409;2942;8681;2438;7715;191;723;1797;5623;1988;6346
230130;201409;5791;19163;4898;17214;515;2132;3410;11782;3925;13914
230140;201409;3636;11738;3121;10794;458;1661;2047;7257;2505;8918
230150;201409;1799;5707;1567;5227;286;1094;977;3146;1263;4240
230160;201409;6622;19759;5748;18466;478;1784;4411;14142;4889;15926
230170;201409;6766;21352;5813;19576;553;2164;4226;14100;4779;16264
230180;201409;1977;5705;1730;5253;147;546;1219;3642;1366;4188
230185;201409;4350;14369;3969;13664;707;2445;2504;8959;3211;11404
230190;201409;13031;42439;11831;40043;2577;9745;6136;20456;8713;30201
230195;201409;5238;16208;4692;15338;340;1435;3679;11690;4019;13125
230200;201409;5896;17141;5292;15972;650;2083;3770;11349;4420;13432
230205;201409;4507;14150;4018;13320;319;1344;2927;9674;3246;11018
230210;201409;9628;27681;8409;25766;2094;6498;4650;14712;6744;21210
230220;201409;14202;41228;12858;38910;1666;5711;9003;26876;10669;32587
230230;201409;7760;25385;6936;23708;1027;3717;4421;15250;5448;18967
230240;201409;13890;40067;12355;37349;813;3087;9660;28598;10473;31685
230250;201409;10384;32162;10163;31834;508;1897;8634;26939;9142;28836
230260;201409;15322;51608;14206;49340;2952;10787;8074;28683;11026;39470
230270;201409;7024;21438;6168;19937;708;2482;4468;14531;5176;17013
230280;201409;19503;59119;17473;55586;2229;7201;12515;40137;14744;47338
230290;201409;4865;15121;4220;13803;580;1941;2883;9485;3463;11426
230300;201409;4960;15167;4727;14819;521;1879;3585;11108;4106;12987
230310;201409;5022;15057;4378;13968;368;1472;3230;10089;3598;11561
230320;201409;7591;24328;7032;23344;760;2875;5239;17403;5999;20278
230330;201409;4833;14438;4269;13357;347;1282;3104;9586;3451;10868
230340;201409;3536;12268;3296;11752;511;2052;2091;7314;2602;9366
230350;201409;18743;57642;16910;54474;2731;9451;10731;35088;13462;44539
230360;201409;3195;9364;2676;8387;320;1135;1848;5724;2168;6859
230365;201409;3164;8829;2758;8165;166;597;2187;6434;2353;7031
230370;201409;58116;190508;53344;182070;15777;55681;25616;90529;41393;146210
230380;201409;7278;21168;6195;19292;561;1970;4412;13741;4973;15711
230390;201409;3753;11786;3321;11061;376;1532;2331;7651;2707;9183
230393;201409;3441;11424;2946;10381;301;1408;2061;6997;2362;8405
230395;201409;5240;16244;4823;15473;758;2634;3118;10045;3876;12679
230400;201409;5372;16649;4644;15519;355;1533;3609;11820;3964;13353
230410;201409;15909;50434;14193;47096;2428;8634;8480;28185;10908;36819
230420;201409;25581;83642;23354;79037;5748;21086;11536;38843;17284;59929
230423;201409;4966;16044;4587;15308;529;1953;3183;10794;3712;12747
230425;201409;5650;18906;5143;17751;740;2723;3445;11887;4185;14610
230426;201409;2905;8123;2350;7087;158;647;1731;5078;1889;5725
230427;201409;1804;5512;1368;4567;149;572;914;2945;1063;3517
230428;201409;9485;30798;9144;30202;1744;6411;5808;19032;7552;25443
230430;201409;4666;15055;4373;14492;452;1804;3130;10173;3582;11977
230435;201409;5217;16931;4665;15956;989;3771;2480;8502;3469;12273
230440;201409;370648;1143564;345573;1098192;88207;299489;171637;548332;259844;847821
230445;201409;4849;13073;4087;11954;354;1017;3068;9160;3422;10177
230450;201409;3821;12181;3263;11173;460;1823;2120;7231;2580;9054
230460;201409;1963;6539;1774;6189;199;804;1265;4385;1464;5189
230465;201409;4325;12934;3536;11501;312;1326;2411;7642;2723;8968
230470;201409;11509;42080;10984;41002;1475;5757;7844;29816;9319;35573
230480;201409;1511;4882;1297;4466;197;722;836;2901;1033;3623
230490;201409;2916;8612;2528;7879;469;1642;1325;4043;1794;5685
230495;201409;5863;19700;5306;18766;892;3730;3112;10993;4004;14723
230500;201409;10824;36981;10334;36115;950;3659;7837;27954;8787;31613
230510;201409;1537;5529;1242;4767;320;1326;460;1833;780;3159
230520;201409;5140;15679;4508;14545;495;1869;3062;9810;3557;11679
230523;201409;14651;48403;13099;44799;3618;13558;3910;13618;7528;27176
230526;201409;4266;13078;3757;12195;396;1518;2712;8772;3108;10290
230530;201409;5526;18297;5033;17623;1008;3603;3399;12112;4407;15715
230533;201409;4091;11665;3645;10822;274;905;2832;8329;3106;9234
230535;201409;5533;16505;4814;15195;592;1885;3324;10721;3916;12606
230540;201409;19588;56147;17319;52729;1054;3902;14298;43171;15352;47073
230550;201409;19587;59609;17692;55896;3785;12889;9543;29964;13328;42853
230560;201409;6701;19459;5980;18160;272;1085;4828;14506;5100;15591
230565;201409;3387;9677;2737;8403;221;804;1961;5929;2182;6733
230570;201409;4057;11065;3606;10500;238;850;2988;8608;3226;9458
230580;201409;10706;32785;10094;31913;619;1998;8720;27860;9339;29858
230590;201409;8972;28489;7890;26422;642;2757;5924;19341;6566;22098
230600;201409;3600;10264;2722;8438;198;695;1827;5602;2025;6297
230610;201409;6327;20675;5898;19978;788;2860;4228;14464;5016;17324
230620;201409;2155;6136;1741;5246;167;594;1097;3187;1264;3781
230625;201409;8002;26332;7140;24359;2132;7807;2305;7917;4437;15724
230630;201409;11558;37429;10534;35476;2719;8735;5204;18734;7923;27469
230640;201409;27770;91707;25953;88972;3514;12841;19102;66066;22616;78907
230650;201409;5085;15859;4575;14862;371;1551;3492;11075;3863;12626
230655;201409;8907;33837;8555;33231;704;2845;7179;28261;7883;31106
230660;201409;6551;20425;5727;18923;532;2100;4149;13755;4681;15855
230670;201409;6107;16590;4931;14562;284;1092;3837;10974;4121;12066
230680;201409;2860;8412;2395;7535;368;1242;1456;4576;1824;5818
230690;201409;6264;20775;6144;20537;518;2176;4471;14634;4989;16810
230700;201409;9507;27572;8428;25626;846;3155;5925;17482;6771;20637
230710;201409;7730;25171;6820;23497;860;3019;4891;17174;5751;20193
230720;201409;2009;6313;1733;5779;236;832;1153;3903;1389;4735
230725;201409;3800;12875;3335;11730;751;2772;1596;5575;2347;8347
230730;201409;58961;180605;49435;164929;13795;50024;19849;67577;33644;117601
230740;201409;5734;17813;5294;17038;294;1282;4395;13921;4689;15203
230750;201409;9315;26705;7885;24409;682;2453;6010;18507;6692;20960
230760;201409;9935;30237;9349;28974;1008;3805;6819;20332;7827;24137
230763;201409;4356;13664;3998;12965;284;1307;3076;9628;3360;10935
230765;201409;42697;139805;39400;133045;12415;44828;14142;48381;26557;93209
230770;201409;24354;68443;22486;65777;2340;7541;16614;48622;18954;56163
230780;201409;6195;24138;5883;23419;1524;6137;2943;12452;4467;18589
230790;201409;2665;8982;2515;8728;303;1131;1911;6683;2214;7814
230800;201409;8118;29022;7393;27378;1769;7003;3527;13076;5296;20079
230810;201409;12863;41885;12200;40753;1312;4539;9449;32057;10761;36596
230820;201409;3556;12053;3118;11086;555;2219;1774;6295;2329;8514
230830;201409;8033;24376;7168;22798;783;2851;5012;15883;5795;18734
230835;201409;4245;11517;3564;10553;316;1062;2765;8138;3081;9200
230837;201409;3197;10924;2765;10041;337;1408;1884;6820;2221;8228
230840;201409;9654;31865;8829;30395;1089;4051;6356;22184;7445;26235
230850;201409;11539;35029;10673;33827;1346;4657;7850;24943;9196;29600
230860;201409;5250;15588;4758;14740;363;1338;3685;11344;4048;12682
230870;201409;19430;53446;17419;50153;1517;4985;13260;37914;14777;42899
230880;201409;1982;6867;1841;6579;244;1011;1219;4336;1463;5347
230890;201409;4168;15114;3803;14322;562;2497;2451;9045;3013;11542
230900;201409;3036;10190;2622;9319;569;1991;1362;4979;1931;6970
230910;201409;3107;9220;2497;8066;217;881;1798;5680;2015;6561
230920;201409;4875;14237;4482;13753;298;997;3787;11781;4085;12778
230930;201409;7984;24354;7136;22769;869;2948;4943;15836;5812;18784
230940;201409;7789;22359;6843;20940;445;1421;5553;17097;5998;18518
230945;201409;6133;18451;5256;17167;568;2103;3713;12302;4281;14405
230950;201409;7190;19659;6172;18292;426;1343;4867;14531;5293;15874
230960;201409;13190;42033;12101;39912;2631;9424;6117;20250;8748;29674
230970;201409;13940;44225;12537;41488;2743;10219;6064;19693;8807;29912
230980;201409;3024;9761;2630;8979;819;2839;1201;4271;2020;7110
230990;201409;1645;5105;1360;4514;153;638;896;2898;1049;3536
231000;201409;2926;7944;2310;6764;261;880;1476;4191;1737;5071
231010;201409;3276;9076;2794;8307;282;1051;2091;6093;2373;7144
231020;201409;8289;27714;7819;26766;1417;5029;4887;17079;6304;22108
231025;201409;8108;25415;7322;24032;1139;3881;4784;16073;5923;19954
231030;201409;8199;26917;6908;24217;1292;4902;3977;14036;5269;18938
231040;201409;3110;10208;2770;9505;244;1043;1981;6650;2225;7693
231050;201409;12516;36139;10754;32916;1046;3655;7848;23886;8894;27541
231060;201409;2489;8002;2275;7611;204;929;1631;5291;1835;6220
231070;201409;9573;30266;8769;28680;1631;5614;5259;17308;6890;22922
231080;201409;4408;13802;4027;13130;253;1156;3033;9556;3286;10712
231085;201409;4947;15834;4774;15569;724;2317;3486;11708;4210;14025
231090;201409;4155;11790;3379;10237;186;709;2468;7355;2654;8064
231095;201409;2272;7523;1957;6868;231;903;1305;4637;1536;5540
231100;201409;3124;9769;2617;8753;239;931;1884;6218;2123;7149
231110;201409;3828;12798;3739;12644;403;1534;2741;9297;3144;10831
231120;201409;2428;7940;2252;7622;386;1363;1453;4992;1839;6355
231123;201409;2272;6162;1915;5582;167;469;1506;4427;1673;4896
231126;201409;6866;19036;5565;17112;421;1591;4174;12664;4595;14255
231130;201409;20701;64619;18874;61442;4399;14699;10591;35900;14990;50599
231135;201409;4753;13941;3990;12742;408;1547;2928;9203;3336;10750
231140;201409;16230;52598;14693;49544;1467;6620;10042;32622;11509;39242
231150;201409;6103;17723;5192;16009;950;3232;2825;8512;3775;11744
231160;201409;6103;20691;5764;20029;1136;4194;3682;12821;4818;17015
231170;201409;4882;15624;4446;14734;516;2031;3006;9800;3522;11831
231180;201409;14180;43005;12839;40347;2168;7464;8035;24879;10203;32343
231190;201409;5141;14343;4291;13117;334;1199;3318;10016;3652;11215
231195;201409;4710;16025;4062;14729;420;1816;2925;10583;3345;12399
231200;201409;7881;27189;6866;25085;638;3030;4909;17557;5547;20587
231210;201409;5312;16360;4578;15316;323;1365;3544;11946;3867;13311
231220;201409;14445;40930;12274;37187;1236;4419;8179;24730;9415;29149
231230;201409;9061;31643;8454;30594;924;3906;6426;23178;7350;27084
231240;201409;12427;39498;11124;37045;2105;7587;6195;20921;8300;28508
231250;201409;2049;5991;1413;4446;311;958;534;1638;845;2596
231260;201409;4087;11661;3677;11069;536;1627;2449;7568;2985;9195
231270;201409;7894;22106;6948;20580;643;2507;5077;14615;5720;17122
231280;201409;1769;5826;1646;5587;158;565;1218;4167;1376;4732
231290;201409;32922;115078;29838;107702;6882;27710;13262;46759;20144;74469
231300;201409;4766;13928;3873;12124;331;1272;2757;8369;3088;9641
231310;201409;7756;22315;6514;19780;1224;3863;3583;10772;4807;14635
231320;201409;6911;21496;5947;19609;360;1477;4428;14539;4788;16016
231325;201409;2632;8020;2331;7498;173;657;1748;5631;1921;6288
231330;201409;14435;44814;12150;40431;2015;6792;7516;25372;9531;32164
231335;201409;5326;15409;4616;14111;322;1259;3646;10916;3968;12175
231340;201409;18466;60565;17269;58853;1385;4598;14029;49099;15414;53697
231350;201409;13219;43590;12900;43102;1483;4675;10383;35498;11866;40173
231355;201409;4337;14237;4123;13868;279;1043;3358;11374;3637;12417
231360;201409;7496;24762;6840;23583;1604;5411;4074;14644;5678;20055
231370;201409;2476;6978;1975;6194;116;431;1500;4643;1616;5074
231375;201409;4128;14420;3913;14001;350;1560;3065;10822;3415;12382
231380;201409;5407;17586;5082;17127;788;2798;3487;12047;4275;14845
231390;201409;3522;11145;3312;10814;276;1131;2495;8047;2771;9178
231395;201409;4266;13785;3812;13039;743;2644;2300;8013;3043;10657
231400;201409;10647;31854;9669;30061;1004;3585;6734;20990;7738;24575
231410;201409;13834;47293;12890;45883;1204;4487;10065;36407;11269;40894
240010;201409;2582;7992;2239;7265;539;1945;1005;3129;1544;5074
240020;201409;12069;37926;10750;35406;2777;9719;5110;17116;7887;26835
240030;201409;2679;7819;2594;7680;218;762;2077;6065;2295;6827
240040;201409;841;2526;713;2269;50;229;513;1555;563;1784
240050;201409;3833;10438;3287;9506;231;801;2501;7138;2732;7939
240060;201409;1491;4458;1392;4279;133;488;1072;3211;1205;3699
240070;201409;2950;8536;2793;8247;495;1534;1800;5262;2295;6796
240080;201409;3197;8604;2808;8103;271;729;2168;6405;2439;7134
240090;201409;2330;6376;1970;5705;76;304;1567;4437;1643;4741
240100;201409;10664;30497;9790;28753;1288;4436;6127;17749;7415;22185
240110;201409;5282;16186;4679;15063;853;3090;2790;8667;3643;11757
240120;201409;3090;10269;2957;10020;546;1988;1881;6502;2427;8490
240130;201409;2893;7853;2491;7233;205;709;1946;5566;2151;6275
240140;201409;2306;7014;2023;6493;401;1480;1122;3512;1523;4992
240145;201409;6372;20022;5747;18913;1505;5480;2969;9767;4474;15247
240150;201409;1043;3151;856;2782;112;453;520;1622;632;2075
240160;201409;1427;4655;1260;4366;179;689;785;2784;964;3473
240165;201409;966;3077;841;2821;111;370;541;1873;652;2243
240170;201409;2583;7762;2296;7232;627;2145;1016;3196;1643;5341
240180;201409;3043;9542;2829;9160;722;2429;1473;4950;2195;7379
240185;201409;1529;5086;1474;4985;166;575;1119;3864;1285;4439
240190;201409;944;2895;858;2734;58;249;657;2034;715;2283
240200;201409;14328;37202;11917;34100;2524;7388;6758;20056;9282;27444
240210;201409;2858;8157;2635;7851;225;775;2170;6412;2395;7187
240220;201409;7414;24130;7041;23606;410;1817;6082;20167;6492;21984
240230;201409;5831;16137;5241;15159;432;1395;4146;11877;4578;13272
240240;201409;1901;5838;1403;4580;381;1366;301;865;682;2231
240250;201409;2931;8464;2774;8242;214;711;2249;6646;2463;7357
240260;201409;15149;50443;14417;49242;2528;9529;9332;32089;11860;41618
240270;201409;2519;8086;2328;7774;255;850;1729;5913;1984;6763
240280;201409;1699;4820;1522;4514;127;444;1134;3331;1261;3775
240290;201409;1454;4549;1250;4176;118;561;812;2613;930;3174
240300;201409;2218;6258;1583;4851;420;1377;545;1610;965;2987
240310;201409;10741;30553;9735;28916;2118;6835;5305;15746;7423;22581
240320;201409;2095;6277;1708;5463;114;484;1240;3829;1354;4313
240325;201409;39718;109718;31088;95421;9955;32847;9254;29057;19209;61904
240330;201409;1594;4805;1346;4313;158;630;851;2637;1009;3267
240340;201409;1811;5250;1551;4836;198;662;1109;3460;1307;4122
240350;201409;2205;6591;2061;6387;213;752;1675;5157;1888;5909
240360;201409;7557;22757;6603;21339;1265;4339;4014;13329;5279;17668
240370;201409;2092;5740;1779;5200;165;529;1259;3688;1424;4217
240375;201409;920;2444;814;2283;159;507;481;1308;640;1815
240380;201409;2739;8166;2196;6933;301;994;1279;4003;1580;4997
240390;201409;988;2732;834;2436;77;285;601;1706;678;1991
240400;201409;1524;4085;1288;3711;150;515;934;2607;1084;3122
240410;201409;559;1808;511;1709;87;342;323;1071;410;1413
240420;201409;4999;18963;4777;18457;1330;5087;2493;10208;3823;15295
240430;201409;3698;10482;3402;9975;323;1083;2531;7346;2854;8429
240440;201409;2860;7599;2608;7171;674;1872;1366;3792;2040;5664
240450;201409;3633;10987;3244;10241;364;1465;2169;6611;2533;8076
240460;201409;3058;9490;2913;9291;278;1047;2335;7365;2613;8412
240470;201409;3692;11407;2970;9871;391;1432;1843;6072;2234;7504
240480;201409;475;1241;394;1071;42;115;239;637;281;752
240485;201409;2159;6626;1903;6137;375;1301;1089;3534;1464;4835
240490;201409;1752;4437;1501;4065;90;326;1185;3093;1275;3419
240500;201409;2233;6586;2089;6356;209;702;1583;4815;1792;5517
240510;201409;1887;5660;1746;5406;214;671;1316;4135;1530;4806
240520;201409;1484;4308;1297;4037;194;682;900;2738;1094;3420
240530;201409;2275;7222;2042;6851;288;1010;1436;4850;1724;5860
240540;201409;1869;5706;1787;5568;169;595;1357;4231;1526;4826
240550;201409;835;2376;724;2187;64;218;551;1627;615;1845
240560;201409;3339;9775;3159;9504;309;939;2558;7741;2867;8680
240570;201409;3187;9038;2567;7657;595;1963;1070;2903;1665;4866
240580;201409;8399;25828;7894;24959;1113;3740;5881;18536;6994;22276
240590;201409;844;2373;730;2166;57;217;532;1533;589;1750
240600;201409;1612;4757;1269;4049;170;652;732;2225;902;2877
240610;201409;5149;14440;4455;13164;643;2033;2724;7893;3367;9926
240615;201409;1069;3104;886;2752;154;499;497;1542;651;2041
240620;201409;1782;5709;1625;5436;194;719;1245;4166;1439;4885
240630;201409;2154;6549;2020;6317;213;579;1496;4916;1709;5495
240640;201409;970;2849;813;2585;95;387;544;1690;639;2077
240650;201409;3946;12041;3626;11574;296;1053;2906;9343;3202;10396
240660;201409;2567;8164;2433;7955;268;940;1850;6115;2118;7055
240670;201409;2811;8414;2369;7506;358;1259;1338;4157;1696;5416
240680;201409;1545;4562;1255;4036;148;532;778;2500;926;3032
240690;201409;1139;3176;987;2933;104;369;722;2119;826;2488
240700;201409;2707;8165;2262;7326;119;557;1751;5522;1870;6079
240710;201409;19028;49031;16846;46128;3204;8611;10499;29716;13703;38327
240720;201409;5912;16834;5592;16353;1733;5419;2679;7684;4412;13103
240725;201409;1090;3278;845;2732;87;308;490;1551;577;1859
240730;201409;2394;7246;2072;6652;216;766;1466;4692;1682;5458
240740;201409;2272;6807;2039;6383;270;912;1337;4192;1607;5104
240750;201409;2331;8655;2137;8293;467;1984;1183;4663;1650;6647
240760;201409;1327;3812;1229;3679;121;298;955;3046;1076;3344
240770;201409;3667;10533;3304;10002;359;1223;2458;7462;2817;8685
240780;201409;6085;16901;4894;15016;877;2834;2850;8928;3727;11762
240790;201409;881;2733;718;2441;50;211;534;1817;584;2028
240800;201409;42157;121925;38246;115204;10832;34195;16322;50068;27154;84263
240810;201409;100968;297754;94666;286488;28234;88076;45502;139853;73736;227929
240820;201409;7126;21237;6124;19636;1300;4528;3085;10293;4385;14821
240830;201409;9685;29616;9071;28730;697;2320;7475;24045;8172;26365
240840;201409;1329;3694;1144;3381;144;488;692;2019;836;2507
240850;201409;1321;3931;970;3167;181;658;510;1608;691;2266
240860;201409;1378;3888;1158;3513;100;352;855;2541;955;2893
240870;201409;1205;3359;1018;2997;130;453;661;1853;791;2306
240880;201409;1221;4154;1154;4053;144;590;843;2937;987;3527
240890;201409;5572;15738;4797;14341;980;3204;2416;7114;3396;10318
240895;201409;2848;9713;2575;9220;352;1339;1776;6475;2128;7814
240910;201409;2828;8843;2561;8347;231;896;1914;6176;2145;7072
240920;201409;879;2819;782;2598;218;792;333;1067;551;1859
240930;201409;3754;10055;3368;9556;302;881;2672;7690;2974;8571
240933;201409;1560;4512;1386;4217;216;744;870;2646;1086;3390
240940;201409;6825;19099;5719;17176;1075;3419;3209;9606;4284;13025
240950;201409;1218;3766;1147;3647;113;452;823;2601;936;3053
240960;201409;826;2569;732;2386;91;337;515;1671;606;2008
240970;201409;1994;5570;1661;4995;138;495;1219;3577;1357;4072
240980;201409;3404;11091;3167;10647;663;2404;1931;6471;2594;8875
240990;201409;3120;9284;2927;8897;540;1804;1824;5430;2364;7234
241000;201409;1118;3129;968;2870;82;288;707;2063;789;2351
241010;201409;2995;10059;2724;9544;397;1679;1909;6483;2306;8162
241020;201409;2199;6181;1799;5406;153;549;1152;3331;1305;3880
241025;201409;1575;4852;1418;4551;108;460;1025;3207;1133;3667
241030;201409;2609;8561;2345;8086;203;793;1806;6259;2009;7052
241040;201409;2278;7866;2081;7504;224;940;1509;5484;1733;6424
241050;201409;1391;4119;1240;3862;112;442;921;2793;1033;3235
241060;201409;1017;2924;924;2764;111;352;673;2020;784;2372
241070;201409;954;2716;832;2498;97;342;575;1672;672;2014
241080;201409;1227;3638;1045;3298;91;374;730;2235;821;2609
241090;201409;2190;6356;1871;5781;124;534;1506;4574;1630;5108
241100;201409;1227;3665;1051;3269;129;431;667;2045;796;2476
241105;201409;1205;3684;1129;3540;209;706;653;2114;862;2820
241110;201409;875;2787;732;2470;79;345;457;1510;536;1855
241120;201409;8020;24248;7315;23124;1470;4686;4759;15454;6229;20140
241140;201409;3574;9955;3153;9133;414;1263;2150;6153;2564;7416
241142;201409;714;2139;514;1699;134;507;150;447;284;954
241150;201409;5981;17794;5396;16809;837;2732;3621;11433;4458;14165
241160;201409;1136;3307;1067;3175;169;544;744;2206;913;2750
241170;201409;1401;4108;1281;3888;176;586;805;2545;981;3131
241180;201409;984;2768;778;2341;99;327;446;1303;545;1630
241190;201409;1176;3253;963;2821;81;304;631;1749;712;2053
241200;201409;21523;64077;19765;61226;5285;17172;9853;31165;15138;48337
241210;201409;1579;4576;1314;4030;276;928;643;1945;919;2873
241220;201409;8138;27307;7712;26481;1881;6693;4272;15007;6153;21700
241230;201409;3175;9390;2903;8994;219;835;2364;7248;2583;8083
241240;201409;1158;3407;870;2778;111;382;461;1521;572;1903
241250;201409;5767;18155;4922;16491;312;1526;3924;12813;4236;14339
241255;201409;1863;7115;1761;6888;455;1893;812;3275;1267;5168
241260;201409;5232;14146;4221;12580;332;1274;3055;8920;3387;10194
241270;201409;2114;6357;1853;5854;253;886;1124;3568;1377;4454
241280;201409;2182;6350;2024;6043;315;1011;1346;4043;1661;5054
241290;201409;3381;9315;2708;8241;455;1449;1675;5107;2130;6556
241300;201409;1486;4293;1317;4006;85;265;1009;3118;1094;3383
241310;201409;1581;4936;1495;4795;233;736;1030;3409;1263;4145
241320;201409;959;3203;885;3045;154;570;519;1797;673;2367
241330;201409;1567;4932;1449;4779;144;560;1179;3869;1323;4429
241335;201409;2729;8373;2564;8082;175;568;2170;6859;2345;7427
241340;201409;1996;6182;1767;5686;434;1529;863;2732;1297;4261
241350;201409;1965;6285;1818;6003;183;775;1357;4347;1540;5122
241355;201409;1350;3813;1157;3486;65;213;1013;3042;1078;3255
241360;201409;2224;6111;1920;5543;137;460;1398;3886;1535;4346
241370;201409;1369;4221;1109;3670;192;683;580;1889;772;2572
241380;201409;745;2140;637;1923;111;373;350;1062;461;1435
241390;201409;3035;10010;2842;9647;531;1911;1860;6413;2391;8324
241400;201409;3625;10820;3383;10481;384;1340;2614;8150;2998;9490
241410;201409;2808;8218;2518;7825;386;1295;1793;5595;2179;6890
241415;201409;1702;5194;1559;4943;118;465;1188;3707;1306;4172
241420;201409;2310;7993;2019;7483;684;2840;655;2373;1339;5213
241430;201409;537;1623;436;1389;52;188;282;869;334;1057
241440;201409;6140;22316;5742;21635;1103;4359;3880;14821;4983;19180
241445;201409;1085;3249;1016;3153;140;361;787;2583;927;2944
241450;201409;3351;9301;3014;8799;500;1570;2018;5850;2518;7420
241460;201409;3695;10770;3271;9944;273;1002;2346;7055;2619;8057
241470;201409;1388;3910;1175;3655;129;507;868;2644;997;3151
241475;201409;1274;3960;1119;3669;70;336;819;2624;889;2960
241480;201409;3356;10815;3029;10322;1058;3624;1163;4361;2221;7985
241490;201409;650;1743;534;1560;47;180;360;1005;407;1185
241500;201409;758;2393;690;2295;38;165;597;1958;635;2123
250010;201409;2807;8744;2443;8101;224;921;1835;5958;2059;6879
250020;201409;1713;4916;1315;4200;107;475;876;2673;983;3148
250030;201409;8270;23315;7488;22221;861;2590;5739;17326;6600;19916
250040;201409;4613;15460;4261;14751;761;2794;2658;9285;3419;12079
250050;201409;3815;11854;3556;11489;460;1677;2553;8327;3013;10004
250053;201409;1368;4022;1261;3884;204;645;837;2610;1041;3255
250057;201409;708;2816;690;2795;36;102;612;2612;648;2714
250060;201409;5169;16165;4931;15798;645;2329;3760;11889;4405;14218
250070;201409;3892;12191;3641;11739;218;971;3026;9490;3244;10461
250073;201409;806;2445;719;2286;70;257;534;1694;604;1951
250077;201409;2339;6830;1950;6209;266;927;1161;3729;1427;4656
250080;201409;4862;14149;4693;13905;561;1726;3558;10594;4119;12320
250090;201409;2616;7796;2514;7634;131;464;2122;6346;2253;6810
250100;201409;4076;13611;3888;13279;446;1726;2982;10136;3428;11862
250110;201409;5914;17782;5639;17393;755;2633;4262;13034;5017;15667
250115;201409;554;1801;486;1637;40;202;288;904;328;1106
250120;201409;2270;6743;1956;6151;191;686;1447;4531;1638;5217
250130;201409;5820;17824;5486;17358;335;1146;4620;14829;4955;15975
250135;201409;1106;3390;1011;3225;117;408;706;2260;823;2668
250140;201409;2177;7037;2007;6811;225;835;1520;5230;1745;6065
250150;201409;5138;17305;4703;16474;479;2002;3420;11865;3899;13867
250153;201409;1602;4279;1435;4034;120;416;1116;3134;1236;3550
250157;201409;1780;6024;1637;5723;301;1093;1034;3671;1335;4764
250160;201409;3422;10580;3321;10414;211;739;2859;9042;3070;9781
250170;201409;1658;4886;1539;4697;295;929;988;3097;1283;4026
250180;201409;17200;53110;16590;52100;2344;8530;11946;36663;14290;45193
250190;201409;4120;12128;3799;11597;643;2078;2483;7470;3126;9548
250200;201409;2282;6306;1823;5678;136;501;1501;4638;1637;5139
250205;201409;1037;3376;941;3193;93;419;616;2132;709;2551
250210;201409;1676;5433;1551;5248;183;760;1121;3731;1304;4491
250215;201409;1453;4967;1412;4892;206;798;896;3122;1102;3920
250220;201409;837;2381;694;2200;46;171;590;1853;636;2024
250230;201409;1792;4510;1454;3957;131;418;1144;3026;1275;3444
250240;201409;2733;8691;2407;8182;203;727;1833;6313;2036;7040
250250;201409;4676;14046;4288;13518;375;1204;3507;11189;3882;12393
250260;201409;1933;5869;1680;5446;149;586;1248;4009;1397;4595
250270;201409;1357;4222;1206;4033;155;533;909;3101;1064;3634
250280;201409;3870;11599;3561;11106;658;2126;2328;7524;2986;9650
250290;201409;2153;5741;1774;5250;65;246;1558;4605;1623;4851
250300;201409;5615;16529;5313;16148;616;2506;4264;12412;4880;14918
250310;201409;1185;3746;1073;3559;148;567;786;2581;934;3148
250320;201409;8133;25541;7724;24709;1077;3907;5257;16384;6334;20291
250330;201409;2691;8345;2319;7837;256;1002;1762;5915;2018;6917
250340;201409;1156;3370;1068;3230;52;172;915;2775;967;2947
250350;201409;4628;12625;4208;12112;189;611;3683;10731;3872;11342
250355;201409;2190;6693;1987;6394;153;646;1541;4886;1694;5532
250360;201409;2092;6229;1945;6026;115;425;1551;4833;1666;5258
250370;201409;13763;39048;11886;36808;1217;3987;9788;30477;11005;34464
250375;201409;1126;3543;1058;3429;62;250;894;2890;956;3140
250380;201409;1723;4890;1624;4763;97;332;1421;4158;1518;4490
250390;201409;1968;5288;1602;4676;221;656;1056;3122;1277;3778
250400;201409;74413;203369;63291;185776;15480;47850;32683;97832;48163;145682
250403;201409;1608;5254;1508;5116;205;783;1095;3695;1300;4478
250407;201409;1203;3463;1046;3200;69;224;819;2483;888;2707
250410;201409;688;2190;606;2043;68;283;461;1539;529;1822
250415;201409;1842;5786;1676;5468;141;542;1228;3938;1369;4480
250420;201409;1350;4179;1247;4019;100;403;1028;3242;1128;3645
250430;201409;6823;19049;6368;18386;497;1732;5214;14773;5711;16505
250435;201409;1679;5051;1493;4691;220;803;883;2815;1103;3618
250440;201409;4711;13800;4401;13371;302;933;3621;11093;3923;12026
250450;201409;2106;5997;1863;5676;99;339;1662;5071;1761;5410
250460;201409;6592;19845;6107;19189;743;2501;4615;14635;5358;17136
250470;201409;1637;4557;1467;4316;150;537;1050;2993;1200;3530
250480;201409;4123;12315;3718;11732;157;649;3218;10111;3375;10760
250485;201409;641;1662;542;1499;27;94;430;1149;457;1243
250490;201409;4280;13813;4175;13662;954;3293;2629;8657;3583;11950
250500;201409;1960;5922;1800;5651;386;1220;1049;3393;1435;4613
250510;201409;5038;14119;4455;13316;304;1096;3673;10936;3977;12032
250520;201409;1936;5962;1833;5785;329;1180;1098;3381;1427;4561
250523;201409;1838;5794;1743;5661;251;858;1271;4180;1522;5038
250527;201409;1527;4575;1437;4458;61;255;1294;3975;1355;4230
250530;201409;697;2120;613;2012;49;165;502;1680;551;1845
250535;201409;1344;4275;1278;4140;83;358;1013;3222;1096;3580
250540;201409;2512;7488;2355;7313;78;235;2172;6830;2250;7065
250550;201409;907;3045;834;2932;65;273;644;2239;709;2512
250560;201409;1819;5788;1780;5731;142;496;1517;4900;1659;5396
250570;201409;2576;8359;2293;7814;208;840;1725;5813;1933;6653
250580;201409;1203;3268;982;2918;103;428;706;1989;809;2417
250590;201409;1062;3250;956;3109;91;370;739;2367;830;2737
250600;201409;7195;21180;6815;20624;486;1424;5698;17468;6184;18892
250610;201409;3550;10357;3279;9948;395;1318;2354;7148;2749;8466
250620;201409;874;2538;809;2409;158;516;502;1470;660;1986
250625;201409;2311;7439;2275;7392;78;195;2121;6991;2199;7186
250630;201409;10699;34241;10140;33247;2275;7925;5837;19235;8112;27160
250640;201409;3952;11746;3696;11443;284;1067;3114;9539;3398;10606
250650;201409;966;2811;892;2671;127;450;530;1594;657;2044
250660;201409;2161;5341;1652;4733;29;74;1571;4528;1600;4602
250670;201409;2812;9346;2665;9074;270;1111;1991;6743;2261;7854
250680;201409;5080;14520;4839;14179;270;905;4189;12309;4459;13214
250690;201409;6480;17201;6247;16897;570;1703;5335;14294;5905;15997
250700;201409;5503;16359;5078;15737;795;2664;3490;10717;4285;13381
250710;201409;4763;14964;4366;14448;673;2263;3046;10369;3719;12632
250720;201409;2689;7972;2555;7750;144;565;2152;6476;2296;7041
250730;201409;3786;11685;3598;11409;446;1592;2674;8405;3120;9997
250740;201409;2102;6166;1843;5739;198;713;1345;4123;1543;4836
250750;201409;105863;311270;99515;301511;17560;58180;66002;197850;83562;256030
250760;201409;2331;6833;2154;6569;182;674;1697;5113;1879;5787
250770;201409;4120;14027;3901;13729;727;2781;2504;8866;3231;11647
250780;201409;1951;5764;1675;5249;199;772;1081;3266;1280;4038
250790;201409;2528;8239;2393;8046;556;1800;1535;5365;2091;7165
250800;201409;2856;8200;2492;7579;153;561;1934;5750;2087;6311
250810;201409;1400;4106;1214;3828;118;473;956;2954;1074;3427
250820;201409;2109;6412;2026;6294;124;412;1708;5373;1832;5785
250830;201409;6107;20190;5746;19462;785;3087;3933;13127;4718;16214
250840;201409;1053;3374;919;3101;119;449;590;2005;709;2454
250850;201409;2476;7155;2199;6704;214;829;1450;4572;1664;5401
250855;201409;1119;3394;1052;3290;93;342;828;2529;921;2871
250860;201409;3087;10247;2774;9660;679;2657;1089;3726;1768;6383
250870;201409;1218;3465;1057;3201;71;275;779;2286;850;2561
250880;201409;1467;4224;1326;4028;189;596;955;2906;1144;3502
250890;201409;10036;31322;9375;30408;1570;5873;6325;20132;7895;26005
250900;201409;3134;10224;2780;9556;356;1237;1929;6737;2285;7974
250905;201409;2151;6773;2053;6645;351;1175;1472;4827;1823;6002
250910;201409;5550;16110;5175;15549;494;1643;4045;12138;4539;13781
250915;201409;1749;5179;1610;4974;144;436;1333;4204;1477;4640
250920;201409;3656;10418;3428;10095;445;1239;2498;7643;2943;8882
250930;201409;2055;6661;1963;6517;333;1269;1364;4474;1697;5743
250933;201409;1210;3921;1163;3842;128;441;860;2880;988;3321
250937;201409;876;2720;782;2527;119;456;467;1507;586;1963
250939;201409;1767;5465;1598;5187;221;779;1071;3458;1292;4237
250940;201409;4079;11972;3776;11497;245;895;3002;9193;3247;10088
250950;201409;1193;3840;1116;3735;43;150;1001;3372;1044;3522
250960;201409;1336;4148;1184;3944;112;449;921;3070;1033;3519
250970;201409;9298;25323;8273;23860;1218;3536;5766;16784;6984;20320
250980;201409;2762;8238;2513;7799;249;987;1745;5205;1994;6192
250990;201409;2187;7490;2015;7146;299;1218;1365;4789;1664;6007
251000;201409;2611;7417;2136;6738;135;496;1715;5402;1850;5898
251010;201409;2902;8443;2640;8048;184;667;2112;6495;2296;7162
251020;201409;1755;5186;1612;5004;152;518;1336;4177;1488;4695
251030;201409;1359;3770;1234;3562;129;426;810;2363;939;2789
251040;201409;1961;6180;1765;5872;185;843;1263;4049;1448;4892
251050;201409;1177;3450;1034;3191;181;597;578;1839;759;2436
251060;201409;1067;2560;856;2299;84;288;654;1696;738;1984
251065;201409;595;1784;522;1674;72;262;322;994;394;1256
251070;201409;644;1814;590;1736;64;254;455;1250;519;1504
251080;201409;21932;61291;20288;58506;5187;15588;10949;32028;16136;47616
251090;201409;3127;9860;2777;9209;280;1084;2010;6579;2290;7663
251100;201409;1035;3329;893;3048;191;741;477;1562;668;2303
251110;201409;2184;6337;1927;5872;226;746;1319;4031;1545;4777
251120;201409;6027;20782;5817;20412;752;3143;4507;15491;5259;18634
251130;201409;4088;10629;3669;10165;37;107;3547;9855;3584;9962
251140;201409;4623;14138;4284;13615;231;912;3392;10755;3623;11667
251150;201409;2926;9352;2677;8990;376;1413;1891;6401;2267;7814
251160;201409;1910;6328;1827;6212;98;388;1594;5427;1692;5815
251170;201409;1479;4547;1433;4491;124;459;1183;3667;1307;4126
251180;201409;2962;8869;2711;8541;578;1827;1619;5255;2197;7082
251190;201409;4513;12776;4364;12606;276;810;3903;11314;4179;12124
251200;201409;4253;13234;4053;12978;184;628;3613;11649;3797;12277
251203;201409;1382;4324;1290;4132;108;456;817;2718;925;3174
251207;201409;1244;3882;1078;3570;97;423;739;2371;836;2794
251210;201409;8340;23841;7279;22420;967;2926;5425;17104;6392;20030
251220;201409;1345;3619;1172;3353;182;550;767;2268;949;2818
251230;201409;5344;16010;4717;15270;428;1560;3989;12919;4417;14479
251240;201409;3259;10671;3177;10545;344;1259;2540;8422;2884;9681
251250;201409;10924;32615;10138;31407;1404;4901;7353;22522;8757;27423
251260;201409;565;1716;496;1621;40;135;367;1202;407;1337
251270;201409;4376;13590;4077;13217;163;640;3657;11884;3820;12524
251272;201409;1453;4363;1367;4242;130;426;1096;3441;1226;3867
251274;201409;1045;3264;982;3142;127;506;600;1958;727;2464
251275;201409;1448;4086;1373;3973;152;566;1014;2832;1166;3398
251276;201409;1534;4551;1448;4397;215;716;905;2835;1120;3551
251278;201409;659;2104;571;1899;88;323;342;1181;430;1504
251280;201409;2450;7639;2340;7458;259;919;1800;5698;2059;6617
251290;201409;6351;17900;6018;17487;868;2889;4387;12485;5255;15374
251300;201409;773;2668;717;2584;70;326;520;1833;590;2159
251310;201409;3400;9873;3130;9490;193;724;2523;7582;2716;8306
251315;201409;1764;6171;1703;6064;299;1106;1078;3926;1377;5032
251320;201409;2197;6155;1804;5520;151;515;1274;3954;1425;4469
251330;201409;2099;5454;1729;4970;112;449;1485;4142;1597;4591
251335;201409;1026;3520;965;3407;95;432;707;2425;802;2857
251340;201409;4031;11192;3397;10236;351;1299;2378;6996;2729;8295
251350;201409;1622;4977;1474;4761;203;719;1011;3248;1214;3967
251360;201409;1886;6143;1760;5991;119;473;1486;5108;1605;5581
251365;201409;916;2694;734;2319;59;229;478;1482;537;1711
251370;201409;24086;78824;23563;78033;3557;13514;17541;56861;21098;70375
251380;201409;1441;4459;1259;4148;95;401;995;3207;1090;3608
251385;201409;892;2478;805;2339;78;254;560;1607;638;1861
251390;201409;5981;21084;5582;20394;1236;4769;3444;12687;4680;17456
251392;201409;1098;3243;1007;3098;95;304;750;2360;845;2664
251394;201409;643;1957;530;1742;43;170;373;1212;416;1382
251396;201409;890;2539;791;2364;106;340;547;1601;653;1941
251398;201409;1150;3338;961;2988;83;305;657;2029;740;2334
251400;201409;1388;3936;1257;3756;176;656;851;2446;1027;3102
251410;201409;1672;4352;1523;4109;181;557;1046;2873;1227;3430
251420;201409;2261;6457;1922;6075;192;677;1491;4687;1683;5364
251430;201409;1768;6229;1597;5949;121;531;1313;4898;1434;5429
251440;201409;1484;4421;1258;3977;148;529;898;2807;1046;3336
251445;201409;1678;5070;1589;4940;112;425;1342;4123;1454;4548
251450;201409;4959;15461;4430;14785;181;756;3832;12788;4013;13544
251455;201409;1221;3808;1079;3576;92;375;761;2529;853;2904
251460;201409;907;2767;867;2702;125;399;665;2105;790;2504
251465;201409;506;1573;460;1481;50;185;301;955;351;1140
251470;201409;1322;3813;1090;3384;134;486;644;2012;778;2498
251480;201409;1145;3105;1024;2909;65;241;820;2284;885;2525
251490;201409;2122;6259;1840;5876;321;1183;1158;3642;1479;4825
251500;201409;1818;5945;1763;5859;190;711;1386;4557;1576;5268
251510;201409;2700;8946;2487;8497;435;1586;1539;5319;1974;6905
251520;201409;1144;3105;1030;2927;151;457;571;1640;722;2097
251530;201409;12416;35699;11887;34934;721;2624;10199;29606;10920;32230
251540;201409;2936;9563;2703;9066;256;1024;2064;6890;2320;7914
251550;201409;4063;10156;3389;9290;189;646;2781;7463;2970;8109
251560;201409;756;2332;689;2216;104;413;418;1231;522;1644
251570;201409;1098;3199;923;2836;112;423;597;1875;709;2298
251580;201409;2234;6148;2052;5904;374;952;1441;4323;1815;5275
251590;201409;1751;5716;1716;5676;115;426;1481;4957;1596;5383
251593;201409;1081;3348;997;3232;153;548;637;2011;790;2559
251597;201409;2040;6275;1964;6159;181;679;1544;4754;1725;5433
251600;201409;7590;22074;7170;21376;892;2663;5377;16347;6269;19010
251610;201409;3677;11042;3399;10670;359;1235;2618;8321;2977;9556
251615;201409;1230;3542;1048;3225;109;414;678;2128;787;2542
251620;201409;17864;50376;15694;47622;1895;5909;11801;36381;13696;42290
251630;201409;5449;13830;4734;12936;420;1181;3699;10232;4119;11413
251640;201409;2743;7883;2240;6976;225;842;1616;4980;1841;5822
251650;201409;4467;12697;4010;12116;329;1056;3287;10124;3616;11180
251660;201409;3692;12163;3376;11659;282;1280;2681;9063;2963;10343
251670;201409;4146;12320;3696;11702;82;271;3362;10730;3444;11001
251675;201409;776;2559;729;2486;169;613;412;1387;581;2000
251680;201409;2929;8174;2343;7292;139;562;1905;5830;2044;6392
251690;201409;3654;11164;3376;10653;309;1100;2465;7705;2774;8805
251700;201409;2196;7114;2068;6942;212;783;1663;5613;1875;6396
251710;201409;969;2532;725;2087;105;356;378;1051;483;1407
251720;201409;1449;4458;1316;4226;116;457;1010;3196;1126;3653
251740;201409;764;2151;613;1884;101;339;359;1112;460;1451
260005;201409;25649;63480;22492;59027;4820;12835;13640;35808;18460;48643
260010;201409;9824;26789;7883;24363;946;3123;5826;18086;6772;21209
260020;201409;5983;17472;5281;16414;539;1615;3950;12730;4489;14345
260030;201409;5484;16461;5060;15818;446;1607;4010;12425;4456;14032
260040;201409;10412;25144;8636;23131;700;1589;7048;19555;7748;21144
260050;201409;11281;35576;10463;34637;648;2271;9146;30588;9794;32859
260060;201409;4154;11506;3789;10907;357;1066;2957;8582;3314;9648
260070;201409;9875;29327;9379;28583;1900;6187;6095;18522;7995;24709
260080;201409;5491;15460;4854;14528;490;1677;3648;10745;4138;12422
260090;201409;5418;15035;5066;14540;1150;3187;3390;10037;4540;13224
260100;201409;3576;9539;3245;9091;251;851;2613;7408;2864;8259
260105;201409;4800;14176;4613;13830;746;2435;3179;9414;3925;11849
260110;201409;22416;64860;20628;62692;1398;4257;17725;54415;19123;58672
260120;201409;11579;35552;10754;34090;2889;9326;5650;18594;8539;27920
260130;201409;3200;9074;3028;8797;468;1302;2186;6501;2654;7803
260140;201409;13836;35242;11837;32780;1152;3456;9221;25904;10373;29360
260150;201409;3220;9240;2866;8730;223;805;2264;6937;2487;7742
260160;201409;6128;18651;5486;17887;514;1766;4489;14915;5003;16681
260170;201409;18072;49480;17285;48444;1534;3996;14159;40342;15693;44338
260180;201409;3574;10959;3249;10485;254;975;2631;8433;2885;9408
260190;201409;16549;39655;15547;38395;873;2309;13546;33447;14419;35756
260200;201409;11805;33237;10752;31714;1101;3460;8125;24635;9226;28095
260210;201409;11685;35909;10701;34485;877;3115;8623;28062;9500;31177
260220;201409;9632;29217;9348;28813;781;2998;7913;23883;8694;26881
260230;201409;10167;29377;9568;28571;697;2113;7840;23880;8537;25993
260240;201409;3020;9225;2619;8657;374;1327;1875;6241;2249;7568
260250;201409;2800;7493;2568;7203;191;570;2104;5939;2295;6509
260260;201409;11833;34388;11415;33799;1151;3711;9168;27653;10319;31364
260270;201409;3670;10988;3427;10627;363;1397;2642;8032;3005;9429
260280;201409;13302;43322;12206;41615;799;2972;10196;35226;10995;38198
260290;201409;35629;107742;34222;105336;5985;20427;22935;69651;28920;90078
260300;201409;8598;26071;7549;24518;558;2283;6024;19498;6582;21781
260310;201409;5238;15551;4908;15046;1541;4379;2509;8354;4050;12733
260320;201409;7109;23633;6608;22902;573;2060;5265;18595;5838;20655
260330;201409;3193;9884;2958;9496;301;1174;2015;6678;2316;7852
260340;201409;1938;5745;1824;5573;98;352;1587;4821;1685;5173
260345;201409;27268;88213;25945;85539;7702;27462;11933;37989;19635;65451
260350;201409;4380;12393;4148;12030;303;1007;3417;9843;3720;10850
260360;201409;2485;7654;2356;7434;454;1576;1474;4650;1928;6226
260370;201409;6218;19174;5620;18111;702;2496;4021;13085;4723;15581
260380;201409;5117;16621;4723;16094;497;1739;3605;12479;4102;14218
260390;201409;4840;15027;4181;13965;483;1815;2978;9791;3461;11606
260392;201409;3624;11360;3373;11033;150;573;3000;9819;3150;10392
260400;201409;14332;41922;13738;40929;2344;7956;9456;27495;11800;35451
260410;201409;64473;189793;60800;183692;20320;61767;27789;87018;48109;148785
260415;201409;4180;13222;3629;12132;503;2005;2271;7457;2774;9462
260420;201409;12483;29085;11397;27931;802;2058;9772;24034;10574;26092
260430;201409;2811;9340;2532;8894;309;1257;1837;6374;2146;7631
260440;201409;3507;10667;3220;10091;594;2028;1932;5935;2526;7963
260450;201409;5404;16092;5083;15588;426;1418;4122;12680;4548;14098
260460;201409;5960;18409;5575;17796;977;3459;3550;11129;4527;14588
260470;201409;5262;15005;4948;14571;477;1484;4015;12000;4492;13484
260480;201409;4043;11795;3597;11120;598;2070;2446;7498;3044;9568
260490;201409;6212;16030;5432;14760;615;2005;3761;10216;4376;12221
260500;201409;6954;19078;6421;18309;729;2190;4714;13599;5443;15789
260510;201409;10770;28223;9978;27143;818;2267;7968;22387;8786;24654
260515;201409;4703;14603;3675;12440;360;1418;2309;7811;2669;9229
260520;201409;16681;44781;16138;44037;3335;8972;10948;30420;14283;39392
260530;201409;10296;30788;8978;28929;576;1824;7610;24916;8186;26740
260540;201409;5998;15439;5653;15059;685;1524;4574;12584;5259;14108
260545;201409;43;166;30;123;5;23;7;27;12;50
260550;201409;2921;9688;2568;8975;644;2505;1163;4029;1807;6534
260560;201409;6891;17673;6148;16622;310;889;5384;14560;5694;15449
260570;201409;6832;23247;6329;22383;937;3660;4472;15925;5409;19585
260580;201409;4020;11053;3795;10699;287;939;3178;8790;3465;9729
260590;201409;6021;15264;5764;14962;248;549;5265;13845;5513;14394
260600;201409;27258;83698;25655;80990;4104;13824;17348;55193;21452;69017
260610;201409;7212;21581;6856;21071;1220;4006;4800;14660;6020;18666
260620;201409;17834;54792;17121;53580;3346;11642;10853;33299;14199;44941
260630;201409;2387;7046;2057;6506;216;828;1535;4796;1751;5624
260640;201409;17930;49152;16916;47724;2440;7227;12053;34078;14493;41305
260650;201409;5726;17853;5331;17175;707;2247;3681;12639;4388;14886
260660;201409;8672;23980;7786;22853;536;1658;6578;19473;7114;21131
260670;201409;2504;6957;2103;6412;286;980;1421;4340;1707;5320
260680;201409;23885;65655;22303;62902;5007;14693;12468;34886;17475;49579
260690;201409;3741;10235;3214;9420;185;678;2641;7663;2826;8341
260700;201409;5809;17243;5670;17097;93;171;5493;16783;5586;16954
260710;201409;1368;4168;1242;3987;143;546;941;2973;1084;3519
260720;201409;17502;57537;16629;55994;4380;15059;9042;31266;13422;46325
260730;201409;7438;24353;6659;23178;927;3405;4787;16902;5714;20307
260740;201409;1371;4160;1199;3846;181;643;730;2342;911;2985
260750;201409;6837;21658;6339;20977;600;1851;5242;17753;5842;19604
260760;201409;4924;13567;4616;13170;485;1517;3617;10311;4102;11828
260765;201409;8335;28849;8045;28405;1422;5735;5432;19087;6854;24822
260770;201409;4404;11386;4001;10858;249;848;3192;8506;3441;9354
260775;201409;5395;15618;5105;15180;590;2113;3682;10614;4272;12727
260780;201409;4061;13294;3888;12999;928;3460;2261;7469;3189;10929
260790;201409;123623;317567;118313;309809;26450;70846;72404;190625;98854;261471
260795;201409;3101;9814;2864;9448;467;1642;1910;6378;2377;8020
260800;201409;4946;13380;4581;12884;224;930;3993;10904;4217;11834
260805;201409;4182;12188;3761;11528;524;1733;2588;7937;3112;9670
260810;201409;7498;21683;7306;21433;465;1486;6387;18769;6852;20255
260820;201409;4687;13304;4354;12852;1141;3419;2532;7525;3673;10944
260825;201409;3127;9992;2908;9659;312;1015;2297;7759;2609;8774
260830;201409;3832;12327;3509;11752;967;3096;1982;6979;2949;10075
260840;201409;4285;12401;3900;11843;288;1117;3220;9588;3508;10705
260845;201409;4363;12793;4055;12203;670;2120;2729;8249;3399;10369
260850;201409;5089;17215;4585;16117;1122;4403;2234;7688;3356;12091
260860;201409;3328;10606;3065;10150;291;1027;2334;7799;2625;8826
260870;201409;4288;11864;3916;11395;519;1404;2975;8891;3494;10295
260875;201409;7548;20217;6779;19020;1142;3239;4346;12576;5488;15815
260880;201409;9158;28904;8682;28229;801;2659;7162;23534;7963;26193
260890;201409;15292;43645;14454;42367;1649;5367;10685;31409;12334;36776
260900;201409;6219;19050;5298;17432;891;3175;3214;10611;4105;13786
260910;201409;3223;9533;2920;9085;242;862;2348;7340;2590;8202
260915;201409;4678;15552;4505;15306;122;411;4169;14372;4291;14783
260920;201409;3482;10593;3312;10367;480;1604;2461;7889;2941;9493
260930;201409;4278;13460;3769;12695;474;1663;2729;9315;3203;10978
260940;201409;15649;42825;14363;40631;2479;8184;8705;24200;11184;32384
260950;201409;6328;20169;5988;19505;889;3654;3752;11524;4641;15178
260960;201409;68686;191383;64937;185313;14132;42039;38074;109645;52206;151684
260970;201409;5497;17372;5110;16815;561;2190;3789;12403;4350;14593
260980;201409;4073;13042;3866;12767;260;872;3288;11098;3548;11970
260990;201409;18584;57843;17151;55924;1969;6211;13100;44390;15069;50601
261000;201409;16151;44918;13033;39895;2698;8729;7123;22339;9821;31068
261010;201409;2838;7831;2654;7597;223;459;2260;6778;2483;7237
261020;201409;6145;18257;5638;17489;458;1744;4558;13743;5016;15487
261030;201409;3566;11588;3371;11252;344;1271;2660;8843;3004;10114
261040;201409;5479;17569;4714;16285;528;2161;3396;11603;3924;13764
261050;201409;8916;25230;8312;24254;1113;3329;5772;16795;6885;20124
261060;201409;11780;36063;11275;35234;1523;5439;8339;25595;9862;31034
261070;201409;51651;132057;46493;124784;9538;26380;28294;76609;37832;102989
261080;201409;5924;17845;5579;17294;415;1229;4701;14827;5116;16056
261090;201409;16915;47025;15774;45490;1578;4649;12598;36722;14176;41371
261100;201409;7517;24081;6893;23049;851;3193;4957;16620;5808;19813
261110;201409;68642;197302;62612;188525;15627;47338;34468;109694;50095;157032
261120;201409;3787;10119;3417;9659;143;452;3030;8592;3173;9044
261130;201409;7311;18945;6983;18578;265;723;6418;17079;6683;17802
261140;201409;3334;9381;3057;8946;539;1743;1923;5541;2462;7284
261150;201409;5842;17230;5267;16394;690;2379;3816;11937;4506;14316
261153;201409;2019;5892;1693;5427;98;371;1372;4432;1470;4803
261160;201409;229594;598933;218329;583336;50923;136849;126392;348142;177315;484991
261170;201409;6218;17250;5742;16577;786;2300;4335;12635;5121;14935
261180;201409;9899;27948;9480;27340;1062;3117;7308;21236;8370;24353
261190;201409;5567;17504;5250;17091;780;3263;3636;11383;4416;14646
261200;201409;4021;9869;3715;9477;570;1428;2680;6987;3250;8415
261210;201409;2029;5327;1937;5211;137;356;1691;4621;1828;4977
261220;201409;13393;42880;11465;38643;2335;8452;5855;19792;8190;28244
261230;201409;4230;12966;3923;12570;175;627;3483;11206;3658;11833
261240;201409;5086;14934;4803;14417;786;2292;3358;10236;4144;12528
261245;201409;3953;12331;3422;11434;269;1120;2538;8534;2807;9654
261247;201409;3605;11023;3086;10059;374;1298;2187;7191;2561;8489
261250;201409;19863;53400;19060;52343;3463;9334;14020;39194;17483;48528
261255;201409;4441;13530;3977;12766;318;1143;3141;10229;3459;11372
261260;201409;12589;35773;11488;34477;698;1903;9994;30640;10692;32543
261270;201409;3873;11275;3575;10810;472;1536;2504;7545;2976;9081
261280;201409;2815;8604;2561;8229;268;955;1941;6242;2209;7197
261290;201409;3133;8853;2814;8453;215;727;2322;7042;2537;7769
261300;201409;10778;35647;9665;33706;1723;6762;5993;20771;7716;27533
261310;201409;8644;26113;8188;25345;2017;6388;4738;14809;6755;21197
261320;201409;6170;19145;5794;18451;589;1858;4461;14509;5050;16367
261330;201409;5640;16605;5427;16289;560;1701;4303;13002;4863;14703
261340;201409;4670;15210;4433;14831;670;2630;2858;9537;3528;12167
261350;201409;8241;27741;7780;26949;635;2661;6140;21099;6775;23760
261360;201409;9625;24961;8727;23749;1151;3240;6179;17135;7330;20375
261370;201409;21516;63683;20289;61778;4416;14027;12501;38321;16917;52348
261380;201409;4280;14672;3960;14095;630;2389;2659;9595;3289;11984
261390;201409;17588;53934;16050;51286;2777;9718;9956;31664;12733;41382
261400;201409;5018;17385;4562;16471;600;2435;3138;11410;3738;13845
261410;201409;8753;25277;8196;24434;1124;3394;6043;18313;7167;21707
261420;201409;8261;27597;7935;27120;2075;7712;4501;15604;6576;23316
261430;201409;3672;11371;3127;10635;394;1348;2306;8032;2700;9380
261440;201409;1713;5270;1575;5062;109;466;1280;4061;1389;4527
261450;201409;14573;41724;14174;41207;828;2503;12699;37013;13527;39516
261460;201409;8550;24679;7992;23901;811;2221;6042;19466;6853;21687
261470;201409;4038;10936;3707;10542;207;642;3214;9115;3421;9757
261480;201409;3598;13145;3351;12694;399;1704;2520;9394;2919;11098
261485;201409;5110;15774;4675;14992;946;3412;2703;8592;3649;12004
261500;201409;5951;16493;5239;15531;645;1704;4003;12398;4648;14102
261510;201409;2100;6631;1965;6429;176;574;1546;5140;1722;5714
261520;201409;2672;8701;2371;8158;191;771;1688;5852;1879;6623
261530;201409;12646;40791;11203;37966;2539;9393;5168;17529;7707;26922
261540;201409;7534;24325;7239;23791;1417;4602;4861;16329;6278;20931
261550;201409;3575;10628;3411;10388;420;1583;2681;7920;3101;9503
261560;201409;7155;23196;6535;22398;1234;4352;4518;15830;5752;20182
261570;201409;3686;11243;3253;10548;512;1735;2179;7105;2691;8840
261580;201409;5927;18719;5292;17692;476;1781;4184;14200;4660;15981
261590;201409;2929;8103;2556;7588;314;997;1841;5565;2155;6562
261600;201409;5360;14743;4582;13650;474;1455;3478;10487;3952;11942
261610;201409;2362;7051;2043;6579;126;522;1667;5246;1793;5768
261618;201409;2610;7412;2451;7202;253;810;1938;5649;2191;6459
261620;201409;4688;14360;4418;13934;634;2047;3076;9923;3710;11970
261630;201409;8251;24093;7150;22087;1279;4525;3991;11944;5270;16469
261640;201409;30958;80576;28560;77544;2106;5594;23892;66102;25998;71696
261650;201409;3886;12273;3639;11909;522;1833;2625;8639;3147;10472
270010;201409;4587;17341;4195;16541;517;2307;2900;11512;3417;13819
270020;201409;4097;12250;3835;11847;473;1641;2903;8875;3376;10516
270030;201409;46819;141240;44468;137527;11489;35997;25601;80949;37090;116946
270040;201409;10553;32628;10022;32008;1719;4920;7402;24695;9121;29615
270050;201409;4103;11928;3805;11539;400;1450;2950;8843;3350;10293
270060;201409;1767;5690;1668;5551;354;1276;1024;3451;1378;4727
270070;201409;4277;13228;3960;12801;205;899;3414;10869;3619;11768
270080;201409;1365;4250;1220;4008;223;820;782;2521;1005;3341
270090;201409;2113;6633;2032;6499;68;261;1846;5862;1914;6123
270100;201409;6524;20166;6233;19773;1301;4332;4116;13031;5417;17363
270110;201409;3498;9869;3213;9539;542;1605;2124;6762;2666;8367
270120;201409;3141;9122;2844;8724;153;530;2467;7630;2620;8160
270130;201409;5331;16574;5041;16237;508;1479;4161;13815;4669;15294
270135;201409;1795;5046;1707;4949;124;205;1532;4622;1656;4827
270140;201409;9983;24911;8821;23407;772;2955;7013;17499;7785;20454
270150;201409;2774;9446;2707;9358;196;742;2374;8228;2570;8970
270160;201409;5168;17264;4753;16750;298;1107;4047;14352;4345;15459
270170;201409;4140;13516;3824;13053;812;3208;2191;7378;3003;10586
270180;201409;2352;7749;2091;7416;157;727;1688;5934;1845;6661
270190;201409;1967;6407;1863;6251;146;586;1471;4959;1617;5545
270200;201409;2788;9383;2606;9087;269;1146;1984;6791;2253;7937
270210;201409;4638;14822;4458;14590;402;1593;3749;12146;4151;13739
270220;201409;1729;5424;1598;5169;317;1151;847;2783;1164;3934
270230;201409;11436;36989;10045;34767;1510;6195;6556;22317;8066;28512
270235;201409;6528;21183;6175;20596;410;1689;5094;16878;5504;18567
270240;201409;9991;29912;8726;28258;1641;5519;5546;18229;7187;23748
270250;201409;3586;9136;3264;8775;174;453;2952;7973;3126;8426
270255;201409;5175;15728;4237;14054;373;1546;3044;9952;3417;11498
270260;201409;6521;20897;6358;20616;860;3185;4771;15548;5631;18733
270270;201409;1243;3580;1146;3435;193;604;728;2146;921;2750
270280;201409;3787;11139;3543;10784;476;1643;2547;7637;3023;9280
270290;201409;8625;30102;8170;29300;882;3703;6330;22534;7212;26237
270300;201409;3429;11751;3235;11524;207;842;2772;9939;2979;10781
270310;201409;7620;23316;6837;21992;422;1894;5594;17571;6016;19465
270320;201409;6518;21034;6301;20675;1461;5421;3687;12140;5148;17561
270330;201409;4952;16282;4651;15878;483;1769;3707;12773;4190;14542
270340;201409;1832;5644;1651;5403;193;678;1251;4164;1444;4842
270350;201409;2124;5833;1967;5636;265;761;1357;4111;1622;4872
270360;201409;2120;6638;2070;6577;243;734;1704;5560;1947;6294
270370;201409;1753;5678;1610;5429;181;686;1093;3804;1274;4490
270375;201409;3082;9168;2813;8761;412;1551;1897;5672;2309;7223
270380;201409;6097;18584;5751;18103;631;1992;4448;14324;5079;16316
270390;201409;1462;4011;1314;3822;202;670;909;2559;1111;3229
270400;201409;6074;18732;5551;17936;499;1918;3981;12667;4480;14585
270410;201409;5170;15925;4903;15420;599;2072;3568;11137;4167;13209
270420;201409;5696;18603;5536;18377;302;1414;4634;15121;4936;16535
270430;201409;143329;418219;136695;408749;36600;110610;75089;231955;111689;342565
270440;201409;5142;15729;4836;15276;380;1390;3838;12232;4218;13622
270450;201409;6765;21042;6514;20722;595;2185;5218;16641;5813;18826
270460;201409;3719;10112;3346;9603;262;908;2733;7718;2995;8626
270470;201409;11431;36437;10778;35347;1688;5553;7156;24180;8844;29733
270480;201409;3187;9975;2855;9389;365;1445;1899;6036;2264;7481
270490;201409;1015;3247;955;3161;91;361;727;2386;818;2747
270500;201409;5483;18671;5230;18333;486;1771;4197;15074;4683;16845
270510;201409;6221;19066;5676;18295;877;3603;4059;12473;4936;16076
270520;201409;3830;12328;3586;11935;882;3176;1906;6440;2788;9616
270530;201409;1584;4638;1404;4405;210;665;961;3114;1171;3779
270540;201409;2106;7219;1932;6965;177;819;1528;5424;1705;6243
270550;201409;7287;21864;6459;20763;1059;3518;4357;14397;5416;17915
270560;201409;3141;9745;2959;9457;515;1927;2058;6382;2573;8309
270570;201409;4356;14111;3978;13517;462;1904;2773;9346;3235;11250
270580;201409;2127;6963;2044;6829;282;991;1537;5213;1819;6204
270590;201409;1455;4892;1366;4738;71;300;1208;4186;1279;4486
270600;201409;2972;9930;2671;9463;241;1178;2039;7030;2280;8208
270610;201409;3326;10510;3084;10153;317;1157;2444;8000;2761;9157
270620;201409;1535;5104;1397;4895;150;694;1079;3670;1229;4364
270630;201409;18666;52137;17392;50134;2559;7439;12436;36446;14995;43885
270640;201409;6154;18857;5517;18044;471;1895;4460;14347;4931;16242
270642;201409;2522;8660;2349;8384;378;1517;1592;5737;1970;7254
270644;201409;2502;7282;2250;7004;178;501;1935;6142;2113;6643
270650;201409;4185;13208;4016;12970;851;3319;2448;7621;3299;10940
270660;201409;2523;6451;1984;5646;147;523;1410;3988;1557;4511
270670;201409;16575;44214;14405;41630;1906;5491;10647;31791;12553;37282
270680;201409;4270;12956;4119;12776;205;581;3695;11602;3900;12183
270690;201409;9319;26173;8606;25321;2832;7964;4298;13580;7130;21544
270700;201409;807;2507;765;2439;143;546;478;1479;621;2025
270710;201409;5999;19849;5738;19502;642;2324;4563;15634;5205;17958
270720;201409;3459;11674;3185;11201;256;1180;2564;8895;2820;10075
270730;201409;6845;20918;6492;20485;939;2969;4995;16043;5934;19012
270740;201409;2479;7176;2324;6957;355;1220;1599;4697;1954;5917
270750;201409;5041;16093;4674;15533;525;1884;3589;11967;4114;13851
270760;201409;3675;11002;3310;10402;374;1259;2446;7722;2820;8981
270770;201409;18702;50542;15944;47169;3131;9504;9906;30215;13037;39719
270780;201409;1980;6394;1843;6182;260;944;1300;4398;1560;5342
270790;201409;1763;5510;1612;5268;356;1278;930;2985;1286;4263
270800;201409;11654;34782;10895;33759;1015;3432;8853;27448;9868;30880
270810;201409;3486;10720;2847;9554;379;1469;1790;6009;2169;7478
270820;201409;1925;6444;1741;6119;281;1134;1145;4004;1426;5138
270830;201409;5600;16866;5088;16221;1046;3739;3271;10464;4317;14203
270840;201409;7753;26075;7055;25187;467;2217;5926;20876;6393;23093
270850;201409;7760;25393;7580;25176;1419;5669;5232;16657;6651;22326
270860;201409;11778;35318;10974;34222;1712;6191;7911;24141;9623;30332
270870;201409;2352;6918;1912;5991;312;1031;1156;3623;1468;4654
270880;201409;8002;26124;7549;25457;580;2447;6208;20643;6788;23090
270890;201409;2728;8265;2528;7927;408;1508;1761;5391;2169;6899
270895;201409;3095;11399;2939;11194;253;1033;2440;9414;2693;10447
270900;201409;1959;5321;1590;4787;110;413;1208;3562;1318;3975
270910;201409;3331;11514;3249;11352;338;1521;2558;8676;2896;10197
270915;201409;10199;34459;9246;32741;1772;7200;5392;18870;7164;26070
270920;201409;6600;20429;6201;19874;286;1307;5474;17332;5760;18639
270930;201409;17698;48024;14694;44272;2744;8781;8998;27778;11742;36559
270940;201409;5989;20181;5723;19870;670;2629;4431;15421;5101;18050
280010;201409;733;2164;642;2016;73;294;414;1261;487;1555
280020;201409;5146;15245;4531;14131;878;2879;2800;8757;3678;11636
280030;201409;76694;203258;67815;189872;17376;50774;34095;97117;51471;147891
280040;201409;3276;10173;2923;9673;363;1216;2158;7356;2521;8572
280050;201409;4152;13331;3866;12873;1214;4182;1834;6309;3048;10491
280060;201409;4430;14755;4189;14347;901;3304;2486;8615;3387;11919
280067;201409;7845;22136;6685;20564;785;2528;4932;15263;5717;17791
280070;201409;1990;6750;1894;6603;349;1283;1316;4647;1665;5930
280100;201409;4123;12889;3686;12107;987;3327;1784;6043;2771;9370
280110;201409;1458;4416;1340;4221;83;323;1113;3485;1196;3808
280120;201409;7692;24618;7117;23702;1076;3301;5090;17782;6166;21083
280130;201409;8042;22868;7481;22042;1247;4070;5005;14658;6252;18728
280140;201409;5798;15825;5253;15093;579;1673;4066;11834;4645;13507
280150;201409;3552;10909;3265;10380;509;1871;2139;6580;2648;8451
280160;201409;1557;4435;1402;4200;174;591;1016;3030;1190;3621
280170;201409;4803;14315;4346;13686;509;1520;3374;10961;3883;12481
280190;201409;1197;3395;1060;3176;98;391;768;2192;866;2583
280200;201409;1149;3550;1056;3404;173;689;728;2251;901;2940
280210;201409;13754;42450;12679;40902;2561;8374;8155;27192;10716;35566
280220;201409;1629;4968;1532;4831;108;402;1300;4081;1408;4483
280230;201409;3909;11449;3500;10772;661;2034;2085;6615;2746;8649
280240;201409;3597;10647;3271;10139;285;858;2583;8117;2868;8975
280250;201409;858;2273;725;2071;142;474;434;1141;576;1615
280260;201409;2119;5577;1933;5347;119;320;1681;4691;1800;5011
280270;201409;2309;7157;2015;6676;137;547;1578;5151;1715;5698
280280;201409;4178;13747;3866;13229;945;2775;2170;8300;3115;11075
280290;201409;17515;55065;15915;52438;2713;9589;10399;34740;13112;44329
280300;201409;10334;31422;9547;30522;815;2709;7927;25745;8742;28454
280310;201409;1498;4217;1303;3914;111;424;891;2587;1002;3011
280320;201409;8210;27024;7571;25872;1465;5563;4151;14196;5616;19759
280330;201409;4995;14000;4609;13461;586;1884;3524;10257;4110;12141
280340;201409;3889;11424;3680;11145;334;1101;2921;9008;3255;10109
280350;201409;22350;64547;20664;62052;2802;8629;14838;45366;17640;53995
280360;201409;6039;19094;5698;18560;1170;4289;3425;11014;4595;15303
280370;201409;2017;5733;1822;5427;218;742;1334;3906;1552;4648
280380;201409;1036;3142;953;3033;105;401;742;2338;847;2739
280390;201409;3365;9856;2920;9054;605;1796;1777;5619;2382;7415
280400;201409;4622;13227;4215;12683;976;2766;2634;8366;3610;11132
280410;201409;2442;7903;2146;7326;400;1552;1182;3887;1582;5439
280420;201409;4363;12534;4038;12038;255;797;3490;10471;3745;11268
280430;201409;2324;6045;2144;5823;156;521;1788;4832;1944;5353
280440;201409;5195;15122;4846;14699;469;1390;4031;12425;4500;13815
280445;201409;2507;7177;2293;6809;107;406;1886;5505;1993;5911
280450;201409;9262;24999;8525;24123;745;1691;7135;20987;7880;22678
280460;201409;7351;19617;6552;18513;991;2915;4647;13388;5638;16303
280470;201409;1905;5668;1724;5394;209;666;1276;4044;1485;4710
280480;201409;31981;95741;30631;93770;5146;17900;20666;62085;25812;79985
280490;201409;3829;11720;3413;10937;382;1369;2452;7816;2834;9185
280500;201409;879;2365;827;2298;26;81;746;2058;772;2139
280510;201409;2796;8199;2410;7682;302;1096;1792;5748;2094;6844
280520;201409;1773;5053;1628;4862;185;475;1284;3999;1469;4474
280530;201409;2293;6756;2146;6570;227;755;1729;5349;1956;6104
280540;201409;9546;25779;8923;24947;350;1165;7962;22155;8312;23320
280550;201409;6774;18467;5897;17066;649;2085;4296;12342;4945;14427
280560;201409;8145;23932;7635;23118;605;1969;6206;18767;6811;20736
280570;201409;7010;19430;6292;18499;852;2811;4452;13056;5304;15867
280580;201409;5536;17147;4699;15687;897;3029;2891;9953;3788;12982
280590;201409;2436;7408;2226;7152;284;1186;1619;5122;1903;6308
280600;201409;4108;12562;3837;12113;422;1536;2783;8728;3205;10264
280610;201409;2468;7089;2289;6836;313;1068;1579;4637;1892;5705
280620;201409;5355;16221;4743;15051;811;2521;3090;10056;3901;12577
280630;201409;3866;12616;3683;12340;388;1159;2970;10320;3358;11479
280640;201409;2296;6655;2149;6485;100;228;1977;6086;2077;6314
280650;201409;1179;3648;1063;3441;167;594;711;2311;878;2905
280660;201409;2717;7852;2599;7678;370;1101;2054;6086;2424;7187
280670;201409;15270;40514;14342;39246;1980;5658;10381;28441;12361;34099
280680;201409;2912;7717;2484;7122;160;519;2076;5947;2236;6466
280690;201409;1030;2921;885;2711;135;441;592;1789;727;2230
280700;201409;1197;3507;1039;3272;106;322;756;2442;862;2764
280710;201409;11371;30828;10576;29884;802;2067;8990;25771;9792;27838
280720;201409;2415;6563;2144;6256;250;753;1596;4756;1846;5509
280730;201409;977;2927;931;2863;78;233;787;2466;865;2699
280740;201409;13300;36125;11519;33499;1843;5220;7728;23096;9571;28316
280750;201409;3630;11142;3313;10576;332;1259;2373;7525;2705;8784
280760;201409;5917;18238;5399;17547;721;2323;3961;13373;4682;15696
290010;201409;3091;6916;2214;5559;69;285;1771;4207;1840;4492
290020;201409;5013;15859;4576;15409;393;1113;3972;13749;4365;14862
290030;201409;3366;10599;3216;10370;451;1548;2411;7744;2862;9292
290035;201409;4760;12567;4246;11910;310;918;3482;9985;3792;10903
290040;201409;3897;11185;3509;10730;270;1036;2861;8622;3131;9658
290050;201409;2765;8997;2574;8701;246;936;1977;6725;2223;7661
290060;201409;1355;3450;1133;3178;205;651;805;2203;1010;2854
290070;201409;31755;82835;27441;77406;5896;16809;15165;44943;21061;61752
290080;201409;6103;18540;5343;17556;669;2210;4004;13551;4673;15761
290090;201409;2306;5066;1846;4584;206;492;1516;3848;1722;4340
290100;201409;10418;29781;9195;27789;1652;5012;5684;17849;7336;22861
290110;201409;5408;16274;5189;15913;879;2975;3530;10680;4409;13655
290115;201409;5085;15088;4454;14252;352;1198;3474;11319;3826;12517
290120;201409;7051;19002;6413;18214;420;1203;5549;15840;5969;17043
290130;201409;4643;12224;3995;11441;346;1107;3216;9118;3562;10225
290135;201409;5316;13572;4633;12505;447;1446;3182;8448;3629;9894
290140;201409;4145;13170;3613;12477;324;1188;2994;10411;3318;11599
290150;201409;2143;6356;2047;6221;169;528;1742;5326;1911;5854
290160;201409;3577;9673;3487;9564;281;526;3105;8787;3386;9313
290170;201409;2887;9651;2656;9285;252;998;2192;7667;2444;8665
290180;201409;3112;8897;2725;8316;284;965;2015;6192;2299;7157
290190;201409;4204;13901;4065;13662;446;1553;3081;10485;3527;12038
290195;201409;2249;6244;1919;5749;149;532;1513;4543;1662;5075
290200;201409;3918;12559;3573;11959;379;1330;2718;9170;3097;10500
290205;201409;3046;9444;2789;9039;364;1426;2009;6367;2373;7793
290210;201409;15797;43714;14680;42353;2813;6984;9947;31036;12760;38020
290220;201409;2485;7517;2377;7350;275;1014;1758;5305;2033;6319
290225;201409;3123;8290;2926;8080;181;355;2631;7489;2812;7844
290230;201409;2410;7961;2352;7884;217;766;1974;6688;2191;7454
290240;201409;3977;10501;3591;9961;373;1119;2715;7431;3088;8550
290250;201409;3897;12308;3314;11404;287;1037;2572;8982;2859;10019
290260;201409;5010;14928;4470;14104;453;1568;3487;11030;3940;12598
290265;201409;3488;11184;3263;10790;314;1207;2501;8269;2815;9476
290270;201409;12565;45383;11790;44189;1645;6478;8606;32841;10251;39319
290280;201409;5337;17519;5036;16977;542;1914;3729;12861;4271;14775
290290;201409;9873;31775;9003;30333;1610;5581;5951;20510;7561;26091
290300;201409;4447;12768;3180;10384;264;850;2190;7433;2454;8283
290310;201409;1568;4722;1442;4525;249;875;917;2826;1166;3701
290320;201409;27799;84739;24487;80313;5686;19687;14110;47130;19796;66817
290323;201409;4208;11263;3484;10486;220;753;2996;8997;3216;9750
290327;201409;4170;13255;3809;12578;630;2165;2519;8341;3149;10506
290330;201409;1973;5119;1862;4998;220;669;1534;4066;1754;4735
290340;201409;5213;16320;4817;15785;1213;3959;2745;9276;3958;13235
290350;201409;5078;15305;4198;14112;586;1994;2871;9946;3457;11940
290360;201409;4398;13702;3868;12971;218;774;3299;11220;3517;11994
290370;201409;4733;13862;4311;13342;453;1385;3530;11094;3983;12479
290380;201409;5668;16575;4982;15572;440;1453;3946;12421;4386;13874
290390;201409;15704;49342;14705;47694;3035;9562;9044;30730;12079;40292
290395;201409;2822;9100;2542;8614;235;954;1909;6477;2144;7431
290400;201409;3760;11350;3320;10740;384;1284;2505;8149;2889;9433
290405;201409;4567;14619;3974;13575;507;1776;2669;9390;3176;11166
290410;201409;6172;18303;5181;16836;586;2307;3720;11829;4306;14136
290420;201409;3416;10035;2830;9203;274;1022;2217;7168;2491;8190
290430;201409;3595;11235;3212;10630;668;2317;1973;6624;2641;8941
290440;201409;3154;8292;2541;7478;243;785;1987;5925;2230;6710
290450;201409;3682;10698;3216;10038;549;1756;2111;6699;2660;8455
290460;201409;13840;41967;12772;40159;3732;12400;5727;17950;9459;30350
290470;201409;4845;13417;3791;11994;857;3004;1998;6474;2855;9478
290475;201409;5024;17554;4562;16727;557;2291;3246;11975;3803;14266
290480;201409;2682;7015;2368;6594;384;1131;1580;4467;1964;5598
290485;201409;4977;15821;4419;14993;466;2037;3458;11571;3924;13608
290490;201409;8366;22310;8058;21901;731;2129;6643;18024;7374;20153
290500;201409;4683;14869;3953;13497;803;2962;1978;6709;2781;9671
290510;201409;3514;10238;3068;9620;239;875;2458;7748;2697;8623
290515;201409;3004;9152;2768;8806;255;808;2177;7084;2432;7892
290520;201409;11943;37025;9720;32928;1026;4173;6236;20950;7262;25123
290530;201409;5414;15591;4632;14470;418;1352;3697;11610;4115;12962
290540;201409;4017;11631;3821;11383;451;1256;3018;9235;3469;10491
290550;201409;4476;12111;3940;11462;171;499;3548;10395;3719;10894
290560;201409;6223;18420;5478;17334;1207;4097;3201;10301;4408;14398
290570;201409;41540;120158;38967;116296;4963;15812;28522;84644;33485;100456
290580;201409;7504;26006;7186;25520;1356;4751;4939;18112;6295;22863
290590;201409;7749;24391;6486;22270;477;1976;5077;17384;5554;19360
290600;201409;18709;57321;17305;55092;3116;9689;11204;37264;14320;46953
290610;201409;2448;8439;2073;7693;204;964;1509;5481;1713;6445
290620;201409;7296;21670;6518;20545;488;1661;5372;17002;5860;18663
290630;201409;8403;22564;7408;21505;835;2365;6014;17721;6849;20086
290640;201409;2770;8177;2302;7390;236;803;1646;5315;1882;6118
290650;201409;12102;35724;11362;34649;2805;8483;6850;21587;9655;30070
290660;201409;3825;10532;3128;9537;216;756;2474;7594;2690;8350
290670;201409;7152;21882;6502;20859;857;2661;4797;15901;5654;18562
290680;201409;10307;30608;9449;29580;601;2011;7934;25056;8535;27067
290682;201409;4601;13485;4145;12855;203;784;3445;10594;3648;11378
290685;201409;3400;8634;2515;7389;325;1023;1535;4616;1860;5639
290687;201409;8421;22714;6648;20504;1459;4749;3799;12009;5258;16758
290689;201409;3206;9172;2707;8390;247;810;2125;6681;2372;7491
290690;201409;5632;16381;5127;15741;546;1740;4087;12659;4633;14399
290700;201409;2285;7191;2184;7042;209;759;1718;5540;1927;6299
290710;201409;7951;25284;7352;24369;476;1540;6330;21257;6806;22797
290720;201409;19323;56567;17230;53998;1804;5176;14075;45432;15879;50608
290730;201409;7488;20880;6806;19993;1224;3514;4646;13881;5870;17395
290740;201409;964;2885;818;2645;119;397;524;1736;643;2133
290750;201409;10460;29985;9027;27405;1739;6052;4971;14331;6710;20383
290755;201409;2464;6923;2046;6225;132;478;1588;4805;1720;5283
290760;201409;4552;13397;3711;12126;408;1282;2664;8844;3072;10126
290770;201409;2654;9286;2466;9040;139;634;2012;7433;2151;8067
290780;201409;9126;23665;8080;22244;859;2007;6228;17782;7087;19789
290790;201409;4865;14388;4513;13891;424;1260;3582;11368;4006;12628
290800;201409;7573;16360;5805;14479;850;1856;4418;11509;5268;13365
290810;201409;5090;16212;4402;15120;334;1264;3332;11579;3666;12843
290820;201409;5569;15924;4986;15143;484;1641;3863;11760;4347;13401
290830;201409;4298;12056;4014;11614;284;1107;3214;8999;3498;10106
290840;201409;18276;51576;16631;49308;2710;7683;11493;35577;14203;43260
290850;201409;6955;20569;6803;20349;1143;3288;5102;15797;6245;19085
290860;201409;5035;17626;4701;17207;737;2713;3436;12987;4173;15700
290870;201409;4935;14728;4107;13568;440;1740;2992;9794;3432;11534
290880;201409;1450;4031;1194;3622;111;349;825;2523;936;2872
290890;201409;7073;18897;6178;17883;739;2134;4860;14267;5599;16401
290900;201409;2508;7314;1899;6297;288;1055;1019;3350;1307;4405
290910;201409;4989;13685;4275;12660;264;846;3575;10642;3839;11488
290920;201409;4927;14549;4444;13889;328;926;3661;11671;3989;12597
290930;201409;7733;24659;6944;23293;718;2796;5132;16991;5850;19787
290940;201409;3627;11536;3379;11213;284;934;2864;9720;3148;10654
290950;201409;1591;4481;1429;4250;209;637;985;2986;1194;3623
290960;201409;6124;17325;5594;16624;402;1219;4551;13692;4953;14911
290970;201409;3778;12171;3421;11542;480;1613;2240;7807;2720;9420
290980;201409;10914;32254;9524;29567;2719;8859;3797;11695;6516;20554
290990;201409;9399;28234;8260;26375;953;3200;6176;19737;7129;22937
291000;201409;3327;9947;3054;9593;350;1123;2414;7710;2764;8833
291005;201409;14326;39612;12847;37499;2130;6517;8747;25878;10877;32395
291010;201409;3189;10254;2561;8855;318;1174;1627;5681;1945;6855
291020;201409;1442;3812;1110;3232;136;470;667;1862;803;2332
291030;201409;2308;6341;1737;5191;190;633;1087;3174;1277;3807
291040;201409;5772;17761;5265;17040;677;2389;3906;12662;4583;15051
291050;201409;8134;27047;7418;25683;2028;7616;3704;12745;5732;20361
291060;201409;6393;23452;6063;23006;896;3857;4333;16395;5229;20252
291070;201409;16722;48932;15277;46877;1736;5328;11483;35869;13219;41197
291072;201409;22794;69543;19272;62549;5945;20455;7451;24988;13396;45443
291075;201409;5403;15428;4894;14747;392;1080;3775;11764;4167;12844
291077;201409;1585;4590;1312;4161;164;592;861;2706;1025;3298
291080;201409;84629;261456;75484;244593;23854;79904;28236;90627;52090;170531
291085;201409;5891;15662;5122;14634;576;1708;4000;11526;4576;13234
291090;201409;1515;3786;1327;3546;105;402;1083;2792;1188;3194
291100;201409;2712;7111;2217;6599;118;455;1870;5558;1988;6013
291110;201409;5155;18434;4618;17598;650;2846;3221;12135;3871;14981
291120;201409;7784;20839;7242;20073;950;2687;5452;15210;6402;17897
291125;201409;1766;3791;1421;3426;148;365;1083;2691;1231;3056
291130;201409;3043;9323;2641;8645;249;966;1895;6128;2144;7094
291140;201409;4263;12764;3897;12089;581;1847;2657;8316;3238;10163
291150;201409;2029;5312;1932;5197;184;512;1502;4028;1686;4540
291160;201409;5659;17455;4938;16330;1248;4157;2724;9183;3972;13340
291165;201409;2542;7397;2014;6401;126;549;1452;4468;1578;5017
291170;201409;21339;55417;18386;51720;1150;3859;14664;41015;15814;44874
291180;201409;6635;17397;5361;15565;625;2029;3810;10966;4435;12995
291185;201409;3967;10778;3678;10389;321;970;3047;8585;3368;9555
291190;201409;7645;21180;6859;20215;795;2363;5316;15992;6111;18355
291200;201409;2780;8439;2302;7562;179;624;1692;5619;1871;6243
291210;201409;7709;18223;6674;17047;550;1461;5389;13823;5939;15284
291220;201409;4309;13701;4038;13240;575;2092;2876;9337;3451;11429
291230;201409;4116;10660;3711;10190;122;303;3393;9414;3515;9717
291240;201409;4992;13387;4215;12030;267;813;3374;9519;3641;10332
291250;201409;3838;11468;3026;10092;335;1150;2067;6997;2402;8147
291260;201409;1185;3484;1101;3364;112;385;847;2579;959;2964
291270;201409;4449;14730;4111;14117;1137;4094;2255;7860;3392;11954
291280;201409;2484;6462;1874;5642;467;1465;1041;3125;1508;4590
291290;201409;6047;17013;5423;16225;885;2653;3562;10968;4447;13621
291300;201409;4646;13555;3894;12300;485;1727;2680;8387;3165;10114
291310;201409;5591;15951;4869;14735;415;1316;3746;11359;4161;12675
291320;201409;6278;20047;5411;18375;1300;4837;2854;9556;4154;14393
291330;201409;1714;5191;1586;4994;225;815;1041;3176;1266;3991
291340;201409;4096;11896;3284;10737;288;1067;2570;8379;2858;9446
291345;201409;3597;11633;3386;11403;217;687;2982;10295;3199;10982
291350;201409;5909;17533;5286;16545;455;1527;3937;12476;4392;14003
291360;201409;36541;105028;33845;101059;8492;24978;20057;62100;28549;87078
291370;201409;9254;26941;8858;26413;951;2764;6866;20993;7817;23757
291380;201409;3912;12030;3383;11153;279;957;2489;8415;2768;9372
291390;201409;10767;29749;9807;28614;1394;3917;7430;22039;8824;25956
291400;201409;17402;45553;14204;41277;2410;7000;9100;27497;11510;34497
291410;201409;3386;8831;2507;7551;193;774;1889;5531;2082;6305
291420;201409;2295;6079;2022;5753;117;336;1795;5156;1912;5492
291430;201409;3448;10046;3045;9520;237;937;2395;7374;2632;8311
291440;201409;6307;19739;5401;18146;567;1985;4093;13924;4660;15909
291450;201409;7907;24137;7052;22868;352;1139;5882;19510;6234;20649
291460;201409;13800;41626;12279;39314;2232;7634;7926;25547;10158;33181
291465;201409;8598;24760;7803;23844;773;2560;6335;19403;7108;21963
291470;201409;16237;44652;14324;42285;1460;4208;10825;33124;12285;37332
291480;201409;36561;98520;32507;92926;4990;15894;21549;61294;26539;77188
291490;201409;4592;15016;4481;14867;465;1516;3719;12540;4184;14056
291500;201409;4292;12483;3684;11615;294;1082;2922;9174;3216;10256
291510;201409;3740;11342;3439;10943;151;480;3089;9939;3240;10419
291520;201409;4169;11205;3640;10483;528;1481;2413;7213;2941;8694
291530;201409;2163;6250;1843;5749;471;1567;952;3050;1423;4617
291535;201409;4465;12909;4014;12250;338;1064;3089;9760;3427;10824
291540;201409;2296;5503;1958;5149;174;368;1665;4520;1839;4888
291550;201409;5787;15567;5192;14745;1241;3466;2972;8622;4213;12088
291560;201409;17907;45195;13859;40629;1333;3934;10775;32428;12108;36362
291570;201409;2524;6721;2393;6563;172;397;2130;5978;2302;6375
291580;201409;6003;18267;5320;17244;706;2746;3665;11843;4371;14589
291590;201409;2046;6331;1837;5990;291;982;1213;4115;1504;5097
291600;201409;5671;15610;4233;13468;1021;3584;2057;6426;3078;10010
291610;201409;5296;15921;5137;15707;368;1199;4394;13552;4762;14751
291620;201409;3160;7492;2606;6904;190;475;2072;5703;2262;6178
291630;201409;3259;8118;2831;7624;299;770;2278;6260;2577;7030
291640;201409;18227;49654;15043;45387;4091;13084;6168;18983;10259;32067
291650;201409;8403;24815;7707;23984;695;1734;6462;20862;7157;22596
291660;201409;2493;6521;2165;6069;258;871;1485;3997;1743;4868
291670;201409;2545;7022;2344;6709;376;1082;1404;4297;1780;5379
291680;201409;5106;14429;4576;13575;1123;3664;2230;6859;3353;10523
291685;201409;4794;11928;4036;10953;561;1464;2884;8115;3445;9579
291690;201409;4138;11269;3407;10127;327;963;2421;7285;2748;8248
291700;201409;9730;30193;8919;28836;1063;3533;6588;21689;7651;25222
291710;201409;6234;16393;5375;15294;927;2743;3399;10146;4326;12889
291720;201409;3957;13657;3566;12818;399;1650;2596;9204;2995;10854
291730;201409;6143;19216;5701;18628;957;3270;4059;13548;5016;16818
291733;201409;2681;7856;2268;7312;313;1088;1529;4960;1842;6048
291735;201409;2538;7284;2159;6701;128;474;1756;5387;1884;5861
291740;201409;4116;11907;3284;10635;358;1305;2341;7572;2699;8877
291750;201409;22850;59507;17896;52033;3951;11992;9546;28192;13497;40184
291760;201409;12786;40109;11548;37899;4413;15921;4183;13658;8596;29579
291770;201409;8275;23849;7412;22363;1190;3923;4891;14542;6081;18465
291780;201409;4439;13598;4156;13082;460;1449;3196;10111;3656;11560
291790;201409;2593;8052;2449;7856;125;519;2118;6724;2243;7243
291800;201409;33166;94575;29745;89733;5931;18341;18280;56820;24211;75161
291810;201409;11254;31501;9537;29441;634;2266;7784;24152;8418;26418
291820;201409;3803;11275;3421;10723;298;955;2714;8589;3012;9544
291830;201409;4527;12167;4189;11679;493;1454;3185;8928;3678;10382
291835;201409;6373;19726;5174;17672;1296;4757;2933;9990;4229;14747
291840;201409;50914;138814;43208;130454;5504;15978;33050;102907;38554;118885
291845;201409;3052;8781;2741;8412;220;613;2399;7487;2619;8100
291850;201409;4903;13722;4101;12595;462;1372;3074;9730;3536;11102
291855;201409;1772;4623;1529;4306;188;648;1126;3060;1314;3708
291860;201409;2119;6251;1807;5645;186;655;1186;3670;1372;4325
291870;201409;1435;3846;1102;3253;126;435;690;2020;816;2455
291875;201409;2947;9340;2653;8882;232;967;1910;6269;2142;7236
291880;201409;4837;15363;4560;14928;338;1130;3824;12630;4162;13760
291890;201409;1454;3642;1229;3370;303;854;733;2076;1036;2930
291900;201409;1353;3799;1151;3485;109;385;890;2677;999;3062
291905;201409;3039;7993;2516;7152;216;688;1805;5180;2021;5868
291910;201409;2760;7428;2344;6927;181;653;1931;5660;2112;6313
291915;201409;6923;21344;6122;19822;515;1719;5001;16406;5516;18125
291920;201409;33465;98069;30820;94100;6325;19958;18521;57904;24846;77862
291930;201409;2644;7835;2378;7412;246;867;1759;5468;2005;6335
291940;201409;3634;10349;2711;8725;426;1555;1500;4655;1926;6210
291950;201409;9476;31749;8599;30309;1873;6558;4889;17832;6762;24390
291955;201409;9248;29093;8790;28419;2122;6813;5212;17525;7334;24338
291960;201409;3443;10171;2890;9365;337;1018;2080;7082;2417;8100
291970;201409;4452;13344;3958;12709;579;1966;2754;8947;3333;10913
291980;201409;11708;33726;8956;29758;970;3398;6409;21763;7379;25161
291990;201409;2327;7142;2113;6826;183;620;1620;5362;1803;5982
291992;201409;2923;8967;2849;8817;437;1438;2102;6457;2539;7895
291995;201409;2195;6439;1956;6089;244;806;1465;4611;1709;5417
292000;201409;2272;6674;2027;6319;311;1119;1428;4386;1739;5505
292010;201409;6565;16752;5012;14478;504;1477;3830;11135;4334;12612
292020;201409;4624;15448;4291;14907;697;2532;2993;10570;3690;13102
292030;201409;2265;7008;2010;6649;256;924;1275;4248;1531;5172
292040;201409;4754;13138;4203;12563;327;858;3573;11090;3900;11948
292045;201409;2778;9567;2750;9523;91;276;2612;9093;2703;9369
292050;201409;6499;20233;5688;18627;572;2275;3852;12428;4424;14703
292060;201409;11601;31936;10943;31092;1048;2927;8950;25619;9998;28546
292070;201409;4529;14300;4402;14136;404;1212;3740;12171;4144;13383
292080;201409;3775;9764;3228;9068;294;860;2593;7367;2887;8227
292090;201409;4368;11496;3731;10775;328;1079;3044;8841;3372;9920
292100;201409;11216;30930;9503;28550;2716;8473;4382;13738;7098;22211
292105;201409;3266;9982;2822;9338;226;892;2261;7459;2487;8351
292110;201409;7240;19058;5548;16545;1223;3687;3176;9766;4399;13453
292120;201409;8789;24456;7748;22624;1655;4856;4063;12611;5718;17467
292130;201409;3202;8608;2851;8114;559;1501;1878;5502;2437;7003
292140;201409;5570;14330;4809;13294;923;2495;3007;8694;3930;11189
292145;201409;2758;8431;2514;8052;216;667;1904;6384;2120;7051
292150;201409;13810;41982;12785;40360;911;3254;10039;32068;10950;35322
292160;201409;2840;8108;2445;7586;167;486;2080;6598;2247;7084
292170;201409;9299;26866;7909;24508;1155;3970;4963;15494;6118;19464
292180;201409;3617;10360;2893;9220;443;1399;1862;6068;2305;7467
292190;201409;3430;9621;2900;8860;585;1875;1824;5666;2409;7541
292200;201409;6468;21125;5681;19576;1659;6133;2423;8357;4082;14490
292205;201409;4104;12631;3709;12076;275;1038;2994;9744;3269;10782
292210;201409;6869;19083;5833;17697;552;1784;4557;14080;5109;15864
292220;201409;2000;5573;1846;5361;391;1073;1124;3310;1515;4383
292225;201409;3187;9852;2929;9474;190;685;2421;7901;2611;8586
292230;201409;6414;19313;6118;18854;571;2267;4704;14018;5275;16285
292240;201409;4494;14193;4109;13364;628;2212;2596;8334;3224;10546
292250;201409;5346;16460;4969;15764;1170;3853;2569;8157;3739;12010
292260;201409;3249;9934;3101;9714;298;993;2509;7878;2807;8871
292265;201409;2907;9384;2615;8864;189;762;1987;6683;2176;7445
292270;201409;4183;10961;3359;9997;243;880;2760;8194;3003;9074
292273;201409;2860;6937;2201;6115;289;748;1596;4692;1885;5440
292275;201409;1936;5035;1740;4734;205;603;1295;3503;1500;4106
292280;201409;2113;6276;1913;6058;201;486;1494;5082;1695;5568
292285;201409;2706;7498;2375;7023;210;698;1847;5535;2057;6233
292290;201409;7597;22540;6353;20874;464;1740;4995;16633;5459;18373
292300;201409;8873;26892;7730;25597;1944;6547;4739;16202;6683;22749
292303;201409;2928;9079;2725;8801;128;485;2355;7591;2483;8076
292305;201409;3245;8750;3072;8519;126;375;2758;7676;2884;8051
292310;201409;6189;18197;5637;17438;245;880;4775;14792;5020;15672
292320;201409;6463;19001;5645;17621;565;1950;4329;13506;4894;15456
292330;201409;2079;5800;1944;5612;190;609;1540;4397;1730;5006
292335;201409;5490;14335;4894;13554;529;1415;3948;11079;4477;12494
292340;201409;6763;19077;5739;17422;641;2024;4036;12320;4677;14344
292350;201409;2229;6729;2043;6483;236;860;1603;5078;1839;5938
292360;201409;5124;14578;4921;14038;185;526;4363;12704;4548;13230
292370;201409;9347;27200;8461;25888;1131;3260;6038;19347;7169;22607
292380;201409;7632;22150;7102;21318;564;1571;5852;17816;6416;19387
292390;201409;3818;8594;3361;8099;113;188;3137;7664;3250;7852
292400;201409;22551;67012;21477;65295;3299;10535;15157;46841;18456;57376
292405;201409;4617;12005;3949;11174;277;777;3274;9363;3551;10140
292410;201409;1990;5344;1884;5222;146;394;1643;4581;1789;4975
292420;201409;3909;12496;3746;12291;171;458;3407;11426;3578;11884
292430;201409;5682;17088;4494;15410;309;1262;3428;11704;3737;12966
292440;201409;8776;28845;8121;27887;300;1177;7122;24824;7422;26001
292450;201409;4479;13273;3644;11940;353;1233;2636;8790;2989;10023
292460;201409;5758;17143;5056;15892;972;3193;3140;9962;4112;13155
292465;201409;2525;7569;2117;6909;235;879;1502;4940;1737;5819
292467;201409;2090;6792;1978;6603;367;1313;1324;4475;1691;5788
292470;201409;3290;8725;2713;7809;242;807;2050;5841;2292;6648
292480;201409;6520;17230;5598;15977;341;1110;4751;13538;5092;14648
292490;201409;2399;6591;2004;6014;179;636;1555;4610;1734;5246
292500;201409;6761;20217;5860;18676;689;2374;4155;13428;4844;15802
292510;201409;13649;38858;12014;36523;1231;3955;9257;28627;10488;32582
292520;201409;6136;18368;5530;17404;1558;4982;2850;9097;4408;14079
292525;201409;5675;14784;4933;13913;367;1089;4050;11556;4417;12645
292530;201409;26975;79589;24333;76156;5938;19141;13741;44482;19679;63623
292540;201409;2972;8514;2670;8106;332;1161;2025;6127;2357;7288
292550;201409;6844;21877;6048;20748;838;3061;4344;15247;5182;18308
292560;201409;4242;11670;3620;10839;298;1096;2903;8542;3201;9638
292570;201409;4171;12319;4008;12147;157;444;3555;11145;3712;11589
292575;201409;6281;21280;6101;20977;911;3266;4608;15869;5519;19135
292580;201409;7230;21395;6682;20696;541;1675;5548;17419;6089;19094
292590;201409;7526;23411;7175;22834;826;2718;5491;17537;6317;20255
292593;201409;3350;8715;2830;7953;268;760;2206;6197;2474;6957
292595;201409;6235;17232;5425;16172;502;1607;4167;12532;4669;14139
292600;201409;10886;30783;10113;29799;992;2337;8250;25205;9242;27542
292610;201409;4474;12940;3645;11562;445;1471;2414;7846;2859;9317
292620;201409;6015;17697;5228;16775;229;736;4739;15345;4968;16081
292630;201409;10094;25543;8679;23427;834;2320;6523;17932;7357;20252
292640;201409;8533;27211;7580;25933;628;2308;5864;20489;6492;22797
292650;201409;5120;13830;4884;13508;510;996;4047;11878;4557;12874
292660;201409;11460;34449;10780;33471;1287;4108;8229;26035;9516;30143
292665;201409;2719;8104;2651;8003;66;167;2521;7678;2587;7845
292670;201409;3988;11239;3078;9696;312;1080;2021;6398;2333;7478
292680;201409;3758;11288;3496;10890;412;1227;2745;8647;3157;9874
292690;201409;3454;9308;2462;7753;297;1001;1656;5328;1953;6329
292700;201409;9535;28497;8252;26634;1188;3567;5822;19654;7010;23221
292710;201409;1998;6546;1897;6400;86;319;1700;5766;1786;6085
292720;201409;9871;25325;8651;23941;708;1975;7271;20364;7979;22339
292730;201409;3631;10974;3486;10760;463;1429;2553;8022;3016;9451
292740;201409;371374;1030043;352066;1001924;80112;239782;214800;611342;294912;851124
292750;201409;6377;17250;5579;16150;400;1167;4556;13384;4956;14551
292760;201409;4316;13702;3958;13079;567;2010;2616;8760;3183;10770
292770;201409;6264;19063;5849;18401;1292;4071;3621;11750;4913;15821
292780;201409;1921;4655;1512;4145;180;601;1100;2967;1280;3568
292790;201409;3515;9163;3354;8990;235;509;2909;8089;3144;8598
292800;201409;9792;29270;9091;28132;853;2920;7146;22071;7999;24991
292805;201409;3277;9459;2986;9046;562;1825;2012;6102;2574;7927
292810;201409;10286;30853;8611;28588;1184;4075;6198;21082;7382;25157
292820;201409;7662;21811;5581;18816;405;1594;4453;15070;4858;16664
292830;201409;1951;5747;1772;5499;108;428;1476;4537;1584;4965
292840;201409;7656;24521;7178;23860;412;1550;6274;20819;6686;22369
292850;201409;3323;8806;2741;7942;300;931;1989;5712;2289;6643
292860;201409;15572;42314;14873;41374;1870;5356;11517;32229;13387;37585
292870;201409;20221;55877;17699;51970;2961;9532;10699;31080;13660;40612
292880;201409;12324;36252;11109;34390;1513;5070;7522;23145;9035;28215
292890;201409;5916;20051;5312;18929;974;3669;3154;11497;4128;15166
292895;201409;2818;7037;2253;6187;309;854;1618;4433;1927;5287
292900;201409;3140;9743;2969;9475;370;1461;2071;6375;2441;7836
292905;201409;4405;12675;3678;11757;273;767;3066;10097;3339;10864
292910;201409;5296;16170;4817;15296;839;2882;2984;9396;3823;12278
292920;201409;8982;26724;8520;26016;835;2870;6690;19939;7525;22809
292925;201409;5278;16257;4657;15382;471;1608;3557;11861;4028;13469
292930;201409;6620;21411;6304;20842;664;2762;4695;15163;5359;17925
292935;201409;2161;6136;1810;5752;122;307;1532;5070;1654;5377
292937;201409;3371;8573;2839;7911;320;1002;2171;5981;2491;6983
292940;201409;3209;8806;2524;7849;311;989;1734;5587;2045;6576
292950;201409;8433;25592;8019;24873;972;3579;5842;17644;6814;21223
292960;201409;5127;13686;4495;12809;470;1455;3275;9275;3745;10730
292970;201409;4500;13515;4004;12869;200;806;3343;10778;3543;11584
292975;201409;3522;9574;3360;9341;365;993;2785;7838;3150;8831
292980;201409;3661;9861;2961;8974;388;1348;2063;6192;2451;7540
292990;201409;12447;35747;11239;33906;705;2254;9521;28767;10226;31021
293000;201409;3016;7856;2468;7164;125;423;2146;6220;2271;6643
293010;201409;19493;54682;16974;50702;3050;9900;10463;31212;13513;41112
293015;201409;8172;26360;6615;23957;1063;4256;4253;15330;5316;19586
293020;201409;9693;31970;9054;31062;620;2422;7474;25875;8094;28297
293030;201409;5783;16729;4642;15014;456;1530;3247;10933;3703;12463
293040;201409;3651;11983;3483;11648;186;669;3085;10303;3271;10972
293050;201409;21005;58780;18615;55722;2853;8693;12564;38540;15417;47233
293060;201409;4431;11373;3709;10228;422;1243;2561;7023;2983;8266
293070;201409;21245;64326;19478;61270;5293;16926;10075;32548;15368;49474
293075;201409;3471;11267;3141;10835;250;907;2568;8955;2818;9862
293076;201409;3844;10731;3552;10313;270;756;2976;8806;3246;9562
293077;201409;5122;15875;4438;14970;1021;3615;2541;8687;3562;12302
293080;201409;4928;15504;4500;14813;334;1444;3538;11412;3872;12856
293090;201409;3626;11370;2963;10417;302;1099;2234;7988;2536;9087
293100;201409;5917;17926;5056;16414;551;1902;3709;12196;4260;14098
293105;201409;3982;13293;3517;12397;499;1850;2393;8576;2892;10426
293110;201409;2049;6074;1875;5804;126;449;1543;4758;1669;5207
293120;201409;4124;13601;3822;13173;383;1288;2995;10559;3378;11847
293130;201409;4130;11604;3377;10755;178;644;2992;9660;3170;10304
293135;201409;30812;78681;23528;68645;4755;16034;11379;32802;16134;48836
293140;201409;2167;6344;2077;6212;219;784;1593;4645;1812;5429
293150;201409;5928;19441;5297;18212;1046;3714;3126;11114;4172;14828
293160;201409;3660;9828;3412;9543;464;940;2649;7892;3113;8832
293170;201409;3555;10702;3282;10295;478;1628;2312;7344;2790;8972
293180;201409;5478;15404;4499;13878;356;1287;3475;10574;3831;11861
293190;201409;14179;43091;13360;41853;596;2679;11542;35510;12138;38189
293200;201409;6628;19134;5837;18057;280;1024;4979;15426;5259;16450
293210;201409;5192;15151;4727;14397;471;1562;3532;10806;4003;12368
293220;201409;5350;16050;4763;15061;1193;3926;2451;7887;3644;11813
293230;201409;4079;12672;3745;12192;577;2050;2667;8707;3244;10757
293240;201409;4623;12132;3628;10696;195;592;2841;8366;3036;8958
293245;201409;4601;13122;4189;12477;510;1516;3024;9331;3534;10847
293250;201409;6047;16946;5537;16199;665;2052;4030;11801;4695;13853
293260;201409;4876;14519;4063;13334;373;1346;3011;9985;3384;11331
293270;201409;5916;16143;5607;15811;543;1339;4827;13955;5370;15294
293280;201409;5771;16156;4990;15129;456;1259;3866;12119;4322;13378
293290;201409;16811;56079;15836;54133;3732;13253;8618;30081;12350;43334
293300;201409;6850;16808;5875;15710;482;1220;4783;12978;5265;14198
293305;201409;4902;12225;4267;11354;278;784;3560;9486;3838;10270
293310;201409;2808;7193;2277;6327;235;704;1593;4379;1828;5083
293315;201409;5021;12662;4534;11941;741;1883;2897;8074;3638;9957
293317;201409;2633;7683;2351;7164;275;882;1551;4721;1826;5603
293320;201409;8229;27078;8038;26831;719;2603;6763;22613;7482;25216
293325;201409;1962;5681;1634;5178;250;857;1104;3533;1354;4390
293330;201409;55841;176946;50300;167537;11374;40736;27081;91288;38455;132024
293340;201409;2748;7838;2179;6857;312;1098;1479;4551;1791;5649
293345;201409;3661;10854;3080;10034;346;1125;2257;7597;2603;8722
293350;201409;6897;19246;6575;18873;408;1010;5852;17189;6260;18199
293360;201409;14118;42717;12838;41052;864;2690;10945;35719;11809;38409
310010;201409;1226;3314;885;2769;224;847;371;1056;595;1903
310020;201409;3897;12373;3245;10950;1130;4122;612;1874;1742;5996
310030;201409;2611;8467;2244;7805;648;2406;1110;3831;1758;6237
310040;201409;1051;2871;877;2630;91;318;659;1958;750;2276
310050;201409;1939;6736;1726;6231;323;1382;897;3190;1220;4572
310060;201409;3328;10980;2986;10518;375;1377;2259;8075;2634;9452
310070;201409;318;913;245;776;33;142;133;378;166;520
310080;201409;785;2407;638;2120;177;678;222;679;399;1357
310090;201409;5014;14841;4329;13654;680;2373;2671;8436;3351;10809
310100;201409;3458;10502;2875;9525;277;1112;2140;7037;2417;8149
310110;201409;6048;17045;5081;15581;1139;3978;2817;8545;3956;12523
310120;201409;610;1956;561;1871;208;829;242;690;450;1519
310130;201409;473;1480;432;1414;105;398;223;684;328;1082
310140;201409;267;931;233;868;82;342;52;170;134;512
310150;201409;5101;15784;4592;14846;1017;3698;2342;7524;3359;11222
310160;201409;7771;24829;6583;22695;1983;7548;2405;8212;4388;15760
310163;201409;864;2904;748;2664;204;808;299;1021;503;1829
310170;201409;10194;28898;9341;27626;1656;5040;6092;18634;7748;23674
310180;201409;1916;5499;1565;5009;408;1463;751;2326;1159;3789
310190;201409;2627;8840;2384;8428;753;2951;417;1529;1170;4480
310200;201409;1978;6641;1663;5985;490;1950;572;2028;1062;3978
310205;201409;1091;3267;904;2957;186;617;524;1762;710;2379
310210;201409;2636;8128;2413;7794;328;1192;1777;5721;2105;6913
310220;201409;1282;3638;1034;3313;223;781;589;1851;812;2632
310230;201409;3020;9824;2593;8873;757;2969;1025;3240;1782;6209
310240;201409;1048;3662;894;3371;164;680;447;1775;611;2455
310250;201409;990;3397;963;3353;218;860;569;1916;787;2776
310260;201409;3223;10358;2681;9200;673;2592;1011;3377;1684;5969
310270;201409;2532;7425;2230;6982;200;668;1747;5544;1947;6212
310280;201409;2243;6367;1987;5965;458;1676;1036;2951;1494;4627
310285;201409;2247;7854;2108;7646;299;1128;1583;5872;1882;7000
310290;201409;1347;4211;1255;4073;375;1377;593;1756;968;3133
310300;201409;1943;6599;1835;6377;516;1964;992;3399;1508;5363
310310;201409;397;1092;287;866;52;156;139;419;191;575
310320;201409;415;1362;354;1235;74;315;166;565;240;880
310330;201409;518;1307;374;1055;43;158;207;525;250;683
310340;201409;8789;27146;7549;25099;1531;5309;4260;14589;5791;19898
310350;201409;16095;45577;12372;39085;4184;14306;3503;11115;7687;25421
310360;201409;481;1501;465;1474;79;290;313;946;392;1236
310370;201409;1500;5299;1447;5200;426;1598;775;2797;1201;4395
310375;201409;1442;3891;968;3039;168;601;425;1276;593;1877
310380;201409;401;1135;317;1019;128;458;127;374;255;832
310390;201409;509;1823;434;1652;118;488;78;257;196;745
310400;201409;10611;31879;8492;28057;2705;9712;2576;8540;5281;18252
310410;201409;1063;3438;698;2844;242;1049;152;619;394;1668
310420;201409;5957;17213;3585;11799;825;3052;643;1882;1468;4934
310430;201409;1697;5761;1400;5146;457;1795;362;1308;819;3103
310440;201409;626;1836;543;1708;150;516;224;680;374;1196
310445;201409;1262;4152;1054;3762;168;677;658;2328;826;3005
310450;201409;4782;13734;3898;12441;697;2388;2489;8128;3186;10516
310460;201409;1680;5393;1450;4980;481;1806;337;1206;818;3012
310470;201409;3794;9786;3224;9070;319;1030;2533;7157;2852;8187
310480;201409;1184;3640;977;3220;237;916;410;1233;647;2149
310490;201409;3388;11443;2981;10663;1006;3942;1124;3983;2130;7925
310500;201409;1556;5380;1432;5122;424;1650;591;2088;1015;3738
310510;201409;2648;8670;2226;7684;784;2933;472;1554;1256;4487
310520;201409;1432;3850;1149;3386;88;270;776;2302;864;2572
310530;201409;893;2854;550;1952;119;475;108;356;227;831
310540;201409;3849;12638;3548;12184;1241;4463;1417;4954;2658;9417
310550;201409;1256;3763;1039;3382;291;1126;442;1309;733;2435
310560;201409;16866;52658;14472;47966;4559;16747;4908;15481;9467;32228
310570;201409;1290;3982;1207;3873;168;593;897;2885;1065;3478
310590;201409;4250;12510;3373;10823;653;2354;1346;4144;1999;6498
310600;201409;1663;5623;1549;5367;533;2077;539;1720;1072;3797
310610;201409;581;1953;532;1855;162;671;180;556;342;1227
310620;201409;193840;613146;160280;545426;43292;163891;61978;202468;105270;366359
310630;201409;4342;14044;4111;13616;784;2924;2746;8920;3530;11844
310640;201409;1483;4553;1191;4027;422;1541;297;934;719;2475
310650;201409;2966;9481;2412;8526;470;1808;1322;4791;1792;6599
310660;201409;1405;4200;1224;3943;171;591;903;2868;1074;3459
310665;201409;1251;3905;1143;3741;195;685;784;2605;979;3290
310670;201409;58188;182737;53446;172311;16006;54102;22822;72918;38828;127020
310680;201409;822;2394;739;2265;173;574;383;1154;556;1728
310690;201409;1349;4454;1087;3949;334;1387;305;1030;639;2417
310700;201409;546;1487;447;1344;127;434;222;628;349;1062
310710;201409;7447;24276;5883;21659;1597;6548;1694;6153;3291;12701
310720;201409;872;2680;794;2535;231;845;358;1061;589;1906
310730;201409;9927;31229;9017;29776;2031;7284;5351;17700;7382;24984
310740;201409;5475;18330;4591;16488;1568;6157;1096;3755;2664;9912
310750;201409;1693;4339;1364;3906;238;691;923;2679;1161;3370
310760;201409;651;2010;557;1842;135;478;240;781;375;1259
310770;201409;806;2913;778;2857;278;1135;346;1221;624;2356
310780;201409;3845;10946;3374;10127;592;1822;2081;6268;2673;8090
310790;201409;1907;6084;1703;5723;470;1638;845;2920;1315;4558
310800;201409;3144;10188;2503;8912;994;3876;389;1330;1383;5206
310810;201409;1537;4320;1397;4081;324;1034;698;1963;1022;2997
310820;201409;1547;4357;1107;3578;308;1100;348;1068;656;2168
310825;201409;2485;8456;1999;7589;167;864;1462;5473;1629;6337
310830;201409;1437;4856;1189;4331;393;1521;362;1256;755;2777
310840;201409;2400;7774;2025;7068;766;2943;551;1801;1317;4744
310850;201409;1599;4792;1367;4483;197;727;1004;3279;1201;4006
310855;201409;3258;10491;2891;9904;657;2405;1730;6036;2387;8441
310860;201409;8198;25282;7125;23436;1185;4149;4170;14093;5355;18242
310870;201409;1009;2872;829;2563;165;550;429;1316;594;1866
310880;201409;1266;3901;963;3330;203;811;454;1543;657;2354
310890;201409;2827;8978;2256;7908;673;2667;674;2223;1347;4890
310900;201409;4625;15400;3941;14007;1176;4621;1534;5269;2710;9890
310910;201409;2138;6132;1442;4801;402;1496;354;1113;756;2609
310920;201409;1975;6007;1574;5430;405;1592;761;2625;1166;4217
310925;201409;969;3227;880;3065;345;1318;290;1008;635;2326
310930;201409;5636;16451;4533;14749;840;2957;2672;8906;3512;11863
310940;201409;6482;18898;5473;17333;1107;3783;2977;9447;4084;13230
310945;201409;1373;3915;1130;3576;223;817;673;2041;896;2858
310950;201409;2103;6943;1633;5874;533;2132;479;1606;1012;3738
310960;201409;495;1666;423;1529;157;614;141;512;298;1126
310970;201409;1546;5368;1166;4365;385;1579;171;563;556;2142
310980;201409;478;1248;324;955;57;205;147;380;204;585
310990;201409;1233;4229;1055;3836;271;1104;345;1157;616;2261
311000;201409;3593;12397;3146;11428;905;3769;1149;3920;2054;7689
311010;201409;980;3170;873;2978;281;1018;417;1398;698;2416
311020;201409;935;2917;786;2667;194;750;318;997;512;1747
311030;201409;1940;5782;1486;4846;457;1648;493;1448;950;3096
311040;201409;503;1697;434;1511;107;394;102;341;209;735
311050;201409;2684;8737;2296;7972;697;2655;913;3157;1610;5812
311060;201409;2542;7955;2036;6852;603;2183;499;1628;1102;3811
311070;201409;1762;6234;1553;5804;435;1831;502;1867;937;3698
311080;201409;1242;3380;1110;3177;176;575;712;2022;888;2597
311090;201409;1711;6401;1456;5863;508;2338;280;1047;788;3385
311100;201409;2458;8543;2149;7891;944;3675;515;1894;1459;5569
311110;201409;4162;10044;2972;8358;609;1893;1528;4225;2137;6118
311115;201409;1187;3576;1031;3340;132;533;659;2141;791;2674
311120;201409;7923;22555;6154;19271;1634;5751;1665;4806;3299;10557
311130;201409;2431;7424;1938;6757;553;2254;849;2833;1402;5087
311140;201409;1478;4111;1224;3788;177;645;842;2532;1019;3177
311150;201409;2445;8197;2261;7891;610;2204;1130;4020;1740;6224
311160;201409;5026;16947;4227;15543;1551;6139;1338;4872;2889;11011
311170;201409;769;2386;607;2069;81;274;327;1179;408;1453
311180;201409;1643;4597;1201;3725;375;1265;281;789;656;2054
311190;201409;1122;3363;950;3007;258;930;374;1084;632;2014
311200;201409;2222;6843;1837;6020;614;2226;432;1250;1046;3476
311205;201409;1214;3938;1063;3630;263;1017;423;1474;686;2491
311210;201409;985;3191;898;3059;168;575;626;2197;794;2772
311220;201409;940;3015;754;2593;211;772;255;866;466;1638
311230;201409;9141;28091;7664;25388;1622;5879;3722;12602;5344;18481
311240;201409;1367;4203;1138;3826;370;1335;383;1298;753;2633
311250;201409;976;3213;876;3056;253;1015;307;925;560;1940
311260;201409;2975;8160;2265;6920;693;2323;710;2113;1403;4436
311265;201409;1354;3602;1045;3161;162;598;696;2088;858;2686
311270;201409;3555;11499;3156;10947;571;2321;2104;7137;2675;9458
311280;201409;1482;4157;1087;3389;301;1040;333;1008;634;2048
311290;201409;2365;7737;2195;7386;433;1450;1280;4443;1713;5893
311300;201409;5124;16897;4602;16024;720;2846;3022;10608;3742;13454
311310;201409;503;1792;487;1765;118;501;217;735;335;1236
311320;201409;4221;14201;3695;13004;933;3770;1329;4434;2262;8204
311330;201409;5647;17262;4854;16005;1733;6153;1732;5639;3465;11792
311340;201409;12831;41267;11568;38834;3845;13869;3676;12255;7521;26124
311350;201409;2412;7107;2012;6357;462;1696;910;2723;1372;4419
311360;201409;1364;3878;1083;3503;494;1665;278;922;772;2587
311370;201409;4713;13999;4148;13034;1093;4078;1714;5015;2807;9093
311380;201409;495;1620;420;1481;125;510;132;427;257;937
311390;201409;2029;7480;1904;7267;861;3660;606;2181;1467;5841
311400;201409;1752;5850;1598;5572;466;1845;716;2312;1182;4157
311410;201409;2083;7497;1934;7286;627;2528;1003;3825;1630;6353
311420;201409;2499;8602;2037;7439;736;2870;482;1587;1218;4457
311430;201409;4191;13085;3080;10581;758;2852;584;1956;1342;4808
311440;201409;2323;7837;1819;6855;677;2933;357;1281;1034;4214
311450;201409;1900;6709;1609;5992;495;2031;386;1328;881;3359
311455;201409;1641;4451;1397;4084;321;1047;760;2147;1081;3194
311460;201409;679;2230;523;1898;126;569;137;468;263;1037
311470;201409;624;1991;502;1722;147;599;158;489;305;1088
311480;201409;834;2316;788;2246;251;713;375;1039;626;1752
311490;201409;317;1238;297;1174;114;470;98;375;212;845
311500;201409;533;1609;438;1431;149;522;172;553;321;1075
311510;201409;3221;10057;2628;8908;1013;3902;708;2239;1721;6141
311520;201409;708;2422;665;2329;251;942;250;848;501;1790
311530;201409;11795;31122;8134;24771;2204;7976;2399;7012;4603;14988
311535;201409;762;2300;540;1840;129;514;97;303;226;817
311540;201409;715;2572;683;2524;224;872;350;1267;574;2139
311545;201409;2304;7144;2146;6939;313;1126;1524;4925;1837;6051
311547;201409;1689;4676;1427;4271;145;451;967;2928;1112;3379
311550;201409;3462;11265;2979;10254;865;3325;1014;3415;1879;6740
311560;201409;293;780;257;735;64;209;145;391;209;600
311570;201409;2174;5395;1735;4848;117;337;1404;3996;1521;4333
311580;201409;2480;5417;2034;4883;607;1362;1140;2888;1747;4250
311590;201409;415;1323;362;1252;115;469;105;359;220;828
311600;201409;1436;4238;1203;3952;301;958;693;2377;994;3335
311610;201409;3433;11885;3178;11472;1048;3786;1414;5474;2462;9260
311615;201409;2843;9249;2433;8544;301;1259;1712;5972;2013;7231
311620;201409;464;1492;419;1430;105;403;225;753;330;1156
311630;201409;1481;4414;1259;4021;290;922;670;2184;960;3106
311640;201409;897;2802;738;2541;138;513;473;1629;611;2142
311650;201409;2473;7081;2008;6335;307;1055;1176;3798;1483;4853
311660;201409;2722;9559;2344;8686;702;2905;421;1370;1123;4275
311670;201409;1473;4515;1263;4143;431;1557;523;1690;954;3247
311680;201409;2357;7322;1963;6742;469;1711;1113;3884;1582;5595
311690;201409;577;1580;492;1479;82;270;340;1016;422;1286
311700;201409;2302;6486;2005;6056;193;749;1547;4553;1740;5302
311710;201409;1771;5466;1388;4780;551;2070;404;1357;955;3427
311720;201409;415;1424;381;1357;65;262;245;858;310;1120
311730;201409;5662;14812;3508;10979;1064;3751;1251;3550;2315;7301
311740;201409;1016;2918;880;2750;366;1122;428;1401;794;2523
311750;201409;4015;13491;3638;12907;691;2722;2179;7738;2870;10460
311760;201409;812;2760;761;2653;211;866;337;1060;548;1926
311770;201409;2597;8162;2125;7316;578;2245;664;2195;1242;4440
311780;201409;1167;4359;995;3920;378;1668;221;818;599;2486
311783;201409;2140;6892;1864;6358;193;769;1252;4378;1445;5147
311787;201409;638;2235;469;1737;93;367;100;325;193;692
311790;201409;1379;4371;1115;3849;328;1226;312;1025;640;2251
311800;201409;4032;13772;2939;10453;705;2681;230;662;935;3343
311810;201409;1054;3556;997;3454;48;229;835;2867;883;3096
311820;201409;847;2783;714;2464;232;923;331;1052;563;1975
311830;201409;10944;38939;9768;35969;3861;14882;2313;8483;6174;23365
311840;201409;3534;10475;3055;9750;944;3352;1345;4170;2289;7522
311850;201409;327;981;282;905;79;269;136;435;215;704
311860;201409;51577;159954;44851;147163;11761;42499;20085;63824;31846;106323
311870;201409;2434;7248;1930;6289;508;1888;640;1921;1148;3809
311880;201409;7295;21461;6570;20570;1067;3268;4473;14652;5540;17920
311890;201409;1652;5202;1386;4632;400;1482;544;1754;944;3236
311900;201409;809;2537;734;2433;143;475;465;1636;608;2111
311910;201409;4863;14207;3961;12978;1133;3990;1678;5549;2811;9539
311920;201409;2137;6930;1831;6452;230;896;1221;4277;1451;5173
311930;201409;4950;14658;4394;13767;1793;5895;1363;4333;3156;10228
311940;201409;11875;36264;9841;32022;3009;10690;2376;7313;5385;18003
311950;201409;2351;6958;1989;6483;146;486;1539;5074;1685;5560
311960;201409;432;1433;397;1362;118;475;182;547;300;1022
311970;201409;481;1717;414;1571;130;553;78;282;208;835
311980;201409;800;2221;576;1855;139;484;211;686;350;1170
311990;201409;525;1601;465;1507;188;647;161;489;349;1136
311995;201409;1174;3614;784;2653;169;639;183;531;352;1170
312000;201409;710;2203;665;2134;130;466;376;1200;506;1666
312010;201409;1055;3419;950;3193;201;740;431;1439;632;2179
312015;201409;1620;4949;1397;4562;208;808;847;2776;1055;3584
312020;201409;1008;3272;896;3102;247;958;448;1535;695;2493
312030;201409;1849;5501;1659;5258;177;632;1304;4118;1481;4750
312040;201409;700;2659;602;2362;171;754;128;470;299;1224
312050;201409;1494;5181;1302;4782;403;1643;298;1047;701;2690
312060;201409;767;2358;677;2230;313;1095;199;590;512;1685
312070;201409;996;3086;656;2332;166;644;236;823;402;1467
312080;201409;2718;7636;2116;6686;461;1739;1026;2990;1487;4729
312083;201409;974;2759;810;2516;129;469;491;1502;620;1971
312087;201409;2363;7207;2102;6843;314;1084;1486;4920;1800;6004
312090;201409;10120;32815;9197;31203;2943;10996;3788;12467;6731;23463
312100;201409;1389;4702;1218;4411;259;1033;670;2489;929;3522
312110;201409;1206;4283;1075;3994;402;1663;215;713;617;2376
312120;201409;952;3322;857;3113;273;1093;247;814;520;1907
312125;201409;1327;4292;1188;4012;322;1130;570;1972;892;3102
312130;201409;870;2656;707;2310;167;619;287;894;454;1513
312140;201409;1100;3489;906;3022;215;787;312;923;527;1710
312150;201409;567;1624;476;1425;41;143;322;935;363;1078
312160;201409;8347;28408;7615;26905;2412;9268;2727;9694;5139;18962
312170;201409;1025;3040;919;2838;133;433;549;1719;682;2152
312180;201409;1641;5058;1489;4794;419;1412;599;1890;1018;3302
312190;201409;703;2320;554;2025;230;924;107;364;337;1288
312200;201409;4948;14809;4304;13750;551;1873;2996;9611;3547;11484
312210;201409;1268;3421;982;3003;272;918;454;1344;726;2262
312220;201409;1970;6474;1778;6250;239;870;1355;4950;1594;5820
312230;201409;18573;61825;15662;55976;7271;27391;3336;12346;10607;39737
312235;201409;1792;5148;1503;4706;156;621;1034;3222;1190;3843
312240;201409;1133;3872;972;3531;292;1145;346;1252;638;2397
312245;201409;2441;7129;2116;6689;183;522;1696;5474;1879;5996
312247;201409;939;2778;717;2420;184;706;351;1207;535;1913
312250;201409;1208;3502;1009;3152;225;796;463;1392;688;2188
312260;201409;983;3094;801;2829;132;557;534;1871;666;2428
312270;201409;808;2514;678;2270;155;622;255;737;410;1359
312280;201409;482;1659;442;1566;199;747;59;203;258;950
312290;201409;854;2935;806;2866;331;1321;213;741;544;2062
312300;201409;1138;3787;949;3353;295;1112;148;466;443;1578
312310;201409;959;3645;874;3428;257;1086;352;1350;609;2436
312320;201409;2452;7001;1956;5974;564;1919;480;1210;1044;3129
312330;201409;1206;3607;1050;3375;263;970;595;1906;858;2876
312340;201409;328;851;292;804;43;157;220;572;263;729
312350;201409;384;1003;356;968;47;150;289;754;336;904
312352;201409;1689;5517;1552;5319;435;1502;934;3310;1369;4812
312360;201409;3793;12840;3295;11796;1080;4212;910;3212;1990;7424
312370;201409;1695;5474;1564;5258;577;2161;550;1737;1127;3898
312380;201409;2050;5962;1850;5658;250;784;1337;4216;1587;5000
312385;201409;1299;4006;1154;3758;161;663;775;2420;936;3083
312390;201409;2026;6766;1681;5995;520;1965;327;1082;847;3047
312400;201409;3528;11604;3067;10683;1128;4086;1075;3896;2203;7982
312410;201409;11065;36929;9931;34654;2964;11245;3699;12633;6663;23878
312420;201409;4189;13264;3981;13011;703;2309;2811;9442;3514;11751
312430;201409;8704;25730;7740;24287;1395;4419;5015;16261;6410;20680
312440;201409;678;2173;591;2022;144;538;299;1037;443;1575
312450;201409;1131;4022;1014;3795;434;1680;368;1378;802;3058
312460;201409;396;1208;354;1161;82;298;189;610;271;908
312470;201409;781;2220;539;1737;128;472;149;468;277;940
312480;201409;1396;4088;1151;3802;388;1380;528;1680;916;3060
312490;201409;2002;5393;1600;4815;234;854;982;2833;1216;3687
312500;201409;680;2230;620;2142;146;614;335;1106;481;1720
312510;201409;2817;9048;2308;7931;554;2197;953;2992;1507;5189
312520;201409;405;1385;356;1287;123;460;125;461;248;921
312530;201409;607;1979;572;1915;111;457;335;1056;446;1513
312540;201409;1497;4714;1171;4059;293;1100;582;1981;875;3081
312550;201409;644;2084;583;1957;59;227;391;1287;450;1514
312560;201409;2257;5950;1967;5571;208;674;1516;4315;1724;4989
312570;201409;2807;8495;2415;7798;760;2605;795;2495;1555;5100
312580;201409;542;1814;444;1615;104;450;176;603;280;1053
312590;201409;1878;6274;1654;5789;456;1839;587;1871;1043;3710
312595;201409;2091;7065;1863;6523;516;1948;880;3018;1396;4966
312600;201409;822;2962;749;2804;202;869;348;1224;550;2093
312610;201409;9027;27637;7487;24763;2739;9769;2210;7101;4949;16870
312620;201409;2120;6120;1625;5454;118;416;1306;4516;1424;4932
312630;201409;516;1735;478;1663;130;507;214;718;344;1225
312640;201409;612;1998;501;1763;131;539;198;640;329;1179
312650;201409;2400;7072;1718;5792;210;812;937;3125;1147;3937
312660;201409;1336;3712;1123;3387;142;512;767;2263;909;2775
312670;201409;6226;19037;5556;18063;1381;5035;2797;8958;4178;13993
312675;201409;1482;4666;1267;4226;214;779;715;2412;929;3191
312680;201409;1738;5302;1552;5004;247;884;945;3118;1192;4002
312690;201409;2428;6590;1990;5976;395;1383;1092;3142;1487;4525
312695;201409;928;3314;868;3227;181;662;574;2213;755;2875
312700;201409;2045;5955;1549;5003;235;851;818;2620;1053;3471
312705;201409;1457;4248;1256;3937;191;621;848;2668;1039;3289
312707;201409;1782;5509;1467;4980;242;993;806;2674;1048;3667
312710;201409;8507;23806;6167;19660;2239;7911;1429;4284;3668;12195
312720;201409;778;2648;704;2507;189;745;301;1020;490;1765
312730;201409;1954;4788;1431;4185;236;802;834;2426;1070;3228
312733;201409;1768;4752;1327;3926;116;429;939;2661;1055;3090
312735;201409;922;2690;817;2539;267;920;405;1207;672;2127
312737;201409;1049;2556;737;2130;244;728;295;896;539;1624
312738;201409;557;1772;431;1513;127;518;159;527;286;1045
312740;201409;514;1472;350;1264;120;468;107;393;227;861
312750;201409;1321;4719;1260;4596;322;1341;608;2163;930;3504
312760;201409;2448;7883;1926;6846;568;2221;444;1598;1012;3819
312770;201409;46875;128919;36473;112740;10847;36426;12212;37249;23059;73675
312780;201409;2878;10170;2581;9650;518;2100;1477;5667;1995;7767
312790;201409;388;1016;238;747;77;278;63;170;140;448
312800;201409;5395;18201;4633;16642;1508;5781;1455;5326;2963;11107
312810;201409;2314;7123;1676;5934;551;2154;373;1244;924;3398
312820;201409;2195;6467;1976;6108;258;966;1280;3826;1538;4792
312825;201409;1551;4228;1358;3996;138;438;1073;3151;1211;3589
312830;201409;2862;9238;2065;7578;571;2297;403;1475;974;3772
312840;201409;1225;4028;1034;3659;210;888;478;1627;688;2515
312850;201409;649;2140;547;1933;125;515;204;702;329;1217
312860;201409;1334;3875;999;3306;319;1228;293;852;612;2080
312870;201409;5784;18395;4461;15803;1222;4854;1295;4432;2517;9286
312880;201409;1293;3911;1099;3582;207;751;614;2001;821;2752
312890;201409;1558;4714;1098;3729;360;1381;366;1188;726;2569
312900;201409;1493;4801;1371;4630;356;1243;833;2864;1189;4107
312910;201409;1582;3554;1197;3030;293;858;582;1364;875;2222
312920;201409;1049;3420;923;3239;285;1114;407;1394;692;2508
312930;201409;2290;6746;2013;6346;465;1537;1029;3328;1494;4865
312940;201409;947;3178;852;3009;263;1085;248;813;511;1898
312950;201409;3577;10221;2887;9170;1002;3436;1059;3324;2061;6760
312960;201409;2034;6083;1838;5824;257;782;1364;4459;1621;5241
312965;201409;1843;5867;1566;5363;305;1125;903;3140;1208;4265
312970;201409;1207;4126;1044;3871;412;1724;199;705;611;2429
312980;201409;21954;76383;20923;73943;7930;29971;7795;26905;15725;56876
312990;201409;411;1266;313;1088;117;454;99;340;216;794
313000;201409;540;1817;444;1619;135;597;162;529;297;1126
313005;201409;2729;8795;2416;8270;441;1612;1447;4997;1888;6609
313010;201409;4252;14256;3780;13450;1191;4648;1554;5298;2745;9946
313020;201409;1062;3651;964;3429;323;1287;291;907;614;2194
313030;201409;1625;4561;1298;4113;345;1245;666;2006;1011;3251
313040;201409;996;3482;854;3082;208;837;282;964;490;1801
313050;201409;1964;6348;1615;5837;538;2171;592;2041;1130;4212
313055;201409;1567;5158;1430;4961;135;502;1086;3825;1221;4327
313060;201409;1034;3524;899;3186;391;1442;152;519;543;1961
313065;201409;2030;6594;1783;6208;307;1214;1268;4386;1575;5600
313070;201409;1277;3778;1039;3332;265;975;506;1529;771;2504
313080;201409;485;1524;397;1348;113;448;129;362;242;810
313090;201409;5639;16576;5023;15587;842;2740;3331;10507;4173;13247
313100;201409;1192;3831;1110;3710;176;650;806;2665;982;3315
313110;201409;1770;5182;1378;4436;325;1214;522;1549;847;2763
313115;201409;2889;10123;2762;9872;857;3425;1313;4487;2170;7912
313120;201409;3997;11279;3483;10565;882;2860;2097;6360;2979;9220
313130;201409;25363;78126;21913;70855;6320;22363;7573;23148;13893;45511
313140;201409;715;1878;536;1599;44;162;361;1057;405;1219
313150;201409;1693;5288;1514;4975;683;2320;415;1404;1098;3724
313160;201409;1188;3595;1046;3356;212;788;619;1904;831;2692
313170;201409;9901;36171;9006;34009;3499;13754;2049;7776;5548;21530
313180;201409;2834;7363;2133;6427;649;2159;768;2232;1417;4391
313190;201409;3676;13404;3246;12165;945;3854;1063;3850;2008;7704
313200;201409;1525;4786;1351;4493;227;883;846;2845;1073;3728
313210;201409;4716;14703;4004;13735;928;3712;2181;7193;3109;10905
313220;201409;1265;3868;934;3137;249;962;266;798;515;1760
313230;201409;2581;9176;2415;8924;437;1674;1552;5946;1989;7620
313240;201409;8706;29151;7384;26684;2064;8233;3071;11064;5135;19297
313250;201409;7907;24659;7125;23335;1320;4422;4261;14345;5581;18767
313260;201409;645;1999;531;1778;129;498;161;514;290;1012
313270;201409;5843;17231;5184;16215;823;2773;3507;11043;4330;13816
313280;201409;559;1813;432;1510;86;349;113;370;199;719
313290;201409;1050;3757;871;3398;293;1257;220;797;513;2054
313300;201409;2045;6970;1742;6226;574;2242;336;1071;910;3313
313310;201409;1090;3856;987;3629;284;1182;189;626;473;1808
313320;201409;2552;7597;2041;6737;421;1479;892;2956;1313;4435
313330;201409;4075;13169;3537;12158;732;2868;1824;6216;2556;9084
313340;201409;2362;5747;1809;4961;384;1097;1004;2733;1388;3830
313350;201409;3459;10847;2681;9082;697;2543;584;1816;1281;4359
313360;201409;1237;3752;957;3242;307;1209;421;1318;728;2527
313370;201409;1531;5341;1450;5115;302;1254;692;2267;994;3521
313375;201409;2186;5879;1472;4789;392;1544;521;1616;913;3160
313380;201409;6993;23899;6092;21908;2295;8921;1906;6556;4201;15477
313390;201409;949;3416;916;3365;135;564;621;2264;756;2828
313400;201409;3851;11087;3543;10716;428;1354;2745;8480;3173;9834
313410;201409;1422;4048;1209;3755;266;905;714;2224;980;3129
313420;201409;20992;51152;13211;37531;3216;10296;3095;8437;6311;18733
313430;201409;1335;4340;1174;4012;362;1377;443;1433;805;2810
313440;201409;6928;16519;5038;14243;732;2258;3375;9561;4107;11819
313450;201409;744;2220;594;1901;153;588;206;589;359;1177
313460;201409;2531;8969;2282;8535;742;3037;704;2526;1446;5563
313470;201409;3531;9836;3334;9612;337;846;2805;8308;3142;9154
313480;201409;1161;3403;895;2928;156;591;398;1227;554;1818
313490;201409;1712;5546;1220;4690;502;1982;258;1021;760;3003
313500;201409;455;1464;429;1411;104;401;217;681;321;1082
313505;201409;9194;27247;8547;26482;508;1133;7715;24680;8223;25813
313507;201409;1514;4226;1333;3966;250;858;794;2405;1044;3263
313510;201409;16597;48478;14683;45886;2582;8190;9635;30980;12217;39170
313520;201409;16782;50361;14175;45933;2140;7856;9092;29386;11232;37242
313530;201409;595;1993;512;1835;90;378;192;631;282;1009
313535;201409;2681;7960;2377;7445;326;1077;1590;5043;1916;6120
313540;201409;1150;3642;909;3031;271;948;226;690;497;1638
313545;201409;1427;5172;1257;4853;220;1045;770;2824;990;3869
313550;201409;2017;6832;1882;6542;534;1994;926;3122;1460;5116
313560;201409;2358;5783;2043;5427;299;717;1544;4292;1843;5009
313570;201409;846;3076;742;2874;282;1172;258;946;540;2118
313580;201409;6398;18034;5428;16712;797;2686;3812;11801;4609;14487
313590;201409;1105;3285;895;3035;416;1506;335;1112;751;2618
313600;201409;4011;12210;3508;11405;645;2274;2113;6988;2758;9262
313610;201409;1191;3699;1031;3385;270;969;457;1476;727;2445
313620;201409;7561;25282;7119;24348;2517;9143;2461;8286;4978;17429
313630;201409;9305;28186;7722;25692;2269;8353;2964;10224;5233;18577
313640;201409;921;2829;770;2603;268;982;258;853;526;1835
313650;201409;2369;7742;2099;7290;301;1057;1529;5430;1830;6487
313652;201409;1038;3728;953;3557;175;706;571;2138;746;2844
313655;201409;1036;3366;843;3038;162;675;510;1783;672;2458
313657;201409;1274;4033;1120;3783;163;728;775;2401;938;3129
313660;201409;944;3232;870;3098;222;911;419;1407;641;2318
313665;201409;3308;10964;3056;10405;713;2753;1506;4922;2219;7675
313670;201409;49382;141070;33867;114042;9785;36668;10462;34176;20247;70844
313680;201409;1143;3446;994;3213;138;460;695;2280;833;2740
313690;201409;996;3591;891;3366;270;1046;354;1379;624;2425
313695;201409;1540;4966;1295;4568;163;663;889;3158;1052;3821
313700;201409;4006;13239;3392;12399;573;2168;2319;8672;2892;10840
313710;201409;1448;4080;1203;3716;345;1154;570;1724;915;2878
313720;201409;5624;18877;4844;17200;1331;5276;1525;4944;2856;10220
313730;201409;1320;3576;1020;3211;180;640;609;1913;789;2553
313740;201409;2159;7803;1794;6855;638;2727;241;852;879;3579
313750;201409;3046;9371;2654;8612;883;3063;817;2492;1700;5555
313753;201409;1945;5874;1600;5269;505;1785;636;2116;1141;3901
313760;201409;4543;14904;3764;13268;1158;4469;1136;3804;2294;8273
313770;201409;3860;12901;3608;12378;1256;4546;1241;4206;2497;8752
313780;201409;4155;11786;3364;10623;834;3049;1647;5077;2481;8126
313790;201409;562;1951;543;1922;128;453;309;1128;437;1581
313800;201409;1291;3682;1144;3450;195;659;727;2191;922;2850
313810;201409;1613;4791;1556;4710;184;533;1223;3799;1407;4332
313820;201409;14167;41006;11906;37064;3091;10793;5124;15806;8215;26599
313830;201409;453;1553;392;1418;123;503;119;415;242;918
313835;201409;1093;3584;1040;3503;260;931;576;1932;836;2863
313840;201409;8335;24504;6728;21722;1944;7048;2194;6821;4138;13869
313850;201409;1305;3646;1174;3421;298;988;607;1674;905;2662
313860;201409;2800;8698;2286;7556;660;2472;532;1614;1192;4086
313862;201409;1218;3244;845;2621;232;767;296;929;528;1696
313865;201409;2353;7364;2147;7026;318;1157;1495;4889;1813;6046
313867;201409;1133;3906;963;3556;350;1381;324;1214;674;2595
313868;201409;1620;5667;1432;5274;185;790;960;3530;1145;4320
313870;201409;925;2906;831;2769;259;987;297;909;556;1896
313880;201409;2282;7349;2089;7088;524;2059;1045;3299;1569;5358
313890;201409;2063;5594;1738;5183;289;858;1133;3448;1422;4306
313900;201409;4928;17954;4587;17184;1704;7009;1344;5023;3048;12032
313910;201409;787;2682;674;2439;267;1048;117;393;384;1441
313920;201409;3912;12467;3456;11680;631;2156;2109;7409;2740;9565
313925;201409;2164;5725;1491;4449;131;431;947;2800;1078;3231
313930;201409;5523;18066;4610;16443;832;3228;2622;9573;3454;12801
313940;201409;7883;27028;6694;25092;2276;9282;2486;9637;4762;18919
313950;201409;5034;14644;4185;13253;1374;4901;1516;4576;2890;9477
313960;201409;6452;17131;5105;15262;1695;5622;1405;4117;3100;9739
313970;201409;1544;4508;1298;4231;227;813;865;2852;1092;3665
313980;201409;1283;4228;1104;3907;376;1468;359;1251;735;2719
313990;201409;2026;7665;1782;7072;643;2765;439;1621;1082;4386
314000;201409;8589;29083;7981;27904;2131;8539;4318;14633;6449;23172
314010;201409;1193;3403;987;3143;170;648;579;1789;749;2437
314015;201409;1627;6054;1492;5753;533;2168;476;1822;1009;3990
314020;201409;545;1700;429;1439;131;491;106;329;237;820
314030;201409;864;2799;686;2390;122;460;261;897;383;1357
314040;201409;667;1942;574;1779;187;612;284;871;471;1483
314050;201409;2015;6571;1664;5839;517;2016;515;1663;1032;3679
314053;201409;1552;5117;1432;4969;240;811;992;3588;1232;4399
314055;201409;2330;6955;2065;6586;184;614;1576;5127;1760;5741
314060;201409;1154;3646;949;3298;109;450;620;2145;729;2595
314070;201409;3914;12199;2958;10299;855;3251;751;2469;1606;5720
314080;201409;1977;6115;1387;4804;308;1215;343;1069;651;2284
314085;201409;1936;6692;1683;6326;530;2198;618;2305;1148;4503
314090;201409;3613;12364;3234;11608;1071;4160;1165;4243;2236;8403
314100;201409;3698;9852;3193;9146;381;1054;2452;7210;2833;8264
314110;201409;4599;15189;4055;14031;1037;4140;1521;4854;2558;8994
314120;201409;1096;2663;586;1849;180;641;150;450;330;1091
314130;201409;698;2042;398;1353;72;262;84;280;156;542
314140;201409;5265;16422;4591;15119;1013;3587;2160;7136;3173;10723
314150;201409;1837;4868;1425;4218;277;924;699;2024;976;2948
314160;201409;2528;6774;1993;6056;142;458;1612;5053;1754;5511
314170;201409;1148;3520;947;3077;167;638;498;1552;665;2190
314180;201409;6667;21012;5836;19757;1592;5880;2640;9134;4232;15014
314190;201409;873;2668;732;2438;230;887;284;894;514;1781
314200;201409;3150;10159;2815;9549;416;1639;1894;6325;2310;7964
314210;201409;2087;6427;1866;6017;338;1246;1097;3398;1435;4644
314220;201409;1804;5860;1493;5239;512;2010;358;1107;870;3117
314225;201409;1248;3773;1120;3598;79;229;968;3184;1047;3413
314230;201409;738;2560;680;2452;222;856;242;846;464;1702
314240;201409;1198;3813;1049;3589;204;659;700;2508;904;3167
314250;201409;555;1673;427;1411;107;411;163;492;270;903
314260;201409;1316;4770;1238;4597;428;1692;434;1597;862;3289
314270;201409;2874;9797;2627;9353;329;1336;1798;6451;2127;7787
314280;201409;3473;9924;2476;7994;762;2810;706;2010;1468;4820
314290;201409;5575;15545;4752;14233;1078;3566;2928;8614;4006;12180
314300;201409;2004;6751;1843;6370;628;2253;674;2282;1302;4535
314310;201409;6850;21790;6027;20105;2304;8207;1782;5753;4086;13960
314315;201409;989;3788;917;3648;175;783;538;2175;713;2958
314320;201409;3711;11018;2945;9979;1026;3760;1192;4024;2218;7784
314330;201409;58200;184693;53520;176874;16180;58201;23647;77402;39827;135603
314340;201409;2588;7221;1414;4742;381;1403;135;297;516;1700
314345;201409;1408;4685;1239;4416;384;1417;648;2351;1032;3768
314350;201409;1499;4397;1213;3924;505;1775;330;1035;835;2810
314360;201409;755;2390;521;1882;152;638;131;441;283;1079
314370;201409;576;2023;533;1958;154;626;268;969;422;1595
314380;201409;1266;3847;916;3170;331;1223;258;920;589;2143
314390;201409;16441;49147;12961;42462;3911;13991;3697;11570;7608;25561
314400;201409;5707;16215;4634;14711;1561;5049;2222;7389;3783;12438
314410;201409;2862;9195;2454;8342;798;3077;825;2626;1623;5703
314420;201409;798;2329;636;2101;90;372;441;1431;531;1803
314430;201409;8447;25113;7578;23417;2516;8301;2504;7880;5020;16181
314435;201409;1330;4294;1181;4027;167;706;761;2544;928;3250
314437;201409;1229;3235;1077;3011;93;262;850;2403;943;2665
314440;201409;765;2128;539;1815;204;754;107;328;311;1082
314450;201409;1841;5454;1567;5062;520;1882;725;2231;1245;4113
314460;201409;4570;15866;3944;14424;1348;5340;774;2794;2122;8134
314465;201409;2460;7836;2268;7501;215;878;1708;5532;1923;6410
314467;201409;1174;3294;1005;3005;144;422;670;2048;814;2470
314470;201409;2492;8132;1984;6956;562;2256;493;1470;1055;3726
314480;201409;6476;21921;4517;16545;936;3746;505;1627;1441;5373
314490;201409;1007;2977;807;2575;251;870;311;941;562;1811
314500;201409;3033;8510;2366;7245;723;2428;825;2544;1548;4972
314505;201409;1813;5629;1712;5457;341;1198;1064;3399;1405;4597
314510;201409;2071;5852;1446;4918;528;1976;388;1272;916;3248
314520;201409;3971;15071;3257;13215;1093;4853;624;2312;1717;7165
314530;201409;7311;25493;6742;24608;1291;4853;3970;15095;5261;19948
314535;201409;3055;8394;2591;7773;353;1159;1869;5612;2222;6771
314537;201409;1488;4432;1200;3918;246;914;611;2008;857;2922
314540;201409;466;1445;410;1323;131;495;132;385;263;880
314545;201409;1430;4524;1257;4252;251;940;746;2508;997;3448
314550;201409;634;1809;490;1614;121;498;169;501;290;999
314560;201409;5489;19536;4808;17721;1259;5096;1251;4440;2510;9536
314570;201409;360;1111;309;994;87;307;147;456;234;763
314580;201409;502;1745;404;1513;117;490;88;324;205;814
314585;201409;872;2906;620;2337;177;740;174;661;351;1401
314587;201409;1810;5758;1607;5391;293;992;883;3026;1176;4018
314590;201409;4396;15333;3272;12237;878;3479;452;1588;1330;5067
314600;201409;2160;7480;1777;6752;705;2958;375;1365;1080;4323
314610;201409;8716;30921;8132;29550;2628;10445;2911;10036;5539;20481
314620;201409;1900;5536;1687;5265;232;679;1257;4070;1489;4749
314625;201409;1584;5304;1544;5255;173;587;1243;4318;1416;4905
314630;201409;5337;15716;4675;14667;594;2073;3253;10344;3847;12417
314640;201409;850;2442;719;2209;256;829;200;574;456;1403
314650;201409;1366;4043;1057;3481;276;1047;410;1221;686;2268
314655;201409;1613;4851;1239;4145;257;906;638;2143;895;3049
314660;201409;230;639;178;536;25;88;102;292;127;380
314670;201409;1568;4345;1255;3797;240;797;711;2143;951;2940
314675;201409;1999;6110;1765;5698;233;858;1117;3621;1350;4479
314690;201409;2804;8919;2364;8129;678;2690;699;2233;1377;4923
314700;201409;10407;38098;8796;34486;3642;15122;2051;8234;5693;23356
314710;201409;9067;28870;6403;22872;1647;6604;967;3122;2614;9726
314720;201409;2744;9189;2302;8276;688;2736;894;3170;1582;5906
314730;201409;2601;8023;2156;7383;769;2876;707;2336;1476;5212
314740;201409;3215;10699;2901;10106;846;3268;1172;3895;2018;7163
314750;201409;346;1131;311;1052;68;273;143;459;211;732
314760;201409;1714;5893;1248;4680;270;1224;291;904;561;2128
314770;201409;1201;3784;716;2439;90;378;114;286;204;664
314780;201409;334;913;252;806;88;326;109;337;197;663
314790;201409;13931;42677;10709;36977;4066;15913;2653;8606;6719;24519
314795;201409;1557;4755;1354;4427;162;669;1008;3177;1170;3846
314800;201409;17710;54124;14489;47532;5840;20045;3043;10192;8883;30237
314810;201409;13436;40399;10545;35175;3439;12715;2642;8801;6081;21516
314820;201409;1150;3178;790;2637;275;1007;251;762;526;1769
314830;201409;1814;6052;1556;5578;555;2166;595;2176;1150;4342
314840;201409;1140;4021;898;3647;224;1046;493;1972;717;3018
314850;201409;2322;6615;1891;5860;370;1342;1071;3271;1441;4613
314860;201409;3385;11589;3093;11113;658;2642;1862;6683;2520;9325
314870;201409;5907;18901;5258;18019;754;2901;3759;13069;4513;15970
314875;201409;1751;6009;1709;5950;242;808;1390;4927;1632;5735
314880;201409;854;2468;758;2321;71;224;541;1685;612;1909
314890;201409;615;1867;442;1509;108;428;136;402;244;830
314900;201409;452;1411;364;1262;97;350;166;577;263;927
314910;201409;1815;6332;1587;5922;649;2645;415;1467;1064;4112
314915;201409;2597;8180;2286;7715;222;883;1767;5912;1989;6795
314920;201409;664;1918;501;1679;111;423;235;735;346;1158
314930;201409;5372;18367;4748;16990;1585;6195;1133;3987;2718;10182
314940;201409;425;1261;397;1206;98;329;212;610;310;939
314950;201409;404;1374;337;1243;92;381;80;291;172;672
314960;201409;854;2765;684;2412;217;828;168;550;385;1378
314970;201409;905;3217;815;3042;303;1234;215;763;518;1997
314980;201409;2307;7107;2076;6727;872;2973;348;1078;1220;4051
314990;201409;3275;10561;2637;9132;975;3737;501;1553;1476;5290
314995;201409;1658;5109;1491;4874;196;772;1047;3362;1243;4134
315000;201409;1134;3299;919;2955;179;672;531;1678;710;2350
315010;201409;503;1608;415;1418;126;505;144;437;270;942
315015;201409;2006;6223;1825;6005;294;974;1314;4493;1608;5467
315020;201409;792;2511;607;2102;124;484;277;920;401;1404
315030;201409;1022;3130;876;2853;343;1178;212;679;555;1857
315040;201409;967;3004;886;2859;170;585;540;1719;710;2304
315050;201409;1679;5008;1385;4517;453;1619;503;1613;956;3232
315053;201409;1181;3499;1025;3250;256;967;428;1306;684;2273
315057;201409;1950;6639;1579;6062;259;1034;970;3850;1229;4884
315060;201409;1044;3421;799;2871;247;958;199;741;446;1699
315070;201409;771;2296;686;2178;199;707;363;1094;562;1801
315080;201409;3531;12097;3169;11319;858;3320;1431;5065;2289;8385
315090;201409;774;2811;688;2623;179;732;247;980;426;1712
315100;201409;1232;4238;965;3621;276;1168;212;726;488;1894
315110;201409;1730;5338;1512;4939;401;1429;691;2236;1092;3665
315120;201409;14292;34546;10216;29251;1887;5684;5569;16780;7456;22464
315130;201409;1856;6200;1679;5846;582;2226;452;1533;1034;3759
315140;201409;2672;8938;2228;7970;642;2660;726;2319;1368;4979
315150;201409;4983;13743;3733;11540;897;3212;1395;4151;2292;7363
315160;201409;1412;4127;1242;3838;275;942;659;1970;934;2912
315170;201409;1385;4087;1172;3776;219;756;652;2278;871;3034
315180;201409;14936;46046;11175;37982;3147;12086;2680;8711;5827;20797
315190;201409;2430;6494;1988;5854;585;1830;956;2826;1541;4656
315200;201409;4657;15767;3881;14000;1237;4849;1045;3662;2282;8511
315210;201409;9193;28069;7654;25007;2482;8803;2669;8545;5151;17348
315213;201409;1152;3752;1104;3686;105;307;932;3208;1037;3515
315217;201409;2796;9430;2343;8646;380;1596;1367;5053;1747;6649
315220;201409;10352;30433;8946;28322;2476;7811;4601;15193;7077;23004
315230;201409;2668;7137;2358;6764;148;342;2067;6088;2215;6430
315240;201409;3458;10960;3110;10392;630;2261;1893;6310;2523;8571
315250;201409;10177;32582;7745;27870;2534;10155;2397;8576;4931;18731
315260;201409;1145;3721;903;3187;331;1304;174;546;505;1850
315270;201409;891;3192;772;2937;257;1049;199;734;456;1783
315280;201409;4074;12470;3183;10474;1090;3770;800;2502;1890;6272
315290;201409;1326;3781;1008;3264;369;1319;201;645;570;1964
315300;201409;550;1564;428;1413;208;717;142;454;350;1171
315310;201409;1275;4224;1124;3955;169;682;733;2533;902;3215
315320;201409;892;2899;740;2685;204;809;351;1325;555;2134
315330;201409;717;2601;485;1989;166;767;70;270;236;1037
315340;201409;4334;12577;3646;11493;926;3147;1683;5407;2609;8554
315350;201409;1926;5425;1498;4822;278;904;944;3155;1222;4059
315360;201409;1762;5916;1439;5072;332;1277;500;1662;832;2939
315370;201409;619;1876;546;1765;131;461;305;980;436;1441
315380;201409;297;1043;253;930;93;373;41;137;134;510
315390;201409;1981;7077;1712;6428;617;2473;421;1557;1038;4030
315400;201409;4871;14924;4217;13647;988;3462;2142;6925;3130;10387
315410;201409;1872;5153;1583;4701;269;994;990;2829;1259;3823
315415;201409;1233;4140;1135;3983;449;1565;505;1874;954;3439
315420;201409;1222;3933;907;3256;271;1047;163;559;434;1606
315430;201409;4156;11354;3121;9609;863;3005;911;2693;1774;5698
315440;201409;997;3058;890;2893;178;653;478;1538;656;2191
315445;201409;2283;6437;1906;5922;272;973;1328;4094;1600;5067
315450;201409;2577;8177;2382;7884;504;1637;1499;5173;2003;6810
315460;201409;40333;135757;36032;126487;12858;48444;9119;31192;21977;79636
315470;201409;582;1791;499;1641;87;329;293;932;380;1261
315480;201409;1532;4822;1022;3632;223;884;197;650;420;1534
315490;201409;3403;9614;2840;8819;499;1803;1550;4684;2049;6487
315500;201409;470;1462;304;1066;61;256;107;312;168;568
315510;201409;1538;4389;1315;4032;93;320;985;3036;1078;3356
315520;201409;1193;3672;981;3384;172;679;601;2017;773;2696
315530;201409;519;1832;488;1776;224;869;171;597;395;1466
315540;201409;1286;3937;1026;3502;234;974;369;1225;603;2199
315550;201409;1871;5418;1530;4965;535;1932;559;1811;1094;3743
315560;201409;7458;24338;6794;23444;927;3512;4693;16354;5620;19866
315570;201409;2423;7629;2262;7384;512;1882;1298;4182;1810;6064
315580;201409;2832;8714;2290;7699;658;2565;833;2602;1491;5167
315590;201409;925;2709;832;2570;137;487;515;1548;652;2035
315600;201409;2728;9567;2251;8737;418;1691;1272;5183;1690;6874
315610;201409;1047;3104;872;2726;187;732;330;866;517;1598
315620;201409;357;1262;340;1227;103;362;176;667;279;1029
315630;201409;1036;3317;886;3068;254;948;246;821;500;1769
315640;201409;839;2522;710;2280;213;769;269;817;482;1586
315645;201409;897;2881;777;2599;315;1159;198;632;513;1791
315650;201409;2067;5847;1767;5426;160;628;1327;4004;1487;4632
315660;201409;2762;7431;2417;6897;507;1482;1423;4072;1930;5554
315670;201409;12533;44390;11439;42152;4135;16244;3666;13315;7801;29559
315680;201409;2957;10313;2424;9272;925;3632;583;2349;1508;5981
315690;201409;3551;11103;2816;9693;951;3572;781;2706;1732;6278
315700;201409;7670;24323;6580;22113;1379;5296;3169;10230;4548;15526
315710;201409;1903;5594;1521;4986;192;758;935;3026;1127;3784
315720;201409;3107;10099;2841;9579;698;2739;1417;4504;2115;7243
315725;201409;1706;5252;1388;4831;393;1413;731;2591;1124;4004
315727;201409;673;2113;589;1943;140;510;270;864;410;1374
315730;201409;1020;3128;930;2961;206;710;523;1668;729;2378
315733;201409;1205;3884;1111;3699;458;1606;375;1235;833;2841
315737;201409;1399;4231;1116;3718;112;441;710;2388;822;2829
315740;201409;1103;3493;948;3189;206;826;479;1512;685;2338
315750;201409;1186;3662;1060;3476;113;457;789;2535;902;2992
315760;201409;991;2736;955;2691;25;75;884;2496;909;2571
315765;201409;1576;4781;1456;4597;140;463;1144;3658;1284;4121
315770;201409;1746;5694;1579;5333;454;1654;563;1852;1017;3506
315780;201409;24587;81489;22704;77350;7418;26945;7082;24131;14500;51076
315790;201409;3410;11656;3035;10859;385;1332;2053;7564;2438;8896
315800;201409;1586;6187;1279;5259;381;1736;265;1039;646;2775
315810;201409;1546;4396;1315;4032;220;729;852;2565;1072;3294
315820;201409;3082;10075;2621;9373;805;2989;1228;4526;2033;7515
315830;201409;1492;5057;1351;4749;342;1354;409;1334;751;2688
315840;201409;794;2115;599;1780;109;382;231;627;340;1009
315850;201409;1346;4748;1294;4638;337;1264;586;2040;923;3304
315860;201409;473;1701;377;1511;109;509;81;311;190;820
315870;201409;486;1460;411;1346;126;456;137;407;263;863
315880;201409;1150;3151;954;2902;249;864;457;1386;706;2250
315890;201409;1754;5972;1583;5709;549;2073;742;2736;1291;4809
315895;201409;5349;16625;4911;15798;1277;4557;2308;7272;3585;11829
315900;201409;818;2582;767;2497;158;627;474;1424;632;2051
315910;201409;623;2214;581;2133;216;822;273;993;489;1815
315920;201409;1593;4640;1076;3546;293;1099;320;956;613;2055
315930;201409;1163;3239;933;2833;265;884;330;969;595;1853
315935;201409;1181;4019;1093;3823;352;1357;348;1180;700;2537
315940;201409;681;2162;607;2011;176;662;251;799;427;1461
315950;201409;1286;3957;1190;3767;279;889;717;2336;996;3225
315960;201409;2837;9453;2126;8003;1014;4370;120;377;1134;4747
315970;201409;811;2284;653;2062;74;225;477;1562;551;1787
315980;201409;4545;11233;2943;8489;781;2575;886;2226;1667;4801
315990;201409;4511;13453;3956;12584;888;3277;2118;6687;3006;9964
316000;201409;614;1996;550;1894;232;870;175;576;407;1446
316010;201409;488;1745;426;1615;109;493;139;463;248;956
316020;201409;1204;3824;972;3419;178;734;555;1936;733;2670
316030;201409;3787;10686;2697;8901;397;1445;1413;4799;1810;6244
316040;201409;3632;11500;2598;9150;472;1921;345;912;817;2833
316045;201409;2188;6994;2027;6721;287;867;1457;5089;1744;5956
316050;201409;373;1187;304;1077;67;267;171;578;238;845
316060;201409;801;2400;653;2185;122;502;357;1125;479;1627
316070;201409;6402;20914;5643;19159;1626;6160;2323;7499;3949;13659
316080;201409;760;2845;684;2638;185;778;134;532;319;1310
316090;201409;689;2017;488;1592;125;462;128;380;253;842
316095;201409;1358;4475;1219;4216;265;928;789;2802;1054;3730
316100;201409;2752;9293;2116;7656;577;2387;430;1440;1007;3827
316105;201409;988;2768;740;2364;172;606;345;1126;517;1732
316110;201409;12837;44675;11635;42469;1660;6627;7962;29781;9622;36408
316120;201409;1345;4549;1207;4212;393;1428;436;1483;829;2911
316130;201409;1528;3470;1013;2755;205;662;509;1339;714;2001
316140;201409;1110;3279;857;2875;121;460;518;1754;639;2214
316150;201409;1457;4364;1383;4248;327;1182;791;2360;1118;3542
316160;201409;1273;3826;1004;3281;144;541;559;1805;703;2346
316165;201409;1006;2744;844;2493;174;594;479;1387;653;1981
316170;201409;1447;4190;1085;3552;244;897;452;1399;696;2296
316180;201409;1329;4265;1018;3592;288;1189;272;858;560;2047
316190;201409;2792;8694;1438;5101;338;1253;247;771;585;2024
316200;201409;3960;12912;3051;11027;785;3274;904;3160;1689;6434
316210;201409;5528;17543;4823;16214;2184;7886;986;3328;3170;11214
316220;201409;691;2170;484;1763;118;510;62;236;180;746
316225;201409;1154;3333;1016;3140;146;541;701;2116;847;2657
316230;201409;469;1396;386;1250;79;271;198;673;277;944
316240;201409;6814;21013;5879;19790;662;2293;4521;15410;5183;17703
316245;201409;3234;11277;3019;10915;279;1253;2310;8321;2589;9574
316250;201409;9225;28549;7858;25713;2718;9775;2391;7358;5109;17133
316255;201409;2480;7760;2191;7413;357;1189;1586;5455;1943;6644
316257;201409;1459;4072;1117;3458;272;935;415;1255;687;2190
316260;201409;1932;5466;1437;4728;269;977;803;2700;1072;3677
316265;201409;1259;3595;1009;3092;117;421;664;1954;781;2375
316270;201409;5230;16799;4830;15963;1383;4823;2167;7253;3550;12076
316280;201409;3451;11390;3111;10708;595;2269;1744;6007;2339;8276
316290;201409;3386;11057;3017;10348;768;3016;1324;4324;2092;7340
316292;201409;3848;12703;3507;12078;987;3723;1628;5351;2615;9074
316294;201409;868;2805;563;2072;134;577;68;233;202;810
316295;201409;2090;7378;1963;7120;446;1887;1077;3693;1523;5580
316300;201409;1035;3169;880;2890;87;293;606;2037;693;2330
316310;201409;696;2203;542;1884;132;525;194;658;326;1183
316320;201409;584;1963;520;1871;150;592;144;497;294;1089
316330;201409;1064;3210;839;2736;135;445;500;1653;635;2098
316340;201409;1185;3846;1018;3510;321;1274;330;1038;651;2312
316350;201409;1519;4767;1381;4527;292;953;707;2486;999;3439
316360;201409;793;2072;619;1829;72;222;472;1401;544;1623
316370;201409;5226;17302;4634;16085;1643;6100;1080;3804;2723;9904
316380;201409;1542;4329;1265;3918;134;474;904;2813;1038;3287
316390;201409;950;2852;792;2577;260;920;339;1116;599;2036
316400;201409;1531;5139;1320;4743;365;1399;547;1982;912;3381
316410;201409;1240;4143;1159;4013;260;956;684;2387;944;3343
316420;201409;2088;6936;1909;6696;278;1138;1247;4377;1525;5515
316430;201409;1003;3076;813;2724;247;920;287;905;534;1825
316440;201409;699;2286;595;2148;243;1008;174;600;417;1608
316443;201409;742;2246;616;2006;159;569;264;835;423;1404
316447;201409;1554;4940;1461;4793;119;424;1253;4117;1372;4541
316450;201409;2317;7934;2044;7412;398;1512;1274;4730;1672;6242
316460;201409;921;2969;864;2873;262;942;479;1534;741;2476
316470;201409;8423;27770;6667;23859;2087;8500;2004;6828;4091;15328
316480;201409;255;878;230;833;67;253;73;256;140;509
316490;201409;383;1230;364;1184;125;426;155;486;280;912
316500;201409;1093;3993;743;2897;167;705;47;180;214;885
316510;201409;979;3550;874;3319;346;1358;236;891;582;2249
316520;201409;1248;3881;1037;3551;272;1053;393;1220;665;2273
316530;201409;1150;3758;956;3349;236;1031;358;1051;594;2082
316540;201409;1043;3415;937;3237;259;1062;359;1139;618;2201
316550;201409;1347;4482;1235;4304;270;1028;763;2662;1033;3690
316553;201409;2385;8693;1992;7744;703;2964;469;1744;1172;4708
316555;201409;2977;10220;2598;9794;239;872;2090;8080;2329;8952
316556;201409;626;1738;507;1525;45;170;368;1064;413;1234
316557;201409;745;2734;714;2680;342;1381;191;663;533;2044
316560;201409;379;1284;315;1139;91;386;73;222;164;608
316570;201409;1469;4684;1282;4290;259;949;682;2277;941;3226
316580;201409;292;851;225;720;60;230;77;224;137;454
316590;201409;1557;4334;1171;3672;211;793;675;2023;886;2816
316600;201409;1194;3903;1058;3625;375;1343;295;992;670;2335
316610;201409;637;2323;581;2219;141;592;340;1297;481;1889
316620;201409;2306;7284;2010;6693;465;1732;1083;3528;1548;5260
316630;201409;1581;5298;1385;4880;575;2114;426;1505;1001;3619
316640;201409;263;869;229;796;61;238;93;310;154;548
316650;201409;993;3749;868;3537;206;860;473;2049;679;2909
316660;201409;158;466;125;399;27;101;58;175;85;276
316670;201409;1949;5665;1574;4955;610;2135;394;1116;1004;3251
316680;201409;2081;6079;1786;5632;238;736;1371;4420;1609;5156
316690;201409;1223;4196;1106;3961;379;1539;412;1432;791;2971
316695;201409;1264;3938;1127;3695;127;411;734;2515;861;2926
316700;201409;359;1218;335;1160;87;348;159;511;246;859
316710;201409;3535;13374;3070;12294;1062;4512;944;3954;2006;8466
316720;201409;19303;65097;16398;58551;5696;21647;4305;15150;10001;36797
316730;201409;451;1431;399;1330;101;392;207;639;308;1031
316740;201409;780;2683;700;2518;272;1047;216;754;488;1801
316750;201409;432;1508;385;1408;107;439;125;420;232;859
316760;201409;3701;12484;3136;11823;1784;6721;973;3899;2757;10620
316770;201409;1534;4461;1364;4234;206;696;946;3022;1152;3718
316780;201409;736;2532;679;2421;252;973;198;664;450;1637
316790;201409;878;2604;647;2191;178;681;232;772;410;1453
316800;201409;6011;20047;5462;19021;1152;4650;2784;9272;3936;13922
316805;201409;911;2465;856;2393;151;399;641;1851;792;2250
316810;201409;623;1931;544;1762;180;634;239;752;419;1386
316820;201409;405;1155;274;924;91;333;63;216;154;549
316830;201409;656;2320;634;2282;216;848;274;954;490;1802
316840;201409;2994;9050;2593;8309;706;2560;1084;3292;1790;5852
316850;201409;2260;7079;2038;6664;449;1618;1127;3687;1576;5305
316860;201409;24904;77095;22318;72286;6167;22040;9907;31731;16074;53771
316870;201409;7443;24791;6430;22335;2367;8828;1302;4417;3669;13245
316880;201409;937;3145;902;3087;357;1357;295;946;652;2303
316890;201409;1507;3861;1207;3450;472;1494;508;1379;980;2873
316900;201409;2832;8978;2459;8210;777;2889;822;2497;1599;5386
316905;201409;503;1716;438;1568;192;719;129;450;321;1169
316910;201409;766;2620;608;2270;152;592;193;750;345;1342
316920;201409;1644;4985;1322;4478;258;938;642;2177;900;3115
316930;201409;9926;34325;8307;30604;2568;10439;1635;5642;4203;16081
316935;201409;5171;15551;3593;12317;1234;4698;728;2346;1962;7044
316940;201409;7200;24207;5985;21566;1642;6561;1577;5462;3219;12023
316950;201409;1617;4720;1402;4417;211;796;941;2934;1152;3730
316960;201409;5656;14523;4680;13261;1037;3175;2716;7705;3753;10880
316970;201409;3708;12057;3507;11706;1194;4526;1168;3609;2362;8135
316980;201409;1124;3335;812;2795;341;1293;209;721;550;2014
316990;201409;10519;35088;9306;32256;3806;14287;1199;3965;5005;18252
317000;201409;2809;9718;2708;9600;215;645;2168;8463;2383;9108
317005;201409;2634;8391;2412;8091;386;1311;1744;5957;2130;7268
317010;201409;33771;88755;21606;68559;6296;22059;5431;18105;11727;40164
317020;201409;57057;166028;36581;122280;9765;35919;9028;28267;18793;64186
317030;201409;901;2533;749;2307;120;432;425;1299;545;1731
317040;201409;13809;41611;11897;38036;4043;13474;4813;15666;8856;29140
317043;201409;871;2481;736;2303;159;518;452;1442;611;1960
317047;201409;1243;3292;924;2760;185;614;415;1225;600;1839
317050;201409;1935;6824;1624;6083;479;1942;600;2153;1079;4095
317052;201409;2556;8137;2266;7694;276;1032;1683;5772;1959;6804
317057;201409;1847;5293;1426;4560;213;816;775;2404;988;3220
317060;201409;406;1213;306;989;73;270;107;310;180;580
317065;201409;1254;4181;1139;3988;130;531;893;3102;1023;3633
317070;201409;9419;31126;7163;25861;2129;8494;1541;5595;3670;14089
317075;201409;1311;4089;1105;3700;378;1365;376;1211;754;2576
317080;201409;7443;21346;6683;20055;2049;6566;2628;7879;4677;14445
317090;201409;5018;16981;4686;16409;713;2555;3221;11506;3934;14061
317100;201409;3505;10157;2913;9170;970;3374;1172;3495;2142;6869
317103;201409;2044;7123;1724;6460;357;1665;783;2841;1140;4506
317107;201409;1398;4336;1210;3955;253;956;660;2028;913;2984
317110;201409;785;2092;537;1629;153;539;213;598;366;1137
317115;201409;1138;3645;991;3322;150;528;637;2157;787;2685
317120;201409;13894;47237;11857;42367;3926;14984;4437;15643;8363;30627
317130;201409;9277;29483;8254;27631;2275;8530;3643;11933;5918;20463
317140;201409;686;2350;646;2273;88;335;427;1500;515;1835
317150;201409;1094;3021;927;2831;107;373;687;2099;794;2472
317160;201409;3934;10483;2952;9213;396;1421;2016;6242;2412;7663
317170;201409;2087;6029;1822;5556;259;917;1088;3146;1347;4063
317180;201409;1879;6369;1484;5471;435;1763;470;1680;905;3443
317190;201409;1408;4048;1171;3724;171;554;815;2599;986;3153
317200;201409;4963;16305;4470;15287;1502;5617;1435;4712;2937;10329
317210;201409;1148;3501;952;3205;258;967;461;1563;719;2530
317220;201409;362;1294;352;1282;125;463;185;689;310;1152
320010;201409;6049;19060;5341;17464;1019;3572;2746;8946;3765;12518
320013;201409;2110;6256;1486;5078;234;840;803;2817;1037;3657
320016;201409;3637;10074;3067;9254;484;1451;2147;6613;2631;8064
320020;201409;4433;14209;3975;13239;1344;4741;1466;4843;2810;9584
320030;201409;1548;4976;1268;4363;395;1444;500;1672;895;3116
320035;201409;1937;5885;1738;5567;535;1898;796;2429;1331;4327
320040;201409;3280;11056;2690;9626;736;2895;767;2621;1503;5516
320050;201409;1990;5426;1712;4892;297;955;1025;2868;1322;3823
320060;201409;11739;37307;9103;31051;2311;8713;3203;10362;5514;19075
320070;201409;1884;6286;1613;5635;544;2016;418;1351;962;3367
320080;201409;5798;17047;4616;14668;1440;4896;1490;4681;2930;9577
320090;201409;9239;26495;7181;22446;1978;6605;3165;9600;5143;16205
320100;201409;3292;9958;2709;8784;682;2375;1279;4080;1961;6455
320110;201409;1569;4785;1420;4499;393;1331;508;1583;901;2914
320115;201409;1818;6551;1670;6231;887;3436;478;1808;1365;5244
320120;201409;18681;61773;15540;55370;5468;20863;4526;16321;9994;37184
320130;201409;43240;143411;39977;136427;11106;41187;18860;62928;29966;104115
320140;201409;4116;13258;2877;10241;776;3080;317;1033;1093;4113
320150;201409;18771;53280;13943;43963;4362;14827;2704;8413;7066;23240
320160;201409;5534;16962;4743;15586;1299;4811;1993;6095;3292;10906
320170;201409;1662;5448;1417;4905;401;1463;550;1935;951;3398
320180;201409;912;3012;819;2869;311;1135;319;1124;630;2259
320190;201409;4168;14398;3369;12397;1056;4072;1017;3682;2073;7754
320200;201409;1185;3808;1034;3506;306;1101;442;1533;748;2634
320210;201409;4979;14009;4315;12776;905;3066;2388;6720;3293;9786
320220;201409;3051;9344;2417;8205;730;2703;927;3176;1657;5879
320225;201409;1549;5449;1322;4861;496;1933;299;1153;795;3086
320230;201409;4358;14639;4062;14063;1426;5286;1439;5069;2865;10355
320240;201409;10823;32660;8363;27948;2478;8912;2293;7671;4771;16583
320245;201409;4198;14336;3893;13577;1282;4726;1385;4715;2667;9441
320250;201409;1876;5859;1393;4747;371;1404;311;954;682;2358
320255;201409;2086;6991;1810;6511;741;2850;650;2403;1391;5253
320260;201409;1138;3556;856;2824;233;863;299;854;532;1717
320265;201409;2541;7867;2164;7414;311;1077;1563;5527;1874;6604
320270;201409;2826;8654;2163;7311;568;2080;937;3113;1505;5193
320280;201409;7416;22647;6721;21330;1622;5580;3307;10291;4929;15871
320290;201409;1751;5796;1383;4840;499;1835;340;1092;839;2927
320300;201409;4434;15020;4070;14173;1317;4853;1275;4442;2592;9295
320305;201409;4879;16076;4421;15025;1134;4203;2025;6712;3159;10915
320310;201409;2065;6287;1818;5819;499;1713;811;2525;1310;4238
320313;201409;2450;7361;1744;5723;497;1877;304;895;801;2772
320316;201409;2352;7238;2099;6703;669;2232;872;2761;1541;4993
320320;201409;20160;64601;16992;58412;5160;19656;6461;21655;11621;41311
320330;201409;3135;9429;2701;8690;576;1821;1570;5256;2146;7077
320332;201409;5243;17807;4709;16787;1652;6191;1774;6503;3426;12694
320334;201409;1676;5541;1245;4569;424;1736;266;888;690;2624
320335;201409;2339;7094;1649;5487;567;2069;335;1059;902;3128
320340;201409;5975;16882;4791;14827;1179;3997;2247;6882;3426;10879
320350;201409;5714;14962;4161;12243;934;2948;1802;5248;2736;8196
320360;201409;1809;4825;1364;3977;275;919;637;1716;912;2635
320370;201409;3607;11888;3049;10727;970;3474;1166;4131;2136;7605
320380;201409;2947;8941;2622;8333;513;1779;1554;4846;2067;6625
320390;201409;8560;26003;7014;22835;2256;8084;2252;6971;4508;15055
320400;201409;4160;12005;3462;10963;969;3427;1580;4724;2549;8151
320405;201409;4159;12391;3798;11896;1151;3901;2054;6317;3205;10218
320410;201409;6411;15837;4610;13748;882;2738;2858;8551;3740;11289
320420;201409;1587;4973;1148;4183;397;1586;202;717;599;2303
320425;201409;2493;6389;2024;5691;356;1102;1222;3418;1578;4520
320430;201409;2470;7229;2229;6749;463;1495;1182;3541;1645;5036
320435;201409;2666;8961;2267;8107;1071;3960;697;2601;1768;6561
320440;201409;1469;4921;1308;4468;390;1442;424;1378;814;2820
320450;201409;2586;8314;2187;7451;662;2435;907;3007;1569;5442
320455;201409;4566;15819;3457;12976;1135;4486;835;3092;1970;7578
320460;201409;3243;10513;2599;9130;754;2849;942;3199;1696;6048
320465;201409;1739;5488;1344;4530;340;1235;512;1649;852;2884
320470;201409;4854;14880;3438;11704;1111;4123;528;1606;1639;5729
320480;201409;2028;6159;1681;5467;425;1604;728;2243;1153;3847
320490;201409;17199;54084;14343;48393;4872;17645;4460;15269;9332;32914
320495;201409;1378;4374;1059;3638;479;1701;139;508;618;2209
320500;201409;48878;152150;42518;139865;12916;46114;19005;61093;31921;107207
320501;201409;3937;12756;3558;12109;1172;4475;1543;5061;2715;9536
320503;201409;2031;7096;1654;6171;530;2161;472;1587;1002;3748
320506;201409;3492;11067;2329;8046;717;2630;237;756;954;3386
320510;201409;9169;29242;8017;26879;2502;9052;3343;11020;5845;20072
320515;201409;2200;6340;1933;5816;572;1808;684;2006;1256;3814
320517;201409;2362;7708;1938;6792;772;2907;425;1397;1197;4304
320520;201409;36642;115845;30834;104320;9813;36226;12360;41634;22173;77860
320530;201409;29830;92855;25424;83961;6739;25239;11372;35607;18111;60846
330010;201409;19186;59733;17553;56352;3475;12559;10600;33009;14075;45568
330015;201409;2042;5694;1767;5179;460;1509;668;1891;1128;3400
330020;201409;17549;52545;16006;50026;3716;12560;9137;28234;12853;40794
330022;201409;1750;5602;1541;5196;327;1287;832;2686;1159;3973
330023;201409;3590;11639;3343;11119;930;3366;1390;4414;2320;7780
330025;201409;3912;11256;3369;10469;830;2789;1952;5988;2782;8777
330030;201409;8229;28042;7299;26067;2017;7893;3259;11198;5276;19091
330040;201409;15025;43545;12763;39805;3412;11450;6370;19433;9782;30883
330045;201409;71407;204048;64734;193880;9458;30466;44935;133616;54393;164082
330050;201409;3034;9667;2698;8986;935;3455;796;2499;1731;5954
330060;201409;5857;17790;5236;16880;1303;4635;2950;9547;4253;14182
330070;201409;26606;82160;24141;77703;6636;22641;11253;36308;17889;58949
330080;201409;9811;28061;9290;27293;1747;4987;6361;19204;8108;24191
330090;201409;3376;9330;3118;8885;850;2600;1520;4270;2370;6870
330093;201409;2074;6187;1727;5489;434;1480;581;1745;1015;3225
330095;201409;1249;4326;1153;4104;435;1696;215;697;650;2393
330100;201409;58217;190120;53422;181513;11962;44994;27770;94991;39732;139985
330110;201409;2793;8835;2550;8385;803;2855;867;2851;1670;5706
330115;201409;2524;7515;2307;7147;671;2277;1078;3235;1749;5512
330120;201409;2609;7582;2380;7263;742;2454;1106;3264;1848;5718
330130;201409;4217;13879;3798;13077;1249;4614;1520;5225;2769;9839
330140;201409;3598;11040;3279;10596;913;3147;1646;5387;2559;8534
330150;201409;2673;7983;2070;6712;556;1964;509;1612;1065;3576
330160;201409;1457;5036;1350;4809;490;1870;504;1763;994;3633
330170;201409;109165;331062;101951;319561;16332;54738;70173;220150;86505;274888
330180;201409;1921;5836;1675;5370;232;945;1045;3125;1277;4070
330185;201409;8464;26716;7741;25384;2028;6964;4052;13507;6080;20471
330187;201409;4543;13016;4013;12128;838;2761;2398;7276;3236;10037
330190;201409;29833;89029;28270;86430;6636;21362;17258;52292;23894;73654
330200;201409;14563;45951;13077;43123;3178;10702;7036;23623;10214;34325
330205;201409;2684;7294;2367;6745;588;1875;1182;3251;1770;5126
330210;201409;4598;12094;3325;9749;993;3151;817;2373;1810;5524
330220;201409;12062;37919;10982;35620;3635;12682;3372;10453;7007;23135
330225;201409;4228;13293;3963;12893;512;1915;2869;9451;3381;11366
330227;201409;18770;52934;16659;49964;4088;12994;9493;28139;13581;41133
330230;201409;1539;4578;1405;4333;410;1404;582;1685;992;3089
330240;201409;21201;65906;18852;61555;7582;26764;3752;11942;11334;38706
330245;201409;1318;4165;1083;3686;317;1174;257;873;574;2047
330250;201409;38870;114101;35950;109160;10677;32821;17650;54822;28327;87643
330260;201409;4052;12836;3704;12076;941;3353;1729;5436;2670;8789
330270;201409;14931;43123;12448;39221;3780;12615;4731;15152;8511;27767
330280;201409;2157;6708;1819;6000;384;1413;875;2732;1259;4145
330285;201409;19985;58919;18353;56542;3668;12058;11757;36337;15425;48395
330290;201409;3718;10529;3284;9902;673;2312;1944;5602;2617;7914
330300;201409;4216;13696;3917;13144;933;3359;2105;7070;3038;10429
330310;201409;2882;8333;2590;7828;624;1924;1319;3984;1943;5908
330320;201409;13115;39249;12294;37968;1894;6359;8812;27088;10706;33447
330330;201409;33469;95784;30607;91156;6993;22265;18788;55383;25781;77648
330340;201409;15658;48013;12686;42090;4089;14473;3658;12087;7747;26560
330350;201409;98362;307400;94226;301155;17479;56612;66336;214785;83815;271397
330360;201409;5939;18531;5798;18313;724;2478;4586;14437;5310;16915
330370;201409;3997;14734;3745;14138;1445;5697;1253;4776;2698;10473
330380;201409;4906;15782;4260;14581;1044;3871;2152;7265;3196;11136
330385;201409;4208;14611;3887;13944;1316;5022;1493;5324;2809;10346
330390;201409;25177;84561;22837;79772;5776;22384;11319;38726;17095;61110
330395;201409;3507;10416;3236;9934;590;1998;1964;5976;2554;7974
330400;201409;2703;8980;2468;8525;521;2085;1297;4158;1818;6243
330410;201409;3155;10043;2717;9155;613;2177;1391;4705;2004;6882
330411;201409;2691;8512;2356;7819;468;1825;1273;3986;1741;5811
330412;201409;1447;4980;1151;4395;314;1360;409;1486;723;2846
330414;201409;26843;76162;23060;71035;4298;13815;14879;46205;19177;60020
330415;201409;3819;11868;3350;10985;903;3200;1430;4694;2333;7894
330420;201409;9228;28532;6604;23201;1988;7659;1200;4161;3188;11820
330430;201409;8704;25579;7713;23815;1818;6129;3872;11784;5690;17913
330440;201409;2150;7185;1805;6455;634;2531;404;1310;1038;3841
330450;201409;1719;5867;1590;5615;494;1954;687;2399;1181;4353
330452;201409;10931;33344;8841;29154;2437;8947;3612;11438;6049;20385
330455;201409;500731;1455945;426237;1333414;112042;372890;216237;675070;328279;1047960
330460;201409;1429;4771;1313;4560;332;1327;633;2176;965;3503
330470;201409;4921;15717;4474;14844;1529;5553;1628;5180;3157;10733
330475;201409;8584;27034;7680;25468;2146;7713;3527;11727;5673;19440
330480;201409;6793;20176;6222;19275;1690;5620;2981;9153;4671;14773
330490;201409;105960;294916;98077;283424;12556;38025;75305;218566;87861;256591
330500;201409;7142;21770;6707;20899;1482;4937;3728;11866;5210;16803
330510;201409;44280;141559;41336;136619;13402;45032;20431;69076;33833;114108
330513;201409;1626;4885;1479;4607;518;1634;595;1884;1113;3518
330515;201409;3187;10038;2877;9446;954;3309;1013;3282;1967;6591
330520;201409;13578;40679;12374;38607;3203;10448;6468;20343;9671;30791
330530;201409;1602;4797;1452;4512;389;1306;658;2007;1047;3313
330540;201409;3602;10711;3062;9813;863;2979;1295;4092;2158;7071
330550;201409;9208;30333;8094;28223;3428;12631;1982;6926;5410;19557
330555;201409;10829;32782;9710;31084;1911;6275;6183;20185;8094;26460
330560;201409;4391;13358;4035;12756;900;3217;2140;6537;3040;9754
330570;201409;3744;10808;3174;9829;826;2630;1631;5133;2457;7763
330575;201409;5797;17124;5248;16164;1141;3850;3112;9262;4253;13112
330580;201409;17896;57388;15576;52649;5068;17949;5917;20369;10985;38318
330590;201409;2013;6060;1882;5832;539;1690;990;3125;1529;4815
330600;201409;10870;31574;8853;28290;1368;5283;5274;16219;6642;21502
330610;201409;9452;30332;8717;28972;2044;7615;4604;15093;6648;22708
330615;201409;1703;6038;1560;5665;695;2637;446;1666;1141;4303
330620;201409;4190;14580;3827;13860;1413;5432;1076;4028;2489;9460
330630;201409;23468;74568;20431;68677;5232;19751;10245;32972;15477;52723
350010;201409;3054;9494;2361;8027;793;2842;453;1448;1246;4290
350020;201409;650;1843;492;1538;143;500;195;581;338;1081
350030;201409;4996;15859;4126;13896;1563;5737;1074;3409;2637;9146
350040;201409;613;2207;527;2012;172;707;117;403;289;1110
350050;201409;1448;4693;1207;4217;338;1346;403;1302;741;2648
350055;201409;675;2187;639;2129;200;755;314;976;514;1731
350060;201409;95;328;88;315;27;112;34;114;61;226
350070;201409;2808;9241;2168;7716;544;2135;429;1327;973;3462
350075;201409;570;1965;486;1818;167;698;132;444;299;1142
350080;201409;633;1838;483;1532;118;410;183;573;301;983
350090;201409;597;1706;446;1433;126;435;124;358;250;793
350100;201409;2129;7147;1701;6161;568;2203;503;1760;1071;3963
350110;201409;507;1540;387;1264;91;339;150;449;241;788
350115;201409;1404;4522;1235;4114;262;1005;581;1751;843;2756
350120;201409;537;1435;269;855;68;236;50;156;118;392
350130;201409;3927;11915;3535;11122;860;3044;1662;4862;2522;7906
350140;201409;709;2245;638;2105;154;574;281;886;435;1460
350150;201409;440;1522;404;1440;160;591;105;382;265;973
350160;201409;6661;20854;5068;17362;1503;5712;1921;6027;3424;11739
350170;201409;2326;8214;2061;7531;709;2708;493;1709;1202;4417
350180;201409;1472;3877;1218;3439;325;949;533;1482;858;2431
350190;201409;3491;11709;3001;10714;803;3383;1474;4769;2277;8152
350200;201409;410;1395;372;1329;129;518;133;459;262;977
350210;201409;7833;21816;6156;18893;2336;7746;2061;6014;4397;13760
350220;201409;3235;10358;2932;9804;1010;3832;940;2867;1950;6699
350230;201409;793;2668;724;2547;242;917;258;907;500;1824
350240;201409;614;1876;535;1749;129;468;297;943;426;1411
350250;201409;2838;10530;2743;10339;1114;4439;973;3648;2087;8087
350260;201409;1124;2962;916;2602;214;607;407;1188;621;1795
350270;201409;5476;16800;4789;15337;979;3439;2351;7415;3330;10854
350275;201409;2115;7055;1899;6708;561;2184;734;2452;1295;4636
350280;201409;24372;62824;15668;47150;4083;13036;3750;11370;7833;24406
350290;201409;1995;6784;1720;6159;520;1924;542;1987;1062;3911
350300;201409;542;1676;485;1563;145;484;203;660;348;1144
350310;201409;976;3271;892;3073;215;844;364;1187;579;2031
350315;201409;577;1808;472;1587;91;390;144;441;235;831
350320;201409;12429;39887;10808;36368;3330;11957;1849;6254;5179;18211
350330;201409;13304;38585;8643;27036;1877;6208;3218;9296;5095;15504
350335;201409;569;1669;523;1574;139;433;221;724;360;1157
350340;201409;1156;3604;888;3074;234;905;274;897;508;1802
350350;201409;771;2456;678;2298;177;694;249;838;426;1532
350360;201409;931;3283;802;2996;262;1030;287;1090;549;2120
350370;201409;739;2285;553;1844;123;455;108;302;231;757
350380;201409;4004;12945;3336;11845;1360;5249;857;2887;2217;8136
350390;201409;8964;28816;7934;26811;2315;8350;3535;11633;5850;19983
350395;201409;369;1107;246;851;72;270;59;199;131;469
350400;201409;8801;25702;7251;22866;2090;7223;2815;8489;4905;15712
350410;201409;8553;30487;7129;27200;2474;10217;1622;5962;4096;16179
350420;201409;953;3041;763;2673;371;1340;96;333;467;1673
350430;201409;882;2774;756;2552;205;809;374;1211;579;2020
350440;201409;1499;4844;1403;4654;453;1610;673;2135;1126;3745
350450;201409;8243;24993;6526;21551;1989;7125;1785;5582;3774;12707
350460;201409;1640;4795;1188;3829;349;1257;378;1107;727;2364
350470;201409;260;723;214;648;56;205;104;286;160;491
350480;201409;760;2346;507;1746;84;325;93;271;177;596
350490;201409;2130;6213;1815;5781;525;1921;805;2374;1330;4295
350500;201409;627;1845;547;1722;143;492;228;684;371;1176
350510;201409;1181;3743;949;3177;266;1012;340;1025;606;2037
350520;201409;989;3707;839;3363;270;1181;224;835;494;2016
350530;201409;2675;8069;2204;7028;798;2740;623;1827;1421;4567
350535;201409;1518;4530;1451;4427;97;355;1197;3642;1294;3997
350540;201409;2125;6018;1785;5403;502;1624;701;2124;1203;3748
350550;201409;11391;33391;9072;29325;2517;9091;3532;10844;6049;19935
350560;201409;3672;12274;3319;11509;639;2357;1730;6077;2369;8434
350570;201409;22211;76346;20267;71817;6655;25182;7371;25174;14026;50356
350580;201409;2118;6919;1665;5815;536;2070;263;792;799;2862
350590;201409;4362;14031;3359;11852;1022;4030;1143;3644;2165;7674
350600;201409;42056;107089;29252;86206;5891;19150;14829;42108;20720;61258
350610;201409;9675;28162;7612;24574;2034;7316;3319;10361;5353;17677
350620;201409;505;1529;413;1380;107;403;172;538;279;941
350630;201409;1787;5493;1391;4682;422;1609;287;852;709;2461
350635;201409;5539;17719;4413;15509;1348;5021;1699;5981;3047;11002
350640;201409;701;2293;557;1897;155;567;151;477;306;1044
350650;201409;6898;21140;3706;13195;1116;4373;363;1284;1479;5657
350660;201409;3907;12137;3389;11219;789;2890;1831;5946;2620;8836
350670;201409;1941;6055;1808;5805;380;1335;1118;3469;1498;4804
350680;201409;1271;3970;1022;3451;298;1171;405;1301;703;2472
350690;201409;1127;3738;950;3364;292;1140;273;899;565;2039
350700;201409;2877;9870;2486;8965;965;3794;830;2686;1795;6480
350710;201409;2373;7531;2142;7144;346;1280;1414;4677;1760;5957
350715;201409;1127;3440;991;3183;296;1089;347;1022;643;2111
350720;201409;147;447;132;414;45;158;46;123;91;281
350730;201409;454;1722;429;1654;132;567;141;507;273;1074
350740;201409;2548;7707;2199;6928;569;1948;935;2917;1504;4865
350745;201409;405;1273;312;1050;62;248;138;410;200;658
350750;201409;10428;32026;8023;27148;2268;8433;2092;6611;4360;15044
350760;201409;12932;41116;11572;38619;3577;13260;5150;16397;8727;29657
350770;201409;942;2770;681;2254;157;593;270;865;427;1458
350775;201409;703;1981;603;1814;151;527;277;813;428;1340
350780;201409;2218;6774;1644;5540;525;1961;223;701;748;2662
350790;201409;2252;7323;1780;6312;556;2125;389;1237;945;3362
350800;201409;3235;10968;3077;10699;658;2584;1878;6366;2536;8950
350810;201409;2675;7825;2334;7222;838;2808;728;2256;1566;5064
350820;201409;591;1622;436;1293;91;326;185;486;276;812
350830;201409;925;2932;667;2301;129;490;145;424;274;914
350840;201409;2471;8818;2046;7733;663;2768;414;1351;1077;4119
350850;201409;6979;23729;5819;20955;2088;7965;1454;5054;3542;13019
350860;201409;3500;11267;3345;11022;483;1806;2515;8233;2998;10039
350870;201409;2618;8762;2293;8255;668;2606;1282;4660;1950;7266
350880;201409;1755;5943;1503;5377;501;1892;317;1134;818;3026
350890;201409;704;2084;501;1619;104;397;136;359;240;756
350900;201409;4734;15934;3880;13937;1071;4167;1031;3505;2102;7672
350910;201409;942;2875;862;2692;336;1083;303;927;639;2010
350920;201409;10448;31183;9545;29654;1842;6312;6086;18278;7928;24590
350925;201409;4492;13890;3835;12557;1028;3705;1674;5129;2702;8834
350930;201409;1632;4526;1355;4068;167;615;944;2719;1111;3334
350940;201409;2377;7948;2168;7600;485;1962;1288;4329;1773;6291
350945;201409;966;3216;848;2947;213;820;380;1262;593;2082
350950;201409;74683;239359;63179;215524;18281;67833;25990;86163;44271;153996
350960;201409;4859;17066;4300;15784;848;3573;2425;8572;3273;12145
350970;201409;4651;16730;4096;15352;1482;6011;1178;4181;2660;10192
350980;201409;728;2367;664;2257;316;1131;181;626;497;1757
350990;201409;1894;6545;1662;6092;581;2289;526;1853;1107;4142
350995;201409;867;3058;823;2971;212;889;436;1505;648;2394
351000;201409;3768;11425;3246;10412;517;1895;1852;5733;2369;7628
351010;201409;445;1331;319;1072;128;478;73;238;201;716
351015;201409;976;3257;841;3001;297;1173;299;1022;596;2195
351020;201409;8239;26600;7267;25051;1982;7338;3549;12311;5531;19649
351030;201409;1651;5957;1525;5672;430;1883;584;2003;1014;3886
351040;201409;3869;12355;3561;11794;792;3066;2097;6550;2889;9616
351050;201409;10420;33108;8300;28920;2676;10153;2854;9883;5530;20036
351060;201409;37640;116482;31335;104517;9582;34158;12027;39619;21609;73777
351070;201409;1970;5573;1411;4567;505;1802;256;698;761;2500
351080;201409;2934;8807;2324;8036;682;2612;1064;3569;1746;6181
351090;201409;408;1412;317;1214;92;403;70;257;162;660
351100;201409;2225;7007;1868;6286;721;2518;582;1982;1303;4500
351110;201409;8480;21937;4721;15322;1321;4768;1219;3664;2540;8432
351120;201409;658;1977;542;1722;74;273;277;792;351;1065
351130;201409;926;2583;487;1663;94;386;120;368;214;754
351140;201409;2068;7181;1883;6768;708;2759;590;2056;1298;4815
351150;201409;2350;8156;1861;6812;547;2185;436;1452;983;3637
351160;201409;1603;5631;1441;5253;480;1939;499;1741;979;3680
351170;201409;1701;5629;1373;4853;362;1396;568;1869;930;3265
351190;201409;725;2355;589;1996;147;541;122;353;269;894
351200;201409;2425;7245;2034;6454;550;1977;736;2104;1286;4081
351210;201409;1168;3643;963;3227;293;1051;322;1014;615;2065
351220;201409;3664;12380;3246;11513;855;3253;1514;5352;2369;8605
351230;201409;2034;6745;1816;6320;522;2008;930;3156;1452;5164
351240;201409;1036;3326;742;2634;208;815;186;571;394;1386
351250;201409;909;2622;668;2133;131;461;308;940;439;1401
351260;201409;1212;3587;1082;3312;277;938;452;1308;729;2246
351270;201409;416;1470;382;1402;122;506;134;437;256;943
351280;201409;5573;16854;4092;13472;1068;3763;1320;3967;2388;7730
351290;201409;1170;3444;926;2970;292;972;318;953;610;1925
351300;201409;11450;41192;9550;36723;2891;12025;3384;12884;6275;24909
351310;201409;3557;11113;2963;10022;733;2849;1409;4433;2142;7282
351320;201409;1036;3656;901;3332;305;1216;229;747;534;1963
351330;201409;307;873;260;791;110;339;66;199;176;538
351340;201409;6875;23941;6199;22528;1805;6902;2968;10821;4773;17723
351350;201409;8188;26953;7217;24840;2225;8035;2581;8535;4806;16570
351360;201409;4967;15248;4641;14649;1278;4396;2153;6598;3431;10994
351370;201409;2277;7285;1810;6270;552;2172;546;1725;1098;3897
351380;201409;38032;118979;35035;112979;9222;32298;16780;52032;26002;84330
351385;201409;254;793;247;782;84;270;104;324;188;594
351390;201409;1344;4477;1165;4105;416;1600;455;1500;871;3100
351400;201409;1249;4047;1174;3867;460;1605;355;1191;815;2796
351410;201409;3100;9393;2735;8734;627;2147;1463;4579;2090;6726
351420;201409;458;1359;333;1083;99;327;64;206;163;533
351430;201409;926;2948;847;2805;138;481;603;2012;741;2493
351440;201409;4869;14903;4106;13203;1504;5000;1043;3159;2547;8159
351450;201409;1864;5322;1644;5016;526;1646;800;2518;1326;4164
351460;201409;858;2705;729;2453;352;1263;213;679;565;1942
351470;201409;1140;3493;1013;3246;373;1304;330;1025;703;2329
351480;201409;3047;9876;2772;9410;636;2559;1425;4683;2061;7242
351490;201409;2077;7012;1860;6538;369;1499;1022;3436;1391;4935
351492;201409;190;600;132;457;25;103;53;171;78;274
351495;201409;164;563;130;476;43;168;42;143;85;311
351500;201409;22343;71295;19383;65258;6160;22671;7639;24806;13799;47477
351510;201409;8258;26506;6973;24061;1770;6592;3456;11829;5226;18421
351512;201409;456;1343;382;1201;90;301;183;565;273;866
351515;201409;2242;7306;1705;6076;539;2077;474;1574;1013;3651
351518;201409;1799;6114;1310;5189;393;1748;303;1112;696;2860
351519;201409;891;2806;739;2460;213;831;285;850;498;1681
351520;201409;829;2271;407;1415;79;312;67;204;146;516
351530;201409;497;1574;393;1316;78;280;129;383;207;663
351535;201409;2692;6989;2170;6241;251;821;1524;4337;1775;5158
351540;201409;2270;7220;2002;6721;902;3224;427;1397;1329;4621
351550;201409;4368;12767;3124;10289;765;2878;1124;3572;1889;6450
351560;201409;457;1478;396;1336;126;458;79;261;205;719
351565;201409;253;847;235;801;73;284;98;302;171;586
351570;201409;13537;43695;11794;40135;3356;12114;5697;19157;9053;31271
351580;201409;416;1160;308;937;60;184;103;300;163;484
351590;201409;535;1483;413;1233;125;403;94;258;219;661
351600;201409;1993;5706;1777;5332;384;1316;874;2447;1258;3763
351610;201409;700;1936;555;1680;99;348;276;785;375;1133
351620;201409;17730;57735;13507;48535;3484;13854;3494;11154;6978;25008
351630;201409;17085;56759;15687;54367;3991;14359;8939;31220;12930;45579
351640;201409;9190;29399;7643;26611;1798;6843;4013;13722;5811;20565
351650;201409;430;1285;253;838;74;262;39;121;113;383
351660;201409;784;2460;586;1979;144;517;170;522;314;1039
351670;201409;4080;12701;3386;11221;669;2579;1711;5334;2380;7913
351680;201409;690;2123;427;1437;101;364;69;197;170;561
351685;201409;469;1432;381;1273;102;352;156;535;258;887
351690;201409;1409;4195;1081;3430;427;1353;304;917;731;2270
351700;201409;1556;4657;1395;4342;469;1518;510;1539;979;3057
351710;201409;817;2556;686;2260;176;610;221;666;397;1276
351720;201409;1803;5668;1322;4408;327;1184;450;1395;777;2579
351730;201409;1178;3482;992;3225;403;1445;343;1050;746;2495
351740;201409;4918;13997;4076;12227;1113;3561;1346;3810;2459;7371
351750;201409;1604;5279;1358;4752;448;1745;380;1224;828;2969
351760;201409;3916;12546;3422;11438;962;3458;1424;4552;2386;8010
351770;201409;2406;7768;2098;7196;624;2273;1050;3544;1674;5817
351780;201409;1641;4683;1064;3393;283;983;240;713;523;1696
351790;201409;1194;3559;1027;3318;380;1274;422;1347;802;2621
351800;201409;426;935;317;785;40;111;201;477;241;588
351810;201409;1229;3717;1155;3622;280;1015;741;2228;1021;3243
351820;201409;1961;6249;1596;5572;543;2008;195;646;738;2654
351830;201409;4632;14839;3805;12839;901;3318;1794;5833;2695;9151
351840;201409;9308;32210;8290;30046;2858;11006;2826;10075;5684;21081
351850;201409;1542;4928;1239;4287;350;1396;394;1179;744;2575
351860;201409;3762;12180;3390;11411;1000;3686;1497;4800;2497;8486
351870;201409;36377;112579;32894;106268;8353;28676;17869;57631;26222;86307
351880;201409;106057;344349;92544;314617;29132;104889;27530;92430;56662;197319
351885;201409;670;2437;624;2332;178;725;285;1027;463;1752
351890;201409;856;2577;688;2222;215;755;179;547;394;1302
351900;201409;1464;4519;1263;4202;378;1331;491;1643;869;2974
351905;201409;453;1535;385;1412;95;417;199;670;294;1087
351907;201409;16299;51082;14122;46892;2941;11135;7633;24309;10574;35444
351910;201409;1219;3874;1121;3713;276;1045;441;1373;717;2418
351920;201409;1231;3524;1146;3386;274;908;668;1932;942;2840
351925;201409;1044;3110;950;2931;154;577;597;1712;751;2289
351930;201409;3259;11051;3028;10558;858;3482;1435;4546;2293;8028
351940;201409;1064;3270;981;3121;283;979;568;1740;851;2719
351950;201409;1453;4032;1062;3282;200;699;539;1582;739;2281
351960;201409;4351;13022;3337;11161;955;3379;1542;5155;2497;8534
351970;201409;7147;27069;6466;25566;2358;9745;2181;8691;4539;18436
351980;201409;992;3031;799;2648;183;686;316;936;499;1622
351990;201409;1668;4808;1329;4137;401;1429;342;924;743;2353
352000;201409;2582;8303;2345;7815;635;2266;1027;3256;1662;5522
352010;201409;2346;7962;2109;7371;746;2726;454;1567;1200;4293
352020;201409;1621;5210;1434;4820;441;1570;524;1732;965;3302
352030;201409;4899;14980;4323;14148;1060;3620;2427;8083;3487;11703
352040;201409;2055;7118;1733;6317;486;1919;423;1437;909;3356
352042;201409;2546;7134;1864;5716;444;1495;943;2825;1387;4320
352044;201409;1509;5049;1163;4163;277;1044;229;744;506;1788
352050;201409;6956;22482;4763;17454;1457;5911;955;3026;2412;8937
352060;201409;862;2558;748;2359;199;742;307;888;506;1630
352070;201409;764;2053;705;1963;272;794;259;770;531;1564
352080;201409;610;1834;485;1603;143;536;169;503;312;1039
352090;201409;1803;5864;1429;5038;378;1504;395;1224;773;2728
352100;201409;2579;8031;1871;6593;537;2123;647;2067;1184;4190
352110;201409;496;1846;443;1713;137;569;159;593;296;1162
352115;201409;424;1392;363;1257;97;387;163;520;260;907
352120;201409;903;2784;779;2583;152;564;432;1425;584;1989
352130;201409;1914;5534;1351;4400;386;1366;466;1387;852;2753
352140;201409;1741;5412;1224;4250;331;1236;515;1753;846;2989
352150;201409;710;2165;541;1829;160;537;232;773;392;1310
352160;201409;1300;3640;1181;3479;257;806;718;2131;975;2937
352170;201409;2646;8087;2389;7604;557;1977;1285;3873;1842;5850
352180;201409;3721;10675;3216;9737;884;2963;1373;3902;2257;6865
352190;201409;1193;3668;1092;3487;239;885;582;1757;821;2642
352200;201409;462;1590;381;1428;83;334;187;727;270;1061
352210;201409;16193;43620;12898;38728;2369;7517;7905;24195;10274;31712
352215;201409;598;1873;538;1790;80;313;308;1030;388;1343
352220;201409;15281;50935;14061;48405;4867;17776;5197;17774;10064;35550
352230;201409;14069;48268;12377;45023;3930;15508;4738;16955;8668;32463
352240;201409;10095;31924;9003;29928;3003;11196;3539;11081;6542;22277
352250;201409;23265;75437;20556;69870;5821;21439;8022;26903;13843;48342
352260;201409;6003;18202;4091;14107;1032;3962;1414;4484;2446;8446
352265;201409;938;2969;793;2729;122;510;476;1569;598;2079
352270;201409;2585;8851;2209;7970;857;3200;514;1794;1371;4994
352280;201409;2555;7917;2134;7186;591;2221;707;2266;1298;4487
352290;201409;1358;4388;1177;3983;301;1163;377;1148;678;2311
352300;201409;1040;3119;856;2788;249;893;383;1193;632;2086
352310;201409;33831;108182;29841;101236;7655;27878;17349;58346;25004;86224
352320;201409;5706;17715;4927;16193;1494;5367;1693;5020;3187;10387
352330;201409;2281;7387;1969;6978;708;2663;671;2391;1379;5054
352340;201409;6039;20616;4923;17911;1633;6421;976;3263;2609;9684
352350;201409;1855;6797;1684;6407;485;1986;602;2222;1087;4208
352360;201409;1249;4094;1111;3821;289;1194;637;2039;926;3233
352370;201409;936;3202;852;3010;210;843;393;1335;603;2178
352380;201409;1055;3351;929;3132;338;1263;273;890;611;2153
352390;201409;15900;45165;10926;35284;2244;8432;5278;15859;7522;24291
352400;201409;3253;9536;2122;7251;573;2130;706;2226;1279;4356
352410;201409;3872;11356;2975;9799;966;3434;945;2989;1911;6423
352420;201409;1328;3785;1227;3613;432;1416;506;1462;938;2878
352430;201409;6597;20739;5813;19444;2227;8093;2025;6624;4252;14717
352440;201409;16549;52212;13591;46251;3836;14052;5114;16996;8950;31048
352450;201409;687;2017;464;1578;125;481;108;323;233;804
352460;201409;2266;7502;1953;6913;677;2666;591;1922;1268;4588
352470;201409;4979;14145;3020;9984;632;2281;1184;3822;1816;6103
352480;201409;5602;15816;4543;13858;1121;3930;1943;5480;3064;9410
352490;201409;767;2733;649;2441;165;686;144;514;309;1200
352500;201409;8885;28302;8316;27331;3944;14017;2571;7689;6515;21706
352510;201409;3579;12257;2963;10941;1128;4468;732;2633;1860;7101
352520;201409;2535;8984;2253;8307;612;2412;1141;4149;1753;6561
352530;201409;7008;22667;5140;18436;1524;5923;815;2648;2339;8571
352540;201409;483;1602;365;1321;63;271;107;372;170;643
352550;201409;950;3159;665;2462;184;765;122;389;306;1154
352560;201409;663;1979;498;1606;100;365;202;590;302;955
352570;201409;1592;5180;1149;4114;272;1122;280;881;552;2003
352580;201409;962;2874;824;2634;272;974;360;1073;632;2047
352585;201409;238;778;190;677;63;242;47;163;110;405
352590;201409;11654;37288;10198;34386;2237;8420;5795;18881;8032;27301
352600;201409;2044;6479;1858;6114;620;2161;727;2316;1347;4477
352610;201409;3670;11535;3186;10702;1140;4144;1035;3318;2175;7462
352620;201409;5697;18050;5386;17626;1192;4207;3475;11328;4667;15535
352630;201409;877;2900;829;2780;262;948;373;1232;635;2180
352640;201409;3224;10253;2654;8990;573;2143;1213;3997;1786;6140
352650;201409;879;2608;658;2147;152;548;222;675;374;1223
352660;201409;1104;3854;892;3334;264;1076;230;824;494;1900
352670;201409;11245;34650;6948;24780;2172;8163;1337;4611;3509;12774
352680;201409;3478;12148;2689;10177;647;2700;694;2343;1341;5043
352690;201409;28674;83446;20967;67560;5089;18050;9128;28335;14217;46385
352700;201409;805;2382;644;2130;194;733;289;899;483;1632
352710;201409;5529;16473;4082;13478;1083;3941;1549;4896;2632;8837
352720;201409;9311;31148;8616;29660;2856;10256;3433;11763;6289;22019
352725;201409;433;1269;288;943;55;215;94;280;149;495
352730;201409;2801;9667;2463;8744;679;2670;803;2544;1482;5214
352740;201409;2348;6992;1990;6367;509;1894;971;2883;1480;4777
352750;201409;443;1341;314;1041;98;350;68;193;166;543
352760;201409;1044;3675;943;3468;302;1189;462;1637;764;2826
352770;201409;966;2977;901;2861;290;985;324;1022;614;2007
352780;201409;645;2185;562;1990;145;580;177;570;322;1150
352790;201409;622;1795;445;1447;103;363;100;305;203;668
352800;201409;1236;4585;976;3838;318;1296;201;693;519;1989
352810;201409;1125;3005;786;2339;152;537;275;774;427;1311
352820;201409;634;1867;510;1666;211;721;111;367;322;1088
352830;201409;491;1401;344;1094;81;276;69;189;150;465
352840;201409;3855;13424;3382;12367;1058;4107;1060;3857;2118;7964
352850;201409;10354;33526;9043;31152;2766;10041;3363;11687;6129;21728
352860;201409;1079;3586;1004;3422;398;1408;296;955;694;2363
352870;201409;1144;2894;877;2392;152;517;458;1136;610;1653
352880;201409;2519;7449;1931;6154;508;1726;523;1521;1031;3247
352885;201409;321;1086;306;1053;93;348;136;442;229;790
352890;201409;838;2311;678;1992;159;520;279;743;438;1263
352900;201409;19227;57587;14367;47374;3560;12772;5765;18163;9325;30935
352910;201409;288;912;252;831;88;283;35;103;123;386
352920;201409;3452;10595;2925;9536;999;3532;1051;3188;2050;6720
352930;201409;7091;22747;5819;19871;1767;6546;1098;3545;2865;10091
352940;201409;26604;89260;22663;79736;8268;30573;4101;13772;12369;44345
352950;201409;336;1052;240;844;66;275;67;202;133;477
352960;201409;622;1950;413;1444;80;312;73;236;153;548
352965;201409;383;1092;311;955;85;287;55;157;140;444
352970;201409;3446;9039;3040;8468;480;1392;2112;5967;2592;7359
352980;201409;1585;4741;1350;4370;403;1326;639;2175;1042;3501
352990;201409;3665;12078;3328;11471;1062;4082;1252;4106;2314;8188
353000;201409;566;1598;397;1229;96;326;96;263;192;589
353010;201409;3001;8500;2231;6939;606;2114;771;2204;1377;4318
353020;201409;4576;12641;3130;9473;555;1892;1286;3539;1841;5431
353030;201409;4013;11830;3289;10407;1017;3510;866;2565;1883;6075
353040;201409;747;2141;642;1975;206;687;246;739;452;1426
353050;201409;5747;19817;4894;17999;1728;6858;1595;5603;3323;12461
353060;201409;35377;113562;33020;109735;5349;21059;22926;73294;28275;94353
353070;201409;9270;31157;7320;26654;2524;9673;1953;7147;4477;16820
353080;201409;5458;17978;4187;15127;1335;5195;1188;4019;2523;9214
353090;201409;616;2068;546;1921;99;417;269;862;368;1279
353100;201409;290;862;223;708;104;340;51;161;155;501
353110;201409;8132;25348;7286;23816;1859;6450;3939;13020;5798;19470
353120;201409;486;1607;410;1441;137;542;103;310;240;852
353130;201409;3104;9663;2711;8986;1040;3765;987;3107;2027;6872
353140;201409;2758;7742;2203;6634;705;2318;724;1965;1429;4283
353150;201409;2044;6418;1696;5764;610;2177;457;1576;1067;3753
353160;201409;703;2054;536;1705;170;552;103;299;273;851
353170;201409;524;1841;471;1741;172;715;188;665;360;1380
353180;201409;5647;17615;4916;16234;718;2727;3117;10044;3835;12771
353190;201409;3782;12041;3269;10857;775;2883;1547;4765;2322;7648
353200;201409;872;2982;744;2670;232;922;264;911;496;1833
353205;201409;556;1791;462;1579;110;378;167;574;277;952
353210;201409;1149;3031;915;2609;116;396;606;1677;722;2073
353215;201409;587;1834;505;1651;107;396;159;503;266;899
353220;201409;953;2904;815;2604;229;767;256;804;485;1571
353230;201409;965;3086;888;2955;250;932;286;869;536;1801
353240;201409;2297;7632;2090;7199;634;2423;921;2977;1555;5400
353250;201409;1307;3699;1078;3285;303;984;412;1200;715;2184
353260;201409;1238;3599;1070;3328;333;1120;426;1247;759;2367
353270;201409;695;2104;597;1910;183;635;178;528;361;1163
353280;201409;615;2018;539;1882;190;725;148;487;338;1212
353282;201409;1844;6055;1778;5937;369;1375;1075;3460;1444;4835
353284;201409;304;836;204;635;47;147;58;187;105;334
353286;201409;150;441;101;323;29;92;13;41;42;133
353290;201409;515;1741;438;1602;163;644;176;616;339;1260
353300;201409;1808;5729;1553;5151;483;1765;559;1652;1042;3417
353310;201409;357;1110;331;1053;150;497;97;288;247;785
353320;201409;583;1649;502;1514;116;392;251;722;367;1114
353325;201409;606;2079;499;1831;132;525;78;257;210;782
353330;201409;603;1771;428;1377;98;367;193;562;291;929
353340;201409;3289;10564;2802;9601;985;3585;1012;3406;1997;6991
353350;201409;3677;11142;3195;10272;1127;3872;1363;4261;2490;8133
353360;201409;469;1631;414;1497;109;451;227;778;336;1229
353370;201409;733;2383;663;2202;163;570;343;1123;506;1693
353380;201409;423;1389;375;1301;103;408;162;537;265;945
353390;201409;5703;15336;4012;12248;890;3085;1495;4124;2385;7209
353400;201409;644;2001;535;1772;141;497;143;408;284;905
353410;201409;711;2181;603;2009;175;659;308;990;483;1649
353420;201409;717;2129;555;1734;180;593;175;512;355;1105
353430;201409;2580;8979;1858;6871;519;1998;179;590;698;2588
353440;201409;63187;207495;55473;188804;17284;61830;18298;60760;35582;122590
353450;201409;482;1462;416;1340;120;435;160;498;280;933
353460;201409;3714;10390;3132;9367;566;1837;1680;5032;2246;6869
353470;201409;11757;37167;9271;31955;3016;11233;2330;7743;5346;18976
353475;201409;1772;5111;1275;4012;308;1058;379;1084;687;2142
353480;201409;1589;4752;1414;4422;316;1093;786;2371;1102;3464
353490;201409;1672;4791;1394;4227;407;1379;413;1125;820;2504
353500;201409;1260;3636;1144;3437;489;1550;415;1187;904;2737
353510;201409;1422;4589;1180;3966;352;1304;345;1009;697;2313
353520;201409;1295;3783;1050;3346;347;1180;354;1138;701;2318
353530;201409;2855;8560;2560;8019;634;2216;1219;3677;1853;5893
353540;201409;2186;6670;1961;6274;619;2068;841;2713;1460;4781
353550;201409;6961;20078;6131;18724;1123;4024;3528;10134;4651;14158
353560;201409;2224;7365;1849;6661;474;1892;691;2435;1165;4327
353570;201409;548;1726;442;1504;100;381;239;740;339;1121
353580;201409;2552;8317;2390;8032;687;2575;1340;4363;2027;6938
353590;201409;848;2424;692;2141;258;857;171;546;429;1403
353600;201409;1973;5645;1782;5300;411;1335;925;2729;1336;4064
353610;201409;628;2202;541;2021;150;655;166;576;316;1231
353620;201409;2391;8010;2102;7438;669;2530;696;2341;1365;4871
353625;201409;397;1086;276;875;108;376;76;225;184;601
353630;201409;1735;5952;1338;4930;320;1277;237;757;557;2034
353640;201409;1685;4860;1471;4408;368;1137;662;2007;1030;3144
353650;201409;6949;21260;5025;16944;1165;4239;1788;5710;2953;9949
353657;201409;356;1136;313;1042;57;227;128;400;185;627
353660;201409;1462;3734;1048;3079;446;1439;192;422;638;1861
353670;201409;5006;16535;4368;15098;1475;5588;1388;4485;2863;10073
353680;201409;710;2504;664;2419;316;1209;211;757;527;1966
353690;201409;582;1570;384;1239;98;369;142;415;240;784
353700;201409;2471;7849;2152;7166;515;1898;782;2457;1297;4355
353710;201409;3520;9502;1839;6552;555;2163;546;1929;1101;4092
353715;201409;490;1460;414;1312;89;301;178;549;267;850
353720;201409;2181;6785;1871;6314;368;1351;1075;3638;1443;4989
353730;201409;4628;14453;3710;12313;969;3478;1051;3215;2020;6693
353740;201409;2329;7081;1872;6101;642;2175;534;1675;1176;3850
353750;201409;837;2914;656;2457;184;759;190;710;374;1469
353760;201409;8070;23908;6526;21288;1546;5471;3314;10761;4860;16232
353770;201409;834;2597;534;1835;117;434;55;124;172;558
353780;201409;6105;21631;5521;20421;2486;9426;1520;5838;4006;15264
353790;201409;1836;6510;1524;5841;473;2041;355;1320;828;3361
353800;201409;15239;48748;12105;42616;3417;13227;4764;16251;8181;29478
353810;201409;1219;4042;1068;3694;325;1205;396;1343;721;2548
353820;201409;1321;4630;1236;4428;380;1543;548;1822;928;3365
353830;201409;826;2238;647;1914;133;425;277;802;410;1227
353850;201409;1914;6283;1789;6058;435;1618;876;2828;1311;4446
353860;201409;2436;8242;2015;7232;607;2339;579;2011;1186;4350
353870;201409;24344;75680;18260;62919;4416;17012;6077;18925;10493;35937
353880;201409;2415;7602;2010;6906;299;1225;1218;4095;1517;5320
353890;201409;2715;7016;1969;5766;481;1559;942;2631;1423;4190
353900;201409;1163;3634;870;2963;227;871;207;615;434;1486
353910;201409;2192;7736;2086;7450;675;2592;948;3383;1623;5975
353920;201409;2483;7388;1831;5985;444;1543;326;946;770;2489
353930;201409;4228;14831;3534;13264;1278;5099;839;3113;2117;8212
353940;201409;1550;4992;1324;4490;351;1361;521;1623;872;2984
353950;201409;3723;12083;3423;11536;566;2205;2195;7200;2761;9405
353960;201409;632;2018;498;1719;126;468;141;425;267;893
353970;201409;550;1622;477;1518;48;191;353;1097;401;1288
353980;201409;15004;44510;12531;40236;3071;10571;6455;20435;9526;31006
353990;201409;519;1630;476;1526;142;504;192;557;334;1061
354000;201409;2039;6023;1395;4727;356;1317;149;448;505;1765
354010;201409;401;1241;360;1173;139;461;139;463;278;924
354020;201409;4524;13747;4022;12659;1105;3801;1778;5204;2883;9005
354025;201409;1135;3219;900;2811;253;840;231;722;484;1562
354030;201409;665;1769;467;1460;127;442;175;505;302;947
354040;201409;810;2203;633;1866;94;328;360;978;454;1306
354050;201409;1070;3507;943;3240;338;1262;286;953;624;2215
354060;201409;5158;16389;3780;13307;1023;3906;1444;4872;2467;8778
354070;201409;3774;12646;3284;11516;1128;4212;843;2924;1971;7136
354075;201409;2292;8593;2188;8402;721;3009;977;3713;1698;6722
354080;201409;2006;6206;1532;5049;451;1537;443;1333;894;2870
354085;201409;323;871;283;793;34;122;204;529;238;651
354090;201409;1273;3844;1203;3734;150;526;910;2802;1060;3328
354100;201409;17322;59432;14825;54522;4069;15866;6732;24680;10801;40546
354105;201409;954;2990;815;2726;205;811;372;1116;577;1927
354110;201409;847;2435;692;2200;209;755;217;627;426;1382
354120;201409;2228;6240;1792;5422;454;1557;686;1891;1140;3448
354130;201409;5712;17149;4748;15215;1891;6423;1147;3396;3038;9819
354140;201409;23973;61484;14828;44236;3001;9933;5746;15897;8747;25830
354150;201409;4663;12960;3646;11114;1007;3389;1631;4751;2638;8140
354160;201409;4102;13544;3566;12340;1059;3937;1464;4929;2523;8866
354165;201409;417;1530;376;1428;143;584;100;386;243;970
354170;201409;1670;5381;1355;4615;306;1184;483;1446;789;2630
354180;201409;531;1600;507;1555;78;275;319;918;397;1193
354190;201409;1691;5683;1470;5178;507;1918;494;1674;1001;3592
354200;201409;1201;3494;971;3050;205;735;397;1123;602;1858
354210;201409;885;3027;782;2818;183;775;329;1095;512;1870
354220;201409;3297;10244;2943;9546;955;3372;1234;3837;2189;7209
354230;201409;819;2719;772;2634;220;789;378;1276;598;2065
354240;201409;1417;4790;1136;4145;350;1380;279;960;629;2340
354250;201409;566;1806;465;1638;217;851;127;411;344;1262
354260;201409;8172;24866;7233;23343;2176;7737;2982;9389;5158;17126
354270;201409;1215;4268;1105;4030;337;1367;440;1589;777;2956
354280;201409;852;2565;789;2453;155;561;475;1438;630;1999
354290;201409;1356;4776;1254;4554;381;1478;419;1506;800;2984
354300;201409;3391;11545;3270;11307;858;3167;1733;5895;2591;9062
354310;201409;811;2686;647;2287;184;720;204;710;388;1430
354320;201409;877;2648;750;2390;218;782;243;702;461;1484
354323;201409;400;1163;313;994;82;285;86;243;168;528
354325;201409;1258;4264;1111;3921;261;1051;458;1493;719;2544
354330;201409;8265;25806;7306;23901;1954;6856;3685;11636;5639;18492
354340;201409;31716;102852;26714;93510;9840;36940;9575;32754;19415;69694
354350;201409;1198;3584;1124;3447;300;1008;611;1797;911;2805
354360;201409;466;1527;379;1359;115;446;43;143;158;589
354370;201409;1185;4006;1032;3685;149;657;671;2311;820;2968
354380;201409;1348;4052;1118;3634;424;1518;211;604;635;2122
354390;201409;12124;38859;9001;31898;2368;9184;2379;8027;4747;17211
354400;201409;2192;7836;1910;7149;538;2152;593;2123;1131;4275
354410;201409;6614;20120;5506;18276;1311;4665;2825;9371;4136;14036
354420;201409;1722;5122;1428;4474;449;1492;513;1546;962;3038
354425;201409;3575;10256;3091;9360;1069;3429;1010;3100;2079;6529
354430;201409;1375;4525;1261;4336;343;1315;613;2021;956;3336
354440;201409;585;1732;458;1472;90;310;201;628;291;938
354450;201409;527;1528;329;1089;49;210;85;236;134;446
354460;201409;899;2623;757;2362;267;867;343;1054;610;1921
354470;201409;533;1511;414;1270;72;287;188;498;260;785
354480;201409;807;2394;708;2228;155;565;364;1063;519;1628
354490;201409;803;2718;639;2318;162;642;212;679;374;1321
354500;201409;2622;8902;2390;8465;946;3752;562;1900;1508;5652
354510;201409;776;2478;688;2310;174;640;364;1193;538;1833
354515;201409;364;1276;297;1117;72;309;94;325;166;634
354520;201409;7264;24985;4937;18286;1489;6165;1825;6462;3314;12627
354530;201409;2953;10621;2760;10234;789;3186;1432;5237;2221;8423
354540;201409;1351;4171;1142;3774;394;1422;385;1259;779;2681
354550;201409;599;1919;530;1763;106;368;228;722;334;1090
354560;201409;1485;4420;1089;3526;274;915;384;1202;658;2117
354570;201409;744;2294;587;1918;187;649;115;353;302;1002
354580;201409;9465;27433;7511;23691;1590;5632;3458;10336;5048;15968
354600;201409;1786;6113;1587;5711;470;1963;701;2359;1171;4322
354610;201409;516;1445;333;1042;70;222;87;237;157;459
354620;201409;428;1459;356;1323;109;471;131;449;240;920
354625;201409;287;957;241;860;64;252;68;233;132;485
354630;201409;1986;6836;1791;6387;787;2854;523;1789;1310;4643
354640;201409;4261;14232;3606;12765;1086;4345;803;2589;1889;6934
354650;201409;1045;3208;940;2986;190;688;534;1641;724;2329
354660;201409;2179;6476;1712;5629;392;1435;853;2780;1245;4215
354670;201409;1678;5464;1347;4621;398;1498;361;1075;759;2573
354680;201409;5474;18404;5001;17350;1440;5319;2002;6768;3442;12087
354690;201409;884;2981;632;2352;130;507;186;636;316;1143
354700;201409;1198;3387;803;2546;140;536;340;907;480;1443
354710;201409;645;1902;550;1709;141;496;209;597;350;1093
354720;201409;212;609;169;521;63;192;42;125;105;317
354730;201409;6363;22044;5532;20284;1514;6072;2485;8847;3999;14919
354740;201409;270;814;198;690;53;187;47;169;100;356
354750;201409;2440;7814;2050;7208;699;2663;746;2568;1445;5231
354760;201409;2275;7590;1907;6733;640;2413;398;1326;1038;3739
354765;201409;312;821;199;617;47;176;31;87;78;263
354770;201409;2861;8426;2297;7500;1059;3684;430;1346;1489;5030
354780;201409;37620;116534;33966;108265;7838;27813;17019;51477;24857;79290
354790;201409;916;2993;802;2793;222;863;354;1131;576;1994
354800;201409;1766;5206;1575;4947;328;1162;1021;3196;1349;4358
354805;201409;978;3011;728;2439;120;446;141;424;261;870
354810;201409;720;2394;517;1872;166;659;99;316;265;975
354820;201409;1128;3975;1000;3704;289;1223;286;958;575;2181
354830;201409;481;1444;402;1300;138;494;153;455;291;949
354840;201409;822;2424;741;2279;227;739;319;975;546;1714
354850;201409;15540;49574;11695;41504;3037;11996;4325;14231;7362;26227
354860;201409;1322;4333;1200;4121;299;1200;565;1834;864;3034
354870;201409;45865;147024;42421;139677;12682;44394;20167;65151;32849;109545
354880;201409;4229;13148;3028;10441;844;3188;741;2240;1585;5428
354890;201409;15964;49047;13728;44574;3939;13799;4803;15038;8742;28837
354900;201409;624;1737;500;1550;175;565;188;584;363;1149
354910;201409;6685;20611;3922;14227;937;3768;435;1468;1372;5236
354920;201409;522;1540;403;1326;117;430;107;331;224;761
354925;201409;374;1080;227;775;48;187;39;108;87;295
354930;201409;321;913;257;792;86;281;89;277;175;558
354940;201409;2275;8101;1748;6629;660;2637;251;872;911;3509
354950;201409;1574;5198;1405;4956;257;1049;860;2993;1117;4042
354960;201409;794;2539;693;2371;204;769;270;898;474;1667
354970;201409;4172;13933;3713;12983;784;3188;2019;6727;2803;9915
354980;201409;33463;83868;19226;59116;4394;15208;6557;18591;10951;33799
354990;201409;44167;141530;38072;128694;8519;31840;19681;64577;28200;96417
354995;201409;2018;6381;1899;6206;491;1715;1004;3291;1495;5006
355000;201409;1725;5803;1514;5408;559;2176;352;1196;911;3372
355010;201409;3834;12224;3204;10794;907;3324;1275;4216;2182;7540
355020;201409;3428;12189;2905;11138;1412;5712;785;3024;2197;8736
355030;201409;909622;2644587;813000;2450250;206658;676752;366451;1071547;573109;1748299
355040;201409;3092;10128;2780;9560;871;3306;1391;4604;2262;7910
355050;201409;1320;4163;1084;3675;381;1358;262;889;643;2247
355060;201409;5161;17747;4140;15412;1112;4629;1032;3558;2144;8187
355070;201409;6658;20963;5952;19760;1363;5291;3239;10093;4602;15384
355080;201409;1401;4981;1075;4148;331;1405;159;529;490;1934
355090;201409;1151;4107;973;3675;231;951;402;1467;633;2418
355100;201409;25499;80814;22020;74818;7249;26316;8321;28342;15570;54658
355110;201409;1360;4735;1234;4454;422;1647;427;1502;849;3149
355120;201409;680;2175;585;1991;169;629;252;830;421;1459
355130;201409;615;1666;369;1122;90;320;135;339;225;659
355140;201409;1057;3850;1011;3749;281;1143;496;1819;777;2962
355150;201409;3709;12336;3258;11483;1016;3746;1321;4547;2337;8293
355160;201409;1688;5726;1459;5331;611;2478;396;1313;1007;3791
355170;201409;10290;29507;7380;24238;2552;9036;1955;6330;4507;15366
355180;201409;2953;9156;2504;8309;689;2639;957;2938;1646;5577
355190;201409;1393;4807;1235;4468;526;1956;367;1287;893;3243
355200;201409;952;3507;898;3395;421;1672;227;841;648;2513
355210;201409;2989;10272;2725;9694;779;3134;1203;3973;1982;7107
355220;201409;32636;109967;29481;103371;12228;44353;8698;31068;20926;75421
355230;201409;1351;3873;772;2542;139;514;187;537;326;1051
355240;201409;24123;73211;17885;59532;4217;15542;6882;21383;11099;36925
355250;201409;26310;88114;23516;82478;7185;26676;10063;35009;17248;61685
355255;201409;953;2641;676;2062;136;452;202;581;338;1033
355260;201409;1678;4902;1503;4592;425;1477;591;1647;1016;3124
355270;201409;1744;5390;1661;5257;247;931;1178;3596;1425;4527
355280;201409;24976;75409;21319;68264;5188;18674;9484;28884;14672;47558
355290;201409;913;2957;831;2809;195;710;383;1248;578;1958
355300;201409;952;3127;762;2695;187;719;252;840;439;1559
355310;201409;1139;3456;971;3158;231;774;467;1571;698;2345
355320;201409;764;2450;674;2234;197;745;242;689;439;1434
355330;201409;1999;6693;1487;5615;511;2167;447;1597;958;3764
355340;201409;3213;8708;2973;8296;687;2148;1738;4644;2425;6792
355350;201409;1469;5123;1293;4746;428;1691;402;1435;830;3126
355360;201409;1288;4467;1189;4264;257;1002;794;2864;1051;3866
355365;201409;316;1003;268;905;80;306;71;225;151;531
355370;201409;7628;19797;5548;17221;1825;6166;2306;7212;4131;13378
355380;201409;3731;11394;2887;9400;832;2992;619;1713;1451;4705
355385;201409;1036;3350;969;3232;429;1553;277;849;706;2402
355390;201409;1456;4066;1251;3671;351;1126;479;1347;830;2473
355395;201409;1916;5864;1448;4769;282;1020;588;1769;870;2789
355400;201409;9722;33224;8692;31098;3069;11923;3191;11027;6260;22950
355410;201409;14950;53200;13186;49336;4996;19916;3623;13764;8619;33680
355420;201409;848;3082;798;2957;295;1166;271;1022;566;2188
355430;201409;3928;11476;3358;10456;769;2638;1713;5173;2482;7811
355440;201409;968;3231;781;2733;216;801;230;704;446;1505
355450;201409;2749;9192;2265;8086;676;2651;736;2484;1412;5135
355460;201409;597;1679;450;1412;115;439;160;427;275;866
355465;201409;461;1423;397;1300;125;434;101;328;226;762
355470;201409;993;3054;799;2708;257;962;288;921;545;1883
355475;201409;134;514;118;465;37;146;41;172;78;318
355480;201409;3354;12289;3158;11856;992;3938;1410;5213;2402;9151
355490;201409;880;2621;688;2218;177;592;146;477;323;1069
355495;201409;759;2559;704;2450;199;777;287;972;486;1749
355500;201409;9081;26944;6046;20144;1458;5356;1351;4140;2809;9496
355510;201409;2277;6272;1477;4659;346;1244;435;1252;781;2496
355520;201409;465;1175;282;809;62;203;94;234;156;437
355530;201409;292;695;125;384;13;41;39;128;52;169
355535;201409;703;2167;554;1872;166;655;149;419;315;1074
355540;201409;10513;34121;9972;33203;2916;10462;4979;16145;7895;26607
355550;201409;779;2393;699;2260;188;664;345;1085;533;1749
355560;201409;1453;4355;1063;3512;284;1059;216;559;500;1618
355570;201409;218;710;170;596;36;129;35;100;71;229
355580;201409;1337;4008;1118;3577;391;1366;428;1336;819;2702
355590;201409;260;738;232;680;54;182;112;323;166;505
355600;201409;1131;3632;947;3209;383;1417;227;729;610;2146
355610;201409;1534;4489;1307;4122;353;1244;595;1802;948;3046
355620;201409;4155;13345;3327;11419;750;2939;1390;4346;2140;7285
355630;201409;3492;10152;2181;7350;484;1826;677;2080;1161;3906
355635;201409;1028;3412;893;3174;148;591;585;2072;733;2663
355640;201409;3934;13123;3256;11525;1136;4190;631;2166;1767;6356
355645;201409;3506;12487;3277;12065;650;2620;2004;7365;2654;9985
355650;201409;7019;22268;6136;20518;1196;4806;3660;11442;4856;16248
355660;201409;1409;4554;1174;4078;365;1440;473;1541;838;2981
355670;201409;2502;8014;1761;6264;468;1916;639;2010;1107;3926
355680;201409;1823;6255;1469;5390;554;2129;328;1139;882;3268
355690;201409;436;1392;330;1209;213;837;26;65;239;902
355695;201409;371;1114;242;793;32;104;20;48;52;152
355700;201409;6887;24276;6090;22357;1834;7296;2549;9035;4383;16331
355710;201409;13161;33670;8231;24655;2674;8503;2200;6320;4874;14823
355715;201409;273;846;180;641;45;182;37;114;82;296
355720;201409;1557;5115;1262;4449;392;1517;385;1213;777;2730
355730;201409;814;2834;728;2638;285;1066;176;637;461;1703
410010;201409;1665;5334;1499;4984;427;1532;474;1550;901;3082
410020;201409;1300;4394;1195;4176;368;1364;448;1535;816;2899
410030;201409;1077;3709;896;3256;282;1067;176;636;458;1703
410040;201409;13459;45127;12267;42666;4412;16342;3679;12702;8091;29044
410045;201409;970;2780;683;2199;193;676;210;619;403;1295
410050;201409;3024;8611;1984;6549;640;2273;454;1402;1094;3675
410060;201409;2110;6716;1896;6299;545;2000;766;2505;1311;4505
410070;201409;2235;6369;1819;5526;706;2281;397;1091;1103;3372
410080;201409;1526;4582;1262;4084;319;1103;609;1889;928;2992
410090;201409;1165;3681;1061;3464;350;1270;385;1190;735;2460
410100;201409;2397;7337;1699;5693;515;1968;268;833;783;2801
410105;201409;479;1526;348;1205;78;305;40;106;118;411
410110;201409;2766;8382;2346;7549;574;2093;856;2655;1430;4748
410115;201409;633;1759;502;1496;121;394;174;495;295;889
410120;201409;2986;10275;2823;10031;1048;3896;1225;4490;2273;8386
410130;201409;1446;4830;1308;4507;427;1454;561;1962;988;3416
410140;201409;16532;45628;11664;36604;3256;11264;4012;12471;7268;23735
410150;201409;17508;43703;8263;24769;1749;5790;1702;4556;3451;10346
410160;201409;3473;11049;3164;10532;1041;3781;1155;3888;2196;7669
410165;201409;711;2084;562;1753;136;455;253;747;389;1202
410170;201409;1957;6027;1645;5353;606;2145;499;1578;1105;3723
410180;201409;9362;30132;8131;27424;2043;7840;3608;11334;5651;19174
410185;201409;669;1831;591;1684;128;386;306;865;434;1251
410190;201409;2351;7014;2006;6217;653;2170;526;1534;1179;3704
410200;201409;3827;10850;2742;8618;733;2546;398;1124;1131;3670
410210;201409;2779;8554;2185;7222;547;2021;463;1300;1010;3321
410220;201409;629;1816;455;1447;93;335;151;445;244;780
410230;201409;1920;6194;1727;5845;654;2431;638;2091;1292;4522
410240;201409;5403;16848;4944;15859;1610;5544;1787;5634;3397;11178
410250;201409;2454;6915;1635;5172;492;1723;337;953;829;2676
410260;201409;1781;5519;1552;5102;479;1684;583;1875;1062;3559
410270;201409;586;1710;485;1510;130;451;197;601;327;1052
410275;201409;958;2865;667;2226;122;434;327;1088;449;1522
410280;201409;2986;8925;2131;7063;511;1930;420;1291;931;3221
410290;201409;3374;10358;2892;9419;734;2588;1281;4168;2015;6756
410300;201409;660;1891;583;1725;86;310;296;780;382;1090
410302;201409;609;1736;477;1511;63;219;270;862;333;1081
410304;201409;1506;4873;1382;4618;432;1492;574;1991;1006;3483
410305;201409;2282;6075;1949;5585;503;1497;1151;3379;1654;4876
410310;201409;2489;8234;2264;7794;646;2407;878;3051;1524;5458
410315;201409;683;2022;472;1606;114;396;148;475;262;871
410320;201409;1264;3724;785;2636;156;592;65;175;221;767
410322;201409;624;1856;449;1462;130;426;123;387;253;813
410330;201409;1567;4406;1336;3969;395;1255;451;1322;846;2577
410335;201409;1046;3100;882;2804;210;746;360;1089;570;1835
410337;201409;861;2303;687;1982;138;471;282;729;420;1200
410340;201409;605;1813;468;1456;94;335;148;394;242;729
410345;201409;2048;6087;1609;5157;547;1908;405;1196;952;3104
410347;201409;650;1790;418;1348;77;291;154;484;231;775
410350;201409;905;2787;600;2128;162;671;111;337;273;1008
410360;201409;3809;11438;3315;10540;1008;3442;1215;3825;2223;7267
410370;201409;13649;40196;10258;32655;2743;9865;3013;8759;5756;18624
410380;201409;1464;4655;1328;4359;339;1203;595;1870;934;3073
410390;201409;2932;8588;2371;7552;902;3086;646;1890;1548;4976
410395;201409;919;3111;820;2895;209;854;391;1364;600;2218
410400;201409;5494;17785;4847;16499;1494;5704;1612;5276;3106;10980
410405;201409;1020;2989;815;2574;206;757;330;991;536;1748
410410;201409;1391;4693;1324;4584;499;1936;403;1305;902;3241
410420;201409;9724;31851;8493;29010;2932;10775;2130;6806;5062;17581
410425;201409;3315;10659;2359;8408;566;2234;332;1116;898;3350
410430;201409;16461;45401;12348;37637;3424;11428;3940;11917;7364;23345
410440;201409;3683;11630;3323;10927;855;3038;1583;5196;2438;8234
410442;201409;3061;10551;2756;9829;933;3531;868;3074;1801;6605
410445;201409;2388;7973;2052;7358;598;2335;778;2875;1376;5210
410450;201409;2652;7622;2119;6602;680;2230;397;1122;1077;3352
410460;201409;2426;7242;2026;6439;557;1893;752;2268;1309;4161
410465;201409;2151;7647;1837;6901;608;2435;677;2362;1285;4797
410470;201409;1448;4694;1189;4080;328;1256;375;1272;703;2528
410480;201409;31696;92697;24857;78768;8758;30188;6199;18816;14957;49004
410490;201409;11851;38392;9645;33487;2969;11302;3003;10068;5972;21370
410500;201409;1602;5042;1303;4383;489;1791;372;1238;861;3029
410510;201409;2563;6867;1846;5406;435;1367;759;2055;1194;3422
410520;201409;3325;11614;3146;11227;1172;4399;1163;4141;2335;8540
410530;201409;1723;4910;1444;4358;363;1244;611;1736;974;2980
410540;201409;3947;11510;2740;9072;743;2595;900;2939;1643;5534
410550;201409;7166;21822;5278;17567;1649;6030;856;2606;2505;8636
410560;201409;1350;4335;1058;3603;285;1076;277;782;562;1858
410570;201409;3003;9819;2732;9326;851;2976;1116;4133;1967;7109
410580;201409;26997;85067;23341;77349;7981;28878;6950;21745;14931;50623
410590;201409;1258;3983;767;2571;140;493;185;547;325;1040
410600;201409;2093;6199;1743;5495;461;1513;758;2409;1219;3922
410610;201409;845;2586;712;2332;158;582;318;1003;476;1585
410620;201409;1836;6607;1562;5856;508;2007;333;1198;841;3205
410630;201409;2651;7935;2058;6615;598;2127;564;1652;1162;3779
410640;201409;5301;15493;4194;13351;1443;5200;981;2941;2424;8141
410645;201409;1318;4674;1259;4563;547;2135;393;1424;940;3559
410650;201409;2556;7824;2063;6785;741;2577;485;1516;1226;4093
410655;201409;965;2934;793;2590;219;793;258;815;477;1608
410657;201409;726;2139;541;1747;161;579;198;570;359;1149
410660;201409;3907;11392;2987;9325;1080;3530;665;1909;1745;5439
410670;201409;1019;2902;778;2420;221;745;206;594;427;1339
410680;201409;2566;8903;2145;7810;643;2327;725;2781;1368;5108
410685;201409;719;2144;644;2009;98;299;458;1449;556;1748
410690;201409;107685;314169;74105;242778;18337;66520;18501;54825;36838;121345
410700;201409;2446;7719;2277;7380;727;2563;936;2918;1663;5481
410710;201409;1125;3527;886;2960;287;1043;245;740;532;1783
410712;201409;835;2577;723;2357;302;1078;217;727;519;1805
410715;201409;1104;3427;926;3029;246;870;348;1096;594;1966
410720;201409;3364;10015;2487;8141;652;2382;732;2184;1384;4566
410725;201409;1072;3076;754;2424;160;546;161;440;321;986
410730;201409;747;2268;678;2115;284;948;189;569;473;1517
410740;201409;846;2521;579;1963;112;447;279;930;391;1377
410750;201409;1996;5927;1681;5261;514;1750;516;1507;1030;3257
410752;201409;275;812;213;675;52;196;88;251;140;447
410753;201409;486;1402;338;1060;80;292;114;327;194;619
410754;201409;986;3047;868;2849;89;318;597;2018;686;2336
410755;201409;857;2226;665;1920;98;339;399;1100;497;1439
410760;201409;2678;8585;2489;8217;902;3116;1003;3251;1905;6367
410765;201409;16479;49369;12074;40238;3025;11253;1890;5896;4915;17149
410770;201409;978;2768;779;2374;254;853;237;680;491;1533
410773;201409;1401;4126;1179;3747;289;1062;612;1848;901;2910
410775;201409;1866;5476;1761;5305;496;1481;990;3070;1486;4551
410780;201409;493;1403;378;1208;115;372;161;573;276;945
410785;201409;892;2878;672;2254;249;882;191;639;440;1521
410790;201409;622;1942;518;1699;143;524;111;298;254;822
410800;201409;2911;7664;2314;6684;803;2603;844;2254;1647;4857
410810;201409;302;957;244;818;32;125;113;380;145;505
410820;201409;1113;3368;900;2855;277;929;212;643;489;1572
410830;201409;32773;96229;26912;85648;8457;29403;9335;29187;17792;58590
410832;201409;1220;3669;1090;3427;248;907;543;1594;791;2501
410840;201409;6707;20149;4570;15427;1421;5249;698;2086;2119;7335
410845;201409;1592;4722;1340;4178;292;1005;620;1880;912;2885
410850;201409;2893;8560;2580;8079;598;2150;1396;4358;1994;6508
410855;201409;777;2173;618;1830;178;570;226;647;404;1217
410860;201409;4042;11586;3437;10464;783;2525;1675;5182;2458;7707
410865;201409;1749;5998;1584;5678;400;1531;847;3109;1247;4640
410870;201409;1437;4396;1344;4246;673;2263;403;1242;1076;3505
410880;201409;4599;13755;3692;11990;928;3429;890;2575;1818;6004
410890;201409;1113;3477;830;2928;235;899;79;236;314;1135
410895;201409;1059;3723;946;3473;362;1432;299;1043;661;2475
410900;201409;958;2701;717;2293;159;590;227;674;386;1264
410910;201409;376;1127;329;1041;67;233;173;533;240;766
410920;201409;894;2746;734;2452;215;794;242;756;457;1550
410930;201409;1803;5400;1518;4872;374;1433;660;2072;1034;3505
410940;201409;21879;73433;19390;68670;6319;24340;7516;26826;13835;51166
410950;201409;1914;6374;1745;6061;362;1312;1067;3761;1429;5073
410960;201409;7183;20093;4773;15526;1552;5521;1366;4341;2918;9862
410965;201409;1126;3545;998;3269;345;1171;391;1280;736;2451
410970;201409;5303;16064;4324;14070;1519;5531;913;2936;2432;8467
410975;201409;1555;4505;1281;4031;242;898;620;1933;862;2831
410980;201409;5770;16550;3526;11816;841;3109;674;2137;1515;5246
410990;201409;872;2559;532;1780;175;647;108;299;283;946
411000;201409;446;1365;304;1026;71;273;48;130;119;403
411005;201409;536;1577;363;1144;101;318;63;172;164;490
411007;201409;2093;6763;1875;6261;553;1971;759;2542;1312;4513
411010;201409;4183;14373;3801;13512;1401;5507;966;3170;2367;8677
411020;201409;2587;8232;2331;7777;800;2970;811;2708;1611;5678
411030;201409;893;2422;739;2136;247;779;217;583;464;1362
411040;201409;561;1697;347;1157;102;367;87;281;189;648
411050;201409;2190;7806;1937;7218;656;2651;334;1143;990;3794
411060;201409;2153;6790;1851;6132;572;2034;320;978;892;3012
411065;201409;406;1249;329;1094;70;246;121;381;191;627
411070;201409;5034;15880;3682;12840;1104;4255;573;1797;1677;6052
411080;201409;2114;6536;1897;6080;553;1969;609;1863;1162;3832
411090;201409;690;1735;530;1489;118;406;142;352;260;758
411095;201409;1668;4608;1285;3854;301;1008;351;976;652;1984
411100;201409;1529;4420;1140;3656;275;994;246;711;521;1705
411110;201409;966;2925;720;2361;218;760;127;361;345;1121
411120;201409;1876;5831;1577;5173;495;1745;494;1578;989;3323
411125;201409;4859;15939;4705;15621;1591;5591;2120;6905;3711;12496
411130;201409;812;2442;660;2122;190;625;219;727;409;1352
411140;201409;2018;7263;1731;6547;630;2480;480;1891;1110;4371
411150;201409;6111;17312;4960;14992;1467;4780;1296;3592;2763;8372
411155;201409;1279;3718;1088;3342;349;1178;427;1226;776;2404
411160;201409;322;977;287;903;108;346;102;318;210;664
411170;201409;856;2891;747;2627;226;831;241;852;467;1683
411180;201409;6538;19902;5661;18249;1726;6093;1835;5873;3561;11966
411190;201409;1890;5557;1616;5049;485;1703;493;1439;978;3142
411200;201409;4567;13906;3767;12535;1171;4313;1470;4723;2641;9036
411210;201409;2597;7578;2080;6599;837;2822;386;1186;1223;4008
411220;201409;1235;3560;1008;3127;257;933;434;1213;691;2146
411230;201409;1307;3740;840;2742;267;967;194;561;461;1528
411240;201409;1282;3056;689;2084;171;548;215;605;386;1153
411250;201409;2593;7655;2157;6793;608;2068;675;2093;1283;4161
411260;201409;319;886;217;706;46;173;97;297;143;470
411270;201409;2126;6772;1942;6413;592;2175;859;2754;1451;4929
411275;201409;1601;4852;1371;4311;411;1348;391;1185;802;2533
411280;201409;1770;5514;1419;4753;449;1669;235;697;684;2366
411290;201409;1046;2920;874;2577;253;770;295;898;548;1668
411295;201409;1123;3321;1029;3151;246;812;431;1303;677;2115
411300;201409;1107;2884;801;2272;78;254;378;992;456;1246
411310;201409;876;2512;666;2140;121;443;276;868;397;1311
411320;201409;5753;17163;4328;14298;1271;4411;1054;3322;2325;7733
411325;201409;1599;5086;1429;4765;258;959;872;2893;1130;3852
411330;201409;3780;12198;3313;11297;1277;4745;980;3245;2257;7990
411340;201409;1014;2968;667;2155;154;546;262;830;416;1376
411342;201409;905;2609;743;2255;213;718;219;590;432;1308
411345;201409;1101;3470;1014;3297;306;1087;482;1554;788;2641
411350;201409;2972;9055;2085;7172;648;2423;261;816;909;3239
411360;201409;581;1464;362;1046;46;181;168;407;214;588
411370;201409;46954;136110;36009;115001;7804;29197;13274;38916;21078;68113
411373;201409;1511;4759;1260;4256;361;1363;357;1157;718;2520
411375;201409;1182;3318;927;2801;245;784;332;943;577;1727
411380;201409;1310;3533;818;2485;152;500;248;714;400;1214
411390;201409;1896;5821;1678;5456;447;1610;781;2430;1228;4040
411400;201409;1875;5587;1448;4605;337;1207;430;1256;767;2463
411410;201409;2665;8251;2189;7120;701;2580;573;1608;1274;4188
411420;201409;4677;13654;3505;10974;929;3234;702;1850;1631;5084
411430;201409;3034;9760;2585;8930;783;2952;1121;3782;1904;6734
411435;201409;601;1928;510;1699;137;506;191;604;328;1110
411440;201409;2655;8684;2400;8179;899;3224;722;2573;1621;5797
411450;201409;2189;6682;1999;6352;447;1481;1188;3805;1635;5286
411460;201409;4763;14589;3292;11025;1206;4263;630;2038;1836;6301
411470;201409;902;2745;622;2046;132;478;124;349;256;827
411480;201409;5162;15764;4038;13494;1581;5717;899;2901;2480;8618
411490;201409;1748;5478;1551;5107;571;2125;429;1276;1000;3401
411500;201409;1761;4916;1242;3930;352;1214;318;986;670;2200
411510;201409;2514;7362;1985;6312;674;2363;455;1282;1129;3645
411520;201409;26112;72173;16037;50663;4024;14080;3759;11089;7783;25169
411530;201409;946;2735;639;2152;233;880;111;310;344;1190
411535;201409;484;1413;231;795;41;169;25;59;66;228
411540;201409;3115;8472;2436;7204;456;1431;1243;3677;1699;5108
411545;201409;1067;3690;980;3517;203;776;635;2305;838;3081
411550;201409;758;2136;617;1897;253;849;146;428;399;1277
411560;201409;2728;8180;2174;6861;623;2139;479;1378;1102;3517
411570;201409;6501;17993;4824;15115;1416;4893;1151;3711;2567;8604
411573;201409;1027;3092;968;2988;203;660;562;1765;765;2425
411575;201409;1552;5025;1333;4531;345;1261;513;1730;858;2991
411580;201409;3855;11228;2775;8981;680;2568;450;1169;1130;3737
411585;201409;569;1867;395;1355;113;403;70;223;183;626
411590;201409;603;1782;534;1648;139;480;189;565;328;1045
411600;201409;375;1148;308;1014;88;343;85;284;173;627
411605;201409;2393;6523;1747;5270;461;1518;670;1938;1131;3456
411610;201409;2453;6988;2195;6604;469;1521;1439;4278;1908;5799
411620;201409;2943;9593;2762;9268;852;3049;1240;4267;2092;7316
411630;201409;502;1302;286;954;68;273;60;175;128;448
411640;201409;605;1891;505;1682;153;548;190;596;343;1144
411650;201409;195;651;171;609;46;185;61;200;107;385
411660;201409;897;2545;721;2200;190;613;310;948;500;1561
411670;201409;1724;5048;1518;4627;491;1665;550;1559;1041;3224
411680;201409;1774;5420;1544;5025;376;1190;918;3142;1294;4332
411690;201409;3639;10965;3007;9723;964;3281;820;2715;1784;5996
411695;201409;720;2339;576;2024;136;515;228;812;364;1327
411700;201409;1966;5705;1423;4635;349;1268;387;1178;736;2446
411705;201409;2335;7947;2037;7362;474;1747;1140;4243;1614;5990
411710;201409;2242;6842;1823;5908;537;1871;485;1461;1022;3332
411720;201409;750;2255;558;1798;108;385;148;436;256;821
411721;201409;734;2228;617;1983;199;708;130;380;329;1088
411722;201409;731;2201;563;1816;135;500;165;473;300;973
411725;201409;1368;4423;861;3110;215;836;197;695;412;1531
411727;201409;2335;6734;1887;5778;462;1527;798;2304;1260;3831
411729;201409;507;1411;373;1169;105;371;119;328;224;699
411730;201409;5285;15525;4456;13938;1935;6248;1333;4226;3268;10474
411740;201409;616;1812;446;1424;106;367;171;524;277;891
411745;201409;923;2868;769;2513;211;715;207;650;418;1365
411750;201409;4804;14904;3634;12012;1098;4009;709;2150;1807;6159
411760;201409;9069;26946;8095;25269;3024;10090;2524;7975;5548;18065
411770;201409;4023;14011;3507;12744;1386;5286;797;2899;2183;8185
411780;201409;3128;10201;3006;10058;399;1223;2256;8009;2655;9232
411790;201409;2701;7745;1970;6273;597;2195;643;1936;1240;4131
411800;201409;1456;4247;886;2923;158;592;171;459;329;1051
411810;201409;1619;4985;1406;4521;395;1451;454;1289;849;2740
411820;201409;17082;53946;14273;48600;5128;17969;4410;15672;9538;33641
411830;201409;425;1157;338;1025;149;452;47;146;196;598
411840;201409;9461;28130;7439;24126;2189;7748;2008;6267;4197;14015
411845;201409;599;1815;433;1409;108;377;104;328;212;705
411850;201409;6156;18754;5110;16575;1390;4838;1506;4859;2896;9697
411860;201409;935;2984;775;2630;221;797;233;751;454;1548
411870;201409;1076;3790;832;3117;153;600;218;794;371;1394
411880;201409;2435;7083;2037;6373;603;2150;725;2114;1328;4264
411885;201409;754;2053;583;1731;136;515;233;597;369;1112
411890;201409;1380;4261;982;3303;283;1020;192;579;475;1599
411900;201409;974;3128;704;2438;215;752;120;416;335;1168
411910;201409;1246;4287;1071;3878;344;1355;331;1139;675;2494
411915;201409;12706;35925;8317;26741;1942;6903;2070;6104;4012;13007
411920;201409;1092;3824;966;3499;283;1130;223;748;506;1878
411925;201409;602;1693;410;1340;115;397;131;413;246;810
411930;201409;6428;21231;5658;19636;1870;6980;1980;6852;3850;13832
411940;201409;3702;12467;3282;11557;1113;4091;867;2966;1980;7057
411950;201409;10514;33917;8911;30717;2499;9442;4089;13843;6588;23285
411960;201409;4927;14998;4535;14229;1151;4044;2173;6662;3324;10706
411965;201409;602;1802;468;1586;104;397;169;583;273;980
411970;201409;797;2245;611;1947;198;708;166;485;364;1193
411980;201409;1452;4503;1226;4004;215;753;536;1736;751;2489
411990;201409;31317;106723;27165;97605;9631;36963;7839;28247;17470;65210
411995;201409;3212;10092;2863;9370;1162;4102;758;2432;1920;6534
412000;201409;2268;6132;1800;5324;383;1322;838;2215;1221;3537
412010;201409;744;2525;625;2244;170;636;158;538;328;1174
412015;201409;680;2087;545;1785;112;394;275;892;387;1286
412020;201409;447;1315;319;1035;113;396;123;375;236;771
412030;201409;655;2068;432;1517;96;395;120;378;216;773
412033;201409;789;2402;560;1867;140;506;120;353;260;859
412035;201409;1044;2935;789;2469;198;678;321;949;519;1627
412040;201409;784;2576;703;2367;251;871;234;774;485;1645
412050;201409;1655;4992;1277;4161;329;1208;279;862;608;2070
412060;201409;6911;24353;6313;22999;1965;7640;2507;9115;4472;16755
412065;201409;1012;3097;835;2717;248;912;245;743;493;1655
412070;201409;1263;3511;1046;3075;227;714;391;1130;618;1844
412080;201409;1622;5053;1027;3647;218;870;97;272;315;1142
412085;201409;379;1070;178;573;46;173;49;136;95;309
412090;201409;4955;16147;4734;15739;1039;3674;2962;9953;4001;13627
412100;201409;2257;7109;1976;6600;668;2346;679;2223;1347;4569
412110;201409;1165;3355;797;2559;239;830;234;730;473;1560
412120;201409;1873;6431;1681;5968;435;1749;778;2586;1213;4335
412125;201409;993;3075;883;2883;251;870;359;1196;610;2066
412130;201409;654;1933;483;1591;107;390;127;397;234;787
412135;201409;564;1629;406;1299;103;363;153;446;256;809
412140;201409;1439;4388;1182;3825;309;1058;367;1181;676;2239
412150;201409;3015;8908;2613;8100;410;1449;1555;4685;1965;6134
412160;201409;997;3245;668;2396;171;704;236;830;407;1534
412170;201409;4639;15286;3910;13823;1359;5163;1415;4910;2774;10073
412175;201409;1496;5185;1342;4835;381;1494;557;2001;938;3495
412180;201409;1832;5817;1418;5035;503;1960;412;1402;915;3362
412190;201409;3207;9532;2558;8406;878;3082;682;2278;1560;5360
412200;201409;2338;7759;1663;5923;401;1567;527;1851;928;3418
412210;201409;777;2202;455;1505;112;416;71;221;183;637
412215;201409;3542;11231;3212;10626;578;1951;2060;7015;2638;8966
412217;201409;1251;3680;1165;3528;219;770;753;2155;972;2925
412220;201409;5121;17247;4899;16804;1496;5396;2693;9219;4189;14615
412230;201409;3103;10533;2698;9697;781;3128;856;2956;1637;6084
412240;201409;9702;25334;5592;17596;1291;4545;969;2749;2260;7294
412250;201409;2231;6814;1973;6252;669;2295;557;1636;1226;3931
412260;201409;1384;4107;935;3127;203;788;304;904;507;1692
412265;201409;1238;3897;1123;3680;283;1061;548;1761;831;2822
412270;201409;867;2799;657;2308;152;604;130;432;282;1036
412280;201409;676;2111;506;1754;265;976;84;272;349;1248
412290;201409;1219;3466;982;2986;208;724;373;1049;581;1773
412300;201409;1837;5536;1529;4925;479;1724;402;1224;881;2948
412310;201409;1233;3499;1093;3305;199;515;738;2471;937;2986
412320;201409;728;2014;538;1683;132;464;189;587;321;1051
412330;201409;2030;5570;1563;4740;357;1159;749;2270;1106;3429
412340;201409;805;2543;546;1862;97;358;105;340;202;698
412350;201409;2692;8234;2201;7146;746;2571;360;1068;1106;3639
412360;201409;353;1113;278;917;54;204;89;241;143;445
412370;201409;1151;3611;910;3133;326;1203;266;892;592;2095
412380;201409;2098;6383;1801;5712;556;1850;531;1665;1087;3515
412382;201409;731;2071;506;1577;118;392;153;436;271;828
412385;201409;2487;7875;2256;7353;717;2484;749;2426;1466;4910
412390;201409;2507;7496;2288;7119;789;2619;885;2770;1674;5389
412395;201409;980;2719;785;2408;121;382;480;1482;601;1864
412400;201409;1196;3708;1055;3438;332;1112;409;1392;741;2504
412402;201409;2179;6643;1783;5795;575;2054;512;1476;1087;3530
412405;201409;4239;11960;2766;8819;762;2711;366;1098;1128;3809
412410;201409;6527;21067;5850;19705;2478;9119;1315;4353;3793;13472
412420;201409;547;1622;435;1387;140;488;135;356;275;844
412430;201409;498;1466;411;1285;112;391;168;477;280;868
412440;201409;4109;12297;3503;11222;733;2566;1370;4560;2103;7126
412450;201409;303;986;238;814;43;156;39;92;82;248
412460;201409;1031;2946;737;2383;186;711;175;516;361;1227
412470;201409;1891;6473;1673;5927;559;2070;580;2101;1139;4171
412480;201409;1327;3911;918;2990;219;770;145;386;364;1156
412490;201409;1309;3862;1152;3492;319;1020;345;1019;664;2039
412500;201409;2093;6223;1787;5617;513;1838;472;1284;985;3122
412510;201409;2811;9507;2475;8628;749;2815;945;3257;1694;6072
412520;201409;1891;5275;1423;4463;448;1507;459;1403;907;2910
412530;201409;809;2429;682;2139;201;640;208;650;409;1290
412535;201409;500;1537;330;1078;81;295;89;252;170;547
412540;201409;1161;3406;867;2767;151;551;321;1012;472;1563
412545;201409;966;2761;785;2366;148;505;309;843;457;1348
412550;201409;25587;77450;17512;59079;4901;17958;3690;11585;8591;29543
412555;201409;351;1075;242;801;57;212;45;120;102;332
412560;201409;4916;15869;3907;13780;1073;4319;988;3163;2061;7482
412570;201409;4308;12674;3164;10057;822;2909;690;2072;1512;4981
412575;201409;878;2709;704;2295;174;650;220;659;394;1309
412580;201409;1491;4141;1081;3403;272;895;338;1022;610;1917
412590;201409;516;1565;406;1354;137;487;123;428;260;915
412600;201409;1571;4956;1343;4483;433;1597;443;1382;876;2979
412610;201409;830;2673;661;2266;228;896;179;528;407;1424
412620;201409;1303;4319;1089;3852;370;1413;238;810;608;2223
412625;201409;14297;40830;11844;36090;4321;14039;2784;8378;7105;22417
412627;201409;1061;3267;732;2530;259;955;82;269;341;1224
412630;201409;3634;11614;3141;10532;865;3063;1034;3354;1899;6417
412635;201409;558;1604;394;1229;106;346;53;159;159;505
412640;201409;870;2635;595;1974;142;500;98;278;240;778
412650;201409;2349;6746;1941;5974;533;1847;678;1868;1211;3715
412660;201409;3158;9569;2594;8369;681;2439;628;1900;1309;4339
412665;201409;746;1999;462;1480;161;569;133;395;294;964
412667;201409;1516;4512;1207;3890;318;1176;343;1024;661;2200
412670;201409;696;2195;473;1640;105;411;84;218;189;629
412680;201409;1660;5277;1270;4388;350;1302;342;1063;692;2365
412690;201409;766;2438;615;2095;234;855;119;396;353;1251
412700;201409;1864;6072;1623;5669;617;2375;580;1985;1197;4360
412710;201409;8974;28259;7549;25270;2204;8031;2046;6567;4250;14598
412720;201409;1729;5480;1207;4103;301;1100;154;417;455;1517
412730;201409;2898;8756;2003;6795;648;2358;282;845;930;3203
412740;201409;2231;7279;1948;6621;799;2839;336;1184;1135;4023
412750;201409;3556;11581;3227;11012;590;2340;2134;7069;2724;9409
412760;201409;2437;8121;2322;7915;687;2626;1054;3438;1741;6064
412770;201409;12902;37397;8229;27004;1939;7062;1850;5521;3789;12583
412780;201409;1523;4976;1341;4551;412;1499;434;1398;846;2897
412785;201409;2550;7462;1852;5971;463;1645;885;2771;1348;4416
412788;201409;1436;4675;1309;4422;347;1351;483;1454;830;2805
412790;201409;1253;3873;1025;3391;272;963;305;937;577;1900
412795;201409;1065;3092;923;2834;298;945;327;982;625;1927
412796;201409;2736;8652;2521;8196;701;2553;1047;3199;1748;5752
412800;201409;3711;11007;2952;9459;837;2949;912;2758;1749;5707
412810;201409;10842;30632;6504;20900;1674;5828;1479;4292;3153;10120
412820;201409;6894;20853;5116;17304;1480;5499;1146;3924;2626;9423
412830;201409;412;1339;352;1210;101;407;96;282;197;689
412840;201409;2219;6368;1829;5570;513;1698;479;1413;992;3111
412850;201409;2691;8173;2290;7538;431;1680;1146;3571;1577;5251
412853;201409;1615;4700;1426;4340;172;697;883;2472;1055;3169
412855;201409;1706;4897;1349;4154;431;1516;373;994;804;2510
412860;201409;1347;4061;1131;3634;315;1139;468;1433;783;2572
412862;201409;878;2350;650;1906;170;551;245;666;415;1217
412863;201409;1264;4266;1211;4170;190;698;832;2849;1022;3547
412865;201409;684;2161;503;1712;110;411;195;673;305;1084
412870;201409;1046;3015;873;2725;301;998;278;865;579;1863
412880;201409;1609;4461;1362;4049;420;1358;356;1015;776;2373
420005;201409;540;1601;361;1196;82;298;138;428;220;726
420010;201409;3539;10644;2959;9699;493;1712;1999;6718;2492;8430
420020;201409;808;2658;473;1755;84;359;60;171;144;530
420030;201409;577;1654;326;1154;96;387;59;199;155;586
420040;201409;999;3106;666;2433;214;867;134;418;348;1285
420050;201409;850;2661;680;2265;198;691;281;905;479;1596
420055;201409;323;1032;218;773;57;215;43;131;100;346
420060;201409;387;1369;294;1117;87;365;41;138;128;503
420070;201409;1641;5246;1340;4532;246;911;665;2300;911;3211
420075;201409;209;608;116;393;30;120;36;106;66;226
420080;201409;629;2081;529;1865;193;737;127;434;320;1171
420090;201409;695;2474;539;2100;158;636;99;383;257;1019
420100;201409;1537;4948;1416;4779;383;1326;823;2819;1206;4145
420110;201409;463;1590;420;1495;118;428;197;711;315;1139
420120;201409;343;1206;287;1079;107;448;63;216;170;664
420125;201409;392;1585;363;1514;156;689;109;418;265;1107
420127;201409;618;1922;281;1059;95;379;42;157;137;536
420130;201409;2605;8905;2257;8176;686;2706;803;2712;1489;5418
420140;201409;5335;15669;3716;12527;1037;3930;736;2272;1773;6202
420150;201409;832;2481;565;1870;167;604;177;530;344;1134
420160;201409;326;968;203;690;40;153;50;160;90;313
420165;201409;241;775;158;553;38;155;37;125;75;280
420170;201409;251;833;177;677;71;315;22;57;93;372
420180;201409;477;1515;287;1043;82;310;64;223;146;533
420190;201409;611;1945;371;1370;126;509;64;217;190;726
420195;201409;1456;4199;1170;3795;285;994;577;1934;862;2928
420200;201409;3012;9890;1949;7357;652;2708;344;1186;996;3894
420205;201409;1121;3740;1002;3522;287;1069;460;1621;747;2690
420207;201409;1474;4372;1042;3440;322;1212;313;933;635;2145
420208;201409;522;1562;351;1225;129;494;104;343;233;837
420209;201409;375;1196;233;840;48;180;68;239;116;419
420210;201409;1862;6025;1287;4886;392;1730;192;637;584;2367
420213;201409;960;3476;911;3358;202;766;577;2154;779;2920
420215;201409;524;1724;387;1360;122;444;68;224;190;668
420220;201409;436;1696;409;1637;175;745;108;386;283;1131
420230;201409;4741;14657;3659;12625;945;3650;1740;5841;2685;9491
420240;201409;14475;41981;9133;31783;2104;8705;3611;11383;5715;20088
420243;201409;599;1859;485;1609;114;433;175;557;289;990
420245;201409;1277;3976;884;3130;250;1000;195;596;445;1596
420250;201409;843;2709;785;2616;270;984;343;1150;613;2134
420253;201409;682;1796;557;1618;131;386;268;857;399;1243
420257;201409;447;1366;337;1151;91;324;157;526;248;850
420260;201409;1444;4713;1238;4337;344;1311;572;2010;916;3321
420270;201409;608;1951;256;934;49;180;33;102;82;282
420280;201409;2539;7014;1603;5297;405;1592;572;1671;977;3263
420285;201409;168;499;60;223;7;31;1;2;8;33
420287;201409;673;2078;578;1898;156;535;218;722;374;1257
420290;201409;6953;20739;4451;14880;1047;3829;1470;4585;2517;8414
420300;201409;6097;18886;4011;14352;1034;4212;837;2943;1871;7155
420310;201409;908;2750;866;2681;185;612;549;1660;734;2272
420315;201409;1001;3261;797;2835;239;939;315;1104;554;2043
420320;201409;5161;16153;4254;14512;1244;4715;1748;5818;2992;10533
420325;201409;469;1522;446;1466;138;491;166;532;304;1023
420330;201409;1331;4658;1046;3860;359;1403;244;794;603;2197
420340;201409;1534;4801;1178;3939;281;1025;314;1001;595;2026
420350;201409;1679;5435;1444;4935;416;1509;626;2150;1042;3659
420360;201409;3908;12489;2902;10162;1055;4065;533;1698;1588;5763
420370;201409;2126;5955;1759;5368;221;684;1387;4228;1608;4912
420380;201409;5678;18989;4712;16691;1514;5751;1329;4715;2843;10466
420390;201409;2173;6507;1330;4693;396;1505;337;1137;733;2642
420395;201409;2113;6617;1588;5415;382;1455;331;1002;713;2457
420400;201409;1542;4605;1136;3806;346;1350;327;991;673;2341
420410;201409;865;2408;613;1984;161;590;315;994;476;1584
420415;201409;528;1698;415;1412;130;472;139;463;269;935
420417;201409;824;2670;697;2359;141;511;348;1168;489;1679
420419;201409;471;1499;324;1204;142;570;81;303;223;873
420420;201409;11581;34960;8757;29101;2661;9889;2860;9093;5521;18982
420425;201409;1286;3563;797;2539;94;371;346;1008;440;1379
420430;201409;4276;13464;2953;10309;897;3401;857;2954;1754;6355
420435;201409;289;927;209;734;55;224;96;323;151;547
420440;201409;1509;4425;921;3163;364;1342;170;542;534;1884
420445;201409;442;1282;347;1111;84;271;175;574;259;845
420450;201409;1323;3910;792;2794;195;774;161;485;356;1259
420455;201409;2344;7278;2082;6804;552;2054;937;2988;1489;5042
420460;201409;10329;32539;8329;28685;2431;9409;3102;10234;5533;19643
420470;201409;1257;3525;840;2716;252;915;240;728;492;1643
420475;201409;185;602;122;445;41;154;32;119;73;273
420480;201409;6214;18581;5129;16677;2053;7413;931;2971;2984;10384
420490;201409;923;2787;631;2237;208;777;154;533;362;1310
420500;201409;2153;6643;1755;5886;546;1981;850;2836;1396;4817
420510;201409;200;838;185;799;77;342;53;210;130;552
420515;201409;166;596;133;519;41;172;26;102;67;274
420517;201409;971;3009;891;2855;159;534;582;1882;741;2416
420519;201409;475;1328;347;1072;66;215;131;404;197;619
420520;201409;830;2334;655;2083;185;653;312;953;497;1606
420530;201409;1426;4946;1145;4236;365;1478;291;950;656;2428
420535;201409;283;843;177;616;60;233;30;86;90;319
420540;201409;23172;68075;16160;52748;4926;17528;4694;14284;9620;31812
420543;201409;502;1363;361;1123;47;174;215;700;262;874
420545;201409;1727;5584;1420;4892;389;1495;476;1540;865;3035
420550;201409;5083;16466;4064;14119;1150;4519;1129;3750;2279;8269
420555;201409;465;1515;391;1353;136;510;121;405;257;915
420560;201409;599;1763;500;1553;92;318;257;786;349;1104
420570;201409;2105;6948;1703;5947;506;1994;549;1798;1055;3792
420580;201409;1304;4276;1081;3866;318;1265;487;1730;805;2995
420590;201409;3578;11278;2546;8867;706;2678;509;1619;1215;4297
420600;201409;999;3463;902;3233;241;918;379;1396;620;2314
420610;201409;656;2130;448;1645;148;589;79;260;227;849
420620;201409;1224;3821;1086;3567;398;1377;304;994;702;2371
420630;201409;1250;3958;906;3120;250;919;287;887;537;1806
420640;201409;707;2208;334;1264;85;369;24;69;109;438
420650;201409;2161;6574;1227;4337;256;1026;224;664;480;1690
420660;201409;695;2060;557;1799;128;470;266;838;394;1308
420665;201409;859;2496;553;1852;119;445;181;539;300;984
420670;201409;1832;5810;1369;4770;342;1363;273;848;615;2211
420675;201409;259;816;183;636;45;178;72;236;117;414
420680;201409;527;1293;317;964;64;219;110;311;174;530
420690;201409;862;2990;629;2335;133;544;194;655;327;1199
420700;201409;3818;11092;2935;9297;726;2666;979;2959;1705;5625
420710;201409;832;2968;693;2681;268;1121;198;731;466;1852
420720;201409;1989;6144;1719;5773;466;1638;998;3361;1464;4999
420730;201409;4857;15134;4201;13896;1441;5112;1629;5295;3070;10407
420740;201409;834;2736;797;2684;181;626;543;1844;724;2470
420750;201409;2635;8582;1858;6667;444;1819;561;1756;1005;3575
420757;201409;144;431;97;362;33;135;28;98;61;233
420760;201409;462;1487;339;1153;75;272;98;313;173;585
420765;201409;708;2335;433;1628;123;507;97;345;220;852
420768;201409;1321;4613;1084;4061;362;1421;400;1507;762;2928
420770;201409;948;2944;592;2132;191;747;148;508;339;1255
420775;201409;726;2313;465;1593;146;501;99;322;245;823
420780;201409;1715;5287;1153;3896;313;1145;299;933;612;2078
420785;201409;324;988;225;734;43;156;74;217;117;373
420790;201409;1408;5049;1150;4337;340;1425;464;1644;804;3069
420800;201409;973;2852;568;1915;175;654;128;397;303;1051
420810;201409;2705;9398;2175;8142;788;3273;570;2065;1358;5338
420820;201409;8903;29590;7012;26097;2362;9751;2308;8634;4670;18385
420830;201409;2905;9795;2505;9018;939;3653;878;3073;1817;6726
420840;201409;994;2969;580;2109;164;668;167;558;331;1226
420845;201409;1399;4679;1124;4128;416;1722;246;812;662;2534
420850;201409;2141;7041;1422;5458;493;2038;301;1150;794;3188
420860;201409;686;2003;464;1591;164;636;189;632;353;1268
420870;201409;1445;4173;1140;3718;431;1549;364;1117;795;2666
420880;201409;1501;5048;1226;4313;354;1305;232;761;586;2066
420890;201409;13525;32729;6191;19588;1266;4610;2134;5957;3400;10567
420895;201409;240;656;116;375;35;122;27;79;62;201
420900;201409;2466;7098;1600;5357;445;1599;414;1321;859;2920
420910;201409;24063;73392;15754;55525;3750;15131;4371;14321;8121;29452
420915;201409;722;2815;622;2536;194;801;272;1140;466;1941
420917;201409;467;1459;249;806;60;228;87;233;147;461
420920;201409;212;623;112;390;49;181;18;65;67;246
420930;201409;21579;64704;17840;58224;5422;19351;6574;21240;11996;40591
420940;201409;4558;13959;3896;12499;1112;3961;1156;3356;2268;7317
420945;201409;244;761;160;553;51;196;42;137;93;333
420950;201409;671;1949;318;1192;76;330;59;198;135;528
420960;201409;1495;4674;1290;4305;416;1569;493;1526;909;3095
420970;201409;2767;8729;2439;8188;628;2270;1297;4456;1925;6726
420980;201409;482;1553;396;1396;122;429;191;734;313;1163
420985;201409;619;1842;360;1275;109;421;105;352;214;773
420990;201409;949;2825;650;2291;177;692;185;609;362;1301
421000;201409;695;2496;497;1978;158;683;69;221;227;904
421003;201409;715;2046;304;1056;66;253;58;161;124;414
421005;201409;268;864;222;781;72;273;106;364;178;637
421010;201409;7180;21830;5355;18233;1739;6456;1594;5129;3333;11585
421020;201409;510;1632;383;1380;69;253;203;770;272;1023
421030;201409;1038;3826;962;3635;345;1378;327;1249;672;2627
421040;201409;963;2890;779;2557;245;873;302;925;547;1798
421050;201409;2090;5565;1177;3915;325;1242;297;849;622;2091
421055;201409;292;935;189;681;59;232;50;149;109;381
421060;201409;585;2147;481;1852;121;503;141;524;262;1027
421070;201409;819;2578;541;1903;147;593;138;466;285;1059
421080;201409;704;2284;632;2129;189;673;299;999;488;1672
421085;201409;588;1595;325;1122;81;305;87;320;168;625
421090;201409;497;1401;340;1053;84;275;139;413;223;688
421100;201409;1101;3361;766;2618;220;797;175;522;395;1319
421105;201409;1556;4941;1331;4524;333;1238;544;1891;877;3129
421110;201409;1681;5538;1463;5161;547;2083;466;1539;1013;3622
421120;201409;1735;5594;1260;4447;296;1208;386;1220;682;2428
421125;201409;464;1394;347;1174;108;408;126;405;234;813
421130;201409;3507;11579;2909;10434;1055;4196;974;3474;2029;7670
421140;201409;443;1388;353;1193;94;358;134;424;228;782
421145;201409;612;2016;450;1568;79;309;197;660;276;969
421150;201409;595;1942;462;1689;127;499;187;683;314;1182
421160;201409;1126;3438;676;2350;160;629;225;717;385;1346
421165;201409;343;1215;277;1009;69;259;122;447;191;706
421170;201409;2052;6398;1631;5460;441;1557;842;2780;1283;4337
421175;201409;1474;4404;1160;3871;351;1378;423;1264;774;2642
421180;201409;623;1788;350;1186;95;363;125;385;220;748
421185;201409;493;1403;360;1138;75;229;178;581;253;810
421187;201409;335;1062;268;923;82;296;110;366;192;662
421189;201409;540;1648;486;1543;124;405;190;601;314;1006
421190;201409;11751;36510;8174;28727;2418;9084;2296;7940;4714;17024
421200;201409;1113;3699;958;3362;265;1019;349;1182;614;2201
421205;201409;247;776;185;639;44;181;47;135;91;316
421210;201409;2191;6814;1815;5879;619;2111;563;1763;1182;3874
421220;201409;2557;8725;2246;8047;796;3109;634;2239;1430;5348
421223;201409;792;2247;498;1720;143;526;221;748;364;1274
421225;201409;1262;3919;1047;3466;285;1002;437;1445;722;2447
421227;201409;975;3216;868;3049;221;771;512;1862;733;2633
421230;201409;760;2548;683;2365;199;732;248;834;447;1566
421240;201409;575;1902;364;1285;87;323;71;220;158;543
421250;201409;2059;6312;1406;5123;513;2038;370;1307;883;3345
421260;201409;396;1199;159;615;47;183;31;114;78;297
421265;201409;409;1421;371;1320;93;347;131;468;224;815
421270;201409;764;2063;460;1536;156;569;115;419;271;988
421280;201409;1754;5565;1431;5053;487;1912;461;1634;948;3546
421290;201409;2103;5956;1331;4408;427;1534;318;939;745;2473
421300;201409;338;1049;281;926;103;387;111;338;214;725
421310;201409;541;1840;458;1619;157;562;119;403;276;965
421315;201409;393;1177;230;830;49;183;39;145;88;328
421320;201409;604;2062;412;1541;81;339;76;233;157;572
421330;201409;651;2276;565;2096;236;979;79;277;315;1256
421335;201409;585;1930;466;1690;126;501;103;377;229;878
421340;201409;2082;6481;1776;5956;413;1572;982;3262;1395;4834
421350;201409;1145;3884;952;3454;313;1266;287;990;600;2256
421360;201409;3376;10071;2216;7773;531;2116;719;2352;1250;4468
421370;201409;1132;3968;968;3596;333;1367;289;1021;622;2388
421380;201409;1114;3234;894;2803;180;621;435;1370;615;1991
421390;201409;202;660;154;532;28;97;43;162;71;259
421400;201409;429;1616;348;1422;139;604;92;351;231;955
421410;201409;397;1191;300;1003;63;217;150;506;213;723
421415;201409;443;1381;212;784;68;269;56;193;124;462
421420;201409;1432;4475;1076;3603;251;899;234;717;485;1616
421430;201409;308;1006;242;875;79;323;47;159;126;482
421440;201409;880;2653;606;2121;172;646;224;748;396;1394
421450;201409;631;2102;451;1680;152;621;89;309;241;930
421460;201409;735;2306;483;1789;132;537;121;425;253;962
421470;201409;559;2035;472;1838;140;559;186;730;326;1289
421480;201409;2879;8768;1846;6672;548;2230;479;1570;1027;3800
421490;201409;343;1141;191;738;74;312;50;191;124;503
421500;201409;2810;9949;2451;9183;1001;4178;556;2032;1557;6210
421505;201409;426;1466;384;1358;118;439;155;541;273;980
421507;201409;722;2330;512;1836;115;433;197;709;312;1142
421510;201409;313;1174;286;1119;95;431;121;408;216;839
421520;201409;836;2260;546;1658;61;237;282;780;343;1017
421530;201409;536;1796;340;1337;89;396;116;442;205;838
421535;201409;705;2127;405;1470;82;321;203;704;285;1025
421540;201409;430;1259;367;1140;91;312;150;438;241;750
421545;201409;1301;4471;1047;3936;339;1428;232;826;571;2254
421550;201409;2329;7848;2063;7325;729;2884;630;2162;1359;5046
421555;201409;335;1016;135;476;24;95;28;90;52;185
421560;201409;234;712;101;361;25;100;22;75;47;175
421565;201409;1121;3548;1024;3379;435;1540;362;1154;797;2694
421567;201409;977;3629;843;3276;406;1624;179;690;585;2314
421568;201409;504;1635;386;1369;110;405;119;416;229;821
421569;201409;216;703;133;501;27;109;36;130;63;239
421570;201409;1303;4288;840;3109;288;1169;201;709;489;1878
421575;201409;638;2136;568;1993;117;437;326;1148;443;1585
421580;201409;4373;14589;3486;12544;1274;5129;882;2884;2156;8013
421590;201409;265;846;215;739;46;165;105;343;151;508
421600;201409;598;1799;438;1450;133;482;107;331;240;813
421605;201409;726;2251;513;1811;129;520;143;474;272;994
421610;201409;1877;4898;1471;4309;197;634;962;2812;1159;3446
421620;201409;5400;16669;3848;13338;1283;4799;1275;4432;2558;9231
421625;201409;443;1389;257;923;68;273;88;302;156;575
421630;201409;2886;8730;1775;6176;526;1992;352;1178;878;3170
421635;201409;370;1228;261;966;68;274;98;331;166;605
421640;201409;1164;3718;1001;3430;217;754;600;2101;817;2855
421650;201409;2427;8180;2094;7406;838;3262;352;1146;1190;4408
421660;201409;9989;33456;8095;29589;2673;10803;2571;8854;5244;19657
421670;201409;1296;4225;950;3418;302;1186;277;988;579;2174
421680;201409;1531;5022;1342;4562;526;1888;271;891;797;2779
421690;201409;2108;6950;1642;5811;470;1811;275;903;745;2714
421700;201409;754;2327;459;1643;143;579;142;435;285;1014
421710;201409;377;1345;279;1058;111;432;74;271;185;703
421715;201409;319;906;195;648;55;192;59;189;114;381
421720;201409;1712;5248;1174;4124;446;1763;353;1119;799;2882
421725;201409;137;481;132;470;54;215;42;145;96;360
421730;201409;663;2053;342;1242;86;341;78;228;164;569
421740;201409;708;2184;488;1640;123;500;115;285;238;785
421750;201409;1523;4594;1173;3853;328;1180;469;1413;797;2593
421755;201409;472;1495;337;1154;104;392;96;295;200;687
421760;201409;584;1950;339;1248;87;357;128;449;215;806
421770;201409;3921;11952;3160;10390;1231;4211;912;3089;2143;7300
421775;201409;600;1769;392;1382;91;334;123;423;214;757
421780;201409;1840;6360;1446;5450;554;2256;424;1504;978;3760
421790;201409;1074;3021;654;2307;213;854;162;513;375;1367
421795;201409;418;1286;282;937;51;189;88;291;139;480
421800;201409;2957;9509;2288;8158;643;2589;837;2708;1480;5297
421810;201409;699;2248;507;1798;157;590;91;311;248;901
421820;201409;1327;4072;939;3285;217;893;264;827;481;1720
421825;201409;1465;4889;1358;4628;235;940;846;2764;1081;3704
421830;201409;3264;11143;3048;10709;781;2907;1554;5598;2335;8505
421835;201409;202;625;156;547;50;208;75;239;125;447
421840;201409;535;1901;469;1738;165;669;173;612;338;1281
421850;201409;618;1817;442;1475;146;515;139;470;285;985
421860;201409;401;1285;258;961;58;238;59;208;117;446
421870;201409;5518;16302;3923;12974;1231;4386;782;2491;2013;6877
421875;201409;457;1378;218;805;57;241;51;163;108;404
421880;201409;1143;3744;916;3209;281;1122;243;781;524;1903
421885;201409;373;1301;330;1203;88;325;135;491;223;816
421890;201409;1120;3834;968;3503;333;1336;305;1068;638;2404
421895;201409;445;1508;410;1438;112;393;227;824;339;1217
421900;201409;909;2956;755;2581;220;798;265;833;485;1631
421910;201409;568;1806;406;1423;107;419;117;361;224;780
421915;201409;646;1975;492;1620;120;424;165;508;285;932
421917;201409;636;1982;502;1748;163;671;189;601;352;1272
421920;201409;886;2621;629;2264;284;1068;211;752;495;1820
421930;201409;4248;11981;2879;9446;927;3400;503;1546;1430;4946
421935;201409;916;3175;723;2733;202;849;265;968;467;1817
421940;201409;368;1327;262;1020;82;355;61;214;143;569
421950;201409;4654;13300;2577;8852;792;2889;574;1990;1366;4879
421960;201409;267;858;214;736;59;220;60;194;119;414
421970;201409;2323;6992;1666;5525;608;2208;331;960;939;3168
421985;201409;535;1443;292;948;58;210;92;305;150;515
422000;201409;686;2016;537;1737;107;379;282;940;389;1319
430003;201409;912;2569;726;2251;214;729;229;688;443;1417
430005;201409;327;1097;276;985;58;221;152;528;210;749
430010;201409;2338;6629;1775;5559;550;1780;682;2165;1232;3945
430020;201409;1134;3041;986;2819;225;744;572;1559;797;2303
430030;201409;1625;4397;1336;3874;458;1414;415;1142;873;2556
430040;201409;13079;34412;10908;30799;3396;9931;4006;11326;7402;21257
430045;201409;774;2160;619;1839;120;402;345;998;465;1400
430047;201409;281;705;170;514;36;103;77;232;113;335
430050;201409;1149;3159;755;2399;159;583;289;862;448;1445
430055;201409;310;888;199;628;37;130;101;315;138;445
430057;201409;86;227;42;136;8;30;13;30;21;60
430060;201409;16517;53911;14543;50333;4286;15479;7121;25192;11407;40671
430063;201409;1116;3325;905;2864;247;791;431;1417;678;2208
430064;201409;1741;5188;1453;4697;425;1394;645;2154;1070;3548
430066;201409;180;456;133;381;27;88;74;198;101;286
430070;201409;707;2093;409;1413;111;417;121;381;232;798
430080;201409;668;2170;527;1842;144;558;158;514;302;1072
430085;201409;746;2115;533;1732;160;596;210;643;370;1239
430087;201409;1012;3094;964;3004;108;377;753;2323;861;2700
430090;201409;858;2288;304;1008;45;174;68;224;113;398
430100;201409;1159;3611;862;2969;297;1131;214;616;511;1747
430105;201409;867;2753;665;2342;203;796;174;578;377;1374
430107;201409;275;932;217;758;47;181;83;272;130;453
430110;201409;2352;6861;2116;6469;694;2242;939;2861;1633;5103
430120;201409;1880;5744;1485;4897;339;1186;810;2611;1149;3797
430130;201409;4670;12027;4186;11328;817;2370;2497;6779;3314;9149
430140;201409;1286;4110;982;3387;309;1104;329;1102;638;2206
430150;201409;976;2640;647;2018;166;555;190;584;356;1139
430155;201409;562;1701;401;1358;89;289;191;663;280;952
430160;201409;19089;56236;17679;53902;3900;12841;9991;31227;13891;44068
430163;201409;2008;6049;1724;5515;387;1383;858;2776;1245;4159
430165;201409;400;1225;248;923;99;392;63;222;162;614
430170;201409;809;2374;381;1332;79;295;76;228;155;523
430175;201409;972;3084;769;2600;185;589;363;1307;548;1896
430180;201409;1162;3178;990;2888;246;796;484;1389;730;2185
430185;201409;782;1962;404;1228;65;220;136;374;201;594
430187;201409;750;2299;606;1991;183;687;199;606;382;1293
430190;201409;2410;7176;2111;6598;532;1892;1030;3202;1562;5094
430192;201409;207;637;106;333;16;49;31;94;47;143
430195;201409;297;908;78;282;10;36;13;39;23;75
430200;201409;1878;5986;1555;5312;467;1684;388;1332;855;3016
430205;201409;526;1538;403;1302;59;210;248;789;307;999
430210;201409;6814;19354;3800;12775;1026;3727;779;2404;1805;6131
430215;201409;382;1107;278;884;63;220;121;367;184;587
430220;201409;726;1903;345;1141;67;246;67;211;134;457
430222;201409;328;999;254;837;56;221;113;348;169;569
430223;201409;360;1078;315;1006;63;205;208;673;271;878
430225;201409;61;176;37;117;7;18;9;23;16;41
430230;201409;2181;6928;2054;6794;355;1031;1604;5524;1959;6555
430235;201409;288;952;228;799;73;276;57;185;130;461
430237;201409;503;1368;382;1148;48;185;251;719;299;904
430240;201409;1239;3556;908;2961;303;1107;305;922;608;2029
430245;201409;985;3144;763;2646;210;753;343;1213;553;1966
430250;201409;1653;4568;1481;4266;631;1875;433;1279;1064;3154
430258;201409;218;623;150;482;25;83;66;219;91;302
430260;201409;865;2447;580;1849;80;287;322;1032;402;1319
430265;201409;346;1075;278;921;87;280;45;135;132;415
430270;201409;3685;10442;3296;9770;778;2605;1759;5128;2537;7733
430280;201409;5596;15771;4719;14143;1339;4255;2097;6269;3436;10524
430290;201409;2569;7060;2438;6914;301;838;2023;5851;2324;6689
430300;201409;10684;32382;8970;29044;3110;10573;3691;12204;6801;22777
430310;201409;9214;28837;7999;26450;2570;9098;3375;10869;5945;19967
430320;201409;878;2592;600;2019;97;287;312;1102;409;1389
430330;201409;1034;2821;867;2504;268;818;345;921;613;1739
430340;201409;788;1989;441;1466;103;386;214;700;317;1086
430350;201409;6491;20624;5510;18442;2007;7097;1949;6396;3956;13493
430355;201409;341;882;161;507;34;124;36;104;70;228
430360;201409;1179;3161;999;2812;193;608;551;1505;744;2113
430367;201409;365;1001;239;772;43;150;70;215;113;365
430370;201409;650;1915;511;1632;185;632;134;390;319;1022
430380;201409;892;2303;498;1582;132;448;181;591;313;1039
430390;201409;4700;13714;3417;11021;900;3148;990;3031;1890;6179
430400;201409;1400;3373;962;2712;290;928;431;1104;721;2032
430410;201409;731;1974;563;1696;105;349;289;871;394;1220
430420;201409;4797;13993;3868;11852;1151;3610;1586;4874;2737;8484
430430;201409;858;2363;546;1761;175;619;152;464;327;1083
430435;201409;2155;5850;1731;5067;405;1243;920;2719;1325;3962
430440;201409;5084;15820;4111;13792;884;3118;1939;6811;2823;9929
430450;201409;9242;26598;7397;22780;2864;9286;2087;6376;4951;15662
430460;201409;28956;87839;23367;77490;7361;26185;8481;28104;15842;54289
430461;201409;493;1370;170;552;35;123;44;137;79;260
430462;201409;373;1091;296;955;124;438;83;250;207;688
430463;201409;4183;13625;3681;12616;913;3414;1853;6356;2766;9770
430465;201409;679;1840;577;1666;127;419;374;1048;501;1467
430466;201409;4608;13419;4313;12903;1164;3777;2282;6789;3446;10566
430467;201409;617;1879;541;1752;133;474;271;855;404;1329
430468;201409;1527;4425;1330;4114;516;1719;417;1275;933;2994
430469;201409;224;630;65;245;9;40;17;63;26;103
430470;201409;7861;21125;5675;17340;1907;6241;1470;4421;3377;10662
430471;201409;928;3071;826;2850;301;1082;218;752;519;1834
430480;201409;968;2630;525;1700;89;311;133;381;222;692
430485;201409;261;797;142;507;28;97;55;199;83;296
430490;201409;553;1639;394;1335;117;405;140;494;257;899
430495;201409;446;1322;296;990;62;225;81;254;143;479
430500;201409;1677;4721;1416;4265;446;1465;621;1848;1067;3313
430510;201409;26269;80563;20548;67555;7094;25529;6026;18883;13120;44412
430511;201409;498;1516;245;828;48;174;46;129;94;303
430512;201409;1378;3609;1211;3329;353;986;472;1356;825;2342
430513;201409;747;2068;497;1533;78;256;236;725;314;981
430515;201409;627;1844;492;1552;103;314;213;706;316;1020
430517;201409;1495;4901;1297;4466;267;972;794;2726;1061;3698
430520;201409;1860;5434;1446;4534;460;1545;558;1693;1018;3238
430530;201409;986;2771;523;1686;95;358;152;438;247;796
430535;201409;2622;8350;2157;7336;601;2286;737;2432;1338;4718
430537;201409;644;1863;448;1527;50;170;342;1185;392;1355
430540;201409;796;1915;591;1637;137;423;340;917;477;1340
430543;201409;592;1447;534;1389;119;341;369;954;488;1295
430544;201409;798;2599;665;2288;140;531;344;1148;484;1679
430545;201409;1482;4795;1290;4549;423;1485;684;2575;1107;4060
430550;201409;738;2179;502;1676;104;374;200;670;304;1044
430558;201409;121;364;79;269;35;134;12;31;47;165
430560;201409;405;1026;242;718;35;127;91;256;126;383
430570;201409;1271;3317;880;2591;225;767;431;1157;656;1924
430580;201409;1213;3349;764;2479;253;854;203;680;456;1534
430583;201409;154;419;48;159;6;22;4;11;10;33
430585;201409;372;995;243;717;79;257;102;268;181;525
430587;201409;303;932;257;836;97;328;79;255;176;583
430590;201409;1555;4402;1473;4272;303;962;930;2684;1233;3646
430593;201409;37;142;32;126;10;49;11;35;21;84
430595;201409;265;754;106;382;35;145;16;47;51;192
430597;201409;417;1278;317;1035;63;223;130;407;193;630
430600;201409;2288;6283;1373;4240;297;978;471;1420;768;2398
430605;201409;1422;4414;1126;3776;283;1035;470;1606;753;2641
430607;201409;789;2083;626;1812;100;313;393;1147;493;1460
430610;201409;8688;23509;6762;20351;1754;5791;2813;8466;4567;14257
430613;201409;267;661;118;363;28;81;29;79;57;160
430620;201409;1018;3103;830;2670;247;880;330;993;577;1873
430630;201409;514;1542;299;993;92;317;57;170;149;487
430632;201409;767;2139;460;1448;93;342;233;674;326;1016
430635;201409;709;1972;502;1562;120;397;241;743;361;1140
430637;201409;562;1604;501;1479;87;297;322;912;409;1209
430640;201409;2055;5786;1063;3505;251;878;213;589;464;1467
430642;201409;512;1360;316;1000;68;233;130;400;198;633
430645;201409;198;583;110;379;27;99;27;90;54;189
430650;201409;2196;7197;1905;6577;429;1501;1051;3756;1480;5257
430655;201409;317;955;277;868;73;248;103;272;176;520
430660;201409;6362;18665;5060;16252;1518;5367;2101;6671;3619;12038
430670;201409;506;1488;459;1394;43;127;345;1081;388;1208
430673;201409;821;1992;450;1361;122;385;188;562;310;947
430675;201409;259;760;128;432;31;117;50;163;81;280
430676;201409;4819;14541;4314;13672;1338;4510;1741;5725;3079;10235
430680;201409;1277;3797;935;3036;204;753;360;1059;564;1812
430690;201409;4692;13614;3836;11905;1231;3960;1399;4442;2630;8402
430692;201409;309;1058;224;882;31;120;137;552;168;672
430693;201409;1852;5187;1350;4080;311;1027;396;1140;707;2167
430695;201409;500;1455;402;1268;78;296;205;611;283;907
430697;201409;496;1409;377;1200;120;372;146;503;266;875
430700;201409;9614;25150;4402;14556;928;3434;492;1491;1420;4925
430705;201409;422;1327;390;1271;128;447;166;546;294;993
430710;201409;1914;4944;1498;4235;305;933;743;2184;1048;3117
430720;201409;945;2347;620;1861;175;568;243;740;418;1308
430730;201409;1979;5327;1506;4558;366;1068;806;2586;1172;3654
430740;201409;632;1806;390;1284;125;437;73;221;198;658
430745;201409;551;1580;330;1042;68;232;103;337;171;569
430750;201409;1935;5481;1607;4911;382;1289;829;2437;1211;3726
430755;201409;678;1900;478;1459;102;369;216;591;318;960
430760;201409;3828;9805;2981;8678;738;2298;1537;4615;2275;6913
430770;201409;7300;21812;6079;19603;1402;4936;3144;10032;4546;14968
430780;201409;2729;7745;1834;5919;517;1811;677;2092;1194;3903
430781;201409;674;1987;483;1584;142;482;152;486;294;968
430783;201409;624;1573;449;1285;99;315;206;550;305;865
430786;201409;132;430;103;354;33;117;24;85;57;202
430790;201409;4395;12170;2898;9058;608;2212;1269;3675;1877;5887
430800;201409;860;2596;615;2006;148;509;216;670;364;1179
430805;201409;510;1451;372;1196;52;160;221;749;273;909
430807;201409;332;987;240;781;57;223;78;224;135;447
430810;201409;773;2158;382;1281;73;276;75;222;148;498
430820;201409;1165;3709;853;2907;246;899;258;810;504;1709
430825;201409;472;1324;242;763;48;162;78;215;126;377
430830;201409;2732;8002;2531;7689;368;1109;1645;5307;2013;6416
430840;201409;1044;3235;942;3019;246;809;446;1477;692;2286
430843;201409;122;365;78;252;16;49;35;110;51;159
430845;201409;385;1171;313;1022;122;426;41;130;163;556
430850;201409;3497;10635;3093;9889;840;2838;1400;4482;2240;7320
430860;201409;923;2527;552;1890;177;701;155;479;332;1180
430865;201409;758;2064;688;1944;222;656;332;926;554;1582
430870;201409;715;2039;430;1444;132;457;110;344;242;801
430880;201409;1465;4218;1160;3622;450;1454;332;1080;782;2534
430885;201409;223;669;168;577;52;192;60;198;112;390
430890;201409;1804;4782;1295;3814;76;260;741;2115;817;2375
430900;201409;3461;9173;3088;8582;728;2184;1705;4646;2433;6830
430905;201409;1202;3544;807;2662;249;891;209;662;458;1553
430910;201409;1981;6224;1574;5413;572;2111;580;1930;1152;4041
430912;201409;622;1734;478;1495;72;262;274;835;346;1097
430915;201409;463;1540;325;1251;104;425;93;376;197;801
430920;201409;19159;60351;17497;57183;5166;17739;9948;32347;15114;50086
430925;201409;94;263;71;219;23;79;34;100;57;179
430930;201409;10428;31949;8021;27085;2429;8683;2949;10344;5378;19027
430940;201409;1367;4263;960;3295;245;937;278;891;523;1828
430950;201409;1672;4693;1263;3836;395;1268;395;1150;790;2418
430955;201409;163;508;90;307;31;112;23;72;54;184
430957;201409;331;1116;268;979;70;263;120;448;190;711
430960;201409;1869;5343;1629;4921;603;1941;568;1742;1171;3683
430965;201409;1468;4350;1263;3985;108;397;1010;3169;1118;3566
430970;201409;565;1592;331;1076;80;286;99;313;179;599
430975;201409;664;2153;511;1777;85;321;279;966;364;1287
430980;201409;615;1466;349;1065;96;334;139;381;235;715
430990;201409;704;2276;533;1848;181;640;143;491;324;1131
430995;201409;754;2253;667;2078;231;753;255;786;486;1539
431000;201409;1827;4921;1000;3188;242;881;141;379;383;1260
431010;201409;2987;8771;2007;6753;527;1951;634;1988;1161;3939
431020;201409;15066;37556;10421;29104;2865;8222;3421;9847;6286;18069
431030;201409;405;1212;225;792;57;213;53;179;110;392
431033;201409;2900;8421;2637;8014;654;2051;1456;4635;2110;6686
431036;201409;245;673;111;373;21;73;30;91;51;164
431040;201409;1052;3064;883;2770;241;838;458;1402;699;2240
431041;201409;613;1690;547;1595;167;502;237;727;404;1229
431043;201409;432;1420;323;1162;153;603;103;333;256;936
431046;201409;132;398;98;324;26;96;33;106;59;202
431050;201409;1951;4940;1528;4213;361;1066;832;2265;1193;3331
431053;201409;655;2167;550;1936;178;677;178;646;356;1323
431055;201409;710;1979;658;1886;74;210;479;1392;553;1602
431057;201409;392;1156;229;801;55;198;93;327;148;525
431060;201409;6478;19118;6065;18572;1673;4978;3528;11294;5201;16272
431065;201409;520;1498;451;1366;47;155;299;901;346;1056
431070;201409;791;2301;470;1569;102;354;121;371;223;725
431075;201409;298;907;198;686;38;143;62;222;100;365
431080;201409;747;2442;614;2152;171;642;133;445;304;1087
431085;201409;984;2606;792;2281;140;430;481;1376;621;1806
431087;201409;645;1865;564;1703;80;234;366;1109;446;1343
431090;201409;591;1492;305;946;104;338;66;189;170;527
431100;201409;4867;13396;4067;12004;1194;3713;1673;5062;2867;8775
431110;201409;1694;4528;1272;3677;301;944;642;1793;943;2737
431112;201409;672;2110;637;2045;205;664;306;979;511;1643
431113;201409;693;2030;515;1630;152;497;146;466;298;963
431115;201409;1611;4740;1431;4424;293;953;855;2638;1148;3591
431120;201409;2951;9300;2476;8358;772;2849;1021;3348;1793;6197
431123;201409;587;1765;451;1496;119;429;228;765;347;1194
431125;201409;1454;4462;1102;3705;346;1151;384;1391;730;2542
431127;201409;152;410;60;194;7;20;6;17;13;37
431130;201409;4127;11891;3282;10389;889;3057;1376;4355;2265;7412
431140;201409;4165;10625;2279;7342;449;1687;580;1617;1029;3304
431142;201409;578;1741;518;1627;71;224;335;1074;406;1298
431150;201409;1380;4182;1114;3660;310;1067;413;1366;723;2433
431160;201409;1034;3064;867;2711;172;540;427;1439;599;1979
431162;201409;470;1268;227;772;31;132;36;100;67;232
431164;201409;160;449;44;166;17;68;1;4;18;72
431170;201409;1000;2909;771;2456;272;898;222;707;494;1605
431171;201409;928;2770;797;2500;289;950;211;637;500;1587
431173;201409;530;1563;474;1460;109;347;280;871;389;1218
431175;201409;1348;3751;1160;3466;387;1216;471;1404;858;2620
431177;201409;1103;3541;919;3159;320;1214;389;1308;709;2522
431179;201409;318;680;85;247;17;62;27;63;44;125
431180;201409;2277;6618;1652;5254;393;1346;435;1314;828;2660
431190;201409;820;2257;464;1530;116;421;132;421;248;842
431198;201409;399;1298;349;1194;163;594;76;253;239;847
431200;201409;342;966;107;354;24;86;10;29;34;115
431205;201409;375;1190;236;819;55;189;90;306;145;495
431210;201409;825;2300;711;2078;192;562;378;1115;570;1677
431213;201409;315;980;260;872;81;303;93;301;174;604
431215;201409;345;1024;174;593;35;117;17;45;52;162
431217;201409;250;752;194;621;63;219;50;170;113;389
431220;201409;1202;3126;844;2426;130;428;433;1183;563;1611
431225;201409;1428;4229;1234;3890;296;977;676;2158;972;3135
431230;201409;997;2941;775;2472;130;446;420;1321;550;1767
431235;201409;76;183;36;110;9;30;12;35;21;65
431237;201409;463;1508;407;1427;117;467;190;646;307;1113
431238;201409;55;175;45;150;10;36;15;49;25;85
431240;201409;2873;8732;2450;7995;882;3107;738;2348;1620;5455
431242;201409;438;1414;415;1369;174;623;63;197;237;820
431244;201409;509;1243;346;969;73;242;161;416;234;658
431245;201409;1213;3306;982;2890;182;564;610;1813;792;2377
431247;201409;242;757;193;658;79;296;69;217;148;513
431250;201409;1978;6183;1747;5848;547;1979;752;2567;1299;4546
431260;201409;424;1236;289;960;81;308;72;218;153;526
431261;201409;229;799;195;718;40;163;67;239;107;402
431262;201409;400;1101;163;549;28;117;66;220;94;337
431265;201409;1451;3877;824;2527;203;716;232;597;435;1313
431267;201409;207;620;173;555;48;174;79;235;127;409
431270;201409;2765;7410;2117;6394;593;1880;952;2963;1545;4843
431275;201409;251;803;152;548;45;161;30;94;75;255
431280;201409;277;783;115;392;23;92;24;63;47;155
431290;201409;378;1237;296;1021;86;343;74;245;160;588
431295;201409;231;738;138;470;24;90;38;112;62;202
431300;201409;308;855;91;348;26;102;5;21;31;123
431301;201409;255;827;174;614;45;159;41;126;86;285
431303;201409;803;2147;529;1575;128;447;183;504;311;951
431306;201409;2236;6234;1695;5235;324;1193;595;1661;919;2854
431308;201409;57;196;53;185;35;120;14;52;49;172
431310;201409;815;2492;518;1801;108;394;180;631;288;1025
431320;201409;992;2905;612;2118;175;676;158;516;333;1192
431330;201409;2522;6424;1235;3936;374;1298;195;594;569;1892
431333;201409;464;1238;215;651;43;142;70;178;113;320
431335;201409;98;289;83;253;20;57;31;92;51;149
431337;201409;2711;8351;2077;6936;564;1962;530;1716;1094;3678
431339;201409;729;2022;511;1546;112;350;240;723;352;1073
431340;201409;28905;77499;20974;63641;5328;17736;7201;21278;12529;39014
431342;201409;655;1711;552;1536;161;482;293;782;454;1264
431344;201409;410;1124;304;936;32;102;193;607;225;709
431346;201409;346;913;195;575;59;173;54;161;113;334
431349;201409;685;1993;468;1465;104;337;158;486;262;823
431350;201409;4197;12555;3646;11578;726;2652;2042;6270;2768;8922
431360;201409;844;2273;630;1915;166;529;250;775;416;1304
431365;201409;1495;4524;1293;4180;477;1654;513;1677;990;3331
431370;201409;5756;16549;4764;14804;1425;4733;1816;5694;3241;10427
431380;201409;1118;3418;1050;3268;183;610;722;2212;905;2822
431390;201409;3837;10830;2593;8388;802;2943;771;2286;1573;5229
431395;201409;1702;5051;1489;4695;444;1490;606;1913;1050;3403
431400;201409;242;782;148;542;48;187;18;48;66;235
431402;201409;1353;3311;818;2344;174;525;395;1096;569;1621
431403;201409;331;991;248;840;82;304;60;206;142;510
431405;201409;4889;13985;3916;12510;949;3516;1863;5712;2812;9228
431406;201409;831;2615;652;2182;209;716;281;928;490;1644
431407;201409;699;2085;472;1585;142;488;115;359;257;847
431410;201409;17466;53782;13711;46184;5021;18024;3377;11821;8398;29845
431413;201409;215;531;106;329;12;42;45;132;57;174
431415;201409;968;2779;784;2425;199;668;354;1041;553;1709
431417;201409;716;1818;575;1605;99;285;318;914;417;1199
431420;201409;1654;4590;1455;4263;344;1044;799;2429;1143;3473
431430;201409;616;1688;450;1394;114;389;163;472;277;861
431440;201409;34071;99227;30044;92572;9830;31146;13374;43183;23204;74329
431442;201409;217;688;171;571;60;223;26;64;86;287
431445;201409;547;1502;353;1077;68;219;144;424;212;643
431446;201409;521;1528;382;1233;94;315;167;541;261;856
431447;201409;859;2452;610;1889;137;459;262;825;399;1284
431449;201409;960;2719;778;2397;125;428;432;1354;557;1782
431450;201409;2376;6212;2164;5885;476;1358;1415;3821;1891;5179
431455;201409;726;1850;414;1174;128;366;118;316;246;682
431460;201409;3774;10622;3247;9597;991;3004;1205;3676;2196;6680
431470;201409;1931;5714;1538;4840;423;1318;666;2192;1089;3510
431475;201409;192;572;55;217;9;38;4;15;13;53
431477;201409;751;2049;519;1581;87;292;293;862;380;1154
431478;201409;256;673;102;306;20;58;39;113;59;171
431480;201409;3002;8600;2344;7382;700;2445;900;2711;1600;5156
431490;201409;119278;334719;104501;312315;17801;60267;69791;204949;87592;265216
431500;201409;1222;3193;966;2706;267;735;385;1103;652;1838
431505;201409;446;1173;385;1081;46;122;300;859;346;981
431507;201409;468;1146;370;965;70;179;230;606;300;785
431510;201409;2277;6240;1885;5534;396;1292;943;2637;1339;3929
431513;201409;281;766;124;397;26;89;59;189;85;278
431514;201409;111;294;42;145;5;20;4;16;9;36
431515;201409;795;2371;563;1778;120;424;234;658;354;1082
431517;201409;98;317;90;299;39;138;26;73;65;211
431520;201409;502;1510;319;1044;61;220;90;285;151;505
431530;201409;4799;11610;3687;10316;1111;3128;1794;5323;2905;8451
431531;201409;312;887;217;695;57;191;85;272;142;463
431532;201409;589;1667;519;1521;159;504;217;624;376;1128
431535;201409;455;1291;280;878;68;231;77;222;145;453
431540;201409;2282;7348;2035;6987;291;919;1346;4961;1637;5880
431545;201409;241;681;64;226;7;27;13;57;20;84
431550;201409;2578;7686;2349;7269;540;1889;1183;3603;1723;5492
431555;201409;832;2163;710;1973;161;439;395;1108;556;1547
431560;201409;25898;79691;21263;70173;8202;27495;6736;23306;14938;50801
431570;201409;5843;16564;5220;15585;1563;4771;2791;8439;4354;13210
431575;201409;495;1327;350;1070;71;251;107;300;178;551
431580;201409;838;2559;605;2022;175;660;195;586;370;1246
431590;201409;1035;2893;707;2208;102;331;330;1028;432;1359
431595;201409;650;1825;524;1542;134;411;198;584;332;995
431600;201409;2419;7113;1768;5756;478;1785;370;1038;848;2823
431610;201409;1791;5060;1311;4166;302;1013;646;2059;948;3072
431620;201409;464;1415;263;863;77;271;111;331;188;602
431630;201409;1550;4152;1104;3242;300;903;509;1514;809;2417
431640;201409;6489;19173;5860;18155;1430;4884;3342;10211;4772;15095
431642;201409;575;1650;479;1461;79;279;261;761;340;1040
431643;201409;231;616;198;556;29;92;118;311;147;403
431645;201409;1886;5619;1699;5279;386;1263;960;3012;1346;4275
431647;201409;187;536;132;402;41;130;34;87;75;217
431650;201409;271;845;186;663;37;145;42;130;79;275
431660;201409;1607;4736;1163;3808;363;1243;416;1305;779;2548
431670;201409;1470;4067;1166;3509;319;1061;514;1483;833;2544
431673;201409;252;736;157;527;43;161;44;142;87;303
431675;201409;619;1723;233;790;60;213;59;172;119;385
431680;201409;11031;30658;8395;25937;2528;8361;2862;8916;5390;17277
431690;201409;27693;78991;22428;70578;6877;23129;9287;29758;16164;52887
431695;201409;161;546;117;431;30;111;29;78;59;189
431697;201409;534;1501;471;1383;136;404;210;641;346;1045
431700;201409;1724;4861;1463;4351;282;913;787;2291;1069;3204
431710;201409;13535;39327;11148;35189;3516;11680;4094;13328;7610;25008
431720;201409;7609;21465;6183;18710;1433;4844;3047;9036;4480;13880
431725;201409;35;123;33;119;13;48;12;43;25;91
431730;201409;4047;12343;3279;10876;970;3537;1067;3598;2037;7135
431740;201409;6273;18252;5402;16612;1975;6541;1481;4344;3456;10885
431750;201409;10966;31235;9390;28643;2048;6756;4931;15330;6979;22086
431755;201409;312;846;73;269;15;64;15;53;30;117
431760;201409;4316;12995;3567;11538;1003;3540;1169;3617;2172;7157
431770;201409;2447;6672;2058;6045;497;1530;1116;3250;1613;4780
431775;201409;250;691;182;562;74;242;44;119;118;361
431780;201409;2459;6593;1852;5447;532;1663;538;1513;1070;3176
431790;201409;1329;4170;1161;3849;284;996;614;2039;898;3035
431795;201409;502;1469;372;1163;75;249;172;550;247;799
431800;201409;10057;29715;8334;26431;2832;9675;2357;7311;5189;16986
431805;201409;318;767;88;299;13;52;16;52;29;104
431810;201409;3758;10403;3039;8926;657;2059;1429;4149;2086;6208
431820;201409;2989;9431;2609;8660;738;2641;999;3228;1737;5869
431830;201409;12321;31443;9920;27753;3153;9463;3915;11133;7068;20596
431840;201409;3722;11075;3262;10207;977;3160;1491;4761;2468;7921
431842;201409;786;2005;402;1213;82;274;128;360;210;634
431843;201409;386;1125;340;1046;68;227;190;573;258;800
431844;201409;189;545;134;443;37;141;44;135;81;276
431845;201409;561;1692;505;1575;57;182;339;1073;396;1255
431846;201409;549;1619;471;1479;93;337;278;870;371;1207
431848;201409;202;552;109;366;23;91;23;72;46;163
431849;201409;425;1052;111;334;27;89;31;78;58;167
431850;201409;5248;15376;4604;14107;1146;3772;2116;6394;3262;10166
431860;201409;1010;2814;779;2399;160;573;418;1214;578;1787
431861;201409;100;303;61;212;14;46;8;23;22;69
431862;201409;514;1736;417;1516;145;566;104;364;249;930
431870;201409;27413;77607;22719;69127;6283;20876;9604;28441;15887;49317
431880;201409;5149;16097;4228;13986;1223;4423;1718;5522;2941;9945
431890;201409;6447;17885;5252;15751;1909;5998;1728;5310;3637;11308
431900;201409;1078;3155;788;2598;236;875;301;891;537;1766
431910;201409;1029;2450;492;1425;105;342;188;491;293;833
431912;201409;643;1855;500;1570;169;515;167;554;336;1069
431915;201409;1473;3999;1101;3323;283;928;439;1321;722;2249
431920;201409;1575;4399;1432;4196;194;516;1105;3341;1299;3857
431930;201409;1382;3791;1057;3265;169;486;631;2087;800;2573
431935;201409;125;445;110;414;47;201;31;95;78;296
431936;201409;505;1444;427;1277;75;218;250;814;325;1032
431937;201409;358;960;211;648;57;191;43;117;100;308
431940;201409;2919;7978;1926;6013;526;1753;551;1689;1077;3442
431950;201409;2020;6422;1807;6030;505;1837;753;2406;1258;4243
431960;201409;3857;11410;3515;10743;1078;3456;1279;3943;2357;7399
431970;201409;525;1442;274;889;42;162;85;256;127;418
431971;201409;142;407;117;370;30;101;49;147;79;248
431973;201409;513;1768;453;1643;69;252;271;1032;340;1284
431975;201409;25;86;16;65;4;21;4;16;8;37
431980;201409;1637;4735;1411;4270;371;1239;539;1528;910;2767
431990;201409;9118;25290;7038;21852;1583;5637;2839;8346;4422;13983
432000;201409;11824;34424;9578;30451;3087;10289;3993;12697;7080;22986
432010;201409;2704;7926;2287;7131;556;1941;1067;3220;1623;5161
432020;201409;2502;6236;2025;5616;300;909;1375;3790;1675;4699
432023;201409;575;1667;400;1276;108;391;144;423;252;814
432026;201409;1394;4174;1042;3432;215;734;543;1789;758;2523
432030;201409;453;1334;364;1145;93;303;164;496;257;799
432032;201409;588;1547;393;1177;65;226;216;615;281;841
432035;201409;909;2871;810;2680;181;622;481;1586;662;2208
432040;201409;1045;2637;573;1862;150;543;141;368;291;911
432045;201409;257;796;175;632;48;182;67;252;115;434
432050;201409;828;2392;730;2203;143;458;422;1298;565;1756
432055;201409;873;2694;737;2403;161;587;435;1365;596;1952
432057;201409;485;1261;378;1061;51;161;238;626;289;787
432060;201409;487;1374;207;717;56;215;53;162;109;377
432065;201409;251;730;194;624;49;173;90;268;139;441
432067;201409;1099;3537;813;2870;221;816;388;1358;609;2174
432070;201409;2698;7292;1926;5751;584;1966;615;1728;1199;3694
432080;201409;4484;13062;3896;11987;1228;3968;1599;4861;2827;8829
432085;201409;309;955;248;841;71;280;115;374;186;654
432090;201409;1880;5774;1570;5102;592;2068;496;1450;1088;3518
432100;201409;1315;3882;728;2509;197;711;129;369;326;1080
432110;201409;3238;9742;2564;8294;851;3022;478;1458;1329;4480
432120;201409;5667;17100;4885;15646;1814;6209;1640;5237;3454;11446
432130;201409;2484;7076;2037;6482;657;2294;951;3025;1608;5319
432132;201409;474;1427;262;923;45;168;97;309;142;477
432135;201409;813;2462;771;2390;122;403;541;1669;663;2072
432140;201409;3013;8870;2449;7825;697;2292;968;3388;1665;5680
432143;201409;1481;4448;1272;4096;304;1007;713;2363;1017;3370
432145;201409;1218;3857;828;2920;263;1015;167;534;430;1549
432146;201409;289;908;210;713;73;259;51;167;124;426
432147;201409;845;2669;678;2301;200;692;272;943;472;1635
432149;201409;382;1136;244;802;69;244;93;293;162;537
432150;201409;4189;12079;3182;10169;1014;3536;1017;3114;2031;6650
432160;201409;4957;16026;4420;15098;1504;5393;1797;6402;3301;11795
432162;201409;365;912;97;319;25;88;25;71;50;159
432163;201409;406;1073;108;344;16;50;23;77;39;127
432166;201409;838;2511;685;2187;142;523;333;993;475;1516
432170;201409;944;3120;642;2437;150;609;137;493;287;1102
432180;201409;3025;8043;2119;6478;637;2087;641;1914;1278;4001
432183;201409;472;1522;396;1361;175;620;96;328;271;948
432185;201409;1015;2791;642;2070;139;504;273;861;412;1365
432190;201409;3803;10505;2756;8174;778;2414;865;2405;1643;4819
432195;201409;1394;3904;1211;3630;207;667;772;2302;979;2969
432200;201409;3509;10680;2827;9470;755;2720;1360;4674;2115;7394
432210;201409;501;1437;397;1265;109;409;187;547;296;956
432215;201409;936;2918;820;2722;148;466;510;1795;658;2261
432218;201409;334;922;253;764;48;156;115;318;163;474
432220;201409;4203;11217;3483;10053;452;1540;2284;6463;2736;8003
432225;201409;67;222;57;202;27;101;14;47;41;148
432230;201409;1249;3496;867;2658;257;875;329;892;586;1767
432232;201409;608;1797;478;1539;117;424;227;716;344;1140
432234;201409;565;1563;412;1201;104;310;175;487;279;797
432235;201409;79;243;48;169;15;66;8;27;23;93
432237;201409;520;1445;470;1364;35;138;368;1035;403;1173
432240;201409;16387;53910;14288;51053;3121;12322;8568;31304;11689;43626
432250;201409;5862;20330;5443;19497;2285;8822;1581;5716;3866;14538
432252;201409;513;1496;421;1323;132;444;186;591;318;1035
432253;201409;1385;4455;998;3496;319;1151;306;1080;625;2231
432254;201409;731;1998;218;707;50;176;36;104;86;280
432255;201409;224;572;127;418;36;126;40;127;76;253
432260;201409;7782;19841;5438;15887;1338;4101;2373;7055;3711;11156
432270;201409;2924;8934;2523;8231;774;2576;1107;3695;1881;6271
432280;201409;1373;3985;773;2604;175;643;184;558;359;1201
432285;201409;187;588;70;238;24;88;12;32;36;120
432290;201409;624;1885;414;1395;101;367;156;506;257;873
432300;201409;25569;77919;23116;73660;5755;19512;12705;40467;18460;59979
432310;201409;886;2702;746;2455;157;593;411;1312;568;1905
432320;201409;301;826;177;566;50;159;57;187;107;346
432330;201409;303;809;113;383;16;54;13;37;29;91
432335;201409;217;629;93;327;26;99;12;36;38;135
432340;201409;339;877;166;514;39;128;55;164;94;292
432345;201409;789;2240;731;2147;160;548;406;1122;566;1670
432350;201409;509;1415;317;1039;83;291;84;255;167;546
432360;201409;152;457;40;144;14;56;13;42;27;98
432370;201409;507;1436;398;1216;44;130;247;779;291;909
432375;201409;920;2351;726;2030;125;362;432;1228;557;1590
432377;201409;127;405;44;146;8;34;15;39;23;73
432380;201409;947;3293;855;3113;331;1353;342;1176;673;2529
500020;201409;2141;6553;1579;5444;428;1705;550;1747;978;3452
500025;201409;1102;2752;712;2067;125;384;375;1060;500;1444
500060;201409;6627;19451;5342;17368;779;2545;3560;12042;4339;14587
500070;201409;4284;12639;3634;11510;889;3187;1687;5260;2576;8447
500080;201409;1816;5378;1366;4561;450;1640;455;1563;905;3203
500085;201409;2204;5916;1649;5054;214;733;1015;3005;1229;3738
500090;201409;2510;7265;1908;6167;427;1438;947;3147;1374;4585
500100;201409;2658;8022;2448;7679;779;2779;1140;3414;1919;6193
500110;201409;8434;24837;6937;22556;1140;4000;4055;13878;5195;17878
500124;201409;1989;6381;1696;5888;312;1048;1009;3802;1321;4850
500150;201409;1590;4086;1206;3451;295;966;558;1466;853;2432
500190;201409;5257;13783;4120;12362;910;2941;2347;7306;3257;10247
500200;201409;2787;7124;2036;5958;376;1258;1182;3366;1558;4624
500210;201409;5114;15107;4380;13972;1021;3461;2260;7348;3281;10809
500215;201409;1647;5094;1356;4526;270;1016;577;1836;847;2852
500220;201409;2915;9203;2383;8212;578;2139;920;3251;1498;5390
500230;201409;2799;7324;2162;6360;667;2108;884;2636;1551;4744
500240;201409;5162;15952;3799;13184;761;2847;1549;5711;2310;8558
500260;201409;2697;7234;2117;6286;410;1335;1037;2911;1447;4246
500270;201409;117130;305137;77712;237199;21945;72692;20689;62945;42634;135637
500280;201409;1459;4144;1242;3845;180;588;863;2734;1043;3322
500290;201409;4298;10748;2743;8207;795;2739;894;2433;1689;5172
500295;201409;2695;8235;1853;6159;459;1716;500;1451;959;3167
500310;201409;881;2350;754;2159;180;559;362;1001;542;1560
500315;201409;3286;10278;2809;9566;552;1846;1791;6423;2343;8269
500320;201409;14974;49389;12935;45639;4171;15507;4980;18670;9151;34177
500325;201409;4381;11584;3318;9877;877;2858;1590;4623;2467;7481
500330;201409;6361;17466;4925;14763;1201;3885;2417;7174;3618;11059
500345;201409;2638;7509;2165;6723;520;1817;1124;3372;1644;5189
500348;201409;2623;7553;2338;7080;257;885;1732;5221;1989;6106
500350;201409;1265;3867;812;2839;140;530;250;894;390;1424
500370;201409;24551;76386;19179;65903;5026;19169;6681;23074;11707;42243
500375;201409;2916;7939;2116;6445;534;1772;885;2741;1419;4513
500380;201409;3089;8888;2597;7982;915;2935;856;2611;1771;5546
500390;201409;629;1358;411;1051;49;157;292;704;341;861
500400;201409;1434;4467;1105;3666;299;1104;339;1032;638;2136
500410;201409;2261;6348;1808;5668;465;1620;859;2662;1324;4282
500430;201409;2880;8334;2294;7491;557;1974;1033;3492;1590;5466
500440;201409;1506;4246;1179;3707;272;953;604;1855;876;2808
500450;201409;2242;6959;1760;5979;471;1789;371;1130;842;2919
500460;201409;3911;11634;3048;10193;928;3432;866;2875;1794;6307
500470;201409;2992;8912;2118;6981;606;2160;360;1084;966;3244
500480;201409;2046;6567;1896;6344;195;644;1516;5223;1711;5867
500490;201409;1124;3183;927;2834;292;991;323;994;615;1985
500500;201409;3718;11532;2970;10371;1130;4427;958;3308;2088;7735
500510;201409;952;2519;615;1932;131;479;258;722;389;1201
500515;201409;2023;5350;1605;4790;281;798;989;3214;1270;4012
500520;201409;2954;10135;2642;9700;534;2083;1669;6322;2203;8405
500525;201409;1259;3990;1033;3540;228;832;527;1898;755;2730
500540;201409;5877;16709;3585;12171;1129;4385;689;2140;1818;6525
500560;201409;4978;16312;4463;15548;876;3232;2999;10584;3875;13816
500568;201409;4093;10463;3027;8898;710;2219;1540;4537;2250;6756
500570;201409;8213;22592;5725;18063;1772;6003;1924;6023;3696;12026
500580;201409;3623;10551;2896;9277;414;1435;1936;6214;2350;7649
500600;201409;3451;9607;2523;7936;647;2211;1029;3229;1676;5440
500620;201409;8262;23188;6041;19306;1312;4686;2998;9598;4310;14284
500625;201409;746;2252;465;1628;103;393;158;530;261;923
500627;201409;460;1331;347;1109;75;247;104;353;179;600
500630;201409;6401;17906;5082;15924;1684;5778;1681;5229;3365;11007
500635;201409;2597;9979;2164;9262;344;1361;1347;6352;1691;7713
500640;201409;1681;4123;1324;3617;133;410;970;2617;1103;3027
500660;201409;18058;52473;14468;46351;4027;14484;5965;18907;9992;33391
500690;201409;3019;8557;2483;7884;883;2863;977;3362;1860;6225
500710;201409;3979;11929;3433;11002;852;2973;1726;5526;2578;8499
500720;201409;6104;16612;4007;12801;1212;4232;1161;3601;2373;7833
500730;201409;1032;2960;787;2468;183;626;319;970;502;1596
500740;201409;3845;10840;2813;8961;592;2145;1317;4019;1909;6164
500750;201409;878;2572;803;2474;179;577;501;1589;680;2166
500755;201409;1296;3824;958;3153;240;886;342;1024;582;1910
500769;201409;4994;13534;3205;9848;704;2394;918;2485;1622;4879
500770;201409;1835;5398;1388;4531;420;1493;469;1539;889;3032
500780;201409;1128;3501;970;3191;294;1065;411;1285;705;2350
500790;201409;9133;25755;7635;23088;1479;5224;4214;12183;5693;17407
500793;201409;2393;6942;1912;6141;360;1285;939;2903;1299;4188
500795;201409;2545;7493;2212;7010;302;827;1632;5509;1934;6336
500797;201409;1022;2743;741;2266;152;492;335;1027;487;1519
500800;201409;2759;7764;2188;6951;826;2954;750;2413;1576;5367
500830;201409;17498;50620;12795;41129;3708;12870;4014;12462;7722;25332
500840;201409;1480;4238;1086;3459;209;713;503;1575;712;2288
510010;201409;1386;4238;1211;3943;388;1301;552;1841;940;3142
510020;201409;3212;9337;2175;7242;602;2136;647;2064;1249;4200
510025;201409;9509;28482;8168;26149;2376;8402;3553;11047;5929;19449
510030;201409;2183;5949;1819;5385;553;1717;802;2344;1355;4061
510035;201409;919;2726;766;2487;149;495;450;1520;599;2015
510040;201409;1802;5042;1423;4480;314;1113;736;2315;1050;3428
510050;201409;1891;5580;1393;4637;375;1360;528;1721;903;3081
510060;201409;1382;4026;1029;3359;262;924;369;1170;631;2094
510080;201409;1151;3595;933;3195;300;1155;264;823;564;1978
510100;201409;682;1839;467;1405;80;260;196;548;276;808
510120;201409;304;635;175;468;19;55;115;308;134;363
510125;201409;3231;8564;2546;7375;506;1781;1223;3356;1729;5137
510130;201409;2169;6005;1842;5476;534;1659;786;2382;1320;4041
510140;201409;3029;9805;2466;8905;1002;3976;630;2110;1632;6086
510160;201409;1360;4577;1267;4457;123;496;1017;3571;1140;4067
510170;201409;6171;18987;5196;17204;1182;4323;2558;8222;3740;12545
510180;201409;12013;32466;8761;27158;2668;8691;3154;10673;5822;19364
510185;201409;1472;4365;1236;4048;217;682;823;2934;1040;3616
510190;201409;2035;6392;1459;5435;394;1617;586;2260;980;3877
510250;201409;14562;45364;12556;42490;3720;13446;6108;21166;9828;34612
510260;201409;2579;9998;2320;9419;740;3193;966;4156;1706;7349
510263;201409;4593;12671;3409;10688;973;3306;1151;3483;2124;6789
510267;201409;5509;15963;3976;12660;959;3312;1326;4073;2285;7385
510268;201409;910;2666;778;2480;203;691;409;1308;612;1999
510269;201409;959;2947;769;2599;229;808;332;1158;561;1966
510270;201409;2609;8198;2334;7708;422;1479;1329;4498;1751;5977
510279;201409;2119;6727;1898;6315;636;2333;694;2140;1330;4473
510285;201409;1439;4297;1146;3756;306;1107;434;1335;740;2442
510300;201409;3369;10177;2919;9537;345;1238;2223;7317;2568;8555
510305;201409;1667;5286;1355;4673;412;1522;398;1367;810;2889
510310;201409;1110;3223;879;2840;306;1073;299;938;605;2011
510320;201409;3758;11060;2878;9320;874;3263;606;1751;1480;5014
510325;201409;5501;17636;4777;16608;852;3013;3427;12233;4279;15246
510330;201409;2867;9383;2446;8587;648;2514;967;3420;1615;5934
510335;201409;4676;14628;4032;13767;717;2399;2782;9975;3499;12374
510336;201409;622;1903;499;1652;123;439;237;772;360;1211
510337;201409;2308;7622;1970;6961;803;2854;571;2212;1374;5066
510340;201409;66751;194390;52696;172503;20716;73863;12142;41585;32858;115448
510343;201409;1174;3489;1047;3318;132;415;825;2676;957;3091
510345;201409;1711;5111;1428;4597;371;1302;524;1582;895;2884
510350;201409;3610;10323;2920;9375;785;2698;1441;4734;2226;7432
510360;201409;1981;5130;1400;4402;250;871;932;2864;1182;3735
510370;201409;1012;3594;909;3429;226;878;531;2055;757;2933
510380;201409;517;1628;380;1352;152;598;67;219;219;817
510385;201409;1009;3736;782;3177;155;658;366;1590;521;2248
510390;201409;1214;3713;1120;3605;299;830;682;2421;981;3251
510395;201409;914;2252;673;1938;124;374;375;1154;499;1528
510410;201409;4376;14314;4053;13681;1101;3963;2140;7307;3241;11270
510420;201409;2403;6299;1802;5271;266;931;981;2833;1247;3764
510450;201409;595;1642;445;1424;117;424;185;566;302;990
510452;201409;654;2145;470;1701;120;474;182;633;302;1107
510454;201409;896;2853;782;2674;156;546;490;1745;646;2291
510455;201409;1005;3085;755;2578;193;763;255;835;448;1598
510460;201409;2213;6190;1857;5683;305;1090;1218;3628;1523;4718
510480;201409;4466;12100;3286;9854;900;2858;925;2638;1825;5496
510490;201409;1502;4934;1346;4700;294;1189;813;2761;1107;3950
510500;201409;1465;4456;1071;3699;285;1144;467;1549;752;2693
510510;201409;3166;11207;2808;10592;1044;4216;1098;4125;2142;8341
510515;201409;5951;18533;4665;15667;1155;4322;1298;4144;2453;8466
510517;201409;1891;5613;1641;5229;508;1621;842;2815;1350;4436
510520;201409;2297;5783;1731;5000;133;451;1226;3583;1359;4034
510523;201409;1109;3347;949;3074;188;643;576;1887;764;2530
510525;201409;8151;21199;5444;16911;1348;4499;2073;6397;3421;10896
510530;201409;577;1639;500;1523;89;328;284;845;373;1173
510550;201409;2825;9258;2392;8484;713;2621;1012;3671;1725;6292
510558;201409;2231;6340;1773;5667;480;1646;845;2707;1325;4353
510560;201409;1739;5621;1235;4715;405;1665;334;1298;739;2963
510562;201409;5408;16288;4639;14773;1560;5442;1570;5037;3130;10479
510590;201409;3198;8599;2569;7783;691;2156;1293;4052;1984;6208
510600;201409;1505;3914;997;3072;192;649;436;1232;628;1881
510610;201409;2929;8561;2559;8052;242;872;2023;6367;2265;7239
510615;201409;2120;6739;1858;6309;567;2077;884;3004;1451;5081
510617;201409;660;1965;553;1776;72;230;412;1374;484;1604
510618;201409;1425;4145;1022;3351;247;952;463;1469;710;2421
510619;201409;794;2194;509;1659;98;358;137;432;235;790
510620;201409;1418;3624;823;2701;254;967;195;589;449;1556
510621;201409;1045;3676;927;3424;279;1123;318;1110;597;2233
510622;201409;3816;11732;2617;9030;759;2843;427;1254;1186;4097
510623;201409;3878;11194;3189;10014;976;3255;1348;4205;2324;7460
510624;201409;1362;4148;1017;3492;250;961;373;1180;623;2141
510625;201409;2346;6952;1893;6136;584;2078;492;1519;1076;3597
510626;201409;1390;4213;1076;3737;337;1292;517;1812;854;3104
510627;201409;740;2202;560;1860;170;622;180;604;350;1226
510628;201409;1658;4194;1228;3612;139;450;890;2608;1029;3058
510629;201409;1801;5853;1491;5164;467;1784;496;1642;963;3426
510630;201409;2592;8763;2104;7819;654;2728;535;2001;1189;4729
510631;201409;407;1181;366;1116;67;204;249;764;316;968
510637;201409;2879;8551;2545;7979;708;2401;1304;4020;2012;6421
510642;201409;4951;16144;4230;15158;1270;4858;2068;7715;3338;12573
510645;201409;935;2184;636;1785;204;592;228;679;432;1271
510650;201409;6174;20932;5698;20344;1229;4557;3700;13812;4929;18369
510665;201409;1338;3665;913;2879;277;929;288;872;565;1801
510670;201409;398;919;218;657;44;160;89;252;133;412
510675;201409;6932;22166;5654;19631;1880;7283;1461;4837;3341;12120
510677;201409;2589;6583;1921;5711;293;881;1362;4220;1655;5101
510680;201409;846;2622;696;2342;165;611;272;858;437;1469
510682;201409;2470;7679;1956;6728;546;2067;608;2030;1154;4097
510685;201409;1001;2686;850;2485;102;339;616;1785;718;2124
510700;201409;4174;11380;3061;9669;676;2286;1730;5560;2406;7846
510704;201409;9084;25137;7459;22411;1802;6050;3858;11308;5660;17358
510706;201409;1971;6053;1481;5260;408;1492;732;2662;1140;4154
510710;201409;3674;10384;2760;8536;809;2695;839;2327;1648;5022
510715;201409;695;1787;455;1383;118;388;185;524;303;912
510718;201409;1874;5417;1558;5035;605;2004;651;2190;1256;4194
510719;201409;466;1068;285;828;39;153;127;334;166;487
510720;201409;1313;3069;982;2680;95;255;775;2161;870;2416
510724;201409;858;2625;724;2370;171;629;379;1186;550;1815
510726;201409;684;1861;558;1649;153;463;209;590;362;1053
510729;201409;801;2107;565;1724;145;482;254;779;399;1261
510730;201409;2457;7662;2145;7079;559;2075;1028;3241;1587;5316
510735;201409;1119;3796;914;3456;253;1017;456;1737;709;2754
510740;201409;1154;2852;863;2438;223;624;468;1370;691;1994
510757;201409;717;2456;632;2289;177;665;316;1145;493;1810
510760;201409;30245;84164;23159;71907;7837;26073;7761;24064;15598;50137
510770;201409;4615;12319;4145;11773;642;1763;2705;8630;3347;10393
510774;201409;453;1243;381;1125;88;304;183;549;271;853
510775;201409;855;2423;680;2151;248;851;246;767;494;1618
510776;201409;464;1321;387;1188;104;360;184;542;288;902
510777;201409;1620;4811;1211;4255;215;858;848;2972;1063;3830
510779;201409;688;2026;506;1693;102;365;209;723;311;1088
510780;201409;4084;12038;3465;11118;836;2782;1814;6074;2650;8856
510785;201409;1996;5897;1601;5225;532;1828;589;1948;1121;3776
510787;201409;2348;7138;1987;6534;697;2463;726;2297;1423;4760
510788;201409;434;1236;353;1107;154;464;115;390;269;854
510790;201409;16168;47351;10928;37231;3179;12316;1477;4883;4656;17199
510792;201409;6577;20583;4712;16795;1155;4743;1094;3594;2249;8337
510794;201409;1402;4322;1108;3848;481;1800;275;865;756;2665
510795;201409;10040;31710;7706;27024;2511;9524;2074;7356;4585;16880
510800;201409;1887;5372;1585;4970;466;1622;777;2316;1243;3938
510805;201409;2064;5765;1677;5211;191;621;1266;3975;1457;4596
510810;201409;719;1757;561;1542;159;465;280;742;439;1207
510820;201409;865;2120;625;1762;148;494;261;670;409;1164
510830;201409;602;2039;527;1913;159;614;268;1038;427;1652
510835;201409;722;2195;534;1830;173;640;178;559;351;1199
510840;201409;53578;134486;42944;120946;10511;31028;22898;66768;33409;97796
510850;201409;1726;5064;1350;4449;529;1967;262;712;791;2679
510860;201409;2610;8637;2049;7410;726;2871;320;1075;1046;3946
510880;201409;843;2833;736;2637;246;932;310;1137;556;2069
510885;201409;586;1665;456;1475;83;313;214;680;297;993
510890;201409;937;3083;801;2836;279;1124;247;777;526;1901
510895;201409;1191;3770;1031;3459;303;1169;424;1331;727;2500
520005;201409;1336;4323;1231;4155;391;1376;587;2020;978;3396
520010;201409;1939;6693;1712;6222;717;2900;383;1259;1100;4159
520013;201409;4068;11346;3074;9555;788;2584;1317;4129;2105;6713
520015;201409;578;1597;464;1428;119;386;193;615;312;1001
520017;201409;1127;3487;973;3228;261;957;427;1367;688;2324
520020;201409;430;1165;335;1012;88;273;158;496;246;769
520025;201409;25083;80234;24283;79290;2849;9746;20002;65679;22851;75425
520030;201409;4863;15583;4257;14599;1241;4552;1902;6626;3143;11178
520050;201409;365;1065;325;991;60;205;215;639;275;844
520055;201409;848;2525;709;2267;146;468;378;1256;524;1724
520060;201409;1688;5247;1478;4834;364;1310;607;2019;971;3329
520080;201409;1710;5224;1484;4891;368;1196;812;2814;1180;4010
520082;201409;695;2236;648;2156;141;448;403;1376;544;1824
520085;201409;1046;3281;919;3003;237;816;326;1059;563;1875
520090;201409;1044;2471;790;2136;174;419;429;1247;603;1666
520110;201409;43083;128213;33793;114162;13422;50157;8767;29872;22189;80029
520120;201409;266;698;157;503;40;145;37;125;77;270
520130;201409;3897;11399;3597;10952;752;2436;2250;6866;3002;9302
520140;201409;45024;148758;39951;138819;14694;55175;10857;37425;25551;92600
520145;201409;553;1431;407;1219;99;320;161;476;260;796
520150;201409;666;1785;550;1648;153;496;289;854;442;1350
520160;201409;919;2683;777;2469;256;852;303;973;559;1825
520170;201409;4353;10405;3495;9472;518;1472;2607;7233;3125;8705
520180;201409;1944;5824;1625;5294;415;1550;684;2156;1099;3706
520215;201409;1927;4998;1632;4565;261;755;1033;2938;1294;3693
520235;201409;858;2307;668;2030;195;649;295;867;490;1516
520250;201409;1286;4074;1092;3753;332;1219;518;1811;850;3030
520260;201409;795;2072;561;1637;92;301;267;752;359;1053
520280;201409;586;1718;539;1650;268;870;142;480;410;1350
520310;201409;1122;2792;868;2439;208;559;449;1393;657;1952
520320;201409;1750;5555;1427;4916;184;682;905;3189;1089;3871
520330;201409;2921;9129;2251;7938;730;2827;476;1579;1206;4406
520340;201409;1980;5014;1557;4509;209;527;1185;3600;1394;4127
520350;201409;3310;9777;2803;8797;897;3063;1298;3947;2195;7010
520355;201409;1215;4147;1135;4019;414;1565;482;1684;896;3249
520357;201409;909;2495;764;2277;82;268;535;1584;617;1852
520360;201409;648;1837;576;1712;130;392;289;886;419;1278
520380;201409;1288;3535;900;2794;185;631;423;1312;608;1943
520390;201409;1257;3331;876;2797;293;1084;328;951;621;2035
520393;201409;591;1549;520;1440;87;253;345;957;432;1210
520396;201409;762;2439;663;2239;93;353;456;1558;549;1911
520400;201409;1822;5122;1561;4774;282;946;998;3045;1280;3991
520410;201409;1661;4372;1292;3880;349;1134;675;2018;1024;3152
520420;201409;350;980;250;781;56;188;77;212;133;400
520425;201409;1497;4166;1365;3940;422;1299;677;1916;1099;3215
520430;201409;2172;5751;1482;4470;330;1111;591;1695;921;2806
520440;201409;3689;9792;2667;8071;946;3129;761;2286;1707;5415
520450;201409;10284;29372;7547;24173;2087;7343;1289;3810;3376;11153
520455;201409;723;2149;585;1919;218;776;178;584;396;1360
520460;201409;928;2663;741;2347;177;634;340;1038;517;1672
520465;201409;863;2367;751;2221;163;569;410;1160;573;1729
520470;201409;1828;5936;1663;5678;361;1228;1088;3887;1449;5115
520480;201409;1019;2968;838;2683;192;646;474;1523;666;2169
520485;201409;1309;4293;1159;4019;381;1408;588;2047;969;3455
520490;201409;4526;13958;3591;12506;1224;4558;1476;5237;2700;9795
520495;201409;1448;3849;1175;3516;98;306;998;3022;1096;3328
520500;201409;2084;5565;1849;5246;592;1763;838;2544;1430;4307
520505;201409;910;2592;790;2413;190;601;483;1507;673;2108
520510;201409;11525;32568;7870;26392;2514;9128;2103;7160;4617;16288
520520;201409;1102;3182;912;2904;322;1079;371;1200;693;2279
520530;201409;2403;7495;2055;6922;505;1661;1017;3794;1522;5455
520540;201409;3091;9390;2638;8611;847;2902;994;3277;1841;6179
520545;201409;1361;4207;1166;3821;348;1233;369;1177;717;2410
520547;201409;849;2700;708;2453;281;1043;208;677;489;1720
520549;201409;9847;29068;8199;27000;2620;9061;3917;13123;6537;22184
520551;201409;3915;11811;3733;11588;1045;3442;2196;6978;3241;10420
520552;201409;761;2480;733;2441;123;455;506;1674;629;2129
520570;201409;596;1731;453;1505;201;710;117;392;318;1102
520580;201409;2518;6871;1910;6009;709;2427;661;2063;1370;4490
520590;201409;1562;4413;1263;3914;335;1083;424;1260;759;2343
520620;201409;7266;23270;6572;22230;1402;5089;4059;13886;5461;18975
520630;201409;739;2044;603;1851;144;454;299;921;443;1375
520640;201409;2931;8446;2514;7763;811;2623;1056;3370;1867;5993
520650;201409;914;2553;737;2203;240;769;326;971;566;1740
520660;201409;413;1258;350;1158;121;422;110;360;231;782
520670;201409;838;2589;787;2508;62;161;685;2232;747;2393
520680;201409;656;1906;553;1768;176;596;242;778;418;1374
520690;201409;382;974;264;802;52;138;129;424;181;562
520710;201409;504;1296;326;953;11;36;200;579;211;615
520725;201409;1857;4805;1445;4203;338;1078;803;2322;1141;3400
520735;201409;758;2230;583;1897;187;661;191;604;378;1265
520740;201409;1763;5105;1483;4717;389;1326;721;2269;1110;3595
520750;201409;765;2006;573;1740;148;484;308;963;456;1447
520753;201409;1323;3795;1240;3669;173;468;914;2851;1087;3319
520760;201409;1197;3298;1034;3086;278;870;613;1857;891;2727
520780;201409;2122;5212;1763;4728;227;560;1326;3643;1553;4203
520790;201409;2800;7630;2380;7031;362;1039;1680;5152;2042;6191
520800;201409;18149;53091;16088;50620;3716;11392;9780;33243;13496;44635
520810;201409;981;2672;873;2539;145;416;649;1967;794;2383
520815;201409;520;1727;394;1462;189;799;31;91;220;890
520830;201409;1727;4422;1350;4027;54;124;1224;3748;1278;3872
520840;201409;1844;6085;1602;5615;530;1967;556;2004;1086;3971
520850;201409;831;2448;646;2178;194;699;284;939;478;1638
520860;201409;7340;20788;5435;18175;1584;5759;2389;8184;3973;13943
520870;201409;111724;305515;76032;242304;22683;79379;20480;63011;43163;142390
520880;201409;7095;20146;5039;16878;1512;5700;808;2587;2320;8287
520890;201409;4109;11801;3478;10738;759;2485;1813;5620;2572;8105
520910;201409;3590;10923;2737;9142;871;3154;633;2040;1504;5194
520915;201409;943;2718;712;2275;164;565;299;931;463;1496
520920;201409;3531;9357;2424;7573;651;2173;735;2384;1386;4557
520929;201409;479;1370;421;1302;128;402;221;698;349;1100
520940;201409;1043;3100;913;2904;110;394;669;2100;779;2494
520945;201409;706;1741;584;1549;184;455;277;755;461;1210
520960;201409;915;2665;743;2391;141;465;426;1399;567;1864
520970;201409;3496;10363;2874;9235;711;2501;1108;3499;1819;6000
520980;201409;1015;2779;917;2640;267;861;525;1455;792;2316
520990;201409;3734;11584;3397;10978;712;2416;1845;6524;2557;8940
520993;201409;1213;3307;974;2912;129;428;628;1868;757;2296
520995;201409;2678;7363;2402;6998;366;1085;1737;5113;2103;6198
521000;201409;8189;24624;6923;22468;1788;6423;3154;10106;4942;16529
521010;201409;4076;12580;3425;11325;965;3392;1341;4504;2306;7896
521015;201409;729;2027;612;1840;140;411;347;1081;487;1492
521020;201409;3868;11035;2737;8698;869;3002;505;1389;1374;4391
521030;201409;820;2165;697;1983;155;468;401;1147;556;1615
521040;201409;5930;17013;5328;16104;1847;5623;2632;8399;4479;14022
521056;201409;1002;3079;845;2819;296;1029;353;1231;649;2260
521060;201409;1147;3223;998;2983;278;786;428;1329;706;2115
521080;201409;1269;3128;816;2375;176;609;305;736;481;1345
521090;201409;3351;9771;2825;9057;981;3311;1111;3686;2092;6997
521100;201409;1493;3852;1339;3676;255;681;930;2649;1185;3330
521120;201409;5018;14241;4439;13354;1210;3690;2286;7076;3496;10766
521130;201409;1168;3268;921;2819;191;688;487;1467;678;2155
521140;201409;1011;3284;882;3006;307;1118;236;796;543;1914
521150;201409;13345;34892;8549;25473;3035;9753;2382;6974;5417;16727
521160;201409;788;2022;526;1490;99;311;276;741;375;1052
521170;201409;1419;3420;1166;3075;313;780;671;1804;984;2584
521180;201409;6708;22421;6068;21224;2222;8269;1873;6541;4095;14810
521190;201409;9550;28162;6877;23342;2252;8162;2055;6958;4307;15120
521200;201409;886;2335;796;2205;123;363;530;1459;653;1822
521205;201409;577;1725;463;1516;59;218;269;886;328;1104
521210;201409;929;2663;661;2128;247;904;237;671;484;1575
521220;201409;3987;11176;3289;10218;1080;3589;1365;4213;2445;7802
521225;201409;415;1035;325;923;48;144;213;629;261;773
521230;201409;1390;4389;1280;4156;455;1565;603;1910;1058;3475
521250;201409;28010;91817;25912;88588;10215;37064;9994;34942;20209;72006
521260;201409;822;2006;656;1716;114;373;382;933;496;1306
521270;201409;1880;5837;1721;5587;174;455;1325;4533;1499;4988
521280;201409;1914;5916;1609;5347;505;1808;607;1999;1112;3807
521290;201409;540;1546;396;1307;120;465;143;446;263;911
521295;201409;1174;3204;1058;3050;142;406;857;2503;999;2909
521300;201409;1884;5530;1737;5298;380;1129;1089;3450;1469;4579
521305;201409;865;2345;720;2144;145;399;455;1434;600;1833
521308;201409;5294;15615;4117;13508;937;3294;2039;6635;2976;9929
521310;201409;7906;23976;6177;20627;2033;7201;1570;5035;3603;12236
521340;201409;273;822;247;783;43;155;153;470;196;625
521350;201409;2249;5823;1847;5274;259;752;1233;3749;1492;4501
521370;201409;1036;3316;920;3095;327;1186;309;987;636;2173
521375;201409;1417;4133;1208;3758;320;1090;600;1799;920;2889
521377;201409;1099;3043;1049;2984;105;253;891;2622;996;2875
521380;201409;4740;13412;3435;10971;752;2587;694;2272;1446;4859
521385;201409;623;1730;551;1633;167;522;268;789;435;1311
521390;201409;1123;2945;829;2532;248;859;290;856;538;1715
521400;201409;2453;6623;2088;6193;336;1106;1550;4569;1886;5675
521405;201409;1431;4106;1154;3601;400;1364;485;1506;885;2870
521410;201409;808;2547;736;2424;286;926;306;1058;592;1984
521440;201409;1544;4260;1501;4210;126;323;1311;3770;1437;4093
521450;201409;5178;15747;4320;14169;1342;4693;1293;4178;2635;8871
521460;201409;7478;22813;6785;21721;1754;6068;3603;11419;5357;17487
521470;201409;763;2152;568;1775;158;557;106;315;264;872
521480;201409;520;1517;384;1269;117;394;125;410;242;804
521483;201409;3180;8461;2565;7391;771;2356;1003;2799;1774;5155
521486;201409;1780;4805;1575;4471;281;867;1114;3128;1395;3995
521487;201409;639;1645;452;1350;87;240;214;687;301;927
521490;201409;862;2467;679;2195;84;320;490;1592;574;1912
521500;201409;1416;4474;1147;3912;233;901;506;1589;739;2490
521520;201409;978;2292;830;2096;269;612;370;1042;639;1654
521523;201409;11635;43422;10850;42002;3952;16489;2159;9046;6111;25535
521525;201409;1149;2988;1003;2790;144;459;691;1861;835;2320
521530;201409;2111;6298;1435;4911;523;1889;292;947;815;2836
521540;201409;992;2710;683;2163;182;688;215;626;397;1314
521550;201409;1011;2600;892;2414;254;747;461;1194;715;1941
521560;201409;5014;15400;4037;14089;1602;6038;1284;4466;2886;10504
521565;201409;712;1852;607;1720;105;276;419;1229;524;1505
521570;201409;4851;13587;3430;10764;1082;3558;1136;3605;2218;7163
521580;201409;694;1655;488;1371;172;523;161;453;333;976
521590;201409;759;2134;619;1903;222;709;131;425;353;1134
521600;201409;633;1652;453;1348;117;375;158;422;275;797
521630;201409;1870;4914;1485;4346;541;1817;276;660;817;2477
521640;201409;2106;5733;1739;5202;583;1965;627;1893;1210;3858
521645;201409;668;2010;551;1739;100;345;282;836;382;1181
521680;201409;1499;4776;1261;4273;678;2433;215;687;893;3120
521690;201409;596;1762;534;1645;129;465;263;754;392;1219
521710;201409;2379;7436;2052;6759;463;1608;1021;3365;1484;4973
521720;201409;2224;6399;1973;6063;498;1531;1226;3835;1724;5366
521730;201409;4052;13434;3673;12691;1558;5916;1023;3265;2581;9181
521740;201409;3843;10475;3034;9441;1253;4060;1251;4090;2504;8150
521760;201409;12617;42911;11675;41359;2416;9468;7027;25097;9443;34565
521770;201409;2875;8653;2422;7760;1015;3461;700;2144;1715;5605
521800;201409;9109;26547;7647;24295;2554;8578;3245;10680;5799;19258
521805;201409;1001;2311;779;1979;215;484;427;1206;642;1690
521810;201409;839;2414;714;2219;173;590;372;1130;545;1720
521830;201409;5513;18522;5145;17955;1098;4146;3289;11482;4387;15628
521839;201409;733;2091;571;1778;132;470;211;620;343;1090
521850;201409;7153;20218;6022;18204;1476;4521;2844;8609;4320;13130
521860;201409;1898;5606;1613;5074;420;1450;608;1838;1028;3288
521870;201409;565;1980;516;1850;171;665;146;490;317;1155
521878;201409;666;2100;523;1780;152;583;208;665;360;1248
521880;201409;26717;70530;18184;56395;6065;19906;5649;17853;11714;37759
521890;201409;3824;11779;3139;10410;1196;4260;791;2589;1987;6849
521900;201409;1704;4545;1375;4102;368;1172;560;1586;928;2758
521910;201409;1258;3476;1092;3282;264;822;622;1958;886;2780
521920;201409;410;1239;364;1162;125;432;141;419;266;851
521925;201409;662;2038;584;1880;124;444;250;746;374;1190
521930;201409;4064;13117;3642;12291;1255;4513;1077;3637;2332;8150
521935;201409;684;2029;636;1937;181;574;333;986;514;1560
521940;201409;1154;3138;939;2774;315;966;353;1045;668;2011
521945;201409;712;2383;659;2314;132;424;458;1725;590;2149
521950;201409;599;1764;490;1579;127;447;226;732;353;1179
521960;201409;940;2740;792;2490;192;656;369;1130;561;1786
521970;201409;2524;7210;2283;6893;354;1073;1658;5140;2012;6213
521971;201409;1101;2955;826;2440;182;576;300;853;482;1429
521973;201409;927;3030;811;2791;245;886;265;882;510;1768
521975;201409;14525;40575;13620;39453;2430;7441;9403;27423;11833;34864
521980;201409;1935;5850;1789;5677;295;840;1363;4553;1658;5393
521990;201409;1142;3430;1000;3209;153;540;645;2072;798;2612
522000;201409;2198;6437;1920;6072;401;1329;1147;3760;1548;5089
522005;201409;406;1021;297;856;81;237;140;409;221;646
522010;201409;3105;9177;2596;8307;961;3213;627;1993;1588;5206
522015;201409;1051;3062;862;2777;232;793;417;1365;649;2158
522020;201409;5167;13924;4414;12907;958;3019;2733;7975;3691;10994
522026;201409;738;2099;547;1896;206;784;186;653;392;1437
522028;201409;545;1619;481;1515;105;343;310;967;415;1310
522040;201409;3236;8281;2446;7277;763;2373;1182;3566;1945;5939
522045;201409;14112;46083;11799;41291;3894;15019;2700;9207;6594;24226
522050;201409;1104;3177;875;2779;276;957;344;1025;620;1982
522060;201409;2780;8504;2217;7616;630;2377;1079;3646;1709;6023
522068;201409;1617;5210;1509;5090;129;342;1258;4490;1387;4832
522070;201409;855;2561;765;2420;108;411;519;1633;627;2044
522100;201409;805;2263;716;2129;269;891;326;901;595;1792
522108;201409;968;2857;847;2676;90;295;631;2041;721;2336
522119;201409;1383;4176;1146;3856;192;659;714;2492;906;3151
522130;201409;520;1467;445;1380;137;443;231;733;368;1176
522140;201409;18653;52719;16029;48568;5041;16409;6433;19058;11474;35467
522145;201409;957;2678;881;2557;423;1300;283;806;706;2106
522150;201409;1281;3333;1059;3022;382;1157;389;1148;771;2305
522155;201409;875;2523;769;2366;172;512;473;1522;645;2034
522157;201409;721;2085;620;1930;72;245;482;1508;554;1753
522160;201409;6362;17922;4499;14645;1683;6095;679;2072;2362;8167
522170;201409;3180;8869;2637;8050;808;2487;1040;3300;1848;5787
522180;201409;477;1348;355;1157;146;519;122;404;268;923
522185;201409;15685;47804;13870;45346;3130;10900;8098;26875;11228;37775
522190;201409;1013;2598;804;2264;136;385;459;1323;595;1708
522200;201409;1705;5644;1532;5278;534;1987;461;1530;995;3517
522205;201409;1337;3924;1114;3548;304;1030;521;1659;825;2689
522220;201409;1418;3878;1139;3529;284;901;562;1931;846;2832
522230;201409;1233;3675;1089;3442;163;575;737;2336;900;2911
530010;201409;259972;838399;232777;784912;72162;265261;83974;282236;156136;547497
110001;201408;4638;15147;4017;14146;1049;3809;2281;8168;3330;11977
110002;201408;14259;44858;12149;41070;3764;13750;5236;17674;9000;31424
110003;201408;993;3211;907;3058;258;903;342;1133;600;2036
110004;201408;10213;33041;8561;29564;2874;10715;2458;8455;5332;19170
110005;201408;2426;8055;2251;7714;847;2982;929;3219;1776;6201
110006;201408;3457;9274;2173;7466;741;2684;666;2165;1407;4849
110007;201408;1591;4894;1466;4721;314;1098;807;2830;1121;3928
110008;201408;2619;8911;2454;8670;459;1533;1795;6638;2254;8171
110009;201408;5528;15958;4260;14049;1167;4187;1922;6212;3089;10399
110010;201408;8678;24947;7582;23564;1600;4617;4762;16019;6362;20636
110011;201408;11107;34013;9179;30674;3298;11568;3552;11887;6850;23455
110012;201408;17305;53329;14961;48842;5005;17075;5707;18685;10712;35760
110013;201408;5579;17489;4544;15907;1484;5418;1958;7012;3442;12430
110014;201408;4581;13430;3838;12343;813;2715;2359;7723;3172;10438
110015;201408;5627;17602;4412;15432;1536;5826;1524;5330;3060;11156
110018;201408;5378;15712;4351;14367;1366;5030;2000;6375;3366;11405
110020;201408;61105;176323;49635;161259;10846;36554;28858;96214;39704;132768
110025;201408;4692;13626;3876;12176;661;2207;2673;8385;3334;10592
110026;201408;862;2473;725;2306;191;618;443;1432;634;2050
110028;201408;7993;23362;5907;19786;1832;6737;1451;4736;3283;11473
110029;201408;1738;5083;1391;4490;436;1466;638;2090;1074;3556
110030;201408;12235;34725;9821;31496;2542;8743;5119;16944;7661;25687
110032;201408;4307;13906;3819;12822;1200;4180;1480;4948;2680;9128
110033;201408;5672;18199;5271;17574;1577;5131;2754;9818;4331;14949
110034;201408;3998;10426;3333;9616;587;1618;2486;7320;3073;8938
110037;201408;2175;7327;1875;6763;479;1773;1028;3755;1507;5528
110040;201408;3670;11814;3349;11236;1005;3648;1633;5410;2638;9058
110045;201408;5516;18471;4956;17791;1492;5705;2768;9952;4260;15657
110050;201408;1891;6013;1583;5596;515;1834;854;3099;1369;4933
110060;201408;1039;3541;919;3321;273;1050;441;1607;714;2657
110070;201408;2062;7016;1990;6860;374;1339;1378;4778;1752;6117
110080;201408;3908;12096;3692;11836;427;1244;3075;10158;3502;11402
110090;201408;975;2836;773;2517;232;872;348;1033;580;1905
110092;201408;1758;5680;1596;5469;338;1164;987;3561;1325;4725
110094;201408;3416;10553;3121;10128;767;2578;1894;6281;2661;8859
110100;201408;2717;8518;2330;7869;684;2441;1206;4079;1890;6520
110110;201408;1828;5821;1693;5659;717;2447;738;2555;1455;5002
110120;201408;1784;5830;1409;4970;469;1709;423;1506;892;3215
110130;201408;2858;8152;2145;7090;590;2026;1037;3464;1627;5490
110140;201408;2655;8981;2414;8572;546;1987;1480;5366;2026;7353
110143;201408;1625;5152;1244;4488;315;1183;643;2313;958;3496
110145;201408;1049;3130;914;2922;159;551;613;1961;772;2512
110146;201408;478;1530;436;1466;98;338;254;872;352;1210
110147;201408;923;2729;723;2393;217;791;264;785;481;1576
110148;201408;1424;4242;1085;3544;337;1181;368;1166;705;2347
110149;201408;3895;11352;3041;10055;811;2736;1768;5992;2579;8728
110150;201408;2996;8697;2462;7912;315;1097;1665;5457;1980;6554
110155;201408;979;3187;916;3042;277;971;481;1575;758;2546
110160;201408;2229;6945;1803;6162;565;1989;855;2931;1420;4920
110170;201408;3256;9330;2492;7996;542;1822;1487;4788;2029;6610
110175;201408;1820;5633;1380;5060;181;719;949;3550;1130;4269
110180;201408;1741;5341;1473;4913;359;1234;875;2953;1234;4187
120001;201408;3016;10591;2886;10369;632;2422;1800;6557;2432;8979
120005;201408;1606;6380;1562;6299;165;614;1243;5208;1408;5822
120010;201408;4707;16543;4495;16170;859;2987;3095;11557;3954;14544
120013;201408;1924;7522;1874;7439;434;1708;1196;4993;1630;6701
120017;201408;2200;7814;2071;7569;569;2090;1021;4073;1590;6163
120020;201408;14856;64808;14508;64084;2398;10084;10596;48993;12994;59077
120025;201408;2868;9891;2785;9761;598;2219;1765;6281;2363;8500
120030;201408;6307;24879;6195;24738;461;1697;5391;21971;5852;23668
120032;201408;1409;6756;1355;6624;192;1080;984;4861;1176;5941
120033;201408;3689;14151;3659;14098;192;736;3309;12931;3501;13667
120034;201408;1913;7797;1862;7714;154;770;1605;6580;1759;7350
120035;201408;2845;13581;2810;13500;240;1102;2386;11798;2626;12900
120038;201408;3232;11786;3104;11520;835;3179;1757;6678;2592;9857
120039;201408;1558;8217;1526;8140;181;1010;1228;6634;1409;7644
120040;201408;47831;171422;43642;162902;12429;48784;21553;82397;33982;131181
120042;201408;2867;12372;2727;12035;397;1871;1973;8864;2370;10735
120043;201408;876;4185;848;4125;66;290;719;3614;785;3904
120045;201408;4624;15957;4568;15871;895;3129;3390;11978;4285;15107
120050;201408;8300;34196;7962;33452;1334;5358;5461;24248;6795;29606
120060;201408;7491;33773;7367;33535;669;3070;6178;28804;6847;31874
120070;201408;2907;10861;2834;10688;552;1992;1901;7473;2453;9465
120080;201408;3845;14469;3683;14201;571;2159;2759;11003;3330;13162
130002;201408;2960;12463;2790;12173;253;1180;2285;10108;2538;11288
130006;201408;1840;7872;1654;7523;287;1442;1126;5171;1413;6613
130008;201408;2053;8360;1962;8194;170;744;1601;6803;1771;7547
130010;201408;2847;9530;2493;9118;200;683;2148;8020;2348;8703
130014;201408;3553;11400;3064;10657;500;1857;2037;7186;2537;9043
130020;201408;2645;9307;2635;9295;33;114;2589;9153;2622;9267
130030;201408;7200;27914;6961;27600;626;2110;5918;24290;6544;26400
130040;201408;3675;11423;3347;10988;283;1021;2846;9397;3129;10418
130050;201408;6053;24193;5368;23114;698;2863;3920;17965;4618;20828
130060;201408;5936;26451;5575;25899;584;2733;4492;21321;5076;24054
130063;201408;3437;15223;3395;15152;294;1250;2916;13339;3210;14589
130068;201408;3093;13078;2842;12586;397;1912;1967;8818;2364;10730
130070;201408;6836;22506;6198;21689;644;2246;4944;17743;5588;19989
130080;201408;5126;22794;4919;22488;908;4250;3343;15860;4251;20110
130083;201408;2124;8410;2003;8220;300;1404;1444;5935;1744;7339
130090;201408;2592;9311;2474;9152;170;711;2156;7999;2326;8710
130100;201408;5597;21024;5372;20719;343;1450;4719;18361;5062;19811
130110;201408;6954;22177;6494;21628;631;1912;5415;18623;6046;20535
130115;201408;4165;14958;3990;14727;98;309;3807;14160;3905;14469
130120;201408;13918;53017;13314;52213;1169;4177;11274;45658;12443;49835
130130;201408;3653;15348;3551;15168;385;1695;2890;12561;3275;14256
130140;201408;6377;24724;6292;24626;152;402;6089;24112;6241;24514
130150;201408;3503;13280;3428;13185;217;939;3040;11729;3257;12668
130160;201408;3962;16430;3878;16315;260;983;3519;15019;3779;16002
130165;201408;2839;11663;2743;11500;379;1651;2168;9213;2547;10864
130170;201408;9291;33466;8152;32032;1189;4698;6078;24752;7267;29450
130180;201408;3430;11032;3347;10910;116;360;3104;10178;3220;10538
130185;201408;10111;34277;9417;33465;1140;3729;7601;28128;8741;31857
130190;201408;18126;62322;15992;59611;3137;11424;10597;41592;13734;53016
130195;201408;1857;7750;1799;7665;113;483;1586;6865;1699;7348
130200;201408;1990;7196;1844;6955;449;1721;1134;4394;1583;6115
130210;201408;1195;4721;1131;4610;133;575;906;3756;1039;4331
130220;201408;2040;8380;1875;8067;350;1667;1122;4895;1472;6562
130230;201408;3617;16092;3420;15766;409;1814;2586;12513;2995;14327
130240;201408;8536;32604;7877;31633;500;2238;6751;27529;7251;29767
130250;201408;18539;66109;17705;64978;2251;7688;13892;53151;16143;60839
130255;201408;4115;14518;3892;14153;149;458;3542;13154;3691;13612
130260;201408;261877;848719;235840;806592;66216;233388;122254;430773;188470;664161
130270;201408;7577;31111;6849;29973;1012;4389;5009;22883;6021;27272
130280;201408;3331;13080;3256;12971;164;502;2950;12098;3114;12600
130290;201408;10862;38646;10692;38407;222;515;10206;37303;10428;37818
130300;201408;4559;17489;4267;17051;389;1696;3473;14047;3862;15743
130310;201408;5204;19469;4770;18926;472;1838;3877;15792;4349;17630
130320;201408;2976;10329;2707;9964;353;1331;1993;7524;2346;8855
130330;201408;3723;13507;3341;12984;217;966;2847;11193;3064;12159
130340;201408;18349;70048;17715;69081;3622;13228;11867;49360;15489;62588
130350;201408;3315;13423;3178;13258;308;1350;2633;11200;2941;12550
130353;201408;6107;18762;5323;17697;1295;4198;3225;11492;4520;15690
130356;201408;4656;16743;4461;16443;462;1420;3661;14192;4123;15612
130360;201408;2971;8195;2623;7803;47;89;2482;7563;2529;7652
130370;201408;5110;20017;4385;19037;280;1430;3647;16003;3927;17433
130380;201408;6876;29218;6638;28847;498;2291;5671;24974;6169;27265
130390;201408;4858;21606;4537;21034;489;2396;3485;16605;3974;19001
130395;201408;2083;7507;1846;7009;270;1084;1213;4655;1483;5739
130400;201408;2137;7931;2065;7828;165;672;1799;6881;1964;7553
130406;201408;9926;37856;8864;36222;2034;8334;5429;23218;7463;31552
130410;201408;4135;15736;3788;15095;1066;4513;1882;7719;2948;12232
130420;201408;10245;43276;9866;42597;2892;12112;5816;26494;8708;38606
130423;201408;3235;12563;3057;12316;286;1331;2562;10349;2848;11680
130426;201408;2118;9060;2029;8902;342;1455;1460;6701;1802;8156
130430;201408;3683;12980;3480;12696;510;1927;2487;9286;2997;11213
130440;201408;4047;14165;3741;13819;223;686;3345;12730;3568;13416
140002;201408;1668;5296;1559;5155;174;567;1189;4036;1363;4603
140005;201408;2928;8672;2768;8499;114;275;2581;8046;2695;8321
140010;201408;46553;149053;41565;140878;10046;36395;22417;77551;32463;113946
140015;201408;2856;9315;2730;9149;311;797;2222;7826;2533;8623
140017;201408;3222;10028;2965;9704;261;751;2443;8278;2704;9029
140020;201408;4504;15321;4186;14896;398;1326;3429;12540;3827;13866
140023;201408;2144;7284;1938;6953;257;935;1407;5168;1664;6103
140028;201408;2230;6110;2172;6044;84;146;2016;5760;2100;5906
140030;201408;3746;11844;3577;11631;403;1014;3025;10253;3428;11267
140040;201408;1520;7263;1470;7120;141;747;1117;5521;1258;6268
140045;201408;2543;9192;2356;8915;442;1488;1587;6529;2029;8017
140047;201408;5602;15590;5055;14850;1497;4499;2563;7959;4060;12458
140050;201408;1532;4729;1402;4551;207;694;992;3284;1199;3978
140060;201408;1464;4576;1317;4343;278;949;848;2871;1126;3820
140070;201408;1495;7489;1473;7421;75;420;1325;6687;1400;7107
150010;201408;34012;108336;32400;106185;2282;7721;27484;91417;29766;99138
150013;201408;1659;5025;1568;4916;154;474;1281;4074;1435;4548
150020;201408;12214;41074;11890;40611;1066;3583;10145;35174;11211;38757
150030;201408;6665;28633;6466;28320;646;2354;5422;24809;6068;27163
150034;201408;4517;12344;4248;12007;239;583;3839;11024;4078;11607
150040;201408;12817;43163;11216;41189;2335;7919;7528;29780;9863;37699
150050;201408;6154;23475;5999;23189;608;2491;4893;19135;5501;21626
150060;201408;16960;55444;15965;53939;3292;10751;10732;37598;14024;48349
150070;201408;5818;24040;5249;23395;426;1993;4521;20424;4947;22417
150080;201408;63957;173927;56108;163713;8271;22556;39898;120605;48169;143161
150085;201408;5127;18028;4880;17668;569;1773;3964;14952;4533;16725
150090;201408;10125;39194;9552;38401;973;3853;7765;31914;8738;35767
150095;201408;5301;18121;4908;17526;452;1536;3988;14676;4440;16212
150100;201408;3591;13336;3358;12974;275;1265;2737;10522;3012;11787
150110;201408;3247;15689;3234;15654;188;809;2952;14518;3140;15327
150120;201408;6046;23624;5911;23366;804;3114;4630;18619;5434;21733
150125;201408;823;2534;763;2444;155;541;508;1606;663;2147
150130;201408;21448;66781;20167;64943;1895;5970;16206;53313;18101;59283
150140;201408;156387;462866;150570;455530;17154;51141;123630;379378;140784;430519
150145;201408;4920;15486;4559;15032;646;2206;3450;11539;4096;13745
150150;201408;10280;33492;9663;32507;1794;6262;6592;22460;8386;28722
150157;201408;3049;9415;2723;8954;387;1356;2048;6821;2435;8177
150160;201408;2953;9829;2780;9575;663;2239;1733;6211;2396;8450
150170;201408;22238;82545;21068;80910;3841;14711;15167;59190;19008;73901
150172;201408;3119;10863;2804;10372;402;1511;2123;8019;2525;9530
150175;201408;2102;6431;2016;6335;160;415;1734;5698;1894;6113
150178;201408;10908;33749;9290;31819;794;2559;7846;27517;8640;30076
150180;201408;18207;73591;17551;72670;1626;7172;14564;61078;16190;68250
150190;201408;7236;23355;6806;22754;430;1008;5893;20547;6323;21555
150195;201408;4832;16700;4505;16149;381;1405;3747;13586;4128;14991
150200;201408;5193;16828;5012;16610;152;478;4669;15664;4821;16142
150210;201408;22804;88071;22346;87395;2074;7587;18851;75661;20925;83248
150215;201408;6291;20378;5639;19367;1508;5443;2909;10175;4417;15618
150220;201408;12764;40779;11580;38916;2628;9077;6575;22609;9203;31686
150230;201408;11300;38271;10172;36658;911;3894;8109;29149;9020;33043
150240;201408;34955;106426;31495;100591;10002;32929;13313;44181;23315;77110
150250;201408;4170;16749;4036;16547;562;2239;3094;13166;3656;15405
150260;201408;2107;8480;2015;8301;421;1781;1244;5282;1665;7063
150270;201408;9708;29451;7520;26705;1540;5818;4850;17557;6390;23375
150275;201408;5902;21699;5586;21186;807;3076;4141;16062;4948;19138
150276;201408;2140;6450;1970;6218;350;1181;1480;4676;1830;5857
150277;201408;5014;15705;4376;14920;582;1973;3312;11643;3894;13616
150280;201408;5956;26147;5771;25722;982;4292;4124;18999;5106;23291
150285;201408;2618;10614;2567;10504;369;1541;1891;7970;2260;9511
150290;201408;9314;28548;9050;28232;819;2118;7675;24922;8494;27040
150293;201408;9006;26861;7441;24562;2379;8126;3233;11324;5612;19450
150295;201408;6959;21507;5907;20246;1179;3859;3967;14502;5146;18361
150300;201408;1814;6400;1761;6334;123;395;1477;5502;1600;5897
150304;201408;4219;13176;3649;12386;544;1851;2612;9155;3156;11006
150307;201408;6729;22762;6258;22087;491;1718;5173;18725;5664;20443
150309;201408;6879;24209;6350;23501;1555;5699;4107;15977;5662;21676
150310;201408;5314;24350;5188;24145;598;2743;4162;19895;4760;22638
150320;201408;8860;22858;8474;22444;564;1306;7488;20279;8052;21585
150330;201408;13527;48508;12818;47397;1511;5421;10083;38325;11594;43746
150340;201408;2366;7872;2208;7641;386;1394;1545;5433;1931;6827
150345;201408;6540;22734;6103;22135;627;2272;4990;18504;5617;20776
150350;201408;7264;24366;6914;23876;911;3075;5289;18619;6200;21694
150360;201408;22059;69187;19140;65424;3081;10578;13366;47356;16447;57934
150370;201408;10376;38359;9881;37691;1294;4339;7968;31717;9262;36056
150375;201408;2858;12082;2789;11987;321;1197;2326;10428;2647;11625
150380;201408;9830;29337;8727;27839;844;2866;7146;22983;7990;25849
150390;201408;8298;35654;7910;34889;1629;6929;5116;23628;6745;30557
150400;201408;5636;22872;5428;22431;598;2419;4200;17835;4798;20254
150405;201408;8487;26146;7626;25083;1392;4113;5369;18799;6761;22912
150410;201408;1735;6676;1690;6591;292;1207;1124;4462;1416;5669
150420;201408;35704;125769;31746;119171;8719;34275;15877;62191;24596;96466
150430;201408;6586;24186;6344;23756;755;2994;4895;18597;5650;21591
150440;201408;5435;19038;5246;18756;917;3166;3812;14033;4729;17199
150442;201408;21812;63392;19894;60827;3529;11022;13251;41709;16780;52731
150445;201408;5244;18469;4843;17866;636;2274;3709;14035;4345;16309
150450;201408;4356;20876;4198;20640;398;1939;3501;17617;3899;19556
150460;201408;6925;25332;5813;24146;374;1648;5127;21739;5501;23387
150470;201408;17614;54188;17041;53470;1009;2573;15452;49543;16461;52116
150475;201408;1349;4631;1247;4497;173;590;971;3648;1144;4238
150480;201408;14274;48885;13657;47953;1208;4198;11344;40731;12552;44929
150490;201408;6651;25643;6508;25442;295;1185;5919;23354;6214;24539
150495;201408;4915;18050;4801;17877;222;808;4416;16592;4638;17400
150497;201408;3301;11623;3009;11114;898;3411;1619;6143;2517;9554
150500;201408;3044;8721;2886;8487;436;1257;2150;6381;2586;7638
150503;201408;4030;12668;3472;11961;1213;4262;1760;6359;2973;10621
150506;201408;12507;44200;11508;42773;2372;8085;7878;31134;10250;39219
150510;201408;9873;38892;9201;37709;1472;6096;6429;27395;7901;33491
150520;201408;6555;25924;6467;25800;295;962;6016;24371;6311;25333
150530;201408;11992;42430;10898;40742;1353;4868;8239;31733;9592;36601
150540;201408;4682;14485;4228;13832;342;1169;3525;11563;3867;12732
150543;201408;5361;16919;4865;16204;1122;3823;3128;10671;4250;14494
150548;201408;8677;27914;8136;27216;460;1389;7316;24888;7776;26277
150549;201408;2265;7163;2135;7011;106;245;1951;6583;2057;6828
150550;201408;21254;68095;18926;64112;5599;19509;8996;31203;14595;50712
150553;201408;22180;80042;19428;73709;7621;30715;4742;18055;12363;48770
150555;201408;1772;5472;1557;5168;209;731;1141;3834;1350;4565
150560;201408;2014;6496;1924;6297;262;880;1383;4523;1645;5403
150563;201408;2867;9513;2661;9140;628;2304;1556;5344;2184;7648
150565;201408;3576;12584;3304;12169;253;1079;2635;9832;2888;10911
150570;201408;5539;20835;5439;20662;433;1623;4587;17873;5020;19496
150580;201408;9934;40895;9735;40647;773;2721;8501;36728;9274;39449
150590;201408;5630;22734;5483;22555;120;388;5232;21777;5352;22165
150600;201408;7935;30616;7712;30275;564;2025;6728;27075;7292;29100
150610;201408;2406;8323;2212;7926;279;1104;1545;5485;1824;6589
150611;201408;2689;9710;2544;9398;267;1069;1920;7130;2187;8199
150613;201408;11927;36942;10380;34743;3364;11468;5044;17726;8408;29194
150616;201408;3103;9218;2428;8302;620;2283;1217;4091;1837;6374
150618;201408;7317;25601;7008;25019;2178;7975;3631;13360;5809;21335
150619;201408;5365;18434;5016;17924;670;2609;3673;13195;4343;15804
150620;201408;6261;22816;5701;22099;816;3085;4403;17715;5219;20800
150630;201408;5547;17191;5306;16894;404;1249;4550;14781;4954;16030
150635;201408;4594;15089;4323;14579;891;3022;2666;9301;3557;12323
150640;201408;1629;5151;1614;5128;205;613;1302;4316;1507;4929
150650;201408;12348;38372;11178;36272;3048;10195;5606;18664;8654;28859
150655;201408;5393;17980;4958;17332;627;2299;3795;13435;4422;15734
150658;201408;4375;13954;4020;13441;455;1801;2986;10091;3441;11892
150660;201408;5800;18415;5281;17719;1285;4193;3216;11252;4501;15445
150670;201408;6476;18773;5591;17685;1608;5080;3211;10767;4819;15847
150680;201408;53413;204977;49576;197873;16348;65833;23082;98348;39430;164181
150690;201408;1918;6151;1753;5871;322;1035;1136;3955;1458;4990
150700;201408;5979;18655;5543;18080;1105;3590;3732;12500;4837;16090
150710;201408;4324;14263;3887;13574;463;1571;3004;10695;3467;12266
150715;201408;5048;16415;4509;15618;584;2102;3455;12131;4039;14233
150720;201408;6608;26973;6230;26293;1004;4156;4468;19680;5472;23836
150730;201408;9434;32629;8855;31824;1045;3539;7235;26676;8280;30215
150740;201408;3731;11986;3396;11386;489;1741;2272;7710;2761;9451
150745;201408;5883;18645;5432;18033;1141;3944;3669;12275;4810;16219
150746;201408;1433;4689;1362;4560;208;747;928;3126;1136;3873
150747;201408;5027;16494;4573;15899;509;1631;3527;12882;4036;14513
150750;201408;3023;10269;2916;10131;151;429;2669;9436;2820;9865
150760;201408;11447;37358;10829;36533;2531;8432;6842;23988;9373;32420
150770;201408;5746;21823;5498;21455;703;2592;4317;17753;5020;20345
150775;201408;1190;3711;1063;3481;218;850;622;1974;840;2824
150780;201408;3157;10483;3121;10444;83;200;2964;10062;3047;10262
150790;201408;5258;16827;4886;16380;477;1392;4095;14201;4572;15593
150795;201408;15742;48553;14128;46227;2652;8384;9511;32373;12163;40757
150796;201408;2900;8881;2731;8682;362;1101;2138;7014;2500;8115
150797;201408;3815;12796;3600;12477;202;740;3125;10933;3327;11673
150800;201408;14293;48022;13023;46466;2774;9205;9038;33932;11812;43137
150803;201408;6928;25084;6600;24613;871;3303;4895;18737;5766;22040
150805;201408;2801;9766;2591;9455;389;1363;1908;7171;2297;8534
150808;201408;5997;20544;5150;18963;2205;8619;1200;4532;3405;13151
150810;201408;19782;62147;16615;58263;2473;8227;11953;44227;14426;52454
150812;201408;5419;16863;4971;16181;492;2031;3756;11835;4248;13866
150815;201408;9004;29004;8087;27867;1037;3414;6414;22844;7451;26258
150820;201408;10828;31465;9868;30405;654;1349;8699;27813;9353;29162
150830;201408;12649;48638;11766;47099;699;3008;9870;40583;10569;43591
150835;201408;2086;7637;1939;7297;530;2132;931;3500;1461;5632
150840;201408;8003;23077;6423;20881;1533;5440;3504;11271;5037;16711
160005;201408;744;2782;699;2698;108;510;470;1766;578;2276
160010;201408;1532;5178;1521;5166;123;309;1355;4753;1478;5062
160015;201408;1738;6409;1697;6340;191;627;1362;5315;1553;5942
160020;201408;2314;7659;2153;7434;318;1125;1553;5521;1871;6646
160021;201408;926;3985;907;3954;176;831;637;2825;813;3656
160023;201408;1053;4133;1036;4106;73;251;920;3722;993;3973
160025;201408;1422;3998;1387;3961;15;43;1358;3882;1373;3925
160027;201408;8380;25565;7798;24919;2737;8352;4143;14239;6880;22591
160030;201408;43473;158845;39912;151616;8972;34065;25003;98190;33975;132255
160040;201408;4303;16671;4217;16545;152;692;3934;15437;4086;16129
160050;201408;3665;13603;3315;13084;1299;5023;1575;6641;2874;11664
160053;201408;2787;10821;2727;10734;598;2408;1864;7499;2462;9907
160055;201408;767;2969;753;2951;123;529;566;2225;689;2754
160060;201408;17718;59998;16736;58893;3764;12531;11491;42297;15255;54828
160070;201408;2360;9392;2298;9288;141;562;2044;8398;2185;8960
160080;201408;2729;10085;2714;10060;90;279;2582;9675;2672;9954
170025;201408;566;1933;518;1855;170;629;251;937;421;1566
170030;201408;1189;3916;1072;3698;327;1141;487;1715;814;2856
170035;201408;1561;4646;1289;4135;441;1500;434;1421;875;2921
170040;201408;1906;6293;1670;5942;296;1200;1126;4023;1422;5223
170070;201408;2108;5719;1705;5211;479;1570;886;2757;1365;4327
170100;201408;2587;7363;2283;6853;265;872;1772;5334;2037;6206
170105;201408;759;2431;623;2146;130;528;322;1054;452;1582
170110;201408;1195;3729;1043;3473;241;860;551;1823;792;2683
170130;201408;1453;4553;1263;4272;264;914;759;2663;1023;3577
170190;201408;1694;4870;1337;4319;541;1687;365;1356;906;3043
170200;201408;1628;4895;1211;4108;353;1323;398;1313;751;2636
170210;201408;31121;94153;26380;85989;8832;30660;9257;31431;18089;62091
170215;201408;1183;3733;1055;3541;123;439;806;2734;929;3173
170220;201408;6611;22069;6048;21108;1123;4177;3742;13296;4865;17473
170230;201408;1550;5058;1338;4663;324;1292;661;2222;985;3514
170240;201408;3030;8646;2408;7801;366;1319;1625;5301;1991;6620
170255;201408;3715;11842;3093;10824;927;3320;1391;5121;2318;8441
170270;201408;1060;2722;755;2295;111;379;497;1487;608;1866
170290;201408;3036;9063;2685;8638;200;521;2293;7692;2493;8213
170300;201408;2114;6603;1781;6049;280;1032;1186;4058;1466;5090
170305;201408;793;2475;653;2214;117;429;392;1350;509;1779
170307;201408;1120;3938;960;3629;208;826;497;1970;705;2796
170310;201408;1731;4755;1373;4177;334;988;694;2259;1028;3247
170320;201408;1097;3199;825;2702;209;728;378;1281;587;2009
170330;201408;857;2614;730;2453;125;459;507;1674;632;2133
170360;201408;460;1565;415;1488;104;393;177;616;281;1009
170370;201408;1454;4243;1172;3793;295;1031;541;1762;836;2793
170380;201408;2106;6622;1710;6021;351;1410;932;3255;1283;4665
170382;201408;564;1881;487;1758;123;502;278;981;401;1483
170384;201408;1600;6579;1504;6409;369;1649;919;3998;1288;5647
170386;201408;935;2789;806;2606;214;771;416;1353;630;2124
170388;201408;651;1962;562;1814;112;430;241;763;353;1193
170389;201408;947;3153;868;3037;115;490;621;2133;736;2623
170390;201408;1371;4036;1178;3791;160;548;867;2862;1027;3410
170410;201408;491;1640;453;1567;62;260;302;1021;364;1281
170460;201408;535;1472;391;1223;108;367;134;413;242;780
170510;201408;806;2715;660;2463;118;508;350;1299;468;1807
170550;201408;6014;18291;4792;16075;1789;6550;1155;3868;2944;10418
170555;201408;1397;4092;1126;3676;286;979;601;1988;887;2967
170560;201408;994;3385;808;3148;171;694;510;2064;681;2758
170600;201408;1374;3892;1196;3667;235;688;806;2581;1041;3269
170610;201408;1637;4957;1272;4378;160;620;802;2813;962;3433
170625;201408;436;1372;339;1178;78;291;100;351;178;642
170650;201408;1288;4124;1128;3842;285;1054;544;1888;829;2942
170700;201408;4094;13522;3424;12410;800;3177;1695;6379;2495;9556
170710;201408;1884;5571;1523;4950;257;890;939;3090;1196;3980
170720;201408;1871;5000;1600;4581;308;853;1105;3253;1413;4106
170730;201408;1119;3205;928;2925;264;911;450;1436;714;2347
170740;201408;2280;8050;2014;7579;306;1261;1388;5272;1694;6533
170755;201408;900;2812;756;2501;192;688;292;930;484;1618
170765;201408;1614;4355;1295;3838;349;1092;578;1756;927;2848
170770;201408;1858;6325;1724;6075;352;1292;1059;3805;1411;5097
170820;201408;4220;13509;3811;12858;1052;3736;1737;6002;2789;9738
170825;201408;817;2439;624;2063;149;546;253;817;402;1363
170830;201408;1409;4172;1264;3954;44;90;1136;3610;1180;3700
170900;201408;2919;10151;2777;9884;326;1160;2110;7740;2436;8900
170930;201408;4367;13279;3564;12035;1263;4506;1243;4185;2506;8691
170950;201408;13394;38684;9932;32627;3566;13127;2339;7457;5905;20584
170980;201408;532;1586;413;1386;88;330;242;799;330;1129
171050;201408;1385;4871;1293;4694;73;319;1115;4032;1188;4351
171070;201408;1748;5424;1612;5237;308;1026;1043;3484;1351;4510
171090;201408;983;2826;825;2585;85;280;612;1921;697;2201
171110;201408;672;1947;525;1707;133;474;291;928;424;1402
171150;201408;872;2571;646;2153;132;477;366;1235;498;1712
171180;201408;656;2035;493;1700;135;478;205;758;340;1236
171190;201408;1910;6912;1647;6379;402;1624;799;3226;1201;4850
171195;201408;885;3120;785;2937;140;561;429;1652;569;2213
171200;201408;708;2271;584;2040;137;547;285;937;422;1484
171215;201408;490;1446;375;1234;78;283;164;557;242;840
171240;201408;800;2748;753;2667;70;245;582;2124;652;2369
171245;201408;673;2239;566;1986;131;515;237;798;368;1313
171250;201408;1169;3382;999;3139;92;328;773;2411;865;2739
171270;201408;444;1789;412;1725;110;420;208;957;318;1377
171280;201408;900;2835;796;2660;190;635;411;1495;601;2130
171320;201408;4200;12746;3577;11789;1045;3610;1811;6009;2856;9619
171330;201408;2912;8689;2503;8073;634;2171;1385;4509;2019;6680
171360;201408;1564;4949;1322;4591;285;1027;782;2770;1067;3797
171370;201408;794;2231;705;2097;140;465;385;1134;525;1599
171380;201408;1343;4435;1145;4053;411;1482;437;1583;848;3065
171395;201408;896;2726;723;2414;144;583;366;1195;510;1778
171420;201408;2288;6965;1827;6140;451;1605;824;2816;1275;4421
171430;201408;1055;3279;902;3040;212;716;521;1786;733;2502
171488;201408;2543;7733;2306;7397;597;1920;1282;4302;1879;6222
171500;201408;903;2784;791;2575;126;406;481;1598;607;2004
171510;201408;975;3392;879;3236;146;552;565;2160;711;2712
171515;201408;622;1770;476;1549;96;335;247;798;343;1133
171525;201408;610;2030;510;1845;102;427;288;1019;390;1446
171550;201408;351;1163;290;1040;112;437;46;173;158;610
171570;201408;1305;4017;1145;3738;200;674;789;2607;989;3281
171575;201408;2087;5936;1620;5081;384;1213;746;2456;1130;3669
171610;201408;6443;21842;5776;20580;1925;7248;2033;7244;3958;14492
171620;201408;2488;7545;2222;7156;162;596;1841;5957;2003;6553
171630;201408;916;2974;750;2682;217;843;294;1033;511;1876
171650;201408;2504;7800;2030;6927;541;1987;864;2920;1405;4907
171660;201408;2675;7346;2132;6390;383;1201;1234;3751;1617;4952
171665;201408;1467;4386;1226;3998;198;715;789;2653;987;3368
171670;201408;2395;6497;1903;5781;460;1506;1022;3030;1482;4536
171700;201408;1188;3854;1034;3567;166;645;655;2241;821;2886
171720;201408;747;2270;648;2089;205;698;298;977;503;1675
171750;201408;1352;4366;1178;4037;392;1394;439;1509;831;2903
171780;201408;1301;3532;940;3022;123;449;559;1826;682;2275
171790;201408;1743;5590;1442;5159;258;912;899;3386;1157;4298
171800;201408;734;2329;662;2226;106;379;450;1544;556;1923
171820;201408;10365;31246;9218;29824;1992;6886;5637;18490;7629;25376
171830;201408;1639;5948;1496;5639;414;1638;689;2610;1103;4248
171840;201408;838;2398;736;2256;72;220;565;1761;637;1981
171845;201408;827;2242;647;1937;105;346;379;1119;484;1465
171850;201408;1025;3655;913;3416;128;568;574;2125;702;2693
171855;201408;1281;4051;1154;3842;112;481;879;2843;991;3324
171865;201408;502;1594;420;1472;109;425;207;713;316;1138
171870;201408;704;2198;580;1981;126;468;266;950;392;1418
171875;201408;1420;4449;1198;4116;180;711;853;2905;1033;3616
171880;201408;979;3525;958;3488;119;455;718;2699;837;3154
171884;201408;994;2778;720;2363;156;595;261;910;417;1505
171886;201408;1563;5205;1339;4718;464;1739;445;1593;909;3332
171888;201408;727;2225;599;1984;88;304;363;1243;451;1547
171889;201408;503;1639;474;1580;92;297;306;1053;398;1350
171890;201408;1208;3869;1061;3657;160;614;692;2389;852;3003
171900;201408;514;1934;457;1805;141;565;217;869;358;1434
172000;201408;670;2160;563;1987;93;381;324;1131;417;1512
172010;201408;1204;4143;1130;4026;121;483;872;3126;993;3609
172015;201408;361;1360;311;1282;56;239;184;794;240;1033
172020;201408;2442;8007;2193;7633;310;1150;1558;5519;1868;6669
172025;201408;773;2231;600;1928;107;363;313;1013;420;1376
172030;201408;1133;3834;1020;3629;131;554;707;2507;838;3061
172049;201408;1278;3476;1042;3057;134;395;792;2375;926;2770
172065;201408;1325;3762;1099;3479;109;382;914;2903;1023;3285
172080;201408;2645;8134;2228;7420;278;1092;1524;4988;1802;6080
172085;201408;532;1458;409;1225;96;309;143;416;239;725
172090;201408;3551;10562;2739;9429;583;2097;1615;5755;2198;7852
172093;201408;592;1871;464;1641;129;567;230;774;359;1341
172097;201408;722;2105;595;1900;154;541;238;753;392;1294
172100;201408;28966;96314;24672;87665;8526;33171;6826;24162;15352;57333
172110;201408;1721;6283;1568;6051;180;709;1195;4750;1375;5459
172120;201408;5678;16979;4675;15692;523;1799;3502;12026;4025;13825
172125;201408;335;1010;267;905;62;232;124;425;186;657
172130;201408;545;1554;460;1423;71;230;310;1003;381;1233
172208;201408;2215;6826;2074;6598;401;1377;1198;3858;1599;5235
172210;201408;2456;7588;2247;7252;418;1490;1453;4602;1871;6092
210005;201408;22102;71691;19689;67855;5886;21567;9694;33611;15580;55178
210010;201408;1651;5862;1455;5556;152;577;1123;4402;1275;4979
210015;201408;3542;10966;3231;10498;283;640;2696;9251;2979;9891
210020;201408;7652;18762;7130;18118;457;1269;5925;15220;6382;16489
210030;201408;5954;19785;5623;19330;469;1964;4647;15876;5116;17840
210040;201408;2009;5699;1833;5492;169;517;1465;4429;1634;4946
210043;201408;6406;18897;5764;18046;523;1568;4600;14874;5123;16442
210047;201408;6858;26655;6380;25807;894;3867;4475;18377;5369;22244
210050;201408;2541;8996;2030;8228;647;2730;869;3651;1516;6381
210055;201408;1754;5985;1618;5782;201;732;1218;4402;1419;5134
210060;201408;7927;29352;7134;28082;771;3350;5298;21351;6069;24701
210070;201408;7141;21210;6676;20633;296;982;5920;18435;6216;19417
210080;201408;3746;12917;3673;12815;85;336;3468;12138;3553;12474
210083;201408;4264;14623;4035;14370;127;383;3795;13709;3922;14092
210087;201408;2753;8410;2557;8170;169;577;2213;7133;2382;7710
210090;201408;10288;33512;9857;32813;450;1747;8639;28823;9089;30570
210095;201408;6276;23576;6088;23282;566;2180;5028;19637;5594;21817
210100;201408;7678;22903;7209;22352;344;1230;6413;19889;6757;21119
210110;201408;3274;11264;3175;11137;231;847;2685;9594;2916;10441
210120;201408;26527;75577;22585;70819;2623;8165;17256;55692;19879;63857
210125;201408;3484;11303;3340;11144;241;694;2939;10025;3180;10719
210130;201408;4211;12670;4004;12391;361;1154;3299;10260;3660;11414
210135;201408;1696;4973;1499;4685;132;410;1231;3919;1363;4329
210140;201408;18449;58155;15509;54212;3053;10826;9959;36204;13012;47030
210150;201408;4735;11971;4309;11443;120;321;3960;10511;4080;10832
210160;201408;19171;61701;17857;59745;2163;6692;14114;48813;16277;55505
210170;201408;14401;52381;14119;52005;1034;3439;12417;46774;13451;50213
210173;201408;1857;7877;1804;7773;117;571;1575;6826;1692;7397
210177;201408;3053;9711;2891;9511;288;1059;2376;7768;2664;8827
210180;201408;1551;4785;1457;4650;93;328;1236;3948;1329;4276
210190;201408;5262;16872;4899;16237;390;1712;3725;12065;4115;13777
210193;201408;1464;4683;1342;4473;99;364;1092;3693;1191;4057
210197;201408;1982;6622;1830;6453;186;580;1509;5532;1695;6112
210200;201408;9444;31453;8686;30354;1165;3790;6452;23582;7617;27372
210203;201408;6596;21814;6212;21323;449;1326;5444;19087;5893;20413
210207;201408;3110;10311;2917;9964;395;1279;2126;7488;2521;8767
210210;201408;8959;30238;8601;29742;294;1041;7626;26938;7920;27979
210215;201408;1681;6651;1627;6557;174;744;1321;5375;1495;6119
210220;201408;6401;24475;6123;24027;520;2081;4990;20040;5510;22121
210230;201408;5397;18267;5020;17672;412;1532;4106;14608;4518;16140
210232;201408;12132;41239;10582;39333;1764;6576;7409;29125;9173;35701
210235;201408;3660;11252;3280;10779;251;862;2787;9256;3038;10118
210237;201408;2527;9322;2490;9275;53;145;2386;9000;2439;9145
210240;201408;3079;9732;2922;9508;222;689;2427;8033;2649;8722
210250;201408;5160;16341;4936;16060;162;602;4583;14966;4745;15568
210255;201408;2746;8892;2501;8471;519;1857;1553;5340;2072;7197
210260;201408;5294;16905;4818;16179;681;2239;3551;12225;4232;14464
210270;201408;5399;15466;4801;14635;152;548;4269;13106;4421;13654
210275;201408;3618;9107;3380;8849;115;245;3199;8475;3314;8720
210280;201408;6095;17789;5223;16680;407;1384;4292;13856;4699;15240
210290;201408;5806;18866;5330;18274;446;1471;4434;15585;4880;17056
210300;201408;38617;113261;31902;104783;2912;10017;25157;85059;28069;95076
210310;201408;2904;8366;2745;8138;134;367;2411;7203;2545;7570
210312;201408;2217;7147;2163;7059;118;463;1934;6311;2052;6774
210315;201408;2477;8634;2358;8464;144;583;2035;7345;2179;7928
210317;201408;4390;13094;4197;12849;265;782;3725;11555;3990;12337
210320;201408;19783;62490;18484;60922;1080;3487;16242;54519;17322;58006
210325;201408;3683;11616;3297;11042;354;1260;2546;8609;2900;9869
210330;201408;37543;91055;29495;82530;3845;8358;21621;67649;25466;76007
210340;201408;12115;37356;11067;36046;1419;3882;8280;28793;9699;32675
210350;201408;10673;33246;9849;32079;835;2705;7952;26459;8787;29164
210355;201408;4009;14370;3637;13877;157;388;3307;13085;3464;13473
210360;201408;17302;52791;16096;51047;1389;4606;12843;41340;14232;45946
210370;201408;8884;22636;7747;21418;281;627;7022;19881;7303;20508
210375;201408;3266;9975;2813;9425;496;1749;1960;6703;2456;8452
210380;201408;6477;18560;5794;17592;567;1538;4719;14744;5286;16282
210390;201408;2827;9999;2597;9613;128;604;2262;8393;2390;8997
210400;201408;5114;16076;4921;15842;309;929;4349;14221;4658;15150
210405;201408;9140;25110;7383;22727;2214;6729;3472;11795;5686;18524
210407;201408;2126;7477;1884;7097;202;744;1455;5696;1657;6440
210408;201408;2260;8925;2137;8781;87;325;1926;8194;2013;8519
210409;201408;4005;14470;3792;14135;297;1154;3077;11740;3374;12894
210410;201408;3641;11710;3403;11416;299;851;2930;10127;3229;10978
210420;201408;4287;14159;3978;13620;340;1177;3249;11321;3589;12498
210430;201408;2189;6770;2122;6691;146;486;1845;5845;1991;6331
210440;201408;4359;13535;4233;13352;217;655;3798;12132;4015;12787
210450;201408;2958;9341;2669;8912;198;764;2192;7291;2390;8055
210455;201408;4319;12781;3717;11881;650;2127;2532;8282;3182;10409
210460;201408;4107;13200;3843;12844;223;825;3292;11105;3515;11930
210462;201408;1796;6437;1722;6286;178;704;1328;4927;1506;5631
210465;201408;2748;8950;2578;8737;278;790;2118;7463;2396;8253
210467;201408;6432;21129;6012;20612;483;1423;5055;17993;5538;19416
210470;201408;2056;5692;1607;5034;108;351;1273;4038;1381;4389
210480;201408;14247;47260;12554;44975;3569;12598;6895;26454;10464;39052
210490;201408;3569;10584;3271;10140;290;939;2645;8212;2935;9151
210500;201408;6840;26825;6543;26302;765;2944;5059;21125;5824;24069
210510;201408;6995;23172;6705;22820;411;960;5823;20781;6234;21741
210515;201408;3467;11412;3355;11275;142;416;3097;10557;3239;10973
210520;201408;2779;8754;2586;8470;207;657;2154;7205;2361;7862
210530;201408;42380;136823;35835;126811;10302;39294;17804;64827;28106;104121
210535;201408;3301;11558;3174;11363;174;634;2772;10039;2946;10673
210540;201408;13478;46038;11988;43663;2942;10459;6575;25924;9517;36383
210542;201408;6489;18762;5671;17864;349;895;4986;16157;5335;17052
210545;201408;2294;7606;2179;7407;96;449;1881;6360;1977;6809
210547;201408;3934;13726;3668;13313;300;1004;2967;11063;3267;12067
210550;201408;6459;18188;5619;17256;293;659;5121;16170;5414;16829
210560;201408;4281;13519;3826;12772;286;1075;3164;10544;3450;11619
210565;201408;1558;5392;1348;5079;138;632;1005;3794;1143;4426
210570;201408;12996;37001;11803;35627;1005;2464;9887;30986;10892;33450
210580;201408;3201;9714;2833;9248;372;996;2157;7621;2529;8617
210590;201408;4479;13737;4186;13390;284;897;3636;11827;3920;12724
210592;201408;2538;8094;2454;7965;122;451;2153;6982;2275;7433
210594;201408;2823;8034;2345;7378;155;430;1944;6295;2099;6725
210596;201408;2933;10818;2759;10495;307;1219;2091;8102;2398;9321
210598;201408;2011;6233;1874;6062;116;452;1657;5317;1773;5769
210600;201408;3394;10062;3100;9647;294;969;2448;7623;2742;8592
210610;201408;2746;8751;2466;8409;207;800;2077;7072;2284;7872
210620;201408;1917;5904;1759;5701;47;133;1625;5331;1672;5464
210630;201408;3566;12939;3114;12075;497;1920;1973;7937;2470;9857
210632;201408;4846;16676;4434;16096;425;1584;3599;13243;4024;14827
210635;201408;1959;6921;1871;6788;79;275;1673;6175;1752;6450
210637;201408;2861;9617;2690;9366;161;564;2324;8211;2485;8775
210640;201408;4402;14787;4307;14682;18;51;4194;14404;4212;14455
210650;201408;7044;21454;6920;21303;138;385;6661;20644;6799;21029
210660;201408;7825;24048;7297;23245;270;787;6730;21552;7000;22339
210663;201408;2706;7959;2557;7764;171;567;2184;6674;2355;7241
210667;201408;1755;6273;1674;6148;86;381;1460;5387;1546;5768
210670;201408;4800;17798;4635;17516;446;1719;3646;14180;4092;15899
210675;201408;4916;13772;4598;13375;362;952;3910;11636;4272;12588
210680;201408;4625;12973;4117;12383;232;661;3569;10891;3801;11552
210690;201408;7160;24036;6776;23628;291;918;6175;21926;6466;22844
210700;201408;2693;7728;2389;7381;408;1026;1706;5878;2114;6904
210710;201408;4955;16139;4733;15783;192;718;4177;13985;4369;14703
210720;201408;2557;9310;2410;9095;151;668;2105;7904;2256;8572
210725;201408;1199;4399;1030;4083;168;717;597;2397;765;3114
210730;201408;1256;3887;1105;3710;106;307;921;3178;1027;3485
210735;201408;3970;14382;3686;13884;610;2312;2582;10065;3192;12377
210740;201408;5240;14764;4898;14419;244;654;4541;13549;4785;14203
210745;201408;3848;11652;3610;11323;312;811;3013;9640;3325;10451
210750;201408;20457;56887;18611;54763;2003;5850;15032;45060;17035;50910
210760;201408;6113;16769;5758;16382;85;254;5580;15907;5665;16161
210770;201408;6384;17311;5395;16182;227;714;4845;14607;5072;15321
210780;201408;8763;29224;8084;27989;1010;3652;5777;20392;6787;24044
210790;201408;4811;14608;4147;13852;331;825;3518;12319;3849;13144
210800;201408;5168;14526;4688;13995;205;639;4021;12473;4226;13112
210805;201408;3774;15935;3655;15717;192;820;3153;13893;3345;14713
210810;201408;5872;17563;5293;16896;402;823;4615;15430;5017;16253
210820;201408;9172;26458;8550;25580;1569;4574;5827;18001;7396;22575
210825;201408;5603;18877;5403;18620;288;919;4795;16832;5083;17751
210830;201408;8724;26743;8336;26308;402;1043;7475;24165;7877;25208
210840;201408;3879;10673;3506;10116;278;722;2815;8183;3093;8905
210845;201408;5820;18191;5601;17947;257;653;5022;16592;5279;17245
210850;201408;6305;22942;5841;22133;848;3586;4170;15906;5018;19492
210860;201408;17703;54128;16402;52393;1482;4988;13151;42459;14633;47447
210870;201408;6768;21968;6068;21084;690;2284;4687;16789;5377;19073
210880;201408;4387;14147;4262;13961;220;701;3812;12639;4032;13340
210890;201408;5513;16553;5154;16103;456;1566;4240;13316;4696;14882
210900;201408;4886;15811;4412;15004;1521;5261;1900;6826;3421;12087
210905;201408;1851;5824;1734;5669;128;326;1465;4945;1593;5271
210910;201408;10699;33636;9980;32487;1842;6408;6659;21891;8501;28299
210920;201408;3380;11344;3267;11183;185;609;2852;9946;3037;10555
210923;201408;1562;5690;1475;5559;223;840;1043;4130;1266;4970
210927;201408;4826;15126;4659;14955;34;102;4583;14758;4617;14860
210930;201408;2694;9745;2570;9582;203;917;2145;7993;2348;8910
210940;201408;2968;11623;2912;11511;304;1138;2372;9567;2676;10705
210945;201408;6077;17915;5850;17682;221;267;5567;17296;5788;17563
210950;201408;5814;17759;5055;16633;588;2017;3759;12586;4347;14603
210955;201408;1983;6545;1765;6201;307;1093;1194;4325;1501;5418
210960;201408;9488;31253;9083;30668;2299;7519;5736;20462;8035;27981
210970;201408;1401;5036;1237;4795;174;792;894;3474;1068;4266
210975;201408;1762;6050;1676;5896;170;612;1314;4699;1484;5311
210980;201408;9717;23611;9465;23329;654;1310;8434;21236;9088;22546
210990;201408;17252;49981;13771;45757;2837;9746;8708;29808;11545;39554
211000;201408;16819;53657;15147;51596;1010;3409;13016;45298;14026;48707
211003;201408;5189;18164;4739;17485;521;2019;3537;13436;4058;15455
211010;201408;6825;23463;6619;23224;150;504;6172;21958;6322;22462
211020;201408;7525;23470;7341;23175;206;518;6884;21898;7090;22416
211023;201408;2491;8355;2418;8229;163;577;2029;7047;2192;7624
211027;201408;3061;11896;2945;11714;293;1095;2343;9698;2636;10793
211030;201408;4366;13246;3923;12743;737;1900;2916;10126;3653;12026
211040;201408;4287;16409;4165;16214;157;643;3670;14594;3827;15237
211050;201408;10538;27920;10368;27730;450;1106;9657;26026;10107;27132
211060;201408;6146;21965;6005;21730;608;2069;4950;18361;5558;20430
211065;201408;1784;6092;1630;5894;56;191;1517;5566;1573;5757
211070;201408;8894;30002;8280;28954;763;2679;6627;23649;7390;26328
211080;201408;1394;4254;1145;3905;100;483;915;3022;1015;3505
211085;201408;2071;6918;1789;6524;293;1035;1275;4803;1568;5838
211090;201408;3669;11308;3445;11007;204;768;2937;9324;3141;10092
211100;201408;6956;18131;6784;17928;96;341;6469;17050;6565;17391
211102;201408;3164;11716;3025;11528;291;1044;2542;9944;2833;10988
211105;201408;2896;9217;2541;8723;220;830;2064;7093;2284;7923
211107;201408;4578;14236;4178;13701;257;792;3581;12047;3838;12839
211110;201408;6709;20073;5323;18101;905;2931;3528;12649;4433;15580
211120;201408;33495;92896;29460;87878;4342;12216;21425;66550;25767;78766
211125;201408;2240;7194;2032;6872;153;550;1680;5729;1833;6279
211130;201408;151858;445645;142216;433307;27968;84565;97512;304614;125480;389179
211140;201408;5692;18152;5355;17624;290;1029;4621;15261;4911;16290
211150;201408;10241;30630;9564;29790;693;2209;8171;25753;8864;27962
211153;201408;3201;9552;2934;9244;413;1096;2329;7701;2742;8797
211157;201408;1272;4165;1087;3879;135;577;748;2764;883;3341
211160;201408;4289;14528;3678;13496;426;1882;2643;9610;3069;11492
211163;201408;1740;5773;1650;5652;74;238;1475;5163;1549;5401
211167;201408;1535;5158;1430;4989;48;185;1301;4561;1349;4746
211170;201408;6836;18109;6576;17791;174;531;6077;16421;6251;16952
211172;201408;2462;7175;2167;6745;158;602;1798;5492;1956;6094
211174;201408;2920;8546;2659;8217;123;471;2342;7195;2465;7666
211176;201408;5706;16606;4805;15560;597;1715;3680;12473;4277;14188
211178;201408;3456;10228;3378;10141;89;200;3223;9783;3312;9983
211180;201408;4576;16030;4269;15558;407;1609;3414;12638;3821;14247
211190;201408;2897;9669;2623;9284;125;546;2266;8083;2391;8629
211195;201408;1490;4672;1271;4404;108;336;1041;3737;1149;4073
211200;201408;2211;7631;1982;7311;270;931;1471;5713;1741;6644
211210;201408;7012;21668;6777;21336;439;1380;5840;18608;6279;19988
211220;201408;36818;109166;32216;103167;6756;22228;20674;68089;27430;90317
211223;201408;6077;17486;5608;16739;818;2480;3780;11857;4598;14337
211227;201408;1621;5965;1513;5800;133;612;1205;4627;1338;5239
211230;201408;9218;30827;8419;29470;1195;4211;6041;21667;7236;25878
211240;201408;8500;28632;8183;28245;332;1181;7519;26115;7851;27296
211245;201408;5573;16085;5505;16001;172;406;5191;15270;5363;15676
211250;201408;12294;43836;11663;43104;1265;3452;9689;37908;10954;41360
211260;201408;8360;26352;8188;26112;529;1692;7293;23419;7822;25111
211270;201408;10236;36326;9624;35505;670;2697;7983;29967;8653;32664
211280;201408;12590;37177;11962;36418;1027;2453;10296;32495;11323;34948
211285;201408;2005;7020;1727;6515;404;1620;858;3399;1262;5019
211290;201408;7817;25713;7580;25410;813;2391;6214;21484;7027;23875
211300;201408;8943;27315;8148;26174;555;1847;6931;22434;7486;24281
211400;201408;12764;37086;10665;34707;2451;7723;6286;23013;8737;30736
220005;201408;1738;5113;1623;4937;68;292;1393;4106;1461;4398
220010;201408;1779;4645;1327;4069;117;431;1039;3127;1156;3558
220020;201408;3821;11694;3598;11316;598;2013;2435;7633;3033;9646
220025;201408;2232;5497;2002;5151;52;157;1766;4498;1818;4655
220027;201408;1431;3882;1320;3740;93;242;1115;3204;1208;3446
220030;201408;3485;10113;3400;9977;255;835;2891;8469;3146;9304
220040;201408;8715;26945;8248;26185;1685;5570;5183;16543;6868;22113
220045;201408;1498;4777;1351;4533;134;519;983;3246;1117;3765
220050;201408;4875;14218;4272;13331;370;1359;3392;10437;3762;11796
220060;201408;2114;5515;2015;5397;92;244;1834;4921;1926;5165
220070;201408;2660;7769;2379;7360;203;652;1857;5796;2060;6448
220080;201408;842;2609;796;2532;110;431;572;1753;682;2184
220090;201408;1916;4957;1650;4593;130;446;1361;3698;1491;4144
220095;201408;703;1959;673;1910;32;103;623;1754;655;1857
220100;201408;1425;4278;1211;3923;131;450;895;2940;1026;3390
220105;201408;2297;7508;2105;7144;211;761;1533;5229;1744;5990
220110;201408;3649;10568;3226;9948;239;896;2652;8037;2891;8933
220115;201408;2335;8466;2245;8324;260;1030;1823;6786;2083;7816
220117;201408;1447;3840;1184;3453;121;361;912;2665;1033;3026
220120;201408;13098;37465;12136;36251;409;1492;11102;33132;11511;34624
220130;201408;874;3121;772;2990;63;207;673;2670;736;2877
220140;201408;1681;4497;1525;4299;236;486;1221;3636;1457;4122
220150;201408;7364;23087;6997;22589;417;1535;6047;19518;6464;21053
220155;201408;1095;3421;917;3090;80;337;635;2081;715;2418
220157;201408;1093;2795;994;2653;44;115;848;2260;892;2375
220160;201408;2913;8707;2607;8186;198;751;2016;6271;2214;7022
220170;201408;1375;4341;1228;4096;109;438;973;3227;1082;3665
220173;201408;2129;6454;1752;5730;84;386;1415;4565;1499;4951
220177;201408;1758;5168;1727;5118;67;204;1610;4779;1677;4983
220180;201408;1184;3219;1045;2998;57;206;794;2216;851;2422
220190;201408;4848;15748;4272;15014;509;1746;3355;12028;3864;13774
220191;201408;1492;5042;1422;4914;208;724;1047;3644;1255;4368
220192;201408;1784;5109;1426;4481;169;570;984;3079;1153;3649
220194;201408;1759;5179;1592;4898;165;576;1192;3578;1357;4154
220196;201408;2101;6272;1959;6030;218;736;1486;4583;1704;5319
220198;201408;1349;3770;1078;3417;20;63;998;3205;1018;3268
220200;201408;4716;16131;4429;15695;758;2795;3093;11071;3851;13866
220202;201408;2113;6638;1910;6274;66;270;1682;5490;1748;5760
220205;201408;2998;7845;2642;7375;100;369;2315;6378;2415;6747
220207;201408;927;2863;808;2655;86;332;610;1987;696;2319
220208;201408;1751;5922;1589;5642;239;966;1112;3926;1351;4892
220209;201408;1625;5006;1466;4740;85;329;1131;3656;1216;3985
220210;201408;1931;5070;1682;4742;95;323;1336;3775;1431;4098
220211;201408;1690;4978;1603;4864;115;480;1335;3984;1450;4464
220213;201408;1858;5399;1731;5166;108;390;1364;4003;1472;4393
220217;201408;1846;6072;1774;5980;64;182;1631;5581;1695;5763
220220;201408;11994;34283;10985;32701;1350;3756;7853;24053;9203;27809
220225;201408;1036;3158;938;3016;45;192;806;2548;851;2740
220230;201408;6220;16311;5149;14876;224;639;4549;13215;4773;13854
220240;201408;2781;8866;2610;8570;213;773;2039;6679;2252;7452
220245;201408;1514;4101;1360;3888;70;204;1163;3374;1233;3578
220250;201408;3419;9313;3065;8836;68;174;2813;8217;2881;8391
220253;201408;1889;5582;1612;5104;142;522;1190;3804;1332;4326
220255;201408;1822;5141;1593;4757;97;377;1301;3782;1398;4159
220260;201408;5281;16898;4713;15830;469;1674;3502;11814;3971;13488
220265;201408;1263;4574;1195;4454;108;481;874;3258;982;3739
220270;201408;6995;22784;6799;22444;425;1892;5784;18657;6209;20549
220271;201408;1572;4417;1470;4267;70;192;1285;3782;1355;3974
220272;201408;1815;5576;1673;5346;106;437;1319;4174;1425;4611
220273;201408;1327;3804;1156;3533;121;397;876;2655;997;3052
220275;201408;2144;5699;1818;5279;95;301;1571;4563;1666;4864
220277;201408;2656;7186;2248;6570;158;509;1761;5183;1919;5692
220280;201408;1801;4721;1564;4369;133;480;1203;3280;1336;3760
220285;201408;1721;4648;1523;4369;101;316;1251;3680;1352;3996
220290;201408;6751;21894;5681;20502;589;2309;4346;15866;4935;18175
220300;201408;1982;6434;1739;6104;95;420;1464;5134;1559;5554
220310;201408;2658;8574;2215;8043;93;282;1995;7490;2088;7772
220320;201408;3478;10207;2902;9241;352;1192;2115;6748;2467;7940
220323;201408;1512;5422;1336;5169;145;633;1010;3936;1155;4569
220325;201408;1295;4110;1183;3886;163;575;793;2678;956;3253
220327;201408;1391;4451;1260;4230;73;347;1012;3347;1085;3694
220330;201408;3819;10800;3607;10519;249;760;3064;9030;3313;9790
220335;201408;2149;6200;1935;5940;107;368;1663;5157;1770;5525
220340;201408;1885;5329;1639;4970;143;484;1258;3774;1401;4258
220342;201408;1231;4008;1165;3905;125;468;851;3005;976;3473
220345;201408;3044;8109;2584;7383;78;223;2264;6472;2342;6695
220350;201408;4542;12124;4001;11394;313;991;3167;9015;3480;10006
220360;201408;1504;4092;1193;3608;120;421;875;2625;995;3046
220370;201408;9387;27019;8540;25900;454;1351;7615;23192;8069;24543
220375;201408;1600;5005;1484;4850;72;264;1336;4365;1408;4629
220380;201408;1474;3957;1258;3657;83;277;991;2870;1074;3147
220385;201408;799;2125;666;1903;34;123;548;1518;582;1641
220390;201408;10365;32478;9396;30579;2607;8853;3862;12640;6469;21493
220400;201408;1520;3600;1287;3251;47;160;1110;2718;1157;2878
220410;201408;1401;4006;1186;3704;115;463;927;2822;1042;3285
220415;201408;902;2426;811;2306;83;235;615;1756;698;1991
220420;201408;2323;6729;2070;6231;139;421;1689;5103;1828;5524
220430;201408;3001;8695;2852;8493;373;1136;2212;6594;2585;7730
220435;201408;1697;4978;1559;4762;85;264;1293;3961;1378;4225
220440;201408;2819;8500;2332;7929;135;444;2055;7015;2190;7459
220450;201408;2770;8180;2381;7643;544;1854;1444;4634;1988;6488
220455;201408;1422;4393;1274;4191;49;158;1156;3850;1205;4008
220460;201408;1063;2927;1010;2853;70;215;874;2451;944;2666
220465;201408;2525;8350;2321;8039;560;2074;1406;4913;1966;6987
220470;201408;4164;12461;3762;11778;277;976;2884;8920;3161;9896
220480;201408;2480;7296;2255;6973;186;599;1811;5606;1997;6205
220490;201408;2506;7192;2335;6977;133;469;2003;5970;2136;6439
220500;201408;3496;9327;2913;8321;163;648;2362;6568;2525;7216
220510;201408;2980;8314;2214;7119;109;476;1690;5372;1799;5848
220515;201408;2033;5061;1790;4756;95;261;1504;4012;1599;4273
220520;201408;5288;14721;4910;14184;204;568;4341;12659;4545;13227
220525;201408;1488;4195;1380;4037;108;393;1117;3192;1225;3585
220527;201408;1496;4656;1360;4369;152;510;1020;3327;1172;3837
220530;201408;1249;3644;1132;3461;92;356;943;2799;1035;3155
220535;201408;870;2693;841;2653;77;272;676;2124;753;2396
220540;201408;3721;12291;3577;12066;282;1073;2957;9975;3239;11048
220545;201408;1459;4998;1400;4899;197;789;1005;3466;1202;4255
220550;201408;9614;31269;9050;30310;1395;4934;6308;21191;7703;26125
220551;201408;1476;4991;1369;4812;118;509;1075;3738;1193;4247
220552;201408;1707;5355;1461;4925;122;552;1078;3511;1200;4063
220553;201408;1661;4955;1415;4588;95;356;1150;3722;1245;4078
220554;201408;936;2615;811;2442;100;308;604;1842;704;2150
220555;201408;2515;7343;2352;7135;94;305;2034;6264;2128;6569
220556;201408;1533;4812;1384;4527;108;433;1041;3379;1149;3812
220557;201408;1685;5536;1528;5235;210;785;998;3430;1208;4215
220558;201408;1075;3372;983;3210;100;396;736;2360;836;2756
220559;201408;1605;4536;1465;4322;84;286;1238;3645;1322;3931
220560;201408;1786;4408;1477;3992;90;254;1235;3317;1325;3571
220570;201408;7688;24516;7185;23782;1176;3803;5160;17540;6336;21343
220580;201408;6683;21746;6516;21547;401;1278;5864;19627;6265;20905
220585;201408;1999;7313;1921;7172;147;590;1597;5990;1744;6580
220590;201408;1484;4575;1336;4358;258;874;864;2873;1122;3747
220595;201408;2565;7376;2356;7098;88;307;2109;6365;2197;6672
220600;201408;1378;3408;1154;3137;202;421;795;2299;997;2720
220605;201408;2116;6213;1854;5799;110;370;1478;4624;1588;4994
220610;201408;2851;8778;2757;8644;164;635;2356;7329;2520;7964
220620;201408;8040;27209;7740;26768;427;1689;6777;23487;7204;25176
220630;201408;428;1301;365;1183;60;221;208;664;268;885
220635;201408;1896;6716;1766;6433;178;781;1137;4139;1315;4920
220640;201408;2890;8436;2729;8201;254;853;2173;6524;2427;7377
220650;201408;2540;7146;2266;6715;157;527;1824;5370;1981;5897
220660;201408;2697;8470;2159;7761;262;1130;1699;5988;1961;7118
220665;201408;1238;4239;1182;4148;49;206;1066;3728;1115;3934
220667;201408;1810;6103;1717;5976;89;340;1473;5135;1562;5475
220669;201408;1955;6351;1821;6101;286;1114;1246;4134;1532;5248
220670;201408;2203;6653;2053;6461;163;400;1767;5764;1930;6164
220672;201408;2452;7029;2343;6888;246;696;1955;5838;2201;6534
220675;201408;1396;4080;1302;3924;126;361;983;2992;1109;3353
220680;201408;2294;7492;2189;7346;231;780;1752;5980;1983;6760
220690;201408;1790;5073;1588;4743;119;422;1263;3741;1382;4163
220695;201408;924;2733;863;2630;63;231;673;2019;736;2250
220700;201408;9281;26857;8416;25568;787;2639;6476;19665;7263;22304
220710;201408;795;2384;682;2190;65;200;497;1623;562;1823
220720;201408;2192;5870;2071;5706;97;229;1832;5113;1929;5342
220730;201408;1416;3931;1211;3617;47;177;1020;3024;1067;3201
220735;201408;1098;2828;911;2512;65;214;687;1893;752;2107
220740;201408;1443;4583;1215;4276;165;572;928;3362;1093;3934
220750;201408;4090;11944;3838;11566;509;1338;2934;9183;3443;10521
220755;201408;1231;3550;1149;3416;73;221;954;2834;1027;3055
220760;201408;2743;9528;2540;9242;135;558;2190;8034;2325;8592
220770;201408;24753;83264;22556;78964;7476;27136;9199;33474;16675;60610
220775;201408;1284;3213;1252;3177;20;34;1217;3109;1237;3143
220777;201408;1748;4918;1614;4711;126;363;1292;3750;1418;4113
220779;201408;1245;3614;1208;3563;70;248;1080;3153;1150;3401
220780;201408;6464;16817;5788;15897;466;1250;4734;13167;5200;14417
220785;201408;1369;3675;1323;3583;63;172;1212;3275;1275;3447
220790;201408;9799;31465;9356;30665;992;3491;7365;24072;8357;27563
220793;201408;950;2690;874;2566;62;209;719;2102;781;2311
220795;201408;1563;4373;1512;4296;116;351;1291;3678;1407;4029
220800;201408;17853;50249;16414;48135;1854;6277;12315;35536;14169;41813
220810;201408;3436;10080;2973;9259;202;797;2371;7291;2573;8088
220820;201408;5745;15896;5251;15246;326;1033;4522;13172;4848;14205
220830;201408;7821;22275;7422;21620;842;2482;5736;16876;6578;19358
220840;201408;15345;49013;13871;46025;3639;12321;6619;22599;10258;34920
220850;201408;2929;10295;2794;10108;246;980;2346;8507;2592;9487
220855;201408;639;1982;561;1835;49;194;411;1324;460;1518
220860;201408;968;2664;880;2524;52;211;712;1985;764;2196
220865;201408;2704;7540;2191;6692;121;565;1753;5187;1874;5752
220870;201408;2483;8160;2175;7775;112;427;1928;6915;2040;7342
220880;201408;5546;14437;5053;13836;265;827;4444;12170;4709;12997
220885;201408;1368;4842;1201;4548;122;573;890;3355;1012;3928
220887;201408;1435;3683;1250;3429;48;158;1128;3093;1176;3251
220890;201408;1686;5881;1497;5562;144;519;1193;4579;1337;5098
220900;201408;1998;5806;1769;5340;120;349;1438;4388;1558;4737
220910;201408;1749;5177;1543;4872;82;271;1340;4284;1422;4555
220915;201408;1072;3096;939;2858;56;240;735;2170;791;2410
220920;201408;1382;5045;1288;4909;146;647;938;3544;1084;4191
220930;201408;1527;4918;1357;4693;98;387;1107;3855;1205;4242
220935;201408;1082;3324;963;3083;69;302;686;2095;755;2397
220937;201408;1628;4454;1371;3999;80;294;1077;3052;1157;3346
220940;201408;1475;4526;1362;4285;111;420;1044;3261;1155;3681
220945;201408;501;1789;460;1676;59;248;319;1162;378;1410
220950;201408;1295;3297;932;2672;41;159;714;1987;755;2146
220955;201408;1651;4541;1389;4128;103;331;1080;3192;1183;3523
220960;201408;902;2470;751;2209;52;201;580;1674;632;1875
220965;201408;1735;5210;1637;5069;75;309;1412;4333;1487;4642
220970;201408;2174;5829;1600;4870;169;525;1100;3379;1269;3904
220975;201408;652;2282;643;2269;51;191;574;2023;625;2214
220980;201408;1519;4531;1349;4224;146;519;897;2900;1043;3419
220985;201408;1368;3954;1297;3847;135;456;993;2916;1128;3372
220987;201408;1529;4908;1408;4701;115;497;1064;3464;1179;3961
220990;201408;1876;5412;1625;4981;78;322;1266;3812;1344;4134
220995;201408;1273;3796;1006;3386;89;366;763;2584;852;2950
220997;201408;2163;6902;2061;6736;109;396;1865;6087;1974;6483
221000;201408;4566;14128;4236;13576;511;1827;3100;9863;3611;11690
221005;201408;1466;4660;1360;4458;442;1357;690;2386;1132;3743
221010;201408;1274;3437;1103;3211;72;214;924;2699;996;2913
221020;201408;1950;6053;1819;5813;135;573;1364;4286;1499;4859
221030;201408;1828;5114;1586;4760;114;474;1248;3673;1362;4147
221035;201408;1603;4340;1450;4152;96;249;1275;3715;1371;3964
221037;201408;641;1967;577;1853;37;166;459;1414;496;1580
221038;201408;657;1842;520;1609;42;140;355;1110;397;1250
221039;201408;964;2794;895;2692;62;217;764;2269;826;2486
221040;201408;5312;16259;4988;15739;393;1352;3937;12552;4330;13904
221050;201408;3836;11802;3535;11372;220;857;2999;9589;3219;10446
221060;201408;9347;25596;7914;23603;912;2788;5929;17806;6841;20594
221062;201408;1298;4602;1200;4428;33;129;1113;4119;1146;4248
221063;201408;1164;3757;1081;3599;310;997;621;2215;931;3212
221065;201408;2826;8136;2623;7808;289;867;2045;6092;2334;6959
221070;201408;4415;13527;3987;12858;274;1025;3179;10263;3453;11288
221080;201408;3622;9712;3217;9163;210;649;2667;7621;2877;8270
221090;201408;1385;3837;1205;3548;51;211;995;2866;1046;3077
221093;201408;1840;5499;1745;5309;403;1309;946;2813;1349;4122
221095;201408;1025;2733;877;2520;29;74;775;2246;804;2320
221097;201408;823;2370;724;2198;65;264;547;1631;612;1895
221100;201408;128400;390898;120782;378322;24782;84771;78708;241992;103490;326763
221110;201408;10385;34195;9905;33592;676;2587;8421;28554;9097;31141
221120;201408;4543;15018;4349;14672;1003;3404;2834;9793;3837;13197
221130;201408;4804;14248;4203;13041;1221;3942;2062;6361;3283;10303
221135;201408;1515;4792;1415;4641;161;608;1110;3599;1271;4207
221140;201408;1442;3641;1324;3484;106;279;1117;2950;1223;3229
221150;201408;1257;3246;1044;2879;36;155;830;2254;866;2409
221160;201408;907;2389;849;2297;61;189;649;1762;710;1951
221170;201408;1160;3682;1082;3541;77;315;883;2846;960;3161
230010;201408;3471;9439;2842;8356;182;625;2279;6690;2461;7315
230015;201408;2749;9684;2573;9285;395;1665;1688;5974;2083;7639
230020;201408;14714;48377;14189;47418;900;3305;11812;39711;12712;43016
230030;201408;12906;37749;12003;36354;880;2989;9737;29438;10617;32427
230040;201408;4647;13136;3944;11928;304;1097;3061;9146;3365;10243
230050;201408;2526;8813;2024;7470;390;1595;922;3364;1312;4959
230060;201408;2096;6217;1841;5746;124;454;1401;4329;1525;4783
230070;201408;4406;12271;3853;11449;366;1167;2895;8722;3261;9889
230075;201408;9208;33212;8623;31997;818;3831;6657;24358;7475;28189
230080;201408;2413;6639;2027;6079;130;451;1630;4866;1760;5317
230090;201408;3622;11004;3229;10298;318;1168;2448;7762;2766;8930
230100;201408;17963;55226;16427;52259;4034;13518;8728;28041;12762;41559
230110;201408;14264;46719;13291;44654;2606;9362;7849;26350;10455;35712
230120;201408;8298;22921;7308;21526;846;2531;5439;16273;6285;18804
230125;201408;2934;8658;2435;7696;190;717;1795;5611;1985;6328
230130;201408;5759;19135;4874;17198;506;2098;3404;11833;3910;13931
230140;201408;3614;11696;3112;10772;453;1656;2043;7243;2496;8899
230150;201408;1788;5703;1558;5227;282;1084;977;3165;1259;4249
230160;201408;6589;19757;5724;18478;479;1783;4387;14156;4866;15939
230170;201408;6734;21315;5807;19588;549;2154;4219;14099;4768;16253
230180;201408;1978;5716;1730;5263;148;549;1219;3650;1367;4199
230185;201408;4331;14381;3964;13702;690;2387;2524;9077;3214;11464
230190;201408;12913;42313;11779;40039;2523;9600;6195;20757;8718;30357
230195;201408;5161;16095;4643;15262;340;1463;3638;11577;3978;13040
230200;201408;5874;17134;5275;15977;653;2098;3765;11393;4418;13491
230205;201408;4492;14153;4004;13324;323;1372;2915;9670;3238;11042
230210;201408;9589;27629;8373;25715;2149;6662;4557;14475;6706;21137
230220;201408;14135;41216;12814;38933;1692;5806;8943;26803;10635;32609
230230;201408;7732;25364;6914;23683;1037;3773;4403;15206;5440;18979
230240;201408;13801;39982;12342;37385;822;3116;9622;28557;10444;31673
230250;201408;10365;32126;10146;31804;508;1895;8615;26897;9123;28792
230260;201408;15232;51545;14134;49307;2954;10812;8046;28705;11000;39517
230270;201408;6990;21394;6147;19909;694;2437;4486;14620;5180;17057
230280;201408;19340;58881;17400;55498;2228;7221;12471;40108;14699;47329
230290;201408;4854;15144;4215;13843;575;1934;2884;9527;3459;11461
230300;201408;4937;15167;4709;14823;517;1873;3566;11092;4083;12965
230310;201408;5012;15071;4380;14005;373;1500;3235;10118;3608;11618
230320;201408;7571;24346;7028;23387;770;2911;5231;17419;6001;20330
230330;201408;4853;14491;4294;13421;356;1307;3127;9642;3483;10949
230340;201408;3520;12238;3284;11727;506;2030;2094;7344;2600;9374
230350;201408;18695;57676;16860;54492;2752;9562;10707;35099;13459;44661
230360;201408;3188;9354;2676;8396;320;1134;1859;5760;2179;6894
230365;201408;3130;8827;2735;8178;169;615;2161;6417;2330;7032
230370;201408;57764;190310;53150;182152;15746;55813;25679;91066;41425;146879
230380;201408;7266;21155;6191;19294;565;1989;4404;13733;4969;15722
230390;201408;3743;11788;3317;11074;377;1546;2327;7654;2704;9200
230393;201408;3431;11442;2938;10400;304;1426;2057;7026;2361;8452
230395;201408;5173;16187;4778;15440;719;2551;3131;10145;3850;12696
230400;201408;5357;16647;4638;15541;355;1551;3607;11833;3962;13384
230410;201408;15966;50649;14249;47315;2441;8679;8519;28331;10960;37010
230420;201408;25368;83440;23238;79026;5699;21062;11585;39182;17284;60244
230423;201408;4946;16054;4573;15333;526;1960;3175;10813;3701;12773
230425;201408;5619;18891;5117;17743;737;2753;3425;11863;4162;14616
230426;201408;2897;8129;2346;7100;160;658;1732;5101;1892;5759
230427;201408;1804;5529;1371;4590;146;563;915;2956;1061;3519
230428;201408;9409;30768;9115;30254;1746;6473;5818;19126;7564;25599
230430;201408;4651;15068;4387;14555;446;1778;3161;10307;3607;12085
230435;201408;5199;16936;4659;15984;975;3736;2494;8586;3469;12322
230440;201408;368318;1142200;344225;1098623;87600;298978;172275;552445;259875;851423
230445;201408;4837;13093;4081;11983;355;1029;3061;9165;3416;10194
230450;201408;3803;12174;3252;11176;460;1827;2107;7218;2567;9045
230460;201408;1953;6519;1769;6175;200;804;1257;4365;1457;5169
230465;201408;4310;12926;3520;11484;313;1331;2397;7622;2710;8953
230470;201408;11480;42060;10971;41010;1470;5758;7855;29892;9325;35650
230480;201408;1507;4880;1298;4474;200;737;834;2895;1034;3632
230490;201408;2928;8639;2547;7930;475;1658;1339;4085;1814;5743
230495;201408;5850;19704;5301;18785;890;3717;3122;11062;4012;14779
230500;201408;10826;37020;10338;36161;947;3650;7847;28024;8794;31674
230510;201408;1537;5523;1242;4759;311;1291;469;1855;780;3146
230520;201408;5121;15654;4496;14540;496;1892;3054;9803;3550;11695
230523;201408;14511;48215;13048;44820;3639;13678;3895;13624;7534;27302
230526;201408;4240;13056;3739;12184;397;1520;2697;8767;3094;10287
230530;201408;5502;18256;5022;17603;986;3552;3409;12142;4395;15694
230533;201408;4081;11671;3640;10837;272;908;2825;8325;3097;9233
230535;201408;5562;16611;4850;15323;568;1847;3414;10984;3982;12831
230540;201408;19495;56036;17263;52690;1061;3929;14229;43081;15290;47010
230550;201408;19423;59308;17587;55714;3770;12841;9509;29979;13279;42820
230560;201408;6691;19471;5977;18181;275;1105;4825;14502;5100;15607
230565;201408;3382;9722;2728;8431;220;797;1945;5925;2165;6722
230570;201408;4038;11047;3587;10479;239;865;2977;8601;3216;9466
230580;201408;10681;32781;10080;31924;611;1988;8717;27884;9328;29872
230590;201408;8995;28622;7932;26594;652;2766;5946;19486;6598;22252
230600;201408;3645;10367;2737;8481;202;708;1827;5601;2029;6309
230610;201408;6301;20636;5878;19945;785;2855;4213;14444;4998;17299
230620;201408;2140;6113;1740;5252;169;599;1096;3195;1265;3794
230625;201408;7973;26316;7141;24410;2120;7799;2338;8041;4458;15840
230630;201408;11504;37392;10506;35484;2680;8656;5244;18886;7924;27542
230640;201408;27715;91734;25930;89040;3521;12886;19106;66175;22627;79061
230650;201408;5064;15889;4575;14940;382;1596;3473;11070;3855;12666
230655;201408;8884;33813;8540;33233;704;2839;7164;28261;7868;31100
230660;201408;6495;20354;5691;18892;529;2080;4119;13731;4648;15811
230670;201408;6094;16590;4927;14580;282;1078;3831;10991;4113;12069
230680;201408;2853;8406;2391;7535;368;1244;1456;4583;1824;5827
230690;201408;6304;20891;6171;20635;516;2167;4503;14747;5019;16914
230700;201408;9460;27539;8389;25604;840;3153;5899;17460;6739;20613
230710;201408;7710;25183;6828;23553;852;3000;4909;17249;5761;20249
230720;201408;1997;6287;1724;5761;234;829;1150;3897;1384;4726
230725;201408;3802;12869;3354;11765;742;2762;1664;5767;2406;8529
230730;201408;58436;179800;49256;164860;13639;49531;20519;70048;34158;119579
230740;201408;5694;17759;5267;17001;292;1275;4371;13887;4663;15162
230750;201408;9274;26653;7860;24376;703;2530;5981;18444;6684;20974
230760;201408;9728;29864;9271;28822;1000;3791;6785;20293;7785;24084
230763;201408;4298;13605;3981;12975;288;1344;3053;9592;3341;10936
230765;201408;42591;140033;39399;133468;12465;45133;14211;48799;26676;93932
230770;201408;24293;68352;22454;65732;2313;7481;16619;48635;18932;56116
230780;201408;6167;24154;5865;23455;1510;6102;2961;12594;4471;18696
230790;201408;2637;8941;2494;8697;299;1123;1897;6669;2196;7792
230800;201408;8083;28999;7371;27385;1756;6972;3547;13232;5303;20204
230810;201408;12796;41822;12160;40737;1328;4611;9399;31977;10727;36588
230820;201408;3532;12006;3111;11081;563;2259;1761;6256;2324;8515
230830;201408;8007;24392;7143;22814;778;2842;4995;15887;5773;18729
230835;201408;4233;11505;3558;10553;315;1057;2760;8141;3075;9198
230837;201408;3194;10945;2761;10056;340;1425;1881;6830;2221;8255
230840;201408;9591;31762;8774;30307;1114;4141;6262;21959;7376;26100
230850;201408;11525;35039;10678;33875;1334;4649;7879;25034;9213;29683
230860;201408;5221;15546;4743;14719;367;1361;3667;11293;4034;12654
230870;201408;19402;53572;17404;50301;1540;5063;13219;37949;14759;43012
230880;201408;1975;6850;1837;6570;243;1011;1218;4333;1461;5344
230890;201408;4197;15214;3826;14432;565;2504;2449;9076;3014;11580
230900;201408;3032;10201;2632;9356;575;2008;1362;4979;1937;6987
230910;201408;3090;9217;2493;8088;225;898;1785;5677;2010;6575
230920;201408;4829;14146;4438;13662;304;1026;3734;11647;4038;12673
230930;201408;7948;24332;7127;22790;867;2927;4951;15926;5818;18853
230940;201408;7759;22294;6821;20883;435;1383;5557;17128;5992;18511
230945;201408;6083;18383;5215;17118;576;2117;3682;12264;4258;14381
230950;201408;7163;19605;6150;18243;423;1339;4842;14459;5265;15798
230960;201408;12998;41632;11954;39599;2579;9287;6111;20308;8690;29595
230970;201408;13897;44263;12526;41585;2731;10195;6101;19899;8832;30094
230980;201408;3020;9771;2624;8987;824;2861;1191;4255;2015;7116
230990;201408;1636;5093;1354;4507;154;642;888;2881;1042;3523
231000;201408;2920;7933;2303;6751;267;902;1477;4208;1744;5110
231010;201408;3259;9050;2785;8293;259;1011;2124;6182;2383;7193
231020;201408;8282;27742;7817;26799;1415;5046;4891;17105;6306;22151
231025;201408;8045;25351;7267;23987;1174;3985;4700;15897;5874;19882
231030;201408;8170;26940;6920;24326;1326;5040;4009;14208;5335;19248
231040;201408;3081;10178;2756;9512;250;1061;1957;6622;2207;7683
231050;201408;12496;36217;10778;33081;1052;3676;7864;24020;8916;27696
231060;201408;2476;7975;2268;7598;201;917;1628;5286;1829;6203
231070;201408;9512;30168;8720;28601;1629;5652;5248;17312;6877;22964
231080;201408;4384;13779;4022;13125;253;1156;3031;9556;3284;10712
231085;201408;4892;15770;4742;15528;724;2343;3457;11640;4181;13983
231090;201408;4145;11763;3373;10218;190;717;2461;7330;2651;8047
231095;201408;2265;7551;1956;6918;230;902;1322;4730;1552;5632
231100;201408;3103;9731;2601;8725;235;923;1871;6189;2106;7112
231110;201408;3821;12797;3731;12640;394;1501;2743;9327;3137;10828
231120;201408;2434;7973;2259;7662;385;1359;1464;5035;1849;6394
231123;201408;2249;6145;1912;5584;165;465;1508;4440;1673;4905
231126;201408;6844;18998;5559;17106;429;1618;4169;12652;4598;14270
231130;201408;20625;64616;18848;61513;4422;14817;10545;35832;14967;50649
231135;201408;4740;13929;3982;12739;406;1550;2919;9178;3325;10728
231140;201408;16102;52425;14651;49543;1469;6647;10052;32751;11521;39398
231150;201408;6081;17738;5197;16072;943;3224;2841;8583;3784;11807
231160;201408;6067;20632;5738;19989;1157;4282;3642;12702;4799;16984
231170;201408;4860;15605;4437;14734;519;2042;3001;9818;3520;11860
231180;201408;14116;42975;12811;40410;2166;7527;8086;25125;10252;32652
231190;201408;5132;14348;4280;13118;333;1204;3309;10018;3642;11222
231195;201408;4675;15972;4043;14706;410;1765;2930;10648;3340;12413
231200;201408;7831;27173;6856;25153;646;3070;4893;17579;5539;20649
231210;201408;5281;16292;4559;15265;325;1384;3527;11886;3852;13270
231220;201408;14420;41014;12264;37294;1237;4408;8172;24844;9409;29252
231230;201408;8998;31571;8411;30548;927;3937;6392;23133;7319;27070
231240;201408;12292;39282;11036;36922;2023;7396;6250;21165;8273;28561
231250;201408;2052;6009;1422;4474;302;945;562;1709;864;2654
231260;201408;4083;11664;3683;11095;520;1583;2478;7674;2998;9257
231270;201408;7836;22028;6926;20564;649;2543;5059;14592;5708;17135
231280;201408;1765;5824;1645;5587;159;571;1213;4152;1372;4723
231290;201408;32530;114375;29565;107240;6868;27768;13108;46459;19976;74227
231300;201408;4749;13894;3864;12100;336;1286;2749;8346;3085;9632
231310;201408;7738;22338;6506;19805;1228;3884;3584;10801;4812;14685
231320;201408;6873;21455;5946;19645;363;1490;4437;14599;4800;16089
231325;201408;2622;8019;2325;7507;171;662;1749;5642;1920;6304
231330;201408;14403;44832;12148;40501;2022;6854;7525;25423;9547;32277
231335;201408;5268;15304;4594;14074;324;1262;3638;10907;3962;12169
231340;201408;18359;60418;17184;58741;1390;4643;13948;48951;15338;53594
231350;201408;12947;43242;12647;42779;1442;4615;10188;35264;11630;39879
231355;201408;4318;14251;4123;13918;271;987;3387;11553;3658;12540
231360;201408;7481;24788;6838;23629;1619;5465;4059;14621;5678;20086
231370;201408;2465;6977;1967;6201;113;428;1492;4644;1605;5072
231375;201408;4122;14410;3912;14002;355;1583;3061;10808;3416;12391
231380;201408;5383;17572;5065;17121;781;2774;3482;12061;4263;14835
231390;201408;3522;11170;3317;10849;277;1137;2503;8090;2780;9227
231395;201408;4283;13830;3825;13078;751;2686;2297;8000;3048;10686
231400;201408;10628;31861;9675;30120;1011;3609;6737;21029;7748;24638
231410;201408;13723;47152;12840;45809;1220;4547;10009;36316;11229;40863
240010;201408;2568;7979;2229;7259;538;1942;1001;3137;1539;5079
240020;201408;12046;37928;10739;35435;2782;9740;5104;17130;7886;26870
240030;201408;2667;7805;2584;7671;220;770;2066;6049;2286;6819
240040;201408;835;2515;710;2265;49;228;511;1551;560;1779
240050;201408;3828;10443;3285;9511;230;802;2501;7145;2731;7947
240060;201408;1481;4447;1386;4277;135;498;1067;3204;1202;3702
240070;201408;2934;8521;2790;8253;483;1498;1815;5312;2298;6810
240080;201408;3184;8576;2804;8087;272;732;2174;6414;2446;7146
240090;201408;2329;6377;1970;5708;76;304;1570;4449;1646;4753
240100;201408;10610;30458;9769;28802;1288;4466;6115;17808;7403;22274
240110;201408;5255;16130;4669;15055;854;3092;2807;8736;3661;11828
240120;201408;3090;10283;2960;10041;548;2003;1891;6552;2439;8555
240130;201408;2893;7898;2490;7278;207;724;1940;5593;2147;6317
240140;201408;2288;6976;2019;6480;399;1465;1119;3514;1518;4979
240145;201408;6329;19943;5712;18842;1498;5466;2951;9735;4449;15201
240150;201408;1040;3146;855;2777;114;453;518;1622;632;2075
240160;201408;1424;4658;1260;4373;177;680;793;2811;970;3491
240165;201408;960;3074;837;2820;108;363;545;1887;653;2250
240170;201408;2573;7771;2288;7242;626;2128;1007;3190;1633;5318
240180;201408;3031;9505;2818;9130;722;2426;1476;4967;2198;7393
240185;201408;1513;5048;1460;4950;164;570;1107;3835;1271;4405
240190;201408;931;2875;854;2727;60;261;654;2029;714;2290
240200;201408;14319;37179;11938;34163;2502;7301;6899;20494;9401;27795
240210;201408;2851;8156;2627;7848;223;773;2170;6421;2393;7194
240220;201408;7397;24105;7027;23585;392;1761;6106;20253;6498;22014
240230;201408;5774;16139;5212;15192;438;1429;4120;11890;4558;13319
240240;201408;1909;5918;1415;4636;387;1384;305;879;692;2263
240250;201408;2921;8448;2764;8226;219;734;2236;6612;2455;7346
240260;201408;15142;50864;14417;49670;2495;9540;9385;32472;11880;42012
240270;201408;2477;8001;2300;7714;246;824;1718;5899;1964;6723
240280;201408;1696;4827;1518;4517;130;456;1129;3325;1259;3781
240290;201408;1452;4563;1249;4190;119;568;811;2616;930;3184
240300;201408;2216;6260;1585;4864;414;1360;548;1621;962;2981
240310;201408;10684;30514;9707;28925;2135;6897;5263;15677;7398;22574
240320;201408;2092;6272;1707;5462;114;488;1239;3829;1353;4317
240325;201408;39547;109742;31068;95691;9902;32795;9424;29682;19326;62477
240330;201408;1587;4801;1343;4314;159;637;848;2635;1007;3272
240340;201408;1806;5250;1557;4856;202;674;1110;3467;1312;4141
240350;201408;2203;6622;2060;6419;217;776;1673;5172;1890;5948
240360;201408;7534;22779;6599;21392;1227;4194;4063;13538;5290;17732
240370;201408;2083;5736;1784;5221;161;529;1281;3755;1442;4284
240375;201408;914;2419;810;2266;160;507;478;1295;638;1802
240380;201408;2734;8148;2219;7000;312;1047;1292;4034;1604;5081
240390;201408;988;2736;834;2440;79;293;599;1703;678;1996
240400;201408;1517;4078;1285;3713;151;517;932;2608;1083;3125
240410;201408;555;1798;508;1700;83;325;327;1080;410;1405
240420;201408;4989;18957;4773;18466;1340;5107;2482;10201;3822;15308
240430;201408;3663;10462;3377;9972;334;1126;2497;7302;2831;8428
240440;201408;2837;7568;2597;7149;662;1848;1371;3808;2033;5656
240450;201408;3628;10979;3239;10233;365;1474;2179;6652;2544;8126
240460;201408;3045;9482;2903;9287;277;1043;2325;7364;2602;8407
240470;201408;3679;11364;2962;9842;389;1425;1837;6054;2226;7479
240480;201408;462;1211;390;1059;43;116;237;629;280;745
240485;201408;2154;6621;1900;6137;371;1289;1089;3540;1460;4829
240490;201408;1740;4416;1491;4045;88;325;1178;3074;1266;3399
240500;201408;2218;6571;2076;6345;208;705;1583;4836;1791;5541
240510;201408;1863;5628;1723;5375;216;684;1289;4080;1505;4764
240520;201408;1475;4291;1292;4025;197;690;896;2735;1093;3425
240530;201408;2269;7205;2038;6838;282;987;1443;4872;1725;5859
240540;201408;1863;5711;1784;5576;168;596;1355;4234;1523;4830
240550;201408;831;2367;720;2178;62;214;549;1623;611;1837
240560;201408;3335;9762;3157;9493;309;939;2558;7735;2867;8674
240570;201408;3184;9049;2574;7690;591;1957;1101;3004;1692;4961
240580;201408;8354;25768;7856;24915;1133;3828;5834;18428;6967;22256
240590;201408;846;2379;735;2175;55;212;539;1550;594;1762
240600;201408;1593;4715;1259;4025;173;657;721;2200;894;2857
240610;201408;5137;14451;4454;13182;641;2030;2738;7956;3379;9986
240615;201408;1060;3086;878;2734;156;516;492;1527;648;2043
240620;201408;1766;5700;1614;5435;185;708;1240;4161;1425;4869
240630;201408;2134;6518;2009;6300;213;587;1490;4898;1703;5485
240640;201408;969;2850;814;2590;98;397;544;1694;642;2091
240650;201408;3950;12071;3633;11610;299;1065;2910;9363;3209;10428
240660;201408;2567;8186;2440;7987;272;959;1848;6105;2120;7064
240670;201408;2808;8400;2372;7507;358;1268;1343;4155;1701;5423
240680;201408;1544;4564;1254;4037;143;509;783;2530;926;3039
240690;201408;1136;3175;985;2934;106;374;719;2115;825;2489
240700;201408;2696;8141;2257;7310;122;571;1748;5511;1870;6082
240710;201408;18945;48811;16787;45959;3196;8581;10515;29783;13711;38364
240720;201408;5864;16778;5558;16328;1710;5359;2704;7815;4414;13174
240725;201408;1087;3278;843;2734;86;306;489;1550;575;1856
240730;201408;2388;7251;2078;6682;219;768;1463;4694;1682;5462
240740;201408;2273;6822;2041;6399;272;913;1339;4204;1611;5117
240750;201408;2316;8598;2127;8248;450;1917;1195;4709;1645;6626
240760;201408;1311;3793;1224;3674;119;294;955;3054;1074;3348
240770;201408;3673;10588;3316;10065;379;1283;2447;7443;2826;8726
240780;201408;6049;16846;4877;14988;862;2797;2847;8919;3709;11716
240790;201408;878;2725;715;2432;51;217;530;1805;581;2022
240800;201408;42084;122043;38196;115354;10815;34302;16396;50370;27211;84672
240810;201408;100162;297077;93961;285950;28183;88406;45078;139345;73261;227751
240820;201408;7102;21196;6111;19624;1281;4483;3115;10395;4396;14878
240830;201408;9648;29554;9050;28694;701;2335;7454;24002;8155;26337
240840;201408;1325;3697;1142;3388;148;506;687;2011;835;2517
240850;201408;1320;3939;973;3192;179;667;522;1647;701;2314
240860;201408;1373;3881;1154;3507;100;352;852;2537;952;2889
240870;201408;1196;3334;1016;2986;129;455;661;1840;790;2295
240880;201408;1213;4146;1147;4048;149;618;828;2893;977;3511
240890;201408;5558;15740;4795;14370;959;3159;2447;7220;3406;10379
240895;201408;2842;9719;2573;9229;349;1338;1785;6509;2134;7847
240910;201408;2799;8781;2541;8298;230;897;1904;6155;2134;7052
240920;201408;883;2839;789;2623;223;801;342;1099;565;1900
240930;201408;3745;10039;3365;9547;307;889;2665;7674;2972;8563
240933;201408;1539;4479;1368;4187;220;769;847;2588;1067;3357
240940;201408;6796;19070;5701;17163;1080;3439;3193;9577;4273;13016
240950;201408;1211;3762;1141;3644;114;449;815;2595;929;3044
240960;201408;823;2567;731;2388;93;344;516;1675;609;2019
240970;201408;1992;5587;1658;5010;131;476;1229;3622;1360;4098
240980;201408;3392;11108;3157;10668;665;2430;1930;6500;2595;8930
240990;201408;3117;9285;2927;8906;537;1802;1830;5449;2367;7251
241000;201408;1108;3106;962;2855;81;284;702;2051;783;2335
241010;201408;3091;10287;2797;9746;421;1747;1934;6543;2355;8290
241020;201408;2173;6144;1799;5417;151;544;1150;3328;1301;3872
241025;201408;1564;4841;1409;4540;111;473;1013;3187;1124;3660
241030;201408;2589;8541;2332;8076;200;776;1799;6269;1999;7045
241040;201408;2273;7863;2079;7504;221;922;1509;5494;1730;6416
241050;201408;1385;4110;1240;3865;111;442;921;2793;1032;3235
241060;201408;1016;2930;924;2775;111;356;673;2027;784;2383
241070;201408;950;2706;828;2487;97;347;574;1667;671;2014
241080;201408;1224;3642;1047;3311;92;381;731;2237;823;2618
241090;201408;2182;6335;1870;5776;122;520;1508;4582;1630;5102
241100;201408;1229;3677;1057;3288;121;401;678;2079;799;2480
241105;201408;1183;3626;1113;3493;202;691;646;2090;848;2781
241110;201408;875;2788;732;2471;79;345;455;1502;534;1847
241120;201408;7989;24238;7288;23118;1454;4651;4761;15507;6215;20158
241140;201408;3559;9940;3148;9131;409;1256;2156;6172;2565;7428
241142;201408;709;2135;515;1711;137;518;152;462;289;980
241150;201408;5955;17764;5383;16797;834;2752;3626;11439;4460;14191
241160;201408;1136;3305;1068;3175;169;542;744;2204;913;2746
241170;201408;1391;4094;1274;3879;177;588;796;2523;973;3111
241180;201408;992;2778;783;2353;100;332;448;1306;548;1638
241190;201408;1166;3240;962;2830;79;303;638;1769;717;2072
241200;201408;21456;64074;19749;61318;5236;17051;10003;31676;15239;48727
241210;201408;1579;4579;1318;4045;276;937;647;1957;923;2894
241220;201408;8132;27379;7717;26573;1877;6695;4279;15068;6156;21763
241230;201408;3174;9416;2903;9020;218;838;2364;7263;2582;8101
241240;201408;1154;3387;869;2766;107;365;473;1549;580;1914
241250;201408;5715;18054;4900;16445;312;1522;3906;12781;4218;14303
241255;201408;1866;7141;1767;6919;454;1875;822;3339;1276;5214
241260;201408;5211;14107;4207;12545;340;1302;3030;8849;3370;10151
241270;201408;2106;6351;1847;5854;252;882;1115;3558;1367;4440
241280;201408;2181;6362;2025;6057;315;1017;1349;4054;1664;5071
241290;201408;3368;9327;2702;8268;465;1489;1649;5056;2114;6545
241300;201408;1478;4283;1311;4002;82;261;1012;3131;1094;3392
241310;201408;1571;4951;1492;4826;218;689;1050;3510;1268;4199
241320;201408;954;3193;881;3036;155;580;517;1790;672;2370
241330;201408;1566;4940;1449;4788;145;561;1180;3882;1325;4443
241335;201408;2712;8334;2552;8056;180;593;2147;6794;2327;7387
241340;201408;1995;6186;1766;5689;437;1535;862;2737;1299;4272
241350;201408;1954;6282;1818;6018;181;783;1364;4370;1545;5153
241355;201408;1342;3786;1155;3473;64;208;1012;3032;1076;3240
241360;201408;2208;6091;1915;5540;139;472;1395;3882;1534;4354
241370;201408;1364;4222;1107;3680;192;690;582;1907;774;2597
241380;201408;743;2147;638;1936;108;371;356;1081;464;1452
241390;201408;3019;9990;2827;9629;551;1989;1830;6334;2381;8323
241400;201408;3763;11142;3497;10771;404;1402;2660;8239;3064;9641
241410;201408;2792;8198;2503;7807;376;1275;1792;5604;2168;6879
241415;201408;1676;5119;1546;4895;107;421;1182;3687;1289;4108
241420;201408;2297;7967;2004;7456;673;2797;665;2407;1338;5204
241430;201408;526;1589;432;1375;54;196;280;863;334;1059
241440;201408;6127;22326;5729;21645;1067;4217;3920;15022;4987;19239
241445;201408;1055;3232;995;3143;143;369;767;2574;910;2943
241450;201408;3355;9312;3039;8853;453;1459;2145;6205;2598;7664
241460;201408;3673;10725;3259;9922;280;1025;2335;7035;2615;8060
241470;201408;1388;3918;1177;3664;128;510;871;2653;999;3163
241475;201408;1260;3932;1108;3651;73;351;805;2589;878;2940
241480;201408;3338;10801;3020;10320;1044;3563;1174;4440;2218;8003
241490;201408;651;1749;534;1564;55;211;366;1025;421;1236
241500;201408;757;2396;691;2301;42;183;593;1941;635;2124
250010;201408;2790;8745;2447;8143;232;960;1829;5953;2061;6913
250020;201408;1700;4901;1305;4187;109;486;861;2643;970;3129
250030;201408;8240;23312;7459;22219;854;2581;5716;17326;6570;19907
250040;201408;4619;15493;4268;14785;768;2818;2658;9283;3426;12101
250050;201408;3769;11790;3543;11463;475;1720;2527;8276;3002;9996
250053;201408;1360;4008;1258;3877;203;643;840;2613;1043;3256
250057;201408;710;2809;692;2788;36;102;614;2605;650;2707
250060;201408;5136;16134;4908;15778;649;2346;3744;11880;4393;14226
250070;201408;3890;12183;3642;11742;223;993;3031;9500;3254;10493
250073;201408;800;2437;713;2277;72;266;527;1677;599;1943
250077;201408;2334;6831;1954;6224;270;944;1159;3723;1429;4667
250080;201408;4828;14109;4670;13885;562;1725;3530;10553;4092;12278
250090;201408;2613;7798;2512;7638;133;465;2123;6363;2256;6828
250100;201408;4058;13603;3870;13268;445;1728;2964;10121;3409;11849
250110;201408;5885;17765;5625;17399;753;2627;4263;13083;5016;15710
250115;201408;554;1801;485;1636;40;202;287;903;327;1105
250120;201408;2269;6732;1957;6143;190;682;1446;4516;1636;5198
250130;201408;5807;17793;5472;17324;333;1156;4600;14755;4933;15911
250135;201408;1104;3383;1011;3221;117;407;706;2263;823;2670
250140;201408;2164;7025;1998;6802;225;829;1515;5235;1740;6064
250150;201408;5125;17285;4694;16461;482;2019;3417;11858;3899;13877
250153;201408;1596;4257;1431;4019;123;429;1111;3109;1234;3538
250157;201408;1765;5994;1621;5689;310;1128;1012;3610;1322;4738
250160;201408;3409;10552;3307;10385;208;727;2847;9019;3055;9746
250170;201408;1654;4879;1537;4692;293;926;990;3097;1283;4023
250180;201408;17113;53075;16532;52097;2366;8649;11864;36481;14230;45130
250190;201408;4102;12104;3797;11590;629;2047;2499;7514;3128;9561
250200;201408;2275;6291;1815;5661;139;513;1493;4616;1632;5129
250205;201408;1029;3370;935;3189;94;427;608;2117;702;2544
250210;201408;1675;5430;1551;5246;189;782;1117;3716;1306;4498
250215;201408;1450;4964;1410;4890;210;813;900;3137;1110;3950
250220;201408;838;2378;692;2192;44;158;592;1862;636;2020
250230;201408;1784;4502;1447;3949;131;418;1137;3016;1268;3434
250240;201408;2725;8684;2406;8190;203;733;1845;6365;2048;7098
250250;201408;4669;14042;4278;13512;375;1213;3495;11164;3870;12377
250260;201408;1929;5875;1678;5455;150;592;1248;4018;1398;4610
250270;201408;1346;4208;1199;4022;153;531;907;3099;1060;3630
250280;201408;3847;11581;3546;11101;670;2156;2301;7482;2971;9638
250290;201408;2152;5746;1773;5255;66;249;1557;4609;1623;4858
250300;201408;5593;16506;5296;16134;616;2516;4242;12368;4858;14884
250310;201408;1180;3740;1069;3553;148;568;784;2578;932;3146
250320;201408;8123;25605;7721;24782;1088;3958;5261;16443;6349;20401
250330;201408;2658;8321;2308;7840;264;1029;1751;5914;2015;6943
250340;201408;1159;3375;1071;3235;54;179;918;2777;972;2956
250350;201408;4625;12622;4206;12110;188;611;3684;10736;3872;11347
250355;201408;2182;6683;1982;6387;153;645;1533;4864;1686;5509
250360;201408;2085;6236;1938;6032;115;431;1541;4819;1656;5250
250370;201408;13764;39100;11894;36866;1188;3896;9842;30671;11030;34567
250375;201408;1122;3545;1055;3433;64;254;889;2890;953;3144
250380;201408;1713;4874;1614;4748;96;325;1411;4145;1507;4470
250390;201408;1950;5245;1589;4640;217;649;1049;3098;1266;3747
250400;201408;73685;202235;63142;185715;15416;47770;32978;98919;48394;146689
250403;201408;1590;5220;1493;5084;197;774;1096;3697;1293;4471
250407;201408;1201;3464;1045;3199;69;224;821;2490;890;2714
250410;201408;685;2187;603;2040;69;289;457;1528;526;1817
250415;201408;1840;5789;1674;5467;144;552;1226;3938;1370;4490
250420;201408;1345;4177;1243;4019;99;399;1027;3249;1126;3648
250430;201408;6795;19014;6350;18362;504;1766;5190;14718;5694;16484
250435;201408;1676;5052;1490;4692;224;819;874;2793;1098;3612
250440;201408;4703;13842;4407;13434;312;975;3633;11175;3945;12150
250450;201408;2101;5995;1862;5680;98;337;1660;5071;1758;5408
250460;201408;6554;19784;6082;19145;744;2506;4590;14582;5334;17088
250470;201408;1632;4539;1467;4305;150;536;1050;2985;1200;3521
250480;201408;4103;12280;3702;11702;160;658;3199;10069;3359;10727
250485;201408;640;1667;541;1504;25;89;430;1155;455;1244
250490;201408;4260;13771;4156;13620;946;3268;2625;8652;3571;11920
250500;201408;1951;5923;1796;5661;381;1214;1055;3420;1436;4634
250510;201408;5025;14087;4441;13282;302;1095;3660;10895;3962;11990
250520;201408;1930;5960;1828;5785;328;1175;1093;3378;1421;4553
250523;201408;1835;5793;1745;5668;249;855;1278;4198;1527;5053
250527;201408;1514;4557;1424;4440;61;258;1281;3952;1342;4210
250530;201408;696;2116;611;2007;50;167;499;1673;549;1840
250535;201408;1338;4268;1272;4133;84;363;1006;3209;1090;3572
250540;201408;2497;7463;2340;7289;78;240;2156;6797;2234;7037
250550;201408;910;3054;837;2941;66;277;645;2239;711;2516
250560;201408;1808;5773;1770;5717;144;504;1506;4884;1650;5388
250570;201408;2563;8389;2297;7866;201;801;1741;5906;1942;6707
250580;201408;1197;3254;977;2905;106;432;697;1969;803;2401
250590;201408;1060;3253;954;3112;89;365;740;2374;829;2739
250600;201408;7188;21149;6827;20614;489;1426;5709;17451;6198;18877
250610;201408;3543;10369;3274;9964;397;1322;2349;7150;2746;8472
250620;201408;870;2526;805;2397;156;510;499;1461;655;1971
250625;201408;2282;7380;2248;7335;80;203;2091;6922;2171;7125
250630;201408;10649;34177;10099;33204;2258;7924;5826;19216;8084;27140
250640;201408;3944;11740;3688;11438;287;1079;3108;9531;3395;10610
250650;201408;962;2814;890;2678;131;461;523;1590;654;2051
250660;201408;2152;5334;1644;4726;25;66;1565;4523;1590;4589
250670;201408;2804;9346;2662;9082;272;1118;1989;6755;2261;7873
250680;201408;5064;14526;4821;14183;269;906;4167;12294;4436;13200
250690;201408;6474;17222;6241;16914;576;1722;5323;14289;5899;16011
250700;201408;5463;16320;5070;15745;784;2632;3497;10756;4281;13388
250710;201408;4747;14940;4353;14426;663;2222;3054;10417;3717;12639
250720;201408;2663;7930;2533;7710;145;578;2132;6429;2277;7007
250730;201408;3784;11690;3599;11417;449;1606;2674;8403;3123;10009
250740;201408;2088;6146;1830;5712;197;714;1332;4090;1529;4804
250750;201408;105419;310939;99186;301355;17551;58376;65835;197832;83386;256208
250760;201408;2313;6812;2139;6553;187;692;1671;5067;1858;5759
250770;201408;4115;13994;3895;13693;727;2768;2493;8828;3220;11596
250780;201408;1939;5770;1670;5269;204;791;1077;3282;1281;4073
250790;201408;2523;8235;2389;8043;553;1805;1535;5357;2088;7162
250800;201408;2855;8201;2491;7580;152;558;1937;5770;2089;6328
250810;201408;1396;4098;1207;3816;117;472;953;2948;1070;3420
250820;201408;2108;6420;2027;6304;125;416;1710;5382;1835;5798
250830;201408;6075;20155;5723;19447;782;3093;3914;13090;4696;16183
250840;201408;1051;3373;917;3100;119;451;589;2003;708;2454
250850;201408;2466;7163;2191;6715;219;856;1438;4566;1657;5422
250855;201408;1113;3384;1047;3280;91;332;830;2548;921;2880
250860;201408;3041;10157;2741;9593;672;2646;1077;3706;1749;6352
250870;201408;1220;3488;1059;3223;72;284;781;2300;853;2584
250880;201408;1465;4229;1325;4033;189;600;953;2903;1142;3503
250890;201408;9983;31298;9322;30382;1578;5892;6264;20066;7842;25958
250900;201408;3132;10254;2781;9593;356;1243;1933;6779;2289;8022
250905;201408;2152;6769;2055;6642;345;1163;1483;4846;1828;6009
250910;201408;5540;16111;5168;15554;499;1666;4029;12107;4528;13773
250915;201408;1745;5186;1604;4979;143;436;1334;4215;1477;4651
250920;201408;3650;10395;3422;10075;454;1262;2488;7612;2942;8874
250930;201408;2038;6630;1947;6487;346;1317;1353;4449;1699;5766
250933;201408;1208;3920;1162;3846;128;442;859;2881;987;3323
250937;201408;878;2734;783;2539;120;462;469;1518;589;1980
250939;201408;1764;5470;1598;5198;222;785;1069;3457;1291;4242
250940;201408;4060;11930;3759;11459;250;913;2979;9133;3229;10046
250950;201408;1192;3849;1116;3745;40;136;1004;3395;1044;3531
250960;201408;1345;4185;1196;3988;90;336;972;3283;1062;3619
250970;201408;9255;25288;8252;23862;1210;3525;5758;16798;6968;20323
250980;201408;2751;8256;2512;7842;250;998;1744;5232;1994;6230
250990;201408;2187;7499;2016;7155;298;1221;1375;4820;1673;6041
251000;201408;2595;7404;2132;6736;138;505;1707;5387;1845;5892
251010;201408;2900;8432;2640;8044;188;686;2107;6469;2295;7155
251020;201408;1745;5188;1605;5010;150;517;1332;4185;1482;4702
251030;201408;1350;3763;1225;3555;127;428;810;2363;937;2791
251040;201408;1963;6232;1770;5930;190;879;1266;4083;1456;4962
251050;201408;1177;3488;1039;3239;175;582;594;1914;769;2496
251060;201408;1059;2558;847;2294;84;291;652;1697;736;1988
251065;201408;598;1789;524;1678;71;262;324;995;395;1257
251070;201408;639;1804;589;1732;64;256;456;1250;520;1506
251080;201408;21886;61333;20279;58595;5228;15728;10955;32122;16183;47850
251090;201408;3112;9839;2766;9193;279;1091;2003;6568;2282;7659
251100;201408;1023;3301;888;3032;175;697;487;1597;662;2294
251110;201408;2176;6323;1924;5868;223;736;1317;4030;1540;4766
251120;201408;6010;20787;5817;20440;743;3123;4516;15537;5259;18660
251130;201408;4067;10602;3651;10141;39;116;3527;9820;3566;9936
251140;201408;4589;14084;4258;13573;236;935;3363;10684;3599;11619
251150;201408;2882;9279;2636;8922;374;1399;1865;6380;2239;7779
251160;201408;1912;6338;1830;6223;98;389;1596;5435;1694;5824
251170;201408;1464;4516;1417;4459;127;473;1165;3624;1292;4097
251180;201408;2969;8895;2721;8571;576;1833;1630;5276;2206;7109
251190;201408;4478;12734;4342;12577;278;813;3878;11271;4156;12084
251200;201408;4240;13227;4037;12966;189;646;3585;11594;3774;12240
251203;201408;1373;4314;1285;4128;109;458;808;2705;917;3163
251207;201408;1241;3884;1076;3572;92;403;740;2382;832;2785
251210;201408;8320;23829;7269;22419;978;2961;5404;17058;6382;20019
251220;201408;1341;3618;1169;3354;183;556;765;2267;948;2823
251230;201408;5316;15960;4690;15219;429;1571;3961;12850;4390;14421
251240;201408;3247;10676;3167;10552;340;1268;2530;8406;2870;9674
251250;201408;10868;32546;10092;31352;1410;4940;7307;22420;8717;27360
251260;201408;562;1718;496;1627;39;133;370;1219;409;1352
251270;201408;4353;13545;4055;13173;166;667;3631;11819;3797;12486
251272;201408;1429;4350;1343;4228;132;432;1070;3414;1202;3846
251274;201408;1038;3248;977;3131;128;509;593;1940;721;2449
251275;201408;1445;4082;1370;3969;149;556;1014;2839;1163;3395
251276;201408;1529;4558;1445;4406;215;716;898;2826;1113;3542
251278;201408;656;2100;569;1896;87;319;341;1177;428;1496
251280;201408;2424;7615;2318;7439;262;929;1771;5652;2033;6581
251290;201408;6314;17885;5979;17467;868;2916;4349;12423;5217;15339
251300;201408;772;2670;715;2584;71;330;519;1833;590;2163
251310;201408;3399;9869;3129;9486;201;756;2516;7550;2717;8306
251315;201408;1754;6168;1695;6063;296;1113;1077;3930;1373;5043
251320;201408;2192;6154;1803;5527;151;518;1274;3964;1425;4482
251330;201408;2096;5457;1733;4982;112;450;1486;4143;1598;4593
251335;201408;1025;3520;964;3406;95;432;707;2433;802;2865
251340;201408;4017;11152;3388;10205;350;1305;2373;6976;2723;8281
251350;201408;1624;4989;1479;4782;208;741;1012;3252;1220;3993
251360;201408;1882;6129;1758;5980;121;481;1481;5082;1602;5563
251365;201408;912;2694;731;2320;59;230;475;1482;534;1712
251370;201408;23797;78558;23287;77778;3610;13798;17221;56291;20831;70089
251380;201408;1434;4442;1252;4131;95;402;987;3188;1082;3590
251385;201408;889;2475;804;2339;77;256;559;1600;636;1856
251390;201408;5955;21098;5573;20443;1180;4569;3540;13090;4720;17659
251392;201408;1096;3236;1007;3093;95;304;749;2354;844;2658
251394;201408;632;1940;521;1724;42;163;369;1208;411;1371
251396;201408;889;2545;794;2376;103;336;556;1630;659;1966
251398;201408;1143;3333;955;2984;83;305;651;2020;734;2325
251400;201408;1395;3957;1267;3785;178;668;859;2464;1037;3132
251410;201408;1664;4348;1517;4107;182;560;1042;2871;1224;3431
251420;201408;2257;6465;1920;6088;194;690;1489;4696;1683;5386
251430;201408;1763;6225;1592;5944;120;526;1308;4895;1428;5421
251440;201408;1476;4425;1249;3981;152;547;892;2814;1044;3361
251445;201408;1675;5078;1588;4950;114;430;1337;4121;1451;4551
251450;201408;4943;15468;4421;14799;185;768;3809;12756;3994;13524
251455;201408;1217;3802;1078;3573;91;367;762;2536;853;2903
251460;201408;904;2765;867;2702;125;400;670;2111;795;2511
251465;201408;505;1576;459;1484;50;185;299;953;349;1138
251470;201408;1321;3818;1090;3390;134;488;643;2011;777;2499
251480;201408;1142;3103;1028;2915;65;238;824;2294;889;2532
251490;201408;2118;6258;1837;5876;318;1179;1162;3654;1480;4833
251500;201408;1808;5928;1753;5842;189;709;1377;4540;1566;5249
251510;201408;2674;8938;2484;8525;437;1598;1534;5326;1971;6924
251520;201408;1139;3098;1026;2921;155;466;567;1638;722;2104
251530;201408;12376;35714;11849;34955;723;2641;10168;29620;10891;32261
251540;201408;2928;9553;2700;9068;258;1038;2063;6889;2321;7927
251550;201408;4052;10142;3381;9282;190;649;2774;7451;2964;8100
251560;201408;754;2331;694;2231;106;423;422;1242;528;1665
251570;201408;1094;3194;922;2834;113;427;595;1865;708;2292
251580;201408;2231;6159;2051;5915;369;934;1448;4361;1817;5295
251590;201408;1737;5726;1704;5689;116;432;1468;4963;1584;5395
251593;201408;1053;3317;995;3228;150;542;637;2011;787;2553
251597;201408;2035;6257;1957;6139;178;662;1535;4735;1713;5397
251600;201408;7561;22075;7156;21403;920;2727;5340;16319;6260;19046
251610;201408;3670;11045;3391;10674;356;1231;2614;8326;2970;9557
251615;201408;1232;3546;1050;3229;110;407;679;2133;789;2540
251620;201408;17820;50368;15664;47626;1933;6085;11714;36152;13647;42237
251630;201408;5447;13835;4742;12959;419;1175;3716;10281;4135;11456
251640;201408;2738;7890;2235;6979;228;849;1605;4963;1833;5812
251650;201408;4448;12660;3994;12083;336;1073;3268;10082;3604;11155
251660;201408;3668;12156;3360;11667;282;1286;2668;9071;2950;10357
251670;201408;4132;12272;3693;11668;84;278;3356;10682;3440;10960
251675;201408;774;2554;728;2483;167;609;411;1382;578;1991
251680;201408;2939;8203;2382;7383;141;572;1946;5934;2087;6506
251690;201408;3633;11128;3356;10621;314;1125;2439;7649;2753;8774
251700;201408;2178;7095;2052;6925;211;778;1648;5597;1859;6375
251710;201408;968;2544;723;2097;104;354;376;1060;480;1414
251720;201408;1437;4434;1313;4219;120;473;1003;3170;1123;3643
251740;201408;760;2146;616;1891;101;342;358;1106;459;1448
260005;201408;25552;63342;22435;58966;4814;12812;13642;35902;18456;48714
260010;201408;9809;26805;7871;24385;937;3107;5835;18128;6772;21235
260020;201408;5937;17410;5265;16399;558;1674;3913;12654;4471;14328
260030;201408;5432;16368;5016;15737;465;1646;3956;12320;4421;13966
260040;201408;10387;25106;8610;23097;685;1501;7074;19679;7759;21180
260050;201408;11198;35525;10395;34600;650;2271;9080;30546;9730;32817
260060;201408;4142;11500;3781;10910;357;1062;2956;8606;3313;9668
260070;201408;9843;29357;9351;28618;1925;6263;6050;18501;7975;24764
260080;201408;5419;15391;4805;14491;477;1663;3607;10702;4084;12365
260090;201408;5362;14951;5019;14470;1161;3194;3358;10010;4519;13204
260100;201408;3576;9549;3247;9104;248;853;2621;7427;2869;8280
260105;201408;4765;14104;4581;13757;762;2465;3129;9304;3891;11769
260110;201408;22286;64813;20520;62676;1411;4304;17612;54369;19023;58673
260120;201408;11544;35544;10751;34126;2926;9415;5614;18548;8540;27963
260130;201408;3188;9075;3017;8797;461;1277;2183;6524;2644;7801
260140;201408;13773;35239;11783;32789;1168;3531;9143;25808;10311;29339
260150;201408;3206;9239;2857;8738;223;808;2254;6939;2477;7747
260160;201408;6087;18565;5467;17829;518;1793;4468;14839;4986;16632
260170;201408;18059;49536;17285;48516;1499;3908;14218;40549;15717;44457
260180;201408;3566;10941;3247;10478;249;964;2640;8455;2889;9419
260190;201408;16510;39646;15516;38397;876;2335;13517;33435;14393;35770
260200;201408;11699;33221;10661;31706;1118;3526;8010;24536;9128;28062
260210;201408;11648;35866;10680;34468;880;3108;8621;28110;9501;31218
260220;201408;9537;29153;9256;28755;784;3014;7820;23806;8604;26820
260230;201408;10118;29332;9531;28543;701;2116;7800;23846;8501;25962
260240;201408;3018;9270;2625;8713;374;1331;1873;6259;2247;7590
260250;201408;2786;7483;2560;7204;192;573;2094;5930;2286;6503
260260;201408;11866;34503;11447;33913;1156;3731;9188;27735;10344;31466
260270;201408;3651;10971;3412;10617;371;1415;2623;8015;2994;9430
260280;201408;13199;43158;12132;41500;781;2930;10156;35181;10937;38111
260290;201408;35624;107746;34232;105392;5996;20495;22988;69809;28984;90304
260300;201408;8547;25983;7513;24453;561;2299;5985;19405;6546;21704
260310;201408;5225;15561;4900;15063;1532;4359;2510;8380;4042;12739
260320;201408;7074;23567;6583;22851;564;2063;5269;18607;5833;20670
260330;201408;3189;9867;2955;9481;303;1187;2008;6646;2311;7833
260340;201408;1930;5718;1818;5552;99;362;1588;4813;1687;5175
260345;201408;27137;88320;25861;85747;7569;27156;12211;39173;19780;66329
260350;201408;4315;12320;4111;11993;312;1034;3370;9768;3682;10802
260360;201408;2477;7660;2351;7446;465;1619;1460;4625;1925;6244
260370;201408;6194;19163;5611;18126;699;2474;4013;13116;4712;15590
260380;201408;5107;16608;4713;16080;502;1754;3614;12518;4116;14272
260390;201408;4821;15060;4181;14034;486;1832;2989;9872;3475;11704
260392;201408;3602;11334;3359;11020;149;572;2981;9782;3130;10354
260400;201408;14270;41866;13691;40909;2341;7991;9431;27490;11772;35481
260410;201408;64136;189359;60566;183428;20189;61485;27961;87837;48150;149322
260415;201408;4166;13214;3622;12141;508;2039;2269;7467;2777;9506
260420;201408;12471;29070;11379;27909;812;2091;9744;23975;10556;26066
260430;201408;2792;9264;2516;8824;307;1250;1829;6326;2136;7576
260440;201408;3492;10658;3217;10102;587;2005;1944;5987;2531;7992
260450;201408;5362;16078;5054;15583;434;1469;4082;12607;4516;14076
260460;201408;5939;18354;5568;17780;965;3427;3555;11145;4520;14572
260470;201408;5236;15007;4924;14576;480;1507;3981;11957;4461;13464
260480;201408;4028;11764;3581;11087;608;2107;2423;7441;3031;9548
260490;201408;6198;16031;5424;14769;625;2022;3744;10204;4369;12226
260500;201408;6913;19034;6390;18284;731;2186;4691;13600;5422;15786
260510;201408;10728;28194;9950;27132;825;2298;7936;22346;8761;24644
260515;201408;4704;14644;3679;12487;376;1467;2310;7847;2686;9314
260520;201408;16581;44678;16042;43935;3419;9162;10785;30180;14204;39342
260530;201408;10302;30855;8991;29002;571;1779;7644;25087;8215;26866
260540;201408;5968;15419;5634;15050;681;1516;4560;12578;5241;14094
260545;201408;42;162;29;119;4;19;7;27;11;46
260550;201408;2918;9688;2570;8988;644;2514;1178;4073;1822;6587
260560;201408;6876;17656;6145;16620;317;904;5373;14539;5690;15443
260570;201408;6801;23176;6299;22311;930;3632;4440;15836;5370;19468
260580;201408;3999;11046;3778;10698;290;939;3160;8790;3450;9729
260590;201408;6021;15275;5770;14981;254;566;5256;13823;5510;14389
260600;201408;26934;83289;25418;80710;4160;14105;17099;54745;21259;68850
260610;201408;7207;21590;6859;21097;1232;4014;4806;14731;6038;18745
260620;201408;17757;54806;17072;53650;3297;11560;10912;33593;14209;45153
260630;201408;2384;7048;2060;6517;217;832;1534;4792;1751;5624
260640;201408;17857;49075;16858;47666;2408;7182;12068;34168;14476;41350
260650;201408;5698;17841;5323;17206;726;2313;3654;12595;4380;14908
260660;201408;8637;23936;7757;22818;540;1666;6544;19423;7084;21089
260670;201408;2492;6969;2095;6430;291;1006;1414;4339;1705;5345
260680;201408;23807;65568;22273;62904;5016;14764;12497;35019;17513;49783
260690;201408;3700;10206;3193;9413;191;696;2614;7626;2805;8322
260700;201408;5787;17186;5649;17041;94;180;5471;16721;5565;16901
260710;201408;1361;4156;1241;3983;145;558;941;2969;1086;3527
260720;201408;17428;57523;16604;56044;4386;15096;9034;31330;13420;46426
260730;201408;7413;24337;6640;23170;911;3360;4793;16961;5704;20321
260740;201408;1367;4174;1196;3861;185;654;725;2350;910;3004
260750;201408;6822;21709;6346;21055;576;1791;5285;17918;5861;19709
260760;201408;4908;13546;4598;13140;485;1521;3597;10270;4082;11791
260765;201408;8258;28735;7982;28315;1420;5720;5371;18993;6791;24713
260770;201408;4381;11357;3991;10851;253;873;3182;8482;3435;9355
260775;201408;5385;15641;5096;15205;586;2102;3685;10669;4271;12771
260780;201408;4058;13307;3888;13014;927;3459;2268;7500;3195;10959
260790;201408;123040;317205;117989;309845;26162;70472;72942;192282;99104;262754
260795;201408;3091;9837;2867;9489;478;1684;1901;6377;2379;8061
260800;201408;4923;13347;4563;12859;222;926;3974;10872;4196;11798
260805;201408;4171;12172;3749;11510;516;1714;2592;7956;3108;9670
260810;201408;7484;21676;7296;21431;468;1506;6378;18749;6846;20255
260820;201408;4680;13364;4359;12931;1130;3421;2554;7607;3684;11028
260825;201408;3107;9952;2889;9618;307;1015;2291;7745;2598;8760
260830;201408;3799;12303;3508;11772;986;3145;1969;6964;2955;10109
260840;201408;4277;12430;3907;11898;284;1103;3231;9659;3515;10762
260845;201408;4343;12783;4042;12202;669;2146;2739;8275;3408;10421
260850;201408;5047;17160;4558;16094;1121;4445;2231;7692;3352;12137
260860;201408;3299;10537;3036;10086;293;1038;2310;7741;2603;8779
260870;201408;4265;11848;3898;11387;520;1407;2952;8870;3472;10277
260875;201408;7541;20251;6797;19075;1118;3184;4406;12745;5524;15929
260880;201408;9383;29601;8889;28919;881;2912;7261;23903;8142;26815
260890;201408;15152;43514;14414;42368;1655;5406;10664;31436;12319;36842
260900;201408;6210;19075;5294;17463;911;3250;3195;10579;4106;13829
260910;201408;3218;9554;2918;9108;245;876;2340;7338;2585;8214
260915;201408;4648;15493;4478;15251;123;416;4142;14313;4265;14729
260920;201408;3487;10630;3317;10403;481;1611;2462;7905;2943;9516
260930;201408;4280;13453;3782;12714;484;1693;2745;9346;3229;11039
260940;201408;15541;42768;14273;40599;2487;8279;8618;24057;11105;32336
260950;201408;6289;20118;5957;19471;888;3683;3755;11546;4643;15229
260960;201408;68359;191265;64694;185328;14106;42129;38117;110186;52223;152315
260970;201408;5493;17423;5107;16866;568;2204;3785;12438;4353;14642
260980;201408;4059;13006;3856;12735;264;893;3272;11037;3536;11930
260990;201408;18527;57703;17108;55811;2011;6308;13019;44190;15030;50498
261000;201408;16098;44913;13019;39950;2707;8766;7101;22337;9808;31103
261010;201408;2830;7840;2652;7614;225;467;2259;6792;2484;7259
261020;201408;6135;18288;5638;17536;435;1673;4591;13891;5026;15564
261030;201408;3555;11617;3363;11288;343;1277;2655;8871;2998;10148
261040;201408;5473;17613;4716;16347;540;2211;3404;11668;3944;13879
261050;201408;8867;25186;8271;24225;1118;3341;5730;16759;6848;20100
261060;201408;11748;36058;11246;35231;1549;5528;8284;25505;9833;31033
261070;201408;51397;131907;46305;124721;9635;26771;28029;76153;37664;102924
261080;201408;5917;17861;5576;17315;421;1243;4692;14828;5113;16071
261090;201408;16847;47002;15733;45505;1581;4672;12583;36786;14164;41458
261100;201408;7508;24058;6908;23081;771;2920;5105;17084;5876;20004
261110;201408;68391;196894;62447;188285;15368;46544;34809;110931;50177;157475
261120;201408;3747;10082;3393;9639;139;435;3010;8584;3149;9019
261130;201408;7244;18818;6927;18462;258;699;6363;16974;6621;17673
261140;201408;3323;9396;3051;8965;547;1775;1927;5569;2474;7344
261150;201408;5823;17230;5251;16399;707;2438;3768;11834;4475;14272
261153;201408;2013;5873;1691;5413;101;383;1379;4441;1480;4824
261160;201408;229125;599427;218120;584279;50078;134928;128245;353893;178323;488821
261170;201408;6194;17257;5722;16591;806;2357;4298;12581;5104;14938
261180;201408;9811;27857;9437;27297;1077;3169;7265;21177;8342;24346
261190;201408;5578;17540;5266;17136;788;3287;3653;11420;4441;14707
261200;201408;4015;9870;3719;9489;575;1444;2684;6991;3259;8435
261210;201408;2030;5340;1939;5225;134;351;1693;4632;1827;4983
261220;201408;13325;42812;11482;38782;2343;8517;5914;20027;8257;28544
261230;201408;4205;12941;3909;12557;174;624;3478;11215;3652;11839
261240;201408;5049;14878;4784;14392;785;2296;3348;10224;4133;12520
261245;201408;3940;12338;3418;11456;272;1137;2534;8544;2806;9681
261247;201408;3593;11030;3085;10082;381;1323;2186;7214;2567;8537
261250;201408;19804;53297;19012;52255;3437;9278;14007;39163;17444;48441
261255;201408;4444;13542;3980;12779;322;1154;3140;10229;3462;11383
261260;201408;12502;35665;11425;34398;697;1913;9932;30534;10629;32447
261270;201408;3869;11265;3585;10824;472;1538;2510;7551;2982;9089
261280;201408;2803;8603;2557;8244;264;959;1945;6266;2209;7225
261290;201408;3118;8850;2803;8454;218;736;2310;7033;2528;7769
261300;201408;10715;35574;9626;33676;1692;6672;6023;20952;7715;27624
261310;201408;8634;26153;8201;25426;2002;6385;4786;14941;6788;21326
261320;201408;6103;19026;5747;18359;602;1913;4406;14369;5008;16282
261330;201408;5599;16547;5391;16238;554;1693;4275;12957;4829;14650
261340;201408;4649;15207;4420;14835;671;2653;2860;9551;3531;12204
261350;201408;8207;27733;7752;26949;640;2686;6108;21058;6748;23744
261360;201408;9592;24945;8713;23752;1156;3264;6162;17105;7318;20369
261370;201408;21379;63531;20192;61713;4305;13761;12625;38789;16930;52550
261380;201408;4258;14648;3947;14097;626;2373;2658;9646;3284;12019
261390;201408;17531;53972;16015;51354;2782;9749;9956;31801;12738;41550
261400;201408;4987;17329;4550;16459;602;2438;3125;11397;3727;13835
261410;201408;8678;25239;8145;24423;1118;3394;6000;18297;7118;21691
261420;201408;8187;27488;7903;27054;2043;7573;4495;15644;6538;23217
261430;201408;3653;11356;3105;10612;402;1384;2287;8004;2689;9388
261440;201408;1706;5256;1573;5055;113;479;1275;4045;1388;4524
261450;201408;14564;41791;14182;41298;831;2527;12710;37097;13541;39624
261460;201408;8539;24676;7983;23900;822;2258;6019;19415;6841;21673
261470;201408;4031;10933;3697;10536;212;657;3197;9080;3409;9737
261480;201408;3575;13084;3328;12634;402;1711;2501;9349;2903;11060
261485;201408;5091;15720;4666;14969;942;3369;2723;8671;3665;12040
261500;201408;5939;16500;5229;15542;645;1699;4001;12430;4646;14129
261510;201408;2097;6632;1967;6438;175;575;1547;5138;1722;5713
261520;201408;2655;8672;2355;8139;197;794;1688;5860;1885;6654
261530;201408;12621;40915;11189;38118;2509;9353;5228;17816;7737;27169
261540;201408;7509;24318;7223;23802;1417;4606;4864;16390;6281;20996
261550;201408;3550;10599;3387;10361;425;1617;2658;7872;3083;9489
261560;201408;7102;23084;6496;22298;1229;4313;4512;15850;5741;20163
261570;201408;3668;11239;3248;10574;496;1684;2199;7208;2695;8892
261580;201408;5914;18708;5284;17686;474;1771;4181;14206;4655;15977
261590;201408;2927;8115;2567;7623;318;1010;1847;5586;2165;6596
261600;201408;5328;14724;4571;13669;489;1519;3448;10432;3937;11951
261610;201408;2343;7021;2034;6561;119;496;1669;5263;1788;5759
261618;201408;2607;7429;2452;7223;259;828;1931;5639;2190;6467
261620;201408;4665;14347;4416;13956;621;2015;3105;10041;3726;12056
261630;201408;8250;24201;7191;22284;1304;4589;4002;12058;5306;16647
261640;201408;30807;80425;28413;77382;2183;5798;23640;65623;25823;71421
261650;201408;3881;12290;3636;11928;522;1854;2634;8663;3156;10517
270010;201408;4585;17384;4199;16604;518;2317;2905;11556;3423;13873
270020;201408;4068;12263;3806;11859;470;1649;2872;8861;3342;10510
270030;201408;46665;140883;44357;137258;11467;35912;25613;81060;37080;116972
270040;201408;10526;32540;10001;31933;1688;4830;7436;24781;9124;29611
270050;201408;4075;11876;3782;11491;397;1440;2935;8814;3332;10254
270060;201408;1741;5668;1649;5538;357;1309;1011;3421;1368;4730
270070;201408;4269;13234;3956;12810;200;877;3411;10884;3611;11761
270080;201408;1364;4265;1222;4030;220;810;798;2587;1018;3397
270090;201408;2111;6654;2030;6514;69;266;1845;5882;1914;6148
270100;201408;6497;20171;6211;19783;1295;4342;4104;13041;5399;17383
270110;201408;3499;9880;3217;9553;544;1607;2126;6770;2670;8377
270120;201408;3136;9124;2838;8725;156;547;2459;7617;2615;8164
270130;201408;5297;16500;5007;16163;508;1481;4124;13728;4632;15209
270135;201408;1792;5045;1705;4949;122;205;1532;4622;1654;4827
270140;201408;9948;24936;8796;23445;787;3004;6965;17445;7752;20449
270150;201408;2749;9417;2685;9334;205;792;2335;8126;2540;8918
270160;201408;5147;17227;4737;16719;299;1099;4027;14317;4326;15416
270170;201408;4136;13518;3818;13051;817;3229;2174;7333;2991;10562
270180;201408;2339;7736;2078;7402;157;725;1674;5918;1831;6643
270190;201408;1957;6403;1857;6253;147;590;1467;4955;1614;5545
270200;201408;2785;9379;2605;9090;275;1172;1985;6793;2260;7965
270210;201408;4613;14812;4441;14592;406;1610;3728;12123;4134;13733
270220;201408;1730;5438;1599;5185;310;1131;857;2824;1167;3955
270230;201408;11400;37080;10021;34880;1501;6184;6591;22599;8092;28783
270235;201408;6506;21214;6158;20634;417;1711;5078;16919;5495;18630
270240;201408;9912;29846;8709;28275;1594;5395;5638;18576;7232;23971
270250;201408;3584;9142;3264;8782;175;452;2953;7987;3128;8439
270255;201408;5172;15783;4254;14154;387;1614;3042;9965;3429;11579
270260;201408;6483;20866;6319;20580;867;3218;4728;15478;5595;18696
270270;201408;1245;3599;1149;3455;183;576;745;2205;928;2781
270280;201408;3768;11140;3528;10789;476;1666;2538;7629;3014;9295
270290;201408;8610;30115;8165;29332;883;3727;6324;22533;7207;26260
270300;201408;3402;11701;3215;11481;200;825;2759;9914;2959;10739
270310;201408;7565;23253;6797;21944;431;1935;5547;17480;5978;19415
270320;201408;6506;21047;6288;20682;1492;5542;3642;12023;5134;17565
270330;201408;4944;16271;4649;15874;471;1732;3719;12821;4190;14553
270340;201408;1828;5647;1648;5407;198;690;1244;4159;1442;4849
270350;201408;2122;5859;1964;5661;267;777;1357;4132;1624;4909
270360;201408;2109;6615;2060;6554;240;727;1698;5545;1938;6272
270370;201408;1750;5693;1610;5450;181;693;1095;3829;1276;4522
270375;201408;3064;9188;2805;8795;407;1538;1920;5794;2327;7332
270380;201408;6083;18575;5748;18109;630;1990;4450;14348;5080;16338
270390;201408;1462;4021;1313;3831;201;671;907;2563;1108;3234
270400;201408;6055;18736;5544;17960;499;1929;3972;12670;4471;14599
270410;201408;5152;15906;4889;15408;600;2092;3570;11144;4170;13236
270420;201408;5702;18628;5543;18405;301;1408;4646;15164;4947;16572
270430;201408;143239;418784;136780;409609;36362;110009;75832;234495;112194;344504
270440;201408;5136;15746;4834;15296;387;1412;3833;12242;4220;13654
270450;201408;6706;20947;6467;20643;591;2174;5188;16614;5779;18788
270460;201408;3707;10098;3336;9589;261;908;2723;7701;2984;8609
270470;201408;11283;36293;10658;35236;1656;5487;7149;24375;8805;29862
270480;201408;3157;9961;2869;9449;358;1425;1907;6068;2265;7493
270490;201408;1011;3247;954;3164;92;366;726;2386;818;2752
270500;201408;5485;18685;5240;18356;485;1764;4208;15100;4693;16864
270510;201408;6212;19072;5675;18315;882;3624;4070;12529;4952;16153
270520;201408;3810;12312;3571;11928;878;3194;1903;6432;2781;9626
270530;201408;1586;4648;1406;4416;212;667;967;3137;1179;3804
270540;201408;2107;7244;1935;6992;179;826;1530;5445;1709;6271
270550;201408;7287;21902;6460;20805;1054;3519;4349;14394;5403;17913
270560;201408;3118;9711;2941;9431;513;1923;2041;6353;2554;8276
270570;201408;4338;14119;3959;13522;464;1925;2755;9337;3219;11262
270580;201408;2121;6981;2040;6852;284;1003;1532;5223;1816;6226
270590;201408;1448;4889;1360;4736;73;311;1198;4165;1271;4476
270600;201408;2956;9894;2670;9455;240;1175;2037;7019;2277;8194
270610;201408;3311;10498;3072;10147;320;1165;2430;7985;2750;9150
270620;201408;1523;5084;1387;4881;150;691;1069;3662;1219;4353
270630;201408;18597;52056;17363;50127;2541;7405;12486;36617;15027;44022
270640;201408;6097;18785;5490;18017;473;1921;4448;14347;4921;16268
270642;201408;2520;8663;2348;8389;380;1518;1587;5729;1967;7247
270644;201408;2483;7232;2235;6957;174;494;1925;6104;2099;6598
270650;201408;4171;13198;4004;12966;855;3337;2434;7596;3289;10933
270660;201408;2502;6435;1983;5653;144;518;1413;3991;1557;4509
270670;201408;16459;44129;14312;41565;1870;5462;10606;31776;12476;37238
270680;201408;4261;13021;4111;12840;210;592;3683;11654;3893;12246
270690;201408;9230;26092;8536;25262;2810;7938;4271;13565;7081;21503
270700;201408;805;2517;763;2449;141;545;481;1496;622;2041
270710;201408;5955;19814;5700;19473;625;2270;4556;15694;5181;17964
270720;201408;3447;11670;3178;11199;256;1185;2559;8889;2815;10074
270730;201408;6819;20957;6466;20524;949;3041;4949;15977;5898;19018
270740;201408;2460;7172;2310;6958;357;1222;1581;4681;1938;5903
270750;201408;5013;16051;4653;15506;521;1867;3579;11972;4100;13839
270760;201408;3650;10965;3303;10391;383;1289;2442;7720;2825;9009
270770;201408;18566;50343;15841;47009;3106;9501;9865;30119;12971;39620
270780;201408;1976;6387;1838;6171;261;936;1300;4412;1561;5348
270790;201408;1750;5485;1596;5238;364;1302;905;2934;1269;4236
270800;201408;11561;34680;10819;33682;1012;3443;8784;27360;9796;30803
270810;201408;3487;10737;2851;9577;383;1488;1788;5999;2171;7487
270820;201408;1910;6444;1742;6142;277;1120;1153;4048;1430;5168
270830;201408;5576;16862;5066;16220;1058;3807;3226;10367;4284;14174
270840;201408;7733;26083;7037;25198;467;2199;5906;20895;6373;23094
270850;201408;7741;25438;7561;25221;1419;5709;5223;16682;6642;22391
270860;201408;11776;35383;10988;34315;1689;6137;7977;24344;9666;30481
270870;201408;2327;6884;1894;5965;307;1019;1146;3613;1453;4632
270880;201408;8002;26182;7556;25522;580;2450;6228;20739;6808;23189
270890;201408;2715;8257;2517;7925;409;1518;1751;5382;2160;6900
270895;201408;3103;11462;2947;11257;252;1033;2450;9481;2702;10514
270900;201408;1948;5314;1580;4780;108;413;1201;3556;1309;3969
270910;201408;3315;11529;3234;11368;335;1516;2553;8720;2888;10236
270915;201408;10183;34447;9235;32729;1781;7228;5367;18823;7148;26051
270920;201408;6574;20413;6178;19859;292;1333;5440;17276;5732;18609
270930;201408;17610;47978;14633;44257;2771;8907;8886;27516;11657;36423
270940;201408;5995;20226;5729;19915;679;2676;4426;15419;5105;18095
280010;201408;728;2157;637;2008;71;288;412;1260;483;1548
280020;201408;5127;15229;4524;14133;895;2941;2796;8753;3691;11694
280030;201408;76313;202666;67617;189558;17066;49973;34558;98470;51624;148443
280040;201408;3257;10169;2910;9675;370;1238;2147;7366;2517;8604
280050;201408;4145;13351;3864;12905;1177;4038;1904;6610;3081;10648
280060;201408;4419;14751;4185;14352;895;3278;2510;8703;3405;11981
280067;201408;7815;22155;6657;20582;773;2525;4925;15298;5698;17823
280070;201408;1972;6723;1878;6579;339;1264;1323;4674;1662;5938
280100;201408;4118;12915;3683;12138;990;3353;1791;6078;2781;9431
280110;201408;1458;4412;1344;4227;86;338;1109;3461;1195;3799
280120;201408;7680;24572;7112;23673;1078;3316;5081;17737;6159;21053
280130;201408;8117;23194;7562;22382;1259;4117;5077;14971;6336;19088
280140;201408;5760;15775;5218;15042;567;1650;4064;11845;4631;13495
280150;201408;3520;10843;3238;10329;495;1840;2123;6540;2618;8380
280160;201408;1555;4433;1401;4198;172;584;1021;3045;1193;3629
280170;201408;4785;14302;4338;13687;505;1520;3370;10962;3875;12482
280190;201408;1189;3389;1054;3173;98;386;763;2199;861;2585
280200;201408;1125;3525;1053;3403;171;681;727;2257;898;2938
280210;201408;13720;42351;12669;40847;2564;8375;8152;27170;10716;35545
280220;201408;1618;4956;1530;4830;109;412;1301;4092;1410;4504
280230;201408;3913;11529;3509;10856;687;2118;2085;6666;2772;8784
280240;201408;3586;10627;3267;10131;282;843;2583;8126;2865;8969
280250;201408;846;2253;725;2071;139;468;434;1144;573;1612
280260;201408;2115;5563;1929;5333;120;324;1676;4671;1796;4995
280270;201408;2295;7122;2005;6646;142;560;1566;5116;1708;5676
280280;201408;4165;13742;3862;13241;940;2758;2163;8291;3103;11049
280290;201408;17384;54931;15822;52355;2726;9676;10339;34681;13065;44357
280300;201408;10275;31306;9513;30433;804;2664;7896;25645;8700;28309
280310;201408;1497;4227;1308;3933;114;434;895;2599;1009;3033
280320;201408;8170;27016;7538;25874;1459;5565;4116;14144;5575;19709
280330;201408;4936;13886;4567;13375;584;1886;3494;10192;4078;12078
280340;201408;3873;11419;3672;11157;338;1104;2918;9051;3256;10155
280350;201408;22237;64418;20584;61976;2831;8683;14768;45335;17599;54018
280360;201408;6028;19138;5690;18610;1163;4273;3452;11149;4615;15422
280370;201408;2013;5726;1822;5427;223;756;1331;3893;1554;4649
280380;201408;1032;3138;950;3032;106;403;740;2336;846;2739
280390;201408;3334;9831;2905;9059;606;1801;1778;5664;2384;7465
280400;201408;4587;13157;4186;12624;966;2762;2625;8330;3591;11092
280410;201408;2442;7947;2157;7397;381;1495;1263;4201;1644;5696
280420;201408;4347;12521;4027;12030;249;772;3484;10485;3733;11257
280430;201408;2317;6035;2140;5816;160;532;1786;4825;1946;5357
280440;201408;5178;15119;4829;14695;477;1420;4013;12405;4490;13825
280445;201408;2505;7184;2293;6819;109;417;1886;5510;1995;5927
280450;201408;9246;24978;8519;24117;746;1710;7140;20994;7886;22704
280460;201408;7303;19589;6510;18492;1009;2989;4590;13293;5599;16282
280470;201408;1897;5651;1722;5392;210;667;1278;4058;1488;4725
280480;201408;31757;95592;30478;93742;5118;17913;20654;62332;25772;80245
280490;201408;3806;11696;3405;10948;397;1432;2447;7827;2844;9259
280500;201408;879;2364;828;2299;26;81;747;2058;773;2139
280510;201408;2794;8197;2412;7686;303;1097;1796;5762;2099;6859
280520;201408;1765;5048;1621;4858;183;478;1280;3995;1463;4473
280530;201408;2260;6721;2129;6551;229;763;1711;5327;1940;6090
280540;201408;9490;25675;8871;24846;345;1144;7916;22073;8261;23217
280550;201408;6758;18442;5894;17064;646;2093;4295;12332;4941;14425
280560;201408;8110;23877;7604;23065;616;2003;6167;18685;6783;20688
280570;201408;6993;19390;6278;18461;853;2816;4435;13003;5288;15819
280580;201408;5528;17148;4705;15719;862;2905;2942;10140;3804;13045
280590;201408;2437;7428;2229;7173;280;1171;1624;5149;1904;6320
280600;201408;4081;12546;3823;12113;420;1558;2775;8710;3195;10268
280610;201408;2447;7065;2274;6818;310;1055;1568;4638;1878;5693
280620;201408;5329;16193;4721;15030;803;2521;3077;10036;3880;12557
280630;201408;3858;12609;3685;12347;390;1174;2963;10298;3353;11472
280640;201408;2297;6648;2152;6480;102;245;1976;6058;2078;6303
280650;201408;1179;3647;1065;3444;175;625;710;2310;885;2935
280660;201408;2697;7835;2583;7665;348;1052;2065;6130;2413;7182
280670;201408;15171;40314;14264;39076;1814;5231;10537;28868;12351;34099
280680;201408;2899;7698;2477;7110;157;516;2074;5944;2231;6460
280690;201408;1026;2931;883;2723;137;452;584;1773;721;2225
280700;201408;1196;3508;1037;3270;105;318;757;2447;862;2765
280710;201408;11292;30681;10530;29773;792;2076;8965;25666;9757;27742
280720;201408;2402;6561;2150;6274;241;737;1613;4795;1854;5532
280730;201408;969;2917;925;2855;78;238;785;2462;863;2700
280740;201408;13249;36132;11504;33567;1827;5170;7774;23324;9601;28494
280750;201408;3673;11308;3365;10760;327;1249;2431;7717;2758;8966
280760;201408;5909;18267;5399;17586;713;2291;3981;13487;4694;15778
290010;201408;3075;6887;2215;5556;72;297;1779;4219;1851;4516
290020;201408;5022;15874;4584;15423;397;1125;3979;13755;4376;14880
290030;201408;3357;10608;3212;10385;451;1556;2412;7761;2863;9317
290035;201408;4726;12572;4219;11922;314;925;3490;10037;3804;10962
290040;201408;3877;11179;3506;10742;274;1056;2861;8644;3135;9700
290050;201408;2756;9000;2568;8709;245;938;1976;6730;2221;7668
290060;201408;1347;3442;1125;3173;206;661;795;2181;1001;2842
290070;201408;31522;82587;27337;77322;5888;16849;15169;45032;21057;61881
290080;201408;6057;18520;5321;17569;672;2229;3991;13568;4663;15797
290090;201408;2294;5081;1840;4605;201;486;1518;3881;1719;4367
290100;201408;10370;29734;9158;27753;1669;5050;5626;17738;7295;22788
290110;201408;5377;16243;5165;15887;864;2938;3539;10732;4403;13670
290115;201408;5034;15030;4436;14233;349;1196;3471;11328;3820;12524
290120;201408;6986;18976;6414;18264;418;1174;5561;15934;5979;17108
290130;201408;4611;12158;3971;11384;341;1077;3210;9128;3551;10205
290135;201408;5287;13548;4615;12495;451;1466;3161;8416;3612;9882
290140;201408;4120;13148;3596;12466;326;1198;2986;10415;3312;11613
290150;201408;2155;6430;2059;6298;189;587;1727;5312;1916;5899
290160;201408;3568;9689;3482;9585;291;549;3091;8785;3382;9334
290170;201408;2880;9661;2651;9298;251;992;2186;7681;2437;8673
290180;201408;3110;8875;2721;8294;286;976;2005;6150;2291;7126
290190;201408;4209;13914;4071;13678;449;1564;3089;10507;3538;12071
290195;201408;2244;6229;1918;5740;147;527;1512;4530;1659;5057
290200;201408;3908;12545;3569;11954;380;1340;2708;9144;3088;10484
290205;201408;3024;9389;2770;8990;364;1440;1997;6328;2361;7768
290210;201408;15857;43796;14745;42446;2758;6768;10091;31437;12849;38205
290220;201408;2471;7492;2366;7332;282;1039;1738;5256;2020;6295
290225;201408;3123;8330;2924;8118;182;361;2628;7519;2810;7880
290230;201408;2400;7955;2343;7879;225;794;1955;6646;2180;7440
290240;201408;3962;10478;3581;9943;378;1128;2699;7397;3077;8525
290250;201408;3881;12295;3300;11391;289;1060;2559;8948;2848;10008
290260;201408;4976;14921;4463;14132;454;1581;3484;11054;3938;12635
290265;201408;3470;11157;3253;10777;316;1214;2489;8235;2805;9449
290270;201408;12500;45340;11745;44188;1618;6398;8625;33025;10243;39423
290280;201408;5324;17520;5026;16978;579;2053;3679;12714;4258;14767
290290;201408;9825;31687;8969;30273;1624;5602;5921;20473;7545;26075
290300;201408;4405;12698;3156;10337;264;849;2180;7411;2444;8260
290310;201408;1556;4723;1445;4559;243;856;943;2935;1186;3791
290320;201408;27660;84607;24437;80303;5573;19338;14311;47867;19884;67205
290323;201408;4200;11274;3476;10500;219;756;2988;9001;3207;9757
290327;201408;4154;13257;3799;12587;611;2118;2549;8470;3160;10588
290330;201408;1957;5122;1861;5018;228;697;1531;4070;1759;4767
290340;201408;5188;16285;4797;15758;1181;3879;2756;9325;3937;13204
290350;201408;5062;15301;4185;14115;586;2004;2862;9940;3448;11944
290360;201408;4382;13681;3863;12965;219;777;3297;11225;3516;12002
290370;201408;4664;13808;4289;13336;463;1415;3500;11061;3963;12476
290380;201408;5645;16566;4971;15583;449;1499;3932;12406;4381;13905
290390;201408;15628;49251;14667;47661;3031;9533;9023;30762;12054;40295
290395;201408;2819;9132;2543;8654;240;973;1908;6502;2148;7475
290400;201408;3744;11345;3314;10748;387;1308;2495;8132;2882;9440
290405;201408;4555;14605;3964;13558;503;1768;2663;9381;3166;11149
290410;201408;6149;18285;5177;16848;572;2289;3738;11880;4310;14169
290420;201408;3408;10025;2822;9193;272;1019;2213;7167;2485;8186
290430;201408;3591;11269;3217;10682;671;2308;1967;6660;2638;8968
290440;201408;3144;8282;2542;7484;251;805;1986;5924;2237;6729
290450;201408;3673;10699;3210;10040;551;1756;2105;6704;2656;8460
290460;201408;13779;41938;12740;40197;3713;12377;5791;18211;9504;30588
290470;201408;4855;13468;3803;12052;851;2990;2017;6531;2868;9521
290475;201408;4999;17558;4550;16758;543;2198;3271;12194;3814;14392
290480;201408;2680;7024;2367;6605;379;1118;1589;4502;1968;5620
290485;201408;4953;15798;4401;14982;465;2026;3449;11587;3914;13613
290490;201408;8303;22267;8000;21860;739;2169;6602;18010;7341;20179
290500;201408;4680;14885;3975;13564;812;2996;1996;6764;2808;9760
290510;201408;3492;10221;3055;9611;241;885;2441;7722;2682;8607
290515;201408;2936;9060;2743;8767;261;832;2141;7000;2402;7832
290520;201408;11914;36984;9705;32911;1045;4222;6205;20882;7250;25104
290530;201408;5386;15518;4605;14404;414;1338;3684;11601;4098;12939
290540;201408;4000;11609;3807;11364;449;1257;3008;9220;3457;10477
290550;201408;4468;12084;3937;11441;166;476;3547;10384;3713;10860
290560;201408;6237;18510;5497;17434;1210;4117;3229;10419;4439;14536
290570;201408;41287;119814;38747;115994;4929;15800;28495;84792;33424;100592
290580;201408;7462;25978;7149;25495;1372;4816;4881;18002;6253;22818
290590;201408;7726;24366;6478;22277;470;1954;5080;17405;5550;19359
290600;201408;18600;57228;17286;55142;3008;9353;11370;37828;14378;47181
290610;201408;2442;8442;2069;7703;211;1000;1505;5477;1716;6477
290620;201408;7276;21647;6506;20533;495;1698;5363;16997;5858;18695
290630;201408;8354;22529;7367;21481;830;2361;5978;17690;6808;20051
290640;201408;2758;8169;2297;7393;241;819;1643;5324;1884;6143
290650;201408;12014;35581;11294;34528;2820;8558;6776;21400;9596;29958
290660;201408;3819;10533;3128;9548;218;760;2470;7592;2688;8352
290670;201408;7042;21735;6425;20774;870;2701;4760;15905;5630;18606
290680;201408;10569;31316;9726;30308;599;1993;8232;25839;8831;27832
290682;201408;4560;13422;4109;12796;199;779;3421;10561;3620;11340
290685;201408;3375;8602;2513;7387;326;1020;1540;4630;1866;5650
290687;201408;8362;22632;6608;20456;1390;4580;3845;12169;5235;16749
290689;201408;3182;9158;2698;8398;243;787;2124;6705;2367;7492
290690;201408;5603;16340;5114;15720;553;1766;4068;12617;4621;14383
290700;201408;2279;7188;2177;7039;211;767;1711;5533;1922;6300
290710;201408;7904;25187;7324;24296;474;1544;6310;21194;6784;22738
290720;201408;19203;56405;17130;53864;1823;5237;13960;45238;15783;50475
290730;201408;7475;20898;6798;20018;1234;3571;4634;13882;5868;17453
290740;201408;961;2883;818;2646;121;400;523;1733;644;2133
290750;201408;10373;29832;8963;27286;1721;6037;4963;14327;6684;20364
290755;201408;2462;6944;2050;6260;134;488;1591;4824;1725;5312
290760;201408;4528;13390;3694;12135;393;1242;2676;8921;3069;10163
290770;201408;2651;9277;2463;9031;139;629;2009;7430;2148;8059
290780;201408;9080;23633;8048;22229;860;2031;6188;17724;7048;19755
290790;201408;4839;14379;4491;13886;431;1280;3556;11342;3987;12622
290800;201408;7552;16368;5785;14488;860;1875;4386;11496;5246;13371
290810;201408;5029;16086;4366;15043;335;1286;3309;11522;3644;12808
290820;201408;5554;15917;4981;15147;484;1638;3861;11765;4345;13403
290830;201408;4268;12059;4004;11644;285;1122;3199;9006;3484;10128
290840;201408;18153;51388;16531;49142;2647;7546;11509;35681;14156;43227
290850;201408;6888;20510;6741;20295;1151;3344;5026;15663;6177;19007
290860;201408;5017;17606;4692;17199;735;2708;3426;12974;4161;15682
290870;201408;4884;14632;4096;13555;443;1758;3004;9851;3447;11609
290880;201408;1438;4006;1188;3613;109;340;822;2529;931;2869
290890;201408;7039;18864;6158;17862;742;2142;4825;14201;5567;16343
290900;201408;2495;7317;1896;6323;286;1057;1028;3398;1314;4455
290910;201408;4961;13670;4262;12663;266;870;3560;10625;3826;11495
290920;201408;4903;14536;4420;13878;332;926;3636;11665;3968;12591
290930;201408;7645;24515;6865;23157;746;2865;5014;16739;5760;19604
290940;201408;3627;11519;3378;11195;282;921;2867;9721;3149;10642
290950;201408;1580;4474;1429;4256;209;639;989;2997;1198;3636
290960;201408;6118;17341;5594;16649;403;1232;4554;13706;4957;14938
290970;201408;3759;12180;3418;11580;478;1617;2255;7898;2733;9515
290980;201408;10857;32241;9514;29628;2691;8795;3848;11913;6539;20708
290990;201408;9376;28236;8255;26401;940;3170;6187;19812;7127;22982
291000;201408;3309;9931;3039;9583;353;1131;2400;7700;2753;8831
291005;201408;14202;39444;12742;37352;2118;6529;8664;25735;10782;32264
291010;201408;3173;10233;2551;8846;315;1177;1624;5674;1939;6851
291020;201408;1438;3804;1107;3225;135;468;666;1860;801;2328
291030;201408;2303;6349;1745;5223;193;641;1094;3195;1287;3836
291040;201408;5736;17734;5251;17037;686;2416;3886;12650;4572;15066
291050;201408;8102;27004;7418;25712;1997;7485;3766;13022;5763;20507
291060;201408;6355;23398;6036;22979;893;3848;4320;16395;5213;20243
291070;201408;16639;48908;15213;46878;1727;5295;11469;36015;13196;41310
291072;201408;22442;68871;19039;62106;5961;20569;7338;24795;13299;45364
291075;201408;5394;15451;4885;14770;396;1091;3766;11786;4162;12877
291077;201408;1582;4587;1315;4170;161;587;870;2733;1031;3320
291080;201408;84298;260787;75315;244287;23546;78916;28688;92248;52234;171164
291085;201408;5849;15611;5099;14606;579;1729;3984;11508;4563;13237
291090;201408;1492;3758;1311;3525;103;400;1071;2774;1174;3174
291100;201408;2687;7096;2209;6601;118;461;1869;5569;1987;6030
291110;201408;5107;18380;4573;17548;650;2848;3193;12141;3843;14989
291120;201408;7737;20814;7226;20089;944;2687;5445;15238;6389;17925
291125;201408;1760;3786;1413;3419;149;368;1071;2678;1220;3046
291130;201408;3034;9334;2648;8686;253;978;1898;6161;2151;7139
291140;201408;4228;12703;3880;12058;571;1840;2665;8342;3236;10182
291150;201408;2027;5306;1930;5191;185;516;1499;4017;1684;4533
291160;201408;5642;17401;4934;16314;1226;4109;2760;9277;3986;13386
291165;201408;2537;7412;2013;6424;134;580;1450;4485;1584;5065
291170;201408;21275;55288;18343;51631;1162;3896;14650;41000;15812;44896
291180;201408;6643;17469;5375;15657;628;2038;3823;11039;4451;13077
291185;201408;3962;10779;3678;10399;315;962;3056;8609;3371;9571
291190;201408;7609;21191;6841;20245;802;2345;5297;16065;6099;18410
291200;201408;2749;8375;2285;7524;177;629;1687;5598;1864;6227
291210;201408;7694;18209;6668;17042;555;1479;5383;13815;5938;15294
291220;201408;4290;13684;4024;13233;571;2089;2876;9360;3447;11449
291230;201408;4096;10633;3693;10165;128;316;3366;9367;3494;9683
291240;201408;4972;13404;4199;12055;269;829;3351;9506;3620;10335
291250;201408;3825;11457;3013;10079;325;1124;2067;7018;2392;8142
291260;201408;1186;3495;1103;3376;110;383;849;2588;959;2971
291270;201408;4409;14641;4082;14040;1102;3988;2267;7904;3369;11892
291280;201408;2487;6472;1883;5668;472;1468;1048;3150;1520;4618
291290;201408;6029;16977;5412;16199;887;2652;3553;10946;4440;13598
291300;201408;4621;13513;3872;12261;486;1736;2658;8342;3144;10078
291310;201408;5557;15918;4867;14764;420;1326;3752;11405;4172;12731
291320;201408;6236;19986;5382;18337;1304;4854;2822;9485;4126;14339
291330;201408;1696;5166;1576;4982;226;814;1027;3151;1253;3965
291340;201408;4045;11811;3252;10683;293;1088;2549;8346;2842;9434
291345;201408;3601;11671;3389;11439;216;686;2984;10320;3200;11006
291350;201408;6017;17814;5389;16831;479;1593;3951;12506;4430;14099
291360;201408;36337;104894;33745;101116;8290;24455;20343;63174;28633;87629
291370;201408;9241;26950;8846;26426;962;2794;6851;20977;7813;23771
291380;201408;3905;12072;3388;11217;277;947;2504;8514;2781;9461
291390;201408;10696;29639;9747;28509;1373;3867;7416;22056;8789;25923
291400;201408;17358;45571;14181;41328;2399;7010;9111;27619;11510;34629
291410;201408;3376;8824;2497;7545;195;788;1873;5497;2068;6285
291420;201408;2289;6066;2019;5744;114;328;1796;5156;1910;5484
291430;201408;3430;10063;3037;9545;238;937;2395;7420;2633;8357
291440;201408;6263;19699;5372;18133;561;1974;4081;13964;4642;15938
291450;201408;7860;24040;7026;22808;354;1144;5856;19441;6210;20585
291460;201408;13690;41417;12183;39135;2213;7624;7886;25488;10099;33112
291465;201408;8525;24609;7735;23700;792;2649;6251;19182;7043;21831
291470;201408;16121;44483;14227;42137;1463;4204;10757;33065;12220;37269
291480;201408;36375;98389;32359;92853;4998;15908;21471;61384;26469;77292
291490;201408;4542;14957;4437;14817;455;1506;3694;12521;4149;14027
291500;201408;4285;12454;3686;11604;299;1096;2931;9186;3230;10282
291510;201408;3714;11343;3420;10954;147;477;3080;9963;3227;10440
291520;201408;4155;11225;3637;10527;490;1342;2483;7491;2973;8833
291530;201408;2144;6227;1826;5727;458;1531;954;3072;1412;4603
291535;201408;4446;12904;4002;12252;345;1091;3072;9739;3417;10830
291540;201408;2291;5500;1955;5148;172;365;1662;4514;1834;4879
291550;201408;5766;15556;5175;14744;1255;3521;2951;8580;4206;12101
291560;201408;17778;45081;13790;40582;1357;4028;10678;32277;12035;36305
291570;201408;2508;6708;2379;6550;174;404;2110;5949;2284;6353
291580;201408;6017;18374;5346;17359;727;2812;3648;11837;4375;14649
291590;201408;2043;6335;1831;5990;291;987;1207;4105;1498;5092
291600;201408;5641;15648;4212;13532;1010;3595;2060;6504;3070;10099
291610;201408;5296;15876;5139;15668;364;1186;4390;13494;4754;14680
291620;201408;3147;7469;2598;6886;191;473;2071;5694;2262;6167
291630;201408;3245;8111;2826;7634;292;745;2287;6317;2579;7062
291640;201408;18143;49611;15012;45424;4063;13026;6272;19353;10335;32379
291650;201408;8380;24757;7694;23943;699;1715;6454;20873;7153;22588
291660;201408;2438;6425;2146;6018;259;881;1471;3946;1730;4827
291670;201408;2548;7057;2349;6747;381;1108;1406;4312;1787;5420
291680;201408;5088;14438;4568;13609;1138;3740;2225;6863;3363;10603
291685;201408;4736;11868;4024;10950;561;1464;2892;8159;3453;9623
291690;201408;4110;11246;3390;10127;325;960;2409;7284;2734;8244
291700;201408;9702;30179;8902;28853;1059;3545;6587;21729;7646;25274
291710;201408;6172;16325;5337;15254;937;2788;3349;10037;4286;12825
291720;201408;3891;13534;3525;12761;404;1681;2562;9146;2966;10827
291730;201408;6106;19212;5675;18639;987;3382;4002;13439;4989;16821
291733;201408;2672;7857;2268;7328;311;1083;1535;4993;1846;6076
291735;201408;2520;7256;2146;6679;131;485;1754;5397;1885;5882
291740;201408;4091;11901;3261;10630;354;1311;2323;7558;2677;8869
291750;201408;22712;59404;17856;52079;3908;11869;9606;28466;13514;40335
291760;201408;12697;39986;11514;37878;4362;15745;4309;14141;8671;29886
291770;201408;8247;23805;7404;22363;1196;3940;4888;14567;6084;18507
291780;201408;4418;13584;4138;13076;463;1479;3181;10095;3644;11574
291790;201408;2575;8003;2431;7806;127;521;2098;6671;2225;7192
291800;201408;32908;94515;29623;89848;5862;18273;18402;57396;24264;75669
291810;201408;11215;31469;9520;29435;651;2299;7753;24142;8404;26441
291820;201408;3796;11261;3416;10710;298;960;2725;8620;3023;9580
291830;201408;4489;12110;4170;11648;494;1461;3173;8906;3667;10367
291835;201408;6329;19667;5160;17686;1262;4648;2975;10166;4237;14814
291840;201408;50652;138249;42967;129913;5408;15712;32978;102823;38386;118535
291845;201408;3059;8812;2747;8447;221;615;2403;7519;2624;8134
291850;201408;4884;13698;4091;12584;454;1355;3074;9739;3528;11094
291855;201408;1766;4616;1524;4300;186;645;1124;3060;1310;3705
291860;201408;2109;6262;1801;5661;189;661;1175;3665;1364;4326
291870;201408;1433;3847;1111;3277;125;453;714;2092;839;2545
291875;201408;2938;9333;2644;8876;234;974;1901;6268;2135;7242
291880;201408;4798;15272;4534;14861;339;1149;3803;12561;4142;13710
291890;201408;1463;3654;1236;3382;310;876;733;2068;1043;2944
291900;201408;1345;3794;1147;3484;111;398;886;2668;997;3066
291905;201408;3025;7966;2511;7146;220;699;1797;5166;2017;5865
291910;201408;2729;7391;2326;6906;181;653;1911;5629;2092;6282
291915;201408;6874;21251;6099;19766;505;1696;5000;16413;5505;18109
291920;201408;33304;97890;30709;94020;6273;19802;18547;58212;24820;78014
291930;201408;2625;7803;2369;7400;247;885;1756;5460;2003;6345
291940;201408;3627;10377;2712;8757;414;1513;1523;4762;1937;6275
291950;201408;9457;31821;8586;30388;1896;6674;4868;17826;6764;24500
291955;201408;9094;28774;8660;28134;2067;6672;5193;17521;7260;24193
291960;201408;3437;10163;2894;9378;334;1013;2084;7091;2418;8104
291970;201408;4443;13346;3953;12717;580;1978;2748;8934;3328;10912
291980;201408;11682;33717;8946;29774;962;3384;6405;21789;7367;25173
291990;201408;2257;7109;2072;6829;189;669;1587;5331;1776;6000
291992;201408;2890;8916;2820;8775;439;1438;2074;6423;2513;7861
291995;201408;2189;6433;1951;6086;246;810;1461;4609;1707;5419
292000;201408;2438;7187;2202;6842;392;1354;1473;4549;1865;5903
292010;201408;6533;16716;4990;14452;497;1465;3816;11118;4313;12583
292020;201408;4600;15456;4268;14916;673;2478;3009;10684;3682;13162
292030;201408;2267;7032;2011;6670;261;939;1283;4292;1544;5231
292040;201408;4728;13122;4182;12552;330;871;3557;11083;3887;11954
292045;201408;2730;9476;2702;9432;87;276;2567;8998;2654;9274
292050;201408;6489;20267;5694;18681;577;2301;3865;12478;4442;14779
292060;201408;11441;31757;10828;30965;1034;2907;8879;25569;9913;28476
292070;201408;4491;14222;4365;14060;401;1180;3705;12130;4106;13310
292080;201408;3749;9800;3216;9119;300;874;2586;7429;2886;8303
292090;201408;4377;11549;3737;10824;330;1083;3047;8874;3377;9957
292100;201408;11187;30950;9530;28682;2632;8196;4641;14610;7273;22806
292105;201408;3250;9948;2809;9311;227;899;2252;7435;2479;8334
292110;201408;7213;19040;5528;16539;1223;3707;3175;9784;4398;13491
292120;201408;8786;24521;7771;22733;1663;4903;4095;12715;5758;17618
292130;201408;3197;8619;2849;8128;550;1475;1885;5538;2435;7013
292140;201408;5556;14303;4807;13287;838;2242;3107;8990;3945;11232
292145;201408;2732;8369;2490;7990;210;653;1894;6359;2104;7012
292150;201408;13794;41989;12783;40387;917;3252;10040;32103;10957;35355
292160;201408;2836;8116;2442;7595;171;495;2073;6595;2244;7090
292170;201408;9238;26858;7862;24517;1174;4044;4924;15495;6098;19539
292180;201408;3606;10350;2887;9220;449;1429;1854;6041;2303;7470
292190;201408;3418;9604;2893;8847;573;1841;1837;5702;2410;7543
292200;201408;6382;20957;5621;19466;1632;6057;2398;8303;4030;14360
292205;201408;4073;12617;3700;12101;276;1047;2982;9748;3258;10795
292210;201408;6835;19099;5842;17763;554;1768;4562;14154;5116;15922
292220;201408;1982;5540;1838;5339;389;1067;1124;3310;1513;4377
292225;201408;3173;9824;2920;9452;188;678;2418;7907;2606;8585
292230;201408;6354;19238;6063;18785;593;2313;4637;13932;5230;16245
292240;201408;4481;14186;4106;13383;639;2247;2588;8344;3227;10591
292250;201408;5322;16437;4959;15768;1109;3670;2655;8455;3764;12125
292260;201408;3228;9889;3078;9663;301;1000;2480;7811;2781;8811
292265;201408;2899;9426;2614;8919;190;782;1991;6734;2181;7516
292270;201408;4102;10921;3342;10024;244;892;2747;8209;2991;9101
292273;201408;2859;6939;2198;6114;288;749;1594;4686;1882;5435
292275;201408;1931;5048;1759;4782;194;578;1344;3640;1538;4218
292280;201408;2105;6247;1906;6030;202;487;1487;5051;1689;5538
292285;201408;2689;7485;2368;7026;214;716;1841;5535;2055;6251
292290;201408;7559;22567;6321;20907;458;1746;4979;16685;5437;18431
292300;201408;8759;26778;7675;25559;1938;6563;4726;16239;6664;22802
292303;201408;2911;9058;2711;8782;127;481;2342;7576;2469;8057
292305;201408;3221;8715;3054;8493;123;374;2742;7647;2865;8021
292310;201408;6129;18107;5579;17351;248;884;4716;14705;4964;15589
292320;201408;6387;18934;5607;17606;569;1972;4289;13464;4858;15436
292330;201408;2067;5813;1936;5630;192;611;1536;4425;1728;5036
292335;201408;5460;14300;4870;13527;527;1407;3929;11063;4456;12470
292340;201408;6738;19033;5727;17399;627;1995;4062;12401;4689;14396
292350;201408;2226;6742;2046;6506;237;863;1605;5099;1842;5962
292360;201408;5086;14559;4888;14028;187;535;4324;12671;4511;13206
292370;201408;9202;27045;8340;25761;1096;3217;5962;19250;7058;22467
292380;201408;7602;22097;7079;21281;559;1567;5838;17785;6397;19352
292390;201408;3809;8581;3354;8088;113;187;3130;7653;3243;7840
292400;201408;22490;66922;21433;65227;3260;10442;15171;46928;18431;57370
292405;201408;4531;11934;3914;11159;270;778;3259;9377;3529;10155
292410;201408;1979;5323;1874;5202;146;396;1633;4558;1779;4954
292420;201408;3903;12473;3742;12271;171;460;3403;11404;3574;11864
292430;201408;5656;17085;4488;15436;297;1215;3439;11792;3736;13007
292440;201408;8719;28747;8083;27823;299;1181;7086;24763;7385;25944
292450;201408;4461;13264;3648;11970;350;1237;2650;8846;3000;10083
292460;201408;5740;17164;5048;15925;978;3207;3133;9983;4111;13190
292465;201408;2506;7546;2106;6905;239;889;1498;4974;1737;5863
292467;201408;2079;6803;1971;6625;369;1319;1321;4508;1690;5827
292470;201408;3278;8708;2700;7791;243;811;2044;5834;2287;6645
292480;201408;6473;17187;5556;15941;349;1140;4703;13480;5052;14620
292490;201408;2387;6579;1997;6008;179;634;1549;4601;1728;5235
292500;201408;6743;20207;5854;18685;662;2278;4189;13542;4851;15820
292510;201408;13564;38778;11958;36488;1243;3998;9198;28560;10441;32558
292520;201408;6107;18365;5516;17429;1543;4946;2865;9208;4408;14154
292525;201408;5644;14764;4912;13904;373;1103;4025;11531;4398;12634
292530;201408;26759;79223;24201;75915;5817;18767;13893;45105;19710;63872
292540;201408;2972;8516;2674;8112;338;1181;2018;6093;2356;7274
292550;201408;6757;21736;5987;20643;838;3059;4289;15160;5127;18219
292560;201408;4249;11726;3627;10894;295;1081;2918;8627;3213;9708
292570;201408;4159;12305;4000;12138;155;443;3550;11133;3705;11576
292575;201408;6196;21143;6040;20864;913;3274;4550;15758;5463;19032
292580;201408;7232;21426;6687;20733;539;1670;5555;17461;6094;19131
292590;201408;7434;23345;7091;22788;831;2740;5396;17436;6227;20176
292593;201408;3350;8734;2836;7981;271;774;2209;6210;2480;6984
292595;201408;6190;17185;5381;16124;505;1615;4122;12475;4627;14090
292600;201408;10845;30675;10087;29706;1003;2341;8220;25122;9223;27463
292610;201408;4462;12943;3648;11598;460;1522;2407;7832;2867;9354
292620;201408;5983;17777;5217;16878;251;817;4702;15342;4953;16159
292630;201408;10105;25592;8693;23478;834;2328;6540;17985;7374;20313
292640;201408;8481;27183;7537;25920;630;2319;5827;20477;6457;22796
292650;201408;5087;13780;4854;13462;523;1012;4000;11812;4523;12824
292660;201408;11388;34378;10738;33443;1276;4078;8203;26042;9479;30120
292665;201408;2839;8313;2763;8204;81;188;2589;7806;2670;7994
292670;201408;3980;11247;3074;9709;315;1090;2022;6429;2337;7519
292680;201408;3736;11265;3482;10879;385;1165;2762;8717;3147;9882
292690;201408;3446;9317;2468;7788;295;1000;1663;5357;1958;6357
292700;201408;9496;28481;8230;26645;1173;3523;5831;19760;7004;23283
292710;201408;1987;6523;1888;6378;88;329;1690;5737;1778;6066
292720;201408;9754;25188;8597;23880;716;2010;7219;20288;7935;22298
292730;201408;3549;10853;3426;10661;479;1478;2487;7903;2966;9381
292740;201408;369778;1029374;350906;1001944;79873;239788;214967;614122;294840;853910
292750;201408;6271;17069;5534;16056;409;1193;4507;13277;4916;14470
292760;201408;4319;13759;3982;13179;575;2058;2623;8788;3198;10846
292770;201408;6241;19051;5831;18395;1272;4026;3640;11841;4912;15867
292780;201408;1918;4646;1509;4136;182;606;1097;2957;1279;3563
292790;201408;3477;9143;3319;8973;242;525;2862;8043;3104;8568
292800;201408;9768;29247;9084;28138;874;2965;7110;22016;7984;24981
292805;201408;3245;9437;2959;9034;565;1853;1985;6067;2550;7920
292810;201408;10248;30881;8600;28656;1162;4059;6235;21224;7397;25283
292820;201408;7621;21763;5562;18816;417;1617;4428;15059;4845;16676
292830;201408;1941;5741;1763;5494;112;439;1459;4510;1571;4949
292840;201408;7558;24428;7084;23772;419;1568;6169;20692;6588;22260
292850;201408;3329;8806;2748;7945;300;930;1996;5719;2296;6649
292860;201408;15436;42108;14751;41187;1861;5296;11456;32246;13317;37542
292870;201408;20071;55664;17658;51928;2990;9629;10669;31053;13659;40682
292880;201408;12288;36273;11082;34416;1565;5201;7437;23010;9002;28211
292890;201408;5871;19993;5285;18898;978;3686;3141;11499;4119;15185
292895;201408;2813;7034;2251;6187;307;839;1621;4455;1928;5294
292900;201408;3125;9757;2959;9492;371;1465;2064;6400;2435;7865
292905;201408;4393;12672;3674;11762;274;778;3072;10126;3346;10904
292910;201408;5254;16128;4795;15296;845;2918;2979;9408;3824;12326
292920;201408;8878;26510;8437;25830;845;2913;6594;19680;7439;22593
292925;201408;5259;16252;4645;15391;462;1592;3574;11943;4036;13535
292930;201408;6596;21388;6285;20828;679;2825;4664;15094;5343;17919
292935;201408;2151;6126;1803;5745;122;315;1525;5055;1647;5370
292937;201408;3357;8556;2831;7901;321;1013;2172;5982;2493;6995
292940;201408;3192;8791;2514;7843;311;989;1724;5571;2035;6560
292950;201408;8334;25409;7938;24723;967;3582;5790;17553;6757;21135
292960;201408;5063;13618;4446;12760;468;1464;3228;9195;3696;10659
292970;201408;4468;13502;3997;12882;202;817;3343;10792;3545;11609
292975;201408;3463;9474;3329;9280;363;991;2761;7792;3124;8783
292980;201408;3662;9911;2965;9028;393;1367;2071;6253;2464;7620
292990;201408;12406;35716;11222;33908;712;2276;9524;28837;10236;31113
293000;201408;2995;7828;2450;7141;126;430;2127;6191;2253;6621
293010;201408;19408;54624;16915;50694;3057;9977;10482;31347;13539;41324
293015;201408;8095;26241;6574;23929;1063;4276;4244;15353;5307;19629
293020;201408;9675;31937;9039;31038;623;2445;7473;25878;8096;28323
293030;201408;5762;16700;4637;15016;459;1558;3237;10897;3696;12455
293040;201408;3645;11957;3479;11624;190;670;3078;10280;3268;10950
293050;201408;20841;58534;18483;55514;2875;8765;12440;38328;15315;47093
293060;201408;4407;11347;3706;10235;425;1253;2557;7027;2982;8280
293070;201408;21020;63937;19363;61053;5215;16772;10138;32755;15353;49527
293075;201408;3474;11249;3141;10815;243;874;2580;8983;2823;9857
293076;201408;3818;10707;3534;10299;270;759;2964;8799;3234;9558
293077;201408;5121;15867;4437;14969;987;3492;2591;8847;3578;12339
293080;201408;4926;15508;4506;14829;342;1471;3538;11405;3880;12876
293090;201408;3625;11369;2967;10426;293;1063;2248;8030;2541;9093
293100;201408;5892;17895;5040;16396;551;1915;3693;12175;4244;14090
293105;201408;3957;13242;3496;12356;498;1856;2378;8532;2876;10388
293110;201408;2032;6055;1861;5789;129;463;1526;4723;1655;5186
293120;201408;4119;13609;3820;13184;374;1260;3006;10606;3380;11866
293130;201408;4068;11503;3319;10657;182;659;2931;9547;3113;10206
293135;201408;30513;78250;23376;68462;4657;15789;11508;33312;16165;49101
293140;201408;2156;6344;2070;6219;219;785;1590;4660;1809;5445
293150;201408;5907;19419;5289;18219;1039;3702;3133;11145;4172;14847
293160;201408;3635;9800;3389;9518;466;951;2632;7865;3098;8816
293170;201408;3532;10684;3268;10290;489;1668;2297;7325;2786;8993
293180;201408;5462;15409;4498;13912;364;1318;3484;10640;3848;11958
293190;201408;14096;42985;13301;41780;611;2735;11476;35387;12087;38122
293200;201408;6569;19074;5791;18013;273;1019;4949;15395;5222;16414
293210;201408;5126;15071;4683;14357;478;1603;3502;10776;3980;12379
293220;201408;5336;16047;4768;15097;1175;3880;2489;8008;3664;11888
293230;201408;4076;12696;3752;12236;533;1908;2743;8966;3276;10874
293240;201408;4617;12145;3623;10709;199;602;2834;8370;3033;8972
293245;201408;4574;13098;4168;12457;510;1534;3006;9298;3516;10832
293250;201408;6071;17076;5560;16324;673;2080;4044;11883;4717;13963
293260;201408;4837;14465;4034;13297;372;1361;2978;9926;3350;11287
293270;201408;5904;16142;5602;15818;535;1321;4831;13978;5366;15299
293280;201408;5767;16171;4993;15155;450;1240;3873;12155;4323;13395
293290;201408;16787;56156;15840;54266;3689;13102;8766;30681;12455;43783
293300;201408;6761;16710;5804;15634;481;1233;4725;12899;5206;14132
293305;201408;4876;12211;4249;11350;277;786;3545;9482;3822;10268
293310;201408;2798;7188;2273;6328;238;714;1583;4362;1821;5076
293315;201408;4987;12660;4514;11955;752;1930;2868;8042;3620;9972
293317;201408;2620;7662;2342;7149;270;872;1543;4705;1813;5577
293320;201408;8232;27057;8040;26811;744;2694;6734;22480;7478;25174
293325;201408;1965;5703;1636;5198;254;872;1103;3534;1357;4406
293330;201408;55783;177031;50269;167678;11370;40799;27177;91770;38547;132569
293340;201408;2745;7840;2184;6875;307;1080;1492;4609;1799;5689
293345;201408;3646;10848;3068;10031;346;1123;2246;7589;2592;8712
293350;201408;6876;19169;6565;18808;408;1008;5842;17120;6250;18128
293360;201408;14051;42721;12778;41063;864;2698;10884;35706;11748;38404
310010;201408;1225;3319;884;2775;230;876;366;1039;596;1915
310020;201408;3882;12359;3233;10935;1136;4151;610;1871;1746;6022
310030;201408;2598;8482;2244;7838;649;2409;1105;3844;1754;6253
310040;201408;1039;2850;876;2630;89;315;659;1955;748;2270
310050;201408;1937;6758;1725;6248;336;1440;887;3156;1223;4596
310060;201408;3301;10963;2970;10514;376;1382;2240;8050;2616;9432
310070;201408;318;912;245;775;39;164;127;357;166;521
310080;201408;789;2426;642;2138;179;690;225;687;404;1377
310090;201408;4988;14808;4304;13616;675;2372;2669;8443;3344;10815
310100;201408;3447;10499;2875;9543;281;1116;2132;7035;2413;8151
310110;201408;6013;17034;5058;15592;1127;3949;2803;8548;3930;12497
310120;201408;608;1960;561;1880;208;826;240;691;448;1517
310130;201408;473;1490;434;1429;105;400;222;686;327;1086
310140;201408;267;932;233;869;84;349;53;173;137;522
310150;201408;5089;15777;4592;14860;1009;3683;2361;7592;3370;11275
310160;201408;7478;24346;6526;22595;1979;7546;2417;8292;4396;15838
310163;201408;863;2895;745;2653;198;788;299;1020;497;1808
310170;201408;10122;28789;9285;27546;1648;5010;6064;18614;7712;23624
310180;201408;1916;5558;1564;5067;405;1480;759;2367;1164;3847
310190;201408;2622;8829;2380;8420;748;2929;413;1515;1161;4444
310200;201408;1972;6634;1656;5979;490;1953;570;2032;1060;3985
310205;201408;1078;3236;899;2936;182;601;525;1762;707;2363
310210;201408;2611;8103;2396;7783;335;1215;1752;5673;2087;6888
310220;201408;1273;3658;1023;3330;229;811;580;1861;809;2672
310230;201408;3007;9847;2588;8918;766;3024;1026;3274;1792;6298
310240;201408;1048;3674;894;3382;164;684;447;1779;611;2463
310250;201408;983;3399;956;3356;211;833;582;1986;793;2819
310260;201408;3199;10339;2680;9228;680;2631;1015;3413;1695;6044
310270;201408;2490;7369;2212;6954;206;682;1726;5513;1932;6195
310280;201408;2236;6381;1985;5987;476;1732;1016;2912;1492;4644
310285;201408;2254;7892;2114;7683;298;1128;1587;5898;1885;7026
310290;201408;1349;4243;1257;4101;386;1434;586;1733;972;3167
310300;201408;1937;6595;1830;6375;497;1910;1018;3495;1515;5405
310310;201408;395;1089;285;863;51;156;140;423;191;579
310320;201408;407;1358;352;1238;75;319;165;566;240;885
310330;201408;516;1309;377;1065;43;156;210;536;253;692
310340;201408;8696;27067;7527;25111;1510;5271;4267;14657;5777;19928
310350;201408;16059;45652;12360;39189;4191;14365;3491;11132;7682;25497
310360;201408;478;1501;462;1474;84;314;308;933;392;1247
310370;201408;1494;5287;1441;5188;425;1597;773;2801;1198;4398
310375;201408;1437;3884;971;3049;171;616;429;1286;600;1902
310380;201408;399;1131;316;1016;129;460;128;378;257;838
310390;201408;506;1819;431;1648;120;494;76;253;196;747
310400;201408;10544;31785;8465;28048;2715;9780;2557;8517;5272;18297
310410;201408;1056;3418;692;2825;245;1063;149;607;394;1670
310420;201408;5942;17232;3571;11798;836;3097;631;1849;1467;4946
310430;201408;1697;5795;1401;5180;458;1807;366;1330;824;3137
310440;201408;624;1833;542;1706;150;516;222;674;372;1190
310445;201408;1253;4173;1058;3811;159;653;670;2399;829;3052
310450;201408;4756;13665;3883;12391;702;2392;2482;8117;3184;10509
310460;201408;1672;5400;1448;4994;484;1821;340;1224;824;3045
310470;201408;3804;9880;3240;9172;321;1041;2545;7242;2866;8283
310480;201408;1176;3645;975;3235;237;927;411;1242;648;2169
310490;201408;3383;11455;2977;10674;1005;3947;1124;3986;2129;7933
310500;201408;1550;5380;1433;5148;426;1658;596;2126;1022;3784
310510;201408;2580;8520;2219;7694;789;2962;479;1595;1268;4557
310520;201408;1419;3839;1148;3397;89;272;776;2308;865;2580
310530;201408;887;2845;553;1969;119;474;106;352;225;826
310540;201408;3834;12639;3539;12194;1237;4461;1424;5000;2661;9461
310550;201408;1251;3766;1037;3390;292;1135;436;1299;728;2434
310560;201408;16771;52596;14439;48040;4552;16800;4968;15714;9520;32514
310570;201408;1287;3994;1204;3885;171;614;893;2883;1064;3497
310590;201408;4232;12501;3374;10847;660;2385;1350;4163;2010;6548
310600;201408;1662;5623;1548;5368;533;2079;538;1722;1071;3801
310610;201408;577;1957;529;1859;163;676;178;556;341;1232
310620;201408;193127;613556;159812;546219;43266;164552;62223;204179;105489;368731
310630;201408;4304;14004;4074;13573;788;2955;2710;8848;3498;11803
310640;201408;1480;4575;1200;4080;422;1547;316;1006;738;2553
310650;201408;2952;9456;2402;8506;476;1833;1305;4738;1781;6571
310660;201408;1386;4166;1207;3913;169;602;885;2821;1054;3423
310665;201408;1238;3898;1136;3745;198;693;779;2606;977;3299
310670;201408;58028;182963;53377;172707;15995;54327;22964;73551;38959;127878
310680;201408;820;2394;738;2264;172;576;384;1154;556;1730
310690;201408;1336;4446;1084;3952;335;1389;299;1018;634;2407
310700;201408;543;1487;446;1346;127;430;223;638;350;1068
310710;201408;7389;24178;5865;21601;1591;6537;1731;6268;3322;12805
310720;201408;874;2697;796;2552;237;874;357;1057;594;1931
310730;201408;9883;31207;9003;29813;2042;7348;5332;17688;7374;25036
310740;201408;5411;18234;4563;16450;1585;6258;1077;3663;2662;9921
310750;201408;1676;4327;1360;3907;241;708;915;2653;1156;3361
310760;201408;650;2026;558;1861;136;494;242;796;378;1290
310770;201408;797;2894;772;2845;279;1142;344;1218;623;2360
310780;201408;3825;10931;3370;10137;588;1813;2083;6286;2671;8099
310790;201408;1889;6046;1695;5714;471;1645;841;2924;1312;4569
310800;201408;3116;10188;2499;8934;991;3878;404;1395;1395;5273
310810;201408;1533;4322;1396;4092;326;1040;697;1969;1023;3009
310820;201408;1510;4295;1098;3570;308;1103;350;1079;658;2182
310825;201408;2470;8441;1989;7585;164;849;1462;5506;1626;6355
310830;201408;1430;4868;1190;4357;396;1553;363;1261;759;2814
310840;201408;2373;7737;2018;7053;760;2924;549;1801;1309;4725
310850;201408;1588;4790;1361;4486;200;732;993;3271;1193;4003
310855;201408;3246;10520;2888;9947;663;2437;1729;6055;2392;8492
310860;201408;8099;25142;7100;23436;1208;4237;4152;14094;5360;18331
310870;201408;1009;2902;842;2618;172;575;428;1317;600;1892
310880;201408;1265;3919;961;3346;205;829;449;1531;654;2360
310890;201408;2824;9000;2254;7935;678;2693;662;2189;1340;4882
310900;201408;4561;15297;3917;13987;1174;4634;1546;5344;2720;9978
310910;201408;2130;6122;1445;4808;404;1505;358;1119;762;2624
310920;201408;1966;5987;1567;5411;408;1602;756;2611;1164;4213
310925;201408;968;3229;885;3089;346;1326;288;1004;634;2330
310930;201408;5577;16370;4490;14684;840;2950;2640;8863;3480;11813
310940;201408;6456;18949;5481;17447;1143;3904;2952;9416;4095;13320
310945;201408;1349;3855;1108;3517;231;846;648;1972;879;2818
310950;201408;2087;6910;1626;5873;538;2166;480;1615;1018;3781
310960;201408;495;1676;423;1539;152;597;150;552;302;1149
310970;201408;1518;5345;1166;4395;393;1621;164;545;557;2166
310980;201408;495;1312;341;1018;63;234;151;393;214;627
310990;201408;1223;4225;1048;3835;266;1095;353;1202;619;2297
311000;201408;3648;12640;3204;11678;917;3846;1161;3980;2078;7826
311010;201408;974;3167;868;2977;278;1016;413;1390;691;2406
311020;201408;920;2890;779;2656;191;742;320;1017;511;1759
311030;201408;1935;5774;1485;4850;456;1645;495;1464;951;3109
311040;201408;502;1700;434;1517;107;396;102;345;209;741
311050;201408;2673;8714;2286;7948;706;2697;912;3147;1618;5844
311060;201408;2537;7986;2032;6879;608;2215;494;1623;1102;3838
311070;201408;1753;6233;1549;5815;444;1889;497;1846;941;3735
311080;201408;1237;3370;1105;3167;166;536;721;2067;887;2603
311090;201408;1704;6378;1452;5852;507;2343;287;1073;794;3416
311100;201408;2454;8565;2149;7921;951;3715;521;1928;1472;5643
311110;201408;4156;10046;2963;8356;600;1871;1521;4220;2121;6091
311115;201408;1175;3560;1023;3326;130;531;655;2130;785;2661
311120;201408;7855;22499;6141;19281;1630;5742;1685;4888;3315;10630
311130;201408;2410;7424;1936;6779;557;2279;845;2831;1402;5110
311140;201408;1423;4029;1185;3719;176;647;808;2468;984;3115
311150;201408;2450;8210;2265;7900;609;2199;1128;4006;1737;6205
311160;201408;5033;17040;4236;15643;1551;6160;1347;4938;2898;11098
311170;201408;765;2386;605;2070;79;267;327;1184;406;1451
311180;201408;1641;4594;1198;3719;378;1277;279;783;657;2060
311190;201408;1119;3381;952;3037;257;934;381;1117;638;2051
311200;201408;2218;6855;1842;6051;614;2243;438;1266;1052;3509
311205;201408;1204;3921;1059;3631;268;1040;417;1461;685;2501
311210;201408;981;3182;894;3050;169;580;625;2197;794;2777
311220;201408;936;3011;751;2590;210;770;255;867;465;1637
311230;201408;9102;28043;7663;25413;1621;5873;3759;12741;5380;18614
311240;201408;1364;4198;1135;3821;367;1336;379;1282;746;2618
311250;201408;978;3220;879;3069;249;996;307;924;556;1920
311260;201408;2974;8175;2267;6937;699;2342;706;2111;1405;4453
311265;201408;1354;3647;1046;3209;160;598;698;2128;858;2726
311270;201408;3555;11547;3156;11001;582;2374;2094;7140;2676;9514
311280;201408;1477;4153;1088;3395;302;1040;334;1017;636;2057
311290;201408;2356;7729;2184;7374;429;1437;1276;4447;1705;5884
311300;201408;5118;16926;4603;16068;733;2891;3021;10637;3754;13528
311310;201408;500;1790;484;1763;116;494;215;738;331;1232
311320;201408;4204;14170;3683;12982;939;3790;1327;4436;2266;8226
311330;201408;5634;17258;4843;15994;1750;6214;1699;5541;3449;11755
311340;201408;12694;41073;11488;38761;3879;14033;3637;12199;7516;26232
311350;201408;2398;7115;2028;6428;467;1706;924;2778;1391;4484
311360;201408;1367;3901;1088;3530;502;1698;280;932;782;2630
311370;201408;4675;13940;4129;13004;1079;4042;1736;5132;2815;9174
311380;201408;494;1621;420;1482;128;525;128;409;256;934
311390;201408;2026;7476;1904;7268;859;3647;606;2187;1465;5834
311400;201408;1748;5866;1597;5593;478;1894;717;2332;1195;4226
311410;201408;2080;7509;1931;7296;625;2540;1013;3859;1638;6399
311420;201408;2465;8506;2034;7442;737;2884;485;1594;1222;4478
311430;201408;4165;13088;3084;10664;762;2901;609;2045;1371;4946
311440;201408;2306;7797;1810;6842;674;2927;363;1304;1037;4231
311450;201408;1895;6709;1606;5994;490;2022;391;1355;881;3377
311455;201408;1638;4455;1393;4084;317;1038;763;2163;1080;3201
311460;201408;674;2221;519;1892;127;570;134;464;261;1034
311470;201408;623;1993;501;1726;147;600;159;497;306;1097
311480;201408;827;2309;781;2237;252;721;374;1040;626;1761
311490;201408;318;1245;298;1181;116;480;98;377;214;857
311500;201408;529;1602;435;1426;148;520;172;557;320;1077
311510;201408;3203;10028;2623;8911;1011;3895;714;2258;1725;6153
311520;201408;705;2418;663;2327;252;948;248;843;500;1791
311530;201408;11722;31084;8087;24765;2194;7966;2391;7029;4585;14995
311535;201408;764;2314;546;1869;132;533;100;311;232;844
311540;201408;712;2569;680;2521;221;862;348;1267;569;2129
311545;201408;2282;7144;2139;6953;315;1143;1518;4931;1833;6074
311547;201408;1683;4682;1425;4282;147;467;968;2946;1115;3413
311550;201408;3447;11249;2965;10242;873;3360;1008;3403;1881;6763
311560;201408;291;782;256;737;63;209;146;396;209;605
311570;201408;2165;5449;1731;4908;113;334;1405;4057;1518;4391
311580;201408;2470;5405;2032;4884;609;1368;1141;2888;1750;4256
311590;201408;415;1323;362;1252;116;473;105;359;221;832
311600;201408;1417;4199;1190;3924;302;967;686;2357;988;3324
311610;201408;3432;11916;3178;11505;1044;3799;1425;5524;2469;9323
311615;201408;2820;9208;2418;8518;298;1250;1701;5953;1999;7203
311620;201408;463;1492;418;1430;106;405;222;744;328;1149
311630;201408;1479;4422;1259;4028;293;932;669;2184;962;3116
311640;201408;899;2812;742;2558;135;508;489;1688;624;2196
311650;201408;2468;7075;2004;6328;303;1042;1181;3815;1484;4857
311660;201408;2700;9517;2342;8702;695;2889;427;1391;1122;4280
311670;201408;1467;4527;1262;4163;431;1565;522;1694;953;3259
311680;201408;2346;7324;1958;6756;472;1724;1109;3896;1581;5620
311690;201408;572;1578;487;1477;85;284;333;1000;418;1284
311700;201408;2266;6467;1984;6053;191;754;1532;4552;1723;5306
311710;201408;1764;5474;1385;4793;550;2070;405;1376;955;3446
311720;201408;414;1424;380;1356;64;260;245;857;309;1117
311730;201408;5596;14703;3502;10996;1056;3713;1262;3620;2318;7333
311740;201408;1012;2919;880;2758;369;1129;428;1407;797;2536
311750;201408;4009;13494;3638;12921;674;2671;2200;7830;2874;10501
311760;201408;811;2763;759;2654;216;885;330;1039;546;1924
311770;201408;2598;8226;2126;7376;576;2254;666;2217;1242;4471
311780;201408;1156;4330;985;3897;378;1673;215;803;593;2476
311783;201408;2117;6860;1858;6369;209;824;1243;4371;1452;5195
311787;201408;637;2243;468;1739;94;375;99;324;193;699
311790;201408;1352;4325;1100;3822;329;1235;300;987;629;2222
311800;201408;4014;13756;2924;10425;701;2665;223;655;924;3320
311810;201408;1051;3552;998;3457;48;229;834;2863;882;3092
311820;201408;840;2772;714;2468;232;931;329;1044;561;1975
311830;201408;10868;38921;9754;36121;3882;15058;2342;8641;6224;23699
311840;201408;3524;10522;3044;9793;941;3358;1336;4188;2277;7546
311850;201408;323;980;279;906;78;267;135;440;213;707
311860;201408;51230;159741;44601;147082;11717;42581;20036;63979;31753;106560
311870;201408;2434;7297;1937;6350;516;1933;642;1940;1158;3873
311880;201408;7259;21524;6549;20657;1001;3065;4571;15096;5572;18161
311890;201408;1650;5200;1384;4630;399;1477;545;1762;944;3239
311900;201408;809;2537;733;2433;145;480;462;1629;607;2109
311910;201408;4845;14195;3949;12971;1132;3998;1676;5555;2808;9553
311920;201408;2127;6939;1821;6459;229;905;1220;4296;1449;5201
311930;201408;4937;14664;4381;13770;1786;5891;1362;4337;3148;10228
311940;201408;11760;36192;9813;32107;3037;10826;2386;7427;5423;18253
311950;201408;2340;6948;1982;6483;136;446;1573;5212;1709;5658
311960;201408;422;1414;388;1344;117;472;175;535;292;1007
311970;201408;484;1729;416;1581;132;563;81;290;213;853
311980;201408;803;2228;575;1857;138;479;211;692;349;1171
311990;201408;522;1601;463;1510;190;658;160;488;350;1146
311995;201408;1174;3624;790;2680;173;654;186;541;359;1195
312000;201408;710;2201;665;2132;130;467;375;1193;505;1660
312010;201408;1052;3407;948;3187;202;739;432;1442;634;2181
312015;201408;1615;4963;1397;4579;214;832;842;2767;1056;3599
312020;201408;1003;3265;893;3101;239;940;458;1568;697;2508
312030;201408;1844;5500;1656;5259;183;657;1296;4095;1479;4752
312040;201408;698;2662;600;2363;171;762;129;473;300;1235
312050;201408;1492;5179;1302;4783;403;1649;299;1044;702;2693
312060;201408;764;2352;674;2223;314;1091;196;591;510;1682
312070;201408;994;3085;656;2330;168;652;234;812;402;1464
312080;201408;2698;7593;2100;6646;468;1773;1008;2934;1476;4707
312083;201408;969;2774;809;2536;134;489;481;1483;615;1972
312087;201408;2356;7213;2103;6861;320;1106;1484;4921;1804;6027
312090;201408;10058;32755;9181;31224;2933;10997;3801;12510;6734;23507
312100;201408;1385;4706;1215;4418;254;1020;673;2511;927;3531
312110;201408;1203;4291;1072;4000;411;1705;212;707;623;2412
312120;201408;948;3313;855;3107;272;1085;243;804;515;1889
312125;201408;1302;4227;1162;3940;316;1121;557;1932;873;3053
312130;201408;865;2649;706;2308;167;625;289;898;456;1523
312140;201408;1117;3558;926;3101;220;795;318;967;538;1762
312150;201408;564;1617;474;1420;41;144;321;931;362;1075
312160;201408;8284;28306;7573;26855;2420;9329;2722;9727;5142;19056
312170;201408;1029;3065;923;2861;133;437;558;1755;691;2192
312180;201408;1641;5080;1490;4817;426;1437;600;1909;1026;3346
312190;201408;699;2312;551;2018;230;929;104;356;334;1285
312200;201408;4920;14748;4275;13682;563;1912;2954;9484;3517;11396
312210;201408;1257;3422;975;3008;270;922;451;1336;721;2258
312220;201408;1956;6471;1765;6248;245;897;1336;4917;1581;5814
312230;201408;18477;61812;15629;56057;7252;27432;3332;12375;10584;39807
312235;201408;1775;5104;1488;4664;155;618;1020;3181;1175;3799
312240;201408;1129;3866;967;3523;294;1156;345;1249;639;2405
312245;201408;2433;7146;2110;6708;180;520;1691;5487;1871;6007
312247;201408;940;2777;719;2422;185;710;354;1212;539;1922
312250;201408;1202;3517;1010;3183;225;801;470;1430;695;2231
312260;201408;968;3062;796;2814;127;536;541;1900;668;2436
312270;201408;807;2522;681;2282;159;644;258;747;417;1391
312280;201408;481;1663;440;1566;197;743;58;200;255;943
312290;201408;842;2923;794;2853;336;1344;202;715;538;2059
312300;201408;1137;3808;953;3388;295;1119;148;472;443;1591
312310;201408;960;3663;876;3449;258;1103;358;1371;616;2474
312320;201408;2451;7022;1958;6000;558;1910;485;1237;1043;3147
312330;201408;1198;3603;1045;3374;267;985;586;1887;853;2872
312340;201408;328;852;292;805;43;157;220;573;263;730
312350;201408;385;1007;357;972;47;151;289;756;336;907
312352;201408;1679;5492;1543;5297;429;1486;931;3304;1360;4790
312360;201408;3782;12861;3297;11846;1094;4275;925;3292;2019;7567
312370;201408;1695;5511;1564;5295;575;2178;555;1762;1130;3940
312380;201408;2042;5970;1846;5670;250;786;1330;4211;1580;4997
312385;201408;1289;4008;1155;3776;161;666;779;2443;940;3109
312390;201408;2018;6788;1691;6063;527;1997;333;1120;860;3117
312400;201408;3512;11566;3063;10677;1128;4080;1079;3917;2207;7997
312410;201408;11002;36876;9877;34606;2978;11355;3651;12502;6629;23857
312420;201408;4153;13226;3950;12981;716;2358;2758;9337;3474;11695
312430;201408;8668;25692;7703;24247;1376;4397;5007;16273;6383;20670
312440;201408;667;2149;581;1999;144;544;291;1011;435;1555
312450;201408;1144;4113;1031;3888;446;1735;378;1424;824;3159
312460;201408;397;1212;356;1166;83;302;190;611;273;913
312470;201408;780;2227;538;1744;129;476;147;468;276;944
312480;201408;1387;4086;1144;3804;389;1391;526;1688;915;3079
312490;201408;1973;5359;1596;4807;233;853;975;2814;1208;3667
312500;201408;664;2212;611;2132;141;597;331;1112;472;1709
312510;201408;2739;8880;2242;7776;551;2195;903;2864;1454;5059
312520;201408;407;1397;358;1296;124;465;126;465;250;930
312530;201408;605;1973;572;1911;111;457;336;1054;447;1511
312540;201408;1502;4744;1180;4098;295;1122;591;1996;886;3118
312550;201408;642;2077;581;1949;60;233;391;1286;451;1519
312560;201408;2250;5946;1958;5565;213;684;1502;4295;1715;4979
312570;201408;2811;8529;2418;7832;759;2615;798;2507;1557;5122
312580;201408;541;1823;442;1620;107;467;179;613;286;1080
312590;201408;1872;6276;1648;5786;465;1879;572;1823;1037;3702
312595;201408;2086;7064;1859;6519;511;1923;876;3014;1387;4937
312600;201408;816;2960;744;2806;206;889;341;1208;547;2097
312610;201408;9014;27695;7498;24863;2745;9821;2263;7301;5008;17122
312620;201408;2111;6123;1620;5470;110;390;1310;4564;1420;4954
312630;201408;512;1733;475;1663;128;503;214;723;342;1226
312640;201408;613;2013;505;1784;128;529;205;670;333;1199
312650;201408;2397;7095;1726;5835;211;815;937;3134;1148;3949
312660;201408;1328;3710;1120;3391;149;532;758;2247;907;2779
312670;201408;6193;19020;5549;18076;1378;5036;2797;8966;4175;14002
312675;201408;1470;4649;1263;4230;220;809;717;2417;937;3226
312680;201408;1731;5298;1549;5004;248;890;939;3106;1187;3996
312690;201408;2419;6606;1986;6000;390;1380;1102;3186;1492;4566
312695;201408;929;3317;869;3230;179;661;576;2214;755;2875
312700;201408;2038;5929;1548;4992;239;861;820;2625;1059;3486
312705;201408;1447;4241;1257;3956;196;642;848;2677;1044;3319
312707;201408;1779;5512;1467;4991;243;1000;805;2679;1048;3679
312710;201408;8425;23744;6139;19676;2232;7929;1435;4328;3667;12257
312720;201408;774;2648;701;2508;187;747;301;1025;488;1772
312730;201408;1937;4800;1423;4210;231;804;839;2464;1070;3268
312733;201408;1769;4778;1334;3961;116;420;955;2736;1071;3156
312735;201408;915;2704;811;2552;269;938;400;1206;669;2144
312737;201408;1052;2581;740;2155;243;731;298;912;541;1643
312738;201408;550;1757;433;1519;127;523;168;555;295;1078
312740;201408;511;1473;349;1263;120;471;109;402;229;873
312750;201408;1317;4769;1258;4649;325;1373;603;2172;928;3545
312760;201408;2448;7923;1938;6912;574;2257;461;1655;1035;3912
312770;201408;46585;129173;36325;113216;10831;36626;12229;37645;23060;74271
312780;201408;2876;10195;2580;9680;523;2131;1480;5689;2003;7820
312790;201408;390;1020;240;751;77;278;65;172;142;450
312800;201408;5375;18239;4634;16717;1493;5765;1481;5431;2974;11196
312810;201408;2299;7088;1672;5931;559;2184;372;1244;931;3428
312820;201408;2194;6478;1975;6117;262;975;1278;3836;1540;4811
312825;201408;1552;4228;1357;3993;137;441;1075;3149;1212;3590
312830;201408;2854;9239;2060;7581;567;2293;401;1480;968;3773
312840;201408;1217;4015;1028;3650;210;891;472;1606;682;2497
312850;201408;651;2154;549;1946;125;517;206;711;331;1228
312860;201408;1337;3910;1002;3343;320;1241;295;868;615;2109
312870;201408;5768;18402;4462;15853;1225;4890;1296;4432;2521;9322
312880;201408;1283;3894;1089;3563;214;785;594;1937;808;2722
312890;201408;1613;4917;1160;3954;378;1457;392;1278;770;2735
312900;201408;1491;4808;1370;4640;355;1245;831;2866;1186;4111
312910;201408;1555;3533;1183;3023;294;868;566;1342;860;2210
312920;201408;1047;3422;922;3244;287;1127;404;1378;691;2505
312930;201408;2281;6782;2010;6391;467;1555;1026;3345;1493;4900
312940;201408;939;3166;849;3001;258;1070;254;831;512;1901
312950;201408;3570;10223;2884;9178;1004;3447;1075;3380;2079;6827
312960;201408;2012;6046;1818;5789;243;749;1357;4454;1600;5203
312965;201408;1835;5869;1558;5364;313;1160;897;3143;1210;4303
312970;201408;1200;4102;1038;3849;409;1717;202;714;611;2431
312980;201408;21768;76267;20809;73968;7915;30089;7712;26753;15627;56842
312990;201408;408;1252;311;1075;119;455;93;320;212;775
313000;201408;538;1810;445;1622;136;605;164;531;300;1136
313005;201408;2718;8794;2417;8296;437;1610;1460;5054;1897;6664
313010;201408;4218;14238;3766;13463;1181;4653;1553;5308;2734;9961
313020;201408;1060;3648;962;3425;323;1291;291;905;614;2196
313030;201408;1621;4563;1298;4121;340;1220;674;2049;1014;3269
313040;201408;992;3482;850;3079;214;858;274;941;488;1799
313050;201408;1963;6380;1616;5873;541;2204;592;2049;1133;4253
313055;201408;1554;5149;1419;4957;141;529;1075;3815;1216;4344
313060;201408;1030;3551;904;3243;394;1473;156;535;550;2008
313065;201408;2006;6571;1778;6214;304;1207;1265;4392;1569;5599
313070;201408;1277;3798;1039;3351;259;955;505;1541;764;2496
313080;201408;485;1527;396;1351;117;463;127;358;244;821
313090;201408;5596;16612;5009;15659;828;2735;3346;10615;4174;13350
313100;201408;1186;3825;1105;3705;177;657;799;2650;976;3307
313110;201408;1762;5189;1376;4451;325;1215;529;1580;854;2795
313115;201408;2898;10199;2771;9942;859;3444;1320;4526;2179;7970
313120;201408;3953;11285;3445;10568;923;2999;2010;6187;2933;9186
313130;201408;27885;87799;24471;80550;7308;26293;8464;26417;15772;52710
313140;201408;726;1902;537;1607;44;159;357;1049;401;1208
313150;201408;1695;5306;1517;4996;691;2356;419;1425;1110;3781
313160;201408;1184;3598;1046;3367;213;796;623;1923;836;2719
313170;201408;9901;36333;9052;34302;3563;14044;2066;7875;5629;21919
313180;201408;2833;7428;2133;6495;655;2199;767;2255;1422;4454
313190;201408;3662;13415;3243;12208;949;3890;1069;3881;2018;7771
313200;201408;1525;4796;1352;4505;230;893;844;2848;1074;3741
313210;201408;4679;14660;3982;13717;937;3755;2195;7283;3132;11038
313220;201408;1306;4018;975;3280;259;1005;265;794;524;1799
313230;201408;2561;9144;2400;8897;434;1675;1545;5938;1979;7613
313240;201408;8605;29036;7325;26629;2064;8282;3055;11079;5119;19361
313250;201408;7882;24649;7114;23358;1318;4432;4267;14389;5585;18821
313260;201408;638;1986;528;1774;127;489;157;506;284;995
313270;201408;5764;17032;5133;16071;764;2535;3563;11295;4327;13830
313280;201408;554;1810;429;1509;84;345;112;366;196;711
313290;201408;1048;3768;872;3415;293;1264;221;802;514;2066
313300;201408;2036;6971;1737;6239;572;2241;338;1087;910;3328
313310;201408;1089;3862;989;3639;287;1204;189;633;476;1837
313320;201408;2533;7596;2040;6763;426;1504;889;2959;1315;4463
313330;201408;4040;13132;3522;12147;739;2897;1818;6218;2557;9115
313340;201408;2360;5743;1811;4968;386;1106;1001;2724;1387;3830
313350;201408;3436;10809;2674;9077;705;2581;586;1827;1291;4408
313360;201408;1229;3749;954;3240;307;1214;421;1320;728;2534
313370;201408;1527;5336;1449;5114;302;1254;690;2264;992;3518
313375;201408;2175;5855;1468;4773;389;1527;521;1614;910;3141
313380;201408;6973;23921;6075;21945;2286;8935;1905;6574;4191;15509
313390;201408;943;3410;910;3359;135;572;617;2252;752;2824
313400;201408;3810;11066;3530;10724;427;1372;2726;8441;3153;9813
313410;201408;1417;4064;1208;3776;263;906;719;2252;982;3158
313420;201408;20906;51153;13186;37606;3209;10296;3136;8618;6345;18914
313430;201408;1334;4374;1190;4092;371;1418;451;1470;822;2888
313440;201408;6864;16411;5005;14177;724;2248;3383;9594;4107;11842
313450;201408;745;2234;596;1916;153;589;208;603;361;1192
313460;201408;2528;8975;2276;8533;745;3052;705;2541;1450;5593
313470;201408;3519;9848;3332;9635;343;867;2796;8306;3139;9173
313480;201408;1157;3397;892;2926;158;596;392;1216;550;1812
313490;201408;1702;5550;1222;4714;486;1915;285;1138;771;3053
313500;201408;458;1483;433;1434;104;401;225;711;329;1112
313505;201408;9152;27156;8524;26412;520;1170;7679;24573;8199;25743
313507;201408;1508;4228;1330;3970;248;851;791;2407;1039;3258
313510;201408;16305;48210;14551;45919;2398;7667;10060;32601;12458;40268
313520;201408;16722;50311;14146;45944;2143;7896;9081;29386;11224;37282
313530;201408;592;2005;512;1852;90;381;189;623;279;1004
313535;201408;2660;7933;2365;7442;332;1105;1571;4999;1903;6104
313540;201408;1147;3644;905;3032;267;941;230;708;497;1649
313545;201408;1425;5183;1254;4861;220;1047;773;2853;993;3900
313550;201408;2016;6836;1882;6549;536;2006;928;3130;1464;5136
313560;201408;2351;5780;2039;5427;284;676;1556;4334;1840;5010
313570;201408;835;3057;733;2860;278;1169;258;955;536;2124
313580;201408;6384;18030;5430;16729;791;2662;3829;11875;4620;14537
313590;201408;1100;3281;890;3031;410;1489;336;1127;746;2616
313600;201408;3992;12177;3498;11382;669;2338;2073;6875;2742;9213
313610;201408;1184;3708;1026;3398;272;982;451;1469;723;2451
313620;201408;7550;25378;7120;24466;2520;9205;2474;8356;4994;17561
313630;201408;9210;28131;7706;25749;2284;8452;2940;10185;5224;18637
313640;201408;916;2819;772;2608;266;982;267;887;533;1869
313650;201408;2362;7728;2098;7297;301;1048;1535;5472;1836;6520
313652;201408;1038;3749;955;3580;175;708;573;2151;748;2859
313655;201408;1035;3380;845;3058;163;679;513;1806;676;2485
313657;201408;1255;4032;1118;3807;163;729;769;2398;932;3127
313660;201408;936;3223;863;3090;220;904;419;1427;639;2331
313665;201408;3268;10891;3023;10349;719;2789;1490;4895;2209;7684
313670;201408;49050;140475;33690;113809;9789;36809;10483;34328;20272;71137
313680;201408;1145;3443;997;3211;139;460;697;2278;836;2738
313690;201408;990;3575;886;3354;269;1049;352;1374;621;2423
313695;201408;1531;4976;1301;4597;164;671;896;3182;1060;3853
313700;201408;4001;13296;3398;12469;570;2167;2334;8756;2904;10923
313710;201408;1441;4074;1200;3715;342;1146;577;1754;919;2900
313720;201408;5589;18854;4826;17214;1336;5306;1509;4901;2845;10207
313730;201408;1311;3582;1016;3222;162;571;632;2012;794;2583
313740;201408;2147;7786;1788;6851;634;2717;244;871;878;3588
313750;201408;3022;9343;2643;8612;886;3076;806;2479;1692;5555
313753;201408;1939;5876;1597;5280;501;1775;639;2134;1140;3909
313760;201408;4505;14857;3750;13274;1178;4578;1125;3784;2303;8362
313770;201408;3814;12843;3598;12377;1255;4568;1225;4168;2480;8736
313780;201408;4119;11745;3340;10600;836;3069;1622;5023;2458;8092
313790;201408;563;1964;544;1935;127;456;314;1147;441;1603
313800;201408;1289;3690;1142;3458;196;664;723;2190;919;2854
313810;201408;1599;4784;1541;4702;187;548;1206;3773;1393;4321
313820;201408;13982;40884;11754;36967;3112;10945;4975;15538;8087;26483
313830;201408;458;1564;395;1430;125;512;122;428;247;940
313835;201408;1092;3593;1038;3511;257;930;578;1941;835;2871
313840;201408;8202;24346;6681;21712;1938;7067;2208;6903;4146;13970
313850;201408;1302;3659;1173;3435;297;988;612;1696;909;2684
313860;201408;2792;8688;2283;7557;669;2516;529;1592;1198;4108
313862;201408;1207;3244;847;2648;246;814;287;913;533;1727
313865;201408;2345;7366;2143;7036;321;1182;1488;4875;1809;6057
313867;201408;1118;3871;949;3523;348;1372;319;1204;667;2576
313868;201408;1610;5666;1427;5282;188;809;956;3538;1144;4347
313870;201408;927;2913;833;2776;256;975;306;938;562;1913
313880;201408;2279;7355;2087;7095;522;2055;1051;3328;1573;5383
313890;201408;2055;5611;1738;5210;283;847;1142;3489;1425;4336
313900;201408;4906;17919;4567;17151;1715;7076;1336;4990;3051;12066
313910;201408;788;2691;675;2451;272;1068;119;402;391;1470
313920;201408;3898;12436;3460;11692;627;2136;2125;7471;2752;9607
313925;201408;2160;5724;1490;4451;131;435;951;2814;1082;3249
313930;201408;5502;18065;4604;16471;825;3209;2636;9671;3461;12880
313940;201408;7822;26940;6677;25078;2289;9345;2498;9691;4787;19036
313950;201408;5017;14639;4175;13256;1374;4901;1510;4583;2884;9484
313960;201408;6420;17139;5101;15311;1687;5610;1416;4169;3103;9779
313970;201408;1536;4500;1288;4221;233;832;854;2829;1087;3661
313980;201408;1280;4243;1101;3920;375;1473;357;1255;732;2728
313990;201408;2029;7681;1793;7116;645;2777;457;1681;1102;4458
314000;201408;8508;28996;7901;27823;2163;8675;4223;14429;6386;23104
314010;201408;1187;3413;983;3155;168;642;580;1807;748;2449
314015;201408;1622;6076;1488;5776;532;2167;478;1856;1010;4023
314020;201408;543;1698;429;1440;127;472;111;352;238;824
314030;201408;861;2798;684;2389;122;466;256;878;378;1344
314040;201408;666;1946;574;1785;188;618;283;870;471;1488
314050;201408;1999;6558;1664;5857;512;2006;522;1692;1034;3698
314053;201408;1549;5109;1431;4964;238;805;994;3595;1232;4400
314055;201408;2315;6938;2051;6571;188;630;1561;5103;1749;5733
314060;201408;1152;3650;951;3309;110;456;621;2151;731;2607
314070;201408;3823;12052;2921;10222;838;3222;746;2454;1584;5676
314080;201408;1969;6108;1386;4816;304;1197;342;1063;646;2260
314085;201408;1929;6710;1675;6343;532;2220;608;2286;1140;4506
314090;201408;3603;12363;3237;11640;1075;4183;1188;4336;2263;8519
314100;201408;3676;9832;3183;9137;379;1054;2445;7203;2824;8257
314110;201408;4569;15147;4034;14015;1037;4137;1515;4864;2552;9001
314120;201408;1093;2668;584;1852;178;643;151;450;329;1093
314130;201408;698;2051;404;1368;74;268;88;295;162;563
314140;201408;5211;16337;4578;15101;1009;3586;2199;7283;3208;10869
314150;201408;1809;4832;1409;4200;272;915;694;2028;966;2943
314160;201408;2524;6758;2000;6059;139;447;1645;5111;1784;5558
314170;201408;1141;3517;943;3082;163;627;495;1551;658;2178
314180;201408;6661;21056;5838;19811;1585;5885;2651;9186;4236;15071
314190;201408;862;2655;730;2443;229;884;283;897;512;1781
314200;201408;3146;10181;2815;9577;415;1636;1899;6371;2314;8007
314210;201408;2080;6424;1860;6017;339;1251;1087;3375;1426;4626
314220;201408;1779;5836;1488;5234;506;1991;357;1107;863;3098
314225;201408;1216;3758;1093;3587;85;266;941;3146;1026;3412
314230;201408;732;2553;678;2450;223;861;240;839;463;1700
314240;201408;1190;3805;1045;3585;199;643;703;2525;902;3168
314250;201408;549;1665;425;1408;105;407;167;506;272;913
314260;201408;1315;4777;1238;4604;429;1695;436;1605;865;3300
314270;201408;2839;9764;2623;9372;326;1339;1803;6477;2129;7816
314280;201408;3450;9893;2473;8013;764;2822;706;2021;1470;4843
314290;201408;5555;15543;4736;14230;1054;3489;2941;8696;3995;12185
314300;201408;2003;6766;1848;6399;631;2275;687;2330;1318;4605
314310;201408;6828;21850;6019;20191;2284;8163;1812;5907;4096;14070
314315;201408;989;3790;922;3659;178;799;540;2166;718;2965
314320;201408;3687;10992;2935;9968;1026;3773;1183;3998;2209;7771
314330;201408;57470;183744;53103;176404;16044;58071;23864;78411;39908;136482
314340;201408;2565;7175;1401;4714;381;1405;135;294;516;1699
314345;201408;1403;4686;1234;4417;385;1421;644;2357;1029;3778
314350;201408;1496;4391;1205;3905;511;1796;324;1025;835;2821
314360;201408;742;2369;515;1872;151;635;128;437;279;1072
314370;201408;571;2018;532;1963;155;632;268;979;423;1611
314380;201408;1257;3832;912;3168;331;1228;258;922;589;2150
314390;201408;16346;49047;12974;42584;3954;14171;3759;11789;7713;25960
314400;201408;5683;16200;4622;14720;1526;4914;2275;7612;3801;12526
314410;201408;2836;9167;2436;8329;796;3075;820;2630;1616;5705
314420;201408;797;2331;636;2106;90;374;440;1433;530;1807
314430;201408;8423;25019;7560;23445;2533;8379;2496;7904;5029;16283
314435;201408;1319;4275;1173;4013;167;705;760;2548;927;3253
314437;201408;1229;3237;1078;3011;95;266;849;2398;944;2664
314440;201408;765;2132;540;1820;206;763;107;328;313;1091
314450;201408;1836;5446;1566;5063;520;1887;728;2235;1248;4122
314460;201408;4547;15867;3941;14472;1351;5374;789;2861;2140;8235
314465;201408;2452;7852;2259;7509;222;908;1693;5510;1915;6418
314467;201408;1159;3286;994;3003;144;424;661;2054;805;2478
314470;201408;2474;8104;1976;6949;565;2275;487;1462;1052;3737
314480;201408;6530;22194;4589;16868;982;3933;514;1655;1496;5588
314490;201408;1002;3001;809;2615;254;902;316;962;570;1864
314500;201408;3030;8515;2360;7251;722;2429;839;2595;1561;5024
314505;201408;1823;5660;1722;5488;348;1209;1064;3412;1412;4621
314510;201408;2054;5818;1443;4904;521;1945;385;1260;906;3205
314520;201408;3869;14835;3225;13158;1104;4925;620;2302;1724;7227
314530;201408;7300;25567;6733;24683;1294;4883;3977;15171;5271;20054
314535;201408;2997;8346;2571;7766;353;1164;1851;5594;2204;6758
314537;201408;1461;4416;1215;3970;256;946;608;2013;864;2959
314540;201408;464;1440;408;1317;131;499;133;383;264;882
314545;201408;1422;4544;1252;4273;255;967;740;2512;995;3479
314550;201408;629;1809;487;1616;121;500;163;489;284;989
314560;201408;5471;19532;4802;17755;1255;5095;1234;4385;2489;9480
314570;201408;360;1118;311;1005;90;315;146;456;236;771
314580;201408;498;1732;407;1521;127;537;88;317;215;854
314585;201408;867;2908;617;2338;176;742;175;664;351;1406
314587;201408;1797;5731;1598;5369;294;993;879;3015;1173;4008
314590;201408;4401;15382;3272;12278;882;3511;453;1597;1335;5108
314600;201408;2147;7473;1774;6764;710;2982;377;1378;1087;4360
314610;201408;8674;30922;8125;29623;2650;10587;2914;10091;5564;20678
314620;201408;1877;5479;1669;5218;233;681;1242;4033;1475;4714
314625;201408;1582;5319;1545;5273;173;589;1242;4326;1415;4915
314630;201408;5310;15699;4655;14658;597;2083;3231;10313;3828;12396
314640;201408;849;2443;718;2210;255;824;201;580;456;1404
314650;201408;1368;4058;1065;3509;277;1040;416;1251;693;2291
314655;201408;1692;5041;1301;4310;264;937;663;2206;927;3143
314660;201408;226;627;176;528;26;93;101;285;127;378
314670;201408;1553;4312;1247;3780;234;779;708;2138;942;2917
314675;201408;1983;6071;1750;5659;236;862;1108;3606;1344;4468
314690;201408;2812;8954;2374;8175;690;2741;701;2242;1391;4983
314700;201408;10740;39729;9268;36384;3960;16366;2209;8918;6169;25284
314710;201408;8989;28781;6357;22842;1640;6635;941;3054;2581;9689
314720;201408;2735;9202;2291;8284;681;2721;905;3227;1586;5948
314730;201408;2543;7910;2128;7303;778;2916;689;2273;1467;5189
314740;201408;3190;10668;2895;10102;860;3316;1167;3896;2027;7212
314750;201408;344;1125;310;1048;68;276;143;457;211;733
314760;201408;1709;5900;1239;4663;266;1197;282;884;548;2081
314770;201408;1205;3807;732;2501;94;397;110;268;204;665
314780;201408;331;906;249;798;88;323;106;332;194;655
314790;201408;13913;42718;10700;37035;3974;15606;2762;9046;6736;24652
314795;201408;1555;4769;1359;4451;163;674;1012;3190;1175;3864
314800;201408;17652;54232;14498;47778;5855;20183;3092;10418;8947;30601
314810;201408;13403;40481;10540;35313;3432;12750;2669;8943;6101;21693
314820;201408;1146;3171;793;2642;277;1011;256;781;533;1792
314830;201408;1757;5994;1545;5570;550;2159;591;2178;1141;4337
314840;201408;1137;4010;900;3656;200;936;524;2126;724;3062
314850;201408;2324;6651;1898;5905;375;1365;1074;3302;1449;4667
314860;201408;3378;11617;3095;11156;658;2646;1875;6760;2533;9406
314870;201408;5884;18921;5245;18050;758;2928;3751;13091;4509;16019
314875;201408;1752;6006;1710;5947;245;820;1387;4908;1632;5728
314880;201408;850;2467;756;2323;70;224;539;1682;609;1906
314890;201408;596;1810;435;1487;106;421;132;392;238;813
314900;201408;442;1389;359;1246;98;354;163;565;261;919
314910;201408;1799;6300;1577;5908;650;2670;415;1466;1065;4136
314915;201408;2565;8113;2261;7667;223;886;1754;5904;1977;6790
314920;201408;658;1913;496;1675;113;433;228;720;341;1153
314930;201408;5347;18349;4730;16991;1586;6216;1132;3999;2718;10215
314940;201408;425;1261;397;1206;96;321;213;616;309;937
314950;201408;404;1375;337;1244;93;382;81;294;174;676
314960;201408;849;2757;681;2409;217;830;167;547;384;1377
314970;201408;905;3230;814;3050;306;1245;214;773;520;2018
314980;201408;2305;7112;2077;6739;874;2986;348;1079;1222;4065
314990;201408;3262;10572;2637;9170;978;3752;503;1580;1481;5332
314995;201408;1646;5103;1483;4874;202;803;1035;3337;1237;4140
315000;201408;1122;3292;912;2958;179;671;530;1692;709;2363
315010;201408;501;1611;414;1424;125;506;147;453;272;959
315015;201408;1991;6184;1812;5967;292;968;1304;4463;1596;5431
315020;201408;792;2521;617;2141;132;514;278;919;410;1433
315030;201408;1020;3141;874;2863;345;1193;211;682;556;1875
315040;201408;961;2992;883;2854;163;556;552;1769;715;2325
315050;201408;1675;5012;1383;4525;453;1623;499;1603;952;3226
315053;201408;1174;3493;1019;3246;253;958;427;1307;680;2265
315057;201408;1950;6656;1578;6073;253;1000;981;3915;1234;4915
315060;201408;983;3323;804;2889;246;959;202;751;448;1710
315070;201408;759;2271;676;2154;193;687;362;1099;555;1786
315080;201408;3524;12125;3165;11354;858;3332;1454;5178;2312;8510
315090;201408;770;2809;684;2621;178;732;248;986;426;1718
315100;201408;1219;4207;969;3630;281;1188;222;751;503;1939
315110;201408;1720;5308;1505;4913;399;1422;689;2230;1088;3652
315120;201408;14253;34522;10207;29276;1905;5748;5550;16764;7455;22512
315130;201408;1852;6197;1673;5836;579;2216;442;1500;1021;3716
315140;201408;2653;8928;2214;7967;645;2685;715;2292;1360;4977
315150;201408;4965;13746;3720;11552;894;3206;1385;4141;2279;7347
315160;201408;1376;3985;1221;3750;253;862;691;2074;944;2936
315170;201408;1382;4097;1171;3789;224;778;645;2265;869;3043
315180;201408;14798;45909;11150;38056;3156;12169;2705;8845;5861;21014
315190;201408;2431;6518;1991;5879;590;1857;955;2820;1545;4677
315200;201408;4638;15752;3873;14018;1221;4807;1055;3719;2276;8526
315210;201408;9152;28061;7647;25074;2516;8971;2652;8516;5168;17487
315213;201408;1155;3763;1106;3695;108;311;932;3216;1040;3527
315217;201408;2789;9433;2342;8661;381;1612;1364;5048;1745;6660
315220;201408;10389;30754;9110;28908;2546;8050;4725;15607;7271;23657
315230;201408;2642;7093;2356;6750;144;336;2070;6079;2214;6415
315240;201408;3436;10932;3091;10370;619;2243;1895;6341;2514;8584
315250;201408;10071;32399;7682;27793;2519;10144;2398;8622;4917;18766
315260;201408;1146;3728;906;3199;335;1321;175;549;510;1870
315270;201408;890;3194;772;2944;260;1070;198;726;458;1796
315280;201408;4069;12500;3184;10517;1104;3840;799;2510;1903;6350
315290;201408;1314;3770;1005;3270;370;1324;208;672;578;1996
315300;201408;548;1565;427;1415;204;704;145;467;349;1171
315310;201408;1269;4210;1121;3947;170;691;729;2521;899;3212
315320;201408;894;2907;742;2693;205;814;352;1328;557;2142
315330;201408;735;2660;503;2052;176;817;71;270;247;1087
315340;201408;4281;12552;3640;11538;928;3154;1687;5458;2615;8612
315350;201408;1925;5418;1503;4826;272;883;964;3208;1236;4091
315360;201408;1771;5964;1448;5114;350;1361;502;1665;852;3026
315370;201408;619;1885;546;1774;131;463;305;987;436;1450
315380;201408;298;1052;254;939;93;376;42;140;135;516
315390;201408;1980;7091;1719;6472;621;2494;429;1602;1050;4096
315400;201408;4842;14881;4210;13640;993;3485;2165;7011;3158;10496
315410;201408;1864;5148;1578;4701;269;999;980;2806;1249;3805
315415;201408;1224;4110;1125;3955;450;1571;497;1844;947;3415
315420;201408;1422;4416;1036;3660;329;1236;188;638;517;1874
315430;201408;4148;11432;3127;9695;863;3027;936;2795;1799;5822
315440;201408;995;3063;887;2893;175;641;480;1558;655;2199
315445;201408;2264;6415;1893;5910;276;993;1315;4067;1591;5060
315450;201408;2554;8117;2371;7843;496;1609;1507;5190;2003;6799
315460;201408;40174;135667;35947;126588;12805;48478;9260;31762;22065;80240
315470;201408;572;1775;498;1641;83;304;309;1001;392;1305
315480;201408;1513;4774;1011;3601;223;895;194;642;417;1537
315490;201408;3370;9585;2839;8829;497;1805;1562;4739;2059;6544
315500;201408;469;1469;307;1083;63;263;106;315;169;578
315510;201408;1526;4342;1303;3983;95;325;968;2966;1063;3291
315520;201408;1191;3673;980;3386;172;685;602;2021;774;2706
315530;201408;513;1817;482;1761;221;862;170;594;391;1456
315540;201408;1286;3950;1027;3517;240;1008;365;1207;605;2215
315550;201408;1865;5404;1525;4956;522;1898;583;1882;1105;3780
315560;201408;7442;24390;6790;23510;949;3597;4673;16347;5622;19944
315570;201408;2422;7643;2261;7400;505;1869;1308;4216;1813;6085
315580;201408;2816;8709;2283;7710;647;2539;846;2657;1493;5196
315590;201408;925;2699;836;2567;133;473;536;1598;669;2071
315600;201408;2694;9483;2231;8684;411;1681;1270;5176;1681;6857
315610;201408;1047;3112;876;2747;186;728;332;879;518;1607
315620;201408;347;1239;336;1215;101;356;176;667;277;1023
315630;201408;1025;3309;883;3078;255;956;244;825;499;1781
315640;201408;839;2526;710;2283;212;765;268;815;480;1580
315645;201408;891;2873;771;2590;313;1152;196;628;509;1780
315650;201408;2049;5842;1768;5446;162;643;1324;3997;1486;4640
315660;201408;2746;7436;2420;6941;484;1424;1461;4194;1945;5618
315670;201408;12451;44268;11375;42072;4121;16244;3658;13341;7779;29585
315680;201408;2947;10307;2420;9281;917;3600;593;2400;1510;6000
315690;201408;3477;11006;2803;9723;979;3702;813;2854;1792;6556
315700;201408;7594;24187;6533;22041;1383;5357;3156;10200;4539;15557
315710;201408;1889;5590;1516;4997;199;788;929;3026;1128;3814
315720;201408;3111;10126;2850;9616;695;2719;1410;4491;2105;7210
315725;201408;1698;5236;1380;4816;392;1413;727;2582;1119;3995
315727;201408;672;2127;590;1961;141;518;273;879;414;1397
315730;201408;1015;3142;925;2971;203;704;521;1678;724;2382
315733;201408;1203;3889;1109;3702;458;1608;373;1229;831;2837
315737;201408;1395;4232;1127;3758;114;440;710;2398;824;2838
315740;201408;1098;3493;945;3192;210;847;476;1506;686;2353
315750;201408;1176;3672;1057;3507;111;454;789;2570;900;3024
315760;201408;987;2741;953;2694;24;73;884;2503;908;2576
315765;201408;1561;4759;1444;4578;138;462;1137;3650;1275;4112
315770;201408;1733;5665;1571;5319;450;1644;565;1865;1015;3509
315780;201408;24434;81276;22604;77261;7440;27112;7079;24227;14519;51339
315790;201408;3380;11601;3014;10819;377;1310;2042;7547;2419;8857
315800;201408;1574;6166;1284;5287;394;1788;268;1050;662;2838
315810;201408;1536;4383;1308;4023;221;731;844;2552;1065;3283
315820;201408;3074;10078;2616;9380;786;2927;1257;4642;2043;7569
315830;201408;1492;5078;1352;4774;345;1362;411;1351;756;2713
315840;201408;784;2107;594;1774;111;387;221;607;332;994
315850;201408;1348;4772;1298;4668;345;1298;581;2036;926;3334
315860;201408;472;1698;377;1508;111;521;79;298;190;819
315870;201408;486;1462;412;1349;127;464;138;409;265;873
315880;201408;1138;3127;947;2884;241;841;470;1419;711;2260
315890;201408;1748;5959;1578;5698;544;2059;739;2728;1283;4787
315895;201408;5290;16595;4872;15812;1281;4613;2304;7316;3585;11929
315900;201408;810;2568;760;2484;160;628;464;1404;624;2032
315910;201408;627;2229;585;2148;218;827;274;1001;492;1828
315920;201408;1549;4539;1079;3564;301;1133;331;997;632;2130
315930;201408;1161;3245;932;2840;259;864;337;998;596;1862
315935;201408;1179;4014;1090;3819;351;1357;345;1171;696;2528
315940;201408;676;2157;603;2007;179;673;244;781;423;1454
315950;201408;1281;3967;1187;3778;285;922;711;2322;996;3244
315960;201408;2805;9369;2118;7971;1013;4368;119;372;1132;4740
315970;201408;814;2293;656;2071;75;227;479;1569;554;1796
315980;201408;4511;11151;2939;8466;765;2515;907;2289;1672;4804
315990;201408;4494;13448;3949;12598;868;3219;2130;6744;2998;9963
316000;201408;610;2000;546;1898;233;880;170;569;403;1449
316010;201408;484;1750;422;1617;111;509;133;447;244;956
316020;201408;1195;3808;961;3400;179;745;543;1901;722;2646
316030;201408;3781;10696;2702;8923;403;1450;1424;4848;1827;6298
316040;201408;3619;11485;2594;9157;467;1904;339;891;806;2795
316045;201408;2179;6982;2020;6712;286;876;1461;5098;1747;5974
316050;201408;394;1260;333;1167;79;312;179;595;258;907
316060;201408;797;2394;650;2180;121;500;361;1146;482;1646
316070;201408;6347;20813;5649;19248;1641;6236;2358;7645;3999;13881
316080;201408;756;2843;680;2635;190;811;135;531;325;1342
316090;201408;672;1972;483;1572;121;449;131;382;252;831
316095;201408;1350;4464;1213;4207;263;931;783;2785;1046;3716
316100;201408;2747;9295;2132;7711;579;2391;440;1480;1019;3871
316105;201408;984;2785;738;2381;174;621;345;1134;519;1755
316110;201408;12756;44650;11567;42459;1645;6625;7943;29850;9588;36475
316120;201408;1334;4550;1198;4216;389;1427;438;1506;827;2933
316130;201408;1510;3440;1011;2746;204;662;512;1343;716;2005
316140;201408;1107;3281;855;2878;121;459;515;1754;636;2213
316150;201408;1448;4355;1374;4239;328;1185;779;2338;1107;3523
316160;201408;1274;3854;1004;3308;142;539;560;1821;702;2360
316165;201408;1004;2778;841;2523;172;600;482;1413;654;2013
316170;201408;1449;4208;1088;3571;245;907;454;1410;699;2317
316180;201408;1306;4197;1010;3570;290;1204;273;869;563;2073
316190;201408;2774;8644;1453;5151;341;1259;251;784;592;2043
316200;201408;3955;12915;3049;11044;797;3337;901;3153;1698;6490
316210;201408;5514;17568;4819;16264;2192;7940;991;3353;3183;11293
316220;201408;690;2166;482;1757;117;507;61;233;178;740
316225;201408;1129;3300;1004;3131;139;518;698;2132;837;2650
316230;201408;466;1397;385;1253;79;277;198;672;277;949
316240;201408;6754;20898;5848;19716;659;2275;4502;15381;5161;17656
316245;201408;3218;11276;3015;10936;276;1245;2312;8367;2588;9612
316250;201408;9327;29173;8048;26540;2869;10338;2426;7574;5295;17912
316255;201408;2463;7727;2180;7386;349;1163;1584;5457;1933;6620
316257;201408;1461;4114;1119;3497;273;952;417;1268;690;2220
316260;201408;1915;5457;1425;4729;278;1029;787;2648;1065;3677
316265;201408;1211;3509;1019;3130;103;375;718;2149;821;2524
316270;201408;5232;16838;4833;16007;1384;4843;2184;7326;3568;12169
316280;201408;3442;11417;3107;10741;596;2283;1745;6050;2341;8333
316290;201408;3365;11033;3002;10342;773;3055;1332;4365;2105;7420
316292;201408;3836;12740;3509;12135;1008;3836;1604;5277;2612;9113
316294;201408;868;2816;563;2085;134;577;68;239;202;816
316295;201408;2073;7353;1947;7100;444;1891;1068;3677;1512;5568
316300;201408;1031;3184;879;2907;85;289;607;2057;692;2346
316310;201408;700;2222;546;1903;134;531;195;662;329;1193
316320;201408;584;1973;523;1888;146;579;152;527;298;1106
316330;201408;1060;3208;840;2743;135;449;500;1653;635;2102
316340;201408;1178;3842;1015;3514;318;1265;328;1031;646;2296
316350;201408;1502;4780;1367;4544;289;975;722;2547;1011;3522
316360;201408;793;2067;618;1825;72;224;470;1395;542;1619
316370;201408;5213;17285;4624;16073;1641;6119;1091;3854;2732;9973
316380;201408;1535;4329;1259;3919;134;476;896;2803;1030;3279
316390;201408;947;2862;789;2586;257;916;341;1135;598;2051
316400;201408;1519;5124;1323;4771;369;1417;549;1999;918;3416
316410;201408;1237;4145;1157;4016;261;969;680;2369;941;3338
316420;201408;2080;6916;1904;6682;275;1116;1245;4381;1520;5497
316430;201408;996;3056;809;2710;245;913;288;906;533;1819
316440;201408;683;2255;588;2131;239;987;177;619;416;1606
316443;201408;736;2242;617;2012;161;573;263;834;424;1407
316447;201408;1513;4857;1431;4729;118;424;1224;4049;1342;4473
316450;201408;2305;7931;2037;7415;401;1535;1266;4714;1667;6249
316460;201408;912;2953;854;2855;257;934;476;1529;733;2463
316470;201408;8385;27727;6645;23833;2099;8563;1981;6763;4080;15326
316480;201408;254;878;229;833;68;258;73;256;141;514
316490;201408;381;1228;363;1186;126;430;153;481;279;911
316500;201408;1088;3987;740;2897;168;715;48;184;216;899
316510;201408;980;3558;875;3327;348;1366;235;889;583;2255
316520;201408;1243;3889;1034;3564;272;1063;395;1232;667;2295
316530;201408;1154;3762;959;3348;237;1035;362;1054;599;2089
316540;201408;1034;3399;929;3222;258;1069;358;1134;616;2203
316550;201408;1321;4468;1212;4294;260;1011;761;2696;1021;3707
316553;201408;2375;8721;1988;7782;701;2963;471;1766;1172;4729
316555;201408;2925;10170;2587;9784;238;876;2080;8066;2318;8942
316556;201408;628;1754;512;1544;48;189;368;1059;416;1248
316557;201408;745;2735;715;2683;344;1385;194;674;538;2059
316560;201408;377;1284;314;1141;89;376;74;232;163;608
316570;201408;1463;4669;1280;4283;259;948;680;2270;939;3218
316580;201408;293;858;227;732;60;230;80;240;140;470
316590;201408;1555;4340;1174;3689;213;803;676;2026;889;2829
316600;201408;1200;3925;1064;3646;372;1328;306;1036;678;2364
316610;201408;633;2316;578;2214;141;590;337;1284;478;1874
316620;201408;2303;7294;2009;6706;474;1765;1073;3505;1547;5270
316630;201408;1576;5288;1383;4876;574;2107;429;1514;1003;3621
316640;201408;262;864;227;787;60;236;93;308;153;544
316650;201408;987;3742;864;3533;203;863;473;2044;676;2907
316660;201408;158;467;125;400;27;101;58;176;85;277
316670;201408;1930;5638;1563;4938;605;2127;391;1109;996;3236
316680;201408;2081;6070;1785;5620;238;739;1372;4413;1610;5152
316690;201408;1212;4176;1095;3941;379;1550;406;1411;785;2961
316695;201408;1263;3941;1125;3698;122;395;739;2543;861;2938
316700;201408;357;1215;333;1156;88;353;157;504;245;857
316710;201408;3535;13360;3073;12332;1072;4553;946;3984;2018;8537
316720;201408;19617;66564;16789;60204;5897;22508;4508;15953;10405;38461
316730;201408;451;1437;398;1334;101;394;208;643;309;1037
316740;201408;782;2691;704;2532;273;1056;217;753;490;1809
316750;201408;434;1513;386;1410;108;443;127;427;235;870
316760;201408;3682;12451;3124;11803;1766;6658;983;3954;2749;10612
316770;201408;1529;4524;1361;4298;209;718;938;3052;1147;3770
316780;201408;730;2530;680;2434;251;977;198;665;449;1642
316790;201408;870;2585;643;2180;180;693;232;766;412;1459
316800;201408;6000;20052;5456;19039;1153;4685;2793;9298;3946;13983
316805;201408;911;2468;857;2397;149;395;645;1863;794;2258
316810;201408;615;1909;537;1742;179;634;234;733;413;1367
316820;201408;406;1163;274;929;92;337;64;218;156;555
316830;201408;651;2304;629;2268;216;845;270;943;486;1788
316840;201408;2985;9118;2582;8372;704;2591;1081;3322;1785;5913
316850;201408;2251;7076;2033;6667;450;1621;1119;3672;1569;5293
316860;201408;24615;76764;22255;72371;6185;22206;9939;31964;16124;54170
316870;201408;7402;24830;6424;22461;2381;8952;1325;4525;3706;13477
316880;201408;928;3141;897;3091;358;1368;293;946;651;2314
316890;201408;1497;3862;1197;3451;478;1525;491;1344;969;2869
316900;201408;2816;8971;2455;8231;788;2938;830;2533;1618;5471
316905;201408;496;1706;439;1576;195;734;130;454;325;1188
316910;201408;760;2603;608;2268;153;599;195;757;348;1356
316920;201408;1637;4974;1318;4469;255;926;637;2156;892;3082
316930;201408;9897;34318;8330;30739;2589;10539;1703;5928;4292;16467
316935;201408;5140;15504;3581;12324;1232;4713;731;2367;1963;7080
316940;201408;7189;24267;5999;21676;1637;6564;1585;5510;3222;12074
316950;201408;1582;4695;1382;4411;212;806;930;2945;1142;3751
316960;201408;5626;14526;4661;13279;1018;3133;2732;7791;3750;10924
316970;201408;3683;12021;3483;11671;1198;4549;1151;3569;2349;8118
316980;201408;1119;3320;808;2783;340;1295;213;729;553;2024
316990;201408;10491;35154;9322;32434;3824;14438;1231;4080;5055;18518
317000;201408;2773;9690;2684;9584;215;661;2158;8448;2373;9109
317005;201408;2612;8370;2403;8088;386;1312;1742;5972;2128;7284
317010;201408;33635;88699;21524;68587;6281;22141;5435;18160;11716;40301
317020;201408;55704;163129;36067;121164;9667;35724;8966;28250;18633;63974
317030;201408;906;2571;757;2347;121;441;430;1327;551;1768
317040;201408;13732;41543;11860;38045;4049;13537;4798;15664;8847;29201
317043;201408;874;2508;739;2329;158;519;455;1460;613;1979
317047;201408;1244;3312;935;2797;190;636;427;1269;617;1905
317050;201408;1928;6836;1628;6122;480;1955;597;2154;1077;4109
317052;201408;2536;8107;2249;7670;270;1015;1667;5748;1937;6763
317057;201408;1830;5296;1417;4576;213;821;764;2407;977;3228
317060;201408;396;1188;302;979;73;274;107;311;180;585
317065;201408;1249;4174;1133;3984;132;537;885;3090;1017;3627
317070;201408;9299;30856;7120;25813;2134;8566;1549;5644;3683;14210
317075;201408;1302;4061;1103;3687;376;1359;379;1225;755;2584
317080;201408;7413;21312;6675;20062;2049;6586;2630;7905;4679;14491
317090;201408;4988;16961;4661;16395;720;2589;3190;11458;3910;14047
317100;201408;3467;10111;2906;9169;959;3362;1183;3539;2142;6901
317103;201408;2043;7136;1723;6470;356;1665;783;2855;1139;4520
317107;201408;1395;4350;1207;3969;254;964;660;2047;914;3011
317110;201408;779;2093;536;1635;155;550;210;593;365;1143
317115;201408;1126;3635;984;3318;144;519;641;2174;785;2693
317120;201408;13795;47084;11800;42318;3936;15085;4423;15659;8359;30744
317130;201408;9221;29445;8226;27641;2284;8606;3634;11945;5918;20551
317140;201408;684;2347;644;2270;88;336;424;1498;512;1834
317150;201408;1093;3025;925;2834;111;389;683;2091;794;2480
317160;201408;3892;10452;2934;9222;414;1509;1983;6173;2397;7682
317170;201408;2077;6028;1817;5563;260;923;1093;3176;1353;4099
317180;201408;1877;6381;1485;5495;442;1789;466;1674;908;3463
317190;201408;1400;4057;1167;3737;171;562;813;2604;984;3166
317200;201408;4921;16244;4442;15252;1501;5630;1417;4687;2918;10317
317210;201408;1144;3519;953;3228;260;982;461;1566;721;2548
317220;201408;362;1297;351;1284;126;465;183;689;309;1154
320010;201408;6043;19092;5349;17528;1015;3578;2761;9008;3776;12586
320013;201408;2110;6271;1487;5097;233;838;808;2848;1041;3686
320016;201408;3616;10078;3053;9266;484;1465;2137;6621;2621;8086
320020;201408;4325;14077;3972;13309;1341;4763;1476;4908;2817;9671
320030;201408;1513;4906;1258;4345;391;1435;513;1717;904;3152
320035;201408;1922;5870;1724;5554;537;1906;788;2423;1325;4329
320040;201408;3282;11154;2726;9802;756;2992;801;2752;1557;5744
320050;201408;1981;5443;1705;4908;301;969;1012;2857;1313;3826
320060;201408;11685;37186;9070;30975;2278;8602;3244;10513;5522;19115
320070;201408;1875;6292;1614;5665;542;2020;422;1381;964;3401
320080;201408;5776;17049;4612;14714;1433;4888;1508;4758;2941;9646
320090;201408;9225;26556;7183;22535;1972;6615;3196;9730;5168;16345
320100;201408;3326;10097;2749;8937;687;2400;1307;4178;1994;6578
320110;201408;1569;4797;1419;4508;394;1336;511;1602;905;2938
320115;201408;1814;6575;1676;6274;872;3387;505;1912;1377;5299
320120;201408;18548;61714;15519;55536;5496;21049;4575;16550;10071;37599
320130;201408;42822;142839;39633;136014;11108;41473;18694;62678;29802;104151
320140;201408;4133;13426;2933;10488;799;3182;321;1058;1120;4240
320150;201408;18701;53334;13975;44212;4406;15031;2706;8450;7112;23481
320160;201408;5507;16949;4740;15629;1299;4825;2013;6186;3312;11011
320170;201408;1656;5426;1416;4891;398;1451;556;1953;954;3404
320180;201408;911;3013;818;2870;304;1106;325;1154;629;2260
320190;201408;4294;14914;3507;12940;1114;4325;1071;3891;2185;8216
320200;201408;1187;3823;1037;3523;306;1110;452;1563;758;2673
320210;201408;4959;13999;4311;12801;895;3052;2403;6784;3298;9836
320220;201408;3033;9327;2404;8200;724;2687;926;3190;1650;5877
320225;201408;1543;5445;1320;4865;495;1931;300;1166;795;3097
320230;201408;4339;14598;4044;14024;1408;5214;1462;5178;2870;10392
320240;201408;10666;32345;8336;27839;2484;8912;2332;7809;4816;16721
320245;201408;4200;14387;3896;13629;1281;4726;1389;4760;2670;9486
320250;201408;1862;5834;1388;4746;374;1427;310;956;684;2383
320255;201408;2086;7015;1812;6536;745;2873;648;2403;1393;5276
320260;201408;1139;3562;864;2843;236;875;304;858;540;1733
320265;201408;2508;7759;2136;7313;286;987;1573;5560;1859;6547
320270;201408;2810;8634;2153;7300;558;2055;933;3109;1491;5164
320280;201408;7402;22701;6721;21427;1603;5533;3356;10510;4959;16043
320290;201408;1743;5782;1379;4841;496;1824;353;1140;849;2964
320300;201408;4409;15009;4062;14205;1307;4828;1315;4608;2622;9436
320305;201408;4936;16308;4482;15267;1162;4325;2058;6836;3220;11161
320310;201408;2061;6281;1818;5823;500;1729;813;2538;1313;4267
320313;201408;2442;7364;1742;5729;504;1902;306;901;810;2803
320316;201408;2294;7151;2114;6747;666;2222;887;2812;1553;5034
320320;201408;19910;64151;16914;58317;5147;19741;6532;21923;11679;41664
320330;201408;3116;9445;2692;8724;570;1819;1573;5293;2143;7112
320332;201408;5210;17751;4693;16768;1619;6090;1824;6676;3443;12766
320334;201408;1651;5492;1237;4563;416;1703;269;908;685;2611
320335;201408;2317;7024;1637;5446;573;2088;335;1063;908;3151
320340;201408;5925;16826;4763;14805;1173;4011;2232;6858;3405;10869
320350;201408;5710;14979;4176;12304;874;2798;1897;5530;2771;8328
320360;201408;1801;4831;1368;4008;273;911;643;1746;916;2657
320370;201408;3567;11821;3055;10776;964;3449;1178;4197;2142;7646
320380;201408;2920;8915;2609;8318;519;1802;1530;4790;2049;6592
320390;201408;8529;25998;7006;22868;2224;7980;2306;7188;4530;15168
320400;201408;4174;12103;3476;11062;962;3426;1613;4845;2575;8271
320405;201408;4117;12323;3776;11865;1086;3716;2139;6594;3225;10310
320410;201408;6397;15791;4603;13715;874;2712;2898;8672;3772;11384
320420;201408;1603;5008;1171;4226;395;1582;223;751;618;2333
320425;201408;2506;6419;2038;5724;356;1103;1240;3452;1596;4555
320430;201408;2469;7253;2230;6771;456;1476;1178;3543;1634;5019
320435;201408;2638;8895;2253;8068;1059;3934;700;2602;1759;6536
320440;201408;1467;4940;1309;4497;397;1484;418;1352;815;2836
320450;201408;2583;8333;2189;7480;663;2452;913;3033;1576;5485
320455;201408;4491;15693;3454;13014;1140;4511;824;3076;1964;7587
320460;201408;3230;10523;2595;9160;756;2856;946;3252;1702;6108
320465;201408;1714;5444;1339;4536;334;1222;513;1662;847;2884
320470;201408;4810;14799;3414;11676;1119;4172;520;1597;1639;5769
320480;201408;2030;6163;1688;5483;428;1607;732;2254;1160;3861
320490;201408;18181;58106;15360;52476;5236;19020;5146;18002;10382;37022
320495;201408;1370;4368;1064;3661;478;1709;158;564;636;2273
320500;201408;48551;151959;42241;139742;12873;46225;18850;60936;31723;107161
320501;201408;3884;12661;3524;12045;1171;4484;1527;5042;2698;9526
320503;201408;2039;7187;1680;6302;540;2197;489;1669;1029;3866
320506;201408;3464;11000;2331;8048;701;2582;271;866;972;3448
320510;201408;9077;29101;7955;26811;2512;9120;3294;10921;5806;20041
320515;201408;2185;6309;1932;5810;573;1817;688;2010;1261;3827
320517;201408;2338;7681;1939;6826;777;2940;428;1420;1205;4360
320520;201408;36005;115045;30512;104069;9735;36216;12350;41945;22085;78161
320530;201408;29493;92469;25307;83989;6753;25410;11300;35593;18053;61003
330010;201408;18897;59068;17346;55880;3444;12514;10518;32836;13962;45350
330015;201408;2035;5688;1766;5183;465;1529;669;1895;1134;3424
330020;201408;17406;52367;15907;49917;3714;12597;9053;28108;12767;40705
330022;201408;1750;5601;1539;5191;326;1287;833;2683;1159;3970
330023;201408;3572;11659;3336;11163;925;3370;1393;4462;2318;7832
330025;201408;3700;10983;3273;10352;818;2773;1908;5970;2726;8743
330030;201408;8172;27970;7271;26062;1995;7854;3276;11289;5271;19143
330040;201408;14889;43218;12650;39530;3380;11383;6343;19400;9723;30783
330045;201408;70624;202902;64168;193051;9390;30379;44577;133254;53967;163633
330050;201408;3029;9677;2697;9004;935;3471;794;2490;1729;5961
330060;201408;5817;17754;5208;16860;1279;4560;2954;9614;4233;14174
330070;201408;26331;81931;24068;77811;6637;22785;11262;36465;17899;59250
330080;201408;9767;27980;9242;27210;1735;4975;6342;19195;8077;24170
330090;201408;3367;9333;3111;8891;853;2619;1515;4262;2368;6881
330093;201408;2069;6188;1729;5509;437;1492;585;1766;1022;3258
330095;201408;1237;4311;1144;4096;431;1688;211;690;642;2378
330100;201408;58033;190226;53307;181752;12000;45206;27731;95335;39731;140541
330110;201408;2773;8803;2533;8353;790;2823;867;2853;1657;5676
330115;201408;2528;7546;2313;7183;687;2338;1069;3204;1756;5542
330120;201408;2602;7575;2373;7259;742;2449;1110;3295;1852;5744
330130;201408;4198;13854;3776;13038;1247;4626;1510;5196;2757;9822
330140;201408;3554;10933;3242;10499;900;3113;1634;5342;2534;8455
330150;201408;2664;7990;2066;6731;557;1969;501;1591;1058;3560
330160;201408;1442;5019;1336;4791;487;1867;495;1742;982;3609
330170;201408;108610;330626;101446;319209;16096;54180;70128;220854;86224;275034
330180;201408;1910;5816;1668;5352;233;955;1041;3107;1274;4062
330185;201408;8317;26396;7644;25181;2003;6901;4097;13774;6100;20675
330187;201408;4525;13013;4002;12134;847;2809;2380;7229;3227;10038
330190;201408;29421;88586;27964;86168;6623;21592;17060;52029;23683;73621
330200;201408;14434;45643;12968;42859;3100;10459;7061;23761;10161;34220
330205;201408;2686;7320;2369;6771;589;1880;1182;3263;1771;5143
330210;201408;4620;12139;3326;9746;1002;3185;811;2352;1813;5537
330220;201408;11992;37843;10953;35641;3629;12723;3410;10616;7039;23339
330225;201408;4238;13333;3969;12926;511;1924;2876;9464;3387;11388
330227;201408;18670;52882;16619;49997;4094;13054;9477;28162;13571;41216
330230;201408;1541;4586;1409;4347;414;1415;584;1693;998;3108
330240;201408;21091;65820;18782;61556;7574;26811;3745;12029;11319;38840
330245;201408;1307;4144;1075;3670;319;1188;256;869;575;2057
330250;201408;38693;114020;35894;109290;10539;32417;17929;55861;28468;88278
330260;201408;4031;12790;3695;12068;932;3322;1734;5466;2666;8788
330270;201408;14711;42911;12334;39147;3747;12591;4723;15258;8470;27849
330280;201408;2145;6686;1805;5974;386;1423;863;2709;1249;4132
330285;201408;19866;58745;18240;56366;3680;12179;11657;36129;15337;48308
330290;201408;3714;10502;3281;9876;670;2305;1947;5599;2617;7904
330300;201408;4213;13716;3919;13170;934;3368;2113;7111;3047;10479
330310;201408;2872;8317;2589;7830;622;1918;1327;4020;1949;5938
330320;201408;12992;39012;12179;37743;1867;6329;8732;26911;10599;33240
330330;201408;33340;95780;30501;91224;7024;22501;18717;55385;25741;77886
330340;201408;15554;47855;12609;41970;4071;14467;3661;12123;7732;26590
330350;201408;97568;306993;93660;301108;17313;56417;66269;215809;83582;272226
330360;201408;5872;18422;5733;18210;731;2524;4515;14278;5246;16802
330370;201408;3964;14675;3723;14099;1437;5703;1273;4847;2710;10550
330380;201408;4840;15674;4231;14527;1017;3777;2196;7448;3213;11225
330385;201408;4198;14611;3879;13946;1306;4981;1507;5392;2813;10373
330390;201408;24938;84193;22717;79662;5677;22152;11503;39497;17180;61649
330395;201408;3504;10441;3232;9962;588;1987;1966;6012;2554;7999
330400;201408;2673;8932;2439;8479;522;2105;1278;4124;1800;6229
330410;201408;3147;10058;2712;9173;619;2209;1385;4706;2004;6915
330411;201408;2675;8487;2346;7810;479;1868;1257;3951;1736;5819
330412;201408;1435;4952;1141;4375;310;1357;404;1467;714;2824
330414;201408;26650;75874;22906;70805;4292;13871;14782;46039;19074;59910
330415;201408;3766;11789;3312;10937;878;3163;1425;4689;2303;7852
330420;201408;9083;28265;6529;23069;1961;7606;1196;4183;3157;11789
330430;201408;8661;25515;7691;23805;1809;6126;3863;11770;5672;17896
330440;201408;2145;7187;1804;6473;636;2543;401;1302;1037;3845
330450;201408;1702;5853;1587;5619;501;1987;679;2364;1180;4351
330452;201408;10545;32516;8625;28656;2400;8855;3544;11320;5944;20175
330455;201408;497700;1453440;424261;1332790;111370;372548;216707;679236;328077;1051784
330460;201408;1419;4759;1313;4565;332;1329;637;2188;969;3517
330470;201408;4877;15646;4445;14800;1536;5582;1600;5126;3136;10708
330475;201408;8541;26962;7660;25448;2131;7685;3594;11959;5725;19644
330480;201408;6770;20165;6202;19268;1693;5655;2955;9095;4648;14750
330490;201408;105280;294056;97532;282808;12505;38077;75078;218559;87583;256636
330500;201408;7100;21729;6673;20875;1479;4945;3699;11818;5178;16763
330510;201408;44092;141551;41221;136745;13281;44842;20521;69613;33802;114455
330513;201408;1622;4891;1478;4616;521;1650;594;1886;1115;3536
330515;201408;3172;10022;2872;9450;956;3328;1023;3316;1979;6644
330520;201408;13531;40683;12357;38703;3194;10457;6552;20656;9746;31113
330530;201408;1595;4770;1454;4508;392;1317;670;2032;1062;3349
330540;201408;3552;10623;3030;9753;865;2995;1271;4026;2136;7021
330550;201408;9209;30410;8107;28324;3393;12526;2036;7155;5429;19681
330555;201408;10789;32806;9683;31120;1906;6292;6176;20221;8082;26513
330560;201408;4357;13304;4027;12748;897;3227;2174;6646;3071;9873
330570;201408;3727;10792;3163;9822;824;2636;1630;5134;2454;7770
330575;201408;5769;17128;5232;16189;1149;3894;3092;9257;4241;13151
330580;201408;17808;57327;15516;52646;5087;18092;5911;20408;10998;38500
330590;201408;2010;6063;1879;5834;538;1689;987;3124;1525;4813
330600;201408;10733;31341;8789;28166;1369;5289;5256;16201;6625;21490
330610;201408;9399;30288;8675;28937;2059;7700;4538;14927;6597;22627
330615;201408;1701;6079;1561;5707;692;2642;451;1701;1143;4343
330620;201408;4171;14579;3812;13861;1398;5395;1090;4099;2488;9494
330630;201408;23070;74044;20237;68479;5220;19799;10141;32860;15361;52659
350010;201408;3041;9496;2363;8061;803;2875;461;1487;1264;4362
350020;201408;649;1844;492;1540;142;500;196;583;338;1083
350030;201408;4952;15813;4097;13877;1540;5687;1092;3512;2632;9199
350040;201408;613;2204;526;2008;176;723;117;401;293;1124
350050;201408;1439;4694;1198;4225;335;1350;400;1303;735;2653
350055;201408;668;2166;631;2107;198;748;311;968;509;1716
350060;201408;95;330;88;317;27;114;34;114;61;228
350070;201408;2804;9247;2189;7775;540;2123;447;1381;987;3504
350075;201408;563;1953;483;1813;163;688;132;444;295;1132
350080;201408;623;1838;483;1546;120;422;183;580;303;1002
350090;201408;601;1713;448;1438;126;435;127;366;253;801
350100;201408;2129;7161;1708;6193;571;2218;509;1782;1080;4000
350110;201408;502;1536;387;1272;94;352;149;450;243;802
350115;201408;1402;4534;1238;4130;264;1016;583;1769;847;2785
350120;201408;558;1502;295;936;72;244;56;169;128;413
350130;201408;3885;11854;3500;11082;857;3049;1651;4873;2508;7922
350140;201408;709;2244;637;2102;156;585;278;874;434;1459
350150;201408;435;1505;400;1424;155;578;107;380;262;958
350160;201408;6580;20745;5021;17318;1498;5739;1894;5975;3392;11714
350170;201408;2322;8240;2061;7568;716;2740;493;1726;1209;4466
350180;201408;1474;3888;1219;3446;326;952;532;1479;858;2431
350190;201408;3450;11627;2977;10674;799;3374;1465;4762;2264;8136
350200;201408;412;1406;374;1340;129;520;134;461;263;981
350210;201408;7810;21874;6160;18992;2335;7782;2062;6051;4397;13833
350220;201408;3214;10333;2918;9792;1017;3866;932;2853;1949;6719
350230;201408;787;2663;721;2550;240;917;258;910;498;1827
350240;201408;612;1871;532;1741;127;466;296;938;423;1404
350250;201408;2834;10526;2741;10341;1125;4495;972;3635;2097;8130
350260;201408;1109;2967;910;2622;214;627;408;1203;622;1830
350270;201408;5474;16811;4791;15356;988;3468;2339;7387;3327;10855
350275;201408;2114;7074;1898;6734;561;2201;739;2472;1300;4673
350280;201408;24086;62682;15581;47258;4102;13229;3698;11319;7800;24548
350290;201408;1960;6710;1700;6117;518;1918;542;1998;1060;3916
350300;201408;537;1670;481;1559;145;489;198;653;343;1142
350310;201408;969;3256;888;3066;217;857;370;1205;587;2062
350315;201408;576;1821;474;1606;90;389;152;476;242;865
350320;201408;12398;40041;10837;36628;3367;12153;1872;6365;5239;18518
350330;201408;13070;37988;8582;26872;1869;6209;3254;9387;5123;15596
350335;201408;568;1679;524;1586;138;435;223;733;361;1168
350340;201408;1146;3589;888;3080;230;883;279;937;509;1820
350350;201408;771;2460;679;2303;176;690;249;838;425;1528
350360;201408;912;3239;789;2960;261;1028;280;1071;541;2099
350370;201408;734;2274;557;1864;126;469;107;302;233;771
350380;201408;3975;12921;3312;11835;1358;5280;850;2878;2208;8158
350390;201408;8918;28769;7915;26857;2315;8420;3579;11774;5894;20194
350395;201408;364;1101;246;853;71;267;60;199;131;466
350400;201408;8728;25620;7204;22836;2089;7240;2795;8483;4884;15723
350410;201408;8434;30264;7061;27081;2443;10135;1652;6102;4095;16237
350420;201408;949;3042;760;2673;371;1347;95;332;466;1679
350430;201408;878;2769;753;2551;205;818;376;1221;581;2039
350440;201408;1495;4829;1402;4646;453;1598;672;2138;1125;3736
350450;201408;8284;25145;6573;21718;2049;7331;1833;5769;3882;13100
350460;201408;1641;4849;1192;3883;349;1279;382;1129;731;2408
350470;201408;255;718;212;648;56;203;102;283;158;486
350480;201408;753;2345;502;1749;86;338;86;255;172;593
350490;201408;2124;6225;1813;5799;520;1910;828;2467;1348;4377
350500;201408;619;1831;538;1706;140;489;224;677;364;1166
350510;201408;1162;3693;944;3167;273;1033;335;1022;608;2055
350520;201408;980;3677;840;3371;272;1190;229;863;501;2053
350530;201408;2663;8058;2197;7024;793;2736;624;1832;1417;4568
350535;201408;1516;4521;1453;4423;97;352;1211;3671;1308;4023
350540;201408;2121;6024;1784;5421;506;1646;704;2140;1210;3786
350550;201408;11273;33258;9030;29302;2492;9061;3557;10933;6049;19994
350560;201408;3644;12237;3295;11490;640;2383;1720;6070;2360;8453
350570;201408;22134;76511;20209;72008;6625;25214;7371;25293;13996;50507
350580;201408;2126;6977;1687;5912;548;2125;275;834;823;2959
350590;201408;4351;14042;3351;11869;1018;4031;1155;3693;2173;7724
350600;201408;41679;106546;29040;85957;5884;19231;14679;41861;20563;61092
350610;201408;9659;28192;7597;24600;2031;7336;3326;10415;5357;17751
350620;201408;504;1525;412;1376;106;398;175;549;281;947
350630;201408;1767;5462;1379;4662;422;1602;272;816;694;2418
350635;201408;5431;17501;4351;15368;1339;5013;1682;5941;3021;10954
350640;201408;701;2293;557;1894;156;567;155;493;311;1060
350650;201408;6459;19950;3605;12897;1130;4487;373;1310;1503;5797
350660;201408;3841;12081;3337;11188;806;2974;1782;5855;2588;8829
350670;201408;1938;6057;1807;5808;374;1312;1124;3496;1498;4808
350680;201408;1267;3965;1021;3447;296;1171;408;1306;704;2477
350690;201408;1123;3736;945;3357;292;1140;266;876;558;2016
350700;201408;2858;9835;2473;8945;955;3775;835;2701;1790;6476
350710;201408;2346;7479;2125;7113;342;1268;1405;4661;1747;5929
350715;201408;1130;3452;994;3193;299;1097;349;1027;648;2124
350720;201408;147;447;132;414;45;158;46;123;91;281
350730;201408;447;1710;421;1637;133;576;137;497;270;1073
350740;201408;2546;7737;2204;6977;569;1959;938;2940;1507;4899
350745;201408;404;1275;314;1057;65;260;142;423;207;683
350750;201408;10416;32061;8029;27227;2280;8485;2138;6782;4418;15267
350760;201408;12840;41041;11525;38614;3582;13343;5154;16463;8736;29806
350770;201408;939;2777;677;2258;158;600;266;861;424;1461
350775;201408;692;1968;599;1815;149;522;276;817;425;1339
350780;201408;2217;6774;1642;5540;523;1956;223;695;746;2651
350790;201408;2239;7319;1774;6317;556;2126;393;1255;949;3381
350800;201408;3205;10924;3051;10664;653;2576;1879;6407;2532;8983
350810;201408;2665;7808;2329;7218;839;2822;727;2256;1566;5078
350820;201408;589;1626;435;1297;97;346;181;478;278;824
350830;201408;922;2921;662;2282;128;488;150;440;278;928
350840;201408;2436;8724;2022;7675;658;2758;410;1349;1068;4107
350850;201408;6874;23488;5736;20756;2055;7886;1425;4967;3480;12853
350860;201408;3481;11245;3328;11003;492;1846;2490;8171;2982;10017
350870;201408;2597;8752;2285;8257;678;2644;1268;4632;1946;7276
350880;201408;1742;5922;1494;5364;489;1847;327;1186;816;3033
350890;201408;711;2116;516;1676;101;392;155;415;256;807
350900;201408;4714;15927;3886;14009;1079;4216;1050;3576;2129;7792
350910;201408;924;2825;855;2675;337;1095;307;940;644;2035
350920;201408;10316;30951;9440;29464;1822;6254;6040;18246;7862;24500
350925;201408;5485;17100;4854;15824;1423;5055;2100;6532;3523;11587
350930;201408;1614;4510;1353;4075;169;619;946;2730;1115;3349
350940;201408;2374;7953;2166;7605;481;1953;1292;4346;1773;6299
350945;201408;966;3224;851;2971;214;822;382;1278;596;2100
350950;201408;74323;238993;63016;215673;18226;67892;26032;86592;44258;154484
350960;201408;4778;16876;4233;15630;828;3528;2390;8489;3218;12017
350970;201408;4617;16666;4080;15325;1464;5952;1201;4291;2665;10243
350980;201408;721;2345;657;2234;319;1145;168;576;487;1721
350990;201408;1872;6542;1646;6105;574;2261;536;1944;1110;4205
350995;201408;854;3030;811;2948;219;919;423;1464;642;2383
351000;201408;3756;11426;3236;10417;521;1916;1839;5710;2360;7626
351010;201408;444;1341;320;1083;128;483;72;237;200;720
351015;201408;974;3261;841;3010;300;1189;298;1021;598;2210
351020;201408;8137;26400;7181;24885;1954;7307;3515;12265;5469;19572
351030;201408;1620;5890;1500;5613;435;1908;566;1956;1001;3864
351040;201408;3894;12472;3587;11912;801;3104;2120;6641;2921;9745
351050;201408;10285;32815;8240;28784;2694;10235;2845;9869;5539;20104
351060;201408;37261;116064;31055;104287;9608;34459;11824;39235;21432;73694
351070;201408;1956;5556;1402;4556;512;1828;253;701;765;2529
351080;201408;2912;8805;2307;8043;682;2642;1066;3599;1748;6241
351090;201408;398;1379;310;1188;93;411;67;245;160;656
351100;201408;2171;6880;1822;6175;713;2515;565;1927;1278;4442
351110;201408;8266;21521;4655;15156;1327;4809;1221;3698;2548;8507
351120;201408;633;1938;539;1718;74;272;274;783;348;1055
351130;201408;919;2567;484;1653;93;377;120;375;213;752
351140;201408;2057;7144;1874;6739;712;2777;590;2057;1302;4834
351150;201408;2315;8090;1867;6852;546;2195;441;1474;987;3669
351160;201408;1598;5630;1437;5246;481;1951;500;1739;981;3690
351170;201408;1695;5622;1368;4847;357;1387;570;1872;927;3259
351190;201408;723;2353;588;1996;148;546;122;351;270;897
351200;201408;2403;7199;2024;6435;461;1698;841;2440;1302;4138
351210;201408;1153;3628;961;3233;293;1057;326;1032;619;2089
351220;201408;3646;12381;3225;11500;849;3249;1501;5325;2350;8574
351230;201408;2011;6711;1808;6310;531;2054;922;3127;1453;5181
351240;201408;1029;3313;742;2633;213;836;182;557;395;1393
351250;201408;906;2626;676;2156;131;460;321;982;452;1442
351260;201408;1203;3585;1081;3325;275;931;452;1316;727;2247
351270;201408;415;1477;382;1410;125;522;131;430;256;952
351280;201408;5545;16807;4079;13456;1065;3771;1321;3962;2386;7733
351290;201408;1163;3442;922;2972;297;991;309;934;606;1925
351300;201408;11306;40911;9476;36602;2852;11928;3417;13084;6269;25012
351310;201408;3524;11099;2959;10034;724;2833;1419;4463;2143;7296
351320;201408;1036;3667;899;3336;301;1202;230;760;531;1962
351330;201408;306;873;259;789;112;346;66;200;178;546
351340;201408;6854;23937;6185;22543;1787;6866;2978;10870;4765;17736
351350;201408;8161;26901;7197;24809;2209;7990;2605;8619;4814;16609
351360;201408;4935;15196;4620;14628;1280;4402;2167;6670;3447;11072
351370;201408;2259;7265;1804;6274;555;2184;537;1703;1092;3887
351380;201408;38026;119362;35082;113467;9254;32573;16881;52470;26135;85043
351385;201408;254;798;247;787;84;271;104;326;188;597
351390;201408;1333;4459;1159;4090;417;1606;454;1501;871;3107
351400;201408;1245;4049;1172;3872;457;1602;360;1211;817;2813
351410;201408;3081;9373;2722;8729;625;2142;1451;4574;2076;6716
351420;201408;458;1366;333;1089;100;332;63;205;163;537
351430;201408;935;2984;856;2840;138;483;612;2043;750;2526
351440;201408;4853;14941;4105;13284;1520;5085;1052;3207;2572;8292
351450;201408;1864;5347;1641;5036;517;1622;807;2553;1324;4175
351460;201408;865;2735;737;2483;355;1272;216;693;571;1965
351470;201408;1134;3488;1009;3242;378;1325;323;1009;701;2334
351480;201408;3045;9959;2773;9497;638;2577;1425;4731;2063;7308
351490;201408;2066;7006;1851;6535;373;1528;1012;3412;1385;4940
351492;201408;191;605;133;462;25;103;53;171;78;274
351495;201408;164;565;130;478;44;174;42;144;86;318
351500;201408;21990;70829;19231;65101;6129;22616;7623;24992;13752;47608
351510;201408;8178;26428;6935;24076;1766;6628;3457;11894;5223;18522
351512;201408;447;1326;375;1187;90;305;179;555;269;860
351515;201408;2208;7257;1700;6099;539;2091;474;1594;1013;3685
351518;201408;1776;6089;1308;5209;395;1769;304;1114;699;2883
351519;201408;882;2790;735;2454;212;826;283;847;495;1673
351520;201408;832;2320;410;1454;80;325;65;198;145;523
351530;201408;496;1567;396;1317;78;276;135;402;213;678
351535;201408;2690;6999;2165;6250;247;813;1528;4367;1775;5180
351540;201408;2265;7213;1998;6716;909;3252;426;1394;1335;4646
351550;201408;4349;12778;3112;10302;764;2897;1119;3568;1883;6465
351560;201408;454;1473;394;1331;130;479;77;248;207;727
351565;201408;251;846;233;800;74;291;96;297;170;588
351570;201408;13414;43503;11690;39983;3348;12122;5612;18996;8960;31118
351580;201408;418;1167;310;943;59;181;106;307;165;488
351590;201408;534;1479;411;1225;124;396;93;256;217;652
351600;201408;1974;5668;1767;5309;384;1328;885;2476;1269;3804
351610;201408;698;1928;559;1688;105;373;286;811;391;1184
351620;201408;17596;57589;13451;48545;3486;13931;3480;11163;6966;25094
351630;201408;16609;55664;15287;53422;3931;14277;8665;30528;12596;44805
351640;201408;9029;29049;7527;26375;1771;6794;3969;13657;5740;20451
351650;201408;421;1268;254;845;75;264;38;118;113;382
351660;201408;792;2496;598;2026;143;510;168;522;311;1032
351670;201408;4052;12654;3369;11205;645;2496;1734;5439;2379;7935
351680;201408;678;2090;426;1432;102;369;70;199;172;568
351685;201408;469;1439;381;1279;101;352;158;543;259;895
351690;201408;1398;4177;1080;3431;429;1367;306;926;735;2293
351700;201408;1553;4657;1392;4344;472;1529;503;1525;975;3054
351710;201408;818;2577;690;2284;179;626;221;669;400;1295
351720;201408;1794;5677;1326;4448;327;1199;453;1413;780;2612
351730;201408;1173;3474;988;3221;408;1462;333;1019;741;2481
351740;201408;4875;13930;4045;12181;1116;3579;1324;3757;2440;7336
351750;201408;1561;5181;1347;4738;449;1766;382;1235;831;3001
351760;201408;3891;12550;3412;11474;951;3440;1429;4606;2380;8046
351770;201408;2396;7762;2092;7199;623;2275;1046;3544;1669;5819
351780;201408;1638;4689;1081;3452;297;1031;236;705;533;1736
351790;201408;1192;3556;1021;3310;379;1290;420;1336;799;2626
351800;201408;397;900;314;777;40;114;196;459;236;573
351810;201408;1226;3733;1151;3635;281;1023;736;2228;1017;3251
351820;201408;2023;6436;1662;5780;561;2072;206;685;767;2757
351830;201408;4584;14803;3807;12924;908;3361;1807;5923;2715;9284
351840;201408;9252;32180;8263;30084;2861;11042;2818;10114;5679;21156
351850;201408;1500;4876;1213;4265;351;1414;374;1143;725;2557
351860;201408;3740;12130;3382;11394;987;3646;1524;4902;2511;8548
351870;201408;36262;112557;32890;106503;8204;28289;18216;58928;26420;87217
351880;201408;105979;346110;92563;316597;29266;105997;27444;92783;56710;198780
351885;201408;672;2461;627;2359;180;743;289;1044;469;1787
351890;201408;851;2568;684;2215;209;732;177;540;386;1272
351900;201408;1457;4515;1258;4201;378;1333;487;1637;865;2970
351905;201408;453;1545;386;1423;95;420;200;675;295;1095
351907;201408;16149;50842;13992;46680;2965;11262;7481;23916;10446;35178
351910;201408;1213;3874;1119;3721;280;1065;433;1351;713;2416
351920;201408;1234;3549;1151;3415;267;889;683;1990;950;2879
351925;201408;1041;3075;954;2920;154;583;606;1724;760;2307
351930;201408;3248;11075;3018;10589;858;3499;1426;4554;2284;8053
351940;201408;1056;3251;979;3115;282;981;571;1746;853;2727
351950;201408;1455;4035;1061;3276;204;713;530;1557;734;2270
351960;201408;4332;13004;3329;11162;954;3386;1540;5160;2494;8546
351970;201408;7134;27104;6462;25624;2353;9763;2204;8792;4557;18555
351980;201408;972;3000;790;2637;182;697;313;927;495;1624
351990;201408;1661;4801;1332;4144;406;1447;352;952;758;2399
352000;201408;2565;8275;2329;7789;634;2276;1020;3246;1654;5522
352010;201408;2330;7962;2102;7386;745;2731;467;1631;1212;4362
352020;201408;1604;5166;1424;4796;449;1603;520;1725;969;3328
352030;201408;4838;14891;4285;14104;1045;3595;2414;8094;3459;11689
352040;201408;2035;7097;1722;6310;489;1940;426;1440;915;3380
352042;201408;2551;7181;1872;5756;443;1498;949;2844;1392;4342
352044;201408;1509;5075;1169;4191;281;1072;237;765;518;1837
352050;201408;6834;22228;4714;17388;1447;5897;934;2994;2381;8891
352060;201408;859;2563;750;2377;199;744;307;895;506;1639
352070;201408;764;2073;708;1986;277;816;259;774;536;1590
352080;201408;556;1711;468;1559;143;541;157;468;300;1009
352090;201408;1802;5879;1437;5080;380;1527;410;1279;790;2806
352100;201408;2540;7935;1860;6563;537;2126;648;2071;1185;4197
352110;201408;480;1802;431;1683;131;551;154;578;285;1129
352115;201408;421;1384;360;1248;94;370;163;528;257;898
352120;201408;914;2824;795;2634;157;576;438;1447;595;2023
352130;201408;1901;5515;1348;4415;384;1373;468;1393;852;2766
352140;201408;1714;5365;1218;4249;333;1256;513;1748;846;3004
352150;201408;708;2166;540;1828;160;537;228;761;388;1298
352160;201408;1300;3655;1183;3497;260;819;717;2134;977;2953
352170;201408;2629;8074;2376;7598;560;1996;1283;3878;1843;5874
352180;201408;3718;10716;3226;9799;888;2984;1389;3978;2277;6962
352190;201408;1182;3640;1083;3464;236;877;570;1717;806;2594
352200;201408;455;1591;381;1440;84;344;189;737;273;1081
352210;201408;16115;43594;12856;38744;2364;7510;7894;24293;10258;31803
352215;201408;601;1896;544;1817;85;330;311;1033;396;1363
352220;201408;15235;51030;14055;48588;4840;17747;5269;18130;10109;35877
352230;201408;14010;48244;12343;45048;3914;15492;4736;17007;8650;32499
352240;201408;9819;31405;8935;29801;2984;11170;3561;11192;6545;22362
352250;201408;23162;75332;20464;69789;5768;21373;8014;26956;13782;48329
352260;201408;5952;18163;4088;14182;1038;4013;1410;4499;2448;8512
352265;201408;937;2963;792;2723;120;497;479;1583;599;2080
352270;201408;2574;8838;2202;7969;865;3246;505;1763;1370;5009
352280;201408;2540;7893;2127;7175;601;2271;709;2277;1310;4548
352290;201408;1352;4370;1172;3970;306;1183;369;1121;675;2304
352300;201408;1036;3108;853;2777;246;874;379;1190;625;2064
352310;201408;33055;106839;29178;100099;7254;26922;17332;58900;24586;85822
352320;201408;5684;17696;4928;16224;1492;5365;1706;5083;3198;10448
352330;201408;2278;7399;1969;6999;702;2668;677;2421;1379;5089
352340;201408;6025;20669;4917;17976;1644;6509;983;3290;2627;9799
352350;201408;1840;6778;1673;6399;481;1980;601;2231;1082;4211
352360;201408;1242;4090;1105;3818;288;1198;631;2024;919;3222
352370;201408;936;3204;853;3019;207;831;397;1355;604;2186
352380;201408;1055;3368;930;3150;338;1268;281;923;619;2191
352390;201408;15230;43613;10626;34498;2212;8373;5125;15461;7337;23834
352400;201408;3542;10708;2420;8451;681;2613;883;2906;1564;5519
352410;201408;3851;11346;2963;9802;959;3431;950;3012;1909;6443
352420;201408;1325;3772;1223;3600;431;1415;502;1449;933;2864
352430;201408;6550;20657;5777;19383;2225;8106;2032;6670;4257;14776
352440;201408;16503;52250;13587;46392;3807;14033;5181;17250;8988;31283
352450;201408;685;2020;462;1580;125;485;106;318;231;803
352460;201408;2259;7543;1948;6959;677;2696;598;1947;1275;4643
352470;201408;4964;14144;3007;9973;627;2272;1184;3833;1811;6105
352480;201408;5597;15848;4550;13917;1125;3951;1959;5552;3084;9503
352490;201408;764;2746;649;2469;163;682;140;510;303;1192
352500;201408;9186;29637;8629;28699;4080;14656;2702;8213;6782;22869
352510;201408;3547;12259;2940;10943;1112;4452;738;2681;1850;7133
352520;201408;2513;8909;2243;8271;599;2386;1158;4193;1757;6579
352530;201408;6881;22289;5102;18301;1535;5957;817;2677;2352;8634
352540;201408;481;1604;365;1329;68;291;109;390;177;681
352550;201408;942;3138;667;2460;186;773;129;420;315;1193
352560;201408;656;1967;498;1609;100;367;203;595;303;962
352570;201408;1597;5201;1155;4138;275;1144;287;898;562;2042
352580;201408;956;2875;819;2635;276;993;349;1048;625;2041
352585;201408;258;858;206;743;66;257;50;165;116;422
352590;201408;11846;38152;10440;35379;2292;8687;5979;19561;8271;28248
352600;201408;2001;6466;1846;6128;620;2176;717;2311;1337;4487
352610;201408;3709;11796;3258;11036;1197;4385;1062;3456;2259;7841
352620;201408;5665;18038;5355;17614;1190;4201;3444;11309;4634;15510
352630;201408;881;2927;833;2807;258;941;388;1284;646;2225
352640;201408;3210;10257;2640;8992;570;2143;1208;4000;1778;6143
352650;201408;876;2618;657;2160;154;560;221;675;375;1235
352660;201408;1103;3851;893;3339;262;1075;240;870;502;1945
352670;201408;11141;34546;6953;24831;2168;8152;1373;4745;3541;12897
352680;201408;3472;12153;2688;10198;648;2708;685;2313;1333;5021
352690;201408;28151;82559;20808;67434;5119;18245;8987;28058;14106;46303
352700;201408;809;2397;647;2147;195;740;291;908;486;1648
352710;201408;5526;16490;4089;13527;1095;3986;1547;4888;2642;8874
352720;201408;9234;31089;8575;29675;2828;10215;3457;11917;6285;22132
352725;201408;432;1270;288;946;56;223;92;270;148;493
352730;201408;2769;9616;2433;8696;676;2676;778;2491;1454;5167
352740;201408;2345;7005;1990;6383;518;1936;964;2853;1482;4789
352750;201408;438;1333;312;1037;99;356;68;191;167;547
352760;201408;1034;3649;940;3462;304;1207;465;1657;769;2864
352770;201408;955;2958;892;2842;285;969;322;1017;607;1986
352780;201408;643;2190;561;1999;149;598;173;554;322;1152
352790;201408;620;1794;443;1444;103;363;98;298;201;661
352800;201408;1216;4556;972;3844;316;1285;194;671;510;1956
352810;201408;1107;2961;777;2312;146;517;280;791;426;1308
352820;201408;631;1870;510;1672;214;732;109;361;323;1093
352830;201408;482;1382;343;1099;82;280;66;185;148;465
352840;201408;3825;13338;3357;12297;1053;4103;1066;3883;2119;7986
352850;201408;10318;33544;9019;31195;2748;10017;3399;11875;6147;21892
352860;201408;1076;3589;1000;3420;401;1429;291;942;692;2371
352870;201408;1143;2900;882;2420;149;510;465;1164;614;1674
352880;201408;2491;7390;1916;6112;505;1719;512;1484;1017;3203
352885;201408;319;1095;304;1062;94;359;132;432;226;791
352890;201408;828;2290;676;1991;158;517;279;748;437;1265
352900;201408;19245;58139;14518;48209;3678;13325;5857;18548;9535;31873
352910;201408;288;929;254;851;90;304;34;98;124;402
352920;201408;3438;10612;2928;9602;1012;3616;1049;3188;2061;6804
352930;201408;7068;22759;5798;19881;1775;6588;1097;3558;2872;10146
352940;201408;27313;92289;23429;82866;8589;31884;4328;14679;12917;46563
352950;201408;319;1007;230;812;63;267;66;198;129;465
352960;201408;619;1946;415;1454;81;315;76;246;157;561
352965;201408;378;1083;307;947;82;279;54;155;136;434
352970;201408;3435;9039;3035;8481;478;1396;2113;5979;2591;7375
352980;201408;1563;4683;1329;4312;400;1322;624;2126;1024;3448
352990;201408;3627;12007;3310;11443;1055;4069;1245;4090;2300;8159
353000;201408;557;1576;400;1243;97;329;97;267;194;596
353010;201408;2969;8441;2212;6894;600;2085;766;2201;1366;4286
353020;201408;4555;12665;3145;9564;560;1912;1302;3598;1862;5510
353030;201408;3997;11817;3288;10423;1031;3555;870;2583;1901;6138
353040;201408;740;2129;637;1964;204;684;246;734;450;1418
353050;201408;5729;19834;4876;18013;1734;6903;1570;5545;3304;12448
353060;201408;35113;113434;32785;109690;5402;21377;22648;72826;28050;94203
353070;201408;9169;31387;7266;26944;2500;9814;1955;7242;4455;17056
353080;201408;5320;17930;4150;15272;1346;5340;1175;4055;2521;9395
353090;201408;615;2069;546;1923;100;422;268;863;368;1285
353100;201408;286;862;224;716;104;341;51;161;155;502
353110;201408;8099;25425;7269;23894;1818;6362;3984;13223;5802;19585
353120;201408;484;1623;409;1459;138;554;101;313;239;867
353130;201408;3102;9700;2712;9023;1039;3787;993;3122;2032;6909
353140;201408;2754;7767;2201;6659;697;2311;731;1983;1428;4294
353150;201408;2036;6416;1687;5753;605;2170;455;1571;1060;3741
353160;201408;688;2036;538;1722;166;547;103;301;269;848
353170;201408;522;1847;470;1748;176;737;186;656;362;1393
353180;201408;5547;17407;4840;16059;689;2648;3096;10027;3785;12675
353190;201408;3746;11974;3247;10825;775;2886;1535;4736;2310;7622
353200;201408;848;2916;732;2646;227;907;272;939;499;1846
353205;201408;555;1797;462;1586;108;375;169;579;277;954
353210;201408;1139;3017;909;2602;117;401;601;1672;718;2073
353215;201408;588;1845;508;1667;117;435;169;538;286;973
353220;201408;953;2918;820;2628;227;763;259;816;486;1579
353230;201408;966;3103;888;2970;252;950;286;871;538;1821
353240;201408;2292;7633;2084;7199;639;2451;912;2949;1551;5400
353250;201408;1301;3694;1075;3287;305;996;405;1180;710;2176
353260;201408;1220;3547;1057;3289;330;1114;426;1244;756;2358
353270;201408;687;2082;590;1890;181;631;176;517;357;1148
353280;201408;609;2005;535;1872;187;720;150;491;337;1211
353282;201408;1828;6043;1767;5940;347;1311;1092;3543;1439;4854
353284;201408;300;833;207;647;51;161;60;190;111;351
353286;201408;151;454;102;336;30;99;12;42;42;141
353290;201408;505;1729;431;1594;168;668;167;590;335;1258
353300;201408;1841;5848;1581;5261;507;1855;565;1689;1072;3544
353310;201408;352;1114;332;1063;151;503;97;291;248;794
353320;201408;579;1647;498;1513;115;393;249;720;364;1113
353325;201408;601;2074;493;1821;129;528;78;261;207;789
353330;201408;601;1767;428;1377;98;366;194;561;292;927
353340;201408;3285;10611;2802;9653;976;3574;1027;3475;2003;7049
353350;201408;3656;11116;3184;10264;1129;3888;1357;4250;2486;8138
353360;201408;467;1621;412;1487;110;459;225;765;335;1224
353370;201408;730;2384;661;2206;160;558;344;1137;504;1695
353380;201408;419;1383;372;1296;103;407;162;540;265;947
353390;201408;5673;15280;3991;12203;892;3083;1481;4082;2373;7165
353400;201408;646;2014;538;1787;141;500;149;429;290;929
353410;201408;708;2182;600;2010;175;663;307;989;482;1652
353420;201408;716;2130;554;1735;181;600;175;511;356;1111
353430;201408;2564;8961;1852;6874;520;2010;170;554;690;2564
353440;201408;62769;207007;55355;189075;17329;62246;18348;61121;35677;123367
353450;201408;477;1464;413;1344;120;442;158;495;278;937
353460;201408;3679;10339;3100;9322;561;1845;1671;5015;2232;6860
353470;201408;11717;37194;9234;31977;3013;11284;2322;7760;5335;19044
353475;201408;1779;5150;1289;4060;311;1067;381;1086;692;2153
353480;201408;1587;4756;1413;4427;313;1095;788;2375;1101;3470
353490;201408;1673;4812;1394;4243;408;1383;410;1115;818;2498
353500;201408;1257;3645;1143;3453;491;1568;408;1171;899;2739
353510;201408;1418;4603;1181;3992;353;1313;348;1024;701;2337
353520;201408;1287;3844;1043;3404;355;1244;343;1124;698;2368
353530;201408;2837;8545;2546;8009;633;2208;1203;3641;1836;5849
353540;201408;2159;6621;1950;6251;627;2110;830;2685;1457;4795
353550;201408;6952;20093;6129;18747;1119;4015;3531;10155;4650;14170
353560;201408;2218;7380;1847;6688;475;1911;694;2456;1169;4367
353570;201408;543;1724;440;1507;102;390;235;732;337;1122
353580;201408;2536;8291;2374;8001;696;2628;1320;4294;2016;6922
353590;201408;849;2446;692;2161;259;868;173;559;432;1427
353600;201408;1971;5655;1781;5310;415;1358;921;2725;1336;4083
353610;201408;609;2164;534;2006;148;647;167;587;315;1234
353620;201408;2424;8313;2153;7780;698;2717;719;2467;1417;5184
353625;201408;394;1077;274;867;107;376;75;216;182;592
353630;201408;1724;5952;1333;4937;329;1323;236;764;565;2087
353640;201408;1665;4828;1460;4393;371;1159;652;1978;1023;3137
353650;201408;6921;21211;4999;16891;1146;4187;1801;5751;2947;9938
353657;201408;357;1144;317;1056;58;226;128;405;186;631
353660;201408;1443;3723;1048;3084;442;1425;193;421;635;1846
353670;201408;4991;16527;4358;15111;1470;5590;1391;4522;2861;10112
353680;201408;707;2495;662;2411;315;1194;211;764;526;1958
353690;201408;582;1569;384;1238;100;373;144;423;244;796
353700;201408;2465;7850;2149;7169;516;1911;776;2437;1292;4348
353710;201408;3510;9499;1841;6576;556;2173;548;1941;1104;4114
353715;201408;500;1490;414;1325;89;306;180;558;269;864
353720;201408;2184;6812;1873;6338;371;1358;1076;3656;1447;5014
353730;201408;4601;14421;3694;12305;968;3480;1048;3222;2016;6702
353740;201408;2325;7114;1875;6151;650;2216;531;1666;1181;3882
353750;201408;826;2893;655;2464;188;777;185;694;373;1471
353760;201408;7875;23590;6388;21026;1559;5543;3184;10452;4743;15995
353770;201408;822;2567;527;1821;116;430;53;122;169;552
353780;201408;6083;21662;5506;20460;2499;9518;1522;5886;4021;15404
353790;201408;2803;10032;2454;9292;908;3706;536;2050;1444;5756
353800;201408;15154;48687;12069;42648;3402;13226;4771;16320;8173;29546
353810;201408;1203;4009;1059;3677;327;1214;398;1358;725;2572
353820;201408;1286;4550;1228;4438;386;1586;543;1822;929;3408
353830;201408;821;2239;645;1914;134;435;274;795;408;1230
353850;201408;1897;6260;1775;6043;443;1650;869;2822;1312;4472
353860;201408;2412;8181;2000;7188;598;2295;601;2102;1199;4397
353870;201408;24193;75453;18198;62919;4381;16964;6079;18985;10460;35949
353880;201408;2538;7993;2138;7321;370;1490;1257;4192;1627;5682
353890;201408;2694;6987;1952;5745;477;1546;931;2624;1408;4170
353900;201408;1167;3661;874;2991;229;881;207;618;436;1499
353910;201408;2190;7750;2085;7470;679;2616;943;3373;1622;5989
353920;201408;2482;7425;1839;6047;442;1537;332;974;774;2511
353930;201408;4200;14810;3517;13273;1283;5155;828;3089;2111;8244
353940;201408;1547;5008;1327;4527;352;1372;528;1665;880;3037
353950;201408;3730;12127;3429;11581;573;2247;2197;7209;2770;9456
353960;201408;627;2017;497;1731;126;482;143;428;269;910
353970;201408;541;1596;469;1495;51;202;343;1066;394;1268
353980;201408;14908;44406;12451;40172;3050;10555;6425;20423;9475;30978
353990;201408;520;1636;477;1532;143;509;192;557;335;1066
354000;201408;2028;6023;1393;4747;353;1320;152;456;505;1776
354010;201408;399;1234;358;1166;140;462;136;455;276;917
354020;201408;4506;13716;4014;12649;1097;3772;1789;5248;2886;9020
354025;201408;1129;3208;892;2797;250;836;226;708;476;1544
354030;201408;666;1779;469;1475;130;455;175;504;305;959
354040;201408;810;2210;630;1870;94;330;360;986;454;1316
354050;201408;1028;3442;937;3238;342;1285;278;934;620;2219
354060;201408;5087;16263;3775;13334;1020;3913;1460;4937;2480;8850
354070;201408;3765;12649;3276;11516;1127;4210;843;2930;1970;7140
354075;201408;2285;8598;2183;8414;730;3063;974;3707;1704;6770
354080;201408;2004;6200;1542;5085;455;1551;447;1342;902;2893
354085;201408;317;867;280;793;33;120;203;532;236;652
354090;201408;1265;3824;1197;3718;150;524;905;2791;1055;3315
354100;201408;17263;59429;14779;54525;4053;15863;6736;24771;10789;40634
354105;201408;945;2975;807;2711;204;808;365;1100;569;1908
354110;201408;850;2448;695;2213;206;749;223;642;429;1391
354120;201408;2376;6682;1950;5891;521;1769;737;2057;1258;3826
354130;201408;5626;17028;4714;15209;1862;6373;1215;3656;3077;10029
354140;201408;23459;60499;14642;43859;2938;9809;5743;15943;8681;25752
354150;201408;4657;12999;3645;11156;1012;3413;1625;4756;2637;8169
354160;201408;4100;13582;3585;12450;1063;3972;1486;5011;2549;8983
354165;201408;421;1559;380;1456;145;596;100;394;245;990
354170;201408;1664;5398;1352;4635;307;1192;484;1471;791;2663
354180;201408;528;1597;506;1556;78;277;321;925;399;1202
354190;201408;1670;5638;1455;5143;507;1919;486;1654;993;3573
354200;201408;1200;3505;973;3064;204;745;401;1130;605;1875
354210;201408;871;3017;778;2817;187;798;324;1077;511;1875
354220;201408;3279;10239;2932;9555;953;3386;1237;3863;2190;7249
354230;201408;814;2700;768;2617;221;787;380;1291;601;2078
354240;201408;1409;4793;1137;4170;348;1383;284;976;632;2359
354250;201408;561;1797;460;1629;212;829;129;422;341;1251
354260;201408;9247;28096;8307;26563;2653;9195;3429;10794;6082;19989
354270;201408;1211;4265;1102;4031;336;1373;440;1589;776;2962
354280;201408;855;2572;791;2459;156;568;474;1432;630;2000
354290;201408;1354;4794;1253;4572;383;1491;421;1524;804;3015
354300;201408;3358;11508;3241;11274;859;3191;1709;5860;2568;9051
354310;201408;809;2690;645;2291;184;717;203;721;387;1438
354320;201408;872;2639;746;2381;217;781;239;690;456;1471
354323;201408;397;1166;310;994;82;288;84;241;166;529
354325;201408;1290;4411;1144;4071;277;1120;477;1583;754;2703
354330;201408;8223;25802;7320;24017;1963;6917;3713;11768;5676;18685
354340;201408;31410;102411;26612;93488;9855;37133;9584;32883;19439;70016
354350;201408;1185;3557;1112;3421;286;965;624;1840;910;2805
354360;201408;463;1515;376;1345;116;447;41;127;157;574
354370;201408;1179;3990;1028;3674;148;659;682;2346;830;3005
354380;201408;1343;4070;1119;3663;422;1511;212;624;634;2135
354390;201408;12007;38761;8984;31984;2377;9231;2396;8114;4773;17345
354400;201408;2188;7842;1912;7169;539;2159;596;2141;1135;4300
354410;201408;6601;20157;5491;18314;1306;4676;2827;9404;4133;14080
354420;201408;1711;5105;1421;4466;439;1454;515;1563;954;3017
354425;201408;3574;10290;3091;9398;1069;3441;1024;3156;2093;6597
354430;201408;1375;4526;1263;4339;348;1334;613;2015;961;3349
354440;201408;576;1710;452;1455;92;325;196;610;288;935
354450;201408;523;1532;328;1097;49;211;85;238;134;449
354460;201408;866;2563;749;2344;268;878;344;1056;612;1934
354470;201408;532;1517;413;1276;74;299;184;488;258;787
354480;201408;807;2411;708;2245;158;576;361;1060;519;1636
354490;201408;795;2718;636;2319;164;649;211;683;375;1332
354500;201408;2605;8874;2383;8467;929;3691;579;1978;1508;5669
354510;201408;753;2454;680;2303;175;643;354;1176;529;1819
354515;201408;364;1281;296;1118;71;308;93;321;164;629
354520;201408;6965;24141;4895;18234;1498;6242;1804;6410;3302;12652
354530;201408;2931;10602;2742;10225;772;3131;1445;5321;2217;8452
354540;201408;1402;4356;1216;4019;406;1454;465;1543;871;2997
354550;201408;601;1927;532;1771;107;374;230;727;337;1101
354560;201408;1571;4745;1186;3878;318;1068;411;1295;729;2363
354570;201408;735;2270;583;1909;185;635;119;368;304;1003
354580;201408;9522;27900;7571;24165;1591;5717;3500;10569;5091;16286
354600;201408;1774;6106;1577;5707;476;1998;692;2333;1168;4331
354610;201408;508;1426;335;1052;71;230;89;244;160;474
354620;201408;426;1456;352;1316;110;480;125;430;235;910
354625;201408;285;950;239;853;64;250;68;233;132;483
354630;201408;2000;6913;1804;6462;779;2830;537;1852;1316;4682
354640;201408;4228;14224;3597;12803;1094;4408;807;2614;1901;7022
354650;201408;1041;3202;937;2981;191;692;532;1637;723;2329
354660;201408;2166;6492;1704;5653;400;1470;838;2758;1238;4228
354670;201408;1684;5506;1351;4647;402;1519;361;1075;763;2594
354680;201408;5449;18372;4995;17382;1440;5342;2011;6819;3451;12161
354690;201408;880;2974;628;2342;130;508;186;635;316;1143
354700;201408;1206;3432;815;2597;149;571;338;901;487;1472
354710;201408;642;1903;546;1704;141;498;207;594;348;1092
354720;201408;210;602;167;514;63;192;42;126;105;318
354730;201408;6229;21720;5479;20168;1504;6061;2484;8860;3988;14921
354740;201408;268;823;200;702;53;190;48;172;101;362
354750;201408;2411;7769;2043;7221;699;2682;768;2651;1467;5333
354760;201408;2268;7569;1903;6717;645;2442;405;1344;1050;3786
354765;201408;312;822;199;618;47;177;31;87;78;264
354770;201408;2853;8427;2292;7501;1063;3719;425;1328;1488;5047
354780;201408;37718;117804;34213;109832;8083;28860;17223;52511;25306;81371
354790;201408;898;2942;787;2747;222;859;345;1103;567;1962
354800;201408;1720;5085;1533;4835;315;1121;1000;3139;1315;4260
354805;201408;966;2997;721;2429;124;467;138;415;262;882
354810;201408;718;2398;518;1883;166;665;104;337;270;1002
354820;201408;1124;3971;1002;3718;289;1222;279;941;568;2163
354830;201408;455;1412;402;1312;140;505;152;455;292;960
354840;201408;824;2439;742;2293;229;748;318;976;547;1724
354850;201408;15626;50091;11761;41905;3092;12226;4316;14301;7408;26527
354860;201408;1314;4324;1194;4116;304;1225;563;1829;867;3054
354870;201408;45398;146205;42016;138984;12626;44422;20086;65118;32712;109540
354880;201408;4217;13235;3031;10532;865;3294;740;2255;1605;5549
354890;201408;15886;48997;13684;44571;3932;13816;4801;15078;8733;28894
354900;201408;625;1778;505;1598;175;585;194;609;369;1194
354910;201408;6647;20537;3911;14212;931;3750;441;1496;1372;5246
354920;201408;522;1558;403;1343;117;435;109;346;226;781
354925;201408;376;1089;227;779;48;188;39;110;87;298
354930;201408;321;916;257;795;86;283;89;277;175;560
354940;201408;2280;8137;1759;6675;669;2684;259;896;928;3580
354950;201408;1530;5145;1399;4944;259;1059;858;2988;1117;4047
354960;201408;792;2537;692;2372;201;763;272;904;473;1667
354970;201408;4136;13882;3688;12963;790;3225;1992;6661;2782;9886
354980;201408;33497;84171;19232;59338;4398;15270;6563;18682;10961;33952
354990;201408;43151;139463;37512;127557;8477;31868;19449;64211;27926;96079
354995;201408;2018;6395;1896;6218;489;1706;1004;3309;1493;5015
355000;201408;1721;5807;1510;5410;560;2176;363;1248;923;3424
355010;201408;3800;12159;3184;10765;889;3276;1286;4271;2175;7547
355020;201408;3411;12189;2895;11152;1406;5703;789;3064;2195;8767
355030;201408;972138;2829333;875273;2636044;225638;735714;396475;1162960;622113;1898674
355040;201408;3065;10087;2761;9529;861;3305;1382;4575;2243;7880
355050;201408;1308;4144;1075;3666;377;1354;261;888;638;2242
355060;201408;5159;17801;4140;15465;1121;4686;1034;3575;2155;8261
355070;201408;6587;20822;5882;19613;1347;5269;3217;10070;4564;15339
355080;201408;1399;4988;1075;4158;337;1436;158;520;495;1956
355090;201408;1148;4103;974;3686;236;979;400;1455;636;2434
355100;201408;26296;83564;22798;77522;7618;27611;8572;29263;16190;56874
355110;201408;1361;4764;1238;4492;429;1681;425;1507;854;3188
355120;201408;677;2186;587;2009;171;638;252;838;423;1476
355130;201408;613;1667;369;1131;95;332;134;348;229;680
355140;201408;1053;3841;1007;3738;281;1143;490;1799;771;2942
355150;201408;3685;12323;3239;11470;1015;3767;1312;4528;2327;8295
355160;201408;1663;5667;1435;5271;598;2446;393;1311;991;3757
355170;201408;10231;29439;7336;24192;2519;8967;1961;6370;4480;15337
355180;201408;2986;9286;2543;8456;691;2642;992;3075;1683;5717
355190;201408;1335;4708;1218;4435;518;1931;367;1298;885;3229
355200;201408;949;3519;897;3408;425;1694;227;847;652;2541
355210;201408;2953;10214;2692;9641;774;3136;1183;3939;1957;7075
355220;201408;32264;109354;29209;102962;12195;44443;8584;30887;20779;75330
355230;201408;1329;3837;774;2565;147;554;188;542;335;1096
355240;201408;23400;72116;17711;59365;4209;15646;6891;21500;11100;37146
355250;201408;26060;87792;23350;82317;7111;26577;10033;35049;17144;61626
355255;201408;950;2668;677;2094;137;464;203;595;340;1059
355260;201408;1673;4896;1498;4583;422;1471;585;1634;1007;3105
355270;201408;1733;5359;1651;5227;250;951;1165;3544;1415;4495
355280;201408;24646;74840;21173;67980;5166;18691;9466;28885;14632;47576
355290;201408;899;2942;829;2808;199;725;381;1242;580;1967
355300;201408;958;3140;763;2703;189;719;235;786;424;1505
355310;201408;1131;3429;962;3130;235;787;461;1556;696;2343
355320;201408;758;2443;668;2228;197;747;239;689;436;1436
355330;201408;1931;6581;1474;5625;510;2164;452;1633;962;3797
355340;201408;3206;8721;2966;8311;690;2163;1732;4655;2422;6818
355350;201408;1452;5094;1284;4731;427;1695;396;1418;823;3113
355360;201408;1274;4438;1175;4235;251;994;788;2846;1039;3840
355365;201408;318;1011;269;912;81;311;71;227;152;538
355370;201408;7591;19763;5526;17211;1828;6214;2276;7137;4104;13351
355380;201408;3716;11389;2876;9400;826;2976;616;1721;1442;4697
355385;201408;1026;3332;964;3220;427;1547;270;829;697;2376
355390;201408;1457;4086;1254;3695;351;1132;479;1351;830;2483
355395;201408;1898;5844;1439;4773;280;1031;587;1779;867;2810
355400;201408;9616;33015;8616;30966;3032;11834;3205;11129;6237;22963
355410;201408;14628;52535;13011;49023;4936;19773;3684;14121;8620;33894
355420;201408;843;3076;793;2951;295;1166;276;1048;571;2214
355430;201408;3892;11440;3340;10458;766;2638;1694;5141;2460;7779
355440;201408;952;3186;772;2709;219;814;226;697;445;1511
355450;201408;2729;9167;2250;8070;682;2692;734;2490;1416;5182
355460;201408;596;1680;449;1412;117;452;160;424;277;876
355465;201408;462;1429;397;1304;126;443;100;325;226;768
355470;201408;981;3034;790;2695;260;981;278;896;538;1877
355475;201408;134;516;118;467;38;151;40;169;78;320
355480;201408;3335;12282;3143;11854;989;3948;1405;5209;2394;9157
355490;201408;867;2572;680;2173;177;592;148;481;325;1073
355495;201408;756;2555;702;2451;198;774;286;971;484;1745
355500;201408;9060;27007;6046;20216;1461;5380;1345;4126;2806;9506
355510;201408;2264;6266;1472;4661;345;1249;432;1249;777;2498
355520;201408;455;1156;278;808;61;205;93;235;154;440
355530;201408;281;665;120;367;13;41;39;129;52;170
355535;201408;694;2160;558;1889;166;653;150;428;316;1081
355540;201408;10489;34128;9952;33221;2904;10428;5001;16288;7905;26716
355550;201408;770;2369;689;2234;189;669;336;1061;525;1730
355560;201408;1456;4384;1071;3552;288;1077;220;575;508;1652
355570;201408;219;713;171;599;38;136;35;101;73;237
355580;201408;1329;4021;1128;3625;393;1380;434;1358;827;2738
355590;201408;263;744;234;684;54;182;115;330;169;512
355600;201408;1118;3602;936;3184;379;1409;224;721;603;2130
355610;201408;1519;4472;1294;4108;352;1248;587;1787;939;3035
355620;201408;4180;13517;3372;11654;792;3130;1401;4421;2193;7551
355630;201408;3485;10140;2183;7355;486;1829;684;2109;1170;3938
355635;201408;1026;3413;889;3166;152;610;578;2050;730;2660
355640;201408;3888;13072;3262;11566;1148;4246;640;2207;1788;6453
355645;201408;3494;12522;3275;12123;647;2617;2013;7436;2660;10053
355650;201408;6979;22219;6107;20479;1206;4870;3624;11348;4830;16218
355660;201408;1403;4559;1171;4089;370;1464;466;1523;836;2987
355670;201408;2479;7982;1741;6231;468;1923;621;1957;1089;3880
355680;201408;1825;6276;1470;5404;554;2125;327;1143;881;3268
355690;201408;433;1389;330;1208;215;844;26;65;241;909
355695;201408;372;1121;243;797;32;105;20;49;52;154
355700;201408;6852;24266;6062;22359;1832;7348;2538;9018;4370;16366
355710;201408;13163;33783;8245;24793;2686;8561;2227;6424;4913;14985
355715;201408;268;827;177;626;42;164;37;117;79;281
355720;201408;1552;5104;1266;4462;413;1601;386;1216;799;2817
355730;201408;812;2862;729;2678;290;1104;176;646;466;1750
410010;201408;1658;5330;1501;4997;428;1538;479;1562;907;3100
410020;201408;1288;4369;1185;4156;372;1378;440;1513;812;2891
410030;201408;1083;3738;901;3280;287;1085;180;651;467;1736
410040;201408;13389;45060;12216;42621;4410;16409;3655;12656;8065;29065
410045;201408;962;2765;681;2199;198;686;209;626;407;1312
410050;201408;2999;8586;1982;6572;633;2264;480;1498;1113;3762
410060;201408;2097;6732;1891;6327;556;2048;748;2470;1304;4518
410070;201408;2224;6369;1813;5536;708;2305;396;1092;1104;3397
410080;201408;1525;4592;1262;4094;316;1096;617;1925;933;3021
410090;201408;1164;3710;1060;3493;353;1291;381;1189;734;2480
410100;201408;2385;7326;1686;5672;512;1962;272;841;784;2803
410105;201408;482;1544;354;1234;79;311;42;106;121;417
410110;201408;2832;8657;2421;7854;609;2216;876;2738;1485;4954
410115;201408;609;1721;503;1503;122;399;175;496;297;895
410120;201408;2971;10248;2809;10007;1042;3893;1226;4489;2268;8382
410130;201408;1442;4838;1306;4518;421;1442;567;1986;988;3428
410140;201408;16428;45516;11650;36677;3273;11380;4048;12642;7321;24022
410150;201408;18531;46849;8933;27072;1886;6343;1761;4720;3647;11063
410160;201408;3471;11087;3164;10570;1046;3819;1160;3921;2206;7740
410165;201408;702;2069;556;1745;134;449;251;746;385;1195
410170;201408;1940;5992;1635;5331;598;2127;506;1598;1104;3725
410180;201408;9263;29950;8056;27286;2015;7765;3617;11416;5632;19181
410185;201408;669;1839;593;1697;127;387;317;899;444;1286
410190;201408;2340;7012;2002;6227;660;2202;523;1530;1183;3732
410200;201408;3939;11271;2876;9077;796;2787;429;1232;1225;4019
410210;201408;2760;8497;2177;7199;548;2036;465;1308;1013;3344
410220;201408;664;1942;497;1585;110;389;165;486;275;875
410230;201408;1903;6212;1734;5906;667;2482;645;2137;1312;4619
410240;201408;5380;16855;4929;15885;1602;5544;1803;5721;3405;11265
410250;201408;2445;6927;1633;5185;494;1741;338;956;832;2697
410260;201408;1782;5557;1559;5150;483;1702;583;1885;1066;3587
410270;201408;577;1713;487;1529;129;455;204;624;333;1079
410275;201408;957;2883;668;2247;124;446;335;1124;459;1570
410280;201408;2968;8915;2129;7085;514;1940;415;1288;929;3228
410290;201408;3440;10628;2969;9711;755;2677;1318;4307;2073;6984
410300;201408;656;1880;579;1715;87;314;298;783;385;1097
410302;201408;600;1725;476;1508;62;214;270;863;332;1077
410304;201408;1507;4924;1382;4665;437;1515;577;2027;1014;3542
410305;201408;2269;6068;1938;5583;477;1433;1170;3447;1647;4880
410310;201408;2460;8174;2237;7734;649;2430;870;3034;1519;5464
410315;201408;681;2061;509;1718;122;433;168;521;290;954
410320;201408;1261;3716;788;2657;164;628;71;196;235;824
410322;201408;625;1858;451;1469;132;431;126;398;258;829
410330;201408;1563;4399;1324;3947;402;1282;446;1306;848;2588
410335;201408;1100;3250;925;2937;223;799;381;1147;604;1946
410337;201408;861;2312;706;2032;143;485;290;756;433;1241
410340;201408;606;1828;471;1476;94;338;149;398;243;736
410345;201408;2020;6071;1600;5171;541;1890;402;1209;943;3099
410347;201408;877;2479;622;1993;178;632;189;573;367;1205
410350;201408;895;2768;596;2125;162;679;113;350;275;1029
410360;201408;3742;11334;3282;10514;1011;3477;1185;3759;2196;7236
410370;201408;13561;40238;10210;32771;2742;9961;2992;8784;5734;18745
410380;201408;1460;4656;1325;4360;336;1196;605;1906;941;3102
410390;201408;2924;8592;2370;7571;907;3118;640;1868;1547;4986
410395;201408;918;3130;820;2916;212;868;391;1377;603;2245
410400;201408;5448;17701;4816;16444;1498;5743;1606;5266;3104;11009
410405;201408;1022;3004;819;2593;206;760;331;994;537;1754
410410;201408;1380;4679;1315;4574;501;1948;396;1286;897;3234
410420;201408;9753;32152;8562;29424;2969;11014;2189;7045;5158;18059
410425;201408;3296;10701;2394;8562;586;2317;347;1175;933;3492
410430;201408;16365;45365;12334;37762;3446;11551;3932;11957;7378;23508
410440;201408;3661;11615;3320;10963;853;3047;1590;5238;2443;8285
410442;201408;3048;10552;2750;9845;933;3550;864;3073;1797;6623
410445;201408;2439;8132;2094;7509;612;2382;790;2933;1402;5315
410450;201408;2663;7717;2145;6737;715;2390;429;1238;1144;3628
410460;201408;2434;7338;2035;6534;556;1916;761;2316;1317;4232
410465;201408;2129;7619;1825;6899;618;2484;659;2308;1277;4792
410470;201408;1595;5224;1342;4602;395;1503;408;1382;803;2885
410480;201408;31606;93057;24954;79569;8835;30629;6345;19442;15180;50071
410490;201408;11829;38460;9693;33709;3012;11483;3059;10314;6071;21797
410500;201408;1602;5080;1303;4424;490;1803;375;1271;865;3074
410510;201408;2539;6819;1842;5403;443;1402;752;2019;1195;3421
410520;201408;3316;11625;3138;11240;1175;4423;1158;4145;2333;8568
410530;201408;1728;4974;1448;4419;365;1270;614;1764;979;3034
410540;201408;3940;11497;2753;9109;746;2606;915;2988;1661;5594
410550;201408;7053;21692;5327;17757;1661;6084;916;2785;2577;8869
410560;201408;1329;4292;1048;3575;283;1070;269;751;552;1821
410570;201408;3004;9863;2737;9381;814;2857;1187;4405;2001;7262
410580;201408;26754;84897;23253;77499;8000;29088;6992;22034;14992;51122
410590;201408;1262;4004;770;2599;145;516;184;553;329;1069
410600;201408;2084;6182;1729;5468;464;1543;760;2409;1224;3952
410610;201408;846;2593;714;2340;167;606;314;993;481;1599
410620;201408;1798;6510;1576;5934;522;2057;354;1306;876;3363
410630;201408;2634;7949;2063;6678;600;2144;582;1741;1182;3885
410640;201408;5260;15435;4177;13358;1436;5197;989;2991;2425;8188
410645;201408;1314;4661;1254;4547;547;2129;392;1420;939;3549
410650;201408;2547;7822;2061;6800;743;2611;498;1559;1241;4170
410655;201408;958;2932;793;2601;220;792;258;826;478;1618
410657;201408;702;2106;542;1754;162;584;199;573;361;1157
410660;201408;3946;11575;3064;9597;1127;3699;685;1995;1812;5694
410670;201408;1010;2884;777;2428;221;755;205;593;426;1348
410680;201408;2537;8849;2129;7783;636;2329;735;2800;1371;5129
410685;201408;705;2115;637;1995;98;301;453;1436;551;1737
410690;201408;106881;313146;73940;242972;18407;67021;18634;55333;37041;122354
410700;201408;2433;7733;2270;7407;729;2590;936;2942;1665;5532
410710;201408;1126;3537;892;2985;284;1034;256;789;540;1823
410712;201408;829;2563;717;2343;303;1089;214;714;517;1803
410715;201408;1100;3471;934;3096;249;893;353;1130;602;2023
410720;201408;3321;9973;2473;8156;650;2383;744;2250;1394;4633
410725;201408;1064;3073;751;2434;162;559;166;457;328;1016
410730;201408;746;2275;678;2123;280;940;192;579;472;1519
410740;201408;862;2574;595;2019;116;461;287;959;403;1420
410750;201408;1964;5867;1670;5245;523;1793;514;1510;1037;3303
410752;201408;270;800;212;675;50;191;89;256;139;447
410753;201408;486;1466;339;1114;77;298;119;363;196;661
410754;201408;1000;3073;883;2879;90;323;614;2052;704;2375
410755;201408;847;2212;661;1916;101;346;393;1090;494;1436
410760;201408;2631;8536;2470;8233;910;3168;995;3249;1905;6417
410765;201408;16415;49467;12103;40526;3060;11455;1953;6169;5013;17624
410770;201408;954;2728;774;2370;251;842;236;684;487;1526
410773;201408;1394;4118;1173;3741;287;1061;609;1838;896;2899
410775;201408;1857;5480;1763;5327;486;1450;1025;3206;1511;4656
410780;201408;487;1396;371;1197;111;360;158;573;269;933
410785;201408;939;3040;735;2458;269;943;233;775;502;1718
410790;201408;617;1928;514;1688;142;520;111;297;253;817
410800;201408;2862;7599;2297;6655;809;2632;838;2230;1647;4862
410810;201408;303;954;245;819;31;120;115;384;146;504
410820;201408;1110;3375;905;2881;280;940;216;666;496;1606
410830;201408;32710;97996;26921;87491;8407;29903;9421;30155;17828;60058
410832;201408;1212;3664;1091;3445;247;905;546;1615;793;2520
410840;201408;6746;20343;4702;15850;1453;5357;773;2317;2226;7674
410845;201408;1591;4740;1344;4204;297;1026;626;1905;923;2931
410850;201408;2906;8626;2594;8146;600;2171;1402;4385;2002;6556
410855;201408;768;2162;616;1834;175;561;231;670;406;1231
410860;201408;4024;11586;3422;10480;787;2553;1672;5214;2459;7767
410865;201408;1737;6002;1573;5683;399;1536;839;3109;1238;4645
410870;201408;1412;4361;1327;4220;673;2278;395;1224;1068;3502
410880;201408;4595;13873;3703;12137;957;3587;908;2625;1865;6212
410890;201408;1109;3466;834;2937;254;960;80;237;334;1197
410895;201408;1054;3719;947;3480;361;1427;303;1061;664;2488
410900;201408;947;2678;708;2273;158;593;222;660;380;1253
410910;201408;365;1105;322;1027;63;215;173;538;236;753
410920;201408;888;2723;728;2432;214;790;240;753;454;1543
410930;201408;1780;5381;1506;4876;379;1481;658;2067;1037;3548
410940;201408;21772;73343;19324;68653;6239;24102;7625;27282;13864;51384
410950;201408;1914;6376;1744;6060;363;1324;1072;3773;1435;5097
410960;201408;7167;20169;4812;15703;1583;5659;1398;4466;2981;10125
410965;201408;1117;3542;993;3270;344;1172;389;1278;733;2450
410970;201408;5353;16250;4382;14263;1517;5513;977;3164;2494;8677
410975;201408;1546;4522;1276;4056;243;910;622;1965;865;2875
410980;201408;5714;16459;3523;11833;829;3088;700;2222;1529;5310
410990;201408;902;2666;576;1928;187;700;129;360;316;1060
411000;201408;435;1337;299;1009;73;279;46;124;119;403
411005;201408;529;1568;362;1148;101;314;62;170;163;484
411007;201408;2077;6737;1868;6267;553;1967;779;2636;1332;4603
411010;201408;4138;14277;3787;13484;1401;5493;962;3174;2363;8667
411020;201408;2585;8244;2328;7788;799;2970;814;2724;1613;5694
411030;201408;886;2406;736;2124;240;754;221;598;461;1352
411040;201408;531;1621;353;1184;110;401;89;284;199;685
411050;201408;2188;7813;1940;7243;660;2675;333;1156;993;3831
411060;201408;2137;6808;1850;6174;581;2082;323;993;904;3075
411065;201408;407;1258;330;1101;72;253;122;384;194;637
411070;201408;4970;15742;3637;12737;1092;4233;554;1746;1646;5979
411080;201408;2085;6492;1885;6059;543;1952;612;1869;1155;3821
411090;201408;678;1716;526;1490;118;410;139;346;257;756
411095;201408;1658;4826;1287;4082;303;1090;353;1043;656;2133
411100;201408;1521;4416;1133;3650;271;984;247;725;518;1709
411110;201408;957;2912;717;2361;219;769;128;366;347;1135
411120;201408;1840;5797;1580;5229;499;1779;500;1615;999;3394
411125;201408;4836;15925;4690;15625;1591;5607;2137;7006;3728;12613
411130;201408;809;2443;658;2124;190;625;220;734;410;1359
411140;201408;2020;7307;1736;6600;642;2538;475;1888;1117;4426
411150;201408;6100;17312;4956;15012;1483;4852;1318;3677;2801;8529
411155;201408;1267;3710;1083;3345;349;1185;430;1251;779;2436
411160;201408;318;975;289;919;110;353;101;322;211;675
411170;201408;853;2891;745;2629;228;845;239;846;467;1691
411180;201408;6472;19814;5639;18231;1729;6111;1847;5923;3576;12034
411190;201408;1890;5597;1620;5098;485;1710;500;1481;985;3191
411200;201408;4537;13849;3751;12505;1179;4341;1476;4760;2655;9101
411210;201408;2575;7553;2064;6588;832;2827;386;1195;1218;4022
411220;201408;1228;3564;1004;3141;254;934;428;1204;682;2138
411230;201408;1296;3719;832;2727;265;958;197;587;462;1545
411240;201408;1465;3673;867;2688;264;876;239;675;503;1551
411250;201408;2590;7686;2163;6844;615;2101;681;2118;1296;4219
411260;201408;307;853;211;690;51;195;92;285;143;480
411270;201408;2115;6775;1935;6420;595;2197;855;2763;1450;4960
411275;201408;1592;4826;1363;4284;414;1352;390;1177;804;2529
411280;201408;1774;5532;1424;4772;449;1672;235;695;684;2367
411290;201408;1043;2933;875;2595;248;757;308;951;556;1708
411295;201408;1110;3304;1026;3152;247;819;430;1307;677;2126
411300;201408;1099;2861;796;2260;79;257;379;1004;458;1261
411310;201408;880;2515;669;2141;122;450;281;877;403;1327
411320;201408;5613;16977;4371;14500;1285;4494;1108;3512;2393;8006
411325;201408;1595;5094;1424;4770;249;929;880;2935;1129;3864
411330;201408;3748;12169;3303;11314;1273;4743;981;3283;2254;8026
411340;201408;1015;2970;671;2165;156;556;263;834;419;1390
411342;201408;903;2610;741;2255;217;735;211;565;428;1300
411345;201408;1102;3518;1015;3345;301;1083;487;1601;788;2684
411350;201408;2950;9045;2078;7193;652;2458;263;823;915;3281
411360;201408;567;1430;353;1023;47;184;163;395;210;579
411370;201408;46524;135773;35672;114798;7813;29439;13050;38525;20863;67964
411373;201408;1500;4746;1258;4260;362;1378;353;1150;715;2528
411375;201408;1167;3298;921;2804;244;785;330;942;574;1727
411380;201408;1313;3551;823;2507;155;506;247;719;402;1225
411390;201408;1888;5816;1669;5449;443;1580;794;2504;1237;4084
411400;201408;1863;5605;1453;4656;336;1218;445;1305;781;2523
411410;201408;2653;8254;2190;7147;705;2604;576;1622;1281;4226
411420;201408;4641;13626;3502;11009;932;3265;711;1888;1643;5153
411430;201408;3009;9754;2576;8949;795;3006;1107;3756;1902;6762
411435;201408;598;1927;509;1704;134;493;195;625;329;1118
411440;201408;2636;8631;2389;8139;891;3199;731;2591;1622;5790
411450;201408;2177;6689;1991;6367;449;1496;1187;3820;1636;5316
411460;201408;4874;15170;3442;11681;1260;4529;712;2310;1972;6839
411470;201408;906;2776;635;2096;142;518;128;361;270;879
411480;201408;5128;15706;4021;13488;1592;5783;891;2876;2483;8659
411490;201408;1716;5406;1536;5068;585;2178;420;1250;1005;3428
411500;201408;1753;4938;1235;3952;350;1221;313;988;663;2209
411510;201408;2505;7396;1988;6368;672;2376;460;1311;1132;3687
411520;201408;28719;81476;18654;60012;5552;19737;4090;12318;9642;32055
411530;201408;944;2739;638;2157;237;893;110;314;347;1207
411535;201408;482;1449;233;827;39;166;26;65;65;231
411540;201408;3098;8458;2424;7204;439;1376;1270;3801;1709;5177
411545;201408;1068;3714;982;3545;201;773;638;2330;839;3103
411550;201408;760;2145;617;1903;255;857;147;433;402;1290
411560;201408;2716;8270;2173;6958;629;2194;482;1400;1111;3594
411570;201408;6402;17838;4778;15042;1411;4917;1172;3802;2583;8719
411573;201408;1022;3090;962;2986;204;674;555;1751;759;2425
411575;201408;1540;4991;1330;4519;346;1266;517;1736;863;3002
411580;201408;3810;11351;2779;9194;713;2740;456;1201;1169;3941
411585;201408;510;1758;389;1419;113;440;71;237;184;677
411590;201408;599;1790;531;1657;142;493;184;557;326;1050
411600;201408;375;1152;309;1020;88;344;84;282;172;626
411605;201408;2388;6708;1751;5469;464;1577;675;2049;1139;3626
411610;201408;2427;6964;2185;6598;473;1540;1430;4271;1903;5811
411620;201408;2912;9534;2738;9226;850;3076;1238;4257;2088;7333
411630;201408;644;1746;395;1337;116;460;80;232;196;692
411640;201408;606;1904;504;1686;154;554;188;593;342;1147
411650;201408;192;641;168;594;46;183;59;195;105;378
411660;201408;879;2516;717;2205;193;625;302;938;495;1563
411670;201408;1723;5059;1521;4646;489;1660;554;1578;1043;3238
411680;201408;1768;5424;1539;5031;376;1192;918;3155;1294;4347
411690;201408;3756;11406;3140;10224;1034;3519;882;2940;1916;6459
411695;201408;853;2747;698;2419;155;574;316;1111;471;1685
411700;201408;1900;5571;1423;4660;355;1287;393;1198;748;2485
411705;201408;2338;7976;2040;7393;477;1756;1150;4294;1627;6050
411710;201408;2227;6862;1807;5924;533;1871;479;1450;1012;3321
411720;201408;726;2210;561;1807;110;391;146;433;256;824
411721;201408;736;2229;618;1983;201;721;135;391;336;1112
411722;201408;732;2232;566;1851;139;526;163;468;302;994
411725;201408;1384;4479;891;3224;227;885;201;722;428;1607
411727;201408;2321;6734;1880;5791;461;1533;805;2332;1266;3865
411729;201408;499;1389;371;1164;108;383;117;318;225;701
411730;201408;5489;16174;4664;14599;1967;6393;1423;4496;3390;10889
411740;201408;593;1746;445;1416;107;377;171;513;278;890
411745;201408;918;2895;767;2542;211;725;208;661;419;1386
411750;201408;4814;15042;3663;12186;1106;4065;727;2230;1833;6295
411760;201408;9050;27023;8086;25358;3000;10049;2549;8104;5549;18153
411770;201408;4003;14004;3499;12771;1381;5289;811;2966;2192;8255
411780;201408;3117;10185;2991;10038;406;1242;2238;7974;2644;9216
411790;201408;2674;7760;1958;6312;593;2215;633;1933;1226;4148
411800;201408;1438;4210;887;2939;164;618;171;461;335;1079
411810;201408;1616;5008;1411;4554;397;1465;451;1283;848;2748
411820;201408;16969;53716;14226;48528;5104;17872;4449;15865;9553;33737
411830;201408;424;1154;337;1022;146;444;49;151;195;595
411840;201408;9364;28108;7405;24226;2198;7842;2033;6401;4231;14243
411845;201408;583;1842;430;1468;105;387;107;350;212;737
411850;201408;6077;18643;5046;16496;1367;4790;1480;4815;2847;9605
411860;201408;922;2951;772;2623;218;788;228;735;446;1523
411870;201408;1074;3785;835;3124;152;597;225;818;377;1415
411880;201408;2527;7308;2137;6619;611;2140;810;2439;1421;4579
411885;201408;1114;3014;851;2572;224;836;310;796;534;1632
411890;201408;1378;4263;982;3313;285;1031;192;575;477;1606
411900;201408;972;3137;718;2490;217;764;125;428;342;1192
411910;201408;1237;4267;1066;3869;343;1367;335;1145;678;2512
411915;201408;12578;35809;8280;26777;1952;6980;2057;6103;4009;13083
411920;201408;1091;3822;966;3501;283;1131;222;753;505;1884
411925;201408;656;1847;459;1482;129;443;145;448;274;891
411930;201408;6391;21176;5639;19631;1875;6980;1968;6849;3843;13829
411940;201408;3676;12448;3282;11578;1113;4107;894;3075;2007;7182
411950;201408;10555;34227;9031;31186;2567;9734;4167;14099;6734;23833
411960;201408;4887;14925;4509;14186;1135;4007;2193;6737;3328;10744
411965;201408;591;1779;459;1566;103;397;167;578;270;975
411970;201408;778;2230;610;1956;207;739;169;505;376;1244
411980;201408;1554;4777;1279;4211;231;811;562;1829;793;2640
411990;201408;30887;105797;26887;97051;9586;36980;7762;28133;17348;65113
411995;201408;3170;10033;2844;9356;1158;4102;758;2454;1916;6556
412000;201408;2226;6048;1772;5263;382;1320;818;2175;1200;3495
412010;201408;749;2537;631;2259;174;643;159;546;333;1189
412015;201408;678;2089;544;1788;110;392;278;905;388;1297
412020;201408;451;1329;322;1048;114;402;125;381;239;783
412030;201408;645;2041;428;1504;97;401;119;374;216;775
412033;201408;786;2409;562;1883;141;505;120;359;261;864
412035;201408;1033;2942;791;2493;200;688;324;964;524;1652
412040;201408;777;2571;705;2381;254;883;234;776;488;1659
412050;201408;1654;5001;1274;4161;330;1210;280;867;610;2077
412060;201408;6901;24359;6306;23018;1966;7660;2518;9166;4484;16826
412065;201408;1005;3094;829;2716;253;937;242;744;495;1681
412070;201408;1238;3464;1030;3043;223;702;393;1145;616;1847
412080;201408;1670;5200;1072;3799;240;941;109;315;349;1256
412085;201408;371;1077;175;590;46;179;47;141;93;320
412090;201408;4939;16194;4722;15792;1037;3696;2968;10033;4005;13729
412100;201408;2246;7109;1971;6608;666;2350;683;2251;1349;4601
412110;201408;1161;3354;795;2564;245;854;231;719;476;1573
412120;201408;1876;6454;1687;6000;444;1790;785;2623;1229;4413
412125;201408;981;3060;873;2873;249;866;361;1209;610;2075
412130;201408;666;1965;491;1612;111;410;129;398;240;808
412135;201408;566;1634;415;1323;103;365;160;464;263;829
412140;201408;1874;5794;1580;5177;463;1620;453;1486;916;3106
412150;201408;3013;8900;2612;8098;410;1445;1555;4688;1965;6133
412160;201408;987;3211;677;2417;172;687;249;883;421;1570
412170;201408;4601;15281;3900;13860;1361;5206;1411;4916;2772;10122
412175;201408;1489;5188;1334;4834;378;1495;553;2000;931;3495
412180;201408;1806;5772;1411;5043;502;1969;424;1459;926;3428
412190;201408;3211;9569;2563;8441;875;3073;686;2301;1561;5374
412200;201408;2347;7814;1678;5995;408;1604;535;1880;943;3484
412210;201408;787;2228;466;1535;114;427;78;235;192;662
412215;201408;3494;11212;3172;10619;545;1860;2060;7107;2605;8967
412217;201408;1249;3689;1165;3542;223;787;748;2152;971;2939
412220;201408;5894;19614;5644;19111;1805;6367;2956;10078;4761;16445
412230;201408;3086;10517;2698;9702;803;3213;857;2947;1660;6160
412240;201408;9641;25305;5555;17572;1289;4565;957;2737;2246;7302
412250;201408;2223;6815;1969;6267;678;2344;555;1635;1233;3979
412260;201408;1370;4101;928;3129;203;796;301;906;504;1702
412265;201408;1233;3914;1128;3710;285;1075;549;1768;834;2843
412270;201408;853;2785;659;2314;152;604;134;438;286;1042
412280;201408;711;2190;535;1825;268;987;98;299;366;1286
412290;201408;1226;3488;995;3019;211;731;382;1075;593;1806
412300;201408;1851;5601;1545;4993;482;1739;411;1255;893;2994
412310;201408;1232;3511;1092;3318;200;521;736;2478;936;2999
412320;201408;733;2029;537;1687;135;475;187;579;322;1054
412330;201408;2030;5598;1576;4803;360;1175;756;2297;1116;3472
412340;201408;799;2524;547;1865;98;358;106;339;204;697
412350;201408;2659;8483;2185;7419;747;2700;388;1200;1135;3900
412360;201408;353;1124;277;925;54;204;90;251;144;455
412370;201408;1148;3614;906;3135;328;1214;265;894;593;2108
412380;201408;2098;6416;1802;5744;551;1848;534;1676;1085;3524
412382;201408;744;2132;533;1682;128;429;155;454;283;883
412385;201408;2508;7973;2285;7467;722;2503;780;2533;1502;5036
412390;201408;2491;7471;2272;7094;785;2618;882;2759;1667;5377
412395;201408;978;2741;786;2436;123;396;487;1519;610;1915
412400;201408;1198;3729;1057;3459;335;1127;410;1404;745;2531
412402;201408;2157;6678;1785;5871;577;2081;515;1513;1092;3594
412405;201408;4237;12402;2779;9231;773;2886;368;1133;1141;4019
412410;201408;6468;21052;5826;19746;2493;9224;1306;4350;3799;13574
412420;201408;545;1624;435;1392;141;495;134;354;275;849
412430;201408;495;1466;408;1288;111;388;169;487;280;875
412440;201408;4099;12328;3511;11293;735;2577;1396;4670;2131;7247
412450;201408;301;981;238;816;44;162;37;89;81;251
412460;201408;1025;2931;733;2371;187;710;174;516;361;1226
412470;201408;1892;6491;1678;5953;554;2055;599;2170;1153;4225
412480;201408;1313;3917;925;3039;223;792;148;396;371;1188
412490;201408;1310;3886;1151;3508;323;1033;340;1013;663;2046
412500;201408;2088;6240;1785;5635;518;1860;480;1318;998;3178
412510;201408;2801;9510;2468;8635;743;2808;940;3255;1683;6063
412520;201408;1880;5300;1416;4496;432;1470;475;1467;907;2937
412530;201408;807;2428;680;2141;208;671;203;632;411;1303
412535;201408;494;1520;327;1071;83;305;89;254;172;559
412540;201408;1161;3403;871;2777;152;562;334;1052;486;1614
412545;201408;958;2755;785;2378;150;524;308;838;458;1362
412550;201408;26063;79270;18022;61118;5097;18733;3767;11914;8864;30647
412555;201408;345;1063;239;798;58;215;44;119;102;334
412560;201408;4827;15662;3855;13663;1096;4411;965;3101;2061;7512
412570;201408;4450;13556;3332;10966;924;3364;718;2246;1642;5610
412575;201408;875;2721;701;2306;175;656;221;672;396;1328
412580;201408;1502;4167;1095;3436;277;914;349;1043;626;1957
412590;201408;514;1564;406;1359;139;499;122;424;261;923
412600;201408;1561;4951;1335;4482;428;1589;441;1386;869;2975
412610;201408;826;2662;660;2262;229;900;180;526;409;1426
412620;201408;1303;4323;1093;3865;371;1421;245;833;616;2254
412625;201408;14241;40865;11857;36285;4352;14208;2821;8528;7173;22736
412627;201408;1056;3274;734;2558;261;973;82;275;343;1248
412630;201408;3600;11546;3115;10479;864;3084;1017;3307;1881;6391
412635;201408;560;1714;398;1333;106;372;58;180;164;552
412640;201408;866;2635;592;1975;144;507;95;280;239;787
412650;201408;2337;6739;1934;5975;530;1838;685;1911;1215;3749
412660;201408;3132;9532;2589;8383;683;2452;634;1928;1317;4380
412665;201408;743;2003;462;1491;157;555;133;401;290;956
412667;201408;1514;4526;1206;3908;323;1194;342;1028;665;2222
412670;201408;695;2195;476;1649;105;411;84;218;189;629
412680;201408;1632;5266;1282;4452;358;1334;341;1063;699;2397
412690;201408;756;2425;612;2098;233;854;120;401;353;1255
412700;201408;1891;6171;1650;5770;623;2409;603;2064;1226;4473
412710;201408;8951;28300;7542;25354;2215;8134;2049;6604;4264;14738
412720;201408;1715;5468;1204;4115;303;1120;153;409;456;1529
412730;201408;2887;8779;1998;6819;649;2383;284;851;933;3234
412740;201408;2213;7290;1936;6648;800;2885;336;1189;1136;4074
412750;201408;3511;11515;3198;10977;580;2302;2135;7123;2715;9425
412760;201408;2416;8080;2302;7876;689;2638;1038;3401;1727;6039
412770;201408;12813;37516;8243;27316;1944;7179;1870;5672;3814;12851
412780;201408;1525;5028;1347;4610;413;1513;445;1448;858;2961
412785;201408;2571;7567;1882;6099;484;1724;886;2786;1370;4510
412788;201408;1417;4651;1303;4433;351;1375;479;1455;830;2830
412790;201408;1242;3860;1017;3376;262;935;311;962;573;1897
412795;201408;1060;3149;921;2895;306;1006;325;991;631;1997
412796;201408;2696;8598;2478;8140;707;2606;1009;3107;1716;5713
412800;201408;3687;11008;2938;9484;840;2989;910;2768;1750;5757
412810;201408;10784;30603;6518;20996;1696;5936;1483;4328;3179;10264
412820;201408;6844;20771;5094;17281;1492;5540;1137;3902;2629;9442
412830;201408;412;1338;351;1208;100;404;95;279;195;683
412840;201408;2217;6389;1825;5585;515;1711;482;1430;997;3141
412850;201408;2690;8162;2292;7545;427;1659;1168;3664;1595;5323
412853;201408;1693;4953;1490;4564;198;786;886;2501;1084;3287
412855;201408;1697;4951;1365;4253;442;1564;379;1044;821;2608
412860;201408;1345;4062;1130;3639;313;1132;471;1449;784;2581
412862;201408;882;2380;660;1944;175;571;248;680;423;1251
412863;201408;1251;4251;1200;4159;190;709;828;2844;1018;3553
412865;201408;677;2146;500;1705;112;413;191;662;303;1075
412870;201408;1044;3022;872;2733;301;1006;282;880;583;1886
412880;201408;1607;4457;1359;4042;418;1349;354;1013;772;2362
420005;201408;525;1585;350;1175;82;300;133;418;215;718
420010;201408;3512;10604;2939;9671;483;1686;1993;6724;2476;8410
420020;201408;802;2646;472;1756;86;371;61;180;147;551
420030;201408;572;1644;323;1147;94;378;60;204;154;582
420040;201408;1002;3118;671;2449;218;883;139;433;357;1316
420050;201408;836;2645;675;2267;195;685;281;911;476;1596
420055;201408;320;1026;222;788;61;234;46;144;107;378
420060;201408;385;1373;294;1125;88;374;41;140;129;514
420070;201408;2102;6633;1741;5759;366;1325;712;2464;1078;3789
420075;201408;209;612;116;394;30;120;36;106;66;226
420080;201408;627;2079;527;1863;193;745;128;437;321;1182
420090;201408;695;2480;540;2109;160;646;100;386;260;1032
420100;201408;1523;4929;1404;4762;369;1278;834;2880;1203;4158
420110;201408;462;1591;420;1498;121;442;197;711;318;1153
420120;201408;341;1208;286;1086;106;445;63;218;169;663
420125;201408;384;1573;359;1515;155;693;108;420;263;1113
420127;201408;615;1913;280;1053;97;385;41;149;138;534
420130;201408;2596;8928;2264;8235;689;2725;824;2783;1513;5508
420140;201408;5328;15702;3702;12533;1026;3917;746;2324;1772;6241
420150;201408;822;2467;560;1861;167;606;174;521;341;1127
420160;201408;325;973;204;697;40;155;50;160;90;315
420165;201408;237;764;156;550;36;149;36;122;72;271
420170;201408;248;824;174;670;72;317;20;55;92;372
420180;201408;478;1520;290;1057;84;322;64;221;148;543
420190;201408;605;1927;371;1374;125;507;62;211;187;718
420195;201408;1457;4224;1171;3821;287;1013;584;1956;871;2969
420200;201408;3019;9889;1945;7364;647;2707;349;1194;996;3901
420205;201408;1117;3737;999;3520;288;1074;457;1613;745;2687
420207;201408;1470;4381;1040;3449;326;1233;313;932;639;2165
420208;201408;521;1560;351;1223;128;487;105;348;233;835
420209;201408;375;1204;233;844;47;178;68;238;115;416
420210;201408;1854;6043;1279;4890;389;1716;194;665;583;2381
420213;201408;956;3477;907;3359;200;760;578;2166;778;2926
420215;201408;524;1732;387;1367;117;431;73;235;190;666
420220;201408;436;1708;409;1647;175;751;108;390;283;1141
420230;201408;4711;14612;3645;12622;921;3590;1803;6095;2724;9685
420240;201408;14398;41956;9086;31815;2093;8724;3597;11433;5690;20157
420243;201408;597;1860;483;1611;117;447;172;552;289;999
420245;201408;1266;3979;880;3153;257;1042;189;583;446;1625
420250;201408;843;2712;785;2619;271;988;343;1152;614;2140
420253;201408;675;1803;555;1631;133;391;271;877;404;1268
420257;201408;445;1378;337;1165;92;331;159;541;251;872
420260;201408;1434;4704;1235;4343;345;1323;572;2013;917;3336
420270;201408;604;1954;256;950;49;183;34;111;83;294
420280;201408;2494;6954;1597;5318;409;1611;572;1687;981;3298
420285;201408;169;504;61;230;9;40;1;2;10;42
420287;201408;662;2051;575;1887;156;536;218;717;374;1253
420290;201408;6868;20596;4448;14941;1042;3838;1534;4847;2576;8685
420300;201408;6058;18839;3995;14348;1029;4213;844;2998;1873;7211
420310;201408;902;2744;862;2678;185;613;548;1661;733;2274
420315;201408;990;3250;791;2829;232;922;315;1112;547;2034
420320;201408;5106;16048;4231;14478;1221;4645;1774;5921;2995;10566
420325;201408;467;1517;447;1471;141;503;164;526;305;1029
420330;201408;1328;4666;1046;3880;360;1427;242;788;602;2215
420340;201408;1530;4790;1188;3966;291;1057;324;1024;615;2081
420350;201408;1664;5424;1433;4931;411;1500;628;2183;1039;3683
420360;201408;3883;12458;2885;10138;1063;4097;530;1694;1593;5791
420370;201408;2119;5959;1757;5380;219;686;1387;4237;1606;4923
420380;201408;5648;18991;4714;16762;1527;5820;1330;4735;2857;10555
420390;201408;2154;6499;1322;4702;395;1510;338;1146;733;2656
420395;201408;2109;6633;1586;5433;384;1463;332;1015;716;2478
420400;201408;1538;4602;1139;3816;348;1357;334;1019;682;2376
420410;201408;856;2399;609;1982;155;573;316;1006;471;1579
420415;201408;526;1694;415;1414;128;465;142;474;270;939
420417;201408;818;2668;694;2363;146;528;343;1162;489;1690
420419;201408;471;1501;325;1209;140;564;83;311;223;875
420420;201408;11495;34814;8700;29023;2618;9775;2888;9221;5506;18996
420425;201408;1267;3527;787;2515;92;362;334;977;426;1339
420430;201408;4242;13427;2929;10293;903;3443;844;2932;1747;6375
420435;201408;277;901;203;723;54;221;89;305;143;526
420440;201408;1501;4418;919;3171;366;1356;167;532;533;1888
420445;201408;441;1281;346;1109;83;267;176;578;259;845
420450;201408;1316;3923;788;2806;193;778;160;488;353;1266
420455;201408;2334;7267;2080;6815;565;2107;931;2972;1496;5079
420460;201408;10232;32483;8309;28754;2440;9474;3088;10239;5528;19713
420470;201408;1249;3522;838;2722;251;912;240;737;491;1649
420475;201408;184;595;121;438;40;149;32;119;72;268
420480;201408;6199;18589;5128;16705;2061;7451;936;3001;2997;10452
420490;201408;916;2777;625;2229;203;764;155;537;358;1301
420500;201408;2139;6650;1755;5940;546;1991;855;2887;1401;4878
420510;201408;200;846;186;808;78;349;53;212;131;561
420515;201408;166;601;133;524;41;173;25;100;66;273
420517;201408;971;3021;890;2861;161;547;581;1877;742;2424
420519;201408;458;1301;341;1059;67;219;130;408;197;627
420520;201408;825;2336;652;2087;188;666;305;936;493;1602
420530;201408;1422;4937;1147;4244;371;1500;293;966;664;2466
420535;201408;267;816;176;615;56;223;31;89;87;312
420540;201408;22518;66743;15947;52441;4953;17721;4672;14429;9625;32150
420543;201408;501;1374;360;1133;46;171;216;718;262;889
420545;201408;1721;5603;1412;4897;386;1503;476;1547;862;3050
420550;201408;5079;16531;4092;14246;1164;4560;1215;4084;2379;8644
420555;201408;469;1528;393;1361;137;515;120;403;257;918
420560;201408;600;1784;501;1574;92;325;261;808;353;1133
420570;201408;2088;6951;1686;5946;497;1977;542;1796;1039;3773
420580;201408;1277;4201;1057;3793;304;1214;488;1746;792;2960
420590;201408;3540;11186;2543;8874;708;2687;518;1658;1226;4345
420600;201408;988;3433;892;3201;240;925;374;1368;614;2293
420610;201408;654;2133;448;1652;147;590;79;261;226;851
420620;201408;1222;3869;1085;3615;403;1421;301;988;704;2409
420630;201408;1214;3917;904;3143;252;935;286;894;538;1829
420640;201408;705;2208;331;1260;85;375;22;61;107;436
420650;201408;2159;6603;1230;4371;254;1024;224;667;478;1691
420660;201408;689;2057;557;1806;128;463;269;859;397;1322
420665;201408;858;2504;553;1858;116;431;180;542;296;973
420670;201408;1821;5810;1364;4777;344;1362;275;860;619;2222
420675;201408;260;824;184;644;46;184;74;244;120;428
420680;201408;518;1278;312;953;62;210;106;305;168;515
420690;201408;851;2955;620;2307;129;530;197;676;326;1206
420700;201408;3786;11081;2931;9338;727;2686;987;2992;1714;5678
420710;201408;833;2991;695;2704;269;1131;200;745;469;1876
420720;201408;1993;6188;1723;5819;463;1633;1016;3446;1479;5079
420730;201408;4831;15137;4189;13933;1436;5122;1638;5362;3074;10484
420740;201408;831;2745;794;2693;177;620;544;1859;721;2479
420750;201408;2600;8527;1839;6654;433;1775;551;1748;984;3523
420757;201408;131;417;97;365;31;129;28;98;59;227
420760;201408;457;1491;337;1163;77;285;99;324;176;609
420765;201408;700;2335;440;1662;128;531;98;359;226;890
420768;201408;1317;4616;1084;4071;366;1439;401;1523;767;2962
420770;201408;931;2931;593;2150;194;759;147;507;341;1266
420775;201408;721;2323;468;1620;151;527;103;344;254;871
420780;201408;1719;5312;1159;3927;313;1147;311;977;624;2124
420785;201408;324;993;225;737;44;158;76;225;120;383
420790;201408;1398;5040;1146;4344;340;1433;459;1640;799;3073
420800;201408;961;2840;568;1931;177;671;126;389;303;1060
420810;201408;2691;9378;2165;8130;782;3260;575;2098;1357;5358
420820;201408;8813;29493;6979;26113;2372;9823;2334;8793;4706;18616
420830;201408;2896;9809;2500;9043;938;3670;888;3112;1826;6782
420840;201408;975;2945;581;2133;162;668;170;576;332;1244
420845;201408;1373;4604;1105;4063;412;1707;241;801;653;2508
420850;201408;2128;7027;1416;5462;500;2085;300;1151;800;3236
420860;201408;688;2014;465;1604;167;649;189;636;356;1285
420870;201408;1442;4188;1141;3749;437;1575;360;1122;797;2697
420880;201408;1499;5068;1229;4360;355;1323;241;808;596;2131
420890;201408;13475;32694;6203;19711;1275;4677;2193;6177;3468;10854
420895;201408;242;670;118;389;35;121;29;90;64;211
420900;201408;2425;7078;1609;5431;453;1639;411;1327;864;2966
420910;201408;23879;73157;15694;55527;3765;15268;4352;14351;8117;29619
420915;201408;695;2733;620;2529;191;787;278;1174;469;1961
420917;201408;467;1455;250;804;58;218;89;235;147;453
420920;201408;210;610;110;380;49;181;17;59;66;240
420930;201408;21341;64459;17805;58299;5428;19374;6625;21580;12053;40954
420940;201408;4547;13984;3893;12538;1127;4028;1165;3403;2292;7431
420945;201408;246;776;163;567;51;196;43;141;94;337
420950;201408;665;1933;314;1177;76;330;58;194;134;524
420960;201408;1498;4698;1292;4327;418;1582;491;1527;909;3109
420970;201408;2749;8697;2422;8162;619;2250;1302;4494;1921;6744
420980;201408;480;1552;394;1395;120;423;192;742;312;1165
420985;201408;614;1836;358;1277;110;426;104;352;214;778
420990;201408;948;2819;647;2280;176;680;183;601;359;1281
421000;201408;690;2482;493;1959;156;675;68;212;224;887
421003;201408;711;2038;303;1051;66;254;57;160;123;414
421005;201408;268;866;221;781;71;272;105;362;176;634
421010;201408;7098;21753;5343;18243;1723;6398;1614;5222;3337;11620
421020;201408;504;1621;380;1372;68;250;203;773;271;1023
421030;201408;1041;3861;963;3666;346;1390;327;1267;673;2657
421040;201408;960;2895;779;2569;249;891;296;909;545;1800
421050;201408;2079;5570;1182;3959;332;1284;321;941;653;2225
421055;201408;288;931;190;683;59;232;50;150;109;382
421060;201408;579;2132;480;1851;124;517;137;509;261;1026
421070;201408;821;2586;543;1912;140;561;145;503;285;1064
421080;201408;700;2283;630;2131;189;676;298;998;487;1674
421085;201408;591;1605;326;1130;81;306;87;322;168;628
421090;201408;492;1392;335;1045;82;273;140;418;222;691
421100;201408;1099;3368;767;2639;220;806;175;527;395;1333
421105;201408;1535;4918;1318;4514;333;1250;542;1900;875;3150
421110;201408;1680;5568;1460;5186;545;2097;473;1576;1018;3673
421120;201408;1731;5619;1261;4484;298;1221;384;1222;682;2443
421125;201408;461;1396;348;1180;109;410;127;408;236;818
421130;201408;3503;11680;2908;10545;1059;4253;1001;3648;2060;7901
421140;201408;440;1384;353;1196;97;366;135;428;232;794
421145;201408;610;2019;455;1590;81;322;200;667;281;989
421150;201408;567;1872;443;1633;116;464;196;718;312;1182
421160;201408;1049;3219;663;2327;153;612;223;714;376;1326
421165;201408;342;1212;276;1006;68;257;122;445;190;702
421170;201408;2028;6362;1615;5436;439;1563;825;2738;1264;4301
421175;201408;1464;4392;1160;3885;355;1390;423;1273;778;2663
421180;201408;614;1772;347;1177;94;364;124;380;218;744
421185;201408;493;1409;360;1144;75;230;179;588;254;818
421187;201408;332;1055;265;916;83;296;108;362;191;658
421189;201408;539;1652;487;1551;130;430;188;594;318;1024
421190;201408;11550;36325;8115;28880;2434;9263;2310;8102;4744;17365
421200;201408;1090;3659;953;3357;266;1029;347;1176;613;2205
421205;201408;249;791;187;652;45;188;47;135;92;323
421210;201408;2178;6799;1819;5899;624;2128;564;1777;1188;3905
421220;201408;2559;8770;2249;8096;804;3149;646;2291;1450;5440
421223;201408;793;2265;502;1746;142;524;226;771;368;1295
421225;201408;1258;3921;1045;3472;283;1000;437;1453;720;2453
421227;201408;977;3240;870;3073;222;781;515;1882;737;2663
421230;201408;756;2571;680;2390;196;741;248;834;444;1575
421240;201408;576;1910;368;1299;86;318;74;229;160;547
421250;201408;2030;6284;1392;5109;507;2023;378;1361;885;3384
421260;201408;394;1201;162;630;45;177;35;131;80;308
421265;201408;385;1347;347;1246;85;320;116;423;201;743
421270;201408;736;2009;447;1510;154;568;103;390;257;958
421280;201408;1715;5451;1400;4956;483;1906;445;1581;928;3487
421290;201408;2098;5964;1328;4420;426;1540;314;928;740;2468
421300;201408;336;1050;279;927;102;385;110;339;212;724
421310;201408;540;1844;458;1624;157;565;120;410;277;975
421315;201408;392;1176;229;827;49;183;38;141;87;324
421320;201408;594;2049;410;1545;83;359;77;233;160;592
421330;201408;652;2280;567;2102;237;988;79;279;316;1267
421335;201408;587;1946;472;1715;127;505;104;384;231;889
421340;201408;2046;6420;1759;5925;426;1625;955;3185;1381;4810
421350;201408;1146;3919;952;3481;311;1275;289;1006;600;2281
421360;201408;3366;10101;2221;7817;527;2116;739;2440;1266;4556
421370;201408;1110;3939;964;3610;332;1370;283;1016;615;2386
421380;201408;1110;3222;891;2795;180;624;436;1364;616;1988
421390;201408;202;661;154;533;27;92;43;162;70;254
421400;201408;427;1612;345;1416;139;605;91;349;230;954
421410;201408;377;1170;302;1017;63;217;153;525;216;742
421415;201408;418;1316;214;807;69;274;58;203;127;477
421420;201408;1429;4483;1075;3615;252;908;235;722;487;1630
421430;201408;307;1014;242;883;80;331;45;153;125;484
421440;201408;870;2640;600;2113;170;649;223;744;393;1393
421450;201408;628;2112;450;1692;155;636;92;327;247;963
421460;201408;736;2317;484;1802;131;540;122;430;253;970
421470;201408;557;2038;470;1841;139;556;188;740;327;1296
421480;201408;3112;9717;2108;7667;680;2766;569;1906;1249;4672
421490;201408;343;1150;193;752;74;315;51;197;125;512
421500;201408;2785;9944;2450;9212;1012;4238;561;2038;1573;6276
421505;201408;406;1406;371;1316;115;430;147;512;262;942
421507;201408;706;2301;507;1828;117;441;198;716;315;1157
421510;201408;315;1190;288;1135;96;436;122;418;218;854
421520;201408;831;2245;542;1648;61;238;279;766;340;1004
421530;201408;538;1814;342;1353;90;402;117;450;207;852
421535;201408;751;2321;457;1678;90;348;230;826;320;1174
421540;201408;430;1274;369;1159;94;327;151;443;245;770
421545;201408;1292;4487;1040;3951;343;1456;236;850;579;2306
421550;201408;2315;7843;2058;7339;718;2857;653;2256;1371;5113
421555;201408;334;1017;135;481;23;92;29;96;52;188
421560;201408;216;651;100;357;25;100;22;75;47;175
421565;201408;1117;3550;1020;3380;435;1546;359;1153;794;2699
421567;201408;973;3636;840;3284;401;1613;181;705;582;2318
421568;201408;502;1638;388;1382;112;414;120;426;232;840
421569;201408;215;702;132;498;27;109;36;130;63;239
421570;201408;1291;4275;840;3122;289;1186;202;704;491;1890
421575;201408;637;2145;567;2002;117;439;325;1153;442;1592
421580;201408;4344;14554;3481;12582;1288;5203;875;2874;2163;8077
421590;201408;265;851;215;744;47;173;104;339;151;512
421600;201408;594;1788;438;1449;133;483;105;328;238;811
421605;201408;728;2270;515;1827;130;525;143;479;273;1004
421610;201408;1881;4914;1474;4328;196;632;963;2823;1159;3455
421620;201408;5380;16680;3839;13353;1275;4773;1287;4506;2562;9279
421625;201408;434;1390;257;935;67;274;89;308;156;582
421630;201408;2878;8730;1787;6228;527;1987;368;1242;895;3229
421635;201408;363;1223;260;969;69;282;97;330;166;612
421640;201408;1153;3706;997;3435;217;749;603;2133;820;2882
421650;201408;2423;8205;2099;7447;850;3317;360;1186;1210;4503
421660;201408;9894;33384;8037;29586;2681;10905;2570;8967;5251;19872
421670;201408;1284;4213;946;3413;297;1170;280;1002;577;2172
421680;201408;1522;5008;1336;4553;527;1892;276;908;803;2800
421690;201408;2103;6975;1641;5842;468;1799;284;944;752;2743
421700;201408;753;2352;467;1690;144;592;143;440;287;1032
421710;201408;375;1342;278;1059;111;433;74;274;185;707
421715;201408;320;911;197;655;56;201;61;196;117;397
421720;201408;1718;5284;1195;4188;449;1795;358;1121;807;2916
421725;201408;137;486;132;475;53;210;42;152;95;362
421730;201408;666;2084;346;1275;89;360;79;236;168;596
421740;201408;775;2448;561;1930;166;677;141;381;307;1058
421750;201408;1520;4598;1175;3864;327;1183;471;1416;798;2599
421755;201408;475;1508;341;1168;105;396;98;301;203;697
421760;201408;573;1927;337;1257;90;376;131;471;221;847
421770;201408;3901;11931;3156;10410;1249;4291;902;3063;2151;7354
421775;201408;602;1781;394;1394;91;333;123;427;214;760
421780;201408;1840;6387;1445;5469;554;2264;422;1506;976;3770
421790;201408;1061;3017;654;2315;210;851;166;527;376;1378
421795;201408;415;1278;280;932;50;184;88;295;138;479
421800;201408;2922;9470;2275;8156;637;2582;839;2732;1476;5314
421810;201408;697;2260;508;1816;161;606;90;315;251;921
421820;201408;1319;4077;949;3337;218;902;277;878;495;1780
421825;201408;1453;4876;1345;4613;235;943;827;2719;1062;3662
421830;201408;3240;11105;3031;10680;776;2878;1546;5597;2322;8475
421835;201408;195;615;153;543;50;212;72;230;122;442
421840;201408;533;1899;470;1746;166;672;173;613;339;1285
421850;201408;616;1828;440;1481;148;528;137;469;285;997
421860;201408;401;1293;261;976;59;243;59;208;118;451
421870;201408;5525;16430;3938;13097;1221;4377;810;2593;2031;6970
421875;201408;450;1362;217;803;57;243;52;168;109;411
421880;201408;1140;3732;915;3199;280;1120;241;768;521;1888
421885;201408;371;1294;328;1195;88;326;134;487;222;813
421890;201408;1111;3828;963;3506;329;1313;307;1092;636;2405
421895;201408;445;1518;410;1448;112;395;225;824;337;1219
421900;201408;908;2975;755;2601;216;788;269;852;485;1640
421910;201408;567;1815;405;1432;111;437;117;366;228;803
421915;201408;641;1965;490;1618;114;405;168;519;282;924
421917;201408;633;1978;501;1746;163;672;190;607;353;1279
421920;201408;848;2564;628;2259;287;1081;209;741;496;1822
421930;201408;4218;11968;2880;9495;928;3419;516;1611;1444;5030
421935;201408;918;3194;722;2740;199;837;267;983;466;1820
421940;201408;363;1313;261;1026;80;351;61;213;141;564
421950;201408;4611;13253;2574;8880;787;2889;576;2009;1363;4898
421960;201408;266;851;213;729;59;220;60;190;119;410
421970;201408;2252;6862;1668;5540;613;2234;338;986;951;3220
421985;201408;532;1443;295;960;58;211;94;314;152;525
422000;201408;665;1954;519;1684;102;365;275;931;377;1296
430003;201408;920;2684;730;2350;214;766;230;713;444;1479
430005;201408;326;1093;275;981;56;214;153;530;209;744
430010;201408;2325;6622;1769;5566;547;1782;682;2184;1229;3966
430020;201408;1130;3032;984;2811;226;748;570;1550;796;2298
430030;201408;1625;4429;1348;3932;411;1285;547;1523;958;2808
430040;201408;13081;34402;10960;30903;3412;9955;4103;11591;7515;21546
430045;201408;769;2140;616;1827;119;399;344;989;463;1388
430047;201408;264;676;166;504;34;100;76;228;110;328
430050;201408;1145;3170;756;2416;157;582;296;891;453;1473
430055;201408;307;891;200;636;38;136;102;320;140;456
430057;201408;83;221;39;130;8;30;11;25;19;55
430060;201408;16373;53586;14434;50055;4246;15363;7096;25140;11342;40503
430063;201408;1114;3331;902;2869;244;787;432;1424;676;2211
430064;201408;1736;5173;1449;4682;426;1401;637;2123;1063;3524
430066;201408;179;453;132;378;27;88;73;193;100;281
430070;201408;694;2074;413;1438;110;413;121;387;231;800
430080;201408;657;2156;521;1838;144;561;155;508;299;1069
430085;201408;733;2083;528;1721;159;596;209;642;368;1238
430087;201408;1014;3101;966;3011;108;378;754;2326;862;2704
430090;201408;855;2285;305;1014;45;174;68;225;113;399
430100;201408;1134;3555;854;2954;297;1140;210;604;507;1744
430105;201408;862;2737;664;2336;205;796;175;584;380;1380
430107;201408;272;923;215;752;47;180;81;268;128;448
430110;201408;2326;6824;2113;6458;698;2268;939;2857;1637;5125
430120;201408;1859;5705;1484;4898;336;1175;831;2688;1167;3863
430130;201408;4660;12012;4191;11347;793;2303;2538;6904;3331;9207
430140;201408;1269;4085;977;3384;306;1098;329;1109;635;2207
430150;201408;961;2617;650;2028;166;548;196;607;362;1155
430155;201408;527;1652;399;1360;90;298;189;655;279;953
430160;201408;19015;56222;17631;53927;3914;12932;9976;31263;13890;44195
430163;201408;1985;6000;1708;5477;385;1374;855;2772;1240;4146
430165;201408;358;1146;252;945;103;406;62;223;165;629
430170;201408;811;2381;384;1341;82;303;77;232;159;535
430175;201408;971;3080;769;2599;183;583;362;1303;545;1886
430180;201408;1161;3178;990;2890;243;796;486;1386;729;2182
430185;201408;782;1966;403;1229;64;218;136;373;200;591
430187;201408;737;2308;606;2029;181;690;203;638;384;1328
430190;201408;2404;7184;2107;6610;526;1890;1034;3221;1560;5111
430192;201408;206;635;105;329;15;47;31;92;46;139
430195;201408;293;897;78;288;10;36;13;39;23;75
430200;201408;1884;6011;1562;5340;474;1719;386;1322;860;3041
430205;201408;526;1544;407;1319;57;202;258;829;315;1031
430210;201408;6781;19348;3795;12812;1032;3764;783;2436;1815;6200
430215;201408;367;1069;272;868;63;219;120;362;183;581
430220;201408;711;1876;345;1148;69;254;67;212;136;466
430222;201408;328;1008;253;843;56;222;113;352;169;574
430223;201408;361;1080;316;1008;64;208;210;679;274;887
430225;201408;61;177;37;118;7;19;9;23;16;42
430230;201408;2180;6949;2054;6817;364;1069;1597;5516;1961;6585
430235;201408;284;941;227;795;72;275;58;188;130;463
430237;201408;482;1332;379;1134;49;185;252;719;301;904
430240;201408;1202;3544;915;3000;311;1140;305;925;616;2065
430245;201408;974;3142;756;2656;213;776;339;1213;552;1989
430250;201408;1647;4565;1478;4267;627;1866;452;1333;1079;3199
430258;201408;215;612;147;476;23;80;69;226;92;306
430260;201408;861;2438;577;1844;82;298;320;1027;402;1325
430265;201408;344;1072;276;917;85;275;44;131;129;406
430270;201408;3673;10435;3288;9770;781;2626;1749;5111;2530;7737
430280;201408;5561;15736;4708;14149;1338;4268;2100;6297;3438;10565
430290;201408;2558;7049;2431;6909;298;840;2020;5847;2318;6687
430300;201408;10592;32244;8910;28967;3091;10529;3670;12217;6761;22746
430310;201408;9096;28689;7966;26445;2561;9103;3376;10922;5937;20025
430320;201408;879;2595;600;2019;97;287;312;1102;409;1389
430330;201408;1033;2842;868;2527;267;818;347;937;614;1755
430340;201408;788;1988;442;1469;107;402;215;700;322;1102
430350;201408;6469;20624;5499;18461;1993;7071;1953;6412;3946;13483
430355;201408;325;825;165;514;33;123;41;113;74;236
430360;201408;1178;3161;1005;2831;191;604;558;1530;749;2134
430367;201408;359;988;237;763;41;143;72;220;113;363
430370;201408;650;1917;511;1635;186;633;133;391;319;1024
430380;201408;891;2307;498;1587;132;448;182;599;314;1047
430390;201408;4666;13669;3422;11045;896;3134;1005;3106;1901;6240
430400;201408;1395;3354;962;2697;287;901;445;1158;732;2059
430410;201408;727;1966;559;1687;102;341;288;868;390;1209
430420;201408;4776;13996;3854;11869;1146;3604;1583;4900;2729;8504
430430;201408;842;2350;544;1767;174;617;150;465;324;1082
430435;201408;2151;5854;1735;5086;405;1246;924;2724;1329;3970
430440;201408;5044;15697;4090;13711;889;3147;1923;6727;2812;9874
430450;201408;9234;26646;7407;22853;2849;9236;2117;6480;4966;15716
430460;201408;28527;86921;23182;77043;7317;26104;8478;28120;15795;54224
430461;201408;493;1374;169;551;34;123;44;137;78;260
430462;201408;370;1082;294;948;123;428;83;256;206;684
430463;201408;4129;13555;3645;12572;910;3429;1840;6342;2750;9771
430465;201408;679;1848;577;1674;127;419;373;1052;500;1471
430466;201408;4572;13414;4297;12923;1173;3819;2260;6761;3433;10580
430467;201408;613;1882;539;1760;135;487;270;858;405;1345
430468;201408;1517;4399;1321;4091;514;1720;410;1250;924;2970
430469;201408;197;550;63;237;8;37;17;63;25;100
430470;201408;7841;21072;5673;17327;1884;6156;1504;4540;3388;10696
430471;201408;924;3074;826;2860;305;1104;216;747;521;1851
430480;201408;957;2607;519;1690;88;313;128;367;216;680
430485;201408;256;786;141;504;27;93;54;197;81;290
430490;201408;551;1648;391;1340;116;406;139;497;255;903
430495;201408;446;1330;304;1019;63;231;85;267;148;498
430500;201408;1679;4724;1421;4274;448;1456;633;1885;1081;3341
430510;201408;26068;80318;20430;67432;7059;25532;6035;18968;13094;44500
430511;201408;497;1515;244;829;47;170;45;127;92;297
430512;201408;1378;3619;1213;3341;354;988;473;1365;827;2353
430513;201408;728;2035;499;1541;80;261;237;730;317;991
430515;201408;623;1841;492;1559;102;314;214;709;316;1023
430517;201408;1489;4904;1293;4472;261;959;800;2757;1061;3716
430520;201408;1842;5415;1446;4560;463;1561;551;1677;1014;3238
430530;201408;968;2742;523;1693;100;376;147;428;247;804
430535;201408;2606;8353;2157;7361;597;2271;747;2483;1344;4754
430537;201408;642;1856;447;1524;48;162;342;1185;390;1347
430540;201408;784;1903;591;1643;138;428;340;919;478;1347
430543;201408;614;1619;553;1557;127;383;378;1073;505;1456
430544;201408;792;2589;661;2281;142;538;342;1145;484;1683
430545;201408;1468;4749;1276;4504;412;1449;684;2579;1096;4028
430550;201408;736;2182;504;1695;105;373;204;694;309;1067
430558;201408;119;357;80;270;37;140;10;24;47;164
430560;201408;404;1029;246;728;39;144;101;280;140;424
430570;201408;1264;3301;878;2584;219;745;437;1172;656;1917
430580;201408;1177;3305;763;2492;262;888;207;697;469;1585
430583;201408;156;430;53;173;8;31;5;14;13;45
430585;201408;373;1008;245;732;81;263;101;274;182;537
430587;201408;301;940;257;847;102;350;80;262;182;612
430590;201408;1544;4386;1466;4261;313;993;907;2623;1220;3616
430593;201408;37;142;32;126;10;49;11;35;21;84
430595;201408;261;745;106;384;33;138;16;46;49;184
430597;201408;417;1276;317;1036;60;216;132;413;192;629
430600;201408;2267;6259;1378;4265;302;999;487;1470;789;2469
430605;201408;1412;4416;1123;3790;290;1070;466;1598;756;2668
430607;201408;786;2080;626;1812;100;312;394;1150;494;1462
430610;201408;8655;23460;6748;20332;1728;5713;2861;8626;4589;14339
430613;201408;266;665;125;383;30;93;34;90;64;183
430620;201408;1018;3120;834;2697;243;868;332;1006;575;1874
430630;201408;509;1535;299;995;92;317;57;171;149;488
430632;201408;755;2119;461;1461;93;343;233;683;326;1026
430635;201408;707;1962;502;1561;120;393;239;740;359;1133
430637;201408;559;1605;499;1483;85;294;322;919;407;1213
430640;201408;2035;5771;1064;3523;251;891;214;592;465;1483
430642;201408;514;1364;320;1010;67;229;142;442;209;671
430645;201408;195;580;109;379;28;107;25;82;53;189
430650;201408;2187;7191;1896;6570;421;1476;1050;3769;1471;5245
430655;201408;317;959;277;872;73;248;105;279;178;527
430660;201408;6336;18661;5045;16260;1516;5375;2104;6698;3620;12073
430670;201408;506;1490;459;1396;43;127;345;1082;388;1209
430673;201408;814;1988;452;1375;122;386;187;565;309;951
430675;201408;228;686;129;442;30;115;50;165;80;280
430676;201408;4790;14520;4294;13670;1337;4531;1752;5799;3089;10330
430680;201408;1268;3784;928;3023;200;736;366;1092;566;1828
430690;201408;4677;13613;3836;11928;1224;3950;1422;4528;2646;8478
430692;201408;307;1055;224;881;31;120;137;550;168;670
430693;201408;1846;5203;1355;4122;308;1020;409;1193;717;2213
430695;201408;494;1457;401;1272;80;303;203;609;283;912
430697;201408;496;1410;378;1203;120;375;149;508;269;883
430700;201408;9630;25310;4465;14815;935;3469;511;1554;1446;5023
430705;201408;421;1330;388;1273;128;447;165;550;293;997
430710;201408;1912;4971;1498;4265;306;941;751;2227;1057;3168
430720;201408;943;2352;618;1867;175;568;251;783;426;1351
430730;201408;1979;5329;1511;4568;368;1074;811;2597;1179;3671
430740;201408;626;1797;389;1284;126;444;71;213;197;657
430745;201408;551;1589;336;1068;68;231;107;349;175;580
430750;201408;1921;5456;1598;4894;382;1292;821;2414;1203;3706
430755;201408;677;1902;479;1464;101;365;219;600;320;965
430760;201408;3824;9807;2980;8688;726;2277;1551;4665;2277;6942
430770;201408;7197;21626;6056;19576;1400;4967;3130;9999;4530;14966
430780;201408;2692;7678;1827;5915;515;1815;682;2102;1197;3917
430781;201408;667;1974;482;1586;139;476;155;497;294;973
430783;201408;589;1540;448;1292;97;313;208;557;305;870
430786;201408;132;434;103;358;33;119;24;85;57;204
430790;201408;4341;12069;2867;8998;609;2217;1244;3610;1853;5827
430800;201408;855;2597;615;2014;156;539;210;651;366;1190
430805;201408;505;1433;368;1179;50;147;220;747;270;894
430807;201408;323;963;237;771;58;229;76;214;134;443
430810;201408;766;2143;384;1294;76;284;74;222;150;506
430820;201408;1152;3691;849;2914;249;921;258;814;507;1735
430825;201408;469;1319;241;761;48;163;78;216;126;379
430830;201408;2737;8065;2536;7750;369;1125;1654;5363;2023;6488
430840;201408;1043;3249;941;3031;247;817;446;1485;693;2302
430843;201408;118;359;76;249;16;50;34;107;50;157
430845;201408;387;1171;314;1020;123;428;43;133;166;561
430850;201408;3475;10622;3087;9905;848;2883;1378;4428;2226;7311
430860;201408;933;2701;604;2106;196;795;156;485;352;1280
430865;201408;755;2072;686;1953;225;665;330;929;555;1594
430870;201408;708;2032;432;1461;133;466;113;362;246;828
430880;201408;1464;4225;1168;3644;456;1480;336;1083;792;2563
430885;201408;213;648;167;573;50;184;62;204;112;388
430890;201408;1793;4754;1320;3887;73;247;776;2226;849;2473
430900;201408;3421;9113;3088;8599;703;2090;1765;4860;2468;6950
430905;201408;1199;3547;806;2668;252;902;207;653;459;1555
430910;201408;2018;6377;1612;5574;593;2190;599;2007;1192;4197
430912;201408;613;1708;473;1477;73;265;270;820;343;1085
430915;201408;456;1529;324;1251;103;423;91;371;194;794
430920;201408;18999;60092;17366;56995;5181;17840;9855;32207;15036;50047
430925;201408;94;269;71;224;22;76;35;108;57;184
430930;201408;10221;31683;8003;27142;2419;8675;3003;10576;5422;19251
430940;201408;1341;4165;956;3281;249;946;275;890;524;1836
430950;201408;1666;4698;1263;3851;396;1282;392;1141;788;2423
430955;201408;139;446;90;309;31;113;24;75;55;188
430957;201408;332;1121;269;984;69;261;120;449;189;710
430960;201408;1858;5334;1622;4919;597;1930;573;1764;1170;3694
430965;201408;1467;4353;1260;3985;112;412;1000;3142;1112;3554
430970;201408;566;1610;335;1103;83;294;101;331;184;625
430975;201408;662;2168;508;1784;94;355;270;945;364;1300
430980;201408;603;1453;348;1066;95;332;140;385;235;717
430990;201408;700;2261;530;1835;180;635;141;481;321;1116
430995;201408;754;2260;669;2091;230;751;256;792;486;1543
431000;201408;1819;4906;1011;3220;246;893;149;405;395;1298
431010;201408;2972;8800;2027;6840;532;1975;646;2038;1178;4013
431020;201408;15013;37536;10435;29185;2870;8243;3442;9942;6312;18185
431030;201408;409;1222;226;794;57;212;54;185;111;397
431033;201408;2892;8436;2636;8047;656;2064;1461;4670;2117;6734
431036;201408;247;679;114;381;22;76;33;99;55;175
431040;201408;1052;3081;885;2790;239;829;461;1421;700;2250
431041;201408;614;1702;551;1610;171;512;233;723;404;1235
431043;201408;431;1425;323;1172;153;611;103;332;256;943
431046;201408;129;393;96;320;27;100;32;102;59;202
431050;201408;1949;4951;1534;4246;362;1070;843;2311;1205;3381
431053;201408;655;2171;552;1947;181;686;179;647;360;1333
431055;201408;704;1979;651;1885;79;234;468;1367;547;1601
431057;201408;386;1144;228;805;56;202;94;332;150;534
431060;201408;6462;19057;6059;18537;1640;4871;3589;11478;5229;16349
431065;201408;507;1470;448;1361;48;159;297;896;345;1055
431070;201408;775;2267;471;1568;99;345;125;383;224;728
431075;201408;299;912;199;689;38;143;63;224;101;367
431080;201408;743;2425;613;2146;170;639;136;460;306;1099
431085;201408;982;2602;795;2293;142;435;481;1380;623;1815
431087;201408;635;1833;561;1692;77;220;369;1121;446;1341
431090;201408;591;1499;309;964;106;348;68;196;174;544
431100;201408;4888;13629;4080;12210;1199;3786;1684;5154;2883;8940
431110;201408;1692;4532;1271;3679;307;963;638;1790;945;2753
431112;201408;668;2106;635;2047;202;651;309;998;511;1649
431113;201408;691;2048;517;1653;155;506;158;513;313;1019
431115;201408;1606;4743;1429;4432;299;978;853;2639;1152;3617
431120;201408;2934;9286;2472;8368;765;2832;1027;3377;1792;6209
431123;201408;576;1743;451;1494;122;441;224;748;346;1189
431125;201408;1448;4475;1110;3750;354;1204;399;1438;753;2642
431127;201408;139;377;63;205;6;18;8;24;14;42
431130;201408;4114;11856;3275;10363;901;3108;1373;4331;2274;7439
431140;201408;4175;10626;2311;7405;468;1732;607;1695;1075;3427
431142;201408;572;1726;515;1617;72;223;333;1068;405;1291
431150;201408;1379;4193;1115;3675;309;1065;416;1378;725;2443
431160;201408;1032;3062;867;2712;171;540;427;1437;598;1977
431162;201408;472;1270;231;777;31;130;37;106;68;236
431164;201408;148;404;44;166;17;68;1;4;18;72
431170;201408;997;2909;768;2456;268;883;224;717;492;1600
431171;201408;930;2776;798;2505;289;953;211;638;500;1591
431173;201408;513;1534;470;1459;110;348;277;868;387;1216
431175;201408;1346;3753;1160;3473;381;1196;477;1429;858;2625
431177;201408;1102;3543;924;3180;316;1212;398;1337;714;2549
431179;201408;251;562;84;254;18;65;26;62;44;127
431180;201408;2257;6637;1666;5312;389;1338;435;1315;824;2653
431190;201408;815;2247;463;1524;116;424;135;424;251;848
431198;201408;394;1291;344;1187;161;595;75;250;236;845
431200;201408;342;968;107;355;24;86;10;29;34;115
431205;201408;374;1196;236;825;54;189;92;315;146;504
431210;201408;827;2316;715;2096;191;564;379;1121;570;1685
431213;201408;314;975;261;873;81;303;94;302;175;605
431215;201408;346;1028;177;603;35;117;18;51;53;168
431217;201408;248;751;191;617;63;216;50;172;113;388
431220;201408;1208;3158;859;2475;134;444;442;1208;576;1652
431225;201408;1425;4232;1233;3899;298;988;675;2164;973;3152
431230;201408;995;2946;774;2480;129;453;417;1313;546;1766
431235;201408;76;183;36;110;9;30;12;35;21;65
431237;201408;461;1506;407;1429;114;458;192;652;306;1110
431238;201408;55;175;45;150;10;36;15;49;25;85
431240;201408;2886;8803;2462;8066;891;3152;746;2385;1637;5537
431242;201408;440;1423;417;1378;176;631;64;200;240;831
431244;201408;506;1237;347;971;74;246;162;418;236;664
431245;201408;1205;3293;982;2893;185;575;613;1817;798;2392
431247;201408;239;750;190;651;77;291;69;218;146;509
431250;201408;1963;6186;1744;5862;544;1970;757;2602;1301;4572
431260;201408;423;1237;289;964;80;307;72;221;152;528
431261;201408;225;790;191;710;38;152;63;235;101;387
431262;201408;400;1105;163;552;29;124;66;219;95;343
431265;201408;1442;3884;827;2560;200;706;235;613;435;1319
431267;201408;204;614;171;551;48;172;78;235;126;407
431270;201408;2749;7380;2116;6396;598;1905;956;2967;1554;4872
431275;201408;249;797;151;546;45;162;30;94;75;256
431280;201408;272;768;116;396;23;92;24;63;47;155
431290;201408;370;1211;289;996;83;333;70;226;153;559
431295;201408;230;737;138;471;24;90;37;111;61;201
431300;201408;276;787;91;352;27;107;5;21;32;128
431301;201408;255;832;174;619;46;168;40;126;86;294
431303;201408;798;2149;530;1592;127;450;185;514;312;964
431306;201408;2205;6231;1710;5296;328;1205;600;1681;928;2886
431308;201408;57;196;53;185;35;120;14;52;49;172
431310;201408;821;2536;535;1882;121;448;191;686;312;1134
431320;201408;974;2875;611;2121;173;673;161;526;334;1199
431330;201408;2510;6427;1233;3954;370;1296;196;598;566;1894
431333;201408;457;1222;214;650;41;137;70;181;111;318
431335;201408;100;297;84;260;20;59;32;96;52;155
431337;201408;2705;8365;2072;6946;569;1992;538;1761;1107;3753
431339;201408;684;1940;506;1543;112;354;237;719;349;1073
431340;201408;28725;77279;20882;63562;5307;17774;7259;21508;12566;39282
431342;201408;654;1715;551;1540;160;479;292;784;452;1263
431344;201408;408;1119;302;931;32;102;191;602;223;704
431346;201408;345;911;195;577;59;173;54;163;113;336
431349;201408;660;1915;467;1466;106;341;155;479;261;820
431350;201408;4175;12511;3642;11573;718;2609;2081;6403;2799;9012
431360;201408;841;2271;634;1930;169;542;254;788;423;1330
431365;201408;1498;4545;1294;4196;477;1657;514;1689;991;3346
431370;201408;5732;16528;4769;14849;1428;4753;1851;5817;3279;10570
431380;201408;1127;3439;1058;3288;184;617;726;2216;910;2833
431390;201408;3811;10816;2585;8411;803;2950;767;2301;1570;5251
431395;201408;1686;5049;1486;4710;444;1489;612;1947;1056;3436
431400;201408;214;696;141;530;45;180;16;43;61;223
431402;201408;1346;3313;817;2356;173;520;397;1113;570;1633
431403;201408;333;1004;252;856;84;309;63;221;147;530
431405;201408;4864;13944;3898;12481;936;3483;1881;5776;2817;9259
431406;201408;829;2618;650;2183;210;722;277;919;487;1641
431407;201408;694;2079;470;1578;143;493;115;360;258;853
431410;201408;17546;54227;13876;46836;5108;18342;3510;12360;8618;30702
431413;201408;215;531;106;329;12;42;45;132;57;174
431415;201408;969;2786;786;2434;197;656;361;1064;558;1720
431417;201408;717;1831;576;1618;103;297;315;915;418;1212
431420;201408;1660;4615;1459;4285;345;1053;801;2438;1146;3491
431430;201408;616;1695;451;1402;114;388;165;480;279;868
431440;201408;33841;99151;30015;92813;9791;31136;13518;43773;23309;74909
431442;201408;216;691;171;579;63;235;24;60;87;295
431445;201408;544;1497;355;1085;68;219;144;424;212;643
431446;201408;522;1536;383;1242;95;318;167;545;262;863
431447;201408;863;2465;616;1903;139;458;268;844;407;1302
431449;201408;961;2729;780;2413;125;428;432;1361;557;1789
431450;201408;2366;6212;2162;5895;480;1375;1408;3811;1888;5186
431455;201408;714;1834;412;1186;128;374;118;322;246;696
431460;201408;3763;10647;3242;9630;995;3025;1203;3681;2198;6706
431470;201408;1933;5725;1540;4851;423;1318;667;2200;1090;3518
431475;201408;187;549;54;212;9;39;6;20;15;59
431477;201408;746;2044;518;1585;88;295;291;864;379;1159
431478;201408;253;670;102;310;22;67;39;113;61;180
431480;201408;2973;8548;2323;7343;705;2468;880;2659;1585;5127
431490;201408;118237;333207;103761;311271;17777;60440;69245;204125;87022;264565
431500;201408;1216;3194;965;2719;271;749;379;1092;650;1841
431505;201408;435;1172;374;1080;42;117;293;861;335;978
431507;201408;468;1150;370;968;70;179;230;609;300;788
431510;201408;2274;6304;1883;5600;392;1290;947;2706;1339;3996
431513;201408;268;739;122;398;27;92;58;191;85;283
431514;201408;111;290;42;141;6;22;4;14;10;36
431515;201408;790;2365;563;1786;118;421;238;671;356;1092
431517;201408;96;316;89;299;40;142;25;72;65;214
431520;201408;499;1508;322;1065;69;249;84;271;153;520
431530;201408;4806;11700;3695;10409;1099;3122;1828;5449;2927;8571
431531;201408;311;888;219;702;59;200;85;277;144;477
431532;201408;586;1661;515;1515;160;510;211;607;371;1117
431535;201408;410;1214;281;881;67;231;82;235;149;466
431540;201408;2289;7366;2041;7004;296;943;1347;4948;1643;5891
431545;201408;218;602;64;226;7;27;13;57;20;84
431550;201408;2558;7699;2350;7316;545;1919;1189;3634;1734;5553
431555;201408;823;2157;706;1975;163;451;388;1097;551;1548
431560;201408;25587;79269;21266;70405;8249;27708;6828;23733;15077;51441
431570;201408;5846;16648;5233;15697;1579;4827;2816;8560;4395;13387
431575;201408;495;1329;350;1072;69;245;112;316;181;561
431580;201408;819;2530;608;2034;177;667;199;599;376;1266
431590;201408;1034;2896;708;2215;106;344;330;1031;436;1375
431595;201408;646;1824;521;1542;131;404;195;576;326;980
431600;201408;2397;7083;1762;5750;476;1779;363;1019;839;2798
431610;201408;1787;5053;1314;4171;308;1035;641;2038;949;3073
431620;201408;445;1376;263;863;78;275;110;329;188;604
431630;201408;1529;4128;1111;3276;296;894;518;1545;814;2439
431640;201408;6437;19085;5819;18083;1425;4881;3308;10133;4733;15014
431642;201408;570;1646;473;1455;78;276;254;751;332;1027
431643;201408;231;619;198;559;29;92;118;312;147;404
431645;201408;1883;5651;1705;5327;390;1269;959;3044;1349;4313
431647;201408;188;538;133;407;42;132;34;88;76;220
431650;201408;267;843;185;666;38;150;42;133;80;283
431660;201408;1602;4734;1162;3813;365;1254;417;1311;782;2565
431670;201408;1460;4060;1163;3516;325;1083;513;1496;838;2579
431673;201408;253;743;157;531;45;169;42;137;87;306
431675;201408;495;1433;238;815;62;220;60;176;122;396
431680;201408;11002;30645;8403;26014;2538;8407;2924;9138;5462;17545
431690;201408;27470;78716;22307;70511;6849;23139;9237;29727;16086;52866
431695;201408;160;545;116;429;29;112;29;79;58;191
431697;201408;529;1502;469;1390;137;412;210;645;347;1057
431700;201408;1717;4849;1461;4351;280;908;785;2286;1065;3194
431710;201408;13593;39983;11179;35757;3493;11711;4184;13829;7677;25540
431720;201408;7560;21402;6173;18734;1426;4833;3071;9135;4497;13968
431725;201408;35;123;33;119;13;48;12;43;25;91
431730;201408;4041;12407;3270;10927;959;3520;1075;3667;2034;7187
431740;201408;6236;18256;5401;16673;1975;6561;1501;4437;3476;10998
431750;201408;10933;31243;9372;28674;2050;6772;4935;15397;6985;22169
431755;201408;309;828;75;271;15;64;15;50;30;114
431760;201408;4294;12966;3554;11527;996;3516;1162;3608;2158;7124
431770;201408;2437;6657;2049;6032;498;1548;1103;3212;1601;4760
431775;201408;249;690;182;562;75;245;44;119;119;364
431780;201408;2441;6567;1841;5434;529;1679;539;1512;1068;3191
431790;201408;1297;4097;1141;3803;283;996;604;2017;887;3013
431795;201408;501;1481;391;1233;81;278;194;615;275;893
431800;201408;10035;29739;8353;26540;2819;9647;2424;7567;5243;17214
431805;201408;318;769;88;299;13;52;17;54;30;106
431810;201408;3736;10399;3042;8959;654;2059;1442;4195;2096;6254
431820;201408;2979;9424;2607;8675;742;2666;1008;3280;1750;5946
431830;201408;12250;31376;9876;27717;3156;9490;3894;11108;7050;20598
431840;201408;3709;11089;3260;10235;985;3189;1480;4745;2465;7934
431842;201408;782;2006;403;1223;78;263;131;371;209;634
431843;201408;378;1104;334;1029;66;218;191;582;257;800
431844;201408;172;516;132;438;39;150;42;129;81;279
431845;201408;556;1684;506;1577;58;188;339;1069;397;1257
431846;201408;546;1626;469;1487;92;335;276;873;368;1208
431848;201408;202;555;109;368;23;92;23;73;46;165
431849;201408;422;1046;113;341;26;85;32;82;58;167
431850;201408;5201;15312;4578;14081;1113;3707;2163;6549;3276;10256
431860;201408;1009;2814;781;2406;161;571;419;1222;580;1793
431861;201408;100;305;60;208;13;42;8;23;21;65
431862;201408;514;1735;415;1511;147;575;100;347;247;922
431870;201408;27362;77659;22718;69259;6289;20936;9665;28703;15954;49639
431880;201408;5127;16115;4224;14045;1214;4413;1731;5599;2945;10012
431890;201408;6426;17883;5248;15776;1930;6061;1733;5353;3663;11414
431900;201408;1051;3099;788;2626;235;885;298;893;533;1778
431910;201408;1025;2443;489;1421;105;341;187;494;292;835
431912;201408;644;1866;503;1583;168;509;171;570;339;1079
431915;201408;1462;3990;1093;3318;284;934;433;1315;717;2249
431920;201408;1575;4417;1435;4218;194;523;1109;3358;1303;3881
431930;201408;1381;3813;1058;3290;170;499;630;2093;800;2592
431935;201408;123;448;111;423;47;205;32;99;79;304
431936;201408;498;1434;429;1290;70;201;260;851;330;1052
431937;201408;360;968;212;651;58;196;43;116;101;312
431940;201408;2893;7945;1914;6006;521;1738;550;1699;1071;3437
431950;201408;2008;6398;1795;6010;506;1848;743;2376;1249;4224
431960;201408;3840;11387;3505;10734;1076;3469;1278;3936;2354;7405
431970;201408;524;1443;272;889;44;167;83;256;127;423
431971;201408;142;409;118;374;31;104;52;156;83;260
431973;201408;513;1767;453;1642;67;244;273;1038;340;1282
431975;201408;25;86;16;65;4;21;4;16;8;37
431980;201408;1617;4713;1412;4273;375;1257;547;1549;922;2806
431990;201408;9070;25283;7055;21958;1580;5636;2881;8505;4461;14141
432000;201408;11702;34258;9529;30392;3057;10246;4016;12824;7073;23070
432010;201408;2696;7936;2284;7151;554;1948;1081;3276;1635;5224
432020;201408;2491;6223;2019;5609;301;913;1367;3777;1668;4690
432023;201408;575;1673;401;1284;107;381;146;437;253;818
432026;201408;1295;3981;1044;3441;217;743;540;1782;757;2525
432030;201408;450;1333;366;1149;95;306;163;493;258;799
432032;201408;588;1552;393;1183;71;248;213;608;284;856
432035;201408;909;2881;810;2689;182;627;482;1593;664;2220
432040;201408;1043;2645;576;1873;151;549;144;375;295;924
432045;201408;253;788;174;629;49;186;66;247;115;433
432050;201408;825;2391;731;2215;145;460;420;1301;565;1761
432055;201408;875;2707;740;2418;161;584;436;1373;597;1957
432057;201408;485;1262;378;1062;51;162;238;626;289;788
432060;201408;484;1375;207;726;56;220;52;163;108;383
432065;201408;250;729;193;623;48;169;90;269;138;438
432067;201408;1086;3503;803;2842;217;798;385;1357;602;2155
432070;201408;2710;7335;1958;5843;601;2027;639;1796;1240;3823
432080;201408;4466;13058;3884;11990;1225;3977;1606;4899;2831;8876
432085;201408;301;934;240;821;70;280;107;351;177;631
432090;201408;1856;5745;1565;5108;589;2068;495;1448;1084;3516
432100;201408;1310;3864;726;2500;196;708;132;380;328;1088
432110;201408;3216;9700;2551;8286;845;3010;488;1501;1333;4511
432120;201408;5669;17136;4888;15676;1805;6172;1643;5269;3448;11441
432130;201408;2459;7083;2054;6536;633;2215;1002;3177;1635;5392
432132;201408;435;1369;261;926;51;192;95;300;146;492
432135;201408;810;2457;768;2385;123;406;537;1659;660;2065
432140;201408;3002;8864;2441;7824;689;2270;981;3445;1670;5715
432143;201408;1472;4443;1269;4106;301;1002;717;2389;1018;3391
432145;201408;1198;3807;815;2896;268;1043;163;516;431;1559
432146;201408;287;905;208;710;73;262;53;173;126;435
432147;201408;844;2671;677;2302;198;687;273;947;471;1634
432149;201408;383;1141;246;810;70;247;93;295;163;542
432150;201408;4108;11939;3139;10089;1008;3528;1012;3127;2020;6655
432160;201408;4930;15975;4403;15064;1509;5403;1793;6410;3302;11813
432162;201408;353;882;99;328;27;96;25;71;52;167
432163;201408;397;1040;107;340;16;50;23;77;39;127
432166;201408;836;2511;682;2185;143;523;328;979;471;1502
432170;201408;937;3103;641;2432;146;588;139;499;285;1087
432180;201408;3016;8038;2115;6490;636;2098;653;1958;1289;4056
432183;201408;470;1522;395;1363;174;618;95;328;269;946
432185;201408;1000;2774;633;2062;145;536;253;800;398;1336
432190;201408;3772;10449;2745;8175;777;2410;857;2399;1634;4809
432195;201408;1381;3886;1205;3622;208;674;768;2292;976;2966
432200;201408;3445;10580;2790;9408;757;2749;1334;4605;2091;7354
432210;201408;499;1431;396;1264;107;400;189;556;296;956
432215;201408;934;2912;818;2715;148;463;508;1789;656;2252
432218;201408;334;924;254;769;50;165;114;316;164;481
432220;201408;4139;11136;3445;10003;451;1536;2246;6410;2697;7946
432225;201408;68;227;58;207;27;103;13;44;40;147
432230;201408;1251;3530;876;2702;261;884;340;933;601;1817
432232;201408;603;1784;475;1532;116;422;225;711;341;1133
432234;201408;565;1565;412;1203;104;310;175;488;279;798
432235;201408;80;249;48;171;15;66;8;28;23;94
432237;201408;518;1446;469;1367;34;135;369;1043;403;1178
432240;201408;16348;54016;14267;51195;3132;12384;8580;31482;11712;43866
432250;201408;5835;20335;5442;19554;2331;9021;1564;5678;3895;14699
432252;201408;512;1505;420;1331;135;455;185;593;320;1048
432253;201408;1349;4411;995;3494;320;1151;312;1109;632;2260
432254;201408;730;2000;221;719;52;185;37;105;89;290
432255;201408;224;570;128;421;40;143;40;125;80;268
432260;201408;7721;19711;5425;15865;1331;4088;2401;7138;3732;11226
432270;201408;2891;8897;2501;8210;769;2573;1107;3710;1876;6283
432280;201408;1368;3987;796;2687;180;669;192;581;372;1250
432285;201408;177;563;71;244;24;89;12;32;36;121
432290;201408;625;1893;415;1400;97;355;158;513;255;868
432300;201408;25425;77725;23020;73557;5753;19563;12650;40401;18403;59964
432310;201408;1028;3176;880;2910;196;725;464;1496;660;2221
432320;201408;290;804;177;572;51;164;58;193;109;357
432330;201408;293;809;111;386;17;58;14;40;31;98
432335;201408;210;614;92;322;25;94;12;36;37;130
432340;201408;339;876;167;518;41;134;54;162;95;296
432345;201408;784;2230;725;2136;162;555;401;1108;563;1663
432350;201408;505;1410;320;1051;85;297;87;266;172;563
432360;201408;128;381;37;134;14;58;13;42;27;100
432370;201408;502;1427;396;1213;41;123;248;782;289;905
432375;201408;920;2359;730;2043;125;363;436;1239;561;1602
432377;201408;93;313;43;139;8;34;14;34;22;68
432380;201408;952;3313;860;3133;333;1362;344;1182;677;2544
500020;201408;2122;6551;1563;5443;427;1720;533;1716;960;3436
500025;201408;1076;2706;693;2035;123;380;356;1017;479;1397
500060;201408;6572;19348;5323;17347;778;2551;3550;12026;4328;14577
500070;201408;4258;12596;3614;11476;878;3149;1691;5292;2569;8441
500080;201408;1813;5384;1365;4572;456;1662;448;1554;904;3216
500085;201408;2189;5886;1638;5028;211;727;1009;2992;1220;3719
500090;201408;2501;7302;1912;6230;427;1437;957;3210;1384;4647
500100;201408;2610;7910;2426;7616;778;2776;1138;3405;1916;6181
500110;201408;8434;24832;6941;22559;1142;4000;4068;13913;5210;17913
500124;201408;1975;6366;1694;5895;311;1039;1016;3833;1327;4872
500150;201408;1597;4122;1216;3495;293;960;569;1505;862;2465
500190;201408;5181;13667;4088;12319;916;2965;2327;7268;3243;10233
500200;201408;2783;7118;2029;5946;378;1267;1183;3365;1561;4632
500210;201408;5083;15154;4357;14025;1021;3495;2249;7383;3270;10878
500215;201408;1635;5103;1353;4546;274;1044;577;1837;851;2881
500220;201408;2897;9157;2366;8170;584;2159;911;3229;1495;5388
500230;201408;2777;7301;2146;6343;661;2097;882;2644;1543;4741
500240;201408;5137;15902;3795;13186;766;2868;1570;5784;2336;8652
500260;201408;2657;7174;2112;6280;407;1336;1052;2951;1459;4287
500270;201408;116109;303937;77397;237202;22036;73232;20696;63254;42732;136486
500280;201408;1443;4142;1232;3849;181;592;856;2743;1037;3335
500290;201408;4257;10722;2731;8215;790;2740;893;2440;1683;5180
500295;201408;2676;8194;1860;6191;452;1690;507;1484;959;3174
500310;201408;873;2334;753;2153;182;565;361;992;543;1557
500315;201408;3226;10154;2768;9483;541;1823;1767;6370;2308;8193
500320;201408;14781;49117;12814;45481;4156;15494;4981;18755;9137;34249
500325;201408;4361;11555;3305;9854;867;2845;1585;4608;2452;7453
500330;201408;6303;17357;4903;14722;1271;4108;2299;6814;3570;10922
500345;201408;2620;7510;2152;6730;521;1831;1112;3365;1633;5196
500348;201408;2624;7567;2342;7096;256;885;1738;5238;1994;6123
500350;201408;1257;3845;811;2833;134;504;250;890;384;1394
500370;201408;24503;76513;19153;66042;5041;19283;6705;23214;11746;42497
500375;201408;2899;7934;2112;6461;532;1778;880;2741;1412;4519
500380;201408;3078;8895;2580;7978;918;2987;819;2487;1737;5474
500390;201408;627;1351;410;1046;48;153;293;705;341;858
500400;201408;1406;4412;1101;3663;298;1099;339;1038;637;2137
500410;201408;2219;6245;1786;5601;467;1629;844;2615;1311;4244
500430;201408;2850;8321;2293;7514;556;1982;1038;3517;1594;5499
500440;201408;1498;4222;1172;3690;272;948;600;1848;872;2796
500450;201408;2234;6981;1763;6021;470;1800;374;1142;844;2942
500460;201408;3909;11702;3048;10269;924;3429;911;3061;1835;6490
500470;201408;2994;8940;2121;7004;602;2151;363;1090;965;3241
500480;201408;2044;6585;1895;6363;196;655;1513;5230;1709;5885
500490;201408;1120;3189;924;2844;287;979;324;1006;611;1985
500500;201408;3712;11544;2971;10394;1117;4374;971;3376;2088;7750
500510;201408;937;2495;608;1922;129;477;253;716;382;1193
500515;201408;2018;5352;1610;4805;273;789;1005;3244;1278;4033
500520;201408;2934;10151;2628;9722;531;2092;1652;6301;2183;8393
500525;201408;1251;3998;1027;3552;233;854;520;1887;753;2741
500540;201408;5824;16651;3573;12178;1121;4384;701;2178;1822;6562
500560;201408;4916;16194;4410;15443;865;3213;2975;10546;3840;13759
500568;201408;4071;10622;3033;9087;720;2262;1545;4671;2265;6933
500570;201408;8093;22409;5705;18081;1734;5910;2022;6382;3756;12292
500580;201408;3613;10567;2891;9299;417;1458;1921;6189;2338;7647
500600;201408;3425;9537;2525;7929;655;2241;1027;3226;1682;5467
500620;201408;8221;23162;6017;19322;1320;4735;2997;9635;4317;14370
500625;201408;720;2185;464;1621;109;415;150;494;259;909
500627;201408;462;1341;349;1119;76;253;104;354;180;607
500630;201408;6365;17873;5077;15950;1683;5796;1683;5258;3366;11054
500635;201408;2569;9945;2159;9281;335;1341;1360;6414;1695;7755
500640;201408;1658;4098;1317;3611;136;426;963;2600;1099;3026
500660;201408;17843;52686;14351;46696;3921;14386;6038;19411;9959;33797
500690;201408;3084;8817;2512;8100;882;2897;1008;3513;1890;6410
500710;201408;3926;11833;3425;10999;845;2966;1740;5573;2585;8539
500720;201408;6074;16598;3989;12793;1203;4217;1158;3614;2361;7831
500730;201408;1036;2979;791;2491;180;623;322;980;502;1603
500740;201408;3829;10788;2803;8923;602;2182;1304;3966;1906;6148
500750;201408;881;2578;805;2479;179;573;504;1598;683;2171
500755;201408;1293;3804;960;3146;240;883;341;1015;581;1898
500769;201408;4951;13446;3205;9841;718;2437;916;2482;1634;4919
500770;201408;1789;5347;1377;4550;423;1526;481;1591;904;3117
500780;201408;1118;3499;970;3211;292;1066;424;1335;716;2401
500790;201408;9106;25793;7615;23133;1484;5266;4218;12266;5702;17532
500793;201408;2398;6977;1920;6182;356;1285;956;2962;1312;4247
500795;201408;2529;7467;2207;6996;305;828;1631;5515;1936;6343
500797;201408;972;2647;733;2251;156;507;337;1035;493;1542
500800;201408;2723;7689;2157;6877;800;2860;765;2475;1565;5335
500830;201408;17162;50049;12618;40813;3675;12826;3946;12381;7621;25207
500840;201408;1450;4173;1077;3433;212;728;503;1578;715;2306
510010;201408;1387;4251;1213;3956;388;1309;554;1846;942;3155
510020;201408;3165;9224;2168;7225;608;2160;640;2036;1248;4196
510025;201408;9477;28491;8152;26189;2381;8449;3540;11048;5921;19497
510030;201408;2176;5932;1818;5387;552;1714;805;2358;1357;4072
510035;201408;919;2726;766;2487;147;487;451;1523;598;2010
510040;201408;1791;5012;1415;4455;312;1104;737;2319;1049;3423
510050;201408;1887;5574;1390;4631;379;1381;527;1714;906;3095
510060;201408;1363;4009;1025;3353;269;947;362;1149;631;2096
510080;201408;1150;3598;935;3203;300;1162;268;828;568;1990
510100;201408;683;1842;466;1407;84;275;192;537;276;812
510120;201408;305;634;177;474;19;55;118;314;137;369
510125;201408;3200;8521;2526;7355;493;1751;1227;3382;1720;5133
510130;201408;2166;6011;1844;5497;540;1689;787;2388;1327;4077
510140;201408;2967;9702;2460;8904;987;3913;652;2205;1639;6118
510160;201408;1355;4554;1264;4436;118;476;1030;3608;1148;4084
510170;201408;6152;19003;5180;17223;1185;4348;2545;8232;3730;12580
510180;201408;11879;32242;8712;27077;2631;8607;3187;10791;5818;19398
510185;201408;1366;4231;1189;3988;207;668;816;2929;1023;3597
510190;201408;2001;6356;1454;5442;388;1599;590;2297;978;3896
510250;201408;14431;45246;12457;42427;3687;13411;6098;21275;9785;34686
510260;201408;2580;9962;2323;9396;744;3195;977;4178;1721;7373
510263;201408;4560;12607;3381;10628;959;3265;1147;3485;2106;6750
510267;201408;5464;15871;3935;12565;945;3277;1321;4052;2266;7329
510268;201408;899;2643;768;2456;205;707;405;1295;610;2002
510269;201408;887;2774;757;2541;225;784;342;1196;567;1980
510270;201408;2594;8164;2320;7676;409;1432;1335;4543;1744;5975
510279;201408;2103;6715;1891;6321;644;2390;695;2145;1339;4535
510285;201408;1494;4488;1204;3954;335;1211;453;1398;788;2609
510300;201408;3318;10075;2889;9469;345;1241;2197;7252;2542;8493
510305;201408;1661;5286;1356;4697;413;1547;402;1378;815;2925
510310;201408;1115;3241;883;2859;306;1075;302;944;608;2019
510320;201408;3728;11019;2869;9297;868;3238;599;1729;1467;4967
510325;201408;5490;17680;4780;16666;790;2769;3491;12522;4281;15291
510330;201408;2858;9397;2442;8612;645;2502;977;3488;1622;5990
510335;201408;4595;14500;4000;13702;688;2312;2804;10053;3492;12365
510336;201408;603;1872;504;1672;119;430;248;815;367;1245
510337;201408;2319;7696;1984;7035;813;2900;575;2231;1388;5131
510340;201408;66021;193064;52304;171861;20568;73628;12158;41846;32726;115474
510343;201408;1154;3472;1037;3311;130;410;818;2670;948;3080
510345;201408;1702;5103;1428;4600;374;1322;526;1589;900;2911
510350;201408;3608;10350;2923;9410;781;2696;1449;4764;2230;7460
510360;201408;1980;5144;1404;4425;252;878;935;2879;1187;3757
510370;201408;1015;3611;912;3446;236;915;525;2038;761;2953
510380;201408;493;1592;381;1366;152;602;68;226;220;828
510385;201408;990;3661;776;3135;152;644;360;1558;512;2202
510390;201408;1204;3695;1109;3586;293;818;676;2409;969;3227
510395;201408;909;2287;672;1975;122;381;379;1182;501;1563
510410;201408;4333;14263;4029;13670;1092;3933;2124;7291;3216;11224
510420;201408;2388;6269;1792;5261;267;938;973;2822;1240;3760
510450;201408;594;1655;448;1442;117;427;188;582;305;1009
510452;201408;645;2114;462;1673;120;481;173;594;293;1075
510454;201408;879;2815;771;2644;156;555;485;1722;641;2277
510455;201408;1014;3102;766;2606;192;756;264;857;456;1613
510460;201408;2193;6169;1852;5692;320;1138;1215;3643;1535;4781
510480;201408;4437;12072;3282;9865;907;2883;921;2631;1828;5514
510490;201408;1494;4928;1339;4694;295;1196;806;2752;1101;3948
510500;201408;1463;4465;1070;3705;283;1135;472;1567;755;2702
510510;201408;3150;11193;2792;10573;1044;4233;1089;4112;2133;8345
510515;201408;5899;18404;4655;15656;1165;4353;1339;4282;2504;8635
510517;201408;1887;5626;1639;5245;506;1612;843;2842;1349;4454
510520;201408;2301;5804;1731;5014;133;455;1226;3587;1359;4042
510523;201408;1107;3351;947;3077;187;647;575;1885;762;2532
510525;201408;8108;21143;5401;16858;1353;4547;2044;6346;3397;10893
510530;201408;580;1653;502;1536;90;334;283;846;373;1180
510550;201408;2796;9250;2397;8543;715;2649;1034;3765;1749;6414
510558;201408;2185;6324;1756;5689;483;1677;841;2720;1324;4397
510560;201408;1722;5607;1235;4728;407;1669;333;1304;740;2973
510562;201408;5394;16436;4638;14950;1560;5517;1578;5115;3138;10632
510590;201408;3188;8605;2564;7798;695;2171;1280;4020;1975;6191
510600;201408;1503;3910;999;3080;194;663;443;1253;637;1916
510610;201408;2907;8547;2550;8055;241;870;2016;6367;2257;7237
510615;201408;2121;6794;1866;6375;575;2114;891;3046;1466;5160
510617;201408;658;1966;552;1778;72;229;412;1378;484;1607
510618;201408;1390;4088;1009;3335;255;993;453;1447;708;2440
510619;201408;783;2169;506;1646;100;368;138;434;238;802
510620;201408;1411;3613;822;2695;251;954;193;581;444;1535
510621;201408;1069;3759;947;3498;277;1120;317;1104;594;2224
510622;201408;3801;11711;2590;8973;748;2812;426;1266;1174;4078
510623;201408;3856;11122;3170;9951;973;3226;1348;4209;2321;7435
510624;201408;1355;4153;1011;3492;252;983;381;1207;633;2190
510625;201408;2343;6942;1889;6123;580;2064;495;1526;1075;3590
510626;201408;1362;4193;1067;3739;336;1291;520;1842;856;3133
510627;201408;725;2188;567;1894;179;652;182;619;361;1271
510628;201408;1610;4139;1228;3614;142;465;886;2597;1028;3062
510629;201408;1796;5852;1490;5172;466;1779;484;1607;950;3386
510630;201408;2584;8751;2107;7827;655;2726;538;2013;1193;4739
510631;201408;409;1190;367;1124;68;207;249;768;317;975
510637;201408;2859;8529;2536;7979;699;2380;1309;4059;2008;6439
510642;201408;4943;16169;4226;15191;1272;4879;2068;7736;3340;12615
510645;201408;935;2186;636;1786;205;593;229;683;434;1276
510650;201408;6185;20986;5707;20395;1230;4562;3706;13851;4936;18413
510665;201408;1322;3632;903;2862;270;911;293;894;563;1805
510670;201408;378;895;213;652;43;156;88;255;131;411
510675;201408;6881;22172;5627;19687;1889;7341;1449;4852;3338;12193
510677;201408;2571;6558;1913;5694;291;873;1357;4214;1648;5087
510680;201408;852;2648;701;2365;164;609;280;888;444;1497
510682;201408;2473;7715;1965;6776;543;2061;629;2129;1172;4190
510685;201408;997;2681;846;2481;104;344;614;1782;718;2126
510700;201408;4157;11328;3050;9622;676;2282;1718;5507;2394;7789
510704;201408;8951;24928;7360;22242;1804;6073;3793;11171;5597;17244
510706;201408;1944;5981;1465;5211;411;1498;721;2619;1132;4117
510710;201408;3752;10669;2863;8881;854;2861;900;2509;1754;5370
510715;201408;696;1795;468;1418;120;398;183;520;303;918
510718;201408;1858;5398;1546;5020;599;1981;665;2240;1264;4221
510719;201408;463;1064;284;828;39;153;128;340;167;493
510720;201408;1312;3088;982;2700;97;264;771;2167;868;2431
510724;201408;853;2619;720;2365;169;625;379;1189;548;1814
510726;201408;680;1857;554;1642;157;475;204;581;361;1056
510729;201408;795;2101;568;1734;144;480;256;787;400;1267
510730;201408;2430;7628;2137;7076;552;2062;1037;3276;1589;5338
510735;201408;1103;3775;909;3453;257;1020;453;1745;710;2765
510740;201408;1148;2847;860;2435;222;616;467;1376;689;1992
510757;201408;718;2466;634;2302;177;669;316;1150;493;1819
510760;201408;29975;83865;23168;72162;7879;26288;7876;24543;15755;50831
510770;201408;4583;12278;4132;11755;646;1780;2686;8589;3332;10369
510774;201408;442;1208;371;1092;87;295;182;538;269;833
510775;201408;853;2428;682;2159;249;857;252;782;501;1639
510776;201408;462;1316;386;1184;100;346;187;552;287;898
510777;201408;1617;4782;1209;4226;220;876;836;2912;1056;3788
510779;201408;677;2006;501;1685;98;358;208;726;306;1084
510780;201408;4072;12009;3466;11128;815;2705;1854;6216;2669;8921
510785;201408;1977;5858;1591;5203;532;1836;592;1963;1124;3799
510787;201408;2322;7103;1979;6530;684;2437;748;2367;1432;4804
510788;201408;421;1226;347;1104;152;464;112;388;264;852
510790;201408;16060;47236;10920;37303;3198;12441;1481;4945;4679;17386
510792;201408;6433;20306;4615;16600;1160;4790;1028;3416;2188;8206
510794;201408;1397;4334;1108;3867;484;1815;277;881;761;2696
510795;201408;9937;31519;7649;26918;2492;9481;2067;7363;4559;16844
510800;201408;1892;5407;1594;5023;476;1662;771;2316;1247;3978
510805;201408;2031;5685;1659;5153;195;642;1245;3897;1440;4539
510810;201408;711;1740;557;1531;156;458;279;739;435;1197
510820;201408;864;2119;626;1765;148;493;262;675;410;1168
510830;201408;601;2040;527;1916;158;613;268;1035;426;1648
510835;201408;720;2198;536;1840;173;643;185;581;358;1224
510840;201408;53268;134105;42776;120763;10490;30990;22896;66954;33386;97944
510850;201408;1725;5076;1350;4463;535;1990;257;701;792;2691
510860;201408;2575;8574;2044;7402;729;2881;324;1097;1053;3978
510880;201408;846;2851;737;2652;245;930;312;1151;557;2081
510885;201408;581;1660;449;1465;81;306;210;676;291;982
510890;201408;933;3099;797;2850;276;1125;237;756;513;1881
510895;201408;1192;3788;1034;3480;300;1160;427;1343;727;2503
520005;201408;1322;4289;1220;4131;384;1360;597;2059;981;3419
520010;201408;1921;6646;1697;6178;714;2882;380;1257;1094;4139
520013;201408;4059;11331;3072;9558;784;2580;1347;4219;2131;6799
520015;201408;573;1597;463;1432;115;372;196;626;311;998
520017;201408;1287;3980;1110;3693;321;1153;457;1471;778;2624
520020;201408;426;1158;331;1005;87;270;154;489;241;759
520025;201408;24753;79500;23972;78573;2878;9866;19645;64789;22523;74655
520030;201408;4843;15535;4238;14555;1240;4559;1886;6579;3126;11138
520050;201408;350;1058;320;995;61;210;213;643;274;853
520055;201408;815;2425;681;2180;143;456;365;1211;508;1667
520060;201408;1677;5229;1473;4830;361;1294;607;2029;968;3323
520080;201408;1705;5220;1484;4893;376;1226;803;2782;1179;4008
520082;201408;687;2222;640;2142;143;451;394;1363;537;1814
520085;201408;1042;3281;916;3003;231;798;336;1099;567;1897
520090;201408;1027;2436;781;2109;173;415;424;1227;597;1642
520110;201408;42777;127879;33590;113989;13345;49981;8825;30285;22170;80266
520120;201408;264;697;155;502;41;151;36;121;77;272
520130;201408;3870;11356;3573;10911;737;2391;2244;6871;2981;9262
520140;201408;44734;148496;39800;138831;14599;54977;11061;38301;25660;93278
520145;201408;552;1431;409;1224;98;316;170;502;268;818
520150;201408;669;1798;551;1659;153;502;290;859;443;1361
520160;201408;915;2692;776;2482;259;870;300;970;559;1840
520170;201408;4317;10348;3459;9418;516;1459;2579;7205;3095;8664
520180;201408;1934;5827;1621;5308;418;1561;681;2159;1099;3720
520215;201408;1921;4989;1629;4567;264;764;1026;2924;1290;3688
520235;201408;849;2295;662;2027;198;662;285;849;483;1511
520250;201408;1248;3997;1082;3730;328;1217;523;1836;851;3053
520260;201408;792;2073;561;1647;96;321;267;752;363;1073
520280;201408;588;1726;540;1655;269;879;141;472;410;1351
520310;201408;1110;2775;865;2438;205;537;455;1423;660;1960
520320;201408;1722;5481;1408;4860;181;669;884;3132;1065;3801
520330;201408;2911;9126;2247;7939;725;2802;477;1587;1202;4389
520340;201408;1981;5023;1557;4517;204;517;1192;3620;1396;4137
520350;201408;3275;9715;2777;8755;890;3050;1279;3906;2169;6956
520355;201408;1211;4166;1132;4040;410;1558;486;1716;896;3274
520357;201408;911;2501;766;2283;80;261;537;1591;617;1852
520360;201408;641;1821;568;1695;129;391;284;873;413;1264
520380;201408;1279;3522;898;2794;186;635;419;1302;605;1937
520390;201408;1222;3267;866;2778;290;1070;326;954;616;2024
520393;201408;585;1549;520;1446;87;249;346;969;433;1218
520396;201408;757;2435;663;2243;93;351;456;1566;549;1917
520400;201408;1773;5026;1515;4683;279;942;963;2972;1242;3914
520410;201408;1636;4317;1271;3828;351;1145;654;1964;1005;3109
520420;201408;352;986;253;791;62;210;80;221;142;431
520425;201408;1496;4168;1363;3940;417;1285;682;1938;1099;3223
520430;201408;2151;5707;1477;4455;322;1079;604;1741;926;2820
520440;201408;3650;9712;2651;8035;936;3101;768;2306;1704;5407
520450;201408;10228;29345;7576;24322;2113;7452;1335;3969;3448;11421
520455;201408;717;2152;582;1922;219;783;179;594;398;1377
520460;201408;909;2631;730;2329;180;644;329;1014;509;1658
520465;201408;861;2357;748;2212;170;600;386;1084;556;1684
520470;201408;1786;5823;1627;5577;342;1174;1074;3846;1416;5020
520480;201408;1024;2987;842;2700;192;648;479;1540;671;2188
520485;201408;1277;4239;1149;4012;385;1425;585;2052;970;3477
520490;201408;4487;13872;3564;12444;1239;4607;1440;5134;2679;9741
520495;201408;1444;3871;1172;3538;93;287;999;3058;1092;3345
520500;201408;2078;5576;1850;5264;595;1777;836;2551;1431;4328
520505;201408;908;2588;788;2409;193;609;475;1488;668;2097
520510;201408;11475;32485;7826;26312;2515;9182;2056;6986;4571;16168
520520;201408;1093;3167;917;2920;328;1104;375;1207;703;2311
520530;201408;2401;7481;2055;6917;504;1659;1013;3776;1517;5435
520540;201408;3060;9371;2626;8621;839;2896;1011;3347;1850;6243
520545;201408;1349;4175;1154;3790;348;1229;364;1164;712;2393
520547;201408;848;2698;707;2452;276;1026;212;694;488;1720
520549;201408;9683;28740;8073;26722;2576;8943;3840;12962;6416;21905
520551;201408;3883;11765;3708;11553;1050;3453;2172;6947;3222;10400
520552;201408;741;2433;716;2395;124;456;490;1633;614;2089
520570;201408;594;1723;450;1494;201;712;116;385;317;1097
520580;201408;2411;6674;1871;5908;687;2363;656;2051;1343;4414
520590;201408;1555;4395;1265;3912;341;1109;435;1291;776;2400
520620;201408;7252;23356;6588;22362;1391;5081;4097;14049;5488;19130
520630;201408;719;2010;594;1834;137;435;316;981;453;1416
520640;201408;2910;8410;2501;7743;810;2621;1052;3377;1862;5998
520650;201408;885;2500;725;2178;246;787;313;939;559;1726
520660;201408;408;1246;346;1147;117;409;111;364;228;773
520670;201408;821;2565;783;2504;66;177;674;2203;740;2380
520680;201408;638;1883;548;1759;175;604;232;747;407;1351
520690;201408;336;890;239;749;33;103;127;417;160;520
520710;201408;503;1292;325;947;11;36;198;571;209;607
520725;201408;1853;4822;1445;4227;338;1081;809;2357;1147;3438
520735;201408;749;2212;580;1890;189;669;192;604;381;1273
520740;201408;1755;5099;1475;4712;385;1314;721;2284;1106;3598
520750;201408;768;2024;576;1758;148;485;313;985;461;1470
520753;201408;1310;3770;1229;3645;167;447;910;2852;1077;3299
520760;201408;1197;3317;1034;3103;285;906;608;1840;893;2746
520780;201408;2112;5208;1760;4730;232;563;1327;3668;1559;4231
520790;201408;2763;7563;2357;6984;353;1023;1669;5125;2022;6148
520800;201408;17985;52873;15985;50487;3664;11267;9776;33326;13440;44593
520810;201408;981;2674;872;2539;143;421;651;1964;794;2385
520815;201408;504;1696;390;1454;189;800;30;91;219;891
520830;201408;1712;4378;1340;3989;55;127;1217;3717;1272;3844
520840;201408;1752;5872;1566;5518;527;1947;570;2076;1097;4023
520850;201408;827;2443;647;2181;195;704;286;943;481;1647
520860;201408;7271;20682;5416;18158;1506;5475;2499;8600;4005;14075
520870;201408;111104;304618;75544;241447;22426;78711;20442;63076;42868;141787
520880;201408;6981;19869;4955;16647;1472;5568;789;2533;2261;8101
520890;201408;4051;11717;3451;10705;763;2510;1806;5616;2569;8126
520910;201408;3547;10837;2721;9116;866;3146;643;2076;1509;5222
520915;201408;939;2709;709;2266;166;568;297;921;463;1489
520920;201408;3509;9341;2415;7576;644;2152;728;2380;1372;4532
520929;201408;481;1378;423;1310;127;395;222;701;349;1096
520940;201408;1027;3079;901;2886;113;410;659;2082;772;2492
520945;201408;705;1738;583;1546;185;457;274;747;459;1204
520960;201408;915;2677;748;2414;136;452;429;1414;565;1866
520970;201408;3467;10270;2852;9157;701;2471;1114;3514;1815;5985
520980;201408;1008;2770;920;2650;266;861;531;1471;797;2332
520990;201408;3728;11592;3394;10988;729;2496;1821;6432;2550;8928
520993;201408;1219;3330;982;2938;130;430;634;1888;764;2318
520995;201408;2663;7342;2391;6981;366;1085;1733;5109;2099;6194
521000;201408;8071;24430;6877;22382;1754;6317;3186;10257;4940;16574
521010;201408;4058;12590;3431;11388;965;3418;1357;4571;2322;7989
521015;201408;726;2021;609;1834;136;400;347;1082;483;1482
521020;201408;3806;10939;2738;8699;869;3004;518;1425;1387;4429
521030;201408;814;2162;701;1998;146;439;432;1247;578;1686
521040;201408;5649;16580;5146;15806;1806;5587;2599;8378;4405;13965
521056;201408;990;3059;842;2810;292;1021;354;1228;646;2249
521060;201408;1147;3228;1001;2996;276;778;430;1337;706;2115
521080;201408;1269;3134;818;2383;178;618;301;726;479;1344
521090;201408;3340;9738;2823;9039;984;3327;1110;3664;2094;6991
521100;201408;1476;3831;1328;3664;250;674;928;2651;1178;3325
521120;201408;5007;14244;4437;13362;1209;3695;2283;7054;3492;10749
521130;201408;1148;3241;913;2804;196;699;481;1461;677;2160
521140;201408;1002;3282;877;3009;308;1126;234;795;542;1921
521150;201408;13203;34616;8509;25404;2980;9627;2457;7206;5437;16833
521160;201408;790;2026;527;1491;96;300;277;742;373;1042
521170;201408;1400;3395;1161;3071;320;794;666;1802;986;2596
521180;201408;6687;22436;6056;21244;2218;8272;1868;6548;4086;14820
521190;201408;9490;28096;6870;23376;2248;8153;2086;7083;4334;15236
521200;201408;875;2316;791;2193;122;360;529;1460;651;1820
521205;201408;572;1720;460;1514;61;223;264;878;325;1101
521210;201408;921;2658;658;2135;253;927;230;664;483;1591
521220;201408;3954;11170;3274;10230;1067;3573;1358;4215;2425;7788
521225;201408;410;1031;325;924;48;144;213;632;261;776
521230;201408;1389;4387;1279;4153;457;1571;603;1909;1060;3480
521250;201408;27429;90693;25590;87847;10081;36640;10097;35461;20178;72101
521260;201408;825;2019;658;1728;115;379;383;939;498;1318
521270;201408;1862;5813;1708;5570;174;457;1318;4536;1492;4993
521280;201408;1901;5889;1600;5330;500;1783;613;2029;1113;3812
521290;201408;542;1566;398;1326;124;486;143;447;267;933
521295;201408;1162;3185;1054;3040;143;412;850;2481;993;2893
521300;201408;1883;5523;1738;5293;385;1138;1087;3449;1472;4587
521305;201408;871;2346;726;2143;148;414;457;1415;605;1829
521308;201408;5252;15543;4101;13494;917;3238;2055;6699;2972;9937
521310;201408;7770;23684;6139;20521;2037;7209;1579;5084;3616;12293
521340;201408;272;821;246;782;43;156;151;464;194;620
521350;201408;2230;5788;1837;5257;256;752;1224;3724;1480;4476
521370;201408;1026;3298;926;3111;326;1180;315;1000;641;2180
521375;201408;1415;4139;1208;3769;319;1086;608;1842;927;2928
521377;201408;1091;3040;1042;2982;103;250;887;2623;990;2873
521380;201408;4752;13405;3453;11029;766;2649;723;2354;1489;5003
521385;201408;623;1734;550;1635;167;523;269;794;436;1317
521390;201408;1123;2953;829;2540;250;862;288;860;538;1722
521400;201408;2422;6603;2082;6201;337;1113;1545;4571;1882;5684
521405;201408;1404;4056;1143;3574;399;1361;474;1472;873;2833
521410;201408;799;2527;730;2408;280;903;309;1073;589;1976
521440;201408;1511;4215;1489;4187;123;310;1306;3769;1429;4079
521450;201408;5161;15727;4309;14158;1355;4736;1273;4122;2628;8858
521460;201408;7366;22649;6736;21652;1761;6138;3574;11371;5335;17509
521470;201408;762;2146;567;1769;157;554;107;318;264;872
521480;201408;519;1516;383;1268;118;396;124;407;242;803
521483;201408;3175;8455;2560;7385;762;2320;1018;2861;1780;5181
521486;201408;1737;4781;1556;4468;293;917;1084;3073;1377;3990
521487;201408;640;1667;456;1375;88;250;214;695;302;945
521490;201408;856;2450;681;2196;87;334;489;1578;576;1912
521500;201408;1396;4436;1140;3892;224;863;528;1681;752;2544
521520;201408;970;2274;834;2098;275;619;373;1050;648;1669
521523;201408;11622;43424;10837;41996;3877;16197;2232;9373;6109;25570
521525;201408;1134;2956;997;2774;146;466;685;1846;831;2312
521530;201408;2091;6256;1424;4882;527;1911;290;943;817;2854
521540;201408;992;2712;682;2163;182;687;214;623;396;1310
521550;201408;1000;2558;887;2390;255;749;459;1182;714;1931
521560;201408;5007;15404;4040;14112;1612;6081;1276;4438;2888;10519
521565;201408;713;1857;608;1725;107;282;417;1226;524;1508
521570;201408;4802;13526;3426;10775;1087;3572;1133;3613;2220;7185
521580;201408;692;1659;490;1380;174;533;164;457;338;990
521590;201408;756;2126;616;1892;224;710;128;416;352;1126
521600;201408;630;1645;451;1342;116;372;158;420;274;792
521630;201408;1813;4877;1494;4386;551;1851;274;655;825;2506
521640;201408;2063;5656;1698;5118;565;1922;600;1831;1165;3753
521645;201408;664;1999;551;1738;106;363;274;813;380;1176
521680;201408;1494;4771;1262;4279;677;2427;218;702;895;3129
521690;201408;597;1768;535;1651;129;465;264;757;393;1222
521710;201408;2370;7436;2047;6769;458;1599;1041;3450;1499;5049
521720;201408;2175;6339;1952;6032;507;1558;1209;3815;1716;5373
521730;201408;3994;13339;3655;12656;1570;5959;1024;3286;2594;9245
521740;201408;3809;10401;3011;9385;1261;4093;1215;3978;2476;8071
521760;201408;12570;42906;11658;41407;2326;9167;7193;25717;9519;34884
521770;201408;2867;8658;2417;7775;1018;3484;694;2135;1712;5619
521800;201408;9063;26503;7627;24300;2549;8581;3290;10860;5839;19441
521805;201408;999;2305;780;1977;215;480;429;1214;644;1694
521810;201408;832;2408;716;2224;176;603;371;1121;547;1724
521830;201408;5500;18547;5141;17992;1086;4102;3329;11645;4415;15747
521839;201408;733;2102;571;1789;132;473;211;624;343;1097
521850;201408;7119;20145;6007;18166;1474;4506;2868;8693;4342;13199
521860;201408;1876;5571;1602;5063;422;1459;606;1845;1028;3304
521870;201408;564;1979;516;1851;172;671;145;487;317;1158
521878;201408;665;2105;523;1788;151;580;209;677;360;1257
521880;201408;26538;70223;18097;56259;6065;19987;5626;17804;11691;37791
521890;201408;3793;11714;3130;10410;1187;4245;808;2648;1995;6893
521900;201408;1683;4523;1374;4101;369;1174;560;1591;929;2765
521910;201408;1252;3470;1090;3281;270;850;621;1944;891;2794
521920;201408;408;1232;363;1157;123;420;145;436;268;856
521925;201408;656;2023;583;1876;123;441;250;745;373;1186
521930;201408;4051;13096;3630;12276;1260;4542;1085;3672;2345;8214
521935;201408;667;2003;627;1924;174;563;341;1017;515;1580
521940;201408;1157;3151;941;2785;315;966;354;1051;669;2017
521945;201408;690;2358;643;2295;129;417;448;1714;577;2131
521950;201408;587;1744;483;1569;130;460;216;707;346;1167
521960;201408;938;2757;794;2508;195;666;371;1142;566;1808
521970;201408;2523;7227;2283;6909;352;1064;1658;5157;2010;6221
521971;201408;1095;2954;825;2450;176;560;305;871;481;1431
521973;201408;930;3042;812;2796;249;915;260;855;509;1770
521975;201408;14334;40335;13478;39260;2436;7527;9256;27136;11692;34663
521980;201408;1900;5813;1777;5668;285;825;1367;4572;1652;5397
521990;201408;1145;3446;1002;3222;157;556;649;2085;806;2641
522000;201408;2191;6431;1915;6069;400;1338;1147;3754;1547;5092
522005;201408;383;996;292;851;80;237;142;417;222;654
522010;201408;3118;9260;2620;8421;959;3232;655;2078;1614;5310
522015;201408;1031;3030;854;2762;229;791;419;1376;648;2167
522020;201408;5123;13854;4379;12847;954;3020;2724;7959;3678;10979
522026;201408;724;2059;535;1860;206;790;185;646;391;1436
522028;201408;542;1621;490;1540;116;383;306;952;422;1335
522040;201408;3193;8225;2412;7230;765;2380;1145;3501;1910;5881
522045;201408;13875;45390;11661;40829;3887;14960;2690;9188;6577;24148
522050;201408;1094;3148;873;2770;274;953;352;1044;626;1997
522060;201408;2759;8480;2214;7622;630;2370;1086;3682;1716;6052
522068;201408;1604;5186;1499;5069;129;345;1252;4475;1381;4820
522070;201408;854;2566;764;2425;103;402;519;1634;622;2036
522100;201408;806;2271;718;2138;267;889;331;915;598;1804
522108;201408;959;2837;837;2655;89;293;621;2018;710;2311
522119;201408;1372;4169;1139;3855;190;656;718;2518;908;3174
522130;201408;515;1458;441;1373;134;436;234;745;368;1181
522140;201408;18365;52156;15919;48361;4965;16205;6560;19486;11525;35691
522145;201408;949;2673;880;2562;422;1298;285;817;707;2115
522150;201408;1275;3342;1056;3038;384;1179;389;1152;773;2331
522155;201408;869;2515;766;2364;171;515;475;1530;646;2045
522157;201408;712;2069;611;1910;71;241;475;1491;546;1732
522160;201408;6294;17799;4480;14638;1691;6139;691;2118;2382;8257
522170;201408;3184;8882;2644;8071;799;2454;1071;3406;1870;5860
522180;201408;478;1354;358;1169;147;523;125;416;272;939
522185;201408;15393;47386;13805;45198;3108;10878;8080;26822;11188;37700
522190;201408;982;2568;800;2265;137;391;456;1319;593;1710
522200;201408;1681;5598;1518;5252;534;1987;460;1536;994;3523
522205;201408;1337;3930;1114;3554;302;1012;524;1687;826;2699
522220;201408;1418;3893;1139;3542;283;903;564;1943;847;2846
522230;201408;1220;3657;1086;3441;159;562;740;2352;899;2914
530010;201408;259192;840596;232504;787971;72354;267420;83917;283789;156271;551209
110001;201407;4614;15084;3997;14092;1048;3804;2271;8152;3319;11956
110002;201407;14042;44412;12036;40817;3731;13648;5215;17707;8946;31355
110003;201407;992;3214;909;3064;258;902;344;1142;602;2044
110004;201407;10091;32778;8502;29448;2855;10667;2510;8680;5365;19347
110005;201407;2414;8055;2254;7750;854;3022;931;3242;1785;6264
110006;201407;3441;9254;2163;7455;732;2677;678;2208;1410;4885
110007;201407;1566;4865;1455;4705;307;1069;815;2863;1122;3932
110008;201407;2614;8908;2449;8667;459;1537;1795;6641;2254;8178
110009;201407;5475;15846;4230;13983;1146;4125;1930;6256;3076;10381
110010;201407;8607;24803;7541;23457;1570;4536;4758;16011;6328;20547
110011;201407;11080;34021;9163;30698;3303;11618;3556;11945;6859;23563
110012;201407;17316;53426;14991;48967;5028;17167;5713;18707;10741;35874
110013;201407;5558;17480;4534;15918;1449;5293;2019;7265;3468;12558
110014;201407;4547;13376;3815;12305;814;2731;2335;7661;3149;10392
110015;201407;5564;17505;4401;15422;1536;5831;1534;5388;3070;11219
110018;201407;5347;15621;4333;14295;1354;4986;1997;6356;3351;11342
110020;201407;59812;173414;49092;159662;10747;36159;29039;97121;39786;133280
110025;201407;4676;13595;3875;12173;647;2164;2695;8449;3342;10613
110026;201407;860;2467;722;2302;189;615;444;1436;633;2051
110028;201407;7978;23381;5931;19895;1848;6781;1501;4937;3349;11718
110029;201407;1736;5089;1392;4501;437;1464;635;2094;1072;3558
110030;201407;11941;34188;9737;31330;2494;8551;5347;17864;7841;26415
110032;201407;4290;13867;3814;12814;1200;4180;1497;5025;2697;9205
110033;201407;5653;18170;5253;17546;1573;5145;2739;9774;4312;14919
110034;201407;3970;10372;3316;9576;577;1593;2478;7292;3055;8885
110037;201407;2167;7303;1869;6743;475;1745;1036;3791;1511;5536
110040;201407;3663;11817;3355;11263;1006;3637;1632;5429;2638;9066
110045;201407;5461;18398;4933;17757;1465;5594;2800;10106;4265;15700
110050;201407;1862;5939;1558;5532;496;1783;857;3122;1353;4905
110060;201407;1017;3501;903;3293;265;1038;463;1691;728;2729
110070;201407;2048;6989;1981;6843;339;1196;1412;4928;1751;6124
110080;201407;3785;11902;3600;11680;405;1208;3042;10093;3447;11301
110090;201407;971;2839;772;2523;232;878;346;1027;578;1905
110092;201407;1746;5652;1590;5451;347;1186;978;3534;1325;4720
110094;201407;3373;10438;3085;10026;740;2491;1918;6364;2658;8855
110100;201407;2706;8517;2327;7883;690;2458;1198;4079;1888;6537
110110;201407;1816;5798;1687;5642;703;2387;755;2618;1458;5005
110120;201407;1761;5777;1394;4932;462;1685;424;1521;886;3206
110130;201407;2843;8125;2139;7083;566;1944;1071;3590;1637;5534
110140;201407;2634;8960;2417;8596;542;1980;1501;5444;2043;7424
110143;201407;1621;5148;1248;4499;317;1193;650;2337;967;3530
110145;201407;1053;3171;920;2964;160;560;620;2002;780;2562
110146;201407;478;1520;437;1457;98;341;256;866;354;1207
110147;201407;917;2716;721;2395;211;771;269;806;480;1577
110148;201407;1394;4159;1071;3497;333;1163;366;1161;699;2324
110149;201407;3870;11291;3020;10003;793;2677;1779;6046;2572;8723
110150;201407;2979;8674;2449;7896;303;1058;1666;5484;1969;6542
110155;201407;972;3186;910;3044;281;992;474;1566;755;2558
110160;201407;2233;6977;1817;6231;568;2003;876;3025;1444;5028
110170;201407;3265;9369;2504;8043;548;1847;1496;4820;2044;6667
110175;201407;1754;5502;1346;4967;169;673;945;3548;1114;4221
110180;201407;1723;5315;1462;4897;338;1172;890;3008;1228;4180
120001;201407;2968;10475;2853;10281;634;2442;1777;6485;2411;8927
120005;201407;1601;6358;1557;6277;164;606;1243;5207;1407;5813
120010;201407;4622;16320;4420;15973;855;2990;3033;11379;3888;14369
120013;201407;1921;7516;1872;7436;422;1655;1204;5033;1626;6688
120017;201407;2185;7772;2062;7541;570;2077;1019;4086;1589;6163
120020;201407;14741;64371;14410;63684;2349;9834;10573;48929;12922;58763
120025;201407;2834;9811;2753;9685;610;2263;1733;6189;2343;8452
120030;201407;6269;24796;6160;24660;462;1718;5357;21884;5819;23602
120032;201407;1407;6725;1353;6593;189;1056;985;4856;1174;5912
120033;201407;3689;14141;3660;14089;196;753;3304;12898;3500;13651
120034;201407;1897;7754;1852;7680;138;708;1607;6590;1745;7298
120035;201407;2819;13503;2785;13424;243;1122;2358;11701;2601;12823
120038;201407;3229;11798;3101;11529;828;3151;1759;6712;2587;9863
120039;201407;1560;8206;1529;8130;186;1021;1225;6609;1411;7630
120040;201407;47317;169951;43267;161711;12380;48567;21385;81936;33765;130503
120042;201407;2860;12366;2722;12032;372;1754;1992;8978;2364;10732
120043;201407;863;4116;837;4061;62;267;714;3577;776;3844
120045;201407;4574;15828;4520;15744;919;3197;3319;11785;4238;14982
120050;201407;8274;34084;7948;33367;1334;5355;5464;24220;6798;29575
120060;201407;7429;33585;7310;33359;678;3104;6123;28620;6801;31724
120070;201407;2881;10820;2809;10649;540;1949;1897;7493;2437;9442
120080;201407;3815;14377;3652;14108;572;2169;2729;10912;3301;13081
130002;201407;2918;12364;2752;12081;257;1179;2233;9977;2490;11156
130006;201407;1808;7763;1626;7422;275;1389;1112;5134;1387;6523
130008;201407;2040;8303;1949;8139;174;753;1585;6739;1759;7492
130010;201407;2808;9425;2455;9014;207;707;2102;7898;2309;8605
130014;201407;3536;11361;3052;10631;501;1861;2026;7159;2527;9020
130020;201407;2604;9210;2595;9199;34;120;2549;9053;2583;9173
130030;201407;7091;27683;6861;27377;588;2019;5874;24189;6462;26208
130040;201407;3627;11324;3320;10913;276;1011;2827;9325;3103;10336
130050;201407;5997;24004;5315;22930;707;2895;3857;17738;4564;20633
130060;201407;5936;26367;5587;25849;585;2703;4541;21497;5126;24200
130063;201407;3363;14968;3332;14906;301;1261;2854;13106;3155;14367
130068;201407;3072;13013;2827;12534;388;1908;1967;8809;2355;10717
130070;201407;6773;22415;6151;21614;632;2214;4908;17690;5540;19904
130080;201407;5119;22779;4919;22487;889;4152;3400;16122;4289;20274
130083;201407;2098;8322;1980;8139;303;1431;1424;5847;1727;7278
130090;201407;2566;9233;2447;9073;181;754;2118;7873;2299;8627
130100;201407;5548;20998;5332;20705;379;1610;4617;18102;4996;19712
130110;201407;6903;22096;6444;21550;632;1923;5362;18519;5994;20442
130115;201407;4100;14771;3931;14548;95;296;3753;13996;3848;14292
130120;201407;13783;52602;13224;51850;1155;4108;11210;45386;12365;49494
130130;201407;3613;15220;3510;15035;390;1717;2836;12372;3226;14089
130140;201407;6217;24312;6145;24227;156;416;5939;23701;6095;24117
130150;201407;3503;13263;3428;13168;225;984;3033;11670;3258;12654
130160;201407;3939;16335;3859;16227;247;939;3509;14964;3756;15903
130165;201407;2821;11585;2729;11431;387;1680;2148;9120;2535;10800
130170;201407;9151;33175;8038;31767;1205;4790;5948;24380;7153;29170
130180;201407;3399;10952;3321;10844;110;354;3083;10112;3193;10466
130185;201407;9947;33903;9285;33133;1169;3825;7440;27689;8609;31514
130190;201407;17995;62081;15884;59400;3125;11434;10501;41365;13626;52799
130195;201407;1841;7718;1783;7633;112;466;1572;6851;1684;7317
130200;201407;1989;7194;1842;6950;432;1677;1145;4425;1577;6102
130210;201407;1188;4708;1124;4597;132;560;900;3754;1032;4314
130220;201407;2025;8335;1862;8037;356;1700;1114;4885;1470;6585
130230;201407;3482;15702;3289;15384;375;1742;2506;12250;2881;13992
130240;201407;8476;32496;7820;31528;500;2243;6696;27423;7196;29666
130250;201407;18299;65564;17516;64488;2331;7958;13625;52369;15956;60327
130255;201407;4103;14502;3883;14140;146;445;3535;13152;3681;13597
130260;201407;259027;840787;233692;799992;65203;229564;122183;431401;187386;660965
130270;201407;7461;30828;6739;29693;1004;4404;4948;22724;5952;27128
130280;201407;3309;12981;3236;12875;164;496;2930;11999;3094;12495
130290;201407;10727;38052;10559;37815;223;516;10065;36678;10288;37194
130300;201407;4517;17379;4229;16944;390;1712;3433;13913;3823;15625
130310;201407;5142;19296;4711;18757;474;1849;3817;15609;4291;17458
130320;201407;2957;10256;2692;9900;361;1351;1969;7440;2330;8791
130330;201407;3711;13476;3331;12957;216;957;2843;11188;3059;12145
130340;201407;18023;69165;17404;68206;3526;12913;11647;48772;15173;61685
130350;201407;3296;13380;3160;13217;313;1360;2609;11143;2922;12503
130353;201407;6067;18675;5288;17617;1284;4183;3202;11415;4486;15598
130356;201407;4617;16588;4428;16303;462;1417;3636;14074;4098;15491
130360;201407;2961;8175;2628;7798;48;89;2484;7556;2532;7645
130370;201407;5061;19876;4345;18911;264;1333;3657;16105;3921;17438
130380;201407;6820;28985;6587;28621;496;2283;5622;24746;6118;27029
130390;201407;4785;21383;4467;20816;487;2380;3424;16424;3911;18804
130395;201407;2076;7501;1859;7063;277;1103;1219;4686;1496;5789
130400;201407;2126;7899;2055;7797;165;670;1786;6843;1951;7513
130406;201407;9849;37558;8798;35941;1980;8051;5410;23186;7390;31237
130410;201407;4110;15710;3778;15102;986;4159;2035;8404;3021;12563
130420;201407;10178;43077;9805;42405;2841;11937;5791;26404;8632;38341
130423;201407;3208;12492;3034;12252;277;1277;2544;10325;2821;11602
130426;201407;2095;8990;2014;8846;351;1489;1425;6570;1776;8059
130430;201407;3593;12783;3394;12505;500;1914;2416;9120;2916;11034
130440;201407;4051;14162;3750;13831;213;656;3381;12823;3594;13479
140002;201407;1638;5220;1532;5078;175;570;1159;3955;1334;4525
140005;201407;2814;8417;2655;8245;122;309;2458;7751;2580;8060
140010;201407;45144;145939;40609;138491;9606;34830;22496;78392;32102;113222
140015;201407;2831;9290;2714;9134;314;810;2204;7801;2518;8611
140017;201407;3123;9800;2907;9527;237;682;2429;8211;2666;8893
140020;201407;4476;15288;4169;14879;397;1315;3423;12574;3820;13889
140023;201407;2097;7181;1901;6870;253;939;1379;5093;1632;6032
140028;201407;2194;6095;2136;6028;83;149;1981;5742;2064;5891
140030;201407;3626;11585;3466;11385;396;1000;2927;10033;3323;11033
140040;201407;1487;7156;1438;7015;141;751;1079;5388;1220;6139
140045;201407;2519;9105;2346;8856;424;1423;1612;6589;2036;8012
140047;201407;5532;15456;5017;14754;1504;4520;2527;7863;4031;12383
140050;201407;1521;4686;1393;4510;190;649;1000;3285;1190;3934
140060;201407;1452;4578;1312;4366;276;942;850;2911;1126;3853
140070;201407;1474;7336;1458;7286;64;339;1334;6698;1398;7037
150010;201407;33767;107865;32201;105770;2287;7801;27346;91102;29633;98903
150013;201407;1651;5020;1561;4914;148;461;1280;4081;1428;4542
150020;201407;12168;40982;11854;40532;1092;3660;10088;35026;11180;38686
150030;201407;6401;27896;6215;27599;593;2273;5236;24179;5829;26452
150034;201407;4494;12270;4230;11944;232;571;3839;11004;4071;11575
150040;201407;12725;43081;11147;41131;2345;7956;7458;29702;9803;37658
150050;201407;6109;23382;5957;23103;615;2540;4846;18994;5461;21534
150060;201407;16575;54423;15627;52992;3312;10871;10392;36561;13704;47432
150070;201407;5773;23910;5207;23268;430;2006;4476;20288;4906;22294
150080;201407;63041;172069;55524;162350;8034;21948;39840;120558;47874;142506
150085;201407;5064;17935;4827;17590;556;1739;3924;14906;4480;16645
150090;201407;10112;39138;9541;38347;984;3879;7742;31840;8726;35719
150095;201407;5265;18040;4875;17447;450;1541;3958;14591;4408;16132
150100;201407;3580;13308;3348;12949;277;1279;2724;10478;3001;11757
150110;201407;3230;15580;3218;15549;185;793;2946;14458;3131;15251
150120;201407;6023;23559;5892;23309;823;3185;4596;18507;5419;21692
150125;201407;818;2523;759;2434;152;524;504;1599;656;2123
150130;201407;21223;66256;19986;64484;1863;5887;16086;53021;17949;58908
150140;201407;154656;459202;148983;452098;17098;50985;122300;376631;139398;427616
150145;201407;4910;15492;4553;15044;652;2241;3433;11500;4085;13741
150150;201407;10054;32992;9452;32026;1793;6292;6398;21982;8191;28274
150157;201407;3009;9317;2695;8872;386;1354;2033;6762;2419;8116
150160;201407;2949;9817;2777;9564;658;2212;1741;6239;2399;8451
150170;201407;22106;82212;20956;80607;3872;14841;15032;58766;18904;73607
150172;201407;3110;10836;2797;10348;377;1425;2139;8079;2516;9504
150175;201407;2085;6390;2002;6295;160;410;1727;5667;1887;6077
150178;201407;10898;33763;9284;31841;740;2357;7929;27848;8669;30205
150180;201407;18070;73171;17438;72271;1594;7039;14491;60848;16085;67887
150190;201407;7212;23266;6783;22665;436;1014;5857;20426;6293;21440
150195;201407;4769;16638;4458;16108;397;1464;3686;13485;4083;14949
150200;201407;5157;16728;4983;16517;152;475;4648;15594;4800;16069
150210;201407;22670;87507;22246;86877;2074;7559;18795;75281;20869;82840
150215;201407;6229;20228;5603;19264;1485;5365;2932;10269;4417;15634
150220;201407;12697;40659;11525;38814;2609;9015;6569;22668;9178;31683
150230;201407;11123;38040;10049;36500;889;3840;8040;29122;8929;32962
150240;201407;34808;106174;31410;100449;9849;32475;13528;44956;23377;77431
150250;201407;4150;16686;4018;16489;566;2261;3076;13111;3642;15372
150260;201407;2104;8468;2013;8290;424;1799;1241;5263;1665;7062
150270;201407;9691;29444;7515;26719;1532;5802;4860;17603;6392;23405
150275;201407;5879;21615;5565;21102;812;3094;4117;15966;4929;19060
150276;201407;2136;6439;1966;6207;348;1173;1475;4662;1823;5835
150277;201407;4985;15650;4361;14882;571;1939;3308;11635;3879;13574
150280;201407;5905;25959;5722;25538;934;4085;4164;19178;5098;23263
150285;201407;2603;10569;2556;10466;351;1441;1913;8075;2264;9516
150290;201407;9211;28334;8954;28025;824;2161;7570;24659;8394;26820
150293;201407;8922;26792;7418;24570;2374;8127;3242;11384;5616;19511
150295;201407;6929;21504;5906;20282;1201;3932;3943;14449;5144;18381
150300;201407;1797;6349;1743;6282;125;399;1467;5478;1592;5877
150304;201407;4213;13172;3645;12387;538;1848;2617;9161;3155;11009
150307;201407;6677;22681;6214;22014;481;1720;5148;18674;5629;20394
150309;201407;6869;24218;6349;23519;1558;5717;4094;15947;5652;21664
150310;201407;5201;24062;5087;23884;592;2746;4093;19723;4685;22469
150320;201407;8834;22875;8451;22465;564;1311;7462;20288;8026;21599
150330;201407;13340;48219;12671;47150;1476;5375;10008;38199;11484;43574
150340;201407;2330;7800;2178;7578;385;1389;1520;5387;1905;6776
150345;201407;6490;22644;6060;22057;629;2282;4951;18444;5580;20726
150350;201407;7251;24318;6906;23832;892;3007;5300;18639;6192;21646
150360;201407;21905;68879;19035;65197;3060;10540;13314;47269;16374;57809
150370;201407;10311;38257;9836;37611;1281;4319;7931;31628;9212;35947
150375;201407;2825;11985;2756;11891;323;1207;2298;10331;2621;11538
150380;201407;9731;29227;8671;27778;851;2886;7083;22879;7934;25765
150390;201407;8260;35553;7876;34797;1647;7007;5087;23527;6734;30534
150400;201407;5627;22830;5422;22401;617;2477;4170;17728;4787;20205
150405;201407;8442;26062;7595;25013;1401;4142;5343;18728;6744;22870
150410;201407;1732;6662;1688;6578;293;1200;1119;4453;1412;5653
150420;201407;35442;125198;31583;118769;8554;33615;16057;63044;24611;96659
150430;201407;6516;24139;6285;23729;745;3002;4871;18622;5616;21624
150440;201407;5408;18977;5231;18714;880;3047;3832;14119;4712;17166
150442;201407;21716;63147;19823;60621;3425;10693;13322;41953;16747;52646
150445;201407;5149;18266;4749;17660;614;2211;3656;13938;4270;16149
150450;201407;4346;20799;4191;20569;404;1976;3488;17514;3892;19490
150460;201407;6896;25256;5787;24075;374;1637;5097;21678;5471;23315
150470;201407;17481;53902;16914;53192;1023;2622;15309;49205;16332;51827
150475;201407;1265;4320;1168;4194;169;573;896;3362;1065;3935
150480;201407;14212;48746;13613;47845;1188;4126;11333;40734;12521;44860
150490;201407;6551;25369;6417;25180;292;1153;5839;23151;6131;24304
150495;201407;4887;17948;4777;17781;235;849;4373;16431;4608;17280
150497;201407;3295;11614;3005;11107;852;3213;1664;6344;2516;9557
150500;201407;3010;8674;2858;8448;436;1260;2130;6359;2566;7619
150503;201407;3951;12522;3415;11840;1169;4118;1735;6332;2904;10450
150506;201407;12398;44005;11422;42606;2371;8053;7811;31041;10182;39094
150510;201407;9831;38791;9171;37626;1471;6101;6414;27363;7885;33464
150520;201407;6462;25728;6375;25605;310;1023;5905;24101;6215;25124
150530;201407;11869;42190;10789;40511;1360;4897;8138;31523;9498;36420
150540;201407;4661;14461;4219;13824;341;1160;3521;11563;3862;12723
150543;201407;5346;16853;4854;16147;1143;3891;3089;10530;4232;14421
150548;201407;8544;27615;8014;26937;468;1425;7181;24552;7649;25977
150549;201407;2260;7169;2130;7017;108;250;1945;6585;2053;6835
150550;201407;21195;67968;18913;64085;5580;19438;9058;31432;14638;50870
150553;201407;22277;80697;19565;74403;7672;31027;4687;17875;12359;48902
150555;201407;1756;5432;1542;5130;212;741;1129;3799;1341;4540
150560;201407;1996;6462;1908;6266;248;849;1394;4575;1642;5424
150563;201407;2864;9516;2662;9153;625;2275;1569;5422;2194;7697
150565;201407;3541;12495;3287;12108;258;1104;2610;9738;2868;10842
150570;201407;5494;20759;5396;20588;434;1639;4541;17779;4975;19418
150580;201407;9853;40633;9664;40397;767;2689;8452;36544;9219;39233
150590;201407;5567;22523;5420;22345;122;395;5165;21554;5287;21949
150600;201407;7860;30485;7644;30150;570;2058;6654;26905;7224;28963
150610;201407;2396;8328;2207;7938;278;1109;1545;5506;1823;6615
150611;201407;2661;9676;2520;9372;262;1061;1892;7077;2154;8138
150613;201407;11730;36492;10255;34414;3293;11211;5045;17807;8338;29018
150616;201407;3100;9204;2431;8307;619;2263;1254;4229;1873;6492
150618;201407;7301;25593;7004;25034;2168;7951;3640;13409;5808;21360
150619;201407;5300;18330;4960;17835;668;2642;3622;13079;4290;15721
150620;201407;6245;22790;5691;22080;809;3049;4402;17738;5211;20787
150630;201407;5471;17114;5242;16833;408;1286;4480;14667;4888;15953
150635;201407;4491;14864;4229;14369;863;2952;2626;9227;3489;12179
150640;201407;1581;5030;1567;5008;189;571;1284;4260;1473;4831
150650;201407;12281;38184;11134;36129;3028;10120;5634;18757;8662;28877
150655;201407;5343;17878;4915;17246;633;2317;3752;13338;4385;15655
150658;201407;4366;13946;4015;13435;456;1794;2984;10099;3440;11893
150660;201407;5745;18245;5232;17566;1276;4166;3179;11131;4455;15297
150670;201407;6422;18668;5566;17622;1592;5031;3222;10800;4814;15831
150680;201407;51825;201721;48418;195491;16107;65050;22952;99219;39059;164269
150690;201407;1865;6079;1716;5824;298;973;1133;3982;1431;4955
150700;201407;5915;18537;5502;17994;1104;3591;3714;12478;4818;16069
150710;201407;4289;14097;3861;13421;449;1485;3003;10666;3452;12151
150715;201407;5022;16372;4493;15593;578;2074;3447;12137;4025;14211
150720;201407;6595;26957;6233;26308;1034;4262;4454;19634;5488;23896
150730;201407;9303;32228;8752;31490;1035;3514;7156;26403;8191;29917
150740;201407;3729;12005;3397;11411;481;1716;2289;7791;2770;9507
150745;201407;5885;18655;5442;18060;1135;3938;3700;12360;4835;16298
150746;201407;1437;4706;1366;4577;211;757;929;3135;1140;3892
150747;201407;5022;16522;4576;15937;511;1634;3531;12922;4042;14556
150750;201407;2986;10150;2881;10016;146;404;2638;9348;2784;9752
150760;201407;11386;37292;10796;36495;2533;8444;6826;23979;9359;32423
150770;201407;5726;21760;5481;21390;705;2598;4306;17701;5011;20299
150775;201407;1180;3694;1057;3471;215;850;621;1972;836;2822
150780;201407;3113;10396;3083;10364;79;186;2929;9995;3008;10181
150790;201407;5105;16481;4748;16053;405;1107;4046;14220;4451;15327
150795;201407;15615;48190;14059;45959;2528;7897;9617;32776;12145;40673
150796;201407;2870;8833;2722;8656;369;1109;2114;6957;2483;8066
150797;201407;3806;12733;3595;12420;207;758;3125;10887;3332;11645
150800;201407;14215;47873;12966;46341;2756;9182;9003;33848;11759;43030
150803;201407;6906;25030;6580;24564;873;3288;4875;18708;5748;21996
150805;201407;2780;9711;2574;9404;383;1350;1897;7136;2280;8486
150808;201407;5969;20482;5132;18919;2195;8581;1223;4624;3418;13205
150810;201407;19666;61970;16563;58156;2486;8314;11900;44053;14386;52367
150812;201407;5401;16840;4963;16190;491;2025;3767;11896;4258;13921
150815;201407;8967;28906;8069;27793;1044;3434;6383;22726;7427;26160
150820;201407;10708;31267;9763;30225;636;1334;8625;27664;9261;28998
150830;201407;12548;48479;11694;46964;713;3061;9797;40425;10510;43486
150835;201407;2067;7595;1924;7266;519;2090;932;3524;1451;5614
150840;201407;7939;22929;6374;20758;1528;5448;3490;11237;5018;16685
160005;201407;727;2740;685;2660;110;511;452;1713;562;2224
160010;201407;1544;5230;1533;5218;128;321;1362;4793;1490;5114
160015;201407;1694;6273;1654;6204;200;669;1308;5135;1508;5804
160020;201407;2304;7655;2146;7432;316;1123;1550;5524;1866;6647
160021;201407;901;3882;881;3847;166;762;622;2785;788;3547
160023;201407;1055;4135;1038;4108;74;254;922;3725;996;3979
160025;201407;1356;3874;1321;3837;18;61;1289;3740;1307;3801
160027;201407;8301;25408;7727;24770;2639;8216;4148;14158;6787;22374
160030;201407;42342;155685;38924;148659;8596;32860;24629;97039;33225;129899
160040;201407;4291;16626;4206;16504;154;695;3916;15373;4070;16068
160050;201407;3607;13410;3263;12913;1234;4728;1591;6772;2825;11500
160053;201407;2733;10665;2675;10579;589;2346;1821;7399;2410;9745
160055;201407;762;2950;748;2932;125;534;557;2195;682;2729
160060;201407;17635;59739;16649;58629;3787;12590;11386;41980;15173;54570
160070;201407;2288;9180;2226;9074;146;593;1969;8161;2115;8754
160080;201407;2707;10024;2692;9999;89;274;2559;9615;2648;9889
170025;201407;561;1915;514;1840;173;636;243;910;416;1546
170030;201407;1184;3923;1070;3708;322;1140;488;1723;810;2863
170035;201407;1554;4635;1287;4131;449;1531;429;1403;878;2934
170040;201407;1883;6239;1652;5893;300;1216;1102;3951;1402;5167
170070;201407;2108;5739;1710;5236;484;1590;889;2774;1373;4364
170100;201407;2578;7300;2271;6786;265;869;1755;5250;2020;6119
170105;201407;756;2424;621;2141;133;540;319;1047;452;1587
170110;201407;1194;3732;1042;3476;231;836;564;1865;795;2701
170130;201407;1447;4551;1263;4278;249;866;786;2759;1035;3625
170190;201407;1691;4869;1341;4333;537;1666;379;1418;916;3084
170200;201407;1613;4878;1214;4129;352;1317;403;1328;755;2645
170210;201407;30936;93890;26362;86056;8888;30885;9338;31747;18226;62632
170215;201407;1152;3655;1031;3472;126;449;782;2667;908;3116
170220;201407;6585;21985;6029;21045;1080;4021;3825;13580;4905;17601
170230;201407;1546;5056;1338;4664;323;1288;661;2228;984;3516
170240;201407;3025;8633;2406;7796;369;1324;1622;5297;1991;6621
170255;201407;3708;11845;3092;10834;928;3334;1394;5136;2322;8470
170270;201407;1057;2722;756;2300;111;379;498;1489;609;1868
170290;201407;3027;9052;2687;8638;200;521;2294;7690;2494;8211
170300;201407;2104;6588;1778;6046;286;1063;1183;4047;1469;5110
170305;201407;780;2454;648;2205;116;431;389;1343;505;1774
170307;201407;1118;3937;960;3631;211;844;491;1946;702;2790
170310;201407;1727;4755;1370;4177;333;988;692;2259;1025;3247
170320;201407;1100;3211;829;2716;209;725;382;1299;591;2024
170330;201407;860;2644;734;2487;124;453;508;1697;632;2150
170360;201407;457;1567;417;1499;109;412;172;601;281;1013
170370;201407;1446;4238;1176;3819;301;1066;536;1745;837;2811
170380;201407;2110;6651;1714;6050;357;1439;934;3271;1291;4710
170382;201407;564;1888;487;1765;114;468;284;1007;398;1475
170384;201407;1591;6534;1497;6368;366;1631;922;4001;1288;5632
170386;201407;935;2794;805;2609;211;763;412;1340;623;2103
170388;201407;651;1963;561;1813;113;428;240;767;353;1195
170389;201407;941;3141;862;3025;115;489;616;2120;731;2609
170390;201407;1366;4032;1177;3792;159;546;869;2875;1028;3421
170410;201407;490;1628;453;1558;61;252;302;1021;363;1273
170460;201407;534;1470;390;1219;108;366;134;416;242;782
170510;201407;805;2730;660;2479;122;522;349;1306;471;1828
170550;201407;5924;18155;4763;16050;1792;6574;1176;3970;2968;10544
170555;201407;1397;4102;1134;3698;293;1008;607;2000;900;3008
170560;201407;989;3373;811;3147;160;646;528;2128;688;2774
170600;201407;1356;3843;1179;3620;231;686;798;2548;1029;3234
170610;201407;1630;4927;1269;4358;163;630;796;2780;959;3410
170625;201407;439;1381;344;1191;78;285;101;354;179;639
170650;201407;1288;4119;1128;3837;285;1054;545;1889;830;2943
170700;201407;4059;13457;3402;12364;802;3185;1678;6345;2480;9530
170710;201407;1882;5575;1525;4960;242;830;963;3166;1205;3996
170720;201407;1870;4991;1600;4575;298;825;1112;3267;1410;4092
170730;201407;1118;3201;928;2921;268;926;448;1418;716;2344
170740;201407;2264;8008;2002;7544;305;1263;1380;5242;1685;6505
170755;201407;902;2826;758;2515;192;690;294;942;486;1632
170765;201407;1608;4341;1290;3828;348;1081;573;1747;921;2828
170770;201407;1841;6284;1713;6046;356;1296;1046;3778;1402;5074
170820;201407;4210;13488;3809;12854;1052;3741;1732;5988;2784;9729
170825;201407;818;2447;625;2071;149;546;253;821;402;1367
170830;201407;1396;4154;1255;3941;42;80;1133;3617;1175;3697
170900;201407;2918;10165;2780;9904;325;1158;2113;7763;2438;8921
170930;201407;4349;13239;3561;12030;1280;4572;1240;4169;2520;8741
170950;201407;13264;38349;9871;32455;3543;13086;2353;7513;5896;20599
170980;201407;536;1604;416;1403;94;351;248;824;342;1175
171050;201407;1370;4835;1282;4665;72;318;1112;4026;1184;4344
171070;201407;1743;5433;1609;5255;304;1015;1046;3515;1350;4530
171090;201407;978;2817;822;2578;84;280;611;1918;695;2198
171110;201407;667;1942;526;1712;135;482;292;929;427;1411
171150;201407;851;2536;633;2132;129;472;361;1230;490;1702
171180;201407;644;1998;485;1674;133;476;204;753;337;1229
171190;201407;1901;6884;1638;6351;399;1617;795;3212;1194;4829
171195;201407;885;3129;784;2945;139;558;430;1669;569;2227
171200;201407;702;2266;580;2041;136;550;283;935;419;1485
171215;201407;484;1435;371;1227;80;284;159;550;239;834
171240;201407;802;2752;756;2674;69;242;587;2139;656;2381
171245;201407;676;2242;569;1989;131;515;238;798;369;1313
171250;201407;1172;3386;1003;3145;92;331;778;2414;870;2745
171270;201407;440;1779;409;1716;107;412;208;958;315;1370
171280;201407;901;2835;799;2662;190;624;417;1514;607;2138
171320;201407;4188;12715;3567;11765;1038;3598;1815;6021;2853;9619
171330;201407;2902;8670;2501;8068;627;2148;1401;4560;2028;6708
171360;201407;1566;4958;1325;4601;285;1023;784;2778;1069;3801
171370;201407;785;2208;703;2083;141;465;386;1131;527;1596
171380;201407;1335;4422;1139;4039;397;1444;446;1612;843;3056
171395;201407;893;2723;723;2417;144;582;362;1190;506;1772
171420;201407;2289;6971;1831;6151;449;1598;834;2850;1283;4448
171430;201407;1053;3271;902;3034;210;706;526;1802;736;2508
171488;201407;2526;7698;2299;7376;600;1934;1272;4266;1872;6200
171500;201407;898;2765;789;2560;127;409;477;1577;604;1986
171510;201407;969;3377;873;3221;148;557;556;2133;704;2690
171515;201407;622;1774;478;1555;97;337;248;801;345;1138
171525;201407;611;2041;513;1859;98;411;292;1039;390;1450
171550;201407;351;1159;291;1040;112;433;48;179;160;612
171570;201407;1297;4006;1140;3734;202;677;780;2596;982;3273
171575;201407;2069;5902;1615;5074;383;1215;752;2484;1135;3699
171610;201407;6392;21767;5782;20594;1930;7278;2050;7312;3980;14590
171620;201407;2396;7429;2169;7086;159;593;1798;5900;1957;6493
171630;201407;911;2967;751;2689;220;854;295;1033;515;1887
171650;201407;2486;7758;2021;6903;538;1967;874;2955;1412;4922
171660;201407;2666;7336;2129;6394;392;1234;1224;3732;1616;4966
171665;201407;1463;4383;1226;4001;199;714;791;2664;990;3378
171670;201407;2390;6483;1905;5784;455;1490;1037;3069;1492;4559
171700;201407;1180;3848;1036;3586;165;642;658;2266;823;2908
171720;201407;740;2268;648;2099;209;717;295;971;504;1688
171750;201407;1345;4352;1174;4029;386;1365;445;1543;831;2908
171780;201407;1290;3511;934;3007;123;445;555;1826;678;2271
171790;201407;1738;5569;1434;5135;258;916;895;3369;1153;4285
171800;201407;735;2333;664;2231;106;379;453;1554;559;1933
171820;201407;10247;31056;9170;29710;2019;6971;5569;18311;7588;25282
171830;201407;1636;5966;1499;5671;395;1600;710;2690;1105;4290
171840;201407;828;2373;730;2238;71;212;557;1743;628;1955
171845;201407;827;2244;649;1942;101;335;385;1132;486;1467
171850;201407;1020;3636;910;3401;121;538;583;2158;704;2696
171855;201407;1281;4060;1154;3851;114;490;877;2844;991;3334
171865;201407;502;1593;419;1470;110;425;204;704;314;1129
171870;201407;696;2193;574;1976;122;451;270;974;392;1425
171875;201407;1417;4453;1200;4129;186;737;854;2913;1040;3650
171880;201407;978;3520;957;3483;119;455;719;2703;838;3158
171884;201407;943;2694;696;2314;155;585;261;912;416;1497
171886;201407;1555;5188;1339;4720;467;1747;452;1622;919;3369
171888;201407;713;2181;592;1956;88;297;374;1283;462;1580
171889;201407;494;1610;467;1556;92;302;295;1009;387;1311
171890;201407;1190;3839;1048;3636;153;593;696;2424;849;3017
171900;201407;498;1905;457;1805;139;562;216;863;355;1425
172000;201407;668;2151;564;1987;94;386;327;1139;421;1525
172010;201407;1199;4136;1127;4026;121;482;872;3136;993;3618
172015;201407;362;1376;313;1301;56;237;185;811;241;1048
172020;201407;2430;7998;2183;7627;308;1146;1551;5520;1859;6666
172025;201407;760;2211;599;1925;107;363;315;1021;422;1384
172030;201407;1131;3821;1017;3615;137;569;699;2483;836;3052
172049;201407;1221;3362;1040;3045;135;394;784;2359;919;2753
172065;201407;1317;3763;1093;3483;108;378;909;2910;1017;3288
172080;201407;2629;8096;2220;7398;283;1112;1511;4947;1794;6059
172085;201407;532;1460;411;1229;97;311;142;416;239;727
172090;201407;3550;10573;2748;9466;568;2049;1662;5913;2230;7962
172093;201407;591;1870;464;1642;132;582;228;764;360;1346
172097;201407;716;2106;594;1907;155;553;236;746;391;1299
172100;201407;28109;94299;24184;86367;8434;32858;6791;24224;15225;57082
172110;201407;1716;6258;1565;6029;177;677;1203;4787;1380;5464
172120;201407;5667;16962;4669;15687;516;1776;3505;12055;4021;13831
172125;201407;335;1015;267;910;61;232;127;436;188;668
172130;201407;545;1546;461;1418;71;230;312;1000;383;1230
172208;201407;2202;6801;2063;6576;394;1355;1203;3867;1597;5222
172210;201407;2417;7469;2228;7182;379;1331;1493;4745;1872;6076
210005;201407;21975;71471;19622;67736;5766;21160;9830;34166;15596;55326
210010;201407;1630;5819;1443;5525;152;583;1116;4392;1268;4975
210015;201407;3540;10973;3231;10507;293;663;2685;9226;2978;9889
210020;201407;7576;18666;7060;18033;463;1291;5840;15085;6303;16376
210030;201407;5943;19780;5621;19339;466;1927;4649;15916;5115;17843
210040;201407;2001;5701;1827;5496;178;556;1453;4400;1631;4956
210043;201407;6389;18875;5757;18036;518;1547;4593;14873;5111;16420
210047;201407;6798;26538;6332;25711;894;3881;4421;18223;5315;22104
210050;201407;2528;8969;2018;8203;640;2713;878;3690;1518;6403
210055;201407;1739;5959;1608;5772;200;739;1209;4381;1409;5120
210060;201407;7912;29296;7126;28039;766;3325;5306;21370;6072;24695
210070;201407;7087;21103;6639;20543;298;1003;5885;18331;6183;19334
210080;201407;3740;12906;3668;12803;85;334;3461;12119;3546;12453
210083;201407;4184;14433;3991;14217;136;424;3736;13496;3872;13920
210087;201407;2729;8368;2537;8134;170;585;2198;7103;2368;7688
210090;201407;10204;33395;9782;32712;465;1790;8555;28684;9020;30474
210095;201407;6255;23578;6079;23299;566;2184;5023;19656;5589;21840
210100;201407;7644;22805;7185;22269;343;1222;6388;19807;6731;21029
210110;201407;3260;11211;3160;11084;229;841;2672;9549;2901;10390
210120;201407;26314;75316;22434;70624;2612;8257;17110;55371;19722;63628
210125;201407;3436;11203;3295;11047;232;681;2903;9940;3135;10621
210130;201407;4096;12430;3900;12171;356;1140;3205;10062;3561;11202
210135;201407;1688;4945;1493;4661;133;416;1228;3900;1361;4316
210140;201407;18326;57846;15405;53937;3065;10897;9831;35816;12896;46713
210150;201407;4702;11918;4280;11397;124;337;3929;10452;4053;10789
210160;201407;18930;61258;17699;59442;2164;6762;13966;48445;16130;55207
210170;201407;14361;52366;14084;51996;1050;3479;12366;46727;13416;50206
210173;201407;1832;7832;1779;7727;122;588;1550;6776;1672;7364
210177;201407;3037;9714;2873;9513;300;1108;2344;7712;2644;8820
210180;201407;1546;4770;1453;4638;92;329;1231;3928;1323;4257
210190;201407;5244;16829;4898;16228;396;1727;3723;12054;4119;13781
210193;201407;1461;4668;1339;4460;104;379;1084;3668;1188;4047
210197;201407;1970;6574;1819;6407;182;560;1506;5512;1688;6072
210200;201407;9374;31312;8631;30236;1150;3748;6426;23539;7576;27287
210203;201407;6515;21706;6147;21241;434;1311;5389;19002;5823;20313
210207;201407;3096;10268;2904;9923;398;1288;2115;7453;2513;8741
210210;201407;8934;30169;8576;29670;298;1060;7598;26851;7896;27911
210215;201407;1687;6693;1634;6601;173;741;1331;5432;1504;6173
210220;201407;6377;24437;6106;24004;522;2085;4972;20016;5494;22101
210230;201407;5397;18294;5020;17699;413;1535;4107;14637;4520;16172
210232;201407;12054;41178;10551;39337;1765;6591;7379;29119;9144;35710
210235;201407;3609;11163;3245;10713;254;875;2752;9185;3006;10060
210237;201407;2529;9307;2495;9261;51;132;2397;9013;2448;9145
210240;201407;3040;9677;2894;9464;220;686;2401;7983;2621;8669
210250;201407;5115;16179;4896;15908;156;576;4548;14838;4704;15414
210255;201407;2748;8898;2508;8486;512;1823;1573;5403;2085;7226
210260;201407;5271;16852;4803;16135;680;2250;3533;12167;4213;14417
210270;201407;5372;15392;4778;14569;152;543;4244;13038;4396;13581
210275;201407;3598;9117;3357;8856;118;248;3171;8473;3289;8721
210280;201407;6060;17710;5207;16629;403;1365;4285;13824;4688;15189
210290;201407;5793;18811;5324;18229;453;1499;4422;15514;4875;17013
210300;201407;38428;113044;31803;104687;2937;10116;25071;84960;28008;95076
210310;201407;2896;8351;2742;8128;130;360;2411;7197;2541;7557
210312;201407;2209;7134;2158;7049;118;467;1929;6298;2047;6765
210315;201407;2451;8587;2332;8418;144;586;2011;7303;2155;7889
210317;201407;4354;12999;4165;12760;263;778;3693;11464;3956;12242
210320;201407;19697;62255;18424;60728;1083;3510;16177;54309;17260;57819
210325;201407;3651;11580;3276;11020;361;1289;2535;8612;2896;9901
210330;201407;34716;88605;28888;82321;3776;8398;21639;67997;25415;76395
210340;201407;12067;37299;11033;36008;1404;3844;8275;28823;9679;32667
210350;201407;10611;33143;9806;32003;832;2704;7904;26351;8736;29055
210355;201407;3980;14293;3620;13816;147;360;3304;13059;3451;13419
210360;201407;17202;52670;16025;50957;1387;4570;12791;41325;14178;45895
210370;201407;8594;22309;7547;21191;286;675;6823;19605;7109;20280
210375;201407;3259;9955;2810;9414;475;1686;1992;6796;2467;8482
210380;201407;6410;18503;5745;17558;590;1592;4662;14677;5252;16269
210390;201407;2816;9968;2592;9597;125;580;2269;8425;2394;9005
210400;201407;5068;15988;4879;15758;316;957;4300;14104;4616;15061
210405;201407;9117;25088;7376;22725;2207;6720;3485;11830;5692;18550
210407;201407;2121;7478;1887;7110;202;749;1461;5710;1663;6459
210408;201407;2230;8839;2108;8696;84;312;1907;8134;1991;8446
210409;201407;3993;14440;3780;14105;296;1142;3069;11733;3365;12875
210410;201407;3630;11693;3396;11404;299;853;2929;10128;3228;10981
210420;201407;4281;14150;3976;13618;340;1179;3245;11311;3585;12490
210430;201407;2148;6729;2090;6657;146;486;1816;5814;1962;6300
210440;201407;4330;13516;4208;13337;210;655;3776;12102;3986;12757
210450;201407;2955;9345;2668;8919;198;768;2190;7290;2388;8058
210455;201407;4274;12715;3676;11814;658;2162;2481;8168;3139;10330
210460;201407;4089;13155;3827;12803;223;831;3285;11086;3508;11917
210462;201407;1793;6430;1719;6279;174;692;1332;4945;1506;5637
210465;201407;2755;8974;2584;8761;276;795;2126;7480;2402;8275
210467;201407;6360;20958;5940;20438;494;1442;4971;17787;5465;19229
210470;201407;2042;5679;1603;5038;108;350;1268;4038;1376;4388
210480;201407;14136;47021;12488;44789;3586;12629;6814;26227;10400;38856
210490;201407;3510;10502;3226;10079;306;986;2583;8103;2889;9089
210500;201407;6844;26833;6550;26312;767;2933;5067;21162;5834;24095
210510;201407;6983;23140;6699;22799;407;912;5837;20865;6244;21777
210515;201407;3443;11325;3340;11199;148;435;3075;10460;3223;10895
210520;201407;2752;8706;2563;8431;210;670;2128;7151;2338;7821
210530;201407;42127;136513;35745;126751;10279;39242;17860;65184;28139;104426
210535;201407;3268;11478;3153;11295;179;640;2751;9979;2930;10619
210540;201407;13366;45879;11901;43538;2943;10469;6497;25777;9440;36246
210542;201407;6469;18715;5653;17818;344;873;4965;16104;5309;16977
210545;201407;2267;7570;2151;7374;99;457;1848;6317;1947;6774
210547;201407;3900;13651;3640;13246;301;1017;2948;11025;3249;12042
210550;201407;6434;18166;5596;17237;293;674;5100;16137;5393;16811
210560;201407;4264;13497;3820;12780;281;1061;3164;10568;3445;11629
210565;201407;1554;5369;1343;5055;134;600;1012;3824;1146;4424
210570;201407;12933;36919;11753;35561;1014;2495;9848;30921;10862;33416
210580;201407;3186;9681;2820;9217;375;1013;2144;7579;2519;8592
210590;201407;4459;13705;4180;13372;278;877;3638;11831;3916;12708
210592;201407;2536;8088;2454;7961;122;451;2153;6979;2275;7430
210594;201407;2806;8025;2335;7380;153;427;1938;6298;2091;6725
210596;201407;2899;10732;2736;10436;295;1191;2084;8070;2379;9261
210598;201407;2006;6218;1872;6053;116;452;1654;5306;1770;5758
210600;201407;3390;10064;3103;9658;292;962;2463;7674;2755;8636
210610;201407;2724;8708;2449;8374;209;811;2060;7030;2269;7841
210620;201407;1885;5831;1728;5630;47;140;1596;5255;1643;5395
210630;201407;3535;12920;3103;12082;510;1970;1964;7947;2474;9917
210632;201407;4822;16650;4417;16080;440;1647;3571;13165;4011;14812
210635;201407;1941;6857;1856;6730;81;281;1660;6126;1741;6407
210637;201407;2838;9585;2670;9340;158;566;2316;8210;2474;8776
210640;201407;4366;14700;4273;14597;19;56;4159;14312;4178;14368
210650;201407;6968;21271;6848;21126;144;399;6580;20445;6724;20844
210660;201407;7733;23845;7216;23051;282;807;6640;21353;6922;22160
210663;201407;2701;7912;2552;7717;167;561;2182;6632;2349;7193
210667;201407;1748;6258;1668;6137;86;378;1455;5381;1541;5759
210670;201407;4774;17723;4614;17451;453;1749;3625;14108;4078;15857
210675;201407;4879;13722;4601;13370;338;887;3957;11738;4295;12625
210680;201407;4613;12961;4113;12387;231;659;3564;10886;3795;11545
210690;201407;7091;23915;6725;23526;293;946;6127;21797;6420;22743
210700;201407;2688;7713;2383;7364;360;880;1753;6016;2113;6896
210710;201407;4947;16116;4730;15767;190;687;4176;13996;4366;14683
210720;201407;2522;9230;2380;9025;152;671;2069;7814;2221;8485
210725;201407;1195;4407;1028;4097;160;700;610;2462;770;3162
210730;201407;1248;3871;1099;3695;110;316;914;3162;1024;3478
210735;201407;3946;14327;3663;13826;605;2295;2564;10021;3169;12316
210740;201407;5175;14520;4837;14179;239;622;4483;13337;4722;13959
210745;201407;3817;11611;3586;11292;319;832;2975;9567;3294;10399
210750;201407;20380;56805;18580;54730;1982;5799;15052;45132;17034;50931
210760;201407;6069;16671;5730;16299;85;259;5552;15819;5637;16078
210770;201407;6339;17263;5363;16153;242;771;4801;14526;5043;15297
210780;201407;8727;29211;8080;28038;1008;3686;5801;20503;6809;24189
210790;201407;4814;14589;4152;13837;332;833;3527;12311;3859;13144
210800;201407;5141;14459;4669;13940;205;636;4001;12422;4206;13058
210805;201407;3753;15873;3640;15663;195;826;3138;13841;3333;14667
210810;201407;5818;17478;5243;16815;403;850;4574;15337;4977;16187
210820;201407;9129;26357;8517;25501;1571;4605;5805;17919;7376;22524
210825;201407;5585;18816;5392;18569;268;868;4807;16845;5075;17713
210830;201407;8670;26663;8298;26247;345;887;7507;24272;7852;25159
210840;201407;3830;10618;3505;10125;285;729;2795;8159;3080;8888
210845;201407;5683;17923;5470;17685;271;692;4872;16274;5143;16966
210850;201407;6245;22810;5797;22028;843;3603;4139;15802;4982;19405
210860;201407;17615;53980;16344;52285;1423;4818;13170;42564;14593;47382
210870;201407;6722;21830;6040;20976;699;2304;4645;16653;5344;18957
210880;201407;4338;14034;4224;13869;219;708;3781;12554;4000;13262
210890;201407;5436;16406;5084;15962;431;1485;4203;13258;4634;14743
210900;201407;4851;15770;4395;14984;1502;5216;1927;6930;3429;12146
210905;201407;1853;5835;1736;5680;127;324;1468;4958;1595;5282
210910;201407;10674;33607;9970;32485;1832;6380;6667;21928;8499;28308
210920;201407;3388;11397;3283;11246;175;561;2909;10156;3084;10717
210923;201407;1564;5708;1478;5580;220;836;1048;4152;1268;4988
210927;201407;4804;15075;4640;14907;33;97;4567;14720;4600;14817
210930;201407;2681;9712;2560;9555;206;924;2144;8001;2350;8925
210940;201407;2949;11583;2895;11475;307;1149;2353;9530;2660;10679
210945;201407;6056;17846;5834;17618;208;256;5560;17232;5768;17488
210950;201407;5783;17773;5045;16679;619;2123;3721;12542;4340;14665
210955;201407;1978;6531;1761;6188;306;1102;1199;4329;1505;5431
210960;201407;9429;31108;9033;30534;2216;7264;5823;20734;8039;27998
210970;201407;1398;5027;1235;4787;177;800;889;3460;1066;4260
210975;201407;1767;6072;1681;5918;170;612;1318;4718;1488;5330
210980;201407;9405;23169;9164;22898;628;1291;8175;20838;8803;22129
210990;201407;17159;49740;13698;45556;2791;9613;8728;29877;11519;39490
211000;201407;16669;53520;15063;51530;1012;3435;12929;45202;13941;48637
211003;201407;5158;18088;4716;17424;532;2069;3498;13305;4030;15374
211010;201407;6793;23235;6594;23003;144;489;6150;21740;6294;22229
211020;201407;7502;23327;7325;23041;198;484;6876;21804;7074;22288
211023;201407;2488;8355;2419;8236;168;594;2026;7046;2194;7640
211027;201407;3063;11904;2947;11722;289;1071;2350;9736;2639;10807
211030;201407;4334;13192;3897;12695;738;1920;2893;10064;3631;11984
211040;201407;4237;16241;4120;16050;158;651;3627;14429;3785;15080
211050;201407;10430;27732;10263;27541;464;1139;9530;25786;9994;26925
211060;201407;6080;21845;5954;21628;621;2125;4874;18164;5495;20289
211065;201407;1766;6064;1619;5874;58;195;1503;5538;1561;5733
211070;201407;8851;29903;8252;28883;766;2684;6602;23583;7368;26267
211080;201407;1382;4231;1133;3884;93;450;913;3046;1006;3496
211085;201407;2078;6946;1796;6550;293;1036;1282;4831;1575;5867
211090;201407;3629;11256;3409;10959;206;780;2898;9257;3104;10037
211100;201407;6900;18064;6732;17865;97;343;6414;16981;6511;17324
211102;201407;3144;11697;3011;11515;299;1079;2514;9878;2813;10957
211105;201407;2878;9178;2528;8689;219;830;2057;7077;2276;7907
211107;201407;4577;14209;4182;13682;260;799;3588;12041;3848;12840
211110;201407;6667;19977;5294;18027;897;2911;3522;12639;4419;15550
211120;201407;32954;91716;28970;86743;4239;11986;21036;65606;25275;77592
211125;201407;2225;7161;2023;6848;153;552;1668;5696;1821;6248
211130;201407;150942;444194;141555;432171;27827;84119;97377;304937;125204;389056
211140;201407;5679;18168;5350;17656;295;1048;4611;15276;4906;16324
211150;201407;10168;30575;9516;29763;703;2241;8120;25713;8823;27954
211153;201407;3181;9525;2917;9220;388;1020;2340;7761;2728;8781
211157;201407;1271;4173;1092;3898;135;568;759;2808;894;3376
211160;201407;4273;14508;3669;13490;426;1885;2639;9618;3065;11503
211163;201407;1737;5741;1646;5618;72;224;1473;5144;1545;5368
211167;201407;1532;5163;1426;4992;49;191;1296;4559;1345;4750
211170;201407;6836;18118;6577;17799;174;536;6081;16427;6255;16963
211172;201407;2449;7171;2159;6745;164;630;1787;5469;1951;6099
211174;201407;2900;8484;2640;8157;127;486;2315;7108;2442;7594
211176;201407;5700;16567;4809;15530;603;1719;3683;12451;4286;14170
211178;201407;3373;10141;3297;10056;88;195;3145;9709;3233;9904
211180;201407;4568;16031;4266;15565;406;1606;3415;12653;3821;14259
211190;201407;2877;9629;2606;9247;127;555;2246;8035;2373;8590
211195;201407;1484;4666;1269;4403;107;337;1041;3733;1148;4070
211200;201407;2193;7581;1971;7275;271;938;1458;5667;1729;6605
211210;201407;6990;21772;6764;21451;442;1411;5844;18744;6286;20155
211220;201407;36518;108569;32004;102696;6713;22088;20567;67916;27280;90004
211223;201407;6032;17362;5578;16640;830;2499;3750;11775;4580;14274
211227;201407;1618;5953;1512;5790;138;630;1199;4597;1337;5227
211230;201407;9181;30799;8396;29465;1198;4210;6021;21673;7219;25883
211240;201407;8483;28558;8174;28180;333;1165;7516;26097;7849;27262
211245;201407;5488;15904;5416;15816;178;422;5094;15064;5272;15486
211250;201407;12223;43865;11601;43143;1269;3505;9632;37902;10901;41407
211260;201407;8322;26307;8167;26090;498;1604;7309;23502;7807;25106
211270;201407;10213;36325;9605;35511;665;2682;7983;30007;8648;32689
211280;201407;12454;36934;11858;36210;1049;2520;10176;32219;11225;34739
211285;201407;2007;7032;1729;6527;410;1648;859;3389;1269;5037
211290;201407;7786;25595;7559;25303;778;2289;6223;21472;7001;23761
211300;201407;8837;27080;8046;25943;562;1883;6820;22162;7382;24045
211400;201407;12768;37142;10778;34890;2417;7572;6477;23397;8894;30969
220005;201407;1737;5108;1624;4939;65;276;1395;4112;1460;4388
220010;201407;1772;4642;1323;4067;120;444;1036;3124;1156;3568
220020;201407;3806;11636;3586;11268;603;2028;2418;7576;3021;9604
220025;201407;2226;5494;1999;5150;50;149;1767;4510;1817;4659
220027;201407;1428;3877;1319;3737;90;233;1117;3210;1207;3443
220030;201407;3478;10142;3394;10004;256;830;2887;8514;3143;9344
220040;201407;8658;26824;8230;26130;1671;5512;5187;16561;6858;22073
220045;201407;1486;4748;1342;4509;137;531;972;3212;1109;3743
220050;201407;4874;14170;4271;13287;374;1371;3397;10419;3771;11790
220060;201407;2106;5491;2007;5373;92;244;1827;4901;1919;5145
220070;201407;2641;7743;2362;7342;202;652;1842;5774;2044;6426
220080;201407;839;2601;793;2524;111;438;568;1737;679;2175
220090;201407;1895;4922;1635;4565;135;464;1339;3645;1474;4109
220095;201407;700;1954;670;1905;31;100;621;1752;652;1852
220100;201407;1420;4271;1207;3919;127;432;894;2949;1021;3381
220105;201407;2280;7481;2087;7118;212;766;1517;5197;1729;5963
220110;201407;3628;10556;3206;9941;247;933;2626;7995;2873;8928
220115;201407;2300;8374;2214;8234;266;1043;1785;6675;2051;7718
220117;201407;1434;3814;1177;3433;125;367;899;2633;1024;3000
220120;201407;13032;37367;12084;36173;419;1524;11039;33017;11458;34541
220130;201407;860;3091;761;2966;59;188;667;2673;726;2861
220140;201407;1665;4459;1515;4269;233;480;1214;3612;1447;4092
220150;201407;7313;23068;6992;22625;426;1571;6028;19493;6454;21064
220155;201407;1090;3408;912;3075;81;338;632;2077;713;2415
220157;201407;1077;2773;982;2637;45;118;837;2247;882;2365
220160;201407;2895;8669;2598;8160;204;772;2005;6236;2209;7008
220170;201407;1365;4312;1221;4071;111;442;966;3205;1077;3647
220173;201407;2122;6432;1748;5714;82;376;1411;4555;1493;4931
220177;201407;1752;5154;1721;5104;70;213;1600;4754;1670;4967
220180;201407;1178;3201;1041;2984;58;207;790;2206;848;2413
220190;201407;4801;15669;4234;14947;505;1759;3326;11959;3831;13718
220191;201407;1483;5013;1413;4886;206;726;1044;3627;1250;4353
220192;201407;1777;5090;1421;4465;167;576;983;3069;1150;3645
220194;201407;1754;5167;1588;4887;167;593;1185;3547;1352;4140
220196;201407;2095;6267;1955;6028;217;732;1485;4591;1702;5323
220198;201407;1352;3768;1086;3422;20;64;1004;3204;1024;3268
220200;201407;4708;16145;4431;15723;761;2830;3094;11061;3855;13891
220202;201407;2103;6612;1900;6248;66;271;1673;5467;1739;5738
220205;201407;2986;7825;2629;7354;99;368;2301;6353;2400;6721
220207;201407;925;2858;807;2652;85;330;612;1991;697;2321
220208;201407;1720;5896;1572;5644;249;1020;1082;3862;1331;4882
220209;201407;1603;4979;1447;4718;92;351;1115;3643;1207;3994
220210;201407;1922;5051;1675;4727;98;332;1329;3755;1427;4087
220211;201407;1665;4966;1580;4854;119;490;1310;3970;1429;4460
220213;201407;1851;5378;1725;5147;109;392;1360;3990;1469;4382
220217;201407;1821;6016;1749;5924;67;196;1608;5524;1675;5720
220220;201407;11946;34254;10965;32713;1342;3750;7838;24058;9180;27808
220225;201407;1019;3135;928;3001;45;191;796;2530;841;2721
220230;201407;6207;16291;5144;14866;227;647;4539;13192;4766;13839
220240;201407;2760;8824;2591;8531;211;780;2029;6657;2240;7437
220245;201407;1499;4082;1352;3876;77;245;1155;3334;1232;3579
220250;201407;3405;9258;3057;8789;66;171;2807;8173;2873;8344
220253;201407;1891;5600;1615;5125;141;521;1194;3823;1335;4344
220255;201407;1819;5129;1590;4745;99;388;1296;3764;1395;4152
220260;201407;5273;16925;4714;15872;465;1673;3508;11853;3973;13526
220265;201407;1251;4552;1189;4442;110;484;869;3251;979;3735
220270;201407;6926;22688;6737;22358;426;1904;5719;18545;6145;20449
220271;201407;1567;4416;1470;4273;72;199;1282;3780;1354;3979
220272;201407;1803;5569;1665;5345;109;450;1310;4166;1419;4616
220273;201407;1324;3796;1153;3525;124;405;872;2645;996;3050
220275;201407;2132;5669;1809;5251;93;290;1563;4543;1656;4833
220277;201407;2648;7160;2241;6545;158;509;1755;5157;1913;5666
220280;201407;1802;4717;1568;4372;133;482;1210;3291;1343;3773
220285;201407;1703;4621;1518;4363;102;317;1247;3676;1349;3993
220290;201407;6714;21804;5660;20436;573;2253;4348;15888;4921;18141
220300;201407;1977;6423;1739;6101;98;431;1462;5122;1560;5553
220310;201407;2662;8592;2219;8060;93;282;1999;7507;2092;7789
220320;201407;3437;10151;2878;9211;360;1237;2097;6726;2457;7963
220323;201407;1506;5408;1333;5160;145;634;1009;3931;1154;4565
220325;201407;1293;4101;1183;3885;167;590;793;2670;960;3260
220327;201407;1387;4448;1258;4230;75;358;1010;3341;1085;3699
220330;201407;3816;10814;3606;10537;248;760;3063;9043;3311;9803
220335;201407;2142;6163;1932;5907;105;359;1660;5127;1765;5486
220340;201407;1879;5330;1635;4973;147;501;1254;3772;1401;4273
220342;201407;1227;4005;1161;3902;125;467;849;3006;974;3473
220345;201407;3011;8069;2559;7352;76;217;2237;6435;2313;6652
220350;201407;4541;12153;3999;11423;310;981;3166;9044;3476;10025
220360;201407;1500;4098;1189;3614;119;420;872;2629;991;3049
220370;201407;9306;26846;8474;25742;455;1358;7546;23019;8001;24377
220375;201407;1609;4989;1494;4835;74;270;1343;4341;1417;4611
220380;201407;1461;3942;1247;3644;88;292;980;2861;1068;3153
220385;201407;793;2112;663;1893;31;112;547;1513;578;1625
220390;201407;10209;32149;9272;30318;2503;8528;3963;13034;6466;21562
220400;201407;1501;3564;1286;3245;51;173;1117;2737;1168;2910
220410;201407;1400;4012;1187;3714;111;454;932;2844;1043;3298
220415;201407;898;2423;807;2302;84;239;610;1749;694;1988
220420;201407;2309;6706;2062;6222;140;415;1678;5092;1818;5507
220430;201407;2991;8701;2843;8500;377;1147;2209;6618;2586;7765
220435;201407;1698;4976;1560;4760;86;268;1293;3955;1379;4223
220440;201407;2819;8500;2333;7931;136;431;2061;7060;2197;7491
220450;201407;2754;8163;2374;7639;527;1801;1464;4713;1991;6514
220455;201407;1422;4391;1274;4189;47;156;1156;3844;1203;4000
220460;201407;1061;2922;1008;2848;70;215;873;2448;943;2663
220465;201407;2510;8309;2310;8005;551;2043;1407;4915;1958;6958
220470;201407;4149;12442;3752;11767;282;999;2878;8918;3160;9917
220480;201407;2458;7257;2239;6942;180;583;1806;5602;1986;6185
220490;201407;2491;7154;2321;6940;135;479;1988;5926;2123;6405
220500;201407;3484;9324;2912;8332;167;652;2358;6573;2525;7225
220510;201407;2962;8270;2209;7111;105;460;1691;5387;1796;5847
220515;201407;2021;5040;1783;4741;93;258;1499;4000;1592;4258
220520;201407;5210;14610;4851;14094;206;576;4286;12570;4492;13146
220525;201407;1484;4195;1376;4037;109;399;1116;3201;1225;3600
220527;201407;1481;4639;1351;4364;153;512;1016;3331;1169;3843
220530;201407;1244;3638;1131;3460;92;359;942;2797;1034;3156
220535;201407;924;2856;888;2805;91;330;696;2182;787;2512
220540;201407;3699;12267;3560;12048;285;1083;2936;9947;3221;11030
220545;201407;1459;5002;1401;4905;199;793;1004;3467;1203;4260
220550;201407;9566;31161;9010;30210;1404;4970;6261;21046;7665;26016
220551;201407;1462;4963;1357;4786;120;512;1063;3707;1183;4219
220552;201407;1703;5348;1457;4918;124;561;1075;3504;1199;4065
220553;201407;1646;4925;1402;4560;89;338;1145;3715;1234;4053
220554;201407;934;2606;810;2435;101;309;601;1832;702;2141
220555;201407;2497;7308;2337;7104;98;319;2014;6211;2112;6530
220556;201407;1532;4808;1383;4523;108;430;1041;3380;1149;3810
220557;201407;1681;5536;1530;5248;207;791;1013;3476;1220;4267
220558;201407;1070;3359;979;3198;99;389;741;2383;840;2772
220559;201407;1592;4509;1455;4298;85;286;1230;3632;1315;3918
220560;201407;1785;4417;1480;4005;91;250;1236;3330;1327;3580
220570;201407;7656;24420;7164;23709;1153;3670;5174;17632;6327;21302
220580;201407;6654;21690;6488;21493;400;1283;5835;19561;6235;20844
220585;201407;1994;7308;1916;7167;147;594;1596;5994;1743;6588
220590;201407;1478;4571;1334;4358;254;866;866;2881;1120;3747
220595;201407;2542;7342;2340;7073;89;312;2093;6337;2182;6649
220600;201407;1372;3402;1151;3134;205;425;789;2291;994;2716
220605;201407;2097;6204;1842;5801;108;372;1465;4612;1573;4984
220610;201407;2842;8786;2752;8656;170;660;2346;7320;2516;7980
220620;201407;7988;27128;7701;26705;434;1696;6733;23416;7167;25112
220630;201407;425;1292;362;1174;62;228;206;658;268;886
220635;201407;1896;6713;1767;6433;178;782;1141;4141;1319;4923
220640;201407;2866;8413;2716;8190;268;895;2155;6508;2423;7403
220650;201407;2537;7144;2266;6717;153;516;1830;5390;1983;5906
220660;201407;2651;8405;2122;7709;266;1149;1655;5901;1921;7050
220665;201407;1234;4236;1179;4146;53;229;1056;3695;1109;3924
220667;201407;1802;6083;1709;5956;88;344;1465;5107;1553;5451
220669;201407;1940;6328;1808;6084;272;1063;1259;4209;1531;5272
220670;201407;2192;6629;2044;6440;167;407;1758;5741;1925;6148
220672;201407;2430;6984;2327;6852;241;671;1950;5840;2191;6511
220675;201407;1396;4080;1301;3923;125;360;983;2992;1108;3352
220680;201407;2291;7494;2187;7351;231;776;1749;5986;1980;6762
220690;201407;1780;5055;1581;4731;120;432;1255;3716;1375;4148
220695;201407;916;2734;860;2641;71;248;666;2028;737;2276
220700;201407;9244;26822;8397;25560;780;2619;6483;19726;7263;22345
220710;201407;792;2380;680;2190;64;199;494;1619;558;1818
220720;201407;2182;5854;2062;5691;95;222;1824;5101;1919;5323
220730;201407;1405;3907;1203;3600;50;190;1011;2997;1061;3187
220735;201407;1089;2822;906;2512;63;210;682;1891;745;2101
220740;201407;1432;4571;1206;4263;163;569;919;3347;1082;3916
220750;201407;4070;11946;3825;11579;511;1332;2925;9215;3436;10547
220755;201407;1221;3544;1138;3410;73;214;950;2850;1023;3064
220760;201407;2722;9516;2526;9239;139;578;2173;8012;2312;8590
220770;201407;24536;83042;22514;79125;7393;26873;9531;34821;16924;61694
220775;201407;1276;3198;1244;3162;19;33;1211;3096;1230;3129
220777;201407;1741;4907;1610;4707;125;361;1291;3752;1416;4113
220779;201407;1232;3615;1196;3565;72;257;1067;3147;1139;3404
220780;201407;6416;16745;5748;15843;466;1260;4696;13103;5162;14363
220785;201407;1363;3670;1317;3578;59;171;1211;3273;1270;3444
220790;201407;9696;31371;9274;30603;984;3563;7317;24020;8301;27583
220793;201407;946;2683;870;2559;62;210;715;2093;777;2303
220795;201407;1556;4376;1506;4300;119;358;1283;3679;1402;4037
220800;201407;17707;50028;16326;47992;1862;6307;12268;35466;14130;41773
220810;201407;3434;10075;2971;9254;205;804;2366;7281;2571;8085
220820;201407;5717;15878;5227;15233;330;1061;4495;13128;4825;14189
220830;201407;7805;22228;7413;21581;850;2506;5726;16838;6576;19344
220840;201407;15261;48844;13818;45918;3667;12400;6561;22491;10228;34891
220850;201407;2840;10133;2712;9948;275;1078;2222;8209;2497;9287
220855;201407;638;1976;560;1829;48;191;410;1318;458;1509
220860;201407;967;2663;880;2527;53;215;710;1982;763;2197
220865;201407;2692;7539;2186;6701;122;561;1752;5215;1874;5776
220870;201407;2472;8127;2168;7746;114;433;1916;6872;2030;7305
220880;201407;5544;14447;5053;13848;267;836;4442;12176;4709;13012
220885;201407;1363;4822;1200;4536;122;581;888;3335;1010;3916
220887;201407;1419;3676;1235;3423;51;168;1107;3071;1158;3239
220890;201407;1678;5856;1492;5545;143;518;1188;4556;1331;5074
220900;201407;1973;5770;1751;5312;121;351;1418;4361;1539;4712
220910;201407;1734;5160;1539;4870;84;277;1336;4280;1420;4557
220915;201407;1064;3082;934;2848;57;245;736;2179;793;2424
220920;201407;1364;5014;1278;4891;146;646;930;3531;1076;4177
220930;201407;1516;4892;1347;4668;98;391;1099;3834;1197;4225
220935;201407;1077;3319;959;3080;71;311;684;2100;755;2411
220937;201407;1614;4416;1360;3970;79;295;1071;3034;1150;3329
220940;201407;1472;4519;1361;4283;111;421;1042;3257;1153;3678
220945;201407;500;1784;459;1671;60;253;318;1156;378;1409
220950;201407;1291;3296;931;2676;40;156;711;1987;751;2143
220955;201407;1647;4550;1387;4139;107;344;1077;3199;1184;3543
220960;201407;884;2433;744;2192;56;216;574;1662;630;1878
220965;201407;1722;5193;1628;5058;73;297;1412;4358;1485;4655
220970;201407;2170;5820;1598;4866;168;519;1096;3366;1264;3885
220975;201407;645;2267;639;2257;50;186;571;2016;621;2202
220980;201407;1512;4520;1347;4222;142;506;897;2904;1039;3410
220985;201407;1364;3940;1295;3837;139;465;985;2891;1124;3356
220987;201407;1528;4928;1411;4725;116;497;1063;3476;1179;3973
220990;201407;1856;5393;1614;4976;81;332;1257;3811;1338;4143
220995;201407;1274;3794;1009;3386;87;355;767;2592;854;2947
220997;201407;2139;6836;2039;6671;114;409;1839;6009;1953;6418
221000;201407;4548;14100;4222;13551;524;1863;3070;9792;3594;11655
221005;201407;1456;4639;1355;4447;422;1311;707;2432;1129;3743
221010;201407;1268;3423;1099;3199;73;218;921;2690;994;2908
221020;201407;1944;6044;1815;5807;139;597;1365;4288;1504;4885
221030;201407;1829;5115;1589;4765;109;454;1256;3696;1365;4150
221035;201407;1598;4341;1449;4157;97;252;1273;3717;1370;3969
221037;201407;638;1966;576;1858;37;166;460;1422;497;1588
221038;201407;655;1852;522;1627;42;142;355;1116;397;1258
221039;201407;954;2776;887;2676;63;219;754;2247;817;2466
221040;201407;5306;16269;4985;15752;395;1358;3931;12552;4326;13910
221050;201407;3820;11765;3522;11339;217;840;2997;9603;3214;10443
221060;201407;9316;25524;7905;23561;904;2762;5934;17804;6838;20566
221062;201407;1296;4596;1205;4439;33;129;1117;4128;1150;4257
221063;201407;1157;3739;1076;3582;312;997;616;2206;928;3203
221065;201407;2802;8122;2608;7805;303;896;2007;6029;2310;6925
221070;201407;4410;13514;3984;12852;277;1039;3178;10258;3455;11297
221080;201407;3607;9702;3217;9177;216;671;2659;7612;2875;8283
221090;201407;1373;3808;1199;3531;51;211;990;2853;1041;3064
221093;201407;1834;5500;1743;5319;391;1272;959;2864;1350;4136
221095;201407;1017;2722;869;2509;30;77;769;2237;799;2314
221097;201407;821;2368;724;2199;65;265;547;1632;612;1897
221100;201407;127334;389061;120092;377100;24507;84140;78754;242785;103261;326925
221110;201407;10303;34070;9836;33483;691;2644;8331;28369;9022;31013
221120;201407;4496;14923;4303;14577;1011;3436;2788;9682;3799;13118
221130;201407;4762;14160;4182;12993;1176;3813;2108;6513;3284;10326
221135;201407;1501;4757;1404;4612;160;588;1093;3573;1253;4161
221140;201407;1425;3614;1311;3464;109;291;1105;2931;1214;3222
221150;201407;1256;3252;1046;2889;36;156;829;2258;865;2414
221160;201407;908;2410;856;2329;61;190;654;1788;715;1978
221170;201407;1156;3682;1080;3543;76;312;880;2847;956;3159
230010;201407;3461;9442;2836;8367;184;632;2266;6674;2450;7306
230015;201407;2734;9651;2566;9278;391;1656;1705;6037;2096;7693
230020;201407;14621;48246;14105;47295;924;3412;11704;39472;12628;42884
230030;201407;12803;37629;11969;36327;889;3029;9701;29392;10590;32421
230040;201407;4620;13113;3942;11947;313;1132;3046;9125;3359;10257
230050;201407;2561;8923;2101;7687;400;1617;973;3535;1373;5152
230060;201407;2083;6199;1834;5734;124;456;1392;4307;1516;4763
230070;201407;4383;12260;3850;11476;342;1078;2952;8933;3294;10011
230075;201407;9120;33101;8555;31922;845;3935;6578;24234;7423;28169
230080;201407;2391;6611;2010;6060;130;453;1613;4839;1743;5292
230090;201407;3578;10899;3207;10237;308;1143;2452;7769;2760;8912
230100;201407;17863;55124;16361;52240;4086;13759;8625;27808;12711;41567
230110;201407;14222;46748;13272;44741;2592;9373;7870;26500;10462;35873
230120;201407;8254;22835;7275;21467;856;2567;5426;16256;6282;18823
230125;201407;2979;8800;2482;7851;191;730;1826;5699;2017;6429
230130;201407;5706;19010;4834;17102;503;2107;3378;11779;3881;13886
230140;201407;3584;11671;3091;10763;460;1708;2011;7176;2471;8884
230150;201407;1777;5679;1556;5228;286;1102;974;3153;1260;4255
230160;201407;6543;19718;5703;18468;505;1857;4350;14103;4855;15960
230170;201407;6690;21235;5786;19551;559;2196;4197;14041;4756;16237
230180;201407;1967;5699;1728;5265;149;554;1215;3641;1364;4195
230185;201407;4291;14330;3945;13690;675;2338;2531;9128;3206;11466
230190;201407;12720;41965;11699;39900;2452;9386;6243;21012;8695;30398
230195;201407;5092;15972;4617;15208;339;1464;3631;11580;3970;13044
230200;201407;5821;17061;5226;15918;653;2108;3732;11355;4385;13463
230205;201407;4468;14127;3984;13304;327;1401;2897;9644;3224;11045
230210;201407;9509;27489;8312;25600;2221;6863;4421;14142;6642;21005
230220;201407;13992;41053;12719;38843;1735;5982;8786;26480;10521;32462
230230;201407;7669;25248;6876;23607;1037;3782;4366;15122;5403;18904
230240;201407;13719;39987;12321;37484;839;3168;9607;28684;10446;31852
230250;201407;10332;32030;10115;31714;508;1901;8579;26790;9087;28691
230260;201407;15045;51389;13987;49207;2931;10822;7973;28663;10904;39485
230270;201407;6939;21267;6118;19827;689;2397;4480;14610;5169;17007
230280;201407;19250;58818;17388;55588;2213;7210;12471;40211;14684;47421
230290;201407;5187;15984;4531;14669;649;2187;3033;9894;3682;12081
230300;201407;4895;15110;4682;14784;532;1927;3538;11049;4070;12976
230310;201407;4990;15036;4368;13992;374;1501;3227;10115;3601;11616
230320;201407;7548;24375;7019;23439;791;2981;5194;17376;5985;20357
230330;201407;4845;14481;4294;13422;367;1339;3117;9616;3484;10955
230340;201407;3502;12198;3272;11698;517;2066;2077;7300;2594;9366
230350;201407;18606;57521;16772;54338;2774;9647;10632;34916;13406;44563
230360;201407;3123;9219;2659;8376;321;1143;1860;5780;2181;6923
230365;201407;3088;8797;2715;8180;179;643;2131;6394;2310;7037
230370;201407;57321;189530;52876;181709;15607;55451;25751;91577;41358;147028
230380;201407;7230;21099;6168;19249;571;2009;4378;13678;4949;15687
230390;201407;3722;11770;3303;11075;385;1556;2328;7711;2713;9267
230393;201407;3418;11445;2932;10420;307;1436;2043;7017;2350;8453
230395;201407;5081;16067;4724;15393;706;2558;3111;10140;3817;12698
230400;201407;5291;16525;4600;15478;356;1562;3583;11798;3939;13360
230410;201407;15955;50803;14306;47662;2492;8842;8546;28563;11038;37405
230420;201407;25133;83234;23194;79237;5695;21142;11705;39817;17400;60959
230423;201407;4941;16079;4578;15379;541;2032;3173;10811;3714;12843
230425;201407;5595;18882;5096;17736;735;2751;3415;11879;4150;14630
230426;201407;2874;8081;2346;7102;160;654;1733;5109;1893;5763
230427;201407;1797;5507;1368;4564;141;548;918;2957;1059;3505
230428;201407;9305;30583;9062;30155;1761;6521;5796;19128;7557;25649
230430;201407;4655;15125;4393;14615;455;1809;3184;10430;3639;12239
230435;201407;5160;16921;4626;15965;967;3717;2480;8610;3447;12327
230440;201407;365037;1137049;342303;1095965;87119;298386;172419;554796;259538;853182
230445;201407;4798;13054;4067;11995;358;1041;3047;9182;3405;10223
230450;201407;3768;12119;3225;11137;466;1844;2086;7201;2552;9045
230460;201407;1948;6502;1768;6163;198;797;1264;4379;1462;5176
230465;201407;4299;12911;3511;11475;315;1344;2391;7609;2706;8953
230470;201407;11463;42063;10980;41074;1463;5760;7904;30068;9367;35828
230480;201407;1505;4890;1299;4491;205;752;831;2899;1036;3651
230490;201407;2932;8652;2562;7965;481;1676;1349;4126;1830;5802
230495;201407;5823;19652;5281;18745;895;3708;3118;11095;4013;14803
230500;201407;10787;36935;10310;36098;945;3627;7839;28040;8784;31667
230510;201407;1540;5547;1251;4806;309;1292;483;1917;792;3209
230520;201407;5098;15596;4476;14488;488;1867;3053;9804;3541;11671
230523;201407;14222;47558;12885;44451;3650;13724;3880;13666;7530;27390
230526;201407;4237;13059;3738;12187;399;1525;2692;8760;3091;10285
230530;201407;5441;18110;4966;17461;975;3518;3365;12021;4340;15539
230533;201407;4071;11644;3630;10806;269;897;2816;8296;3085;9193
230535;201407;5540;16584;4853;15347;544;1794;3467;11129;4011;12923
230540;201407;19304;55734;17110;52459;1086;4023;14060;42772;15146;46795
230550;201407;19198;58849;17418;55371;3744;12756;9416;29838;13160;42594
230560;201407;6662;19400;5953;18118;277;1120;4804;14443;5081;15563
230565;201407;3348;9734;2719;8480;236;857;1923;5922;2159;6779
230570;201407;4018;11008;3575;10448;243;874;2962;8560;3205;9434
230580;201407;10608;32678;10041;31873;613;1998;8684;27845;9297;29843
230590;201407;9081;28962;8058;27024;663;2811;6036;19820;6699;22631
230600;201407;3658;10407;2742;8506;203;713;1823;5601;2026;6314
230610;201407;6268;20606;5855;19936;790;2866;4213;14508;5003;17374
230620;201407;2139;6100;1750;5272;162;569;1104;3226;1266;3795
230625;201407;7835;26037;7031;24185;2109;7807;2330;8043;4439;15850
230630;201407;11427;37314;10454;35443;2644;8608;5255;18941;7899;27549
230640;201407;27610;91623;25874;89013;3544;12976;19067;66172;22611;79148
230650;201407;5040;15949;4570;15035;382;1597;3480;11196;3862;12793
230655;201407;8810;33628;8481;33084;698;2831;7120;28146;7818;30977
230660;201407;6462;20315;5690;18925;546;2146;4098;13695;4644;15841
230670;201407;6070;16597;4929;14632;282;1089;3822;11002;4104;12091
230680;201407;2859;8417;2401;7564;359;1237;1472;4620;1831;5857
230690;201407;6304;20963;6175;20718;516;2162;4516;14863;5032;17025
230700;201407;9436;27555;8380;25662;856;3225;5859;17404;6715;20629
230710;201407;7695;25145;6835;23546;846;2972;4939;17346;5785;20318
230720;201407;1983;6256;1716;5742;231;824;1141;3866;1372;4690
230725;201407;3787;12818;3358;11775;741;2753;1719;5963;2460;8716
230730;201407;57824;178659;49006;164461;13544;49150;21121;72311;34665;121461
230740;201407;5630;17653;5222;16929;295;1291;4329;13819;4624;15110
230750;201407;9241;26655;7855;24407;709;2552;5974;18457;6683;21009
230760;201407;9619;29635;9189;28662;985;3746;6721;20164;7706;23910
230763;201407;4272;13564;3972;12977;299;1388;3039;9561;3338;10949
230765;201407;42346;139775;39287;133487;12503;45405;14324;49351;26827;94756
230770;201407;24119;67967;22325;65420;2253;7257;16591;48632;18844;55889
230780;201407;6110;24064;5830;23401;1492;6056;2958;12624;4450;18680
230790;201407;2624;8943;2489;8707;293;1098;1903;6721;2196;7819
230800;201407;8036;28969;7356;27431;1773;7064;3543;13264;5316;20328
230810;201407;12699;41668;12091;40640;1344;4684;9325;31826;10669;36510
230820;201407;3515;11991;3107;11105;563;2272;1763;6288;2326;8560
230830;201407;7983;24327;7128;22768;786;2870;4977;15831;5763;18701
230835;201407;4214;11492;3550;10558;310;1042;2756;8147;3066;9189
230837;201407;3183;10955;2761;10085;358;1500;1864;6795;2222;8295
230840;201407;9550;31719;8745;30286;1152;4300;6189;21764;7341;26064
230850;201407;11491;35032;10673;33923;1319;4622;7907;25158;9226;29780
230860;201407;5147;15448;4704;14656;370;1374;3619;11195;3989;12569
230870;201407;19307;53506;17328;50268;1578;5192;13120;37817;14698;43009
230880;201407;1953;6821;1817;6545;245;1038;1204;4302;1449;5340
230890;201407;4168;15159;3800;14386;570;2533;2428;9028;2998;11561
230900;201407;3039;10235;2646;9411;574;2007;1378;5037;1952;7044
230910;201407;3068;9241;2489;8145;236;946;1776;5692;2012;6638
230920;201407;4784;14058;4396;13574;314;1056;3680;11513;3994;12569
230930;201407;7915;24312;7117;22824;884;2983;4936;15926;5820;18909
230940;201407;7741;22246;6816;20849;427;1358;5589;17225;6016;18583
230945;201407;5988;18196;5144;16972;585;2145;3628;12123;4213;14268
230950;201407;7112;19580;6103;18220;427;1370;4796;14406;5223;15776
230960;201407;12869;41428;11839;39429;2537;9185;6111;20427;8648;29612
230970;201407;13755;44041;12449;41502;2702;10149;6195;20290;8897;30439
230980;201407;2996;9720;2601;8945;821;2855;1173;4218;1994;7073
230990;201407;1626;5084;1348;4506;157;663;885;2880;1042;3543
231000;201407;2903;7907;2306;6772;278;938;1469;4182;1747;5120
231010;201407;3219;9028;2769;8312;262;1031;2114;6205;2376;7236
231020;201407;8278;27753;7822;26832;1412;5020;4907;17197;6319;22217
231025;201407;7980;25247;7206;23890;1161;3970;4680;15898;5841;19868
231030;201407;8147;26932;6924;24377;1329;5019;4032;14365;5361;19384
231040;201407;3071;10196;2751;9543;243;1033;1959;6679;2202;7712
231050;201407;12411;36110;10775;33140;1060;3723;7853;24028;8913;27751
231060;201407;2459;7952;2255;7581;198;903;1624;5301;1822;6204
231070;201407;9452;30084;8680;28560;1626;5687;5221;17259;6847;22946
231080;201407;4368;13740;4007;13088;260;1192;3016;9501;3276;10693
231085;201407;4831;15641;4685;15399;709;2335;3424;11545;4133;13880
231090;201407;4127;11736;3378;10244;197;743;2459;7329;2656;8072
231095;201407;2260;7597;1960;6981;226;894;1349;4857;1575;5751
231100;201407;3091;9697;2589;8687;232;908;1862;6159;2094;7067
231110;201407;3799;12780;3710;12625;389;1487;2732;9322;3121;10809
231120;201407;2447;8032;2276;7730;378;1331;1490;5136;1868;6467
231123;201407;2244;6141;1913;5588;166;467;1511;4450;1677;4917
231126;201407;6812;18944;5548;17092;437;1645;4161;12638;4598;14283
231130;201407;20533;64513;18801;61476;4463;14967;10447;35584;14910;50551
231135;201407;4723;13916;3977;12750;407;1557;2916;9187;3323;10744
231140;201407;15956;52150;14615;49466;1463;6627;10067;32843;11530;39470
231150;201407;6045;17724;5172;16068;948;3260;2837;8601;3785;11861
231160;201407;6027;20567;5719;19969;1197;4419;3600;12606;4797;17025
231170;201407;4831;15568;4434;14754;516;2025;2998;9837;3514;11862
231180;201407;14054;42879;12796;40421;2163;7508;8132;25331;10295;32839
231190;201407;5121;14363;4275;13145;331;1201;3304;10048;3635;11249
231195;201407;4659;15961;4041;14724;402;1754;2957;10748;3359;12502
231200;201407;7781;27115;6862;25227;674;3179;4869;17546;5543;20725
231210;201407;5250;16244;4533;15223;324;1386;3508;11850;3832;13236
231220;201407;14358;41027;12243;37389;1256;4489;8138;24877;9394;29366
231230;201407;8930;31506;8354;30488;938;3968;6340;23091;7278;27059
231240;201407;12215;39131;10985;36827;1959;7202;6328;21480;8287;28682
231250;201407;2054;6017;1427;4493;303;955;572;1734;875;2689
231260;201407;4063;11612;3673;11060;524;1597;2481;7666;3005;9263
231270;201407;7808;22017;6921;20601;658;2579;5042;14588;5700;17167
231280;201407;1760;5827;1644;5598;160;581;1213;4153;1373;4734
231290;201407;33569;118643;30691;111644;7372;29715;13215;47030;20587;76745
231300;201407;4700;13801;3840;12058;333;1280;2735;8325;3068;9605
231310;201407;7706;22321;6496;19839;1237;3934;3572;10800;4809;14734
231320;201407;7097;22108;6202;20356;437;1741;4613;15087;5050;16828
231325;201407;2606;8017;2322;7522;176;671;1747;5662;1923;6333
231330;201407;14356;44792;12145;40552;2023;6877;7545;25524;9568;32401
231335;201407;5228;15231;4593;14065;330;1283;3630;10885;3960;12168
231340;201407;18279;60222;17135;58591;1416;4719;13887;48767;15303;53486
231350;201407;12604;42568;12334;42157;1391;4544;9970;34835;11361;39379
231355;201407;4309;14245;4132;13940;281;1024;3428;11683;3709;12707
231360;201407;7453;24742;6827;23624;1628;5503;4055;14618;5683;20121
231370;201407;2445;6949;1961;6202;112;430;1489;4646;1601;5076
231375;201407;4112;14375;3908;13980;356;1599;3058;10784;3414;12383
231380;201407;5364;17559;5051;17114;779;2778;3476;12067;4255;14845
231390;201407;3508;11135;3307;10829;277;1135;2497;8086;2774;9221
231395;201407;4265;13792;3811;13054;753;2693;2287;7989;3040;10682
231400;201407;10580;31782;9659;30101;1026;3678;6733;21042;7759;24720
231410;201407;13654;47035;12793;45733;1216;4518;9978;36286;11194;40804
240010;201407;2558;7950;2222;7235;536;1933;998;3129;1534;5062
240020;201407;11979;37814;10702;35379;2760;9659;5086;17121;7846;26780
240030;201407;2636;7766;2557;7640;219;783;2040;6004;2259;6787
240040;201407;828;2498;707;2263;49;226;506;1546;555;1772
240050;201407;3808;10404;3273;9487;232;813;2493;7128;2725;7941
240060;201407;1467;4413;1380;4268;137;508;1060;3184;1197;3692
240070;201407;2920;8487;2778;8223;472;1473;1815;5309;2287;6782
240080;201407;3176;8542;2803;8062;270;723;2174;6390;2444;7113
240090;201407;2303;6342;1958;5693;75;302;1559;4437;1634;4739
240100;201407;10493;30313;9714;28792;1295;4511;6075;17793;7370;22304
240110;201407;5245;16119;4669;15070;847;3091;2822;8781;3669;11872
240120;201407;3067;10233;2945;10007;548;2008;1883;6531;2431;8539
240130;201407;2876;7882;2478;7270;212;746;1922;5554;2134;6300
240140;201407;2273;6960;2009;6475;403;1484;1106;3493;1509;4977
240145;201407;6301;19901;5690;18811;1481;5424;2928;9682;4409;15106
240150;201407;1034;3130;851;2767;116;464;518;1620;634;2084
240160;201407;1502;4870;1341;4592;197;759;826;2873;1023;3632
240165;201407;953;3052;837;2818;105;358;549;1890;654;2248
240170;201407;2572;7789;2297;7274;631;2126;1023;3252;1654;5378
240180;201407;3012;9483;2808;9130;729;2453;1476;4989;2205;7442
240185;201407;1513;5050;1460;4953;171;594;1100;3813;1271;4407
240190;201407;920;2845;843;2695;61;265;645;2008;706;2273
240200;201407;14495;37567;12120;34614;2505;7197;7199;21453;9704;28650
240210;201407;2833;8107;2613;7812;221;766;2157;6394;2378;7160
240220;201407;7384;24093;7026;23588;380;1702;6116;20305;6496;22007
240230;201407;5696;16019;5177;15130;441;1439;4075;11802;4516;13241
240240;201407;1894;5891;1422;4664;404;1436;305;879;709;2315
240250;201407;2903;8412;2749;8194;214;748;2221;6549;2435;7297
240260;201407;15112;50806;14400;49637;2466;9475;9436;32627;11902;42102
240270;201407;2468;8006;2294;7723;249;832;1709;5896;1958;6728
240280;201407;1688;4804;1512;4498;132;461;1121;3298;1253;3759
240290;201407;1446;4546;1245;4177;117;560;808;2606;925;3166
240300;201407;2204;6252;1585;4875;414;1370;550;1627;964;2997
240310;201407;10621;30399;9696;28902;2174;7028;5213;15527;7387;22555
240320;201407;2085;6243;1704;5450;113;485;1230;3800;1343;4285
240325;201407;39207;109100;30967;95491;9815;32446;9620;30414;19435;62860
240330;201407;1579;4790;1336;4304;161;648;839;2609;1000;3257
240340;201407;1782;5212;1547;4840;204;680;1100;3447;1304;4127
240350;201407;2190;6597;2051;6400;221;791;1658;5128;1879;5919
240360;201407;7517;22767;6590;21391;1201;4099;4096;13674;5297;17773
240370;201407;2073;5717;1792;5239;164;544;1300;3797;1464;4341
240375;201407;911;2414;811;2271;157;496;481;1307;638;1803
240380;201407;2738;8163;2238;7055;315;1051;1310;4094;1625;5145
240390;201407;966;2694;814;2398;75;281;587;1681;662;1962
240400;201407;1504;4045;1277;3689;149;512;930;2599;1079;3111
240410;201407;552;1792;505;1694;81;317;327;1084;408;1401
240420;201407;4974;18880;4764;18403;1367;5194;2470;10143;3837;15337
240430;201407;3613;10406;3341;9940;332;1119;2466;7281;2798;8400
240440;201407;2812;7521;2588;7131;659;1861;1376;3816;2035;5677
240450;201407;4086;12151;3657;11346;544;1981;2274;6935;2818;8916
240460;201407;3007;9450;2876;9267;276;1048;2304;7346;2580;8394
240470;201407;3657;11307;2952;9819;387;1432;1833;6030;2220;7462
240480;201407;461;1210;392;1063;44;119;239;632;283;751
240485;201407;2149;6603;1902;6145;379;1316;1091;3550;1470;4866
240490;201407;1727;4398;1489;4050;90;332;1169;3059;1259;3391
240500;201407;2204;6563;2071;6349;212;720;1576;4827;1788;5547
240510;201407;1832;5587;1701;5346;217;692;1268;4043;1485;4735
240520;201407;1464;4268;1284;4006;197;693;889;2715;1086;3408
240530;201407;2260;7183;2030;6816;274;969;1447;4888;1721;5857
240540;201407;1855;5700;1784;5577;170;599;1351;4227;1521;4826
240550;201407;827;2355;717;2169;61;216;548;1616;609;1832
240560;201407;3332;9752;3156;9490;308;938;2560;7739;2868;8677
240570;201407;3181;9052;2593;7746;577;1909;1157;3190;1734;5099
240580;201407;8280;25646;7796;24823;1156;3899;5767;18300;6923;22199
240590;201407;849;2397;741;2200;55;211;542;1568;597;1779
240600;201407;1585;4692;1255;4013;168;622;724;2215;892;2837
240610;201407;5090;14358;4420;13114;632;2005;2732;7970;3364;9975
240615;201407;1061;3085;883;2744;154;505;501;1554;655;2059
240620;201407;1752;5666;1609;5416;182;709;1245;4166;1427;4875
240630;201407;2117;6483;2002;6289;215;606;1483;4870;1698;5476
240640;201407;960;2831;807;2575;97;391;536;1673;633;2064
240650;201407;3907;12020;3599;11574;299;1071;2883;9332;3182;10403
240660;201407;2535;8128;2424;7947;267;935;1838;6085;2105;7020
240670;201407;2793;8365;2370;7507;361;1294;1342;4145;1703;5439
240680;201407;1539;4551;1257;4042;145;507;779;2526;924;3033
240690;201407;1134;3178;988;2943;106;374;721;2122;827;2496
240700;201407;2717;8205;2283;7386;123;571;1768;5561;1891;6132
240710;201407;18866;48603;16735;45808;3206;8615;10477;29696;13683;38311
240720;201407;5814;16714;5512;16271;1679;5264;2702;7896;4381;13160
240725;201407;1089;3281;843;2732;84;296;490;1552;574;1848
240730;201407;2368;7224;2066;6670;219;777;1456;4684;1675;5461
240740;201407;2279;6850;2048;6428;275;927;1344;4226;1619;5153
240750;201407;2307;8565;2123;8226;442;1887;1211;4753;1653;6640
240760;201407;1313;3803;1228;3688;123;303;955;3059;1078;3362
240770;201407;3633;10569;3299;10073;393;1327;2413;7389;2806;8716
240780;201407;5967;16681;4824;14886;844;2760;2825;8879;3669;11639
240790;201407;871;2712;709;2418;59;245;522;1785;581;2030
240800;201407;41856;121676;38044;115123;10779;34260;16397;50503;27176;84763
240810;201407;98770;294462;92824;283794;28149;88598;44564;138630;72713;227228
240820;201407;7064;21122;6092;19583;1265;4418;3145;10489;4410;14907
240830;201407;9568;29386;9002;28572;708;2363;7412;23911;8120;26274
240840;201407;1329;3707;1147;3399;149;509;691;2019;840;2528
240850;201407;1282;3862;966;3202;185;687;508;1611;693;2298
240860;201407;1343;3820;1142;3488;100;353;842;2519;942;2872
240870;201407;1179;3309;1006;2971;132;462;649;1821;781;2283
240880;201407;1205;4127;1140;4030;152;633;821;2873;973;3506
240890;201407;5519;15676;4810;14412;939;3086;2521;7449;3460;10535
240895;201407;2819;9673;2560;9202;353;1352;1784;6522;2137;7874
240910;201407;2772;8741;2529;8287;238;922;1893;6148;2131;7070
240920;201407;878;2840;791;2641;214;777;367;1177;581;1954
240930;201407;3726;10014;3354;9531;308;899;2657;7662;2965;8561
240933;201407;1537;4488;1368;4199;230;810;835;2557;1065;3367
240940;201407;6758;18993;5685;17121;1089;3461;3166;9514;4255;12975
240950;201407;1189;3730;1125;3620;119;471;801;2567;920;3038
240960;201407;815;2558;725;2382;88;337;515;1677;603;2014
240970;201407;1975;5589;1658;5042;134;495;1226;3639;1360;4134
240980;201407;3372;11091;3149;10674;670;2444;1936;6548;2606;8992
240990;201407;3105;9253;2915;8875;535;1807;1826;5433;2361;7240
241000;201407;1106;3108;964;2864;83;294;702;2054;785;2348
241010;201407;3055;10223;2768;9697;425;1765;1910;6503;2335;8268
241020;201407;2157;6125;1792;5418;155;555;1139;3308;1294;3863
241025;201407;1542;4801;1403;4527;121;503;1003;3152;1124;3655
241030;201407;2568;8492;2321;8051;195;746;1805;6311;2000;7057
241040;201407;2234;7756;2051;7422;218;917;1485;5416;1703;6333
241050;201407;1375;4094;1237;3860;112;442;918;2793;1030;3235
241060;201407;1006;2908;920;2767;111;356;673;2027;784;2383
241070;201407;946;2703;825;2486;99;356;573;1670;672;2026
241080;201407;1217;3625;1045;3308;92;381;728;2230;820;2611
241090;201407;2168;6293;1865;5755;124;525;1520;4609;1644;5134
241100;201407;1224;3674;1059;3301;114;382;684;2101;798;2483
241105;201407;1178;3625;1110;3496;196;676;651;2113;847;2789
241110;201407;868;2774;728;2466;78;345;453;1500;531;1845
241120;201407;7963;24218;7263;23099;1430;4584;4775;15593;6205;20177
241140;201407;3548;9945;3141;9143;407;1261;2153;6178;2560;7439
241142;201407;711;2136;517;1712;139;519;152;456;291;975
241150;201407;5910;17699;5364;16775;833;2760;3610;11404;4443;14164
241160;201407;1138;3317;1070;3187;170;545;745;2213;915;2758
241170;201407;1385;4089;1268;3874;177;589;789;2514;966;3103
241180;201407;1016;2822;800;2389;102;342;462;1331;564;1673
241190;201407;1140;3184;960;2827;76;293;644;1791;720;2084
241200;201407;21289;63714;19641;61071;5166;16840;10126;32133;15292;48973
241210;201407;1567;4571;1314;4056;282;968;644;1959;926;2927
241220;201407;8107;27390;7700;26597;1864;6682;4292;15169;6156;21851
241230;201407;3131;9339;2867;8961;217;820;2329;7223;2546;8043
241240;201407;1151;3374;871;2768;103;349;490;1607;593;1956
241250;201407;5682;17983;4879;16394;312;1523;3891;12751;4203;14274
241255;201407;1869;7153;1772;6938;462;1914;820;3330;1282;5244
241260;201407;5182;14044;4190;12506;341;1311;3007;8789;3348;10100
241270;201407;2096;6323;1839;5828;253;891;1111;3538;1364;4429
241280;201407;2179;6353;2024;6049;317;1021;1349;4055;1666;5076
241290;201407;3349;9284;2692;8230;471;1513;1629;4985;2100;6498
241300;201407;1473;4266;1307;3987;81;258;1009;3120;1090;3378
241310;201407;1565;4941;1488;4821;220;678;1044;3513;1264;4191
241320;201407;934;3153;864;3000;158;601;499;1735;657;2336
241330;201407;1562;4932;1445;4781;147;572;1175;3867;1322;4439
241335;201407;2685;8260;2529;7991;179;585;2130;6748;2309;7333
241340;201407;1987;6173;1762;5682;437;1534;864;2746;1301;4280
241350;201407;1948;6270;1818;6018;178;760;1369;4399;1547;5159
241355;201407;1312;3722;1148;3444;64;211;1005;2999;1069;3210
241360;201407;2177;6032;1909;5520;139;469;1393;3879;1532;4348
241370;201407;1364;4226;1110;3686;187;670;589;1925;776;2595
241380;201407;735;2122;632;1913;101;354;355;1071;456;1425
241390;201407;2996;9948;2818;9615;559;2022;1810;6280;2369;8302
241400;201407;3740;11097;3484;10738;404;1418;2648;8193;3052;9611
241410;201407;2774;8190;2489;7805;377;1283;1785;5608;2162;6891
241415;201407;1645;5011;1522;4796;110;439;1161;3597;1271;4036
241420;201407;2276;7914;1990;7414;670;2800;664;2399;1334;5199
241430;201407;503;1536;430;1367;57;206;277;852;334;1058
241440;201407;6072;22219;5682;21552;1026;4078;3936;15138;4962;19216
241445;201407;1049;3240;991;3153;144;374;771;2604;915;2978
241450;201407;3332;9289;3037;8870;457;1473;2139;6206;2596;7679
241460;201407;3651;10686;3244;9898;281;1036;2324;7012;2605;8048
241470;201407;1357;3874;1175;3651;130;514;870;2639;1000;3153
241475;201407;1252;3928;1102;3650;77;368;796;2571;873;2939
241480;201407;3316;10760;3008;10298;1032;3524;1178;4466;2210;7990
241490;201407;647;1742;534;1567;56;215;366;1028;422;1243
241500;201407;764;2402;700;2313;44;205;602;1931;646;2136
250010;201407;2763;8704;2425;8108;235;967;1803;5902;2038;6869
250020;201407;1695;4904;1302;4190;106;463;853;2638;959;3101
250030;201407;8154;23196;7382;22114;867;2618;5624;17178;6491;19796
250040;201407;4610;15478;4262;14781;791;2901;2659;9316;3450;12217
250050;201407;3724;11704;3505;11391;480;1731;2479;8172;2959;9903
250053;201407;1343;3979;1255;3862;202;644;841;2604;1043;3248
250057;201407;712;2798;694;2776;37;105;615;2590;652;2695
250060;201407;5070;16050;4866;15721;654;2380;3702;11793;4356;14173
250070;201407;3901;12237;3673;11837;238;1041;3036;9524;3274;10565
250073;201407;794;2423;709;2266;76;286;519;1645;595;1931
250077;201407;2315;6797;1939;6196;272;954;1143;3686;1415;4640
250080;201407;4810;14080;4652;13855;573;1760;3504;10492;4077;12252
250090;201407;2628;7830;2532;7680;136;477;2141;6401;2277;6878
250100;201407;4032;13572;3845;13238;444;1732;2948;10111;3392;11843
250110;201407;5820;17672;5568;17318;741;2568;4225;13068;4966;15636
250115;201407;551;1801;486;1651;48;233;292;924;340;1157
250120;201407;2253;6724;1945;6143;192;695;1438;4515;1630;5210
250130;201407;5788;17741;5457;17276;343;1229;4562;14587;4905;15816
250135;201407;1096;3376;1006;3221;119;423;707;2278;826;2701
250140;201407;2157;6996;1992;6774;226;821;1509;5223;1735;6044
250150;201407;5098;17208;4676;16413;486;2032;3389;11773;3875;13805
250153;201407;1588;4253;1427;4020;127;442;1105;3101;1232;3543
250157;201407;1740;5950;1597;5647;318;1143;977;3535;1295;4678
250160;201407;3398;10548;3296;10381;208;736;2837;9006;3045;9742
250170;201407;1633;4820;1525;4647;305;965;969;3030;1274;3995
250180;201407;17026;52993;16459;52037;2417;8826;11740;36227;14157;45053
250190;201407;4059;12042;3762;11538;629;2068;2469;7450;3098;9518
250200;201407;2264;6281;1809;5660;141;519;1483;4602;1624;5121
250205;201407;1022;3358;929;3180;94;428;601;2106;695;2534
250210;201407;1662;5414;1539;5233;186;771;1108;3708;1294;4479
250215;201407;1447;4961;1408;4886;212;821;899;3136;1111;3957
250220;201407;831;2359;687;2175;43;155;589;1851;632;2006
250230;201407;1753;4455;1426;3916;134;431;1120;2990;1254;3421
250240;201407;2710;8661;2394;8172;207;753;1828;6326;2035;7079
250250;201407;4637;14000;4252;13478;374;1213;3469;11132;3843;12345
250260;201407;1930;5878;1682;5465;153;602;1249;4014;1402;4616
250270;201407;1341;4200;1196;4018;153;539;903;3083;1056;3622
250280;201407;3816;11538;3520;11064;676;2169;2271;7438;2947;9607
250290;201407;2150;5747;1772;5255;67;251;1556;4611;1623;4862
250300;201407;5545;16436;5251;16069;618;2539;4195;12271;4813;14810
250310;201407;1180;3741;1069;3554;149;572;784;2578;933;3150
250320;201407;8055;25446;7663;24636;1099;3995;5198;16266;6297;20261
250330;201407;2625;8261;2293;7804;272;1048;1734;5875;2006;6923
250340;201407;1150;3349;1069;3228;55;186;917;2769;972;2955
250350;201407;4596;12587;4191;12088;189;617;3667;10705;3856;11322
250355;201407;2169;6637;1974;6347;155;655;1527;4827;1682;5482
250360;201407;2069;6218;1923;6016;114;429;1526;4802;1640;5231
250370;201407;13751;39130;11906;36924;1093;3561;9981;31154;11074;34715
250375;201407;1114;3538;1049;3429;63;254;883;2885;946;3139
250380;201407;1702;4844;1607;4724;97;328;1403;4117;1500;4445
250390;201407;1950;5237;1593;4637;217;650;1053;3092;1270;3742
250400;201407;72429;199711;62855;184944;15243;47248;33505;100617;48748;147865
250403;201407;1562;5167;1472;5040;192;771;1088;3677;1280;4448
250407;201407;1192;3453;1040;3193;68;224;818;2485;886;2709
250410;201407;684;2181;602;2034;68;283;457;1528;525;1811
250415;201407;1826;5784;1675;5492;140;539;1240;3998;1380;4537
250420;201407;1344;4173;1242;4015;97;391;1029;3254;1126;3645
250430;201407;6752;18933;6319;18299;505;1770;5168;14681;5673;16451
250435;201407;1667;5027;1488;4682;229;835;873;2796;1102;3631
250440;201407;4645;13764;4369;13387;292;951;3623;11175;3915;12126
250450;201407;2094;5959;1862;5654;98;331;1658;5044;1756;5375
250460;201407;6528;19765;6074;19145;749;2521;4574;14556;5323;17077
250470;201407;1634;4543;1471;4311;154;551;1055;3000;1209;3551
250480;201407;4090;12249;3691;11673;161;663;3188;10039;3349;10702
250485;201407;635;1658;536;1496;26;95;424;1141;450;1236
250490;201407;4209;13674;4111;13530;901;3144;2628;8681;3529;11825
250500;201407;1947;5931;1802;5690;349;1119;1100;3551;1449;4670
250510;201407;4993;14053;4417;13261;313;1135;3624;10831;3937;11966
250520;201407;1919;5930;1824;5766;332;1182;1086;3353;1418;4535
250523;201407;1813;5750;1723;5625;245;840;1265;4180;1510;5020
250527;201407;1491;4518;1405;4406;63;266;1261;3913;1324;4179
250530;201407;687;2105;603;1996;50;168;493;1664;543;1832
250535;201407;1332;4268;1266;4133;84;366;1003;3211;1087;3577
250540;201407;2497;7453;2342;7281;81;250;2157;6782;2238;7032
250550;201407;908;3044;836;2932;66;278;643;2227;709;2505
250560;201407;1789;5749;1749;5690;142;504;1486;4851;1628;5355
250570;201407;2561;8421;2302;7912;201;799;1755;5979;1956;6778
250580;201407;1190;3226;970;2877;109;445;686;1926;795;2371
250590;201407;1057;3239;951;3098;90;375;736;2354;826;2729
250600;201407;7193;21144;6835;20617;493;1440;5717;17454;6210;18894
250610;201407;3533;10339;3272;9943;398;1328;2344;7118;2742;8446
250620;201407;870;2527;807;2405;153;504;513;1497;666;2001
250625;201407;2254;7339;2220;7293;84;211;2059;6872;2143;7083
250630;201407;10598;34092;10061;33144;2259;7944;5789;19131;8048;27075
250640;201407;3926;11682;3672;11384;288;1081;3090;9470;3378;10551
250650;201407;961;2813;890;2677;133;466;520;1583;653;2049
250660;201407;2131;5307;1628;4707;26;70;1546;4494;1572;4564
250670;201407;2785;9299;2645;9043;274;1129;1970;6702;2244;7831
250680;201407;5038;14464;4793;14119;270;911;4137;12220;4407;13131
250690;201407;6444;17205;6212;16898;578;1736;5292;14261;5870;15997
250700;201407;5442;16290;5057;15724;792;2661;3468;10693;4260;13354
250710;201407;4697;14828;4306;14315;655;2229;3029;10341;3684;12570
250720;201407;2643;7916;2515;7699;151;599;2109;6399;2260;6998
250730;201407;3756;11681;3576;11415;465;1656;2635;8349;3100;10005
250740;201407;2063;6105;1808;5671;204;743;1304;4025;1508;4768
250750;201407;104745;309813;98742;300618;17570;58595;65556;197357;83126;255952
250760;201407;2294;6790;2123;6536;191;711;1645;5012;1836;5723
250770;201407;4083;13948;3874;13661;726;2770;2476;8796;3202;11566
250780;201407;1932;5765;1667;5272;199;767;1082;3318;1281;4085
250790;201407;2506;8197;2373;8007;553;1814;1520;5318;2073;7132
250800;201407;2831;8176;2475;7577;156;571;1912;5728;2068;6299
250810;201407;1389;4091;1205;3815;118;473;950;2945;1068;3418
250820;201407;2076;6355;2001;6253;128;432;1683;5314;1811;5746
250830;201407;6051;20108;5707;19416;777;3079;3906;13078;4683;16157
250840;201407;1049;3372;915;3099;121;459;586;1997;707;2456
250850;201407;2458;7149;2187;6712;227;888;1435;4563;1662;5451
250855;201407;1105;3364;1043;3265;80;286;842;2599;922;2885
250860;201407;2969;10046;2721;9567;658;2617;1101;3783;1759;6400
250870;201407;1214;3484;1056;3224;70;279;778;2301;848;2580
250880;201407;1436;4187;1306;4002;192;617;929;2848;1121;3465
250890;201407;9870;31149;9212;30238;1584;5952;6154;19874;7738;25826
250900;201407;3119;10242;2772;9592;354;1245;1929;6788;2283;8033
250905;201407;2142;6738;2045;6610;334;1126;1481;4839;1815;5965
250910;201407;5529;16117;5161;15563;502;1674;4012;12090;4514;13764
250915;201407;1740;5186;1599;4979;144;442;1328;4207;1472;4649
250920;201407;3624;10338;3399;10027;462;1293;2457;7523;2919;8816
250930;201407;2019;6585;1933;6453;348;1327;1344;4418;1692;5745
250933;201407;1207;3919;1163;3848;130;451;859;2880;989;3331
250937;201407;878;2743;788;2560;117;457;479;1554;596;2011
250939;201407;1756;5450;1591;5179;222;780;1066;3455;1288;4235
250940;201407;4050;11902;3753;11435;252;899;2970;9113;3222;10012
250950;201407;1180;3827;1105;3725;43;149;990;3361;1033;3510
250960;201407;1349;4220;1202;4025;75;277;1011;3438;1086;3715
250970;201407;9216;25194;8227;23797;1206;3526;5742;16751;6948;20277
250980;201407;2723;8215;2493;7817;256;1032;1716;5162;1972;6194
250990;201407;2182;7498;2013;7160;295;1212;1380;4849;1675;6061
251000;201407;2591;7405;2132;6747;140;515;1707;5395;1847;5910
251010;201407;2888;8397;2630;8014;198;720;2093;6413;2291;7133
251020;201407;1720;5171;1585;4999;148;511;1313;4178;1461;4689
251030;201407;1350;3766;1225;3558;129;433;808;2362;937;2795
251040;201407;1964;6254;1770;5952;190;881;1266;4103;1456;4984
251050;201407;1167;3474;1034;3234;173;574;594;1931;767;2505
251060;201407;1055;2557;845;2294;87;302;646;1685;733;1987
251065;201407;594;1781;521;1671;70;259;323;993;393;1252
251070;201407;631;1795;584;1728;62;248;454;1255;516;1503
251080;201407;21754;61079;20194;58432;5275;15845;10905;32034;16180;47879
251090;201407;3091;9807;2751;9173;283;1108;1991;6562;2274;7670
251100;201407;1012;3291;892;3059;151;609;542;1804;693;2413
251110;201407;2170;6300;1922;5858;220;732;1319;4023;1539;4755
251120;201407;6007;20744;5820;20410;742;3101;4527;15563;5269;18664
251130;201407;4031;10566;3615;10105;39;116;3491;9784;3530;9900
251140;201407;4543;14004;4219;13497;238;945;3323;10593;3561;11538
251150;201407;2871;9292;2627;8940;355;1320;1890;6531;2245;7851
251160;201407;1906;6337;1826;6225;100;395;1593;5442;1693;5837
251170;201407;1450;4491;1404;4435;129;482;1151;3591;1280;4073
251180;201407;2949;8867;2709;8552;572;1817;1622;5266;2194;7083
251190;201407;4437;12698;4303;12543;278;820;3837;11225;4115;12045
251200;201407;4233;13197;4032;12938;215;749;3548;11442;3763;12191
251203;201407;1366;4308;1279;4124;109;457;806;2704;915;3161
251207;201407;1240;3882;1078;3578;91;392;743;2400;834;2792
251210;201407;8283;23778;7242;22378;981;2976;5372;16995;6353;19971
251220;201407;1330;3600;1162;3340;181;553;763;2262;944;2815
251230;201407;5288;15931;4666;15192;430;1581;3938;12815;4368;14396
251240;201407;3231;10653;3153;10533;335;1267;2521;8386;2856;9653
251250;201407;10766;32348;10007;31182;1404;4946;7240;22261;8644;27207
251260;201407;555;1706;492;1621;37;121;375;1251;412;1372
251270;201407;4319;13440;4027;13076;165;665;3604;11725;3769;12390
251272;201407;1401;4300;1313;4174;129;425;1041;3359;1170;3784
251274;201407;1033;3240;972;3122;130;517;592;1942;722;2459
251275;201407;1434;4065;1361;3954;151;562;1004;2819;1155;3381
251276;201407;1520;4539;1437;4388;215;717;892;2814;1107;3531
251278;201407;653;2098;568;1899;86;320;342;1183;428;1503
251280;201407;2394;7558;2290;7388;273;970;1727;5556;2000;6526
251290;201407;6266;17820;5934;17406;874;2931;4301;12350;5175;15281
251300;201407;766;2654;710;2569;72;331;513;1817;585;2148
251310;201407;3387;9837;3121;9460;208;780;2505;7511;2713;8291
251315;201407;1746;6175;1690;6073;294;1115;1075;3939;1369;5054
251320;201407;2181;6152;1801;5539;154;534;1284;4014;1438;4548
251330;201407;2084;5428;1723;4957;118;475;1465;4075;1583;4550
251335;201407;1014;3507;958;3400;99;447;698;2414;797;2861
251340;201407;4007;11127;3389;10197;357;1330;2366;6938;2723;8268
251350;201407;1631;5015;1487;4812;222;781;1008;3253;1230;4034
251360;201407;1888;6110;1766;5963;127;499;1487;5053;1614;5552
251365;201407;905;2682;727;2310;60;234;471;1473;531;1707
251370;201407;23339;77685;22863;76943;3671;14047;16729;55171;20400;69218
251380;201407;1426;4430;1245;4117;99;419;976;3159;1075;3578
251385;201407;885;2476;805;2350;78;266;556;1591;634;1857
251390;201407;5917;21068;5552;20449;1137;4445;3597;13334;4734;17779
251392;201407;1093;3235;1005;3095;97;311;744;2344;841;2655
251394;201407;629;1938;520;1725;41;162;369;1211;410;1373
251396;201407;883;2541;790;2380;99;332;563;1663;662;1995
251398;201407;1137;3312;949;2963;86;321;647;2004;733;2325
251400;201407;1378;3924;1258;3763;176;662;851;2443;1027;3105
251410;201407;1657;4327;1511;4087;182;557;1038;2857;1220;3414
251420;201407;2240;6445;1910;6080;193;692;1479;4679;1672;5371
251430;201407;1762;6223;1593;5947;122;539;1306;4881;1428;5420
251440;201407;1472;4434;1250;3999;159;572;889;2810;1048;3382
251445;201407;1668;5059;1581;4931;114;430;1333;4113;1447;4543
251450;201407;4893;15389;4371;14719;190;786;3760;12676;3950;13462
251455;201407;1221;3816;1082;3587;92;373;765;2545;857;2918
251460;201407;895;2755;860;2696;123;394;667;2114;790;2508
251465;201407;507;1575;462;1484;50;185;303;956;353;1141
251470;201407;1316;3808;1087;3382;133;486;640;2009;773;2495
251480;201407;1135;3097;1022;2910;67;247;816;2281;883;2528
251490;201407;2111;6243;1829;5861;321;1200;1164;3656;1485;4856
251500;201407;1797;5903;1743;5818;186;698;1372;4535;1558;5233
251510;201407;2661;8919;2472;8508;435;1590;1523;5313;1958;6903
251520;201407;1130;3092;1020;2918;154;467;560;1623;714;2090
251530;201407;12222;35543;11704;34800;740;2722;10008;29378;10748;32100
251540;201407;2898;9512;2671;9028;263;1063;2028;6821;2291;7884
251550;201407;4042;10110;3384;9272;190;652;2774;7426;2964;8078
251560;201407;752;2327;692;2227;105;421;422;1244;527;1665
251570;201407;1083;3184;917;2835;115;435;588;1853;703;2288
251580;201407;2227;6150;2048;5907;347;888;1472;4407;1819;5295
251590;201407;1717;5692;1689;5661;117;437;1452;4928;1569;5365
251593;201407;1046;3315;988;3226;148;545;640;2020;788;2565
251597;201407;2022;6224;1944;6106;182;678;1521;4694;1703;5372
251600;201407;7500;22041;7108;21392;959;2838;5257;16225;6216;19063
251610;201407;3663;11036;3388;10673;349;1209;2633;8386;2982;9595
251615;201407;1226;3537;1046;3223;113;412;673;2119;786;2531
251620;201407;17721;50254;15612;47564;1995;6280;11574;35804;13569;42084
251630;201407;5438;13809;4742;12952;419;1174;3729;10319;4148;11493
251640;201407;2727;7895;2227;6992;235;882;1591;4950;1826;5832
251650;201407;4434;12623;3984;12054;341;1093;3262;10050;3603;11143
251660;201407;3654;12167;3353;11690;286;1299;2655;9076;2941;10375
251670;201407;4089;12188;3681;11630;87;295;3340;10626;3427;10921
251675;201407;773;2555;728;2486;168;610;413;1390;581;2000
251680;201407;2927;8187;2387;7395;146;592;1956;5956;2102;6548
251690;201407;3613;11105;3358;10644;328;1168;2430;7642;2758;8810
251700;201407;2171;7094;2048;6927;212;784;1642;5588;1854;6372
251710;201407;962;2527;729;2116;106;371;381;1061;487;1432
251720;201407;1424;4410;1302;4199;122;484;995;3151;1117;3635
251740;201407;755;2143;612;1889;103;349;361;1128;464;1477
260005;201407;25395;63010;22338;58734;4780;12721;13630;35922;18410;48643
260010;201407;9775;26711;7852;24312;939;3112;5834;18115;6773;21227
260020;201407;5893;17354;5233;16355;574;1723;3861;12558;4435;14281
260030;201407;5384;16294;4980;15680;486;1708;3911;12224;4397;13932
260040;201407;10336;25057;8560;23044;663;1458;7060;19732;7723;21190
260050;201407;11109;35505;10313;34592;663;2285;8985;30505;9648;32790
260060;201407;4129;11502;3776;10933;345;1022;2969;8688;3314;9710
260070;201407;9765;29252;9282;28528;1963;6327;5942;18344;7905;24671
260080;201407;5371;15374;4761;14484;484;1678;3540;10635;4024;12313
260090;201407;5269;14794;4956;14352;1190;3283;3283;9840;4473;13123
260100;201407;3561;9527;3238;9092;248;857;2614;7412;2862;8269
260105;201407;4715;14031;4538;13690;774;2493;3063;9173;3837;11666
260110;201407;22112;64653;20385;62562;1421;4329;17448;54158;18869;58487
260120;201407;11336;35071;10651;33854;2943;9439;5570;18471;8513;27910
260130;201407;3166;9064;3000;8795;478;1291;2150;6493;2628;7784
260140;201407;13654;35104;11671;32660;1181;3582;9018;25608;10199;29190
260150;201407;3173;9234;2830;8739;226;825;2228;6929;2454;7754
260160;201407;6073;18500;5465;17780;516;1761;4459;14776;4975;16537
260170;201407;17950;49342;17196;48350;1433;3731;14243;40691;15676;44422
260180;201407;3552;10924;3239;10475;239;929;2641;8479;2880;9408
260190;201407;16391;39487;15429;38297;885;2360;13422;33317;14307;35677
260200;201407;11573;33147;10550;31646;1137;3587;7878;24414;9015;28001
260210;201407;11605;35840;10665;34481;872;3082;8634;28214;9506;31296
260220;201407;9383;28986;9122;28614;798;3083;7660;23555;8458;26638
260230;201407;9927;29116;9419;28424;688;2105;7744;23826;8432;25931
260240;201407;2998;9263;2623;8731;377;1342;1874;6275;2251;7617
260250;201407;2778;7472;2558;7199;195;580;2091;5921;2286;6501
260260;201407;11769;34324;11406;33821;1097;3538;9240;27941;10337;31479
260270;201407;3604;10885;3374;10544;377;1438;2587;7938;2964;9376
260280;201407;13120;43105;12064;41464;771;2945;10105;35133;10876;38078
260290;201407;34893;105953;33580;103763;5854;20181;22708;69116;28562;89297
260300;201407;8473;25839;7469;24362;571;2331;5929;19273;6500;21604
260310;201407;5193;15550;4880;15070;1524;4349;2508;8417;4032;12766
260320;201407;7012;23489;6537;22795;547;2054;5256;18599;5803;20653
260330;201407;3184;9858;2952;9471;304;1190;2002;6629;2306;7819
260340;201407;1907;5671;1797;5507;101;369;1569;4773;1670;5142
260345;201407;26846;87737;25635;85304;7419;26765;12342;39745;19761;66510
260350;201407;4381;12559;4154;12201;361;1183;3324;9723;3685;10906
260360;201407;2457;7640;2344;7449;475;1645;1435;4580;1910;6225
260370;201407;6166;19083;5593;18069;711;2500;3994;13059;4705;15559
260380;201407;5075;16566;4686;16044;494;1728;3604;12540;4098;14268
260390;201407;4812;15052;4181;14049;499;1885;2987;9878;3486;11763
260392;201407;3581;11305;3345;11001;153;589;2962;9746;3115;10335
260400;201407;14121;41575;13569;40663;2324;7952;9366;27389;11690;35341
260410;201407;63713;188639;60307;182986;20065;61190;28067;88327;48132;149517
260415;201407;4130;13187;3598;12143;520;2089;2228;7396;2748;9485
260420;201407;12302;28854;11226;27712;821;2125;9577;23729;10398;25854
260430;201407;2755;9214;2489;8791;306;1255;1819;6328;2125;7583
260440;201407;3491;10691;3228;10160;599;2055;1946;5998;2545;8053
260450;201407;5255;15967;5004;15540;453;1543;4004;12463;4457;14006
260460;201407;5905;18285;5541;17728;952;3385;3544;11148;4496;14533
260470;201407;5166;14941;4857;14513;515;1609;3866;11747;4381;13356
260480;201407;4017;11762;3580;11099;615;2123;2413;7436;3028;9559
260490;201407;6149;15968;5397;14745;645;2091;3701;10121;4346;12212
260500;201407;6882;18995;6367;18256;723;2162;4685;13638;5408;15800
260510;201407;10692;28154;9922;27102;831;2317;7904;22298;8735;24615
260515;201407;4686;14646;3662;12478;382;1482;2285;7808;2667;9290
260520;201407;16341;44270;15822;43563;3514;9371;10472;29603;13986;38974
260530;201407;10287;30829;8991;29000;579;1780;7637;25081;8216;26861
260540;201407;5928;15362;5599;14998;680;1528;4521;12494;5201;14022
260545;201407;42;162;29;119;4;19;7;27;11;46
260550;201407;2900;9667;2571;9015;648;2536;1194;4137;1842;6673
260560;201407;6861;17615;6135;16583;318;889;5360;14505;5678;15394
260570;201407;6739;23081;6264;22258;927;3647;4416;15793;5343;19440
260580;201407;3986;11044;3765;10699;291;942;3141;8773;3432;9715
260590;201407;6022;15285;5786;15010;255;556;5267;13856;5522;14412
260600;201407;26573;82661;25164;80279;4216;14315;16846;54251;21062;68566
260610;201407;7171;21478;6834;21009;1232;3988;4792;14713;6024;18701
260620;201407;17641;54643;16974;53521;3262;11488;10874;33585;14136;45073
260630;201407;2374;7026;2053;6498;220;835;1524;4772;1744;5607
260640;201407;17759;48867;16786;47488;2367;7098;12075;34171;14442;41269
260650;201407;5673;17804;5304;17181;741;2389;3615;12483;4356;14872
260660;201407;8576;23893;7721;22804;538;1658;6499;19396;7037;21054
260670;201407;2479;6956;2085;6421;292;1009;1408;4344;1700;5353
260680;201407;23715;65281;22243;62750;5030;14785;12468;34913;17498;49698
260690;201407;3673;10134;3170;9340;198;721;2585;7538;2783;8259
260700;201407;5747;17098;5611;16955;95;182;5433;16634;5528;16816
260710;201407;1354;4146;1235;3974;146;563;934;2957;1080;3520
260720;201407;17431;57535;16612;56066;4376;15035;9070;31478;13446;46513
260730;201407;7436;24519;6669;23366;887;3301;4849;17215;5736;20516
260740;201407;1369;4183;1201;3876;186;653;732;2375;918;3028
260750;201407;6808;21732;6354;21105;573;1787;5308;18008;5881;19795
260760;201407;4862;13472;4563;13080;487;1526;3553;10185;4040;11711
260765;201407;8222;28681;7951;28270;1423;5706;5335;18945;6758;24651
260770;201407;4368;11360;3983;10859;255;888;3179;8490;3434;9378
260775;201407;5380;15631;5095;15201;587;2111;3683;10651;4270;12762
260780;201407;4033;13274;3871;12991;934;3489;2250;7463;3184;10952
260790;201407;121962;315469;117250;308613;25874;69963;72819;192358;98693;262321
260795;201407;3062;9845;2846;9504;473;1675;1892;6424;2365;8099
260800;201407;4840;13229;4492;12763;228;939;3898;10771;4126;11710
260805;201407;4152;12150;3737;11501;517;1720;2587;7979;3104;9699
260810;201407;7471;21664;7284;21420;470;1515;6362;18727;6832;20242
260820;201407;4649;13330;4339;12905;1130;3423;2544;7590;3674;11013
260825;201407;3093;9915;2882;9597;300;990;2289;7743;2589;8733
260830;201407;3775;12232;3493;11723;997;3176;1949;6900;2946;10076
260840;201407;4253;12442;3894;11920;293;1140;3215;9674;3508;10814
260845;201407;4294;12711;4000;12139;672;2168;2711;8238;3383;10406
260850;201407;5017;17112;4550;16093;1126;4467;2241;7745;3367;12212
260860;201407;3213;10332;2969;9919;306;1085;2239;7558;2545;8643
260870;201407;4223;11781;3857;11322;524;1426;2904;8768;3428;10194
260875;201407;7475;20086;6753;18950;1080;3091;4424;12789;5504;15880
260880;201407;9361;29536;8878;28866;901;2969;7231;23791;8132;26760
260890;201407;15078;43416;14361;42307;1657;5432;10652;31449;12309;36881
260900;201407;6183;19069;5278;17478;929;3291;3170;10580;4099;13871
260910;201407;3172;9524;2885;9091;248;904;2310;7296;2558;8200
260915;201407;4623;15439;4462;15208;124;412;4122;14264;4246;14676
260920;201407;3502;10670;3332;10441;488;1633;2469;7920;2957;9553
260930;201407;4282;13437;3793;12721;504;1745;2747;9329;3251;11074
260940;201407;15352;42471;14138;40385;2508;8347;8499;23815;11007;32162
260950;201407;6233;20005;5903;19364;886;3680;3745;11562;4631;15242
260960;201407;68227;191135;64634;185347;14117;42225;38167;110486;52284;152711
260970;201407;5474;17489;5093;16935;594;2306;3752;12424;4346;14730
260980;201407;4048;12961;3850;12696;270;923;3259;10966;3529;11889
260990;201407;18407;57410;17023;55567;2041;6347;12912;43931;14953;50278
261000;201407;15955;44702;12945;39849;2723;8815;7057;22279;9780;31094
261010;201407;2809;7837;2632;7612;220;467;2246;6795;2466;7262
261020;201407;6200;18499;5693;17732;452;1755;4581;13874;5033;15629
261030;201407;3545;11620;3358;11298;346;1289;2654;8889;3000;10178
261040;201407;5455;17597;4709;16358;537;2168;3403;11747;3940;13915
261050;201407;8812;25101;8229;24176;1173;3511;5625;16510;6798;20021
261060;201407;11653;35916;11168;35116;1583;5650;8192;25323;9775;30973
261070;201407;51376;132302;46410;125320;9874;27387;27864;76084;37738;103471
261080;201407;5874;17840;5545;17317;421;1247;4660;14819;5081;16066
261090;201407;16722;46783;15627;45311;1613;4770;12432;36472;14045;41242
261100;201407;7478;24005;6901;23087;730;2795;5185;17345;5915;20140
261110;201407;68053;196088;62213;187631;15321;46323;34734;110859;50055;157182
261120;201407;3709;10025;3359;9587;151;461;2967;8520;3118;8981
261130;201407;7211;18768;6898;18416;264;712;6333;16931;6597;17643
261140;201407;3295;9353;3031;8934;548;1785;1916;5561;2464;7346
261150;201407;5808;17226;5239;16400;727;2492;3725;11760;4452;14252
261153;201407;2008;5853;1693;5404;100;384;1387;4444;1487;4828
261160;201407;227964;597552;217308;582918;49357;133018;129095;356792;178452;489810
261170;201407;6163;17234;5697;16575;819;2392;4260;12533;5079;14925
261180;201407;9763;27761;9400;27221;1115;3267;7212;21077;8327;24344
261190;201407;5566;17504;5258;17107;797;3321;3643;11377;4440;14698
261200;201407;4007;9860;3714;9482;575;1449;2679;6971;3254;8420
261210;201407;2005;5312;1925;5208;134;354;1680;4611;1814;4965
261220;201407;13246;42722;11466;38833;2336;8522;5946;20213;8282;28735
261230;201407;4157;12882;3893;12535;166;582;3472;11236;3638;11818
261240;201407;5020;14854;4764;14382;790;2299;3339;10257;4129;12556
261245;201407;3919;12310;3409;11453;270;1132;2522;8531;2792;9663
261247;201407;3582;11027;3089;10106;387;1343;2182;7207;2569;8550
261250;201407;19709;53150;18942;52137;3417;9270;14021;39216;17438;48486
261255;201407;4446;13555;3982;12792;325;1163;3138;10224;3463;11387
261260;201407;12375;35450;11332;34224;693;1927;9868;30396;10561;32323
261270;201407;3865;11227;3587;10797;480;1562;2522;7568;3002;9130
261280;201407;2784;8577;2542;8223;262;965;1929;6236;2191;7201
261290;201407;3116;8856;2806;8466;224;752;2306;7022;2530;7774
261300;201407;10661;35497;9590;33630;1677;6628;6053;21111;7730;27739
261310;201407;8604;26135;8191;25437;1994;6383;4814;15060;6808;21443
261320;201407;6074;19002;5725;18343;621;1962;4369;14320;4990;16282
261330;201407;5543;16450;5342;16153;553;1715;4231;12869;4784;14584
261340;201407;4632;15190;4413;14835;671;2649;2860;9568;3531;12217
261350;201407;8127;27600;7706;26860;646;2719;6062;20973;6708;23692
261360;201407;9579;24928;8707;23747;1163;3286;6157;17102;7320;20388
261370;201407;21242;63296;20079;61522;4223;13517;12671;39032;16894;52549
261380;201407;4235;14636;3937;14114;622;2343;2664;9730;3286;12073
261390;201407;17432;53766;15946;51200;2795;9807;9897;31654;12692;41461
261400;201407;4946;17277;4520;16430;607;2460;3094;11367;3701;13827
261410;201407;8575;25112;8059;24313;1128;3444;5909;18157;7037;21601
261420;201407;8151;27414;7875;26997;2023;7506;4499;15678;6522;23184
261430;201407;3651;11343;3108;10606;414;1410;2281;7980;2695;9390
261440;201407;1689;5208;1565;5021;115;481;1263;4009;1378;4490
261450;201407;14482;41688;14112;41205;852;2601;12619;36930;13471;39531
261460;201407;8540;24690;7991;23922;827;2272;6011;19409;6838;21681
261470;201407;4014;10927;3689;10544;214;659;3189;9091;3403;9750
261480;201407;3543;12986;3303;12546;405;1723;2477;9273;2882;10996
261485;201407;5050;15630;4639;14904;942;3371;2698;8621;3640;11992
261500;201407;5899;16380;5196;15434;636;1678;3985;12356;4621;14034
261510;201407;2079;6585;1951;6397;169;562;1538;5117;1707;5679
261520;201407;2640;8660;2348;8141;196;792;1684;5862;1880;6654
261530;201407;12586;40897;11183;38168;2480;9261;5311;18159;7791;27420
261540;201407;7460;24167;7184;23667;1401;4554;4852;16346;6253;20900
261550;201407;3518;10571;3362;10341;425;1625;2638;7849;3063;9474
261560;201407;7042;22938;6454;22174;1224;4277;4501;15839;5725;20116
261570;201407;3655;11232;3249;10595;492;1666;2211;7272;2703;8938
261580;201407;5908;18791;5291;17791;471;1726;4207;14407;4678;16133
261590;201407;2917;8105;2566;7625;320;1016;1847;5591;2167;6607
261600;201407;5276;14629;4538;13601;501;1575;3406;10336;3907;11911
261610;201407;2318;7000;2012;6548;129;547;1647;5241;1776;5788
261618;201407;2590;7418;2435;7208;258;809;1918;5647;2176;6456
261620;201407;4646;14307;4403;13929;566;1843;3163;10221;3729;12064
261630;201407;8209;24185;7188;22333;1326;4685;3994;12071;5320;16756
261640;201407;30632;80118;28265;77107;2229;5932;23422;65153;25651;71085
261650;201407;3854;12268;3613;11910;503;1803;2643;8742;3146;10545
270010;201407;4525;17267;4144;16494;515;2336;2857;11438;3372;13774
270020;201407;4024;12210;3765;11812;486;1708;2813;8748;3299;10456
270030;201407;46157;139578;43936;136108;11346;35482;25500;80875;36846;116357
270040;201407;10481;32509;9963;31914;1665;4791;7425;24796;9090;29587
270050;201407;4045;11845;3755;11461;413;1494;2889;8722;3302;10216
270060;201407;1707;5624;1619;5499;369;1364;982;3356;1351;4720
270070;201407;4234;13175;3929;12761;198;862;3388;10855;3586;11717
270080;201407;1351;4236;1213;4015;218;801;791;2576;1009;3377
270090;201407;2102;6650;2021;6510;70;273;1834;5866;1904;6139
270100;201407;6484;20197;6205;19819;1282;4294;4109;13124;5391;17418
270110;201407;3488;9888;3206;9561;546;1619;2120;6782;2666;8401
270120;201407;3104;9080;2809;8686;154;532;2427;7573;2581;8105
270130;201407;5219;16355;4954;16045;520;1524;4049;13540;4569;15064
270135;201407;1774;5025;1688;4930;120;205;1515;4598;1635;4803
270140;201407;9835;24757;8699;23297;775;2970;6894;17362;7669;20332
270150;201407;2719;9360;2658;9281;205;797;2305;8060;2510;8857
270160;201407;5115;17151;4712;16650;307;1123;3991;14219;4298;15342
270170;201407;4099;13481;3785;13015;821;3258;2131;7236;2952;10494
270180;201407;2327;7714;2072;7388;162;743;1659;5875;1821;6618
270190;201407;1942;6367;1841;6216;148;591;1453;4923;1601;5514
270200;201407;2778;9353;2602;9076;279;1187;1997;6829;2276;8016
270210;201407;4507;14736;4350;14533;409;1628;3636;12053;4045;13681
270220;201407;1730;5444;1601;5195;310;1132;867;2868;1177;4000
270230;201407;11338;37059;9990;34903;1494;6183;6613;22766;8107;28949
270235;201407;6488;21242;6149;20675;421;1740;5075;16961;5496;18701
270240;201407;9881;29860;8708;28330;1515;5134;5807;19142;7322;24276
270250;201407;3564;9113;3243;8752;176;454;2929;7950;3105;8404
270255;201407;5163;15811;4290;14278;405;1687;3048;9992;3453;11679
270260;201407;6422;20785;6259;20500;875;3253;4664;15374;5539;18627
270270;201407;1224;3546;1131;3407;171;542;745;2205;916;2747
270280;201407;3745;11103;3509;10763;474;1673;2520;7592;2994;9265
270290;201407;8552;30049;8121;29292;885;3713;6288;22528;7173;26241
270300;201407;3308;11505;3137;11303;185;792;2709;9805;2894;10597
270310;201407;7456;23064;6713;21795;443;1967;5455;17306;5898;19273
270320;201407;6472;21043;6260;20683;1532;5701;3576;11882;5108;17583
270330;201407;4932;16272;4642;15881;466;1709;3724;12872;4190;14581
270340;201407;1814;5625;1636;5388;200;699;1231;4135;1431;4834
270350;201407;2107;5862;1953;5671;276;807;1344;4133;1620;4940
270360;201407;2104;6611;2053;6548;247;757;1684;5510;1931;6267
270370;201407;1743;5680;1605;5441;181;699;1093;3825;1274;4524
270375;201407;2980;9066;2750;8727;410;1544;1906;5855;2316;7399
270380;201407;6083;18593;5765;18149;638;2002;4460;14377;5098;16379
270390;201407;1459;3999;1311;3811;201;668;904;2542;1105;3210
270400;201407;6019;18668;5508;17887;500;1939;3937;12580;4437;14519
270410;201407;5125;15857;4878;15393;606;2112;3573;11178;4179;13290
270420;201407;5634;18464;5482;18251;298;1391;4612;15100;4910;16491
270430;201407;142757;417792;136589;409080;35919;108522;76826;237629;112745;346151
270440;201407;5122;15727;4822;15280;386;1410;3822;12217;4208;13627
270450;201407;6660;20865;6438;20579;603;2208;5149;16524;5752;18732
270460;201407;3690;10092;3324;9588;258;908;2714;7697;2972;8605
270470;201407;11101;35976;10525;34995;1611;5372;7126;24436;8737;29808
270480;201407;3125;9948;2876;9500;363;1444;1900;6062;2263;7506
270490;201407;1011;3245;954;3162;91;365;725;2379;816;2744
270500;201407;5473;18690;5242;18376;486;1766;4210;15115;4696;16881
270510;201407;6195;19063;5666;18321;891;3662;4077;12577;4968;16239
270520;201407;3790;12276;3557;11902;886;3230;1895;6415;2781;9645
270530;201407;1578;4636;1398;4404;210;662;960;3128;1170;3790
270540;201407;2097;7219;1929;6972;180;836;1527;5433;1707;6269
270550;201407;7217;21787;6406;20716;1077;3592;4272;14229;5349;17821
270560;201407;3101;9695;2927;9418;516;1941;2023;6315;2539;8256
270570;201407;4435;14433;4054;13832;494;2008;2794;9505;3288;11513
270580;201407;2096;6965;2016;6837;284;1008;1507;5190;1791;6198
270590;201407;1430;4854;1343;4703;79;339;1173;4097;1252;4436
270600;201407;2943;9872;2659;9435;242;1182;2031;7016;2273;8198
270610;201407;3297;10462;3061;10114;323;1154;2413;7949;2736;9103
270620;201407;1509;5077;1377;4882;154;703;1057;3652;1211;4355
270630;201407;18552;51997;17347;50121;2533;7377;12519;36751;15052;44128
270640;201407;6042;18718;5469;18005;480;1950;4423;14320;4903;16270
270642;201407;2515;8660;2349;8393;387;1537;1572;5671;1959;7208
270644;201407;2462;7199;2220;6930;174;503;1911;6074;2085;6577
270650;201407;4154;13192;3990;12964;863;3376;2406;7535;3269;10911
270660;201407;2491;6429;1989;5668;149;521;1408;3983;1557;4504
270670;201407;16223;43764;14139;41266;1803;5318;10517;31633;12320;36951
270680;201407;4235;12984;4089;12807;211;600;3656;11603;3867;12203
270690;201407;9131;25895;8470;25104;2781;7866;4257;13527;7038;21393
270700;201407;798;2496;756;2428;138;536;482;1498;620;2034
270710;201407;5906;19692;5660;19361;631;2282;4517;15593;5148;17875
270720;201407;3423;11615;3158;11153;259;1196;2535;8823;2794;10019
270730;201407;6759;20888;6419;20464;958;3077;4881;15838;5839;18915
270740;201407;2431;7145;2281;6930;362;1226;1535;4606;1897;5832
270750;201407;4938;15927;4599;15408;518;1852;3539;11905;4057;13757
270760;201407;3610;10858;3266;10288;391;1317;2406;7615;2797;8932
270770;201407;18329;49816;15658;46544;3037;9356;9825;29991;12862;39347
270780;201407;1973;6412;1837;6202;258;931;1301;4442;1559;5373
270790;201407;1740;5472;1589;5228;376;1342;882;2872;1258;4214
270800;201407;11489;34592;10769;33636;1015;3432;8739;27359;9754;30791
270810;201407;3472;10714;2841;9564;377;1463;1788;6024;2165;7487
270820;201407;1907;6441;1740;6140;274;1107;1158;4070;1432;5177
270830;201407;5528;16819;5035;16191;1073;3849;3172;10258;4245;14107
270840;201407;7592;25937;6916;25081;477;2247;5781;20754;6258;23001
270850;201407;7676;25332;7505;25125;1392;5624;5220;16768;6612;22392
270860;201407;11748;35403;10989;34369;1673;6074;8027;24564;9700;30638
270870;201407;2316;6868;1885;5955;309;1021;1135;3600;1444;4621
270880;201407;7968;26092;7525;25437;553;2373;6225;20733;6778;23106
270890;201407;2704;8257;2508;7929;410;1525;1745;5383;2155;6908
270895;201407;3074;11396;2920;11194;253;1023;2420;9423;2673;10446
270900;201407;1928;5286;1570;4769;108;420;1195;3542;1303;3962
270910;201407;3299;11519;3226;11374;338;1533;2565;8779;2903;10312
270915;201407;10112;34398;9179;32711;1781;7278;5320;18735;7101;26013
270920;201407;6511;20335;6120;19788;295;1345;5374;17179;5669;18524
270930;201407;17462;47784;14521;44110;2761;8900;8752;27249;11513;36149
270940;201407;5971;20188;5721;19893;685;2690;4413;15373;5098;18063
280010;201407;724;2154;634;2006;69;275;412;1274;481;1549
280020;201407;5110;15230;4526;14166;908;2985;2786;8744;3694;11729
280030;201407;75623;201421;67219;188782;16811;49278;34755;99235;51566;148513
280040;201407;3235;10130;2900;9655;364;1220;2143;7361;2507;8581
280050;201407;4155;13398;3875;12959;1159;3966;1959;6827;3118;10793
280060;201407;4369;14651;4169;14311;890;3283;2520;8753;3410;12036
280067;201407;7726;22047;6574;20485;752;2533;4880;15228;5632;17761
280070;201407;1938;6668;1849;6531;320;1215;1317;4691;1637;5906
280100;201407;4117;12920;3684;12146;987;3343;1801;6118;2788;9461
280110;201407;1453;4402;1339;4217;84;332;1106;3457;1190;3789
280120;201407;7635;24466;7075;23579;1072;3296;5060;17680;6132;20976
280130;201407;8068;23158;7522;22360;1273;4197;5042;14932;6315;19129
280140;201407;5718;15724;5182;15003;571;1681;4031;11788;4602;13469
280150;201407;3464;10767;3193;10272;487;1848;2085;6454;2572;8302
280160;201407;1550;4421;1397;4189;175;599;1019;3036;1194;3635
280170;201407;4753;14231;4319;13641;500;1493;3363;10984;3863;12477
280190;201407;1180;3380;1045;3164;98;385;752;2183;850;2568
280200;201407;1117;3507;1046;3386;169;674;719;2232;888;2906
280210;201407;13389;41819;12566;40640;2531;8288;8178;27300;10709;35588
280220;201407;1606;4922;1525;4807;104;400;1306;4096;1410;4496
280230;201407;3914;11529;3512;10863;693;2161;2099;6709;2792;8870
280240;201407;3576;10626;3260;10134;280;834;2577;8133;2857;8967
280250;201407;823;2202;717;2044;139;465;429;1119;568;1584
280260;201407;2103;5546;1922;5321;121;325;1668;4658;1789;4983
280270;201407;2284;7109;1999;6639;140;555;1558;5100;1698;5655
280280;201407;4149;13739;3855;13251;927;2704;2167;8340;3094;11044
280290;201407;17257;54890;15751;52393;2771;9876;10294;34713;13065;44589
280300;201407;10226;31168;9473;30305;816;2674;7853;25522;8669;28196
280310;201407;1469;4168;1284;3883;116;445;870;2540;986;2985
280320;201407;8093;26831;7486;25740;1453;5543;4087;14066;5540;19609
280330;201407;4846;13729;4523;13290;579;1873;3476;10181;4055;12054
280340;201407;3850;11444;3659;11191;341;1122;2910;9092;3251;10214
280350;201407;21945;63970;20373;61644;2849;8741;14629;45128;17478;53869
280360;201407;5996;19084;5667;18569;1169;4290;3450;11177;4619;15467
280370;201407;2003;5711;1817;5420;220;751;1331;3903;1551;4654
280380;201407;1022;3119;943;3018;101;389;734;2321;835;2710
280390;201407;3316;9806;2898;9050;607;1803;1778;5674;2385;7477
280400;201407;4562;13126;4159;12586;972;2796;2593;8252;3565;11048
280410;201407;2443;7957;2161;7417;384;1506;1290;4312;1674;5818
280420;201407;4304;12451;3997;11980;255;781;3451;10433;3706;11214
280430;201407;2302;5999;2126;5782;157;514;1775;4812;1932;5326
280440;201407;5128;15057;4781;14633;473;1428;3970;12334;4443;13762
280445;201407;2470;7129;2271;6780;109;417;1865;5471;1974;5888
280450;201407;9225;24921;8514;24084;743;1706;7171;21052;7914;22758
280460;201407;7246;19518;6461;18427;1026;3028;4537;13222;5563;16250
280470;201407;1868;5597;1693;5339;201;657;1268;4040;1469;4697
280480;201407;31516;95216;30295;93450;5099;17901;20531;62155;25630;80056
280490;201407;3798;11696;3409;10964;397;1433;2454;7849;2851;9282
280500;201407;871;2345;820;2280;26;81;738;2035;764;2116
280510;201407;2781;8188;2401;7682;308;1106;1780;5743;2088;6849
280520;201407;1762;5041;1619;4856;183;481;1277;3984;1460;4465
280530;201407;2215;6653;2097;6499;230;765;1682;5278;1912;6043
280540;201407;9403;25522;8794;24705;344;1138;7847;21951;8191;23089
280550;201407;6713;18362;5869;17016;634;2076;4287;12311;4921;14387
280560;201407;8063;23794;7580;23020;624;2022;6142;18648;6766;20670
280570;201407;6941;19314;6249;18421;865;2859;4393;12900;5258;15759
280580;201407;5507;17087;4707;15708;853;2893;2980;10237;3833;13130
280590;201407;2425;7395;2225;7153;282;1177;1622;5132;1904;6309
280600;201407;4066;12531;3816;12108;414;1546;2779;8725;3193;10271
280610;201407;2403;7005;2249;6779;316;1081;1549;4607;1865;5688
280620;201407;5271;16134;4686;15022;790;2549;3072;10053;3862;12602
280630;201407;3832;12592;3665;12334;390;1172;2942;10283;3332;11455
280640;201407;2298;6623;2155;6459;105;247;1971;6021;2076;6268
280650;201407;1166;3610;1057;3413;174;619;707;2295;881;2914
280660;201407;2687;7825;2576;7658;323;1004;2090;6190;2413;7194
280670;201407;15023;40007;14148;38823;1667;4839;10640;29171;12307;34010
280680;201407;2880;7650;2461;7067;158;509;2066;5931;2224;6440
280690;201407;1025;2930;882;2722;137;459;582;1764;719;2223
280700;201407;1194;3509;1037;3272;106;320;758;2450;864;2770
280710;201407;11169;30486;10427;29596;762;2027;8909;25556;9671;27583
280720;201407;2425;6653;2167;6353;234;713;1640;4895;1874;5608
280730;201407;964;2912;922;2854;80;244;780;2451;860;2695
280740;201407;13173;36021;11452;33493;1836;5191;7741;23313;9577;28504
280750;201407;3654;11263;3349;10721;333;1277;2407;7644;2740;8921
280760;201407;5858;18175;5361;17517;704;2239;3973;13536;4677;15775
290010;201407;3066;6867;2240;5599;78;321;1784;4205;1862;4526
290020;201407;5025;15876;4587;15425;391;1105;3987;13772;4378;14877
290030;201407;3313;10540;3180;10333;443;1554;2402;7748;2845;9302
290035;201407;4691;12556;4200;11922;312;918;3480;10050;3792;10968
290040;201407;3865;11177;3511;10757;278;1075;2869;8662;3147;9737
290050;201407;2746;8984;2562;8703;249;958;1967;6715;2216;7673
290060;201407;1338;3449;1118;3182;209;681;783;2162;992;2843
290070;201407;31409;82521;27275;77305;5844;16751;15228;45337;21072;62088
290080;201407;5997;18393;5287;17482;657;2205;3980;13515;4637;15720
290090;201407;2284;5073;1831;4598;201;499;1508;3857;1709;4356
290100;201407;10301;29658;9115;27699;1704;5153;5543;17577;7247;22730
290110;201407;5339;16153;5137;15819;874;2977;3515;10676;4389;13653
290115;201407;4993;14960;4411;14187;347;1196;3446;11276;3793;12472
290120;201407;6968;18958;6411;18263;421;1185;5569;15960;5990;17145
290130;201407;4596;12137;3972;11390;340;1055;3223;9216;3563;10271
290135;201407;5276;13565;4614;12528;458;1495;3158;8443;3616;9938
290140;201407;4086;13076;3577;12418;329;1214;2969;10363;3298;11577
290150;201407;2138;6384;2041;6251;184;580;1713;5268;1897;5848
290160;201407;3564;9715;3478;9611;300;568;3081;8799;3381;9367
290170;201407;2867;9626;2640;9267;257;1012;2166;7619;2423;8631
290180;201407;3103;8868;2720;8296;289;987;2003;6143;2292;7130
290190;201407;4195;13904;4057;13668;450;1572;3079;10502;3529;12074
290195;201407;2225;6234;1905;5755;150;543;1496;4528;1646;5071
290200;201407;3902;12531;3571;11951;383;1349;2713;9150;3096;10499
290205;201407;3006;9373;2754;8978;368;1454;1981;6314;2349;7768
290210;201407;15839;43768;14758;42465;2657;6434;10268;31950;12925;38384
290220;201407;2451;7460;2348;7301;285;1050;1719;5217;2004;6267
290225;201407;3104;8292;2909;8084;182;365;2612;7477;2794;7842
290230;201407;2381;7907;2325;7834;231;818;1934;6581;2165;7399
290240;201407;3921;10418;3542;9889;381;1149;2664;7341;3045;8490
290250;201407;3873;12273;3298;11380;289;1063;2550;8909;2839;9972
290260;201407;4922;14850;4441;14118;458;1616;3461;11011;3919;12627
290265;201407;3452;11145;3244;10780;321;1235;2485;8251;2806;9486
290270;201407;12365;45106;11631;43997;1582;6271;8593;33113;10175;39384
290280;201407;5258;17422;4975;16902;596;2122;3619;12580;4215;14702
290290;201407;9760;31582;8926;30212;1618;5602;5893;20445;7511;26047
290300;201407;4362;12610;3151;10321;284;890;2168;7392;2452;8282
290310;201407;1552;4747;1446;4591;243;871;963;3011;1206;3882
290320;201407;27483;84254;24367;80098;5481;19014;14469;48378;19950;67392
290323;201407;4172;11229;3451;10458;219;767;2966;8955;3185;9722
290327;201407;4122;13190;3772;12524;574;2002;2576;8575;3150;10577
290330;201407;1933;5085;1844;4988;231;705;1510;4030;1741;4735
290340;201407;5131;16215;4751;15708;1151;3815;2750;9361;3901;13176
290350;201407;5046;15281;4168;14089;577;1979;2870;9988;3447;11967
290360;201407;4354;13644;3846;12939;218;769;3282;11208;3500;11977
290370;201407;4615;13748;4260;13298;457;1418;3473;11008;3930;12426
290380;201407;5636;16551;4975;15599;445;1495;3949;12448;4394;13943
290390;201407;15511;49213;14595;47703;3033;9517;9014;31000;12047;40517
290395;201407;2815;9117;2543;8650;240;975;1908;6494;2148;7469
290400;201407;3712;11320;3292;10736;389;1323;2476;8127;2865;9450
290405;201407;4534;14562;3948;13521;495;1757;2656;9356;3151;11113
290410;201407;6111;18231;5155;16817;573;2299;3727;11867;4300;14166
290420;201407;3387;10003;2817;9193;272;1021;2211;7172;2483;8193
290430;201407;3568;11218;3203;10655;669;2312;1960;6658;2629;8970
290440;201407;3133;8257;2538;7468;248;792;1995;5947;2243;6739
290450;201407;3645;10650;3207;10029;565;1779;2092;6675;2657;8454
290460;201407;13692;41773;12696;40124;3706;12419;5794;18231;9500;30650
290470;201407;4839;13444;3793;12048;833;2931;2031;6593;2864;9524
290475;201407;4994;17603;4556;16825;544;2189;3298;12363;3842;14552
290480;201407;2651;6940;2349;6542;366;1069;1595;4513;1961;5582
290485;201407;4910;15742;4384;14965;470;2045;3424;11544;3894;13589
290490;201407;8237;22145;7943;21749;738;2168;6546;17895;7284;20063
290500;201407;4673;14928;4009;13688;820;3008;2020;6868;2840;9876
290510;201407;3488;10200;3059;9602;244;904;2443;7698;2687;8602
290515;201407;2931;9097;2737;8801;283;885;2090;6917;2373;7802
290520;201407;11871;36887;9684;32841;1076;4338;6172;20782;7248;25120
290530;201407;5352;15469;4580;14370;415;1341;3665;11577;4080;12918
290540;201407;3979;11561;3790;11320;439;1234;2997;9178;3436;10412
290550;201407;4444;12035;3925;11404;165;471;3531;10341;3696;10812
290560;201407;6248;18522;5524;17470;1212;4100;3261;10474;4473;14574
290570;201407;40976;119228;38492;115507;4902;15795;28388;84665;33290;100460
290580;201407;7406;25889;7099;25415;1415;4971;4789;17775;6204;22746
290590;201407;7676;24302;6436;22230;468;1950;5052;17382;5520;19332
290600;201407;18274;56769;17204;55104;2944;9238;11482;38219;14426;47457
290610;201407;2421;8410;2050;7674;210;998;1492;5462;1702;6460
290620;201407;7252;21621;6504;20543;502;1730;5361;17010;5863;18740
290630;201407;8309;22458;7329;21411;835;2382;5945;17626;6780;20008
290640;201407;2732;8111;2282;7353;244;842;1621;5253;1865;6095
290650;201407;11933;35543;11267;34552;2852;8681;6734;21341;9586;30022
290660;201407;3780;10489;3113;9534;222;785;2454;7549;2676;8334
290670;201407;6764;21183;6205;20322;845;2652;4678;15838;5523;18490
290680;201407;10559;31374;9735;30390;598;1981;8255;25980;8853;27961
290682;201407;4508;13330;4063;12713;200;792;3381;10483;3581;11275
290685;201407;3359;8615;2515;7432;319;1003;1549;4696;1868;5699
290687;201407;8321;22571;6588;20436;1322;4331;3917;12470;5239;16801
290689;201407;3174;9130;2692;8371;245;797;2115;6660;2360;7457
290690;201407;5555;16264;5081;15660;566;1825;4030;12517;4596;14342
290700;201407;2267;7178;2169;7037;218;789;1700;5527;1918;6316
290710;201407;7860;25116;7281;24222;470;1536;6279;21146;6749;22682
290720;201407;19066;56147;17013;53627;1830;5260;13823;44933;15653;50193
290730;201407;7426;20808;6769;19960;1253;3611;4567;13746;5820;17357
290740;201407;948;2864;809;2632;122;407;515;1715;637;2122
290750;201407;10326;29733;8939;27224;1707;6007;4978;14364;6685;20371
290755;201407;2448;6922;2045;6253;129;473;1588;4821;1717;5294
290760;201407;4503;13347;3682;12123;386;1224;2682;8970;3068;10194
290770;201407;2636;9240;2448;8994;134;618;2003;7414;2137;8032
290780;201407;9018;23567;7999;22178;876;2082;6137;17662;7013;19744
290790;201407;4786;14305;4446;13822;438;1304;3505;11253;3943;12557
290800;201407;7474;16297;5721;14430;869;1922;4329;11420;5198;13342
290810;201407;5011;16051;4356;15023;332;1280;3302;11510;3634;12790
290820;201407;5533;15902;4963;15135;484;1631;3852;11786;4336;13417
290830;201407;4227;12042;3973;11638;283;1112;3170;9009;3453;10121
290840;201407;17996;51108;16428;48930;2587;7373;11514;35741;14101;43114
290850;201407;6813;20416;6673;20208;1161;3388;4959;15519;6120;18907
290860;201407;4977;17548;4661;17151;718;2655;3418;12991;4136;15646
290870;201407;4867;14614;4087;13552;439;1751;3017;9912;3456;11663
290880;201407;1421;3968;1174;3581;104;327;815;2517;919;2844
290890;201407;6973;18751;6119;17786;733;2139;4789;14111;5522;16250
290900;201407;2483;7309;1887;6325;287;1073;1016;3379;1303;4452
290910;201407;4914;13643;4227;12652;266;869;3520;10595;3786;11464
290920;201407;4871;14468;4391;13814;331;922;3610;11605;3941;12527
290930;201407;7524;24324;6778;23020;771;2950;4898;16488;5669;19438
290940;201407;3606;11453;3364;11143;279;890;2858;9691;3137;10581
290950;201407;1575;4463;1426;4246;206;633;991;2995;1197;3628
290960;201407;6082;17317;5566;16637;413;1256;4517;13677;4930;14933
290970;201407;3753;12187;3424;11604;478;1621;2273;7966;2751;9587
290980;201407;10771;32102;9488;29595;2677;8740;3884;12061;6561;20801
290990;201407;9342;28179;8265;26427;930;3143;6229;19937;7159;23080
291000;201407;3277;9883;3014;9545;365;1174;2361;7613;2726;8787
291005;201407;14066;39226;12642;37184;2111;6515;8566;25557;10677;32072
291010;201407;3154;10201;2538;8827;318;1208;1615;5647;1933;6855
291020;201407;1428;3783;1097;3202;133;465;656;1838;789;2303
291030;201407;2217;6229;1731;5229;182;616;1105;3256;1287;3872
291040;201407;5681;17680;5222;17020;689;2431;3854;12620;4543;15051
291050;201407;8081;27008;7406;25732;1977;7396;3799;13207;5776;20603
291060;201407;6327;23326;6015;22922;891;3843;4334;16456;5225;20299
291070;201407;16432;48666;15051;46691;1738;5317;11299;35815;13037;41132
291072;201407;22251;68624;19003;62195;6075;20993;7337;24891;13412;45884
291075;201407;5385;15481;4878;14802;399;1098;3759;11826;4158;12924
291077;201407;1558;4552;1304;4160;160;582;865;2739;1025;3321
291080;201407;83713;259157;75006;243285;23135;77576;29332;94385;52467;171961
291085;201407;5818;15580;5074;14582;580;1734;3951;11458;4531;13192
291090;201407;1484;3754;1306;3525;104;412;1064;2758;1168;3170
291100;201407;2679;7075;2211;6590;116;448;1875;5577;1991;6025
291110;201407;5092;18350;4570;17534;660;2864;3170;12083;3830;14947
291120;201407;7685;20729;7202;20047;941;2689;5457;15272;6398;17961
291125;201407;1738;3759;1400;3401;153;380;1053;2645;1206;3025
291130;201407;3023;9319;2642;8678;256;995;1892;6147;2148;7142
291140;201407;4189;12642;3863;12042;557;1811;2672;8395;3229;10206
291150;201407;2017;5286;1921;5172;185;515;1485;3984;1670;4499
291160;201407;5627;17327;4958;16306;1191;4009;2853;9482;4044;13491
291165;201407;2517;7362;2006;6406;140;596;1438;4452;1578;5048
291170;201407;21151;55048;18264;51463;1187;3963;14584;40866;15771;44829
291180;201407;6618;17481;5367;15698;636;2052;3812;11069;4448;13121
291185;201407;3937;10743;3666;10377;316;978;3049;8581;3365;9559
291190;201407;7528;21123;6776;20198;829;2407;5214;15983;6043;18390
291200;201407;2724;8337;2269;7500;178;632;1678;5587;1856;6219
291210;201407;7629;18086;6624;16946;563;1505;5328;13687;5891;15192
291220;201407;4268;13630;4014;13202;567;2074;2877;9372;3444;11446
291230;201407;4044;10573;3641;10104;131;320;3312;9300;3443;9620
291240;201407;4939;13373;4176;12040;271;837;3325;9480;3596;10317
291250;201407;3821;11464;3015;10096;326;1126;2075;7052;2401;8178
291260;201407;1187;3497;1104;3379;111;383;851;2595;962;2978
291270;201407;4388;14614;4081;14046;1041;3762;2351;8187;3392;11949
291280;201407;2480;6444;1878;5646;464;1434;1055;3182;1519;4616
291290;201407;6016;16959;5409;16199;885;2666;3559;10957;4444;13623
291300;201407;4584;13454;3843;12217;480;1710;2630;8299;3110;10009
291310;201407;5501;15833;4841;14737;428;1368;3721;11349;4149;12717
291320;201407;6172;19861;5353;18293;1319;4912;2780;9408;4099;14320
291330;201407;1679;5146;1569;4975;223;817;1024;3139;1247;3956
291340;201407;3977;11716;3203;10617;306;1158;2507;8283;2813;9441
291345;201407;3588;11709;3379;11477;216;702;2976;10333;3192;11035
291350;201407;6205;18320;5526;17277;523;1744;3953;12548;4476;14292
291360;201407;36227;104928;33707;101257;8082;23846;20729;64534;28811;88380
291370;201407;9196;26885;8800;26357;972;2815;6800;20891;7772;23706
291380;201407;3900;12083;3397;11254;286;981;2509;8539;2795;9520
291390;201407;10642;29587;9702;28469;1373;3884;7374;22001;8747;25885
291400;201407;17283;45512;14131;41300;2395;7004;9081;27633;11476;34637
291410;201407;3361;8795;2488;7529;196;792;1860;5475;2056;6267
291420;201407;2287;6051;2022;5734;111;317;1806;5166;1917;5483
291430;201407;3402;10034;3013;9521;240;945;2379;7418;2619;8363
291440;201407;6215;19626;5340;18083;563;2006;4070;13978;4633;15984
291450;201407;7785;23869;6978;22675;353;1154;5814;19301;6167;20455
291460;201407;13602;41332;12125;39103;2220;7681;7850;25496;10070;33177
291465;201407;8408;24359;7645;23482;815;2733;6133;18870;6948;21603
291470;201407;16000;44295;14147;42000;1435;4099;10766;33196;12201;37295
291480;201407;36185;98132;32234;92674;5053;16103;21321;61092;26374;77195
291490;201407;4476;14809;4380;14679;437;1463;3669;12450;4106;13913
291500;201407;4263;12400;3680;11570;298;1093;2925;9156;3223;10249
291510;201407;3672;11261;3388;10887;145;466;3051;9911;3196;10377
291520;201407;4144;11237;3637;10552;502;1392;2494;7561;2996;8953
291530;201407;2130;6211;1815;5715;462;1542;943;3049;1405;4591
291535;201407;4417;12842;3980;12200;354;1115;3044;9672;3398;10787
291540;201407;2261;5436;1933;5093;174;371;1637;4451;1811;4822
291550;201407;5739;15514;5160;14725;1252;3537;2937;8538;4189;12075
291560;201407;17625;44889;13695;40445;1394;4151;10554;32014;11948;36165
291570;201407;2482;6657;2356;6504;161;398;2090;5890;2251;6288
291580;201407;5997;18368;5340;17369;725;2806;3641;11847;4366;14653
291590;201407;2039;6327;1831;5988;295;1003;1203;4086;1498;5089
291600;201407;5614;15616;4201;13540;1010;3603;2074;6573;3084;10176
291610;201407;5270;15805;5115;15599;368;1194;4364;13418;4732;14612
291620;201407;3136;7463;2589;6882;189;463;2064;5698;2253;6161
291630;201407;3226;8072;2814;7605;286;721;2295;6348;2581;7069
291640;201407;18047;49467;14978;45378;4005;12878;6401;19747;10406;32625
291650;201407;8310;24663;7633;23860;709;1756;6402;20809;7111;22565
291660;201407;2383;6323;2107;5938;257;881;1443;3890;1700;4771
291670;201407;2521;7020;2325;6713;386;1123;1379;4270;1765;5393
291680;201407;5050;14384;4541;13575;1133;3736;2218;6870;3351;10606
291685;201407;4656;11738;3982;10889;531;1376;2898;8228;3429;9604
291690;201407;4108;11231;3391;10116;326;965;2411;7277;2737;8242
291700;201407;9673;30164;8913;28921;1041;3491;6620;21856;7661;25347
291710;201407;6112;16240;5295;15191;950;2836;3291;9911;4241;12747
291720;201407;3873;13529;3510;12760;402;1700;2555;9138;2957;10838
291730;201407;6054;19133;5632;18574;1002;3448;3947;13315;4949;16763
291733;201407;2656;7832;2259;7313;302;1059;1534;4998;1836;6057
291735;201407;2491;7199;2130;6650;137;507;1758;5446;1895;5953
291740;201407;4074;11883;3247;10614;352;1314;2308;7533;2660;8847
291750;201407;22610;59241;17828;52055;3890;11809;9658;28668;13548;40477
291760;201407;12552;39786;11461;37845;4312;15529;4399;14534;8711;30063
291770;201407;8206;23787;7382;22373;1210;3998;4862;14553;6072;18551
291780;201407;4387;13538;4115;13046;476;1525;3141;9998;3617;11523
291790;201407;2558;7965;2415;7769;130;530;2077;6619;2207;7149
291800;201407;32527;94014;29357;89498;5797;18221;18336;57404;24133;75625
291810;201407;11112;31353;9485;29396;660;2313;7718;24121;8378;26434
291820;201407;3756;11194;3400;10677;311;1000;2699;8551;3010;9551
291830;201407;4451;12055;4151;11623;499;1470;3158;8889;3657;10359
291835;201407;6245;19495;5119;17614;1202;4442;3013;10355;4215;14797
291840;201407;50383;137645;42819;129455;5357;15556;32931;102716;38288;118272
291845;201407;3035;8779;2727;8421;223;619;2385;7495;2608;8114
291850;201407;4867;13681;4082;12580;458;1367;3069;9736;3527;11103
291855;201407;1743;4593;1506;4286;196;674;1103;3042;1299;3716
291860;201407;2096;6244;1798;5669;189;652;1168;3670;1357;4322
291870;201407;1420;3830;1107;3272;120;442;714;2094;834;2536
291875;201407;2925;9308;2633;8855;237;991;1891;6242;2128;7233
291880;201407;4771;15175;4517;14779;341;1144;3787;12496;4128;13640
291890;201407;1453;3648;1236;3388;306;862;737;2089;1043;2951
291900;201407;1347;3806;1150;3497;114;408;883;2661;997;3069
291905;201407;3007;7940;2507;7143;221;704;1798;5179;2019;5883
291910;201407;2705;7357;2317;6889;180;649;1902;5605;2082;6254
291915;201407;6803;21124;6064;19702;507;1704;4970;16362;5477;18066
291920;201407;33011;97440;30514;93747;6255;19735;18512;58384;24767;78119
291930;201407;2607;7769;2358;7383;249;889;1744;5443;1993;6332
291940;201407;3622;10364;2718;8765;418;1534;1536;4790;1954;6324
291950;201407;9426;31767;8558;30341;1908;6752;4846;17759;6754;24511
291955;201407;8928;28428;8521;27814;2043;6595;5096;17301;7139;23896
291960;201407;3434;10175;2907;9418;335;1011;2091;7122;2426;8133
291970;201407;4433;13328;3945;12705;583;1991;2754;8943;3337;10934
291980;201407;11614;33624;8894;29705;957;3373;6365;21750;7322;25123
291990;201407;2227;7095;2047;6819;197;683;1564;5335;1761;6018
291992;201407;2862;8868;2794;8730;445;1471;2043;6351;2488;7822
291995;201407;2177;6410;1941;6067;249;819;1447;4577;1696;5396
292000;201407;2422;7182;2190;6843;393;1362;1462;4545;1855;5907
292010;201407;6525;16729;4989;14473;488;1446;3819;11142;4307;12588
292020;201407;4566;15401;4235;14861;678;2506;2970;10591;3648;13097
292030;201407;2263;7039;2011;6688;261;939;1288;4331;1549;5270
292040;201407;4694;13092;4159;12534;331;876;3531;11049;3862;11925
292045;201407;2694;9399;2667;9356;84;272;2534;8921;2618;9193
292050;201407;6479;20246;5699;18694;582;2323;3893;12564;4475;14887
292060;201407;11322;31597;10719;30824;1027;2940;8797;25438;9824;28378
292070;201407;4459;14179;4339;14024;406;1190;3678;12089;4084;13279
292080;201407;3745;9822;3223;9156;294;855;2609;7507;2903;8362
292090;201407;4368;11580;3734;10860;333;1106;3043;8893;3376;9999
292100;201407;11162;30959;9550;28786;2592;8055;4791;15095;7383;23150
292105;201407;3236;9919;2799;9291;229;903;2243;7420;2472;8323
292110;201407;7182;18976;5507;16487;1212;3687;3167;9756;4379;13443
292120;201407;8763;24541;7769;22793;1633;4814;4145;12904;5778;17718
292130;201407;3202;8633;2857;8148;555;1495;1892;5552;2447;7047
292140;201407;5552;14367;4815;13378;739;1970;3237;9411;3976;11381
292145;201407;2723;8374;2483;8004;214;670;1885;6359;2099;7029
292150;201407;13734;41927;12742;40350;927;3285;10018;32119;10945;35404
292160;201407;2811;8072;2424;7558;171;501;2057;6556;2228;7057
292170;201407;9138;26845;7792;24544;1179;4067;4892;15636;6071;19703
292180;201407;3590;10329;2886;9227;448;1437;1863;6071;2311;7508
292190;201407;3405;9576;2887;8832;571;1828;1838;5709;2409;7537
292200;201407;6281;20757;5536;19285;1638;6093;2311;8066;3949;14159
292205;201407;4004;12509;3665;12044;276;1064;2957;9708;3233;10772
292210;201407;6798;19142;5835;17854;553;1757;4555;14252;5108;16009
292220;201407;1930;5476;1822;5313;373;1029;1127;3324;1500;4353
292225;201407;3151;9787;2901;9420;193;699;2402;7875;2595;8574
292230;201407;6292;19126;6020;18700;612;2359;4601;13871;5213;16230
292240;201407;4522;14331;4165;13569;631;2226;2633;8493;3264;10719
292250;201407;5346;16514;4991;15866;1083;3591;2725;8673;3808;12264
292260;201407;3207;9859;3058;9635;305;1017;2455;7758;2760;8775
292265;201407;2898;9488;2620;8993;188;773;2013;6857;2201;7630
292270;201407;4072;10916;3318;10025;246;903;2722;8203;2968;9106
292273;201407;2845;6912;2186;6088;290;757;1585;4650;1875;5407
292275;201407;1927;5052;1765;4801;198;594;1350;3657;1548;4251
292280;201407;2100;6237;1904;6023;199;482;1489;5050;1688;5532
292285;201407;2659;7462;2347;7017;214;713;1823;5532;2037;6245
292290;201407;7530;22509;6308;20880;451;1734;4976;16690;5427;18424
292300;201407;8686;26632;7619;25434;1953;6637;4668;16067;6621;22704
292303;201407;2886;9008;2696;8750;129;485;2329;7556;2458;8041
292305;201407;3201;8703;3044;8497;123;376;2732;7647;2855;8023
292310;201407;6091;18063;5543;17313;249;887;4685;14682;4934;15569
292320;201407;6287;18841;5544;17556;578;2036;4224;13367;4802;15403
292330;201407;2051;5795;1926;5627;200;630;1518;4405;1718;5035
292335;201407;5421;14240;4839;13477;524;1422;3905;11003;4429;12425
292340;201407;6699;19001;5708;17410;620;1977;4075;12520;4695;14497
292350;201407;2210;6712;2038;6489;241;865;1591;5075;1832;5940
292360;201407;5020;14505;4828;13981;193;551;4256;12602;4449;13153
292370;201407;9037;26809;8190;25544;1067;3187;5850;19057;6917;22244
292380;201407;7566;22070;7054;21269;554;1559;5821;17784;6375;19343
292390;201407;3807;8597;3358;8112;110;189;3139;7682;3249;7871
292400;201407;22454;66812;21415;65152;3229;10294;15203;47059;18432;57353
292405;201407;4460;11844;3857;11090;263;761;3219;9342;3482;10103
292410;201407;1965;5303;1863;5185;144;403;1624;4534;1768;4937
292420;201407;3883;12438;3724;12239;170;457;3388;11378;3558;11835
292430;201407;5625;17059;4473;15435;292;1194;3442;11852;3734;13046
292440;201407;8664;28654;8049;27752;300;1186;7042;24658;7342;25844
292450;201407;4459;13269;3656;11996;342;1202;2678;8943;3020;10145
292460;201407;5728;17156;5052;15950;965;3153;3154;10074;4119;13227
292465;201407;2475;7487;2101;6893;245;914;1497;4964;1742;5878
292467;201407;2092;6862;1988;6691;379;1356;1327;4532;1706;5888
292470;201407;3252;8670;2697;7786;244;821;2037;5808;2281;6629
292480;201407;6366;17068;5468;15843;352;1155;4612;13359;4964;14514
292490;201407;2375;6566;1989;6002;179;640;1538;4578;1717;5218
292500;201407;6692;20170;5830;18687;635;2228;4216;13652;4851;15880
292510;201407;13464;38641;11890;36403;1253;4037;9117;28412;10370;32449
292520;201407;6076;18326;5491;17402;1541;4954;2842;9160;4383;14114
292525;201407;5611;14686;4886;13834;379;1113;3991;11446;4370;12559
292530;201407;26450;78762;24035;75654;5688;18409;13994;45585;19682;63994
292540;201407;2952;8524;2663;8126;348;1230;2000;6059;2348;7289
292550;201407;6688;21554;5940;20486;848;3090;4226;14948;5074;18038
292560;201407;4217;11680;3606;10873;307;1138;2901;8603;3208;9741
292570;201407;4119;12231;3963;12067;157;457;3512;11051;3669;11508
292575;201407;6131;21025;5987;20764;926;3325;4484;15598;5410;18923
292580;201407;7214;21388;6677;20707;538;1672;5555;17461;6093;19133
292590;201407;7373;23308;7036;22758;855;2819;5330;17364;6185;20183
292593;201407;3333;8714;2822;7964;275;788;2191;6179;2466;6967
292595;201407;6135;17077;5333;16024;506;1616;4080;12392;4586;14008
292600;201407;10759;30461;10026;29526;1008;2327;8186;25033;9194;27360
292610;201407;4424;12903;3626;11575;477;1581;2380;7775;2857;9356
292620;201407;5915;17794;5191;16938;269;892;4659;15338;4928;16230
292630;201407;10083;25566;8691;23492;837;2339;6541;17997;7378;20336
292640;201407;8415;27110;7481;25862;639;2345;5768;20399;6407;22744
292650;201407;5041;13719;4837;13480;532;1035;3971;11801;4503;12836
292660;201407;11314;34313;10707;33438;1274;4085;8179;26034;9453;30119
292665;201407;2840;8312;2774;8219;80;187;2603;7824;2683;8011
292670;201407;3970;11244;3071;9717;319;1099;2019;6441;2338;7540
292680;201407;3708;11213;3467;10854;364;1119;2772;8747;3136;9866
292690;201407;3432;9314;2467;7803;293;995;1664;5378;1957;6373
292700;201407;9437;28427;8186;26613;1151;3483;5834;19838;6985;23321
292710;201407;1968;6490;1871;6349;91;342;1670;5689;1761;6031
292720;201407;9685;25103;8548;23818;725;2030;7161;20209;7886;22239
292730;201407;3490;10753;3371;10565;493;1509;2424;7787;2917;9296
292740;201407;362766;1017481;344742;991360;79056;238892;211812;609855;290868;848747
292750;201407;6154;16863;5466;15925;418;1216;4439;13141;4857;14357
292760;201407;4315;13791;3983;13216;579;2082;2621;8796;3200;10878
292770;201407;6219;19038;5818;18395;1279;4051;3636;11866;4915;15917
292780;201407;1914;4648;1505;4138;183;612;1092;2952;1275;3564
292790;201407;3467;9138;3307;8965;250;546;2837;8002;3087;8548
292800;201407;9674;29113;9032;28081;885;3021;7053;21914;7938;24935
292805;201407;3238;9457;2959;9062;571;1866;1982;6093;2553;7959
292810;201407;10223;30861;8595;28676;1150;4013;6263;21378;7413;25391
292820;201407;7565;21652;5532;18755;424;1631;4395;14998;4819;16629
292830;201407;1931;5735;1752;5487;114;448;1438;4467;1552;4915
292840;201407;7424;24279;6950;23623;426;1597;6033;20525;6459;22122
292850;201407;3331;8815;2753;7956;308;948;1996;5722;2304;6670
292860;201407;15328;41911;14697;41115;1858;5262;11458;32367;13316;37629
292870;201407;19855;55296;17585;51774;3004;9652;10640;31029;13644;40681
292880;201407;12139;36034;10963;34220;1625;5327;7251;22653;8876;27980
292890;201407;5794;19841;5218;18760;961;3631;3109;11472;4070;15103
292895;201407;2794;7025;2243;6191;308;846;1615;4453;1923;5299
292900;201407;3102;9717;2935;9446;386;1542;2035;6314;2421;7856
292905;201407;4371;12661;3665;11764;274;779;3069;10140;3343;10919
292910;201407;5221;16095;4783;15306;849;2922;2976;9438;3825;12360
292920;201407;8815;26353;8385;25683;856;2939;6521;19474;7377;22413
292925;201407;5210;16202;4606;15356;446;1535;3574;12032;4020;13567
292930;201407;6580;21350;6273;20794;686;2848;4654;15069;5340;17917
292935;201407;2140;6123;1798;5749;123;317;1522;5060;1645;5377
292937;201407;3346;8548;2833;7909;318;1015;2188;6029;2506;7044
292940;201407;3159;8753;2496;7832;314;1004;1702;5526;2016;6530
292950;201407;8301;25375;7912;24707;972;3598;5765;17531;6737;21129
292960;201407;5009;13553;4406;12710;469;1477;3185;9122;3654;10599
292970;201407;4357;13395;3975;12889;208;849;3329;10779;3537;11628
292975;201407;3432;9435;3307;9251;360;992;2741;7760;3101;8752
292980;201407;3652;9923;2956;9050;401;1396;2065;6274;2466;7670
292990;201407;12371;35653;11208;33876;723;2272;9513;28849;10236;31121
293000;201407;2992;7844;2453;7166;128;438;2127;6203;2255;6641
293010;201407;19218;54353;16787;50514;3049;10004;10439;31375;13488;41379
293015;201407;7994;26117;6527;23918;1057;4262;4238;15408;5295;19670
293020;201407;9624;31868;9002;30989;631;2476;7433;25814;8064;28290
293030;201407;5721;16632;4620;14986;476;1615;3224;10857;3700;12472
293040;201407;3744;12194;3557;11837;214;748;3109;10354;3323;11102
293050;201407;20689;58318;18374;55345;2881;8813;12359;38198;15240;47011
293060;201407;4386;11295;3704;10218;428;1259;2554;7010;2982;8269
293070;201407;20787;63404;19212;60688;5147;16578;10140;32826;15287;49404
293075;201407;3469;11219;3139;10797;245;874;2588;9008;2833;9882
293076;201407;3779;10665;3507;10271;269;756;2941;8774;3210;9530
293077;201407;5089;15818;4411;14936;945;3338;2630;9045;3575;12383
293080;201407;4915;15450;4507;14794;350;1483;3531;11353;3881;12836
293090;201407;3610;11344;2962;10422;289;1044;2246;8032;2535;9076
293100;201407;5847;17825;5014;16355;539;1863;3683;12201;4222;14064
293105;201407;3933;13190;3478;12311;506;1894;2364;8486;2870;10380
293110;201407;2010;6021;1855;5778;131;474;1515;4693;1646;5167
293120;201407;4107;13617;3811;13194;350;1191;3036;10717;3386;11908
293130;201407;4012;11451;3280;10624;181;655;2890;9507;3071;10162
293135;201407;30172;77665;23245;68260;4548;15458;11711;34060;16259;49518
293140;201407;2138;6335;2057;6219;221;807;1580;4651;1801;5458
293150;201407;5889;19380;5287;18215;1047;3733;3122;11115;4169;14848
293160;201407;3609;9756;3373;9486;474;981;2607;7793;3081;8774
293170;201407;3482;10630;3230;10253;488;1673;2277;7306;2765;8979
293180;201407;5443;15374;4494;13908;364;1327;3488;10658;3852;11985
293190;201407;14005;42830;13240;41667;621;2787;11401;35190;12022;37977
293200;201407;6530;19061;5767;18013;276;1040;4933;15403;5209;16443
293210;201407;5030;14932;4631;14276;497;1663;3429;10630;3926;12293
293220;201407;5312;16030;4763;15134;1196;3954;2475;7995;3671;11949
293230;201407;4021;12614;3711;12181;493;1801;2788;9143;3281;10944
293240;201407;4585;12067;3602;10639;198;592;2813;8302;3011;8894
293245;201407;4541;13060;4143;12428;516;1556;2974;9237;3490;10793
293250;201407;6044;17029;5539;16291;676;2097;4028;11840;4704;13937
293260;201407;4809;14420;4017;13267;378;1377;2959;9886;3337;11263
293270;201407;5893;16153;5596;15834;533;1321;4830;13996;5363;15317
293280;201407;5750;16164;4982;15156;450;1241;3867;12173;4317;13414
293290;201407;16747;56090;15822;54234;3641;12915;8841;30981;12482;43896
293300;201407;6633;16538;5697;15480;482;1233;4631;12769;5113;14002
293305;201407;4833;12164;4224;11329;283;806;3511;9429;3794;10235
293310;201407;2791;7180;2274;6336;237;711;1583;4360;1820;5071
293315;201407;4981;12657;4520;11971;766;1957;2855;8021;3621;9978
293317;201407;2615;7668;2348;7173;284;910;1551;4760;1835;5670
293320;201407;8205;27000;8017;26758;759;2745;6692;22362;7451;25107
293325;201407;1955;5688;1628;5187;261;902;1089;3496;1350;4398
293330;201407;55605;176615;50170;167452;11217;40250;27521;93151;38738;133401
293340;201407;2743;7835;2186;6878;301;1068;1509;4660;1810;5728
293345;201407;3618;10794;3046;9985;352;1136;2218;7526;2570;8662
293350;201407;6828;19044;6528;18694;405;1009;5817;17021;6222;18030
293360;201407;13958;42585;12706;40945;861;2702;10806;35559;11667;38261
310010;201407;1227;3333;886;2789;231;881;365;1042;596;1923
310020;201407;3875;12363;3228;10940;1139;4172;620;1913;1759;6085
310030;201407;2586;8471;2246;7846;654;2424;1100;3835;1754;6259
310040;201407;1030;2828;871;2614;89;318;651;1926;740;2244
310050;201407;1940;6773;1729;6264;337;1445;889;3164;1226;4609
310060;201407;3285;10983;2965;10549;380;1409;2228;8049;2608;9458
310070;201407;316;914;243;777;38;163;126;360;164;523
310080;201407;781;2405;634;2117;175;677;218;668;393;1345
310090;201407;4962;14787;4292;13630;685;2411;2649;8414;3334;10825
310100;201407;3410;10442;2847;9502;277;1102;2115;7024;2392;8126
310110;201407;5988;17012;5046;15582;1124;3945;2796;8549;3920;12494
310120;201407;606;1962;563;1886;208;825;243;699;451;1524
310130;201407;471;1489;432;1428;105;400;220;685;325;1085
310140;201407;267;931;233;868;84;349;53;173;137;522
310150;201407;5017;15606;4541;14739;975;3586;2374;7665;3349;11251
310160;201407;7429;24197;6491;22489;1964;7486;2451;8404;4415;15890
310163;201407;854;2869;742;2643;197;786;300;1024;497;1810
310170;201407;9996;28583;9206;27397;1650;5020;6030;18555;7680;23575
310180;201407;1908;5547;1558;5064;403;1471;758;2377;1161;3848
310190;201407;2609;8806;2369;8402;744;2926;408;1501;1152;4427
310200;201407;1971;6645;1659;6001;489;1945;574;2056;1063;4001
310205;201407;1059;3208;893;2922;183;603;524;1768;707;2371
310210;201407;2586;8087;2371;7767;350;1269;1711;5598;2061;6867
310220;201407;1277;3666;1027;3338;229;811;584;1869;813;2680
310230;201407;2998;9846;2583;8926;774;3063;1018;3260;1792;6323
310240;201407;1042;3665;889;3373;167;686;447;1791;614;2477
310250;201407;978;3397;954;3358;206;817;597;2042;803;2859
310260;201407;3168;10238;2659;9158;681;2627;998;3359;1679;5986
310270;201407;2458;7329;2198;6940;204;687;1721;5517;1925;6204
310280;201407;2205;6343;1968;5966;501;1822;972;2790;1473;4612
310285;201407;2251;7872;2113;7667;299;1126;1587;5889;1886;7015
310290;201407;1340;4222;1250;4083;380;1430;596;1762;976;3192
310300;201407;1932;6605;1830;6402;494;1901;1029;3557;1523;5458
310310;201407;399;1099;289;872;52;158;143;430;195;588
310320;201407;401;1345;347;1226;74;312;159;547;233;859
310330;201407;509;1300;378;1070;43;160;212;540;255;700
310340;201407;8627;27000;7507;25119;1462;5119;4296;14795;5758;19914
310350;201407;15834;45327;12282;39092;4207;14453;3487;11209;7694;25662
310360;201407;475;1494;459;1467;81;301;309;940;390;1241
310370;201407;1491;5277;1438;5178;422;1582;771;2798;1193;4380
310375;201407;1431;3872;970;3041;172;615;431;1291;603;1906
310380;201407;400;1133;317;1016;129;460;129;379;258;839
310390;201407;503;1802;429;1632;123;503;71;233;194;736
310400;201407;10486;31662;8432;27968;2712;9776;2539;8467;5251;18243
310410;201407;1056;3413;692;2821;247;1072;144;584;391;1656
310420;201407;5917;17183;3552;11759;831;3088;626;1839;1457;4927
310430;201407;1687;5775;1398;5174;460;1816;372;1359;832;3175
310440;201407;621;1827;542;1703;151;521;223;674;374;1195
310445;201407;1233;4158;1049;3822;152;632;674;2445;826;3077
310450;201407;4695;13550;3847;12306;714;2430;2442;8010;3156;10440
310460;201407;1650;5348;1433;4963;483;1828;338;1220;821;3048
310470;201407;3781;9827;3221;9131;319;1039;2537;7223;2856;8262
310480;201407;1158;3605;969;3219;242;952;398;1194;640;2146
310490;201407;3369;11436;2964;10657;995;3910;1120;3992;2115;7902
310500;201407;1537;5350;1425;5129;431;1677;589;2106;1020;3783
310510;201407;2561;8473;2218;7690;794;2976;491;1640;1285;4616
310520;201407;1409;3822;1149;3401;86;263;780;2319;866;2582
310530;201407;882;2836;560;1997;122;482;106;356;228;838
310540;201407;3804;12576;3514;12138;1221;4414;1426;5020;2647;9434
310550;201407;1240;3740;1027;3365;290;1132;427;1276;717;2408
310560;201407;16633;52290;14364;47885;4567;16893;5001;15885;9568;32778
310570;201407;1287;3997;1204;3888;171;614;893;2886;1064;3500
310590;201407;4187;12409;3357;10815;658;2363;1348;4192;2006;6555
310600;201407;1651;5592;1545;5364;537;2095;532;1712;1069;3807
310610;201407;571;1944;524;1848;163;676;176;556;339;1232
310620;201407;191960;611027;158933;544289;43193;164586;61994;204063;105187;368649
310630;201407;4261;13921;4036;13504;783;2954;2667;8736;3450;11690
310640;201407;1474;4559;1198;4076;420;1532;340;1110;760;2642
310650;201407;2940;9429;2398;8501;482;1854;1301;4742;1783;6596
310660;201407;1339;4141;1167;3897;174;619;842;2795;1016;3414
310665;201407;1223;3854;1125;3713;193;677;775;2598;968;3275
310670;201407;57587;182031;53135;172192;15906;54196;23160;74251;39066;128447
310680;201407;813;2394;739;2275;178;596;381;1151;559;1747
310690;201407;1325;4431;1075;3936;329;1373;293;1003;622;2376
310700;201407;529;1480;444;1350;126;425;222;645;348;1070
310710;201407;7362;24120;5860;21591;1590;6532;1793;6487;3383;13019
310720;201407;862;2669;785;2525;232;862;354;1052;586;1914
310730;201407;9743;30933;8923;29633;2043;7350;5287;17610;7330;24960
310740;201407;5298;18012;4503;16321;1617;6386;1028;3527;2645;9913
310750;201407;1664;4309;1355;3896;238;703;909;2642;1147;3345
310760;201407;646;2014;555;1852;136;493;240;791;376;1284
310770;201407;785;2876;765;2837;282;1160;339;1204;621;2364
310780;201407;3799;10876;3356;10102;585;1800;2065;6243;2650;8043
310790;201407;1863;5979;1684;5688;467;1634;847;2949;1314;4583
310800;201407;3122;10220;2513;8977;995;3890;414;1427;1409;5317
310810;201407;1532;4325;1397;4097;328;1041;698;1976;1026;3017
310820;201407;1504;4293;1098;3578;308;1106;352;1094;660;2200
310825;201407;2453;8396;1986;7572;163;833;1464;5534;1627;6367
310830;201407;1470;5037;1232;4522;412;1622;381;1320;793;2942
310840;201407;2360;7729;2011;7050;751;2905;546;1797;1297;4702
310850;201407;1581;4771;1356;4470;204;742;983;3242;1187;3984
310855;201407;3219;10471;2873;9917;669;2456;1713;6022;2382;8478
310860;201407;7984;24972;7026;23332;1224;4295;4091;13984;5315;18279
310870;201407;1044;3002;880;2724;189;628;434;1334;623;1962
310880;201407;1263;3917;961;3352;207;835;448;1532;655;2367
310890;201407;2810;8979;2242;7909;678;2700;641;2133;1319;4833
310900;201407;4483;15116;3886;13918;1174;4643;1559;5423;2733;10066
310910;201407;2118;6112;1450;4836;416;1551;364;1142;780;2693
310920;201407;1954;5964;1559;5395;406;1610;757;2610;1163;4220
310925;201407;964;3222;882;3084;341;1309;289;1010;630;2319
310930;201407;5517;16258;4452;14609;861;3018;2585;8715;3446;11733
310940;201407;6406;18872;5467;17432;1157;3913;2963;9513;4120;13426
310945;201407;1333;3807;1090;3467;229;839;631;1924;860;2763
310950;201407;2067;6866;1633;5900;540;2177;481;1627;1021;3804
310960;201407;483;1659;420;1536;151;598;150;552;301;1150
310970;201407;1493;5302;1158;4387;405;1676;157;522;562;2198
310980;201407;491;1307;339;1015;63;234;150;393;213;627
310990;201407;1220;4232;1048;3849;262;1083;360;1236;622;2319
311000;201407;3690;12802;3244;11837;921;3865;1184;4077;2105;7942
311010;201407;974;3175;869;2988;280;1027;409;1382;689;2409
311020;201407;908;2856;774;2638;193;750;316;1002;509;1752
311030;201407;1931;5771;1488;4862;467;1695;509;1502;976;3197
311040;201407;502;1701;433;1517;106;392;103;349;209;741
311050;201407;2664;8677;2279;7916;701;2677;914;3154;1615;5831
311060;201407;2496;7876;2010;6810;601;2188;493;1622;1094;3810
311070;201407;1748;6214;1546;5799;446;1891;496;1835;942;3726
311080;201407;1235;3356;1103;3153;162;518;737;2126;899;2644
311090;201407;1708;6430;1474;5953;530;2438;286;1074;816;3512
311100;201407;2442;8536;2146;7922;953;3724;539;1995;1492;5719
311110;201407;4143;10016;2958;8334;599;1866;1513;4184;2112;6050
311115;201407;1140;3517;991;3287;128;517;644;2167;772;2684
311120;201407;7765;22283;6093;19168;1641;5799;1675;4901;3316;10700
311130;201407;2402;7400;1928;6756;556;2275;846;2843;1402;5118
311140;201407;1421;4031;1185;3723;175;647;810;2475;985;3122
311150;201407;2441;8184;2255;7873;613;2209;1113;3968;1726;6177
311160;201407;5011;16995;4229;15632;1553;6169;1350;4954;2903;11123
311170;201407;762;2379;603;2065;79;267;325;1178;404;1445
311180;201407;1638;4587;1200;3719;388;1313;274;766;662;2079
311190;201407;1110;3370;946;3037;260;950;372;1108;632;2058
311200;201407;2598;8067;2221;7273;822;2914;555;1653;1377;4567
311205;201407;1205;3930;1062;3645;273;1064;412;1437;685;2501
311210;201407;969;3153;887;3028;165;573;624;2188;789;2761
311220;201407;932;3010;748;2591;207;760;255;874;462;1634
311230;201407;9075;27997;7665;25433;1618;5847;3786;12862;5404;18709
311240;201407;1354;4178;1128;3808;367;1351;375;1256;742;2607
311250;201407;965;3192;870;3048;245;981;306;930;551;1911
311260;201407;2973;8194;2265;6953;709;2389;698;2085;1407;4474
311265;201407;1347;3634;1041;3201;156;582;696;2131;852;2713
311270;201407;3535;11531;3142;10994;593;2435;2072;7080;2665;9515
311280;201407;1464;4116;1086;3386;304;1053;333;1008;637;2061
311290;201407;2340;7692;2166;7329;424;1419;1270;4439;1694;5858
311300;201407;5096;16904;4590;16063;730;2862;3022;10685;3752;13547
311310;201407;497;1781;481;1754;115;485;214;742;329;1227
311320;201407;4187;14134;3672;12964;943;3813;1328;4446;2271;8259
311330;201407;5620;17250;4829;15985;1762;6239;1662;5475;3424;11714
311340;201407;12529;40736;11401;38590;3892;14102;3629;12225;7521;26327
311350;201407;2375;7052;2021;6404;466;1689;926;2800;1392;4489
311360;201407;1356;3864;1082;3497;504;1699;282;943;786;2642
311370;201407;4660;13908;4135;13023;1077;4016;1770;5253;2847;9269
311380;201407;486;1606;412;1467;126;524;124;399;250;923
311390;201407;2025;7493;1905;7286;862;3657;607;2208;1469;5865
311400;201407;1732;5834;1591;5582;476;1877;713;2335;1189;4212
311410;201407;2065;7480;1921;7276;627;2548;1004;3839;1631;6387
311420;201407;2453;8478;2036;7449;739;2894;484;1591;1223;4485
311430;201407;4128;12993;3068;10618;765;2919;612;2074;1377;4993
311440;201407;2241;7614;1772;6744;671;2925;362;1313;1033;4238
311450;201407;1887;6699;1598;5983;483;2004;384;1335;867;3339
311455;201407;1632;4444;1393;4083;316;1037;763;2156;1079;3193
311460;201407;675;2232;524;1911;128;575;136;472;264;1047
311470;201407;622;1991;500;1724;146;597;159;499;305;1096
311480;201407;823;2310;781;2245;249;721;375;1038;624;1759
311490;201407;318;1250;300;1194;114;471;102;398;216;869
311500;201407;527;1594;433;1418;153;538;166;533;319;1071
311510;201407;3192;10022;2650;8996;1043;4005;724;2306;1767;6311
311520;201407;705;2418;664;2329;251;945;252;855;503;1800
311530;201407;11625;30892;8027;24639;2198;8009;2364;6949;4562;14958
311535;201407;769;2342;556;1911;139;561;109;353;248;914
311540;201407;710;2569;678;2521;220;858;346;1267;566;2125
311545;201407;2251;7098;2118;6918;316;1152;1498;4893;1814;6045
311547;201407;1678;4690;1422;4295;145;468;969;2961;1114;3429
311550;201407;3444;11247;2969;10256;883;3401;1005;3398;1888;6799
311560;201407;288;777;255;735;63;209;144;390;207;599
311570;201407;2153;5438;1731;4908;119;345;1389;4008;1508;4353
311580;201407;2458;5395;2025;4881;594;1338;1154;2929;1748;4267
311590;201407;413;1318;360;1246;117;480;104;353;221;833
311600;201407;1370;4151;1185;3919;300;968;686;2361;986;3329
311610;201407;3440;11973;3189;11568;1043;3807;1438;5578;2481;9385
311615;201407;2786;9128;2400;8460;301;1252;1687;5910;1988;7162
311620;201407;464;1498;419;1436;108;413;221;739;329;1152
311630;201407;1475;4410;1257;4019;292;927;671;2191;963;3118
311640;201407;901;2823;746;2572;136;512;492;1698;628;2210
311650;201407;2459;7055;2008;6338;292;1006;1202;3880;1494;4886
311660;201407;2673;9471;2337;8714;702;2922;439;1440;1141;4362
311670;201407;1459;4514;1257;4154;432;1568;520;1686;952;3254
311680;201407;2342;7325;1958;6764;480;1743;1104;3898;1584;5641
311690;201407;563;1554;478;1453;86;291;323;969;409;1260
311700;201407;2215;6384;1958;6003;192;754;1505;4503;1697;5257
311710;201407;1761;5478;1387;4803;549;2080;415;1408;964;3488
311720;201407;414;1424;380;1356;64;261;245;857;309;1118
311730;201407;5420;14380;3503;11025;1065;3736;1276;3721;2341;7457
311740;201407;1007;2902;879;2752;370;1135;427;1397;797;2532
311750;201407;3979;13451;3622;12901;655;2602;2219;7946;2874;10548
311760;201407;808;2771;756;2662;224;929;315;988;539;1917
311770;201407;2595;8235;2127;7392;576;2242;678;2282;1254;4524
311780;201407;1134;4261;971;3852;371;1640;214;804;585;2444
311783;201407;2078;6789;1845;6360;217;858;1221;4324;1438;5182
311787;201407;645;2281;474;1758;94;380;104;338;198;718
311790;201407;1331;4288;1095;3814;334;1254;292;969;626;2223
311800;201407;3979;13655;2893;10334;686;2606;224;670;910;3276
311810;201407;1049;3547;1000;3460;49;234;834;2858;883;3092
311820;201407;831;2754;710;2467;228;925;330;1051;558;1976
311830;201407;10764;38710;9738;36127;3881;15076;2378;8797;6259;23873
311840;201407;3508;10511;3029;9780;949;3397;1314;4140;2263;7537
311850;201407;320;973;278;904;77;261;136;448;213;709
311860;201407;50785;158892;44320;146532;11679;42490;19931;63966;31610;106456
311870;201407;2423;7282;1935;6356;513;1919;651;1983;1164;3902
311880;201407;7204;21473;6511;20632;983;3044;4575;15159;5558;18203
311890;201407;1634;5162;1370;4595;388;1427;545;1782;933;3209
311900;201407;810;2538;735;2434;145;480;464;1630;609;2110
311910;201407;4818;14174;3944;12978;1142;4035;1671;5555;2813;9590
311920;201407;2121;6938;1818;6461;228;902;1221;4311;1449;5213
311930;201407;4913;14627;4368;13750;1767;5843;1367;4364;3134;10207
311940;201407;11635;35910;9781;32015;3040;10866;2405;7512;5445;18378
311950;201407;2334;6937;1979;6475;129;413;1595;5295;1724;5708
311960;201407;406;1391;374;1323;118;473;160;515;278;988
311970;201407;485;1738;417;1588;130;553;80;285;210;838
311980;201407;797;2225;577;1868;136;470;214;704;350;1174
311990;201407;523;1603;464;1512;189;654;161;491;350;1145
311995;201407;1174;3616;792;2678;175;660;187;539;362;1199
312000;201407;704;2196;662;2132;128;461;377;1205;505;1666
312010;201407;1051;3411;950;3196;203;742;431;1441;634;2183
312015;201407;1605;4966;1387;4584;210;812;829;2771;1039;3583
312020;201407;979;3162;870;3001;224;872;464;1572;688;2444
312030;201407;1836;5483;1649;5243;180;651;1291;4082;1471;4733
312040;201407;696;2653;598;2354;173;770;130;478;303;1248
312050;201407;1487;5173;1302;4788;403;1651;297;1037;700;2688
312060;201407;756;2329;669;2206;314;1088;197;593;511;1681
312070;201407;991;3083;655;2333;169;657;237;824;406;1481
312080;201407;2677;7547;2089;6618;471;1787;997;2904;1468;4691
312083;201407;957;2740;801;2510;133;484;478;1470;611;1954
312087;201407;2352;7212;2105;6867;320;1108;1484;4919;1804;6027
312090;201407;10017;32667;9162;31182;2887;10842;3838;12659;6725;23501
312100;201407;1383;4707;1213;4419;251;1010;675;2525;926;3535
312110;201407;1196;4275;1067;3988;408;1693;212;715;620;2408
312120;201407;936;3276;843;3068;276;1097;226;750;502;1847
312125;201407;1278;4156;1138;3859;313;1118;540;1868;853;2986
312130;201407;849;2618;692;2280;165;618;281;885;446;1503
312140;201407;1132;3593;943;3146;216;784;348;1062;564;1846
312150;201407;560;1612;471;1417;42;147;317;925;359;1072
312160;201407;8239;28243;7547;26833;2420;9347;2713;9740;5133;19087
312170;201407;1027;3082;926;2885;135;446;572;1814;707;2260
312180;201407;1625;5052;1484;4807;437;1476;598;1908;1035;3384
312190;201407;690;2287;541;1986;226;919;100;341;326;1260
312200;201407;4877;14686;4239;13625;573;1935;2894;9359;3467;11294
312210;201407;1228;3385;965;2998;269;926;448;1329;717;2255
312220;201407;1942;6432;1752;6210;247;903;1325;4882;1572;5785
312230;201407;18356;61545;15558;55904;7220;27372;3324;12391;10544;39763
312235;201407;1771;5102;1484;4662;156;620;1013;3172;1169;3792
312240;201407;1126;3862;966;3523;296;1157;345;1250;641;2407
312245;201407;2406;7104;2084;6669;187;548;1665;5440;1852;5988
312247;201407;935;2767;719;2416;182;696;355;1215;537;1911
312250;201407;1181;3476;1003;3162;224;799;470;1435;694;2234
312260;201407;960;3050;793;2816;124;528;547;1929;671;2457
312270;201407;806;2516;680;2276;157;633;259;753;416;1386
312280;201407;476;1658;438;1568;198;750;56;196;254;946
312290;201407;832;2910;786;2843;334;1342;198;705;532;2047
312300;201407;1131;3799;952;3386;296;1123;146;466;442;1589
312310;201407;961;3679;879;3470;260;1118;364;1398;624;2516
312320;201407;2452;7043;1958;6023;563;1940;487;1247;1050;3187
312330;201407;1188;3589;1043;3375;270;997;578;1862;848;2859
312340;201407;329;858;293;811;45;167;219;569;264;736
312350;201407;384;1005;356;970;46;150;289;755;335;905
312352;201407;1676;5496;1541;5303;428;1486;926;3298;1354;4784
312360;201407;3757;12843;3304;11895;1108;4325;935;3336;2043;7661
312370;201407;1681;5483;1553;5271;569;2153;557;1784;1126;3937
312380;201407;2040;5975;1848;5681;252;791;1331;4219;1583;5010
312385;201407;1275;3986;1147;3761;163;678;777;2439;940;3117
312390;201407;2078;6996;1754;6280;547;2070;357;1207;904;3277
312400;201407;3487;11519;3062;10671;1123;4070;1083;3934;2206;8004
312410;201407;10900;36623;9805;34432;3009;11487;3609;12396;6618;23883
312420;201407;4120;13182;3923;12946;735;2420;2705;9218;3440;11638
312430;201407;8629;25646;7669;24216;1357;4372;5002;16281;6359;20653
312440;201407;665;2148;580;1999;145;546;289;1009;434;1555
312450;201407;1186;4314;1085;4101;477;1851;391;1482;868;3333
312460;201407;399;1227;358;1181;82;301;194;628;276;929
312470;201407;780;2227;540;1748;130;482;145;457;275;939
312480;201407;1371;4072;1139;3803;384;1376;526;1710;910;3086
312490;201407;1965;5337;1591;4790;235;857;972;2803;1207;3660
312500;201407;632;2174;595;2113;142;608;322;1101;464;1709
312510;201407;2630;8623;2160;7576;550;2204;823;2632;1373;4836
312520;201407;406;1391;357;1290;120;449;127;469;247;918
312530;201407;594;1955;564;1896;111;458;331;1044;442;1502
312540;201407;1497;4743;1180;4107;297;1133;588;1987;885;3120
312550;201407;643;2079;582;1951;60;233;392;1288;452;1521
312560;201407;2218;5887;1936;5517;222;711;1473;4227;1695;4938
312570;201407;2800;8500;2412;7815;762;2633;794;2492;1556;5125
312580;201407;534;1803;437;1607;106;457;176;615;282;1072
312590;201407;1869;6279;1645;5787;471;1903;564;1803;1035;3706
312595;201407;2063;7001;1839;6463;514;1944;848;2919;1362;4863
312600;201407;815;2955;744;2801;212;912;333;1178;545;2090
312610;201407;8700;27404;7448;24977;2768;9951;2303;7542;5071;17493
312620;201407;2106;6104;1619;5459;110;384;1311;4565;1421;4949
312630;201407;512;1737;475;1667;130;508;212;722;342;1230
312640;201407;606;2002;500;1779;131;549;200;656;331;1205
312650;201407;2389;7091;1729;5850;209;810;943;3153;1152;3963
312660;201407;1307;3654;1112;3369;156;557;753;2231;909;2788
312670;201407;6148;18958;5532;18046;1373;5030;2797;8980;4170;14010
312675;201407;1469;4650;1263;4237;222;821;714;2410;936;3231
312680;201407;1723;5284;1542;4991;249;901;933;3084;1182;3985
312690;201407;2413;6653;1985;6050;388;1383;1112;3242;1500;4625
312695;201407;924;3299;865;3213;179;655;573;2205;752;2860
312700;201407;2198;6491;1707;5547;314;1146;881;2825;1195;3971
312705;201407;1430;4218;1247;3951;199;646;842;2684;1041;3330
312707;201407;1780;5522;1469;5001;243;1003;806;2681;1049;3684
312710;201407;8350;23613;6123;19679;2242;7997;1440;4333;3682;12330
312720;201407;774;2658;702;2520;188;750;302;1035;490;1785
312730;201407;1918;4794;1423;4229;221;778;860;2529;1081;3307
312733;201407;1769;4770;1338;3962;115;416;964;2753;1079;3169
312735;201407;914;2705;810;2553;272;941;395;1204;667;2145
312737;201407;1053;2590;746;2174;248;745;310;946;558;1691
312738;201407;546;1747;432;1516;128;531;166;548;294;1079
312740;201407;510;1471;348;1261;120;471;108;400;228;871
312750;201407;1310;4763;1253;4644;329;1398;594;2147;923;3545
312760;201407;2439;7906;1931;6897;573;2268;470;1696;1043;3964
312770;201407;46170;128293;36103;112722;10819;36611;12193;37709;23012;74320
312780;201407;2863;10175;2570;9666;527;2152;1468;5662;1995;7814
312790;201407;383;1011;236;745;76;275;63;170;139;445
312800;201407;5322;18135;4613;16662;1478;5716;1481;5450;2959;11166
312810;201407;2250;7009;1662;5920;559;2187;366;1233;925;3420
312820;201407;2194;6482;1976;6122;265;982;1273;3827;1538;4809
312825;201407;1543;4218;1351;3986;136;437;1074;3157;1210;3594
312830;201407;2838;9217;2061;7596;579;2339;397;1465;976;3804
312840;201407;1207;3994;1019;3631;208;889;465;1584;673;2473
312850;201407;661;2169;557;1955;130;541;208;707;338;1248
312860;201407;1321;3883;1011;3382;328;1280;312;919;640;2199
312870;201407;5735;18352;4456;15856;1229;4931;1306;4487;2535;9418
312880;201407;1274;3867;1077;3527;215;796;584;1897;799;2693
312890;201407;1625;4973;1192;4067;369;1420;414;1366;783;2786
312900;201407;1488;4803;1369;4637;353;1236;832;2871;1185;4107
312910;201407;1513;3473;1163;2995;297;883;552;1318;849;2201
312920;201407;1039;3395;914;3217;287;1128;395;1344;682;2472
312930;201407;2260;6746;1996;6364;463;1554;1025;3351;1488;4905
312940;201407;936;3165;844;2992;251;1052;264;861;515;1913
312950;201407;3555;10193;2889;9178;987;3375;1103;3469;2090;6844
312960;201407;1988;6017;1793;5757;224;711;1355;4471;1579;5182
312965;201407;1834;5880;1559;5381;314;1165;895;3149;1209;4314
312970;201407;1184;4060;1030;3821;415;1735;200;711;615;2446
312980;201407;21574;75812;20662;73638;7889;30084;7666;26657;15555;56741
312990;201407;404;1240;307;1063;116;445;93;320;209;765
313000;201407;536;1805;452;1638;140;615;168;538;308;1153
313005;201407;2664;8685;2377;8210;406;1535;1464;5066;1870;6601
313010;201407;4185;14131;3743;13375;1171;4620;1550;5304;2721;9924
313020;201407;1051;3627;956;3407;322;1289;292;911;614;2200
313030;201407;1610;4536;1294;4100;339;1220;674;2040;1013;3260
313040;201407;987;3478;845;3075;220;881;263;910;483;1791
313050;201407;1948;6360;1604;5859;539;2201;581;2027;1120;4228
313055;201407;1541;5124;1407;4934;151;553;1052;3763;1203;4316
313060;201407;988;3433;893;3214;394;1479;155;533;549;2012
313065;201407;1964;6522;1771;6218;301;1203;1261;4399;1562;5602
313070;201407;1279;3803;1040;3355;260;966;507;1548;767;2514
313080;201407;480;1526;393;1353;123;482;121;355;244;837
313090;201407;5531;16535;4989;15650;821;2732;3349;10640;4170;13372
313100;201407;1175;3808;1097;3693;175;649;793;2646;968;3295
313110;201407;1751;5167;1370;4442;326;1223;525;1577;851;2800
313115;201407;2906;10231;2779;9974;862;3455;1324;4541;2186;7996
313120;201407;3932;11277;3425;10559;947;3080;1953;6047;2900;9127
313130;201407;27824;88131;24644;81399;7382;26752;8887;27857;16269;54609
313140;201407;724;1893;535;1598;43;157;354;1038;397;1195
313150;201407;1686;5289;1511;4985;690;2356;418;1421;1108;3777
313160;201407;1183;3594;1050;3375;212;790;629;1939;841;2729
313170;201407;9907;36607;9137;34696;3638;14366;2104;8034;5742;22400
313180;201407;2808;7378;2116;6455;641;2155;768;2264;1409;4419
313190;201407;3630;13331;3228;12173;938;3837;1091;3991;2029;7828
313200;201407;1521;4803;1352;4522;235;920;845;2854;1080;3774
313210;201407;4666;14730;3985;13814;937;3781;2209;7385;3146;11166
313220;201407;1288;3975;970;3265;261;1006;264;788;525;1794
313230;201407;2550;9134;2394;8894;434;1676;1539;5931;1973;7607
313240;201407;8495;28816;7274;26509;2046;8224;3025;10998;5071;19222
313250;201407;7850;24592;7097;23330;1310;4399;4279;14461;5589;18860
313260;201407;637;1988;529;1779;128;493;158;505;286;998
313270;201407;5742;16965;5127;16037;753;2496;3583;11341;4336;13837
313280;201407;553;1808;429;1508;84;341;111;364;195;705
313290;201407;1046;3772;869;3414;294;1268;219;801;513;2069
313300;201407;2015;6922;1726;6211;556;2187;342;1103;898;3290
313310;201407;1087;3869;988;3652;288;1209;188;636;476;1845
313320;201407;2489;7534;2041;6773;421;1484;916;3077;1337;4561
313330;201407;3987;13071;3498;12138;734;2894;1801;6196;2535;9090
313340;201407;2348;5709;1806;4949;387;1109;994;2701;1381;3810
313350;201407;3425;10796;2667;9073;703;2581;573;1780;1276;4361
313360;201407;1216;3730;945;3229;301;1201;412;1294;713;2495
313370;201407;1514;5302;1439;5089;305;1261;681;2245;986;3506
313375;201407;2152;5805;1459;4751;389;1529;524;1630;913;3159
313380;201407;6949;23894;6068;21954;2283;8949;1892;6545;4175;15494
313390;201407;935;3395;902;3344;135;569;610;2243;745;2812
313400;201407;3749;10989;3483;10664;430;1388;2683;8374;3113;9762
313410;201407;1384;3983;1183;3712;251;867;721;2267;972;3134
313420;201407;20634;50742;13147;37563;3217;10332;3150;8701;6367;19033
313430;201407;1330;4371;1195;4118;376;1435;457;1501;833;2936
313440;201407;6711;16207;5014;14205;735;2269;3423;9733;4158;12002
313450;201407;745;2233;597;1921;156;602;207;601;363;1203
313460;201407;2585;9205;2332;8756;773;3166;729;2639;1502;5805
313470;201407;3501;9814;3324;9612;352;883;2779;8268;3131;9151
313480;201407;1152;3392;887;2921;159;598;389;1217;548;1815
313490;201407;1666;5460;1207;4657;460;1800;318;1269;778;3069
313500;201407;449;1463;425;1415;95;369;245;787;340;1156
313505;201407;9074;26958;8473;26246;525;1190;7617;24374;8142;25564
313507;201407;1439;4110;1270;3867;237;840;759;2335;996;3175
313510;201407;16060;47910;14425;45845;2296;7394;10281;33476;12577;40870
313520;201407;16612;50105;14080;45829;2158;7950;9026;29292;11184;37242
313530;201407;581;1976;507;1832;91;383;189;621;280;1004
313535;201407;2628;7863;2347;7397;348;1143;1538;4920;1886;6063
313540;201407;1145;3639;906;3036;274;963;231;711;505;1674
313545;201407;1414;5168;1250;4865;221;1047;769;2860;990;3907
313550;201407;2010;6844;1883;6571;537;2018;943;3192;1480;5210
313560;201407;2338;5777;2037;5435;281;665;1560;4357;1841;5022
313570;201407;827;3033;726;2838;277;1170;257;950;534;2120
313580;201407;6382;18053;5443;16773;772;2589;3877;12035;4649;14624
313590;201407;1096;3269;885;3018;411;1492;332;1116;743;2608
313600;201407;3994;12202;3505;11424;655;2282;2100;6981;2755;9263
313610;201407;1167;3667;1015;3373;266;965;447;1463;713;2428
313620;201407;7528;25357;7108;24464;2527;9248;2472;8374;4999;17622
313630;201407;9138;28030;7690;25731;2308;8538;2879;10017;5187;18555
313640;201407;893;2808;760;2613;264;980;280;961;544;1941
313650;201407;2355;7729;2095;7310;299;1042;1535;5488;1834;6530
313652;201407;1034;3735;952;3570;175;710;570;2142;745;2852
313655;201407;1031;3384;847;3075;164;681;515;1817;679;2498
313657;201407;1241;4016;1110;3791;167;748;755;2352;922;3100
313660;201407;928;3210;858;3082;219;904;421;1442;640;2346
313665;201407;3214;10746;2976;10218;721;2807;1469;4855;2190;7662
313670;201407;48442;138993;33408;113047;9780;36929;10550;34611;20330;71540
313680;201407;1145;3445;998;3218;137;452;702;2295;839;2747
313690;201407;989;3568;888;3356;265;1028;357;1393;622;2421
313695;201407;1519;4950;1293;4576;166;680;890;3158;1056;3838
313700;201407;3987;13286;3396;12475;567;2153;2349;8811;2916;10964
313710;201407;1440;4077;1203;3725;344;1153;582;1771;926;2924
313720;201407;5528;18721;4788;17128;1336;5328;1479;4814;2815;10142
313730;201407;1310;3588;1020;3236;148;519;659;2115;807;2634
313740;201407;2132;7757;1778;6837;632;2717;248;889;880;3606
313750;201407;3020;9341;2643;8609;889;3086;810;2494;1699;5580
313753;201407;1925;5841;1592;5258;504;1779;627;2098;1131;3877
313760;201407;4370;14555;3737;13239;1184;4607;1127;3789;2311;8396
313770;201407;3782;12771;3582;12324;1252;4552;1196;4082;2448;8634
313780;201407;4049;11600;3296;10496;837;3084;1584;4910;2421;7994
313790;201407;560;1959;541;1930;125;452;313;1143;438;1595
313800;201407;1283;3674;1140;3447;196;665;721;2178;917;2843
313810;201407;1591;4794;1532;4708;192;565;1188;3750;1380;4315
313820;201407;13498;39946;11390;36209;3156;11191;4649;14779;7805;25970
313830;201407;456;1553;393;1422;125;510;121;428;246;938
313835;201407;1084;3578;1035;3504;251;907;579;1952;830;2859
313840;201407;8070;24152;6641;21676;1952;7128;2201;6894;4153;14022
313850;201407;1297;3655;1169;3432;297;989;611;1694;908;2683
313860;201407;2776;8652;2290;7590;686;2562;539;1624;1225;4186
313862;201407;1193;3193;835;2604;248;818;276;876;524;1694
313865;201407;2326;7331;2133;7014;327;1212;1474;4828;1801;6040
313867;201407;1106;3854;942;3513;345;1366;319;1208;664;2574
313868;201407;1595;5643;1416;5263;186;802;948;3518;1134;4320
313870;201407;929;2920;836;2784;251;964;320;979;571;1943
313880;201407;2272;7348;2082;7095;521;2056;1057;3355;1578;5411
313890;201407;2045;5605;1732;5210;276;837;1145;3513;1421;4350
313900;201407;4882;17887;4549;17131;1699;7040;1333;4981;3032;12021
313910;201407;786;2686;674;2447;281;1103;123;417;404;1520
313920;201407;3828;12334;3444;11685;624;2115;2141;7566;2765;9681
313925;201407;2140;5700;1500;4481;138;459;974;2882;1112;3341
313930;201407;5466;17998;4578;16428;811;3164;2642;9729;3453;12893
313940;201407;7724;26752;6645;24992;2287;9344;2521;9781;4808;19125
313950;201407;4980;14575;4150;13211;1352;4819;1494;4568;2846;9387
313960;201407;6319;16962;5075;15247;1694;5644;1430;4239;3124;9883
313970;201407;1523;4476;1275;4197;236;842;837;2789;1073;3631
313980;201407;1268;4216;1092;3899;375;1476;351;1234;726;2710
313990;201407;2022;7665;1797;7144;654;2810;461;1702;1115;4512
314000;201407;8435;28882;7844;27731;2167;8683;4176;14362;6343;23045
314010;201407;1173;3398;974;3145;164;633;575;1798;739;2431
314015;201407;1617;6079;1487;5789;533;2176;483;1886;1016;4062
314020;201407;524;1656;428;1438;133;497;115;363;248;860
314030;201407;862;2798;686;2393;127;483;256;878;383;1361
314040;201407;651;1922;564;1769;183;616;282;864;465;1480
314050;201407;1955;6469;1645;5819;517;2023;509;1673;1026;3696
314053;201407;1537;5094;1427;4960;238;809;999;3613;1237;4422
314055;201407;2297;6887;2037;6527;188;628;1546;5057;1734;5685
314060;201407;1153;3659;954;3320;112;465;622;2157;734;2622
314070;201407;3799;11999;2912;10190;835;3199;750;2476;1585;5675
314080;201407;1963;6093;1395;4847;299;1193;353;1092;652;2285
314085;201407;1924;6722;1672;6357;534;2220;604;2298;1138;4518
314090;201407;3589;12327;3233;11626;1082;4202;1204;4396;2286;8598
314100;201407;3630;9765;3165;9108;389;1081;2417;7141;2806;8222
314110;201407;4543;15082;4016;13972;1025;4106;1515;4874;2540;8980
314120;201407;1088;2673;587;1868;178;644;153;462;331;1106
314130;201407;700;2062;407;1380;79;283;92;309;171;592
314140;201407;5160;16243;4568;15102;997;3546;2217;7373;3214;10919
314150;201407;1809;4830;1407;4194;273;917;690;2018;963;2935
314160;201407;2508;6727;2005;6055;142;454;1651;5106;1793;5560
314170;201407;1132;3505;942;3089;164;627;491;1544;655;2171
314180;201407;6626;21007;5833;19809;1593;5925;2642;9162;4235;15087
314190;201407;844;2644;735;2459;232;894;283;898;515;1792
314200;201407;3132;10161;2805;9563;419;1654;1895;6372;2314;8026
314210;201407;2056;6381;1842;5989;349;1278;1056;3306;1405;4584
314220;201407;1770;5825;1487;5237;503;1975;357;1116;860;3091
314225;201407;1203;3734;1083;3567;75;220;946;3189;1021;3409
314230;201407;726;2544;672;2441;219;849;238;833;457;1682
314240;201407;1174;3775;1037;3563;209;691;684;2448;893;3139
314250;201407;548;1669;424;1411;110;424;169;522;279;946
314260;201407;1310;4774;1235;4604;429;1695;444;1645;873;3340
314270;201407;2780;9651;2595;9314;325;1343;1795;6479;2120;7822
314280;201407;3403;9756;2457;7966;766;2822;695;2009;1461;4831
314290;201407;5524;15513;4717;14217;1040;3452;2943;8740;3983;12192
314300;201407;1996;6767;1841;6400;626;2254;691;2363;1317;4617
314310;201407;6786;21786;5985;20143;2274;8116;1818;5970;4092;14086
314315;201407;988;3779;923;3653;177;796;541;2166;718;2962
314320;201407;3656;10945;2915;9935;1021;3780;1166;3943;2187;7723
314330;201407;56533;181854;52626;175221;15897;57590;24075;79353;39972;136943
314340;201407;2535;7116;1392;4706;389;1435;128;277;517;1712
314345;201407;1388;4662;1225;4399;381;1410;642;2360;1023;3770
314350;201407;1481;4345;1193;3864;512;1794;320;1014;832;2808
314360;201407;729;2333;510;1858;146;616;134;461;280;1077
314370;201407;572;2020;533;1965;155;630;270;988;425;1618
314380;201407;1221;3722;899;3124;326;1206;257;916;583;2122
314390;201407;16215;48854;12949;42604;3986;14282;3784;11962;7770;26244
314400;201407;5658;16103;4598;14633;1439;4603;2384;7987;3823;12590
314410;201407;2804;9111;2413;8285;792;3087;823;2648;1615;5735
314420;201407;797;2330;638;2107;93;379;441;1433;534;1812
314430;201407;8354;24932;7513;23397;2529;8388;2509;8021;5038;16409
314435;201407;1307;4241;1164;3985;168;710;755;2530;923;3240
314437;201407;1227;3237;1081;3022;99;278;847;2388;946;2666
314440;201407;762;2123;537;1810;203;749;110;340;313;1089
314450;201407;1816;5414;1560;5045;516;1876;724;2220;1240;4096
314460;201407;4727;16484;4142;15136;1470;5791;838;3045;2308;8836
314465;201407;2441;7842;2248;7498;226;920;1683;5506;1909;6426
314467;201407;1148;3265;988;2992;149;435;657;2046;806;2481
314470;201407;2465;8091;1969;6946;562;2281;482;1452;1044;3733
314480;201407;7461;25926;5511;20587;1419;5723;589;1991;2008;7714
314490;201407;1000;3010;818;2650;252;914;337;1036;589;1950
314500;201407;3031;8525;2367;7288;721;2430;864;2698;1585;5128
314505;201407;1814;5660;1719;5495;356;1239;1053;3388;1409;4627
314510;201407;2054;5822;1443;4907;518;1933;388;1274;906;3207
314520;201407;3835;14739;3208;13111;1118;4995;621;2323;1739;7318
314530;201407;7294;25596;6728;24712;1291;4890;3983;15214;5274;20104
314535;201407;2938;8277;2525;7721;354;1174;1796;5508;2150;6682
314537;201407;1451;4400;1217;3978;262;960;602;2001;864;2961
314540;201407;463;1443;407;1320;132;501;132;386;264;887
314545;201407;1407;4518;1245;4261;255;967;729;2489;984;3456
314550;201407;622;1801;482;1610;125;519;155;469;280;988
314560;201407;5434;19417;4774;17667;1260;5125;1234;4408;2494;9533
314570;201407;374;1167;333;1079;99;350;156;488;255;838
314580;201407;490;1713;405;1518;132;558;87;316;219;874
314585;201407;862;2891;614;2329;176;742;174;662;350;1404
314587;201407;1786;5729;1589;5372;290;992;882;3031;1172;4023
314590;201407;4364;15249;3258;12202;892;3561;467;1600;1359;5161
314600;201407;2141;7462;1787;6826;720;3028;380;1389;1100;4417
314610;201407;8622;30798;8095;29555;2647;10575;2904;10124;5551;20699
314620;201407;1871;5458;1663;5197;233;686;1237;4011;1470;4697
314625;201407;1582;5311;1544;5262;175;590;1239;4313;1414;4903
314630;201407;5271;15631;4619;14596;609;2127;3181;10204;3790;12331
314640;201407;849;2437;717;2203;256;826;201;577;457;1403
314650;201407;1351;4033;1058;3494;277;1046;422;1274;699;2320
314655;201407;1701;5070;1311;4341;267;948;671;2228;938;3176
314660;201407;223;622;175;526;25;91;101;287;126;378
314670;201407;1542;4293;1241;3770;234;782;705;2129;939;2911
314675;201407;1962;6034;1740;5640;227;827;1114;3639;1341;4466
314690;201407;2793;8924;2371;8168;693;2751;703;2256;1396;5007
314700;201407;10792;40166;9430;37090;4107;16954;2282;9261;6389;26215
314710;201407;8891;28554;6320;22762;1632;6641;923;2995;2555;9636
314720;201407;2726;9178;2291;8290;683;2732;919;3280;1602;6012
314730;201407;2545;7921;2131;7315;779;2919;690;2279;1469;5198
314740;201407;3164;10603;2874;10053;865;3332;1153;3871;2018;7203
314750;201407;342;1121;308;1045;67;270;143;456;210;726
314760;201407;1734;6011;1257;4747;272;1215;282;895;554;2110
314770;201407;1200;3840;748;2565;96;405;111;276;207;681
314780;201407;329;913;248;802;88;328;105;331;193;659
314790;201407;13862;42645;10676;37026;3931;15438;2832;9355;6763;24793
314795;201407;1551;4785;1363;4478;161;676;1019;3221;1180;3897
314800;201407;17566;54084;14485;47789;5866;20249;3109;10512;8975;30761
314810;201407;13347;40417;10513;35303;3419;12736;2694;9061;6113;21797
314820;201407;1136;3145;786;2621;273;995;260;796;533;1791
314830;201407;1754;5987;1543;5566;542;2125;596;2204;1138;4329
314840;201407;1133;4004;901;3659;179;835;550;2244;729;3079
314850;201407;2312;6669;1907;5957;383;1395;1076;3320;1459;4715
314860;201407;3358;11585;3083;11140;644;2602;1891;6840;2535;9442
314870;201407;5853;18874;5227;18028;757;2913;3736;13079;4493;15992
314875;201407;1738;5982;1697;5923;248;826;1364;4855;1612;5681
314880;201407;850;2471;754;2322;74;233;537;1680;611;1913
314890;201407;583;1774;429;1468;105;414;127;378;232;792
314900;201407;436;1383;355;1240;100;365;166;575;266;940
314910;201407;1788;6265;1573;5887;651;2670;409;1439;1060;4109
314915;201407;2558;8110;2260;7672;225;891;1752;5906;1977;6797
314920;201407;659;1916;498;1680;112;428;231;729;343;1157
314930;201407;5312;18262;4702;16924;1584;6210;1129;4004;2713;10214
314940;201407;424;1262;399;1214;92;309;216;627;308;936
314950;201407;402;1369;335;1237;92;380;80;289;172;669
314960;201407;840;2738;678;2404;214;821;171;569;385;1390
314970;201407;899;3218;811;3041;304;1242;215;772;519;2014
314980;201407;2290;7079;2067;6717;873;2993;348;1078;1221;4071
314990;201407;3243;10518;2634;9162;980;3760;497;1561;1477;5321
314995;201407;1633;5083;1473;4856;211;837;1028;3320;1239;4157
315000;201407;1108;3262;908;2949;175;661;542;1735;717;2396
315010;201407;501;1620;414;1434;127;511;153;478;280;989
315015;201407;1971;6132;1792;5915;294;968;1291;4433;1585;5401
315020;201407;780;2510;635;2207;143;564;282;922;425;1486
315030;201407;1018;3140;871;2859;347;1199;208;679;555;1878
315040;201407;959;2987;880;2846;162;551;552;1771;714;2322
315050;201407;1665;4992;1383;4522;453;1623;496;1589;949;3212
315053;201407;1173;3504;1019;3256;252;955;426;1313;678;2268
315057;201407;1943;6646;1580;6079;253;1002;987;3935;1240;4937
315060;201407;981;3319;803;2887;248;967;202;753;450;1720
315070;201407;743;2237;664;2127;181;649;360;1102;541;1751
315080;201407;3521;12162;3169;11408;840;3268;1488;5360;2328;8628
315090;201407;768;2805;683;2621;176;725;251;998;427;1723
315100;201407;1198;4150;967;3631;286;1197;240;842;526;2039
315110;201407;1716;5294;1504;4909;401;1429;685;2214;1086;3643
315120;201407;14139;34337;10176;29199;1919;5811;5526;16709;7445;22520
315130;201407;1850;6176;1671;5812;575;2189;439;1488;1014;3677
315140;201407;2633;8874;2199;7922;644;2678;707;2267;1351;4945
315150;201407;4935;13679;3699;11501;887;3192;1380;4140;2267;7332
315160;201407;1363;3952;1224;3753;250;848;702;2104;952;2952
315170;201407;1389;4127;1191;3837;227;794;665;2305;892;3099
315180;201407;14652;45609;11133;38075;3189;12295;2745;9045;5934;21340
315190;201407;2428;6515;1990;5879;588;1849;952;2813;1540;4662
315200;201407;4618;15729;3859;14011;1232;4855;1050;3724;2282;8579
315210;201407;9078;27933;7639;25091;2548;9105;2650;8544;5198;17649
315213;201407;1149;3749;1100;3680;107;310;928;3204;1035;3514
315217;201407;2774;9386;2329;8617;380;1606;1349;4997;1729;6603
315220;201407;10345;30777;9130;29059;2272;7225;5145;16984;7417;24209
315230;201407;2600;7018;2341;6710;147;349;2055;6030;2202;6379
315240;201407;3420;10897;3081;10339;616;2231;1891;6348;2507;8579
315250;201407;9928;32047;7603;27597;2514;10164;2420;8723;4934;18887
315260;201407;1137;3714;905;3203;336;1322;176;556;512;1878
315270;201407;892;3209;774;2961;262;1077;200;739;462;1816
315280;201407;4061;12481;3193;10537;1112;3864;811;2553;1923;6417
315290;201407;1306;3755;1003;3266;369;1327;210;675;579;2002
315300;201407;547;1566;428;1418;206;710;146;467;352;1177
315310;201407;1261;4200;1120;3950;165;671;730;2527;895;3198
315320;201407;897;2917;745;2703;206;817;354;1335;560;2152
315330;201407;787;2817;556;2217;189;856;83;304;272;1160
315340;201407;4270;12552;3638;11557;939;3207;1680;5446;2619;8653
315350;201407;1921;5419;1516;4852;255;827;1005;3328;1260;4155
315360;201407;1756;5935;1437;5095;351;1368;494;1647;845;3015
315370;201407;618;1881;545;1770;129;456;306;990;435;1446
315380;201407;295;1044;253;935;93;376;42;140;135;516
315390;201407;1977;7090;1723;6491;621;2500;436;1629;1057;4129
315400;201407;4805;14832;4193;13624;999;3524;2154;6992;3153;10516
315410;201407;1842;5121;1557;4673;273;1027;948;2723;1221;3750
315415;201407;1215;4087;1117;3933;450;1577;491;1822;941;3399
315420;201407;1551;4916;1167;4169;388;1451;210;724;598;2175
315430;201407;4123;11381;3120;9675;857;3010;955;2843;1812;5853
315440;201407;988;3047;880;2875;174;639;480;1564;654;2203
315445;201407;2250;6411;1889;5921;281;1013;1299;4042;1580;5055
315450;201407;2536;8095;2361;7833;490;1594;1509;5205;1999;6799
315460;201407;40029;135272;35849;126293;12738;48248;9335;32050;22073;80298
315470;201407;569;1785;505;1672;75;271;331;1084;406;1355
315480;201407;1491;4705;1014;3599;219;884;204;671;423;1555
315490;201407;3346;9568;2841;8845;499;1818;1596;4853;2095;6671
315500;201407;471;1487;305;1090;64;275;104;314;168;589
315510;201407;1494;4283;1275;3927;97;330;934;2888;1031;3218
315520;201407;1179;3654;974;3376;168;671;598;2015;766;2686
315530;201407;514;1821;483;1765;221;859;172;600;393;1459
315540;201407;1283;3951;1029;3529;239;1001;367;1220;606;2221
315550;201407;1844;5370;1517;4940;508;1850;612;1984;1120;3834
315560;201407;7346;24223;6716;23390;962;3659;4626;16267;5588;19926
315570;201407;2418;7640;2258;7399;499;1854;1316;4248;1815;6102
315580;201407;2803;8685;2272;7690;644;2525;847;2680;1491;5205
315590;201407;916;2677;829;2549;130;465;534;1594;664;2059
315600;201407;2677;9444;2226;8671;407;1671;1270;5177;1677;6848
315610;201407;1038;3105;871;2748;197;773;324;854;521;1627
315620;201407;341;1224;333;1208;100;353;174;659;274;1012
315630;201407;1012;3288;879;3069;255;960;246;830;501;1790
315640;201407;836;2520;708;2279;211;760;270;826;481;1586
315645;201407;886;2865;769;2585;308;1138;197;631;505;1769
315650;201407;2018;5797;1765;5439;163;647;1320;3985;1483;4632
315660;201407;2719;7397;2401;6921;462;1372;1475;4250;1937;5622
315670;201407;12325;43962;11293;41844;4111;16222;3702;13568;7813;29790
315680;201407;2941;10315;2428;9329;923;3613;608;2478;1531;6091
315690;201407;3451;10920;2792;9707;974;3691;819;2897;1793;6588
315700;201407;7541;24095;6531;22051;1398;5419;3154;10202;4552;15621
315710;201407;1865;5546;1517;4999;205;804;918;2999;1123;3803
315720;201407;3108;10092;2845;9599;708;2772;1384;4404;2092;7176
315725;201407;1690;5235;1375;4821;391;1420;725;2587;1116;4007
315727;201407;665;2106;590;1955;139;507;280;903;419;1410
315730;201407;1014;3144;924;2973;203;703;521;1682;724;2385
315733;201407;1201;3891;1110;3710;461;1618;373;1232;834;2850
315737;201407;1396;4244;1132;3776;119;460;715;2410;834;2870
315740;201407;1087;3472;937;3174;210;849;467;1484;677;2333
315750;201407;1171;3660;1053;3494;108;448;788;2561;896;3009
315760;201407;975;2726;943;2684;24;73;873;2492;897;2565
315765;201407;1535;4705;1425;4533;142;478;1112;3582;1254;4060
315770;201407;1717;5612;1560;5273;451;1641;568;1877;1019;3518
315780;201407;24272;80806;22501;76931;7462;27176;7096;24343;14558;51519
315790;201407;3337;11495;2989;10751;382;1329;2010;7449;2392;8778
315800;201407;1573;6165;1296;5338;396;1803;267;1044;663;2847
315810;201407;1525;4370;1299;4010;216;728;838;2532;1054;3260
315820;201407;3071;10087;2617;9401;772;2889;1276;4722;2048;7611
315830;201407;1487;5068;1360;4795;352;1387;422;1385;774;2772
315840;201407;765;2079;590;1761;112;391;215;585;327;976
315850;201407;1352;4793;1302;4689;343;1299;583;2046;926;3345
315860;201407;472;1707;379;1520;112;524;78;301;190;825
315870;201407;485;1463;410;1348;125;458;142;427;267;885
315880;201407;1129;3115;940;2875;242;847;466;1410;708;2257
315890;201407;1730;5903;1562;5645;518;1956;751;2782;1269;4738
315895;201407;5319;16718;4909;15955;1292;4676;2352;7460;3644;12136
315900;201407;801;2549;752;2466;164;645;450;1364;614;2009
315910;201407;629;2234;587;2153;219;830;275;1002;494;1832
315920;201407;1514;4472;1084;3574;309;1166;332;987;641;2153
315930;201407;1155;3240;933;2850;264;884;335;995;599;1879
315935;201407;1181;4019;1096;3835;355;1364;349;1183;704;2547
315940;201407;671;2151;599;2002;176;660;246;796;422;1456
315950;201407;1282;3984;1189;3798;289;939;709;2318;998;3257
315960;201407;2834;9547;2168;8201;1044;4507;136;444;1180;4951
315970;201407;813;2292;655;2070;74;226;479;1569;553;1795
315980;201407;4482;11111;2926;8446;752;2474;912;2317;1664;4791
315990;201407;4465;13397;3925;12553;869;3229;2112;6702;2981;9931
316000;201407;608;1993;544;1891;236;889;167;557;403;1446
316010;201407;467;1715;415;1601;112;513;128;435;240;948
316020;201407;1198;3819;964;3411;180;749;543;1904;723;2653
316030;201407;3769;10685;2697;8928;393;1412;1432;4893;1825;6305
316040;201407;3599;11417;2572;9078;457;1862;323;852;780;2714
316045;201407;2168;6977;2010;6708;290;900;1451;5080;1741;5980
316050;201407;385;1242;329;1156;77;305;175;588;252;893
316060;201407;794;2393;648;2181;122;506;362;1151;484;1657
316070;201407;6287;20829;5675;19477;1709;6523;2387;7820;4096;14343
316080;201407;752;2829;679;2630;187;807;138;537;325;1344
316090;201407;663;1956;484;1577;120;444;132;390;252;834
316095;201407;1337;4441;1204;4191;257;915;777;2778;1034;3693
316100;201407;2741;9310;2139;7757;591;2443;443;1488;1034;3931
316105;201407;982;2785;738;2384;171;611;348;1146;519;1757
316110;201407;12715;44615;11540;42439;1633;6582;7929;29886;9562;36468
316120;201407;1319;4526;1192;4218;394;1444;440;1533;834;2977
316130;201407;1488;3410;1005;2750;206;669;512;1358;718;2027
316140;201407;1107;3288;859;2889;125;472;516;1757;641;2229
316150;201407;1415;4281;1348;4180;335;1208;762;2288;1097;3496
316160;201407;1269;3835;1001;3293;137;523;562;1826;699;2349
316165;201407;1001;2770;838;2515;171;595;481;1411;652;2006
316170;201407;1421;4141;1066;3508;241;908;447;1384;688;2292
316180;201407;1291;4147;1003;3538;283;1171;273;870;556;2041
316190;201407;2750;8571;1465;5202;345;1289;259;804;604;2093
316200;201407;3947;12903;3049;11061;804;3365;910;3199;1714;6564
316210;201407;5495;17525;4809;16237;2184;7922;999;3367;3183;11289
316220;201407;688;2155;480;1746;116;495;62;238;178;733
316225;201407;1117;3295;995;3129;137;514;688;2122;825;2636
316230;201407;463;1391;382;1247;79;278;196;669;275;947
316240;201407;6654;20750;5790;19623;653;2269;4460;15312;5113;17581
316245;201407;3203;11247;3005;10915;278;1251;2307;8352;2585;9603
316250;201407;9554;30127;8351;27659;3104;11198;2458;7701;5562;18899
316255;201407;2430;7674;2156;7344;361;1197;1537;5349;1898;6546
316257;201407;1450;4102;1117;3499;279;975;410;1249;689;2224
316260;201407;1901;5448;1425;4748;292;1081;774;2617;1066;3698
316265;201407;1198;3499;1033;3172;101;349;744;2255;845;2604
316270;201407;5237;16904;4847;16098;1399;4920;2202;7410;3601;12330
316280;201407;3419;11388;3087;10717;601;2309;1744;6062;2345;8371
316290;201407;3311;10918;2980;10294;769;3043;1328;4368;2097;7411
316292;201407;3846;12872;3528;12281;1039;3971;1579;5249;2618;9220
316294;201407;868;2828;563;2093;139;609;69;236;208;845
316295;201407;2056;7323;1930;7069;448;1914;1055;3641;1503;5555
316300;201407;1013;3146;876;2897;81;278;607;2054;688;2332
316310;201407;701;2230;547;1911;134;531;196;669;330;1200
316320;201407;582;1975;521;1888;137;537;160;567;297;1104
316330;201407;1039;3170;831;2727;136;452;495;1655;631;2107
316340;201407;1176;3853;1020;3537;321;1276;326;1030;647;2306
316350;201407;1501;4782;1366;4549;289;973;721;2558;1010;3531
316360;201407;793;2074;618;1832;71;221;472;1406;543;1627
316370;201407;5198;17257;4612;16052;1638;6123;1101;3892;2739;10015
316380;201407;1516;4292;1247;3895;132;476;885;2777;1017;3253
316390;201407;948;2865;790;2589;252;902;345;1145;597;2047
316400;201407;1506;5086;1322;4757;373;1435;546;1978;919;3413
316410;201407;1230;4129;1151;4002;264;981;672;2346;936;3327
316420;201407;2075;6919;1900;6686;274;1103;1245;4399;1519;5502
316430;201407;996;3069;817;2737;247;921;293;921;540;1842
316440;201407;666;2230;584;2123;243;1002;206;726;449;1728
316443;201407;722;2210;608;1987;157;558;255;815;412;1373
316447;201407;1433;4667;1361;4553;121;436;1152;3858;1273;4294
316450;201407;2289;7895;2026;7382;402;1539;1254;4676;1656;6215
316460;201407;904;2918;847;2824;249;916;477;1519;726;2435
316470;201407;8346;27640;6621;23772;2096;8546;1993;6844;4089;15390
316480;201407;252;876;227;831;65;256;76;267;141;523
316490;201407;380;1227;362;1185;125;428;153;482;278;910
316500;201407;1079;3965;738;2892;166;708;47;180;213;888
316510;201407;980;3560;875;3329;345;1357;237;897;582;2254
316520;201407;1244;3894;1036;3572;277;1078;393;1230;670;2308
316530;201407;1161;3792;969;3386;242;1048;369;1079;611;2127
316540;201407;1025;3375;923;3204;263;1089;352;1115;615;2204
316550;201407;1310;4450;1203;4280;259;1003;753;2691;1012;3694
316553;201407;2358;8677;1980;7763;699;2952;476;1792;1175;4744
316555;201407;2915;10130;2580;9748;238;871;2072;8029;2310;8900
316556;201407;625;1751;512;1549;49;197;362;1038;411;1235
316557;201407;743;2736;715;2690;342;1373;199;700;541;2073
316560;201407;375;1282;314;1141;87;368;79;250;166;618
316570;201407;1462;4665;1281;4282;257;938;681;2270;938;3208
316580;201407;293;857;228;733;59;227;81;242;140;469
316590;201407;1544;4323;1169;3686;214;805;670;2020;884;2825
316600;201407;1204;3935;1070;3662;322;1160;386;1293;708;2453
316610;201407;627;2312;579;2224;144;616;334;1272;478;1888
316620;201407;2279;7262;1995;6693;480;1780;1035;3412;1515;5192
316630;201407;1565;5260;1378;4863;579;2114;426;1518;1005;3632
316640;201407;260;856;226;780;60;236;92;303;152;539
316650;201407;976;3731;862;3540;197;840;476;2061;673;2901
316660;201407;141;438;123;403;29;112;57;175;86;287
316670;201407;1913;5610;1551;4918;597;2111;390;1107;987;3218
316680;201407;2076;6057;1781;5612;233;721;1373;4426;1606;5147
316690;201407;1203;4127;1087;3919;375;1538;403;1408;778;2946
316695;201407;1267;3950;1132;3714;121;393;747;2564;868;2957
316700;201407;358;1219;334;1160;88;353;158;508;246;861
316710;201407;3515;13344;3069;12354;1073;4539;958;4061;2031;8600
316720;201407;19960;68036;17196;61826;6105;23347;4690;16709;10795;40056
316730;201407;445;1414;393;1313;98;385;204;624;302;1009
316740;201407;780;2687;703;2531;274;1060;216;749;490;1809
316750;201407;436;1522;392;1427;110;451;129;434;239;885
316760;201407;3686;12463;3125;11814;1758;6621;998;4016;2756;10637
316770;201407;1525;4514;1359;4290;211;719;928;3030;1139;3749
316780;201407;725;2517;676;2422;253;984;191;642;444;1626
316790;201407;865;2577;642;2183;179;693;232;769;411;1462
316800;201407;5975;20006;5433;18996;1158;4711;2778;9284;3936;13995
316805;201407;904;2454;851;2385;152;404;635;1840;787;2244
316810;201407;605;1882;528;1717;173;617;234;731;407;1348
316820;201407;402;1154;274;929;93;338;66;224;159;562
316830;201407;646;2291;624;2254;216;843;262;916;478;1759
316840;201407;2986;9125;2582;8381;705;2594;1083;3338;1788;5932
316850;201407;2231;7050;2024;6664;447;1610;1114;3680;1561;5290
316860;201407;24348;76255;22150;72149;6200;22224;9932;32070;16132;54294
316870;201407;7348;24750;6402;22445;2380;8951;1351;4618;3731;13569
316880;201407;916;3114;887;3067;359;1373;290;939;649;2312
316890;201407;1485;3849;1185;3438;481;1533;478;1325;959;2858
316900;201407;2800;8925;2440;8187;795;2957;819;2516;1614;5473
316905;201407;490;1694;438;1572;195;733;133;462;328;1195
316910;201407;751;2584;602;2258;152;600;201;781;353;1381
316920;201407;1628;4984;1313;4479;244;884;644;2206;888;3090
316930;201407;9858;34245;8354;30861;2607;10665;1807;6270;4414;16935
316935;201407;5098;15395;3569;12295;1227;4704;738;2401;1965;7105
316940;201407;7242;24553;6085;22042;1683;6770;1619;5657;3302;12427
316950;201407;1561;4660;1369;4392;211;799;922;2940;1133;3739
316960;201407;5608;14520;4654;13284;1018;3138;2728;7803;3746;10941
316970;201407;3659;11998;3464;11655;1206;4584;1136;3553;2342;8137
316980;201407;1114;3298;806;2767;342;1292;209;717;551;2009
316990;201407;10289;34622;9221;32146;3838;14537;1247;4131;5085;18668
317000;201407;2760;9671;2671;9565;216;663;2148;8427;2364;9090
317005;201407;2570;8283;2384;8035;381;1296;1736;5961;2117;7257
317010;201407;32837;87305;21251;68038;6196;21943;5453;18322;11649;40265
317020;201407;54082;159229;35477;119558;9599;35589;8733;27654;18332;63243
317030;201407;902;2576;759;2364;126;461;438;1362;564;1823
317040;201407;13579;41278;11796;37938;4037;13525;4785;15685;8822;29210
317043;201407;870;2506;738;2330;160;528;450;1444;610;1972
317047;201407;1239;3302;935;2797;185;608;433;1295;618;1903
317050;201407;1914;6810;1625;6121;488;1974;593;2161;1081;4135
317052;201407;2524;8098;2239;7665;266;1011;1667;5761;1933;6772
317057;201407;1826;5316;1417;4602;214;832;766;2427;980;3259
317060;201407;394;1183;303;981;71;266;108;315;179;581
317065;201407;1239;4150;1124;3961;133;540;874;3060;1007;3600
317070;201407;9205;30641;7087;25766;2143;8626;1566;5727;3709;14353
317075;201407;1295;4047;1102;3684;374;1350;382;1237;756;2587
317080;201407;7360;21225;6646;20017;2060;6652;2623;7896;4683;14548
317090;201407;4969;16963;4644;16395;724;2577;3166;11462;3890;14039
317100;201407;3395;10021;2904;9187;965;3397;1197;3588;2162;6985
317103;201407;2041;7148;1724;6487;356;1653;786;2876;1142;4529
317107;201407;1387;4324;1200;3946;255;967;653;2026;908;2993
317110;201407;764;2077;531;1632;155;550;209;592;364;1142
317115;201407;1114;3606;973;3292;148;526;631;2150;779;2676
317120;201407;13739;46976;11802;42366;3956;15163;4461;15837;8417;31000
317130;201407;9159;29346;8202;27607;2277;8590;3632;11981;5909;20571
317140;201407;669;2314;629;2237;87;338;409;1454;496;1792
317150;201407;1083;2997;918;2809;109;380;682;2083;791;2463
317160;201407;3880;10457;2936;9246;427;1572;1964;6118;2391;7690
317170;201407;2043;5991;1820;5591;263;930;1096;3208;1359;4138
317180;201407;1866;6369;1480;5489;443;1796;457;1650;900;3446
317190;201407;1398;4054;1166;3737;171;561;811;2597;982;3158
317200;201407;4863;16132;4409;15188;1494;5605;1380;4602;2874;10207
317210;201407;1132;3509;948;3229;266;1000;453;1551;719;2551
317220;201407;361;1295;350;1282;123;452;185;700;308;1152
320010;201407;6020;19046;5341;17515;1013;3568;2762;9028;3775;12596
320013;201407;2099;6234;1485;5082;232;838;814;2863;1046;3701
320016;201407;3601;10092;3044;9288;480;1466;2133;6636;2613;8102
320020;201407;4311;14042;3964;13282;1333;4744;1478;4912;2811;9656
320030;201407;1533;4995;1298;4489;398;1461;533;1789;931;3250
320035;201407;1879;5804;1699;5510;550;1954;743;2317;1293;4271
320040;201407;3261;11123;2724;9820;767;3047;809;2785;1576;5832
320050;201407;1972;5439;1701;4910;305;991;1000;2830;1305;3821
320060;201407;11624;36980;9036;30841;2257;8503;3300;10740;5557;19243
320070;201407;1863;6293;1620;5708;547;2036;428;1420;975;3456
320080;201407;5756;17036;4615;14749;1443;4926;1522;4823;2965;9749
320090;201407;9204;26524;7184;22557;1984;6644;3184;9726;5168;16370
320100;201407;3317;10085;2748;8937;683;2377;1311;4199;1994;6576
320110;201407;1567;4800;1420;4515;391;1323;513;1615;904;2938
320115;201407;1815;6652;1708;6409;835;3210;575;2222;1410;5432
320120;201407;18569;62052;15641;56079;5624;21523;4620;16771;10244;38294
320130;201407;42263;141483;39194;134918;11061;41421;18521;62350;29582;103771
320140;201407;4082;13343;2927;10483;799;3190;324;1084;1123;4274
320150;201407;18633;53307;13968;44310;4435;15192;2716;8494;7151;23686
320160;201407;5417;16718;4678;15465;1279;4751;2000;6180;3279;10931
320170;201407;1652;5406;1415;4877;400;1452;558;1961;958;3413
320180;201407;914;3025;821;2882;304;1106;328;1166;632;2272
320190;201407;4378;15310;3650;13495;1175;4545;1144;4183;2319;8728
320200;201407;1179;3822;1036;3536;302;1092;464;1619;766;2711
320210;201407;5728;16041;5001;14741;1213;3993;2638;7460;3851;11453
320220;201407;3013;9255;2394;8148;719;2661;922;3173;1641;5834
320225;201407;1540;5445;1325;4890;498;1941;300;1166;798;3107
320230;201407;4322;14583;4031;14008;1402;5198;1463;5207;2865;10405
320240;201407;10420;31743;8182;27404;2487;8953;2294;7746;4781;16699
320245;201407;4187;14370;3888;13623;1276;4698;1410;4872;2686;9570
320250;201407;1839;5782;1371;4696;365;1402;301;924;666;2326
320255;201407;2082;7012;1809;6536;739;2855;649;2415;1388;5270
320260;201407;1147;3585;874;2870;237;880;311;884;548;1764
320265;201407;2529;7848;2157;7402;291;1004;1589;5628;1880;6632
320270;201407;2798;8616;2153;7313;554;2036;932;3118;1486;5154
320280;201407;7375;22636;6713;21416;1585;5462;3412;10694;4997;16156
320290;201407;1730;5740;1384;4852;507;1866;354;1140;861;3006
320300;201407;4377;14935;4050;14167;1302;4806;1336;4684;2638;9490
320305;201407;4882;16143;4444;15142;1156;4299;2089;6945;3245;11244
320310;201407;2052;6262;1814;5820;493;1711;820;2561;1313;4272
320313;201407;2429;7337;1737;5726;504;1912;305;899;809;2811
320316;201407;2248;7078;2114;6761;660;2205;912;2905;1572;5110
320320;201407;19603;63590;16808;58125;5146;19823;6553;22046;11699;41869
320330;201407;3074;9371;2668;8680;567;1814;1563;5272;2130;7086
320332;201407;5160;17618;4659;16666;1577;5945;1855;6824;3432;12769
320334;201407;1667;5598;1278;4729;441;1809;268;907;709;2716
320335;201407;2305;7002;1637;5459;572;2083;339;1086;911;3169
320340;201407;5901;16810;4759;14815;1167;3991;2239;6898;3406;10889
320350;201407;5696;14931;4177;12298;861;2768;1960;5708;2821;8476
320360;201407;1801;4851;1373;4043;273;920;653;1777;926;2697
320370;201407;3559;11811;3062;10805;963;3453;1207;4308;2170;7761
320380;201407;2886;8867;2584;8290;521;1814;1498;4733;2019;6547
320390;201407;8453;25851;6982;22846;2189;7868;2342;7354;4531;15222
320400;201407;4179;12143;3486;11116;938;3347;1676;5079;2614;8426
320405;201407;4123;12376;3786;11926;1073;3683;2174;6713;3247;10396
320410;201407;6375;15767;4600;13715;840;2603;2960;8886;3800;11489
320420;201407;1549;4834;1127;4078;381;1544;214;725;595;2269
320425;201407;2499;6426;2036;5738;358;1110;1233;3451;1591;4561
320430;201407;2428;7178;2192;6702;451;1464;1158;3516;1609;4980
320435;201407;2606;8822;2231;8013;1034;3865;707;2623;1741;6488
320440;201407;1460;4914;1305;4478;398;1473;413;1338;811;2811
320450;201407;2573;8317;2184;7480;659;2445;920;3066;1579;5511
320455;201407;4476;15677;3466;13084;1147;4534;823;3088;1970;7622
320460;201407;3193;10446;2576;9105;755;2861;946;3256;1701;6117
320465;201407;1694;5392;1330;4509;324;1188;515;1676;839;2864
320470;201407;4752;14711;3410;11711;1119;4185;528;1656;1647;5841
320480;201407;2021;6164;1685;5503;421;1597;736;2266;1157;3863
320490;201407;18066;57853;15282;52313;5216;18977;5165;18128;10381;37105
320495;201407;1370;4374;1071;3684;483;1730;172;609;655;2339
320500;201407;48139;151083;41955;139149;12861;46203;18668;60650;31529;106853
320501;201407;3823;12527;3483;11940;1168;4462;1518;5038;2686;9500
320503;201407;2031;7214;1686;6361;553;2279;500;1714;1053;3993
320506;201407;3431;10897;2358;8136;733;2702;276;864;1009;3566
320510;201407;8974;28815;7885;26613;2539;9217;3217;10701;5756;19918
320515;201407;2170;6260;1919;5764;566;1801;699;2045;1265;3846
320517;201407;2319;7631;1926;6784;768;2911;430;1418;1198;4329
320520;201407;35158;113092;30025;102888;9592;35815;12385;42324;21977;78139
320530;201407;29034;91329;25052;83276;6709;25283;11187;35330;17896;60613
330010;201407;18433;57902;16985;54922;3392;12399;10331;32352;13723;44751
330015;201407;2029;5686;1760;5178;471;1546;665;1893;1136;3439
330020;201407;17214;51961;15746;49556;3695;12508;8963;27974;12658;40482
330022;201407;1714;5530;1528;5171;325;1295;831;2684;1156;3979
330023;201407;3537;11571;3314;11104;923;3378;1391;4457;2314;7835
330025;201407;3529;10732;3195;10238;804;2765;1893;5978;2697;8743
330030;201407;7946;27464;7207;25894;2009;7938;3260;11259;5269;19197
330040;201407;14730;42780;12546;39213;3358;11282;6335;19422;9693;30704
330045;201407;69602;200760;63405;191338;9336;30296;44048;132165;53384;162461
330050;201407;3016;9639;2694;8990;936;3470;784;2457;1720;5927
330060;201407;5769;17650;5178;16782;1269;4530;2954;9627;4223;14157
330070;201407;25988;81155;23808;77178;6608;22702;11130;36172;17738;58874
330080;201407;9659;27757;9181;27077;1732;4948;6364;19365;8096;24313
330090;201407;3337;9293;3092;8869;860;2655;1498;4233;2358;6888
330093;201407;2044;6097;1721;5468;442;1507;586;1769;1028;3276
330095;201407;1234;4296;1144;4089;431;1685;212;692;643;2377
330100;201407;57693;189823;53064;181553;12030;45469;27566;95153;39596;140622
330110;201407;2737;8699;2503;8263;793;2849;865;2848;1658;5697
330115;201407;2518;7548;2308;7189;694;2364;1063;3197;1757;5561
330120;201407;2588;7564;2365;7258;734;2419;1109;3308;1843;5727
330130;201407;4162;13777;3747;12971;1243;4611;1503;5196;2746;9807
330140;201407;3478;10712;3178;10297;880;3054;1592;5202;2472;8256
330150;201407;2649;7959;2057;6717;556;1954;489;1555;1045;3509
330160;201407;1426;4964;1322;4742;484;1866;486;1712;970;3578
330170;201407;107406;327661;100448;316633;15668;52864;69954;220755;85622;273619
330180;201407;1883;5734;1655;5299;232;949;1037;3095;1269;4044
330185;201407;8211;26138;7593;25037;1990;6838;4144;13995;6134;20833
330187;201407;4498;12956;3984;12092;856;2840;2357;7166;3213;10006
330190;201407;29043;87854;27652;85555;6575;21511;16914;51851;23489;73362
330200;201407;14234;45135;12808;42422;3045;10328;6985;23529;10030;33857
330205;201407;2686;7337;2369;6789;590;1881;1186;3288;1776;5169
330210;201407;4654;12211;3340;9775;1012;3207;801;2318;1813;5525
330220;201407;11894;37597;10904;35516;3636;12758;3453;10756;7089;23514
330225;201407;4202;13259;3940;12864;518;1947;2849;9397;3367;11344
330227;201407;18252;52168;16413;49597;4061;13037;9386;27945;13447;40982
330230;201407;1540;4582;1407;4343;412;1415;582;1683;994;3098
330240;201407;20960;65527;18695;61372;7537;26702;3754;12163;11291;38865
330245;201407;1284;4094;1063;3640;323;1215;250;847;573;2062
330250;201407;38364;113211;35743;108831;10387;31900;18276;56933;28663;88833
330260;201407;4005;12721;3681;12023;933;3329;1731;5463;2664;8792
330270;201407;14597;42766;12282;39077;3717;12497;4724;15337;8441;27834
330280;201407;2113;6619;1793;5959;389;1449;861;2707;1250;4156
330285;201407;19705;58346;18102;56011;3681;12189;11553;35866;15234;48055
330290;201407;3692;10440;3270;9840;677;2327;1940;5579;2617;7906
330300;201407;4210;13733;3922;13200;933;3363;2132;7187;3065;10550
330310;201407;2863;8312;2589;7848;622;1934;1332;4033;1954;5967
330320;201407;12836;38597;12046;37368;1835;6202;8640;26696;10475;32898
330330;201407;32914;94803;30165;90414;7007;22471;18486;54819;25493;77290
330340;201407;15362;47432;12509;41742;4039;14421;3746;12410;7785;26831
330350;201407;96359;305134;92874;299915;17039;55565;66191;216825;83230;272390
330360;201407;5813;18315;5681;18111;737;2549;4453;14145;5190;16694
330370;201407;3927;14623;3705;14083;1426;5685;1293;4943;2719;10628
330380;201407;4732;15371;4149;14271;1019;3795;2146;7311;3165;11106
330385;201407;4177;14565;3866;13925;1285;4906;1530;5498;2815;10404
330390;201407;24556;83152;22508;79030;5570;21845;11613;39925;17183;61770
330395;201407;3468;10364;3201;9891;584;1984;1939;5948;2523;7932
330400;201407;2658;8906;2429;8471;528;2136;1263;4085;1791;6221
330410;201407;3123;9987;2695;9122;625;2236;1372;4653;1997;6889
330411;201407;2631;8358;2321;7729;481;1872;1239;3906;1720;5778
330412;201407;1432;4956;1142;4383;313;1384;404;1453;717;2837
330414;201407;26419;75389;22714;70371;4284;13884;14622;45658;18906;59542
330415;201407;3743;11760;3301;10936;862;3107;1431;4732;2293;7839
330420;201407;8898;27835;6470;22913;1951;7631;1196;4181;3147;11812
330430;201407;8460;25094;7560;23508;1792;6130;3829;11692;5621;17822
330440;201407;2133;7169;1797;6463;642;2581;400;1310;1042;3891
330450;201407;1681;5806;1574;5592;503;1998;666;2319;1169;4317
330452;201407;10155;31607;8410;28122;2342;8720;3505;11272;5847;19992
330455;201407;492062;1441084;420424;1323612;110343;370282;215565;677252;325908;1047534
330460;201407;1414;4760;1316;4581;332;1327;643;2214;975;3541
330470;201407;4757;15411;4368;14642;1527;5556;1545;5027;3072;10583
330475;201407;8508;26915;7646;25451;2116;7620;3647;12172;5763;19792
330480;201407;6744;20173;6191;19289;1705;5705;2918;9018;4623;14723
330490;201407;103586;290670;96160;279893;12438;37972;74085;216551;86523;254523
330500;201407;7025;21536;6608;20704;1459;4881;3642;11655;5101;16536
330510;201407;43782;141003;41036;136409;13208;44658;20573;69948;33781;114606
330513;201407;1615;4877;1475;4609;522;1652;590;1876;1112;3528
330515;201407;3151;9976;2864;9426;950;3305;1044;3393;1994;6698
330520;201407;13519;40694;12359;38744;3179;10420;6587;20785;9766;31205
330530;201407;1591;4761;1452;4506;382;1280;695;2125;1077;3405
330540;201407;3505;10532;3011;9718;861;2980;1263;4029;2124;7009
330550;201407;9157;30264;8076;28226;3340;12347;2086;7352;5426;19699
330555;201407;10682;32620;9599;30968;1890;6277;6128;20135;8018;26412
330560;201407;4312;13213;4008;12704;876;3151;2203;6774;3079;9925
330570;201407;3725;10797;3164;9832;819;2615;1637;5165;2456;7780
330575;201407;5706;17037;5189;16124;1141;3890;3075;9269;4216;13159
330580;201407;17693;57121;15442;52530;5068;18085;5887;20391;10955;38476
330590;201407;1997;6040;1866;5811;536;1689;978;3103;1514;4792
330600;201407;10600;31066;8721;28003;1381;5319;5199;16054;6580;21373
330610;201407;9310;30097;8596;28760;2080;7783;4447;14681;6527;22464
330615;201407;1689;6080;1558;5723;692;2649;456;1735;1148;4384
330620;201407;4132;14477;3792;13798;1407;5439;1092;4114;2499;9553
330630;201407;22289;72369;19795;67376;5245;19932;9852;32151;15097;52083
350010;201407;3035;9504;2367;8094;798;2864;472;1537;1270;4401
350020;201407;630;1793;486;1522;143;508;193;566;336;1074
350030;201407;4899;15701;4073;13831;1495;5553;1147;3729;2642;9282
350040;201407;606;2188;524;2003;178;730;116;397;294;1127
350050;201407;1431;4692;1199;4248;338;1365;402;1319;740;2684
350055;201407;644;2130;614;2083;197;755;300;954;497;1709
350060;201407;90;313;83;300;25;107;33;112;58;219
350070;201407;2906;9606;2303;8186;561;2199;462;1414;1023;3613
350075;201407;561;1951;483;1819;164;692;134;458;298;1150
350080;201407;616;1817;478;1526;119;419;186;588;305;1007
350090;201407;591;1694;443;1434;126;439;125;366;251;805
350100;201407;2107;7139;1704;6203;577;2243;512;1809;1089;4052
350110;201407;490;1504;384;1261;97;364;142;425;239;789
350115;201407;1397;4525;1239;4134;259;1003;594;1810;853;2813
350120;201407;552;1486;290;921;71;245;57;172;128;417
350130;201407;3866;11824;3485;11061;865;3082;1635;4853;2500;7935
350140;201407;712;2255;640;2112;156;586;279;876;435;1462
350150;201407;435;1504;400;1423;155;576;107;381;262;957
350160;201407;6439;20349;4936;17040;1483;5680;1853;5857;3336;11537
350170;201407;2298;8196;2053;7566;719;2765;492;1732;1211;4497
350180;201407;1471;3883;1220;3451;324;941;535;1494;859;2435
350190;201407;3397;11499;2938;10570;800;3378;1439;4694;2239;8072
350200;201407;415;1414;377;1348;130;523;135;464;265;987
350210;201407;7743;21767;6152;18986;2334;7777;2064;6088;4398;13865
350220;201407;3200;10309;2912;9783;1028;3910;922;2825;1950;6735
350230;201407;775;2627;712;2522;238;912;252;893;490;1805
350240;201407;606;1852;525;1718;123;461;296;930;419;1391
350250;201407;2807;10473;2717;10292;1118;4481;963;3618;2081;8099
350260;201407;1103;2958;909;2615;216;635;408;1202;624;1837
350270;201407;5456;16798;4791;15389;988;3478;2335;7410;3323;10888
350275;201407;2079;6953;1870;6634;553;2178;745;2488;1298;4666
350280;201407;23662;62108;15492;47249;4098;13299;3665;11310;7763;24609
350290;201407;1888;6528;1661;6004;511;1901;531;1973;1042;3874
350300;201407;536;1671;481;1564;147;494;196;652;343;1146
350310;201407;959;3236;879;3045;217;856;365;1196;582;2052
350315;201407;573;1826;476;1620;87;375;154;493;241;868
350320;201407;12071;39290;10694;36255;3363;12177;1880;6392;5243;18569
350330;201407;12066;35350;8537;26672;1932;6499;3450;9958;5382;16457
350335;201407;561;1658;519;1571;136;431;220;723;356;1154
350340;201407;1116;3531;874;3062;236;916;266;902;502;1818
350350;201407;771;2464;680;2309;177;695;248;836;425;1531
350360;201407;891;3193;782;2928;261;1026;279;1060;540;2086
350370;201407;731;2260;554;1851;127;473;107;301;234;774
350380;201407;3924;12816;3289;11784;1357;5266;843;2877;2200;8143
350390;201407;8866;28669;7883;26831;2270;8278;3646;12052;5916;20330
350395;201407;344;1067;248;868;72;272;59;198;131;470
350400;201407;8647;25417;7148;22683;2085;7235;2776;8449;4861;15684
350410;201407;8250;29858;7004;26928;2443;10132;1662;6192;4105;16324
350420;201407;947;3035;759;2668;370;1344;95;332;465;1676
350430;201407;871;2755;748;2540;207;822;381;1252;588;2074
350440;201407;1491;4808;1398;4623;451;1587;677;2160;1128;3747
350450;201407;8207;24988;6542;21654;2042;7329;1845;5841;3887;13170
350460;201407;1628;4817;1189;3868;351;1292;381;1112;732;2404
350470;201407;255;723;212;653;56;202;103;291;159;493
350480;201407;754;2345;505;1751;92;364;88;254;180;618
350490;201407;2119;6234;1810;5814;515;1893;840;2539;1355;4432
350500;201407;616;1831;535;1706;140;496;226;685;366;1181
350510;201407;1122;3600;931;3143;279;1060;325;997;604;2057
350520;201407;962;3608;833;3332;269;1175;230;873;499;2048
350530;201407;2648;8021;2184;6997;786;2719;622;1833;1408;4552
350535;201407;1510;4506;1448;4411;93;336;1216;3694;1309;4030
350540;201407;2112;6027;1778;5425;501;1633;708;2169;1209;3802
350550;201407;11176;33035;9007;29247;2471;9010;3575;10991;6046;20001
350560;201407;3630;12202;3284;11464;636;2376;1708;6029;2344;8405
350570;201407;22028;76253;20130;71814;6583;25079;7380;25396;13963;50475
350580;201407;2138;7044;1712;6018;569;2203;278;849;847;3052
350590;201407;4323;13959;3330;11805;1015;4023;1144;3661;2159;7684
350600;201407;41166;105477;28726;85317;5890;19305;14440;41361;20330;60666
350610;201407;9353;27689;7522;24524;2018;7338;3445;10856;5463;18194
350620;201407;503;1525;412;1381;108;407;174;550;282;957
350630;201407;1730;5397;1361;4637;413;1573;254;776;667;2349
350635;201407;5338;17314;4313;15293;1339;5008;1658;5902;2997;10910
350640;201407;694;2273;554;1884;155;561;158;501;313;1062
350650;201407;5622;17719;3460;12428;1160;4606;366;1309;1526;5915
350660;201407;3801;12044;3309;11173;839;3071;1720;5718;2559;8789
350670;201407;1907;5970;1782;5740;366;1282;1130;3526;1496;4808
350680;201407;1255;3932;1013;3424;297;1177;409;1314;706;2491
350690;201407;1108;3699;934;3328;293;1155;257;837;550;1992
350700;201407;2830;9758;2456;8903;937;3746;854;2756;1791;6502
350710;201407;2310;7353;2103;7018;346;1285;1397;4607;1743;5892
350715;201407;1128;3465;997;3214;290;1073;365;1086;655;2159
350720;201407;145;447;131;418;41;148;50;139;91;287
350730;201407;445;1703;420;1631;138;595;129;465;267;1060
350740;201407;2502;7613;2198;6954;575;1969;935;2944;1510;4913
350745;201407;395;1241;315;1057;66;263;143;429;209;692
350750;201407;10336;31833;7975;27063;2291;8547;2162;6865;4453;15412
350760;201407;12705;40698;11442;38368;3564;13283;5175;16548;8739;29831
350770;201407;939;2781;676;2257;159;604;263;857;422;1461
350775;201407;686;1976;604;1843;153;534;280;836;433;1370
350780;201407;2206;6746;1638;5530;512;1908;226;701;738;2609
350790;201407;2203;7230;1763;6279;564;2160;384;1226;948;3386
350800;201407;3194;10914;3043;10664;658;2583;1871;6413;2529;8996
350810;201407;2657;7799;2324;7210;834;2809;740;2298;1574;5107
350820;201407;585;1610;431;1284;99;352;175;459;274;811
350830;201407;925;2935;668;2306;132;506;152;441;284;947
350840;201407;2412;8662;2000;7623;654;2745;410;1351;1064;4096
350850;201407;6801;23287;5686;20626;2035;7847;1400;4867;3435;12714
350860;201407;3457;11193;3306;10955;497;1860;2462;8106;2959;9966
350870;201407;2555;8650;2259;8183;683;2661;1243;4552;1926;7213
350880;201407;1730;5892;1485;5342;490;1857;324;1176;814;3033
350890;201407;665;2003;521;1683;101;396;167;445;268;841
350900;201407;4683;15825;3883;13984;1078;4215;1092;3728;2170;7943
350910;201407;911;2814;851;2680;340;1112;311;964;651;2076
350920;201407;10256;30854;9401;29409;1825;6284;6024;18244;7849;24528
350925;201407;5444;17007;4830;15772;1422;5070;2105;6594;3527;11664
350930;201407;1606;4490;1344;4053;160;592;949;2746;1109;3338
350940;201407;2359;7912;2154;7570;473;1928;1290;4347;1763;6275
350945;201407;966;3233;855;2992;216;832;384;1288;600;2120
350950;201407;73840;238046;62750;215258;18224;68086;26089;87072;44313;155158
350960;201407;4740;16777;4211;15571;839;3578;2342;8330;3181;11908
350970;201407;4567;16526;4058;15258;1452;5892;1208;4349;2660;10241
350980;201407;709;2305;646;2197;315;1138;163;555;478;1693
350990;201407;1856;6501;1633;6072;574;2264;536;1954;1110;4218
350995;201407;846;3024;802;2939;223;929;409;1435;632;2364
351000;201407;3739;11389;3221;10384;524;1926;1834;5706;2358;7632
351010;201407;440;1330;319;1078;126;476;72;236;198;712
351015;201407;973;3260;842;3012;304;1206;295;1002;599;2208
351020;201407;8093;26339;7149;24861;1935;7244;3528;12370;5463;19614
351030;201407;1567;5725;1450;5457;423;1840;549;1932;972;3772
351040;201407;3875;12422;3576;11880;802;3106;2120;6644;2922;9750
351050;201407;10143;32504;8164;28602;2693;10271;2819;9794;5512;20065
351060;201407;36179;113352;30290;102225;9552;34301;11411;38214;20963;72515
351070;201407;1943;5539;1400;4568;505;1807;256;732;761;2539
351080;201407;2895;8810;2290;8046;678;2637;1069;3646;1747;6283
351090;201407;384;1347;309;1187;105;461;68;253;173;714
351100;201407;2133;6792;1801;6123;707;2496;556;1913;1263;4409
351110;201407;8118;21204;4611;15027;1308;4746;1240;3773;2548;8519
351120;201407;623;1904;532;1695;72;268;269;767;341;1035
351130;201407;915;2570;483;1660;95;390;119;373;214;763
351140;201407;2047;7115;1867;6721;707;2746;599;2105;1306;4851
351150;201407;2293;8016;1852;6800;552;2223;445;1504;997;3727
351160;201407;1583;5594;1429;5231;483;1963;499;1745;982;3708
351170;201407;1683;5591;1357;4820;359;1395;559;1844;918;3239
351190;201407;719;2348;586;1994;150;553;124;355;274;908
351200;201407;2407;7221;2027;6448;458;1695;849;2454;1307;4149
351210;201407;1134;3568;950;3196;288;1048;325;1028;613;2076
351220;201407;3628;12353;3212;11476;841;3233;1495;5298;2336;8531
351230;201407;1984;6654;1786;6259;539;2082;892;3049;1431;5131
351240;201407;1040;3354;755;2686;214;850;183;560;397;1410
351250;201407;907;2645;682;2192;136;484;327;1007;463;1491
351260;201407;1199;3574;1077;3318;274;927;449;1316;723;2243
351270;201407;407;1462;374;1395;120;510;128;428;248;938
351280;201407;5496;16679;4042;13341;1058;3753;1309;3934;2367;7687
351290;201407;1160;3436;918;2963;298;996;307;930;605;1926
351300;201407;10882;39723;9282;35978;2805;11744;3432;13227;6237;24971
351310;201407;3499;11038;2943;9996;723;2833;1408;4438;2131;7271
351320;201407;1033;3651;902;3340;308;1235;226;738;534;1973
351330;201407;300;869;259;796;114;353;64;198;178;551
351340;201407;6812;23861;6159;22512;1772;6828;2999;10986;4771;17814
351350;201407;8096;26728;7168;24739;2187;7928;2655;8834;4842;16762
351360;201407;4921;15158;4622;14630;1278;4401;2207;6802;3485;11203
351370;201407;2177;7035;1759;6142;550;2155;514;1646;1064;3801
351380;201407;38009;119547;35133;113769;9251;32642;16989;52873;26240;85515
351385;201407;255;809;248;798;85;275;105;336;190;611
351390;201407;1311;4409;1145;4060;417;1610;443;1476;860;3086
351400;201407;1249;4058;1177;3888;455;1596;365;1226;820;2822
351410;201407;3054;9326;2708;8709;615;2117;1450;4591;2065;6708
351420;201407;459;1368;334;1091;100;332;63;205;163;537
351430;201407;932;2975;855;2836;138;481;604;2017;742;2498
351440;201407;4833;14879;4125;13325;1542;5161;1084;3309;2626;8470
351450;201407;1849;5301;1633;5006;512;1606;812;2567;1324;4173
351460;201407;861;2724;732;2471;347;1251;219;704;566;1955
351470;201407;1126;3484;1005;3248;384;1348;316;997;700;2345
351480;201407;3026;9962;2757;9503;650;2624;1407;4732;2057;7356
351490;201407;2059;6992;1846;6525;377;1542;1005;3395;1382;4937
351492;201407;188;595;130;452;23;97;53;170;76;267
351495;201407;162;562;131;480;44;174;43;146;87;320
351500;201407;21467;69427;18939;64248;6006;22187;7671;25283;13677;47470
351510;201407;8043;26136;6870;23964;1752;6594;3460;11980;5212;18574
351512;201407;439;1310;374;1185;91;306;175;545;266;851
351515;201407;2164;7161;1689;6061;536;2079;471;1592;1007;3671
351518;201407;1736;5997;1294;5178;389;1744;300;1114;689;2858
351519;201407;866;2765;729;2449;214;831;282;860;496;1691
351520;201407;834;2337;412;1471;83;339;64;198;147;537
351530;201407;482;1537;399;1320;80;282;135;397;215;679
351535;201407;2676;6997;2164;6272;243;806;1526;4378;1769;5184
351540;201407;2217;7135;1979;6686;927;3323;419;1388;1346;4711
351550;201407;4302;12673;3084;10235;761;2899;1106;3531;1867;6430
351560;201407;443;1444;387;1315;137;511;75;245;212;756
351565;201407;246;831;228;785;75;295;93;289;168;584
351570;201407;13233;43063;11543;39627;3334;12085;5515;18779;8849;30864
351580;201407;416;1167;309;946;57;175;105;309;162;484
351590;201407;533;1474;410;1220;125;399;92;252;217;651
351600;201407;1953;5633;1748;5273;380;1319;880;2476;1260;3795
351610;201407;668;1869;544;1651;107;380;280;800;387;1180
351620;201407;17415;57200;13382;48386;3499;14023;3476;11187;6975;25210
351630;201407;16070;54351;14835;52236;3806;13988;8388;29795;12194;43783
351640;201407;8879;28662;7402;26052;1762;6782;3887;13452;5649;20234
351650;201407;415;1256;252;842;75;264;36;114;111;378
351660;201407;874;2763;679;2293;168;617;203;610;371;1227
351670;201407;4080;12790;3404;11351;663;2569;1753;5531;2416;8100
351680;201407;674;2085;425;1430;101;368;70;201;171;569
351685;201407;466;1426;379;1269;102;354;155;531;257;885
351690;201407;1384;4133;1079;3425;431;1369;307;935;738;2304
351700;201407;1545;4638;1384;4322;471;1523;501;1517;972;3040
351710;201407;816;2572;688;2283;182;639;219;668;401;1307
351720;201407;1762;5587;1306;4388;322;1184;444;1400;766;2584
351730;201407;1166;3454;981;3201;412;1478;319;974;731;2452
351740;201407;4815;13809;4020;12140;1111;3562;1325;3770;2436;7332
351750;201407;1548;5120;1340;4694;446;1745;382;1236;828;2981
351760;201407;3866;12512;3396;11453;937;3407;1444;4672;2381;8079
351770;201407;2377;7731;2075;7171;628;2287;1032;3528;1660;5815
351780;201407;1637;4695;1091;3495;305;1060;234;699;539;1759
351790;201407;1194;3567;1021;3316;382;1309;413;1311;795;2620
351800;201407;392;889;309;766;36;105;194;452;230;557
351810;201407;1223;3732;1149;3635;280;1030;734;2221;1014;3251
351820;201407;2016;6413;1657;5761;569;2100;208;691;777;2791
351830;201407;4461;14529;3785;12931;922;3448;1806;5947;2728;9395
351840;201407;9192;32017;8238;30001;2864;11048;2819;10134;5683;21182
351850;201407;1460;4798;1187;4204;349;1401;350;1086;699;2487
351860;201407;3728;12113;3383;11403;978;3630;1552;4987;2530;8617
351870;201407;36073;112252;32826;106450;7978;27564;18600;60275;26578;87839
351880;201407;103817;340620;91074;312666;29000;105486;27418;93287;56418;198773
351885;201407;670;2459;625;2355;182;751;285;1033;467;1784
351890;201407;845;2559;679;2206;207;731;176;540;383;1271
351900;201407;1450;4501;1256;4195;381;1346;488;1641;869;2987
351905;201407;452;1542;386;1422;95;420;200;674;295;1094
351907;201407;15856;50178;13778;46139;2980;11306;7281;23394;10261;34700
351910;201407;1215;3892;1123;3742;283;1080;433;1356;716;2436
351920;201407;1230;3539;1148;3408;268;892;679;1979;947;2871
351925;201407;1039;3054;956;2906;146;551;619;1750;765;2301
351930;201407;3227;11055;2997;10567;850;3476;1410;4538;2260;8014
351940;201407;1042;3225;973;3101;281;981;568;1737;849;2718
351950;201407;1446;4026;1055;3269;204;717;529;1563;733;2280
351960;201407;4312;13180;3331;11380;960;3416;1539;5296;2499;8712
351970;201407;7108;27033;6442;25567;2367;9831;2206;8804;4573;18635
351980;201407;967;2982;794;2649;175;667;322;961;497;1628
351990;201407;1652;4776;1326;4122;394;1396;356;959;750;2355
352000;201407;2538;8214;2312;7748;618;2223;1029;3289;1647;5512
352010;201407;2321;7959;2105;7411;750;2755;466;1639;1216;4394
352020;201407;1590;5128;1423;4794;449;1604;514;1709;963;3313
352030;201407;4767;14771;4253;14061;1028;3537;2397;8084;3425;11621
352040;201407;1990;6983;1704;6257;493;1949;424;1451;917;3400
352042;201407;2520;7116;1855;5719;441;1499;942;2837;1383;4336
352044;201407;1504;5077;1171;4197;275;1059;250;807;525;1866
352050;201407;6730;21986;4664;17242;1428;5852;920;2960;2348;8812
352060;201407;854;2552;746;2367;198;745;313;905;511;1650
352070;201407;760;2068;704;1981;276;815;257;766;533;1581
352080;201407;554;1707;468;1559;142;538;157;467;299;1005
352090;201407;1789;5828;1441;5073;378;1521;431;1346;809;2867
352100;201407;2496;7832;1845;6505;530;2105;653;2083;1183;4188
352110;201407;468;1759;419;1640;130;547;144;540;274;1087
352115;201407;415;1368;354;1232;97;379;159;519;256;898
352120;201407;926;2842;811;2668;160;588;451;1471;611;2059
352130;201407;1886;5459;1356;4437;386;1381;485;1444;871;2825
352140;201407;1613;5103;1188;4160;334;1257;504;1739;838;2996
352150;201407;684;2113;535;1802;159;529;228;760;387;1289
352160;201407;1270;3615;1165;3469;258;811;700;2110;958;2921
352170;201407;2597;8009;2348;7541;563;2010;1262;3839;1825;5849
352180;201407;3680;10641;3226;9798;881;2959;1419;4067;2300;7026
352190;201407;1157;3567;1059;3394;230;864;565;1700;795;2564
352200;201407;446;1558;374;1414;80;324;187;734;267;1058
352210;201407;15959;43296;12757;38541;2354;7473;7839;24216;10193;31689
352215;201407;594;1875;536;1795;81;315;311;1038;392;1353
352220;201407;15133;50773;14013;48444;4812;17658;5333;18382;10145;36040
352230;201407;13922;48036;12268;44853;3855;15269;4762;17184;8617;32453
352240;201407;9753;31262;8908;29739;2963;11092;3598;11351;6561;22443
352250;201407;23055;75074;20391;69611;5686;21134;8047;27100;13733;48234
352260;201407;5864;17983;4052;14123;1043;4037;1369;4396;2412;8433
352265;201407;955;3024;814;2793;126;510;489;1621;615;2131
352270;201407;2568;8815;2205;7973;867;3252;508;1767;1375;5019
352280;201407;2525;7882;2125;7190;599;2282;706;2276;1305;4558
352290;201407;1339;4357;1161;3960;307;1195;354;1079;661;2274
352300;201407;1028;3100;849;2775;248;883;373;1180;621;2063
352310;201407;34752;115219;31048;108759;7989;30296;18209;62972;26198;93268
352320;201407;5772;17983;5011;16516;1545;5568;1742;5203;3287;10771
352330;201407;2255;7380;1962;7006;690;2615;685;2487;1375;5102
352340;201407;6006;20638;4919;17998;1672;6630;980;3289;2652;9919
352350;201407;1832;6764;1665;6384;481;1991;598;2218;1079;4209
352360;201407;1230;4061;1098;3797;284;1184;625;2004;909;3188
352370;201407;929;3176;847;2994;210;842;390;1330;600;2172
352380;201407;1048;3343;924;3130;333;1251;287;941;620;2192
352390;201407;14176;41336;10291;33691;2190;8321;4990;15267;7180;23588
352400;201407;3513;10625;2396;8380;673;2580;882;2914;1555;5494
352410;201407;3841;11341;2964;9819;954;3407;948;3013;1902;6420
352420;201407;1310;3771;1222;3618;434;1421;502;1467;936;2888
352430;201407;6479;20535;5733;19303;2225;8101;2012;6650;4237;14751
352440;201407;16460;52154;13571;46356;3777;13975;5270;17531;9047;31506
352450;201407;683;2013;464;1585;125;481;108;326;233;807
352460;201407;2233;7482;1937;6922;679;2704;599;1952;1278;4656
352470;201407;4954;14135;3014;10007;627;2274;1188;3857;1815;6131
352480;201407;5572;15806;4543;13910;1140;4019;1952;5529;3092;9548
352490;201407;765;2753;651;2486;167;701;142;526;309;1227
352500;201407;9097;29460;8559;28548;4048;14583;2702;8280;6750;22863
352510;201407;3530;12236;2930;10935;1099;4406;743;2720;1842;7126
352520;201407;2471;8796;2211;8185;581;2330;1163;4223;1744;6553
352530;201407;6766;21951;5046;18141;1530;5958;824;2705;2354;8663
352540;201407;482;1619;378;1375;74;303;120;438;194;741
352550;201407;946;3156;679;2503;196;824;136;441;332;1265
352560;201407;657;1978;501;1623;101;379;206;603;307;982
352570;201407;1600;5208;1156;4148;273;1142;289;907;562;2049
352580;201407;959;2885;824;2651;283;1026;349;1040;632;2066
352585;201407;251;837;200;724;65;252;46;153;111;405
352590;201407;12920;42022;11503;39234;2620;9991;6467;21295;9087;31286
352600;201407;1992;6450;1842;6125;621;2182;714;2303;1335;4485
352610;201407;3705;11838;3277;11126;1237;4563;1085;3514;2322;8077
352620;201407;5621;18019;5327;17617;1156;4078;3455;11446;4611;15524
352630;201407;877;2916;829;2797;259;943;385;1275;644;2218
352640;201407;3192;10227;2631;8977;568;2141;1195;3965;1763;6106
352650;201407;868;2594;648;2133;147;535;222;685;369;1220
352660;201407;1105;3871;894;3356;276;1131;243;895;519;2026
352670;201407;10311;32540;6939;24822;2317;8698;1478;5198;3795;13896
352680;201407;3470;12186;2694;10255;652;2739;683;2320;1335;5059
352690;201407;27367;80751;20554;66868;5135;18349;8834;27751;13969;46100
352700;201407;798;2373;642;2133;193;736;292;918;485;1654
352710;201407;5489;16414;4059;13472;1077;3937;1528;4847;2605;8784
352720;201407;9145;30875;8520;29541;2821;10214;3448;11915;6269;22129
352725;201407;426;1270;285;949;58;235;85;254;143;489
352730;201407;2742;9552;2410;8640;676;2677;764;2467;1440;5144
352740;201407;2327;6972;1979;6358;520;1950;949;2808;1469;4758
352750;201407;424;1304;314;1053;102;378;72;206;174;584
352760;201407;1015;3564;932;3417;304;1202;462;1642;766;2844
352770;201407;956;2974;894;2860;281;959;327;1041;608;2000
352780;201407;638;2178;556;1987;148;598;175;561;323;1159
352790;201407;611;1778;435;1427;103;366;92;277;195;643
352800;201407;1199;4503;961;3817;315;1284;189;653;504;1937
352810;201407;1088;2906;769;2291;146;514;277;776;423;1290
352820;201407;622;1858;506;1669;211;729;107;360;318;1089
352830;201407;476;1368;344;1099;85;289;68;192;153;481
352840;201407;3788;13235;3329;12213;1038;4059;1076;3922;2114;7981
352850;201407;10241;33379;8966;31082;2735;9988;3401;11918;6136;21906
352860;201407;1070;3575;994;3405;406;1454;285;919;691;2373
352870;201407;1136;2881;879;2409;146;497;472;1185;618;1682
352880;201407;2449;7315;1892;6077;489;1691;505;1474;994;3165
352885;201407;317;1092;302;1059;95;361;128;424;223;785
352890;201407;833;2307;679;2003;160;524;279;747;439;1271
352900;201407;19275;58451;14630;48686;3768;13638;5922;18867;9690;32505
352910;201407;286;920;251;840;90;304;32;89;122;393
352920;201407;3423;10577;2917;9577;1017;3631;1043;3189;2060;6820
352930;201407;7060;22767;5789;19887;1771;6590;1101;3588;2872;10178
352940;201407;27269;92298;23476;83107;8606;31973;4451;15131;13057;47104
352950;201407;317;1001;228;806;62;264;66;198;128;462
352960;201407;616;1941;416;1464;83;324;75;244;158;568
352965;201407;377;1079;306;943;81;273;53;151;134;424
352970;201407;3421;9017;3030;8484;452;1335;2146;6090;2598;7425
352980;201407;1557;4670;1325;4303;403;1331;615;2100;1018;3431
352990;201407;3569;11900;3287;11403;1056;4069;1220;4036;2276;8105
353000;201407;554;1566;401;1243;96;324;101;279;197;603
353010;201407;2944;8378;2198;6850;595;2071;773;2215;1368;4286
353020;201407;4535;12627;3174;9667;554;1891;1316;3661;1870;5552
353030;201407;3985;11793;3291;10439;1028;3568;877;2592;1905;6160
353040;201407;731;2100;630;1941;206;687;246;736;452;1423
353050;201407;5695;19805;4864;18039;1759;7006;1541;5482;3300;12488
353060;201407;34785;112743;32493;109094;5446;21563;22322;72040;27768;93603
353070;201407;9077;31139;7217;26797;2473;9737;1934;7165;4407;16902
353080;201407;5270;17809;4135;15228;1344;5354;1171;4030;2515;9384
353090;201407;611;2061;543;1917;99;416;264;855;363;1271
353100;201407;286;862;224;716;103;338;52;163;155;501
353110;201407;8051;25329;7237;23829;1800;6288;3988;13276;5788;19564
353120;201407;482;1622;406;1455;139;561;99;307;238;868
353130;201407;3087;9675;2699;9003;1038;3786;988;3121;2026;6907
353140;201407;2712;7673;2182;6603;689;2289;722;1959;1411;4248
353150;201407;2018;6391;1670;5729;599;2160;451;1576;1050;3736
353160;201407;685;2027;539;1722;167;549;103;300;270;849
353170;201407;521;1845;468;1742;180;752;184;650;364;1402
353180;201407;5450;17139;4765;15840;679;2599;3066;9964;3745;12563
353190;201407;3708;11906;3221;10789;781;2915;1513;4699;2294;7614
353200;201407;838;2887;731;2640;220;897;289;986;509;1883
353205;201407;550;1779;457;1568;104;361;165;568;269;929
353210;201407;1129;2985;904;2578;116;395;596;1653;712;2048
353215;201407;585;1839;506;1665;116;431;170;538;286;969
353220;201407;944;2902;831;2658;232;779;265;834;497;1613
353230;201407;965;3101;887;2968;250;942;284;864;534;1806
353240;201407;2272;7590;2065;7157;642;2471;892;2892;1534;5363
353250;201407;1297;3683;1072;3279;302;988;409;1196;711;2184
353260;201407;1205;3510;1044;3254;333;1123;426;1254;759;2377
353270;201407;688;2083;594;1897;180;629;179;521;359;1150
353280;201407;607;2004;533;1871;185;711;152;502;337;1213
353282;201407;1786;5942;1727;5842;325;1228;1111;3652;1436;4880
353284;201407;337;916;244;737;65;197;74;221;139;418
353286;201407;152;462;103;344;32;108;12;42;44;150
353290;201407;475;1657;417;1550;175;698;155;546;330;1244
353300;201407;1848;5892;1588;5304;527;1924;549;1640;1076;3564
353310;201407;352;1116;332;1065;153;512;95;284;248;796
353320;201407;574;1632;493;1500;113;387;248;720;361;1107
353325;201407;576;1993;479;1773;131;534;77;261;208;795
353330;201407;597;1760;428;1382;98;366;195;572;293;938
353340;201407;3269;10564;2795;9624;966;3538;1040;3526;2006;7064
353350;201407;3618;11023;3164;10206;1120;3874;1365;4269;2485;8143
353360;201407;465;1627;412;1496;113;475;223;761;336;1236
353370;201407;724;2369;658;2202;162;564;338;1121;500;1685
353380;201407;420;1387;374;1301;105;415;163;542;268;957
353390;201407;5668;15269;3990;12204;900;3104;1482;4085;2382;7189
353400;201407;644;2008;537;1784;138;487;153;445;291;932
353410;201407;696;2147;590;1978;178;670;299;967;477;1637
353420;201407;705;2107;541;1704;178;591;173;506;351;1097
353430;201407;2544;8903;1837;6837;515;1995;160;522;675;2517
353440;201407;61986;204833;54834;187542;17217;61912;18260;60889;35477;122801
353450;201407;467;1439;414;1343;126;459;156;485;282;944
353460;201407;3654;10288;3084;9288;548;1802;1673;5036;2221;6838
353470;201407;11662;37059;9189;31852;3015;11301;2294;7690;5309;18991
353475;201407;1775;5159;1297;4085;320;1098;378;1075;698;2173
353480;201407;1583;4742;1411;4416;311;1089;788;2371;1099;3460
353490;201407;1674;4807;1396;4243;408;1383;411;1114;819;2497
353500;201407;1250;3626;1141;3444;494;1587;403;1144;897;2731
353510;201407;1408;4570;1173;3958;349;1307;347;1009;696;2316
353520;201407;1279;3825;1036;3385;355;1244;336;1106;691;2350
353530;201407;2835;8543;2548;8019;643;2232;1185;3600;1828;5832
353540;201407;2125;6522;1924;6164;629;2113;809;2605;1438;4718
353550;201407;6924;20007;6112;18684;1125;4046;3511;10077;4636;14123
353560;201407;2214;7383;1849;6707;475;1928;691;2444;1166;4372
353570;201407;541;1720;439;1506;102;388;233;731;335;1119
353580;201407;2534;8289;2373;8002;703;2651;1313;4273;2016;6924
353590;201407;846;2440;692;2158;259;869;173;556;432;1425
353600;201407;1965;5650;1777;5309;415;1363;916;2717;1331;4080
353610;201407;608;2159;536;2009;148;643;169;593;317;1236
353620;201407;2397;8308;2141;7802;705;2756;719;2501;1424;5257
353625;201407;385;1075;276;882;109;389;75;216;184;605
353630;201407;1725;5959;1339;4956;338;1361;246;805;584;2166
353640;201407;1669;4854;1464;4418;372;1163;654;1994;1026;3157
353650;201407;6914;21206;4992;16885;1135;4164;1823;5812;2958;9976
353657;201407;348;1124;311;1042;61;239;123;390;184;629
353660;201407;1436;3705;1045;3074;442;1418;191;419;633;1837
353670;201407;4971;16482;4361;15145;1468;5601;1430;4664;2898;10265
353680;201407;689;2450;655;2389;317;1199;203;740;520;1939
353690;201407;574;1542;377;1216;103;385;137;400;240;785
353700;201407;2443;7806;2133;7138;521;1929;762;2411;1283;4340
353710;201407;3497;9481;1847;6597;558;2193;550;1954;1108;4147
353715;201407;498;1491;415;1332;93;322;180;561;273;883
353720;201407;2168;6790;1865;6332;367;1336;1073;3676;1440;5012
353730;201407;4567;14336;3673;12258;970;3489;1032;3175;2002;6664
353740;201407;2322;7106;1875;6151;654;2217;530;1673;1184;3890
353750;201407;818;2872;651;2451;187;772;184;695;371;1467
353760;201407;7741;23502;6283;20928;1575;5638;3042;10116;4617;15754
353770;201407;815;2556;538;1860;130;499;61;148;191;647
353780;201407;6028;21520;5462;20343;2501;9540;1517;5884;4018;15424
353790;201407;3174;11366;2828;10619;1059;4270;596;2343;1655;6613
353800;201407;15002;48363;12005;42501;3368;13125;4781;16383;8149;29508
353810;201407;1196;3997;1055;3671;328;1212;392;1348;720;2560
353820;201407;1270;4502;1217;4404;384;1586;539;1803;923;3389
353830;201407;812;2216;640;1897;132;428;273;793;405;1221
353850;201407;1893;6245;1772;6033;449;1670;867;2817;1316;4487
353860;201407;2396;8139;1986;7154;595;2297;608;2115;1203;4412
353870;201407;24319;76273;18423;64000;4460;17405;6146;19347;10606;36752
353880;201407;2230;7352;2021;7018;369;1499;1243;4202;1612;5701
353890;201407;2672;6938;1939;5714;476;1556;927;2610;1403;4166
353900;201407;1159;3649;867;2980;229;886;208;623;437;1509
353910;201407;2184;7732;2079;7452;680;2622;935;3346;1615;5968
353920;201407;2514;7535;1891;6218;454;1572;350;1037;804;2609
353930;201407;4181;14762;3505;13245;1286;5162;830;3107;2116;8269
353940;201407;1544;4982;1332;4526;354;1374;538;1687;892;3061
353950;201407;3712;12092;3409;11541;573;2245;2184;7191;2757;9436
353960;201407;628;2025;504;1751;128;493;151;457;279;950
353970;201407;539;1595;469;1500;50;201;338;1048;388;1249
353980;201407;14812;44136;12409;40041;3029;10481;6459;20541;9488;31022
353990;201407;521;1640;478;1536;143;509;193;561;336;1070
354000;201407;1995;5930;1379;4697;357;1338;146;434;503;1772
354010;201407;397;1231;356;1163;141;470;133;442;274;912
354020;201407;4451;13551;3985;12566;1083;3722;1813;5346;2896;9068
354025;201407;1126;3205;889;2789;247;831;225;695;472;1526
354030;201407;664;1779;471;1489;135;474;174;506;309;980
354040;201407;804;2191;627;1857;97;341;355;970;452;1311
354050;201407;1024;3445;934;3243;344;1297;277;941;621;2238
354060;201407;4960;16018;3770;13336;1034;3957;1472;5010;2506;8967
354070;201407;3738;12564;3252;11435;1129;4224;840;2927;1969;7151
354075;201407;2281;8607;2179;8423;732;3082;968;3693;1700;6775
354080;201407;1992;6160;1539;5067;454;1551;447;1338;901;2889
354085;201407;315;858;280;788;32;120;202;519;234;639
354090;201407;1244;3764;1176;3655;151;521;884;2729;1035;3250
354100;201407;17138;59159;14736;54415;4024;15761;6746;24847;10770;40608
354105;201407;940;2971;804;2709;208;820;358;1086;566;1906
354110;201407;851;2454;695;2215;206;751;225;650;431;1401
354120;201407;2345;6630;1952;5916;530;1802;741;2083;1271;3885
354130;201407;5560;16861;4700;15162;1853;6355;1260;3805;3113;10160
354140;201407;22542;58615;14323;43064;2800;9466;5756;16044;8556;25510
354150;201407;4640;12980;3639;11159;1018;3428;1607;4729;2625;8157
354160;201407;4100;13594;3600;12503;1065;3989;1508;5084;2573;9073
354165;201407;421;1562;381;1461;146;602;100;392;246;994
354170;201407;1659;5386;1348;4622;304;1178;490;1488;794;2666
354180;201407;524;1585;502;1544;76;271;325;938;401;1209
354190;201407;1669;5638;1454;5142;509;1926;482;1643;991;3569
354200;201407;1192;3493;970;3066;205;748;399;1131;604;1879
354210;201407;870;3014;778;2816;187;799;324;1076;511;1875
354220;201407;3233;10151;2900;9496;945;3362;1226;3855;2171;7217
354230;201407;807;2687;763;2609;221;791;380;1296;601;2087
354240;201407;1400;4774;1138;4179;348;1387;289;1006;637;2393
354250;201407;559;1794;458;1624;210;821;129;423;339;1244
354260;201407;9203;28030;8291;26552;2637;9166;3460;10901;6097;20067
354270;201407;1188;4204;1091;3994;334;1361;436;1582;770;2943
354280;201407;851;2561;787;2448;156;563;471;1430;627;1993
354290;201407;1354;4810;1253;4588;390;1523;417;1515;807;3038
354300;201407;3320;11445;3204;11213;869;3246;1668;5764;2537;9010
354310;201407;802;2668;639;2271;184;720;196;698;380;1418
354320;201407;866;2620;740;2362;219;790;233;672;452;1462
354323;201407;382;1132;307;992;89;313;88;254;177;567
354325;201407;1318;4513;1171;4176;292;1181;487;1621;779;2802
354330;201407;8198;25743;7310;23993;1960;6906;3731;11847;5691;18753
354340;201407;31153;101788;26476;93143;9813;37025;9543;32798;19356;69823
354350;201407;1189;3580;1117;3447;291;978;623;1851;914;2829
354360;201407;457;1501;371;1333;115;444;40;124;155;568
354370;201407;1174;3977;1027;3670;148;653;688;2368;836;3021
354380;201407;1341;4079;1124;3691;429;1553;216;631;645;2184
354390;201407;11836;38460;8928;31900;2376;9260;2426;8234;4802;17494
354400;201407;2188;7857;1914;7188;545;2186;603;2171;1148;4357
354410;201407;6575;20114;5468;18286;1294;4653;2844;9487;4138;14140
354420;201407;1708;5106;1421;4474;440;1455;516;1574;956;3029
354425;201407;3542;10257;3098;9438;1073;3458;1047;3247;2120;6705
354430;201407;1362;4506;1254;4327;348;1349;615;2027;963;3376
354440;201407;579;1727;456;1473;92;325;199;625;291;950
354450;201407;521;1527;328;1096;48;208;87;240;135;448
354460;201407;851;2540;739;2330;262;868;343;1059;605;1927
354470;201407;527;1504;408;1264;71;284;187;506;258;790
354480;201407;799;2399;700;2235;161;592;359;1055;520;1647
354490;201407;787;2695;630;2304;161;636;207;676;368;1312
354500;201407;2581;8809;2362;8412;915;3628;614;2131;1529;5759
354510;201407;748;2450;675;2298;178;654;347;1160;525;1814
354515;201407;364;1281;298;1124;71;308;96;332;167;640
354520;201407;6529;22823;4809;18028;1494;6234;1773;6355;3267;12589
354530;201407;2925;10584;2738;10213;765;3109;1457;5360;2222;8469
354540;201407;1415;4396;1241;4083;414;1450;504;1693;918;3143
354550;201407;598;1927;533;1781;108;377;226;714;334;1091
354560;201407;1563;4724;1184;3874;326;1096;410;1293;736;2389
354570;201407;722;2230;573;1880;187;650;122;380;309;1030
354580;201407;9606;28307;7710;24684;1674;6050;3564;10779;5238;16829
354600;201407;1758;6056;1565;5667;475;2003;687;2307;1162;4310
354610;201407;509;1431;339;1064;73;236;90;248;163;484
354620;201407;428;1471;354;1330;112;491;124;431;236;922
354625;201407;285;957;239;860;66;260;67;234;133;494
354630;201407;1983;6930;1798;6489;770;2820;544;1879;1314;4699
354640;201407;4219;14222;3599;12828;1093;4410;823;2685;1916;7095
354650;201407;1031;3173;928;2953;187;684;532;1636;719;2320
354660;201407;2116;6372;1665;5555;409;1503;785;2595;1194;4098
354670;201407;1672;5481;1342;4627;401;1519;355;1062;756;2581
354680;201407;5438;18369;4990;17398;1445;5382;1992;6739;3437;12121
354690;201407;878;2971;627;2343;134;527;182;624;316;1151
354700;201407;1200;3408;819;2598;155;595;342;904;497;1499
354710;201407;634;1877;538;1677;139;491;204;586;343;1077
354720;201407;200;581;167;513;63;189;43;130;106;319
354730;201407;6162;21555;5429;20041;1509;6104;2463;8805;3972;14909
354740;201407;268;821;200;700;54;193;46;164;100;357
354750;201407;2387;7702;2033;7189;701;2694;801;2787;1502;5481
354760;201407;2251;7537;1898;6711;638;2415;421;1410;1059;3825
354765;201407;310;823;201;626;48;180;32;90;80;270
354770;201407;2852;8433;2295;7512;1065;3734;424;1321;1489;5055
354780;201407;38163;120413;34833;112811;8475;30405;17475;53836;25950;84241
354790;201407;870;2869;765;2684;219;848;332;1075;551;1923
354800;201407;1680;4979;1502;4744;303;1083;988;3104;1291;4187
354805;201407;952;2953;722;2426;127;477;142;430;269;907
354810;201407;706;2394;515;1900;169;681;96;320;265;1001
354820;201407;1115;3951;997;3708;294;1243;278;942;572;2185
354830;201407;451;1398;399;1300;137;492;151;454;288;946
354840;201407;826;2452;746;2311;230;753;319;982;549;1735
354850;201407;15278;49238;11598;41492;3100;12275;4249;14210;7349;26485
354860;201407;1308;4312;1190;4105;304;1236;563;1825;867;3061
354870;201407;44919;145112;41698;138218;12586;44379;19926;64766;32512;109145
354880;201407;4175;13136;3010;10476;873;3322;727;2234;1600;5556
354890;201407;15670;48529;13579;44347;3916;13848;4821;15199;8737;29047
354900;201407;626;1780;506;1600;176;588;195;613;371;1201
354910;201407;6622;20491;3906;14215;930;3749;448;1537;1378;5286
354920;201407;520;1555;402;1342;118;442;107;337;225;779
354925;201407;372;1076;224;769;47;186;36;101;83;287
354930;201407;293;866;248;779;84;282;84;264;168;546
354940;201407;2289;8185;1770;6722;671;2690;266;932;937;3622
354950;201407;1522;5125;1391;4925;255;1039;857;2999;1112;4038
354960;201407;789;2526;688;2360;201;765;271;899;472;1664
354970;201407;4100;13789;3656;12879;785;3218;1980;6640;2765;9858
354980;201407;33305;83656;19089;58918;4359;15159;6523;18577;10882;33736
354990;201407;41908;136485;36789;125725;8437;31876;19145;63605;27582;95481
354995;201407;2001;6359;1881;6184;478;1673;1006;3322;1484;4995
355000;201407;1715;5791;1507;5402;543;2110;369;1280;912;3390
355010;201407;3758;12074;3177;10752;892;3320;1311;4360;2203;7680
355020;201407;3387;12136;2885;11138;1409;5723;789;3079;2198;8802
355030;201407;956384;2796182;867329;2619261;225960;738334;392216;1156198;618176;1894532
355040;201407;3028;9990;2729;9439;840;3226;1375;4567;2215;7793
355050;201407;1296;4125;1063;3641;374;1353;254;872;628;2225
355060;201407;5122;17711;4125;15439;1124;4690;1018;3542;2142;8232
355070;201407;6545;20751;5866;19591;1357;5312;3191;10025;4548;15337
355080;201407;1397;4993;1080;4180;348;1477;160;530;508;2007
355090;201407;1138;4095;965;3682;233;972;399;1470;632;2442
355100;201407;29116;93836;25627;87803;8958;32316;9597;33364;18555;65680
355110;201407;1347;4718;1229;4457;426;1666;424;1501;850;3167
355120;201407;675;2185;584;2005;171;641;254;854;425;1495
355130;201407;596;1629;365;1118;96;336;131;339;227;675
355140;201407;1046;3823;998;3713;283;1154;480;1763;763;2917
355150;201407;3615;12175;3184;11345;1008;3771;1288;4468;2296;8239
355160;201407;1626;5572;1401;5181;589;2431;384;1279;973;3710
355170;201407;10167;29304;7290;24088;2491;8892;1963;6392;4454;15284
355180;201407;2968;9231;2537;8430;697;2672;998;3099;1695;5771
355190;201407;1329;4706;1216;4445;522;1948;362;1289;884;3237
355200;201407;945;3503;893;3392;428;1706;226;838;654;2544
355210;201407;2919;10116;2668;9575;776;3151;1164;3884;1940;7035
355220;201407;31604;107635;28780;101754;12082;44126;8452;30660;20534;74786
355230;201407;1291;3757;780;2581;146;549;188;534;334;1083
355240;201407;23085;71319;17647;59178;4201;15649;6912;21590;11113;37239
355250;201407;26017;87989;23361;82640;7094;26628;10127;35491;17221;62119
355255;201407;939;2640;674;2089;136;460;205;605;341;1065
355260;201407;1672;4898;1497;4585;421;1469;588;1641;1009;3110
355270;201407;1714;5315;1633;5187;247;955;1152;3507;1399;4462
355280;201407;24238;73852;20993;67461;5142;18646;9486;29038;14628;47684
355290;201407;892;2923;827;2801;199;728;385;1255;584;1983
355300;201407;942;3113;746;2676;189;721;221;756;410;1477
355310;201407;1112;3386;959;3116;238;796;459;1552;697;2348
355320;201407;747;2415;658;2201;195;736;232;674;427;1410
355330;201407;1903;6515;1474;5637;518;2213;450;1616;968;3829
355340;201407;3182;8696;2947;8292;709;2223;1703;4597;2412;6820
355350;201407;1439;5067;1272;4702;427;1697;390;1406;817;3103
355360;201407;1257;4395;1161;4197;248;991;782;2824;1030;3815
355365;201407;316;1007;268;909;81;311;70;227;151;538
355370;201407;7511;19631;5489;17138;1831;6241;2233;7021;4064;13262
355380;201407;3709;11395;2876;9421;838;3025;621;1742;1459;4767
355385;201407;1020;3326;961;3217;426;1544;269;830;695;2374
355390;201407;1461;4102;1259;3712;354;1141;479;1352;833;2493
355395;201407;1858;5737;1411;4696;269;1022;567;1713;836;2735
355400;201407;9466;32667;8529;30745;2994;11761;3227;11214;6221;22975
355410;201407;14281;51609;12833;48484;4904;19715;3704;14225;8608;33940
355420;201407;840;3072;791;2950;296;1167;273;1041;569;2208
355430;201407;3827;11311;3306;10396;771;2655;1669;5113;2440;7768
355440;201407;936;3133;765;2681;223;828;224;690;447;1518
355450;201407;2708;9104;2249;8059;688;2715;735;2500;1423;5215
355460;201407;596;1682;450;1415;115;447;158;419;273;866
355465;201407;455;1405;389;1276;122;425;101;330;223;755
355470;201407;981;3039;794;2708;267;1010;280;899;547;1909
355475;201407;137;528;121;479;39;156;40;169;79;325
355480;201407;3319;12223;3129;11800;980;3907;1404;5206;2384;9113
355490;201407;856;2542;673;2149;181;614;165;530;346;1144
355495;201407;754;2545;703;2448;199;773;287;974;486;1747
355500;201407;9020;26942;6051;20284;1466;5429;1339;4127;2805;9556
355510;201407;2239;6207;1475;4674;356;1292;436;1270;792;2562
355520;201407;449;1143;280;816;63;211;89;216;152;427
355530;201407;274;649;118;361;12;40;39;129;51;169
355535;201407;687;2147;558;1888;159;628;155;442;314;1070
355540;201407;10452;34066;9923;33186;2883;10347;5013;16387;7896;26734
355550;201407;766;2363;686;2230;190;674;337;1070;527;1744
355560;201407;1459;4402;1083;3598;293;1090;226;602;519;1692
355570;201407;220;717;172;605;38;136;36;108;74;244
355580;201407;1321;4009;1126;3623;394;1385;434;1362;828;2747
355590;201407;262;742;233;682;55;184;115;327;170;511
355600;201407;1102;3557;922;3143;372;1381;217;707;589;2088
355610;201407;1504;4427;1282;4068;353;1248;576;1756;929;3004
355620;201407;4139;13426;3361;11650;815;3232;1385;4369;2200;7601
355630;201407;3463;10114;2173;7340;488;1836;688;2130;1176;3966
355635;201407;1021;3396;884;3146;158;631;570;2014;728;2645
355640;201407;3869;13037;3260;11570;1163;4310;652;2264;1815;6574
355645;201407;3477;12519;3263;12131;649;2643;2008;7447;2657;10090
355650;201407;6890;21971;6033;20276;1209;4911;3556;11147;4765;16058
355660;201407;1392;4531;1163;4066;372;1471;463;1516;835;2987
355670;201407;2444;7882;1711;6147;462;1902;596;1885;1058;3787
355680;201407;1814;6231;1463;5368;551;2099;322;1127;873;3226
355690;201407;425;1364;325;1186;217;849;25;61;242;910
355695;201407;351;1078;244;806;35;117;19;46;54;163
355700;201407;6765;24057;6043;22306;1838;7372;2558;9101;4396;16473
355710;201407;13111;33717;8225;24770;2686;8578;2221;6413;4907;14991
355715;201407;262;811;175;623;42;164;38;121;80;285
355720;201407;1532;5054;1254;4438;402;1568;389;1234;791;2802
355730;201407;801;2832;721;2658;291;1113;180;666;471;1779
410010;201407;1655;5322;1501;4997;430;1547;477;1553;907;3100
410020;201407;1282;4362;1182;4155;368;1365;443;1535;811;2900
410030;201407;1094;3783;922;3355;291;1101;191;695;482;1796
410040;201407;13280;44775;12139;42417;4378;16249;3651;12708;8029;28957
410045;201407;1139;3253;831;2646;249;846;274;818;523;1664
410050;201407;2977;8578;1985;6618;635;2283;514;1634;1149;3917
410060;201407;2071;6664;1872;6271;553;2061;726;2375;1279;4436
410070;201407;2220;6358;1813;5535;708;2297;397;1104;1105;3401
410080;201407;1516;4581;1259;4093;313;1087;622;1948;935;3035
410090;201407;1154;3691;1048;3469;353;1291;378;1186;731;2477
410100;201407;2615;7881;1880;6181;556;2109;382;1117;938;3226
410105;201407;521;1659;389;1344;92;361;48;123;140;484
410110;201407;2796;8560;2395;7793;610;2231;869;2728;1479;4959
410115;201407;590;1689;504;1505;122;405;174;486;296;891
410120;201407;2950;10196;2793;9963;1042;3870;1223;4495;2265;8365
410130;201407;1427;4796;1295;4486;415;1421;569;1994;984;3415
410140;201407;16249;45147;11543;36439;3263;11409;4071;12749;7334;24158
410150;201407;18441;46630;8907;26987;1882;6334;1770;4753;3652;11087
410160;201407;3450;11052;3150;10553;1044;3818;1155;3918;2199;7736
410165;201407;693;2052;554;1744;128;427;260;782;388;1209
410170;201407;1895;5860;1603;5230;593;2101;493;1568;1086;3669
410180;201407;9152;29635;7980;27060;2001;7729;3597;11365;5598;19094
410185;201407;667;1841;595;1708;128;394;328;936;456;1330
410190;201407;2320;6965;1997;6221;659;2202;534;1567;1193;3769
410200;201407;3940;11306;2945;9249;852;2973;487;1385;1339;4358
410210;201407;2728;8423;2160;7165;550;2047;460;1316;1010;3363
410220;201407;669;1964;507;1619;119;416;169;499;288;915
410230;201407;1896;6196;1733;5909;672;2499;647;2152;1319;4651
410240;201407;5341;16778;4902;15838;1599;5539;1801;5739;3400;11278
410250;201407;2428;6899;1631;5181;499;1764;340;965;839;2729
410260;201407;1779;5551;1557;5143;489;1723;580;1874;1069;3597
410270;201407;569;1695;483;1518;129;452;203;623;332;1075
410275;201407;954;2874;668;2245;117;420;342;1149;459;1569
410280;201407;2957;8895;2132;7098;517;1965;415;1286;932;3251
410290;201407;3381;10503;2956;9689;770;2727;1323;4335;2093;7062
410300;201407;649;1873;576;1718;89;327;296;782;385;1109
410302;201407;603;1725;480;1515;60;207;285;905;345;1112
410304;201407;1497;4905;1372;4643;435;1509;565;1998;1000;3507
410305;201407;2239;6013;1927;5553;467;1411;1171;3449;1638;4860
410310;201407;2424;8088;2207;7655;659;2477;834;2915;1493;5392
410315;201407;657;2002;504;1702;121;424;167;522;288;946
410320;201407;1250;3701;799;2705;169;651;71;202;240;853
410322;201407;620;1849;447;1463;131;431;125;397;256;828
410330;201407;1547;4372;1310;3916;401;1288;441;1299;842;2587
410335;201407;1099;3235;925;2926;229;811;376;1133;605;1944
410337;201407;850;2280;703;2018;145;493;286;751;431;1244
410340;201407;603;1817;474;1483;98;347;145;387;243;734
410345;201407;1979;5991;1585;5136;538;1883;405;1217;943;3100
410347;201407;857;2427;619;1983;179;635;188;567;367;1202
410350;201407;880;2739;591;2123;166;697;112;351;278;1048
410360;201407;3661;11174;3233;10415;1018;3516;1141;3653;2159;7169
410370;201407;13442;39994;10183;32774;2770;10089;3000;8884;5770;18973
410380;201407;1454;4654;1320;4360;337;1203;602;1907;939;3110
410390;201407;2907;8569;2362;7566;906;3113;645;1901;1551;5014
410395;201407;924;3138;828;2929;216;881;394;1373;610;2254
410400;201407;5368;17513;4758;16297;1501;5755;1575;5207;3076;10962
410405;201407;1007;2958;807;2553;201;737;323;973;524;1710
410410;201407;1370;4669;1306;4565;508;1976;375;1228;883;3204
410420;201407;9725;32105;8570;29449;2983;11064;2233;7220;5216;18284
410425;201407;3275;10648;2394;8561;587;2311;350;1193;937;3504
410430;201407;16194;45094;12299;37782;3463;11638;3918;12015;7381;23653
410440;201407;3640;11599;3319;10995;858;3066;1596;5274;2454;8340
410442;201407;3045;10538;2752;9844;934;3540;875;3116;1809;6656
410445;201407;2426;8101;2087;7489;603;2349;793;2951;1396;5300
410450;201407;2657;7723;2153;6782;732;2450;445;1307;1177;3757
410460;201407;2438;7374;2040;6559;554;1915;772;2350;1326;4265
410465;201407;2093;7547;1804;6861;616;2480;642;2278;1258;4758
410470;201407;1729;5637;1471;5018;433;1620;442;1494;875;3114
410480;201407;31296;92425;24947;79630;8956;31032;6451;19867;15407;50899
410490;201407;11791;38522;9753;34004;3065;11676;3144;10702;6209;22378
410500;201407;1595;5074;1304;4434;495;1823;372;1263;867;3086
410510;201407;2517;6768;1838;5410;457;1452;756;2026;1213;3478
410520;201407;3289;11567;3118;11193;1186;4473;1150;4126;2336;8599
410530;201407;1720;4963;1445;4416;365;1279;616;1774;981;3053
410540;201407;3923;11501;2754;9143;746;2617;930;3047;1676;5664
410550;201407;6951;21491;5340;17805;1706;6254;923;2791;2629;9045
410560;201407;1325;4280;1043;3562;280;1058;267;740;547;1798
410570;201407;2998;9894;2737;9432;806;2838;1233;4576;2039;7414
410580;201407;26440;84194;23123;77184;7981;29046;7014;22185;14995;51231
410590;201407;1292;4086;806;2706;157;567;191;561;348;1128
410600;201407;2032;6066;1708;5417;462;1536;761;2418;1223;3954
410610;201407;842;2595;718;2364;177;638;313;996;490;1634
410620;201407;1786;6475;1576;5939;526;2071;356;1306;882;3377
410630;201407;2601;7842;2064;6655;600;2140;603;1805;1203;3945
410640;201407;5209;15314;4149;13287;1421;5147;985;2996;2406;8143
410645;201407;1309;4652;1249;4538;546;2127;398;1438;944;3565
410650;201407;2538;7827;2064;6832;740;2600;501;1577;1241;4177
410655;201407;944;2906;787;2589;225;805;250;812;475;1617
410657;201407;701;2108;549;1777;163;593;204;584;367;1177
410660;201407;3924;11505;3075;9625;1141;3756;701;2056;1842;5812
410670;201407;1002;2865;771;2413;218;742;209;610;427;1352
410680;201407;2509;8793;2108;7736;629;2315;730;2800;1359;5115
410685;201407;697;2097;631;1982;98;302;446;1417;544;1719
410690;201407;108344;316643;75290;246887;18926;68780;19064;56594;37990;125374
410700;201407;2418;7716;2258;7396;727;2593;938;2963;1665;5556
410710;201407;1126;3537;894;2990;285;1034;261;807;546;1841
410712;201407;820;2542;710;2325;303;1095;211;702;514;1797
410715;201407;1101;3475;937;3104;253;911;353;1128;606;2039
410720;201407;3268;9821;2448;8058;643;2366;757;2273;1400;4639
410725;201407;1107;3216;790;2573;178;616;186;522;364;1138
410730;201407;740;2259;674;2114;283;953;192;585;475;1538
410740;201407;893;2661;628;2110;120;481;307;1008;427;1489
410750;201407;1941;5820;1663;5238;523;1803;521;1540;1044;3343
410752;201407;266;789;214;681;53;201;91;261;144;462
410753;201407;479;1440;360;1178;73;286;143;439;216;725
410754;201407;995;3058;880;2868;92;335;611;2035;703;2370
410755;201407;804;2153;634;1874;103;359;374;1044;477;1403
410760;201407;2562;8385;2438;8136;903;3147;979;3212;1882;6359
410765;201407;16290;49237;12112;40591;3079;11517;2012;6412;5091;17929
410770;201407;948;2713;773;2368;253;847;232;673;485;1520
410773;201407;1276;3912;1137;3676;287;1069;581;1762;868;2831
410775;201407;1852;5471;1761;5324;483;1437;1037;3251;1520;4688
410780;201407;490;1419;372;1211;111;365;157;568;268;933
410785;201407;936;3047;754;2512;275;954;252;837;527;1791
410790;201407;618;1936;515;1694;143;525;112;309;255;834
410800;201407;2752;7388;2235;6522;803;2625;804;2149;1607;4774
410810;201407;312;970;254;839;36;137;114;371;150;508
410820;201407;1111;3374;912;2894;281;940;218;675;499;1615
410830;201407;32363;97267;26751;87092;8319;29616;9453;30406;17772;60022
410832;201407;1206;3655;1088;3441;252;928;542;1597;794;2525
410840;201407;6834;20754;4902;16515;1559;5776;877;2640;2436;8416
410845;201407;1583;4744;1347;4226;306;1058;641;1960;947;3018
410850;201407;2878;8554;2573;8089;596;2155;1403;4394;1999;6549
410855;201407;737;2094;613;1836;179;577;227;667;406;1244
410860;201407;3964;11471;3390;10417;787;2547;1661;5213;2448;7760
410865;201407;1719;5953;1557;5639;393;1513;824;3071;1217;4584
410870;201407;1383;4306;1299;4168;663;2270;380;1178;1043;3448
410880;201407;4571;13779;3700;12113;964;3613;923;2683;1887;6296
410890;201407;1096;3415;827;2899;260;975;83;246;343;1221
410895;201407;1064;3754;957;3511;359;1409;314;1102;673;2511
410900;201407;938;2663;707;2271;157;586;224;670;381;1256
410910;201407;364;1110;323;1037;65;222;175;550;240;772
410920;201407;879;2699;722;2414;212;783;239;748;451;1531
410930;201407;2122;6616;1842;6097;524;2052;726;2316;1250;4368
410940;201407;21617;73052;19236;68519;6167;23908;7741;27756;13908;51664
410950;201407;1910;6379;1740;6063;365;1333;1068;3778;1433;5111
410960;201407;7079;19951;4808;15668;1575;5587;1440;4618;3015;10205
410965;201407;1107;3494;983;3225;332;1135;387;1262;719;2397
410970;201407;5345;16243;4382;14276;1515;5506;987;3207;2502;8713
410975;201407;1518;4467;1259;4023;236;884;618;1966;854;2850
410980;201407;5548;16010;3476;11676;815;3022;735;2356;1550;5378
410990;201407;1115;3400;805;2719;269;1009;197;572;466;1581
411000;201407;444;1375;305;1042;70;279;44;119;114;398
411005;201407;522;1557;360;1138;105;331;62;171;167;502
411007;201407;2069;6724;1865;6269;549;1963;788;2674;1337;4637
411010;201407;4069;14125;3763;13418;1404;5512;963;3191;2367;8703
411020;201407;2569;8236;2322;7801;793;2957;817;2753;1610;5710
411030;201407;884;2404;736;2124;239;752;221;600;460;1352
411040;201407;492;1528;353;1185;109;395;90;286;199;681
411050;201407;2168;7765;1922;7204;663;2699;335;1160;998;3859
411060;201407;2130;6809;1856;6206;584;2100;327;1002;911;3102
411065;201407;403;1242;328;1090;72;249;119;373;191;622
411070;201407;4988;15926;3677;12967;1118;4353;555;1772;1673;6125
411080;201407;2073;6466;1873;6032;545;1953;605;1859;1150;3812
411090;201407;661;1681;514;1470;112;386;140;366;252;752
411095;201407;1655;4819;1292;4102;310;1114;355;1056;665;2170
411100;201407;1521;4430;1139;3680;275;993;252;755;527;1748
411110;201407;956;2908;718;2362;222;774;131;379;353;1153
411120;201407;1819;5731;1569;5188;498;1776;501;1618;999;3394
411125;201407;4794;15793;4654;15510;1568;5518;2153;7069;3721;12587
411130;201407;801;2434;658;2132;191;629;222;751;413;1380
411140;201407;2032;7341;1743;6620;651;2570;465;1851;1116;4421
411150;201407;6082;17286;4953;15020;1497;4907;1331;3721;2828;8628
411155;201407;1262;3702;1082;3348;354;1209;424;1230;778;2439
411160;201407;319;975;286;909;113;363;97;307;210;670
411170;201407;851;2884;744;2628;230;854;236;835;466;1689
411180;201407;6401;19693;5613;18198;1722;6109;1839;5928;3561;12037
411190;201407;1880;5570;1610;5071;483;1693;506;1514;989;3207
411200;201407;4495;13753;3738;12477;1183;4363;1483;4791;2666;9154
411210;201407;2595;7643;2102;6701;843;2870;392;1220;1235;4090
411220;201407;1218;3549;995;3129;251;923;428;1212;679;2135
411230;201407;1296;3721;834;2734;267;966;197;586;464;1552
411240;201407;1456;3643;861;2671;262;865;235;665;497;1530
411250;201407;2569;7639;2147;6807;614;2092;686;2142;1300;4234
411260;201407;299;843;212;697;59;226;88;271;147;497
411270;201407;2108;6753;1931;6404;589;2178;861;2782;1450;4960
411275;201407;1580;4789;1360;4272;413;1348;388;1172;801;2520
411280;201407;1766;5524;1419;4768;450;1679;234;699;684;2378
411290;201407;1042;2925;877;2595;251;765;312;962;563;1727
411295;201407;1111;3306;1026;3151;252;831;427;1298;679;2129
411300;201407;1092;2852;792;2253;82;271;378;1006;460;1277
411310;201407;881;2525;673;2161;126;465;285;897;411;1362
411320;201407;5657;17232;4464;14858;1305;4590;1159;3708;2464;8298
411325;201407;1579;5076;1418;4771;244;911;890;2990;1134;3901
411330;201407;3681;12040;3286;11292;1273;4757;998;3353;2271;8110
411340;201407;1009;2964;666;2155;154;551;261;837;415;1388
411342;201407;903;2607;740;2250;215;728;212;570;427;1298
411345;201407;1081;3476;999;3314;302;1085;487;1613;789;2698
411350;201407;2941;9026;2082;7212;654;2485;274;851;928;3336
411360;201407;592;1460;349;1011;49;188;161;391;210;579
411370;201407;45785;134189;35217;113769;7824;29611;12707;37695;20531;67306
411373;201407;1491;4720;1252;4240;355;1358;354;1152;709;2510
411375;201407;1155;3276;914;2789;245;798;323;922;568;1720
411380;201407;1301;3522;817;2499;158;517;243;722;401;1239
411390;201407;1878;5798;1665;5447;435;1560;815;2577;1250;4137
411400;201407;1816;5504;1423;4580;329;1213;434;1278;763;2491
411410;201407;2632;8200;2182;7125;702;2591;570;1604;1272;4195
411420;201407;4633;13632;3546;11168;966;3384;729;1974;1695;5358
411430;201407;2973;9662;2553;8883;784;2956;1106;3766;1890;6722
411435;201407;590;1894;502;1675;134;493;192;610;326;1103
411440;201407;2613;8545;2369;8061;879;3136;738;2618;1617;5754
411450;201407;2161;6650;1977;6333;447;1491;1183;3820;1630;5311
411460;201407;4802;15031;3440;11695;1265;4553;708;2304;1973;6857
411470;201407;940;2883;666;2202;166;600;131;368;297;968
411480;201407;5041;15491;3972;13360;1615;5875;865;2798;2480;8673
411490;201407;1708;5399;1539;5092;597;2229;421;1261;1018;3490
411500;201407;1745;4934;1236;3958;356;1250;313;981;669;2231
411510;201407;2502;7389;1997;6376;663;2335;474;1354;1137;3689
411520;201407;29744;85261;19947;64466;6403;22713;4358;13361;10761;36074
411530;201407;940;2737;640;2167;243;914;108;307;351;1221
411535;201407;465;1401;227;810;39;165;24;62;63;227
411540;201407;3160;8642;2507;7445;457;1406;1369;4134;1826;5540
411545;201407;1052;3690;971;3533;199;769;629;2326;828;3095
411550;201407;758;2139;615;1897;257;865;143;420;400;1285
411560;201407;2694;8231;2164;6946;634;2215;494;1443;1128;3658
411570;201407;6291;17576;4727;14891;1418;4937;1176;3831;2594;8768
411573;201407;1013;3075;956;2976;199;664;555;1753;754;2417
411575;201407;1513;4916;1311;4461;339;1233;509;1714;848;2947
411580;201407;3781;11300;2781;9218;730;2799;459;1232;1189;4031
411585;201407;507;1753;388;1418;112;437;74;249;186;686
411590;201407;598;1793;534;1665;144;500;186;561;330;1061
411600;201407;369;1137;306;1010;88;344;80;269;168;613
411605;201407;2370;6674;1752;5476;464;1582;692;2098;1156;3680
411610;201407;2389;6893;2158;6540;475;1552;1404;4210;1879;5762
411620;201407;2874;9429;2707;9139;851;3081;1213;4183;2064;7264
411630;201407;713;1898;425;1431;126;498;91;269;217;767
411640;201407;607;1906;504;1686;154;554;190;600;344;1154
411650;201407;189;634;166;588;44;178;58;191;102;369
411660;201407;869;2498;716;2204;191;622;306;947;497;1569
411670;201407;1718;5046;1523;4661;490;1664;559;1613;1049;3277
411680;201407;1757;5398;1533;5015;376;1196;911;3134;1287;4330
411690;201407;3734;11354;3143;10237;1039;3549;900;3003;1939;6552
411695;201407;852;2761;710;2466;157;582;327;1152;484;1734
411700;201407;1883;5536;1424;4670;360;1312;397;1206;757;2518
411705;201407;2323;7934;2029;7361;469;1724;1160;4333;1629;6057
411710;201407;2209;6789;1789;5866;534;1876;464;1394;998;3270
411720;201407;711;2161;552;1770;116;411;144;428;260;839
411721;201407;735;2231;616;1985;198;702;146;422;344;1124
411722;201407;722;2203;565;1852;140;532;164;473;304;1005
411725;201407;1383;4489;922;3327;234;915;204;742;438;1657
411727;201407;2312;6702;1877;5771;464;1544;817;2372;1281;3916
411729;201407;535;1472;399;1241;111;389;128;344;239;733
411730;201407;5787;17132;4949;15540;1974;6465;1572;4988;3546;11453
411740;201407;579;1699;445;1416;107;378;173;519;280;897
411745;201407;911;2876;762;2523;207;715;204;648;411;1363
411750;201407;4763;14901;3641;12113;1094;4021;712;2190;1806;6211
411760;201407;8993;26949;8047;25317;2969;9945;2587;8297;5556;18242
411770;201407;3971;13969;3493;12812;1386;5336;822;3041;2208;8377
411780;201407;3104;10148;2980;10003;405;1238;2225;7940;2630;9178
411790;201407;2637;7656;1938;6251;576;2156;633;1945;1209;4101
411800;201407;1406;4143;880;2913;164;615;166;442;330;1057
411810;201407;1601;4997;1402;4558;402;1494;440;1257;842;2751
411820;201407;16865;53443;14161;48352;5072;17733;4479;16055;9551;33788
411830;201407;423;1151;340;1025;108;315;122;392;230;707
411840;201407;9218;27802;7365;24141;2214;7912;2045;6457;4259;14369
411845;201407;569;1808;424;1458;107;398;98;322;205;720
411850;201407;5984;18418;5006;16384;1345;4728;1476;4766;2821;9494
411860;201407;913;2927;764;2604;217;790;222;714;439;1504
411870;201407;1070;3773;833;3117;152;597;225;820;377;1417
411880;201407;2515;7292;2135;6622;585;2031;843;2565;1428;4596
411885;201407;1487;4158;1205;3684;374;1279;419;1179;793;2458
411890;201407;1372;4243;985;3326;285;1033;195;587;480;1620
411900;201407;965;3125;715;2489;217;770;126;431;343;1201
411910;201407;1235;4272;1067;3879;342;1372;341;1166;683;2538
411915;201407;12442;35527;8230;26681;1961;7029;2039;6047;4000;13076
411920;201407;1072;3778;951;3462;277;1120;221;753;498;1873
411925;201407;663;1894;481;1557;136;467;151;475;287;942
411930;201407;6331;21041;5599;19534;1878;7004;1952;6819;3830;13823
411940;201407;3663;12414;3279;11575;1113;4136;911;3139;2024;7275
411950;201407;10367;33757;8916;30871;2563;9708;4109;13973;6672;23681
411960;201407;4879;14926;4508;14208;1136;4013;2232;6877;3368;10890
411965;201407;587;1772;452;1548;103;396;164;575;267;971
411970;201407;766;2212;608;1950;206;729;171;515;377;1244
411980;201407;2129;5957;1515;4945;284;985;674;2180;958;3165
411990;201407;30409;104626;26525;96169;9520;36823;7641;27906;17161;64729
411995;201407;3143;9984;2838;9353;1169;4144;765;2486;1934;6630
412000;201407;2158;5934;1726;5181;381;1321;780;2114;1161;3435
412010;201407;748;2523;632;2249;173;641;163;552;336;1193
412015;201407;670;2072;541;1788;108;391;278;912;386;1303
412020;201407;442;1309;333;1088;124;439;129;393;253;832
412030;201407;636;2023;425;1495;94;394;121;383;215;777
412033;201407;775;2389;570;1908;149;541;122;369;271;910
412035;201407;1023;2925;785;2484;201;694;320;960;521;1654
412040;201407;766;2538;698;2360;253;880;231;772;484;1652
412050;201407;1636;4955;1263;4128;330;1206;273;848;603;2054
412060;201407;6878;24318;6290;22998;1965;7644;2512;9179;4477;16823
412065;201407;1005;3102;835;2739;257;950;246;754;503;1704
412070;201407;1224;3431;1022;3024;223;711;395;1148;618;1859
412080;201407;1674;5239;1082;3853;251;994;114;333;365;1327
412085;201407;362;1046;174;589;46;179;44;133;90;312
412090;201407;4929;16207;4714;15806;1041;3712;2969;10074;4010;13786
412100;201407;2236;7115;1969;6633;662;2330;694;2316;1356;4646
412110;201407;1143;3313;794;2562;248;859;232;723;480;1582
412120;201407;2079;7169;1887;6708;518;2055;870;2947;1388;5002
412125;201407;974;3043;869;2863;252;880;356;1195;608;2075
412130;201407;682;2021;506;1666;116;429;130;406;246;835
412135;201407;562;1623;415;1320;104;369;161;466;265;835
412140;201407;1869;5790;1580;5186;464;1629;458;1504;922;3133
412150;201407;2978;8853;2589;8064;411;1440;1531;4654;1942;6094
412160;201407;1129;3610;831;2863;221;863;318;1075;539;1938
412170;201407;4576;15258;3893;13876;1351;5170;1421;4988;2772;10158
412175;201407;1477;5167;1324;4822;383;1509;547;2007;930;3516
412180;201407;1792;5741;1408;5036;511;2005;414;1417;925;3422
412190;201407;3165;9476;2547;8416;877;3089;688;2318;1565;5407
412200;201407;2345;7814;1680;6003;405;1597;536;1890;941;3487
412210;201407;779;2212;463;1526;112;418;79;238;191;656
412215;201407;3416;11030;3102;10450;513;1769;2029;7036;2542;8805
412217;201407;1229;3622;1146;3476;221;772;735;2110;956;2882
412220;201407;5870;19574;5625;19085;1805;6386;2952;10069;4757;16455
412230;201407;3057;10455;2682;9662;795;3190;873;3008;1668;6198
412240;201407;9543;25111;5522;17519;1286;4569;942;2699;2228;7268
412250;201407;2214;6802;1966;6271;696;2399;546;1615;1242;4014
412260;201407;1351;4045;920;3099;201;783;299;894;500;1677
412265;201407;1230;3914;1127;3714;288;1096;547;1764;835;2860
412270;201407;817;2699;636;2251;152;599;129;430;281;1029
412280;201407;703;2172;539;1838;261;961;111;344;372;1305
412290;201407;1277;3613;1051;3160;233;787;401;1139;634;1926
412300;201407;1836;5557;1534;4957;486;1755;409;1246;895;3001
412310;201407;1232;3507;1094;3319;204;532;735;2473;939;3005
412320;201407;723;1992;529;1654;136;476;184;563;320;1039
412330;201407;2029;5599;1578;4813;366;1201;750;2278;1116;3479
412340;201407;787;2494;540;1846;103;373;108;345;211;718
412350;201407;2620;8374;2157;7340;719;2603;432;1367;1151;3970
412360;201407;351;1118;277;923;54;204;89;250;143;454
412370;201407;1146;3621;906;3143;323;1189;268;913;591;2102
412380;201407;2071;6335;1783;5683;542;1816;529;1653;1071;3469
412382;201407;730;2106;534;1687;132;450;156;451;288;901
412385;201407;2546;8086;2332;7599;741;2553;827;2681;1568;5234
412390;201407;2469;7426;2258;7062;774;2591;889;2787;1663;5378
412395;201407;980;2750;789;2448;123;396;490;1534;613;1930
412400;201407;1194;3721;1061;3468;339;1142;418;1430;757;2572
412402;201407;2133;6612;1775;5829;576;2067;507;1493;1083;3560
412405;201407;4215;12367;2777;9240;781;2913;362;1126;1143;4039
412410;201407;6413;20920;5795;19658;2482;9196;1300;4323;3782;13519
412420;201407;544;1624;435;1397;143;505;134;354;277;859
412430;201407;487;1450;401;1273;110;384;169;489;279;873
412440;201407;4086;12321;3525;11339;735;2584;1438;4822;2173;7406
412450;201407;297;966;242;820;45;167;37;87;82;254
412460;201407;1014;2907;728;2364;189;721;174;525;363;1246
412470;201407;1881;6458;1669;5924;558;2080;595;2153;1153;4233
412480;201407;1309;3907;932;3060;225;800;155;417;380;1217
412490;201407;1303;3867;1144;3492;322;1037;339;1011;661;2048
412500;201407;2079;6230;1778;5627;511;1840;481;1333;992;3173
412510;201407;2790;9492;2462;8627;757;2861;934;3244;1691;6105
412520;201407;1877;5311;1420;4518;437;1489;480;1486;917;2975
412530;201407;801;2410;676;2127;210;677;199;617;409;1294
412535;201407;487;1501;326;1065;84;303;94;265;178;568
412540;201407;1153;3379;871;2771;156;573;336;1056;492;1629
412545;201407;947;2726;782;2371;149;522;307;829;456;1351
412550;201407;25685;78300;17844;60628;5017;18478;3756;11973;8773;30451
412555;201407;344;1061;239;798;59;215;42;114;101;329
412560;201407;4744;15530;3833;13640;1127;4521;925;2970;2052;7491
412570;201407;4434;13571;3363;11073;953;3465;743;2337;1696;5802
412575;201407;872;2714;701;2306;174;649;225;686;399;1335
412580;201407;1492;4149;1088;3424;276;913;343;1027;619;1940
412590;201407;511;1560;405;1357;139;500;119;414;258;914
412600;201407;1538;4890;1325;4456;422;1577;430;1352;852;2929
412610;201407;820;2656;657;2262;235;921;176;521;411;1442
412620;201407;1302;4321;1098;3879;376;1439;253;862;629;2301
412625;201407;14136;40592;11831;36207;4384;14325;2817;8524;7201;22849
412627;201407;1040;3242;731;2555;261;979;83;278;344;1257
412630;201407;3575;11510;3128;10516;867;3115;1040;3373;1907;6488
412635;201407;553;1693;397;1335;104;364;59;182;163;546
412640;201407;857;2607;589;1970;143;510;98;293;241;803
412650;201407;2341;6756;1938;5992;532;1843;687;1923;1219;3766
412660;201407;3111;9480;2581;8360;688;2480;640;1936;1328;4416
412665;201407;739;1995;460;1486;153;542;136;411;289;953
412667;201407;1509;4534;1208;3928;332;1230;340;1033;672;2263
412670;201407;689;2171;483;1668;110;429;79;206;189;635
412680;201407;1577;5158;1285;4465;362;1353;347;1081;709;2434
412690;201407;734;2364;600;2062;228;839;117;394;345;1233
412700;201407;1889;6199;1650;5802;622;2418;607;2090;1229;4508
412710;201407;8895;28146;7505;25249;2218;8171;2021;6503;4239;14674
412720;201407;1704;5446;1202;4123;305;1124;151;420;456;1544
412730;201407;2883;8782;2007;6864;654;2400;279;843;933;3243
412740;201407;2196;7244;1932;6632;807;2908;327;1147;1134;4055
412750;201407;3484;11506;3177;10981;588;2351;2105;7078;2693;9429
412760;201407;2385;7993;2276;7801;695;2658;1011;3327;1706;5985
412770;201407;12614;37034;8229;27299;1959;7256;1843;5593;3802;12849
412780;201407;1521;5025;1346;4614;419;1539;443;1447;862;2986
412785;201407;2575;7592;1895;6138;495;1766;874;2742;1369;4508
412788;201407;1403;4632;1293;4422;353;1386;481;1485;834;2871
412790;201407;1232;3840;1013;3368;262;940;311;959;573;1899
412795;201407;1050;3129;910;2872;298;997;316;966;614;1963
412796;201407;2679;8574;2469;8134;696;2555;1028;3204;1724;5759
412800;201407;3652;10954;2917;9456;836;2970;909;2792;1745;5762
412810;201407;10775;30572;6591;21198;1727;6049;1545;4518;3272;10567
412820;201407;6675;20440;5016;17126;1488;5580;1123;3874;2611;9454
412830;201407;408;1321;348;1194;100;401;94;268;194;669
412840;201407;2208;6375;1822;5595;515;1715;487;1462;1002;3177
412850;201407;2681;8140;2287;7537;423;1647;1174;3694;1597;5341
412853;201407;1667;4879;1475;4529;200;810;874;2467;1074;3277
412855;201407;1686;4926;1365;4261;439;1551;373;1026;812;2577
412860;201407;1329;4041;1128;3654;313;1142;473;1462;786;2604
412862;201407;882;2393;664;1963;178;579;250;690;428;1269
412863;201407;1241;4235;1194;4152;190;711;822;2834;1012;3545
412865;201407;678;2153;500;1709;111;409;193;672;304;1081
412870;201407;1044;3037;879;2765;303;1012;301;953;604;1965
412880;201407;1595;4425;1360;4045;417;1347;355;1024;772;2371
420005;201407;524;1589;351;1187;78;289;138;438;216;727
420010;201407;3348;10392;2837;9554;445;1623;1977;6738;2422;8361
420020;201407;795;2635;470;1750;88;380;62;189;150;569
420030;201407;563;1616;319;1130;95;380;59;202;154;582
420040;201407;1005;3136;677;2470;219;878;148;476;367;1354
420050;201407;838;2658;676;2276;195;691;282;914;477;1605
420055;201407;319;1030;223;798;60;229;47;154;107;383
420060;201407;384;1369;294;1125;90;382;41;140;131;522
420070;201407;2084;6599;1736;5754;370;1340;712;2467;1082;3807
420075;201407;209;612;116;394;30;120;36;106;66;226
420080;201407;626;2083;529;1872;194;751;128;440;322;1191
420090;201407;693;2472;540;2109;159;643;102;392;261;1035
420100;201407;1511;4910;1394;4746;363;1259;837;2906;1200;4165
420110;201407;462;1592;421;1500;124;452;198;718;322;1170
420120;201407;340;1206;285;1084;106;447;64;227;170;674
420125;201407;377;1554;355;1504;154;696;107;421;261;1117
420127;201407;611;1907;279;1052;98;391;41;151;139;542
420130;201407;2642;9123;2321;8449;710;2829;848;2864;1558;5693
420140;201407;5307;15669;3698;12547;1042;3984;743;2342;1785;6326
420150;201407;808;2434;555;1844;164;593;170;514;334;1107
420160;201407;317;946;202;687;44;174;47;144;91;318
420165;201407;231;747;155;547;37;151;36;122;73;273
420170;201407;245;814;174;666;70;309;21;57;91;366
420180;201407;479;1528;297;1082;84;321;70;242;154;563
420190;201407;602;1915;370;1370;125;506;62;211;187;717
420195;201407;1446;4201;1160;3800;280;989;585;1973;865;2962
420200;201407;2993;9862;1959;7444;661;2765;355;1223;1016;3988
420205;201407;1106;3713;992;3504;290;1083;448;1590;738;2673
420207;201407;1451;4344;1035;3448;327;1240;309;929;636;2169
420208;201407;519;1551;351;1220;130;496;103;338;233;834
420209;201407;373;1199;231;839;48;181;65;230;113;411
420210;201407;1844;6034;1277;4896;391;1727;189;653;580;2380
420213;201407;923;3409;874;3291;182;710;577;2191;759;2901
420215;201407;526;1734;388;1366;118;442;77;248;195;690
420220;201407;432;1690;404;1625;173;741;105;382;278;1123
420230;201407;4683;14568;3641;12624;923;3596;1813;6144;2736;9740
420240;201407;14140;41538;8997;31671;2100;8817;3568;11402;5668;20219
420243;201407;594;1852;482;1609;117;447;169;546;286;993
420245;201407;1233;3893;865;3120;245;1005;199;638;444;1643
420250;201407;843;2720;787;2629;272;991;344;1160;616;2151
420253;201407;667;1797;551;1632;131;385;269;884;400;1269
420257;201407;443;1376;335;1163;92;331;157;539;249;870
420260;201407;1416;4683;1236;4357;349;1343;570;2014;919;3357
420270;201407;599;1945;257;958;51;191;35;114;86;305
420280;201407;2473;6918;1587;5304;414;1641;568;1679;982;3320
420285;201407;167;498;62;235;10;44;2;9;12;53
420287;201407;662;2048;575;1883;159;544;217;712;376;1256
420290;201407;6735;20256;4415;14860;1035;3823;1549;4909;2584;8732
420300;201407;5927;18542;3915;14171;1001;4135;822;2954;1823;7089
420310;201407;890;2721;852;2658;184;610;540;1650;724;2260
420315;201407;981;3238;783;2818;225;906;312;1105;537;2011
420320;201407;5010;15810;4188;14328;1205;4585;1776;5938;2981;10523
420325;201407;464;1498;448;1463;146;518;160;504;306;1022
420330;201407;1323;4660;1046;3885;368;1468;237;772;605;2240
420340;201407;1525;4783;1183;3957;298;1087;328;1039;626;2126
420350;201407;1655;5402;1430;4924;414;1525;629;2183;1043;3708
420360;201407;3859;12435;2890;10185;1078;4162;531;1701;1609;5863
420370;201407;2101;5944;1763;5414;214;673;1400;4290;1614;4963
420380;201407;5617;18955;4708;16791;1528;5836;1341;4802;2869;10638
420390;201407;2150;6489;1328;4722;396;1509;342;1163;738;2672
420395;201407;2097;6591;1589;5432;396;1507;338;1039;734;2546
420400;201407;1534;4618;1146;3858;351;1371;338;1042;689;2413
420410;201407;844;2385;602;1976;153;572;311;1000;464;1572
420415;201407;526;1695;417;1418;128;466;145;481;273;947
420417;201407;815;2666;692;2364;146;531;341;1158;487;1689
420419;201407;470;1498;325;1209;141;571;84;314;225;885
420420;201407;11412;34603;8646;28877;2562;9581;2926;9406;5488;18987
420425;201407;1265;3526;785;2516;96;375;328;958;424;1333
420430;201407;4216;13366;2916;10264;904;3459;838;2918;1742;6377
420435;201407;265;855;196;691;61;247;74;243;135;490
420440;201407;1496;4394;919;3167;361;1339;167;522;528;1861
420445;201407;436;1271;341;1099;82;265;173;572;255;837
420450;201407;1305;3889;783;2791;188;768;159;480;347;1248
420455;201407;2322;7236;2075;6798;566;2119;938;2995;1504;5114
420460;201407;10142;32248;8250;28588;2419;9417;3081;10237;5500;19654
420470;201407;1246;3519;836;2720;252;918;239;739;491;1657
420475;201407;183;594;120;437;40;149;32;119;72;268
420480;201407;6177;18560;5116;16698;2065;7500;932;2996;2997;10496
420490;201407;897;2735;618;2210;195;741;156;540;351;1281
420500;201407;2137;6644;1757;5942;539;1958;866;2930;1405;4888
420510;201407;201;848;188;811;78;350;54;214;132;564
420515;201407;164;597;133;523;43;179;24;96;67;275
420517;201407;971;3024;892;2871;160;537;581;1886;741;2423
420519;201407;458;1298;341;1056;68;221;129;405;197;626
420520;201407;817;2322;649;2079;190;677;299;916;489;1593
420530;201407;1416;4912;1144;4233;373;1514;292;957;665;2471
420535;201407;268;816;178;616;56;223;33;89;89;312
420540;201407;20765;62314;15364;50767;5020;18156;4645;14493;9665;32649
420543;201407;499;1373;368;1153;48;176;221;729;269;905
420545;201407;1689;5535;1384;4835;383;1505;470;1539;853;3044
420550;201407;5030;16422;4129;14386;1199;4669;1323;4491;2522;9160
420555;201407;471;1541;395;1374;138;520;121;411;259;931
420560;201407;595;1774;496;1564;94;333;254;791;348;1124
420570;201407;2063;6889;1668;5896;488;1935;534;1782;1022;3717
420580;201407;1254;4153;1038;3749;302;1204;482;1744;784;2948
420590;201407;3497;11080;2531;8843;703;2677;519;1663;1222;4340
420600;201407;972;3383;880;3159;237;920;369;1348;606;2268
420610;201407;651;2124;450;1660;145;581;78;259;223;840
420620;201407;1224;3885;1087;3631;411;1459;298;979;709;2438
420630;201407;1175;3849;902;3151;254;953;284;886;538;1839
420640;201407;701;2199;327;1249;82;364;20;55;102;419
420650;201407;2143;6598;1226;4368;255;1040;222;656;477;1696
420660;201407;686;2051;555;1801;126;459;274;869;400;1328
420665;201407;848;2471;545;1830;115;428;177;528;292;956
420670;201407;1803;5776;1355;4760;346;1359;269;860;615;2219
420675;201407;259;827;185;651;46;188;75;246;121;434
420680;201407;516;1276;311;952;63;210;107;313;170;523
420690;201407;837;2920;607;2272;127;519;188;652;315;1171
420700;201407;3786;11129;2940;9406;726;2672;1001;3087;1727;5759
420710;201407;824;2958;685;2668;270;1132;198;741;468;1873
420720;201407;1997;6205;1727;5836;463;1633;1019;3460;1482;5093
420730;201407;4791;15055;4166;13878;1458;5195;1613;5295;3071;10490
420740;201407;821;2716;785;2666;174;612;536;1832;710;2444
420750;201407;2572;8445;1822;6606;437;1795;547;1746;984;3541
420757;201407;128;414;97;365;31;129;28;98;59;227
420760;201407;454;1487;340;1173;75;277;106;345;181;622
420765;201407;680;2281;429;1631;127;528;98;363;225;891
420768;201407;1314;4624;1084;4083;365;1440;403;1545;768;2985
420770;201407;923;2911;595;2158;195;765;154;528;349;1293
420775;201407;717;2316;482;1669;156;547;108;357;264;904
420780;201407;1725;5333;1170;3961;316;1157;319;1000;635;2157
420785;201407;325;998;225;738;44;158;76;225;120;383
420790;201407;1393;5032;1143;4340;342;1438;453;1626;795;3064
420800;201407;950;2820;566;1931;179;679;125;386;304;1065
420810;201407;2687;9371;2161;8121;776;3239;579;2110;1355;5349
420820;201407;8673;29213;6930;26014;2378;9871;2347;8885;4725;18756
420830;201407;2865;9731;2481;8990;934;3661;901;3162;1835;6823
420840;201407;966;2915;578;2121;160;661;170;577;330;1238
420845;201407;1334;4495;1087;3985;403;1671;237;776;640;2447
420850;201407;2117;6997;1413;5460;505;2104;296;1140;801;3244
420860;201407;686;2010;463;1600;166;645;187;633;353;1278
420870;201407;1428;4163;1131;3732;435;1568;356;1118;791;2686
420880;201407;1487;5046;1228;4369;364;1361;241;813;605;2174
420890;201407;13334;32345;6209;19744;1285;4720;2233;6300;3518;11020
420895;201407;241;670;118;390;39;135;31;99;70;234
420900;201407;2407;7029;1602;5405;453;1643;413;1328;866;2971
420910;201407;24394;75131;16301;57726;4094;16568;4459;14786;8553;31354
420915;201407;679;2671;617;2508;195;799;276;1168;471;1967
420917;201407;465;1451;249;804;58;219;89;236;147;455
420920;201407;211;614;111;384;50;185;17;59;67;244
420930;201407;21089;64024;17731;58169;5466;19554;6591;21555;12057;41109
420940;201407;4517;13930;3891;12552;1142;4101;1186;3474;2328;7575
420945;201407;244;771;160;558;51;196;42;139;93;335
420950;201407;655;1910;312;1170;80;342;57;195;137;537
420960;201407;1493;4697;1289;4330;420;1591;485;1518;905;3109
420970;201407;2739;8639;2411;8104;617;2225;1301;4493;1918;6718
420980;201407;478;1543;392;1386;120;420;192;743;312;1163
420985;201407;609;1824;360;1285;112;436;105;354;217;790
420990;201407;947;2821;646;2281;174;676;185;608;359;1284
421000;201407;688;2478;489;1945;156;675;69;218;225;893
421003;201407;707;2036;303;1056;70;272;54;152;124;424
421005;201407;268;865;222;782;71;272;104;358;175;630
421010;201407;7055;21714;5333;18264;1723;6412;1627;5299;3350;11711
421020;201407;502;1613;379;1365;66;243;206;782;272;1025
421030;201407;1042;3864;964;3669;345;1390;326;1264;671;2654
421040;201407;961;2897;780;2571;251;899;296;905;547;1804
421050;201407;2066;5538;1187;3977;332;1284;333;985;665;2269
421055;201407;287;927;189;679;59;232;49;146;108;378
421060;201407;572;2104;476;1832;130;540;130;483;260;1023
421070;201407;816;2581;544;1925;144;578;147;517;291;1095
421080;201407;701;2288;631;2136;189;678;298;998;487;1676
421085;201407;586;1596;328;1136;82;309;86;317;168;626
421090;201407;484;1375;332;1039;81;268;145;441;226;709
421100;201407;1087;3343;766;2639;221;815;180;540;401;1355
421105;201407;1518;4887;1308;4497;334;1252;539;1901;873;3153
421110;201407;1669;5535;1450;5154;537;2071;477;1598;1014;3669
421120;201407;1722;5587;1258;4468;297;1219;387;1233;684;2452
421125;201407;458;1390;347;1176;111;416;125;398;236;814
421130;201407;3500;11715;2905;10579;1071;4306;1000;3682;2071;7988
421140;201407;439;1383;352;1195;97;367;135;430;232;797
421145;201407;603;1998;452;1583;78;310;200;671;278;981
421150;201407;566;1872;442;1633;116;463;197;723;313;1186
421160;201407;951;2933;645;2262;154;618;221;706;375;1324
421165;201407;340;1208;274;1002;68;258;119;437;187;695
421170;201407;1932;6207;1609;5417;441;1568;817;2713;1258;4281
421175;201407;1455;4382;1155;3880;355;1386;420;1277;775;2663
421180;201407;597;1740;344;1168;95;365;125;386;220;751
421185;201407;495;1414;362;1151;76;230;179;591;255;821
421187;201407;334;1060;266;920;82;291;109;367;191;658
421189;201407;542;1663;489;1560;130;432;190;602;320;1034
421190;201407;11149;35378;8048;28740;2431;9272;2310;8169;4741;17441
421200;201407;1096;3695;959;3393;269;1044;352;1206;621;2250
421205;201407;249;791;187;652;45;188;47;135;92;323
421210;201407;2178;6807;1822;5914;626;2137;563;1773;1189;3910
421220;201407;2552;8759;2244;8090;800;3133;657;2338;1457;5471
421223;201407;795;2278;504;1759;144;533;227;779;371;1312
421225;201407;1251;3921;1044;3489;285;1006;437;1464;722;2470
421227;201407;980;3257;874;3092;225;790;515;1888;740;2678
421230;201407;754;2564;679;2385;196;741;247;830;443;1571
421240;201407;576;1914;370;1309;86;318;74;230;160;548
421250;201407;2003;6224;1388;5094;510;2038;379;1359;889;3397
421260;201407;388;1186;162;629;45;177;35;130;80;307
421265;201407;371;1299;333;1193;81;307;101;363;182;670
421270;201407;734;2010;448;1517;156;581;103;387;259;968
421280;201407;1688;5394;1382;4913;482;1910;436;1562;918;3472
421290;201407;2091;5954;1326;4422;432;1561;311;926;743;2487
421300;201407;331;1035;278;920;99;372;113;349;212;721
421310;201407;536;1843;458;1631;157;567;123;423;280;990
421315;201407;389;1164;224;809;50;187;37;136;87;323
421320;201407;587;2032;408;1541;82;355;75;228;157;583
421330;201407;654;2286;570;2109;237;988;81;282;318;1270
421335;201407;583;1935;472;1712;127;501;104;380;231;881
421340;201407;1993;6344;1745;5896;436;1658;930;3116;1366;4774
421350;201407;1141;3907;952;3482;313;1283;293;1023;606;2306
421360;201407;3341;10066;2222;7837;526;2127;742;2451;1268;4578
421370;201407;1103;3937;957;3608;333;1377;276;1006;609;2383
421380;201407;1090;3170;881;2767;178;616;435;1362;613;1978
421390;201407;201;659;154;533;27;92;43;162;70;254
421400;201407;421;1594;339;1398;140;610;84;326;224;936
421410;201407;376;1170;303;1019;63;217;154;527;217;744
421415;201407;402;1291;215;818;70;278;60;213;130;491
421420;201407;1434;4499;1080;3631;257;930;235;719;492;1649
421430;201407;307;1012;242;881;83;347;45;151;128;498
421440;201407;871;2643;600;2114;171;646;222;747;393;1393
421450;201407;628;2112;451;1695;157;643;91;324;248;967
421460;201407;733;2319;482;1805;132;548;120;426;252;974
421470;201407;551;2018;466;1828;136;547;191;753;327;1300
421480;201407;3099;9713;2117;7711;687;2800;583;1954;1270;4754
421490;201407;344;1154;193;754;74;316;51;198;125;514
421500;201407;2778;9948;2454;9246;1019;4263;568;2082;1587;6345
421505;201407;406;1406;371;1316;115;430;147;512;262;942
421507;201407;704;2297;507;1830;119;450;195;704;314;1154
421510;201407;313;1183;286;1128;94;427;123;424;217;851
421520;201407;828;2231;541;1640;60;230;282;776;342;1006
421530;201407;539;1820;343;1359;90;402;118;456;208;858
421535;201407;747;2329;459;1698;91;353;233;850;324;1203
421540;201407;429;1272;369;1158;95;328;151;444;246;772
421545;201407;1262;4430;1033;3946;348;1482;230;837;578;2319
421550;201407;2291;7802;2057;7344;720;2846;661;2302;1381;5148
421555;201407;337;1029;140;494;27;103;29;94;56;197
421560;201407;211;634;99;352;25;100;23;77;48;177
421565;201407;1112;3534;1016;3366;434;1539;355;1142;789;2681
421567;201407;967;3616;834;3264;401;1609;179;699;580;2308
421568;201407;503;1648;390;1394;113;420;120;426;233;846
421569;201407;211;700;129;496;31;132;32;118;63;250
421570;201407;1260;4179;838;3103;285;1174;205;713;490;1887
421575;201407;623;2110;553;1967;113;428;313;1115;426;1543
421580;201407;4343;14578;3494;12642;1305;5263;877;2894;2182;8157
421590;201407;264;848;214;741;47;173;102;333;149;506
421600;201407;587;1774;433;1440;132;478;102;320;234;798
421605;201407;726;2267;512;1821;130;525;143;480;273;1005
421610;201407;1872;4907;1472;4332;197;638;961;2822;1158;3460
421620;201407;5322;16555;3814;13296;1270;4761;1293;4540;2563;9301
421625;201407;424;1364;253;924;66;271;88;306;154;577
421630;201407;2862;8684;1788;6229;524;1974;371;1256;895;3230
421635;201407;358;1207;259;966;70;285;97;330;167;615
421640;201407;1136;3663;989;3406;215;747;607;2145;822;2892
421650;201407;2392;8109;2078;7377;850;3308;353;1170;1203;4478
421660;201407;9688;32754;7908;29147;2647;10765;2550;8948;5197;19713
421670;201407;1276;4196;941;3403;298;1172;276;991;574;2163
421680;201407;1525;5033;1339;4576;534;1919;274;900;808;2819
421690;201407;2103;6984;1646;5864;469;1805;288;963;757;2768
421700;201407;751;2339;469;1685;147;602;143;441;290;1043
421710;201407;375;1347;283;1080;113;439;75;280;188;719
421715;201407;321;916;197;657;58;206;60;196;118;402
421720;201407;1694;5208;1194;4176;449;1788;369;1157;818;2945
421725;201407;133;472;128;461;40;159;57;205;97;364
421730;201407;669;2095;348;1284;90;364;79;235;169;599
421740;201407;744;2353;550;1889;166;678;144;395;310;1073
421750;201407;1513;4584;1169;3853;330;1194;462;1392;792;2586
421755;201407;471;1500;341;1167;105;398;100;305;205;703
421760;201407;571;1924;336;1257;90;377;134;483;224;860
421770;201407;3879;11876;3144;10369;1254;4306;886;3013;2140;7319
421775;201407;602;1783;394;1396;88;323;126;437;214;760
421780;201407;1830;6348;1441;5444;552;2248;421;1504;973;3752
421790;201407;1038;2983;657;2328;211;858;165;524;376;1382
421795;201407;415;1282;284;949;51;190;89;299;140;489
421800;201407;2854;9323;2229;8050;641;2601;801;2629;1442;5230
421810;201407;693;2246;506;1808;160;600;93;327;253;927
421820;201407;1298;4032;944;3331;223;939;279;882;502;1821
421825;201407;1426;4844;1319;4584;231;926;791;2658;1022;3584
421830;201407;3224;11090;3018;10668;774;2860;1532;5582;2306;8442
421835;201407;194;614;153;543;50;212;72;230;122;442
421840;201407;528;1887;468;1742;165;667;174;619;339;1286
421850;201407;616;1833;444;1496;149;532;147;509;296;1041
421860;201407;399;1296;260;981;61;252;55;201;116;453
421870;201407;5474;16310;3905;13017;1216;4368;803;2584;2019;6952
421875;201407;453;1383;219;816;58;252;54;174;112;426
421880;201407;1133;3738;915;3212;278;1115;248;802;526;1917
421885;201407;366;1275;324;1178;88;322;132;480;220;802
421890;201407;1106;3810;958;3488;325;1300;308;1097;633;2397
421895;201407;444;1513;409;1443;110;389;225;823;335;1212
421900;201407;905;2970;753;2598;213;782;272;860;485;1642
421910;201407;558;1802;401;1429;109;435;119;379;228;814
421915;201407;636;1951;487;1611;116;412;164;507;280;919
421917;201407;621;1939;489;1707;157;646;188;604;345;1250
421920;201407;802;2486;622;2239;288;1085;204;724;492;1809
421930;201407;4166;11875;2875;9492;928;3415;519;1649;1447;5064
421935;201407;920;3203;723;2744;196;832;270;992;466;1824
421940;201407;357;1292;255;1009;81;355;62;220;143;575
421950;201407;4577;13201;2576;8907;799;2942;574;2017;1373;4959
421960;201407;265;857;212;735;58;219;60;197;118;416
421970;201407;2227;6808;1661;5527;615;2247;337;982;952;3229
421985;201407;511;1409;286;952;56;209;94;318;150;527
422000;201407;614;1783;474;1528;85;304;267;899;352;1203
430003;201407;916;2675;728;2346;216;775;229;715;445;1490
430005;201407;325;1090;275;980;55;213;155;533;210;746
430010;201407;2293;6565;1753;5541;538;1768;678;2179;1216;3947
430020;201407;1123;3024;981;2807;227;755;568;1545;795;2300
430030;201407;1610;4408;1348;3935;396;1248;573;1587;969;2835
430040;201407;13083;34437;11032;31102;3442;10019;4205;11908;7647;21927
430045;201407;767;2127;615;1819;117;387;348;1002;465;1389
430047;201407;253;664;169;514;35;103;80;241;115;344
430050;201407;1139;3170;758;2426;161;602;303;909;464;1511
430055;201407;303;885;199;638;37;133;103;326;140;459
430057;201407;81;217;37;126;7;29;10;22;17;51
430060;201407;16145;53011;14286;49625;4229;15349;7029;24926;11258;40275
430063;201407;1113;3334;900;2870;240;777;436;1438;676;2215
430064;201407;1729;5161;1444;4674;413;1358;645;2159;1058;3517
430066;201407;179;453;132;378;27;88;73;193;100;281
430070;201407;682;2041;416;1451;111;422;123;395;234;817
430080;201407;654;2153;520;1839;144;562;152;502;296;1064
430085;201407;729;2077;528;1722;159;596;209;642;368;1238
430087;201407;1016;3111;968;3021;108;378;756;2336;864;2714
430090;201407;833;2239;305;1011;42;161;70;232;112;393
430100;201407;1127;3532;846;2930;298;1140;202;584;500;1724
430105;201407;836;2679;649;2295;208;811;172;577;380;1388
430107;201407;266;906;210;738;45;172;81;269;126;441
430110;201407;2309;6802;2102;6449;697;2276;935;2849;1632;5125
430120;201407;1855;5711;1482;4905;331;1153;840;2737;1171;3890
430130;201407;4637;11950;4184;11311;769;2236;2573;6996;3342;9232
430140;201407;1248;4053;975;3389;304;1093;332;1126;636;2219
430150;201407;957;2604;652;2028;165;539;198;614;363;1153
430155;201407;525;1648;397;1356;90;301;189;658;279;959
430160;201407;18947;56126;17611;53905;3919;12946;9999;31361;13918;44307
430163;201407;1981;5994;1706;5475;386;1378;855;2771;1241;4149
430165;201407;340;1110;251;946;106;419;61;220;167;639
430170;201407;812;2385;392;1371;83;297;79;240;162;537
430175;201407;975;3097;775;2624;184;585;368;1324;552;1909
430180;201407;1160;3181;997;2910;246;800;484;1385;730;2185
430185;201407;775;1953;400;1219;64;217;132;361;196;578
430187;201407;743;2331;634;2110;190;725;207;646;397;1371
430190;201407;2394;7170;2100;6602;527;1891;1031;3224;1558;5115
430192;201407;203;623;102;317;14;42;31;92;45;134
430195;201407;295;906;80;297;11;39;13;39;24;78
430200;201407;1881;6020;1564;5358;478;1742;383;1313;861;3055
430205;201407;528;1542;412;1332;53;192;267;864;320;1056
430210;201407;6705;19184;3770;12758;1025;3746;769;2405;1794;6151
430215;201407;360;1053;269;862;62;212;121;371;183;583
430220;201407;704;1855;340;1132;69;252;63;199;132;451
430222;201407;325;1004;251;839;58;226;111;350;169;576
430223;201407;356;1073;313;1003;63;201;209;681;272;882
430225;201407;61;177;37;118;7;19;9;23;16;42
430230;201407;2169;6892;2044;6761;359;1059;1591;5467;1950;6526
430235;201407;285;946;229;802;72;275;60;195;132;470
430237;201407;471;1301;373;1111;52;195;246;697;298;892
430240;201407;1157;3476;915;2999;310;1141;305;918;615;2059
430245;201407;964;3128;754;2662;214;785;333;1199;547;1984
430250;201407;1636;4552;1475;4268;631;1876;462;1369;1093;3245
430258;201407;213;602;145;466;22;75;69;226;91;301
430260;201407;855;2434;573;1843;79;297;317;1021;396;1318
430265;201407;338;1062;274;913;84;274;44;132;128;406
430270;201407;3660;10418;3278;9756;784;2641;1729;5055;2513;7696
430280;201407;5528;15715;4709;14181;1342;4288;2118;6354;3460;10642
430290;201407;2547;7034;2421;6896;299;838;2012;5842;2311;6680
430300;201407;10463;31952;8837;28806;3091;10549;3641;12178;6732;22727
430310;201407;9013;28476;7927;26342;2575;9155;3369;10933;5944;20088
430320;201407;880;2597;601;2023;97;287;313;1105;410;1392
430330;201407;1033;2844;867;2528;264;813;349;942;613;1755
430340;201407;785;1994;448;1501;106;402;216;711;322;1113
430350;201407;6436;20589;5488;18477;1978;7030;1968;6509;3946;13539
430355;201407;264;694;161;502;33;120;41;111;74;231
430360;201407;1180;3166;1011;2849;193;612;563;1547;756;2159
430367;201407;353;979;237;763;42;140;70;219;112;359
430370;201407;646;1907;507;1625;186;633;130;385;316;1018
430380;201407;889;2304;497;1586;132;450;181;597;313;1047
430390;201407;4553;13500;3407;11009;891;3125;1019;3151;1910;6276
430400;201407;1373;3291;962;2685;275;856;455;1194;730;2050
430410;201407;727;1964;559;1686;99;334;289;869;388;1203
430420;201407;4752;13951;3839;11841;1144;3594;1580;4917;2724;8511
430430;201407;837;2333;542;1759;173;612;150;465;323;1077
430435;201407;2122;5791;1731;5079;392;1208;940;2775;1332;3983
430440;201407;4984;15521;4060;13613;884;3135;1916;6705;2800;9840
430450;201407;9212;26622;7410;22881;2824;9166;2166;6640;4990;15806
430460;201407;27999;85652;22900;76251;7249;25877;8395;27965;15644;53842
430461;201407;488;1364;172;558;36;132;44;135;80;267
430462;201407;361;1067;294;950;122;427;95;293;217;720
430463;201407;4083;13482;3621;12543;913;3450;1831;6348;2744;9798
430465;201407;677;1849;574;1674;131;423;366;1048;497;1471
430466;201407;4515;13316;4255;12849;1177;3838;2219;6683;3396;10521
430467;201407;607;1866;534;1746;134;482;266;851;400;1333
430468;201407;1511;4405;1318;4100;529;1780;394;1203;923;2983
430469;201407;180;503;56;207;8;33;14;54;22;87
430470;201407;7778;20916;5664;17293;1893;6217;1527;4601;3420;10818
430471;201407;920;3071;823;2859;304;1105;213;737;517;1842
430480;201407;949;2594;517;1684;89;326;120;334;209;660
430485;201407;248;775;140;503;27;93;52;191;79;284
430490;201407;548;1636;387;1326;115;403;138;492;253;895
430495;201407;443;1330;304;1026;65;235;87;286;152;521
430500;201407;1681;4730;1423;4281;442;1430;648;1938;1090;3368
430510;201407;25934;80274;20334;67307;7007;25417;6025;19009;13032;44426
430511;201407;492;1500;245;828;48;171;45;126;93;297
430512;201407;1369;3611;1206;3337;345;965;481;1390;826;2355
430513;201407;722;2034;505;1561;82;266;237;733;319;999
430515;201407;622;1840;491;1558;102;328;216;707;318;1035
430517;201407;1475;4874;1288;4460;254;938;808;2784;1062;3722
430520;201407;1830;5391;1438;4545;473;1608;550;1672;1023;3280
430530;201407;962;2739;524;1700;108;403;146;429;254;832
430535;201407;2569;8269;2142;7328;594;2261;740;2468;1334;4729
430537;201407;640;1863;449;1539;49;165;343;1199;392;1364
430540;201407;772;1879;586;1633;137;427;335;908;472;1335
430543;201407;610;1605;549;1543;129;387;373;1056;502;1443
430544;201407;769;2524;646;2232;140;530;337;1130;477;1660
430545;201407;1461;4739;1271;4496;413;1453;686;2591;1099;4044
430550;201407;726;2157;501;1688;101;360;211;720;312;1080
430558;201407;120;362;81;275;38;145;10;24;48;169
430560;201407;404;1029;247;732;41;151;104;287;145;438
430570;201407;1246;3266;877;2579;210;719;449;1203;659;1922
430580;201407;1130;3223;761;2496;269;908;207;703;476;1611
430583;201407;156;431;54;178;10;38;5;14;15;52
430585;201407;372;1006;245;732;80;263;104;281;184;544
430587;201407;300;939;256;845;102;351;81;266;183;617
430590;201407;1544;4383;1466;4259;329;1046;887;2558;1216;3604
430593;201407;38;146;33;130;11;52;10;31;21;83
430595;201407;243;695;106;385;33;138;16;46;49;184
430597;201407;413;1272;317;1041;61;221;131;411;192;632
430600;201407;2227;6175;1380;4275;309;1029;496;1498;805;2527
430605;201407;1398;4400;1123;3806;293;1089;469;1611;762;2700
430607;201407;774;2078;624;1819;109;337;383;1128;492;1465
430610;201407;8595;23332;6733;20297;1706;5652;2906;8759;4612;14411
430613;201407;259;641;131;389;29;89;40;100;69;189
430620;201407;1005;3101;828;2690;244;877;331;1009;575;1886
430630;201407;497;1498;300;999;92;315;59;178;151;493
430632;201407;747;2099;472;1500;92;345;242;717;334;1062
430635;201407;707;1963;502;1562;121;395;239;740;360;1135
430637;201407;551;1585;499;1481;82;287;329;939;411;1226
430640;201407;2013;5753;1057;3524;250;892;214;596;464;1488
430642;201407;506;1352;324;1032;65;224;146;454;211;678
430645;201407;197;589;111;388;27;106;28;92;55;198
430650;201407;2169;7153;1883;6540;416;1457;1045;3765;1461;5222
430655;201407;316;953;276;866;73;246;105;279;178;525
430660;201407;6274;18557;5012;16204;1521;5391;2080;6673;3601;12064
430670;201407;507;1491;461;1400;43;127;347;1086;390;1213
430673;201407;811;1985;454;1381;124;390;187;565;311;955
430675;201407;203;619;126;434;29;114;51;167;80;281
430676;201407;4758;14471;4279;13655;1337;4547;1757;5819;3094;10366
430680;201407;1256;3751;926;3020;199;728;369;1107;568;1835
430690;201407;4640;13527;3825;11907;1217;3929;1455;4650;2672;8579
430692;201407;304;1044;222;871;31;120;136;542;167;662
430693;201407;1841;5192;1358;4130;310;1020;407;1195;717;2215
430695;201407;500;1472;416;1302;82;305;215;634;297;939
430697;201407;487;1388;373;1188;116;361;151;516;267;877
430700;201407;10748;28371;5266;17300;1099;4040;654;1983;1753;6023
430705;201407;418;1324;387;1270;129;450;165;550;294;1000
430710;201407;1906;4967;1502;4286;304;930;759;2261;1063;3191
430720;201407;935;2340;612;1856;173;565;248;779;421;1344
430730;201407;1973;5318;1522;4594;361;1054;830;2644;1191;3698
430740;201407;617;1796;387;1290;129;465;64;193;193;658
430745;201407;549;1593;348;1124;71;241;109;356;180;597
430750;201407;1907;5426;1597;4888;381;1287;823;2428;1204;3715
430755;201407;666;1880;478;1466;104;375;214;587;318;962
430760;201407;3779;9696;2975;8667;712;2225;1580;4764;2292;6989
430770;201407;7129;21538;6052;19653;1435;5106;3106;9967;4541;15073
430780;201407;2678;7642;1819;5892;512;1812;688;2117;1200;3929
430781;201407;666;1983;483;1598;138;472;162;526;300;998
430783;201407;586;1526;448;1285;97;308;209;558;306;866
430786;201407;129;431;103;360;34;121;22;80;56;201
430790;201407;4201;11784;2816;8862;588;2153;1226;3577;1814;5730
430800;201407;852;2596;619;2032;162;556;209;650;371;1206
430805;201407;496;1417;362;1167;43;135;222;748;265;883
430807;201407;312;928;228;742;59;237;75;213;134;450
430810;201407;763;2135;384;1294;75;280;75;225;150;505
430820;201407;1125;3609;842;2890;241;878;257;823;498;1701
430825;201407;466;1316;245;773;50;168;79;218;129;386
430830;201407;2738;8072;2539;7761;371;1130;1666;5408;2037;6538
430840;201407;1025;3203;929;2998;243;803;440;1469;683;2272
430843;201407;118;361;77;252;16;50;34;106;50;156
430845;201407;391;1179;316;1028;119;414;45;138;164;552
430850;201407;3455;10585;3076;9880;866;2948;1346;4331;2212;7279
430860;201407;779;2504;594;2082;193;788;153;479;346;1267
430865;201407;750;2059;683;1942;226;674;326;911;552;1585
430870;201407;701;2008;429;1447;134;464;110;355;244;819
430880;201407;1453;4214;1167;3656;458;1496;334;1086;792;2582
430885;201407;202;626;167;570;50;184;62;201;112;385
430890;201407;1749;4661;1313;3865;70;236;784;2250;854;2486
430900;201407;3371;9053;3098;8642;662;1949;1853;5165;2515;7114
430905;201407;1156;3426;792;2625;259;937;210;667;469;1604
430910;201407;2007;6342;1606;5552;589;2172;599;2012;1188;4184
430912;201407;606;1692;472;1473;74;266;269;817;343;1083
430915;201407;454;1535;325;1263;104;423;90;372;194;795
430920;201407;18785;59615;17216;56629;5189;17867;9757;32000;14946;49867
430925;201407;92;260;72;221;21;68;36;111;57;179
430930;201407;9827;30960;7954;27054;2424;8712;3050;10776;5474;19488
430940;201407;1302;4063;945;3249;242;918;274;887;516;1805
430950;201407;1665;4701;1265;3856;396;1280;394;1147;790;2427
430955;201407;127;405;91;310;33;121;24;75;57;196
430957;201407;332;1122;269;985;68;258;121;453;189;711
430960;201407;1851;5328;1615;4913;598;1934;568;1762;1166;3696
430965;201407;1454;4319;1252;3956;115;422;984;3090;1099;3512
430970;201407;561;1613;339;1125;86;310;99;323;185;633
430975;201407;659;2161;506;1779;93;354;269;939;362;1293
430980;201407;593;1436;350;1065;95;328;140;383;235;711
430990;201407;698;2254;528;1827;177;623;140;482;317;1105
430995;201407;749;2251;664;2082;228;746;260;803;488;1549
431000;201407;1801;4875;1011;3228;242;878;154;426;396;1304
431010;201407;2980;8859;2048;6922;543;2006;653;2079;1196;4085
431020;201407;14929;37427;10444;29250;2894;8320;3462;10037;6356;18357
431030;201407;409;1236;232;815;58;216;54;185;112;401
431033;201407;2883;8430;2631;8043;649;2047;1463;4687;2112;6734
431036;201407;245;678;114;380;24;84;33;99;57;183
431040;201407;1053;3081;886;2790;234;814;467;1439;701;2253
431041;201407;610;1701;548;1610;183;551;216;677;399;1228
431043;201407;428;1423;322;1173;154;615;103;334;257;949
431046;201407;124;383;91;303;29;104;30;97;59;201
431050;201407;1932;4914;1543;4264;363;1057;867;2393;1230;3450
431053;201407;650;2161;548;1941;177;676;188;678;365;1354
431055;201407;698;1984;645;1891;81;239;458;1360;539;1599
431057;201407;370;1091;224;793;54;197;93;331;147;528
431060;201407;6427;18983;6032;18480;1607;4761;3632;11621;5239;16382
431065;201407;474;1414;435;1339;49;159;287;885;336;1044
431070;201407;775;2277;475;1592;95;338;132;407;227;745
431075;201407;295;901;197;686;37;140;62;220;99;360
431080;201407;728;2381;606;2120;171;642;133;447;304;1089
431085;201407;976;2590;791;2284;141;432;479;1375;620;1807
431087;201407;636;1833;562;1692;77;220;371;1128;448;1348
431090;201407;587;1500;312;974;108;358;66;189;174;547
431100;201407;4881;13636;4079;12224;1195;3783;1699;5208;2894;8991
431110;201407;1676;4499;1262;3659;311;973;631;1780;942;2753
431112;201407;670;2105;638;2049;202;643;313;1014;515;1657
431113;201407;685;2037;514;1647;156;507;157;509;313;1016
431115;201407;1590;4702;1422;4409;299;978;853;2637;1152;3615
431120;201407;2904;9217;2471;8374;767;2841;1034;3399;1801;6240
431123;201407;569;1738;453;1516;122;440;230;782;352;1222
431125;201407;1445;4480;1109;3757;349;1190;410;1482;759;2672
431127;201407;133;373;66;218;6;19;10;32;16;51
431130;201407;4102;11829;3273;10357;902;3113;1381;4356;2283;7469
431140;201407;4112;10557;2281;7378;457;1718;618;1743;1075;3461
431142;201407;561;1708;509;1609;73;228;328;1062;401;1290
431150;201407;1373;4181;1113;3671;317;1093;418;1388;735;2481
431160;201407;1033;3064;869;2716;173;546;428;1438;601;1984
431162;201407;468;1258;230;772;29;122;36;101;65;223
431164;201407;147;399;43;161;16;63;1;4;17;67
431170;201407;987;2895;765;2450;267;879;223;716;490;1595
431171;201407;924;2764;795;2498;290;960;207;619;497;1579
431173;201407;508;1526;466;1453;109;351;280;879;389;1230
431175;201407;1347;3755;1162;3476;384;1206;481;1443;865;2649
431177;201407;1091;3511;917;3158;309;1175;396;1344;705;2519
431179;201407;226;519;84;257;18;65;26;62;44;127
431180;201407;2753;8278;2162;6949;609;2101;679;2085;1288;4186
431190;201407;797;2212;469;1555;128;475;149;479;277;954
431198;201407;395;1300;345;1196;164;614;74;245;238;859
431200;201407;343;975;113;376;26;91;12;34;38;125
431205;201407;370;1185;237;825;55;197;95;317;150;514
431210;201407;819;2313;708;2095;190;577;376;1119;566;1696
431213;201407;315;978;262;876;81;303;94;301;175;604
431215;201407;347;1031;178;606;35;117;18;51;53;168
431217;201407;249;756;192;622;64;221;50;172;114;393
431220;201407;1217;3173;873;2505;133;432;452;1237;585;1669
431225;201407;1424;4236;1236;3912;297;986;678;2174;975;3160
431230;201407;985;2934;770;2483;133;465;408;1303;541;1768
431235;201407;76;183;36;110;9;30;12;35;21;65
431237;201407;461;1507;407;1430;115;464;192;652;307;1116
431238;201407;55;175;45;150;10;36;15;49;25;85
431240;201407;2859;8749;2432;8009;878;3109;733;2362;1611;5471
431242;201407;440;1423;417;1378;176;631;64;200;240;831
431244;201407;492;1205;344;962;76;255;161;413;237;668
431245;201407;1168;3223;970;2874;185;582;611;1816;796;2398
431247;201407;234;743;186;646;76;289;66;215;142;504
431250;201407;1958;6182;1738;5856;545;1972;752;2595;1297;4567
431260;201407;418;1221;286;956;79;302;72;221;151;523
431261;201407;228;808;193;724;42;168;62;234;104;402
431262;201407;399;1106;163;555;29;124;65;218;94;342
431265;201407;1422;3829;832;2565;202;716;249;651;451;1367
431267;201407;204;620;170;554;51;185;74;225;125;410
431270;201407;2721;7320;2116;6402;604;1933;964;2987;1568;4920
431275;201407;238;769;148;536;44;157;30;94;74;251
431280;201407;220;659;115;392;22;87;26;71;48;158
431290;201407;368;1200;288;988;82;324;70;226;152;550
431295;201407;226;723;134;456;26;99;34;96;60;195
431300;201407;258;758;92;357;26;104;6;25;32;129
431301;201407;254;830;176;625;49;179;41;129;90;308
431303;201407;789;2129;531;1592;123;438;188;519;311;957
431306;201407;2188;6196;1700;5272;327;1211;590;1649;917;2860
431308;201407;57;196;53;185;35;120;14;52;49;172
431310;201407;793;2485;534;1880;121;452;192;686;313;1138
431320;201407;955;2819;599;2083;173;669;158;515;331;1184
431330;201407;2486;6365;1233;3952;369;1289;212;655;581;1944
431333;201407;453;1217;214;654;41;140;70;181;111;321
431335;201407;100;295;84;258;20;57;32;96;52;153
431337;201407;2699;8337;2084;6965;571;1980;556;1817;1127;3797
431339;201407;680;1930;503;1536;112;357;235;711;347;1068
431340;201407;28537;76956;20846;63555;5299;17780;7413;22025;12712;39805
431342;201407;654;1718;550;1542;161;481;292;790;453;1271
431344;201407;408;1118;304;935;32;102;190;598;222;700
431346;201407;349;925;200;592;60;176;56;169;116;345
431349;201407;661;1918;477;1484;104;331;162;492;266;823
431350;201407;4105;12399;3630;11540;712;2593;2070;6368;2782;8961
431360;201407;836;2256;632;1921;169;542;256;789;425;1331
431365;201407;1473;4501;1275;4161;475;1662;507;1676;982;3338
431370;201407;5719;16537;4776;14908;1421;4761;1913;6023;3334;10784
431380;201407;1129;3443;1060;3292;185;617;729;2226;914;2843
431390;201407;3817;10923;2621;8564;815;2993;786;2381;1601;5374
431395;201407;1671;5015;1482;4691;439;1475;615;1956;1054;3431
431400;201407;214;699;141;532;46;185;16;43;62;228
431402;201407;1307;3248;804;2335;170;515;390;1106;560;1621
431403;201407;329;991;250;846;84;309;62;214;146;523
431405;201407;4829;13870;3875;12423;938;3509;1874;5741;2812;9250
431406;201407;831;2626;653;2191;210;719;275;912;485;1631
431407;201407;689;2059;467;1561;144;494;115;359;259;853
431410;201407;17478;54184;13927;47043;5154;18521;3593;12680;8747;31201
431413;201407;214;529;105;327;12;42;46;136;58;178
431415;201407;965;2775;786;2433;198;662;362;1069;560;1731
431417;201407;710;1815;572;1607;102;294;311;904;413;1198
431420;201407;1651;4596;1454;4274;339;1039;804;2450;1143;3489
431430;201407;617;1699;455;1416;116;396;166;480;282;876
431440;201407;33578;98746;29925;92696;9703;30913;13644;44266;23347;75179
431442;201407;216;692;171;580;63;235;24;60;87;295
431445;201407;544;1496;353;1080;67;216;142;418;209;634
431446;201407;523;1536;385;1243;94;316;169;546;263;862
431447;201407;865;2476;619;1917;138;456;271;853;409;1309
431449;201407;960;2724;779;2409;125;425;430;1354;555;1779
431450;201407;2338;6184;2148;5887;485;1393;1390;3782;1875;5175
431455;201407;706;1828;410;1191;127;376;119;327;246;703
431460;201407;3752;10641;3238;9638;989;3013;1215;3721;2204;6734
431470;201407;1935;5742;1541;4862;419;1306;672;2221;1091;3527
431475;201407;190;565;63;250;14;60;4;15;18;75
431477;201407;740;2032;516;1584;90;303;286;853;376;1156
431478;201407;248;656;99;301;23;68;38;112;61;180
431480;201407;2918;8450;2296;7306;711;2495;850;2596;1561;5091
431490;201407;116347;329548;102403;308482;17731;60474;68205;202069;85936;262543
431500;201407;1208;3170;963;2707;277;763;372;1068;649;1831
431505;201407;421;1142;362;1054;39;108;290;860;329;968
431507;201407;469;1150;371;968;70;179;231;609;301;788
431510;201407;2264;6289;1878;5599;387;1272;959;2758;1346;4030
431513;201407;264;730;122;396;26;86;59;195;85;281
431514;201407;111;285;41;133;7;27;3;6;10;33
431515;201407;785;2355;559;1783;122;440;241;683;363;1123
431517;201407;94;306;87;289;40;142;25;72;65;214
431520;201407;495;1501;318;1058;72;265;84;271;156;536
431530;201407;4773;11646;3688;10383;1072;3025;1877;5610;2949;8635
431531;201407;302;869;212;685;55;188;84;278;139;466
431532;201407;581;1653;511;1508;163;520;203;590;366;1110
431535;201407;407;1207;280;879;67;231;81;231;148;462
431540;201407;2281;7358;2032;6995;297;941;1341;4951;1638;5892
431545;201407;201;557;65;232;7;27;13;57;20;84
431550;201407;2541;7674;2339;7303;546;1933;1181;3615;1727;5548
431555;201407;815;2136;708;1976;166;456;383;1086;549;1542
431560;201407;25294;78730;21243;70420;8304;27902;6909;24036;15213;51938
431570;201407;5838;16652;5233;15717;1593;4850;2820;8605;4413;13455
431575;201407;494;1327;350;1072;69;246;111;312;180;558
431580;201407;798;2497;614;2064;174;651;210;642;384;1293
431590;201407;1027;2886;706;2217;109;356;331;1040;440;1396
431595;201407;647;1826;522;1544;132;412;195;570;327;982
431600;201407;2365;7019;1748;5721;475;1779;356;1009;831;2788
431610;201407;1777;5032;1311;4167;306;1029;639;2033;945;3062
431620;201407;427;1340;262;862;81;286;109;326;190;612
431630;201407;1497;4069;1115;3280;293;888;533;1579;826;2467
431640;201407;6375;18952;5774;17977;1440;4928;3257;10002;4697;14930
431642;201407;568;1646;471;1454;77;276;254;752;331;1028
431643;201407;231;619;198;559;29;92;118;312;147;404
431645;201407;1874;5630;1699;5311;387;1252;964;3068;1351;4320
431647;201407;184;527;132;402;43;136;33;82;76;218
431650;201407;267;846;186;670;38;155;43;139;81;294
431660;201407;1578;4693;1165;3827;368;1260;417;1322;785;2582
431670;201407;1444;4027;1158;3509;320;1065;517;1516;837;2581
431673;201407;248;739;158;537;44;160;43;144;87;304
431675;201407;410;1209;240;820;60;211;65;195;125;406
431680;201407;10955;30548;8397;26018;2536;8409;2987;9373;5523;17782
431690;201407;27133;78043;22112;70067;6798;23060;9138;29454;15936;52514
431695;201407;159;542;118;434;28;108;31;87;59;195
431697;201407;527;1498;468;1389;137;411;207;639;344;1050
431700;201407;1715;4845;1462;4353;282;915;784;2279;1066;3194
431710;201407;13522;39904;11153;35768;3448;11547;4269;14190;7717;25737
431720;201407;7483;21234;6141;18668;1418;4831;3080;9165;4498;13996
431725;201407;35;123;33;119;13;48;12;43;25;91
431730;201407;4006;12340;3258;10903;952;3497;1088;3715;2040;7212
431740;201407;6163;18190;5399;16713;1985;6615;1512;4492;3497;11107
431750;201407;10854;31088;9318;28569;2049;6783;4902;15354;6951;22137
431755;201407;284;752;78;276;18;73;14;43;32;116
431760;201407;4252;12881;3523;11462;986;3488;1134;3550;2120;7038
431770;201407;2427;6647;2038;6020;512;1577;1077;3167;1589;4744
431775;201407;249;690;182;562;74;240;44;119;118;359
431780;201407;2434;6554;1843;5439;529;1682;545;1525;1074;3207
431790;201407;1266;4008;1120;3740;282;999;594;1975;876;2974
431795;201407;502;1483;392;1235;81;278;196;619;277;897
431800;201407;9970;29624;8347;26562;2819;9674;2504;7839;5323;17513
431805;201407;315;764;89;302;13;52;18;58;31;110
431810;201407;3720;10401;3048;9013;660;2094;1443;4214;2103;6308
431820;201407;2967;9379;2609;8673;754;2697;1014;3304;1768;6001
431830;201407;12120;31234;9831;27705;3167;9545;3877;11106;7044;20651
431840;201407;3698;11060;3251;10207;984;3171;1477;4745;2461;7916
431842;201407;781;2016;417;1272;86;291;140;400;226;691
431843;201407;377;1096;333;1021;69;236;192;578;261;814
431844;201407;170;510;130;432;38;146;43;134;81;280
431845;201407;553;1681;504;1576;59;193;338;1072;397;1265
431846;201407;545;1629;468;1490;92;335;275;876;367;1211
431848;201407;202;555;109;368;23;92;23;73;46;165
431849;201407;413;1039;118;363;26;85;33;87;59;172
431850;201407;5151;15224;4561;14074;1091;3663;2222;6755;3313;10418
431860;201407;1006;2822;794;2456;167;591;426;1256;593;1847
431861;201407;100;305;60;208;13;42;8;23;21;65
431862;201407;509;1720;414;1504;151;606;106;355;257;961
431870;201407;27001;76817;22567;68873;6270;20901;9756;29089;16026;49990
431880;201407;5053;15960;4195;13991;1227;4464;1715;5564;2942;10028
431890;201407;6347;17775;5239;15767;1950;6131;1729;5361;3679;11492
431900;201407;1049;3111;791;2644;234;881;304;916;538;1797
431910;201407;1018;2420;486;1410;101;328;191;505;292;833
431912;201407;637;1855;501;1581;162;492;175;583;337;1075
431915;201407;1455;3974;1090;3312;285;932;436;1329;721;2261
431920;201407;1572;4419;1433;4222;193;522;1110;3370;1303;3892
431930;201407;1377;3811;1062;3300;173;509;631;2094;804;2603
431935;201407;121;443;110;420;47;204;32;99;79;303
431936;201407;498;1434;437;1309;69;197;278;906;347;1103
431937;201407;358;970;212;656;59;200;42;115;101;315
431940;201407;2868;7926;1913;6036;519;1743;559;1741;1078;3484
431950;201407;1992;6363;1779;5975;510;1869;738;2368;1248;4237
431960;201407;3824;11359;3493;10710;1075;3472;1273;3926;2348;7398
431970;201407;524;1452;277;910;45;169;85;266;130;435
431971;201407;139;402;115;367;31;104;51;155;82;259
431973;201407;506;1760;447;1636;67;244;269;1041;336;1285
431975;201407;21;79;15;63;4;21;4;16;8;37
431980;201407;1605;4678;1411;4273;371;1261;568;1608;939;2869
431990;201407;9036;25268;7095;22082;1585;5648;2929;8660;4514;14308
432000;201407;11600;34128;9519;30410;3049;10245;4034;12909;7083;23154
432010;201407;2660;7867;2276;7133;540;1921;1094;3313;1634;5234
432020;201407;2486;6216;2017;5607;300;905;1365;3780;1665;4685
432023;201407;558;1628;404;1290;106;374;147;439;253;813
432026;201407;1243;3894;1043;3441;218;750;534;1762;752;2512
432030;201407;446;1314;362;1131;99;312;158;477;257;789
432032;201407;587;1556;393;1190;71;243;215;624;286;867
432035;201407;897;2852;803;2669;182;625;475;1577;657;2202
432040;201407;994;2577;565;1854;154;562;133;341;287;903
432045;201407;237;756;174;627;49;187;67;250;116;437
432050;201407;820;2386;730;2217;145;461;423;1313;568;1774
432055;201407;877;2721;743;2435;162;588;439;1391;601;1979
432057;201407;481;1258;376;1060;45;152;241;634;286;786
432060;201407;482;1368;208;723;56;220;53;164;109;384
432065;201407;249;726;192;620;48;169;89;266;137;435
432067;201407;1079;3486;799;2832;214;787;386;1366;600;2153
432070;201407;2739;7397;2001;5936;620;2062;662;1862;1282;3924
432080;201407;4433;12989;3866;11949;1209;3943;1617;4922;2826;8865
432085;201407;296;921;238;814;72;286;100;326;172;612
432090;201407;1840;5714;1559;5104;594;2103;499;1457;1093;3560
432100;201407;1295;3840;718;2494;189;678;131;399;320;1077
432110;201407;3208;9697;2556;8308;853;3056;495;1535;1348;4591
432120;201407;5610;17017;4843;15584;1779;6100;1624;5233;3403;11333
432130;201407;2373;6973;2043;6526;528;1842;1127;3633;1655;5475
432132;201407;433;1359;259;917;49;184;96;303;145;487
432135;201407;810;2455;769;2384;122;398;538;1662;660;2060
432140;201407;2994;8825;2434;7788;694;2275;975;3423;1669;5698
432143;201407;1460;4433;1258;4097;300;1003;712;2391;1012;3394
432145;201407;1184;3767;809;2879;270;1053;163;519;433;1572
432146;201407;286;904;207;709;72;259;54;178;126;437
432147;201407;847;2682;680;2313;199;690;274;950;473;1640
432149;201407;415;1239;281;915;87;299;97;302;184;601
432150;201407;4024;11744;3132;10025;1008;3538;1028;3125;2036;6663
432160;201407;4851;15784;4353;14943;1511;5405;1769;6376;3280;11781
432162;201407;351;868;97;315;27;96;25;69;52;165
432163;201407;393;1026;107;341;16;50;23;77;39;127
432166;201407;836;2511;683;2187;145;530;328;977;473;1507
432170;201407;928;3070;642;2432;142;572;143;522;285;1094
432180;201407;2987;7969;2101;6451;632;2081;647;1942;1279;4023
432183;201407;469;1516;393;1356;174;619;95;331;269;950
432185;201407;989;2760;631;2055;142;522;250;790;392;1312
432190;201407;3741;10378;2733;8153;769;2386;859;2415;1628;4801
432195;201407;1340;3834;1196;3611;208;678;762;2284;970;2962
432200;201407;3412;10487;2768;9342;759;2764;1316;4528;2075;7292
432210;201407;452;1345;388;1246;106;396;192;569;298;965
432215;201407;934;2911;818;2714;149;465;509;1793;658;2258
432218;201407;334;927;256;777;49;161;118;333;167;494
432220;201407;4128;11128;3431;9991;452;1551;2243;6409;2695;7960
432225;201407;67;224;57;204;28;106;13;44;41;150
432230;201407;1236;3499;876;2707;264;894;343;955;607;1849
432232;201407;595;1757;470;1513;113;411;225;710;338;1121
432234;201407;565;1566;414;1210;103;309;178;496;281;805
432235;201407;80;249;48;171;15;66;8;28;23;94
432237;201407;518;1447;469;1368;34;135;369;1044;403;1179
432240;201407;16280;53932;14219;51139;3169;12527;8533;31408;11702;43935
432250;201407;5832;20336;5442;19563;2334;9037;1565;5685;3899;14722
432252;201407;505;1495;418;1327;132;446;186;598;318;1044
432253;201407;1335;4377;991;3478;315;1130;326;1159;641;2289
432254;201407;721;1974;221;720;52;185;37;106;89;291
432255;201407;221;555;124;403;38;136;40;123;78;259
432260;201407;7621;19526;5395;15804;1312;4033;2412;7174;3724;11207
432270;201407;2869;8863;2491;8199;744;2501;1131;3798;1875;6299
432280;201407;1348;3919;804;2701;186;698;189;568;375;1266
432285;201407;170;536;71;244;23;86;12;32;35;118
432290;201407;626;1907;417;1417;96;354;161;527;257;881
432300;201407;25095;76918;22807;72971;5735;19527;12528;40078;18263;59605
432310;201407;1019;3166;881;2914;198;731;465;1500;663;2231
432320;201407;293;814;181;584;52;167;60;198;112;365
432330;201407;288;804;112;393;19;67;14;42;33;109
432335;201407;207;607;91;320;26;97;10;31;36;128
432340;201407;324;848;165;513;42;137;52;155;94;292
432345;201407;778;2228;720;2136;164;569;394;1096;558;1665
432350;201407;499;1397;324;1064;86;300;86;262;172;562
432360;201407;102;299;38;138;14;58;14;45;28;103
432370;201407;496;1416;401;1225;39;118;270;843;309;961
432375;201407;919;2355;730;2040;125;363;437;1238;562;1601
432377;201407;84;287;43;140;10;40;14;34;24;74
432380;201407;937;3266;848;3091;332;1358;335;1147;667;2505
500020;201407;2097;6483;1538;5373;426;1716;516;1666;942;3382
500025;201407;1070;2697;687;2026;126;387;347;1003;473;1390
500060;201407;6534;19241;5290;17247;777;2546;3529;11967;4306;14513
500070;201407;4218;12522;3586;11425;875;3169;1690;5296;2565;8465
500080;201407;1806;5364;1358;4550;459;1674;434;1500;893;3174
500085;201407;2186;5893;1640;5046;213;741;1013;3008;1226;3749
500090;201407;2489;7325;1910;6267;409;1390;975;3297;1384;4687
500100;201407;2595;7904;2415;7615;782;2794;1127;3394;1909;6188
500110;201407;8417;24818;6935;22564;1145;4039;4064;13891;5209;17930
500124;201407;1953;6314;1682;5858;303;1019;1018;3836;1321;4855
500150;201407;1562;4046;1197;3459;289;950;565;1518;854;2468
500190;201407;5134;13592;4050;12252;922;2988;2287;7163;3209;10151
500200;201407;2747;7028;2006;5890;377;1273;1177;3353;1554;4626
500210;201407;5043;15115;4331;14001;1016;3479;2227;7351;3243;10830
500215;201407;1618;5061;1343;4526;278;1065;577;1841;855;2906
500220;201407;2868;9067;2350;8106;586;2168;899;3192;1485;5360
500230;201407;2750;7264;2130;6321;663;2104;874;2632;1537;4736
500240;201407;5088;15751;3776;13104;754;2828;1597;5866;2351;8694
500260;201407;2602;7042;2086;6200;407;1345;1044;2924;1451;4269
500270;201407;114094;299674;76728;235438;22003;73286;20546;62924;42549;136210
500280;201407;1414;4082;1209;3797;189;618;826;2659;1015;3277
500290;201407;4211;10669;2718;8210;798;2782;885;2431;1683;5213
500295;201407;2622;8080;1870;6226;454;1710;528;1573;982;3283
500310;201407;861;2314;748;2146;182;575;362;994;544;1569
500315;201407;3121;9896;2693;9279;530;1796;1729;6259;2259;8055
500320;201407;14584;48590;12684;45114;4120;15375;4976;18799;9096;34174
500325;201407;4352;11559;3306;9873;875;2874;1578;4586;2453;7460
500330;201407;6193;17102;4834;14540;1328;4301;2185;6471;3513;10772
500345;201407;2555;7413;2134;6709;523;1837;1100;3354;1623;5191
500348;201407;2599;7527;2321;7064;254;877;1716;5204;1970;6081
500350;201407;1246;3817;804;2809;134;497;248;886;382;1383
500370;201407;24309;76065;19081;65846;5005;19172;6784;23535;11789;42707
500375;201407;2879;7897;2099;6436;521;1741;893;2787;1414;4528
500380;201407;3052;8830;2566;7937;902;2938;818;2473;1720;5411
500390;201407;626;1356;410;1053;50;160;291;705;341;865
500400;201407;1385;4370;1099;3674;295;1097;336;1041;631;2138
500410;201407;2190;6201;1774;5587;464;1608;852;2672;1316;4280
500430;201407;2824;8302;2281;7512;550;1961;1040;3563;1590;5524
500440;201407;1448;4127;1165;3670;268;938;601;1852;869;2790
500450;201407;2218;6939;1760;6010;469;1800;377;1156;846;2956
500460;201407;3851;11614;3041;10269;912;3368;959;3241;1871;6609
500470;201407;2980;8910;2121;6999;607;2174;359;1076;966;3250
500480;201407;2046;6592;1896;6368;199;671;1507;5211;1706;5882
500490;201407;1109;3166;919;2837;291;994;322;1005;613;1999
500500;201407;3682;11449;2949;10322;1095;4302;973;3385;2068;7687
500510;201407;921;2468;606;1928;128;473;254;733;382;1206
500515;201407;2005;5342;1602;4800;277;797;1004;3245;1281;4042
500520;201407;2889;10085;2592;9670;539;2126;1613;6227;2152;8353
500525;201407;1259;4004;1037;3563;229;837;530;1913;759;2750
500540;201407;5671;16375;3539;12109;1114;4351;717;2266;1831;6617
500560;201407;4894;16156;4398;15423;858;3196;2972;10555;3830;13751
500568;201407;4027;10563;3006;9046;721;2271;1518;4628;2239;6899
500570;201407;7952;22123;5688;18052;1728;5885;2075;6592;3803;12477
500580;201407;3595;10530;2875;9264;429;1502;1889;6090;2318;7592
500600;201407;3333;9326;2478;7812;648;2235;1008;3161;1656;5396
500620;201407;8144;22946;5983;19208;1313;4731;3005;9652;4318;14383
500625;201407;721;2179;467;1626;108;408;153;505;261;913
500627;201407;455;1316;344;1099;74;246;100;342;174;588
500630;201407;6332;17836;5059;15942;1689;5836;1669;5236;3358;11072
500635;201407;2533;9894;2149;9281;321;1294;1383;6539;1704;7833
500640;201407;1608;3997;1286;3538;137;432;936;2531;1073;2963
500660;201407;17386;51705;14060;45984;3794;13958;6036;19561;9830;33519
500690;201407;3060;8792;2503;8098;871;2862;1022;3577;1893;6439
500710;201407;3870;11723;3405;10955;842;2947;1753;5653;2595;8600
500720;201407;6040;16526;3969;12743;1179;4150;1164;3640;2343;7790
500730;201407;1024;2971;784;2491;180;630;324;996;504;1626
500740;201407;3776;10664;2767;8827;611;2211;1267;3864;1878;6075
500750;201407;871;2550;795;2451;178;572;492;1564;670;2136
500755;201407;1291;3801;958;3146;238;870;345;1038;583;1908
500769;201407;4914;13352;3218;9876;712;2399;967;2667;1679;5066
500770;201407;1787;5355;1388;4581;417;1487;491;1624;908;3111
500780;201407;1115;3490;968;3205;289;1054;425;1345;714;2399
500790;201407;9026;25632;7563;23032;1470;5231;4190;12207;5660;17438
500793;201407;2391;6968;1922;6188;345;1241;966;2997;1311;4238
500795;201407;2476;7380;2190;6963;298;804;1631;5530;1929;6334
500797;201407;964;2648;734;2266;162;537;333;1025;495;1562
500800;201407;2667;7595;2130;6822;770;2765;792;2568;1562;5333
500830;201407;16963;49671;12523;40637;3656;12794;3899;12323;7555;25117
500840;201407;1433;4153;1074;3446;216;744;500;1585;716;2329
510010;201407;1374;4208;1204;3927;393;1324;541;1812;934;3136
510020;201407;3059;8973;2148;7180;616;2182;635;2047;1251;4229
510025;201407;9407;28331;8116;26091;2376;8436;3524;11029;5900;19465
510030;201407;2167;5925;1815;5388;546;1699;813;2387;1359;4086
510035;201407;916;2716;763;2477;147;486;447;1515;594;2001
510040;201407;1769;4974;1406;4432;311;1100;729;2297;1040;3397
510050;201407;1878;5531;1388;4618;368;1348;536;1756;904;3104
510060;201407;1348;3976;1022;3351;265;941;365;1162;630;2103
510080;201407;1224;3822;1006;3422;321;1232;296;913;617;2145
510100;201407;675;1827;460;1397;91;297;182;519;273;816
510120;201407;301;629;179;481;20;60;119;314;139;374
510125;201407;3173;8491;2508;7337;504;1789;1214;3347;1718;5136
510130;201407;2161;6005;1841;5493;537;1686;792;2399;1329;4085
510140;201407;2959;9709;2464;8927;964;3803;670;2302;1634;6105
510160;201407;1350;4533;1260;4416;110;445;1043;3647;1153;4092
510170;201407;6157;19066;5193;17297;1193;4398;2560;8288;3753;12686
510180;201407;11654;31874;8632;26937;2600;8566;3236;10967;5836;19533
510185;201407;1263;4106;1157;3948;201;656;813;2934;1014;3590
510190;201407;1917;6232;1430;5403;373;1551;588;2306;961;3857
510250;201407;14152;44636;12250;41945;3688;13454;5957;20945;9645;34399
510260;201407;2580;9946;2328;9392;736;3147;989;4214;1725;7361
510263;201407;4380;12231;3300;10423;961;3327;1127;3416;2088;6743
510267;201407;5425;15795;3929;12549;930;3233;1346;4138;2276;7371
510268;201407;890;2610;760;2424;206;710;401;1281;607;1991
510269;201407;813;2596;737;2480;218;755;349;1219;567;1974
510270;201407;2573;8102;2310;7642;406;1421;1353;4603;1759;6024
510279;201407;2092;6700;1892;6347;653;2434;706;2192;1359;4626
510285;201407;1505;4568;1241;4086;352;1266;462;1431;814;2697
510300;201407;3282;10011;2859;9412;346;1244;2164;7186;2510;8430
510305;201407;1656;5293;1356;4715;413;1556;412;1416;825;2972
510310;201407;1110;3227;880;2849;306;1088;299;922;605;2010
510320;201407;3686;10935;2854;9253;846;3164;594;1706;1440;4870
510325;201407;5470;17659;4769;16656;691;2382;3595;12957;4286;15339
510330;201407;2816;9314;2418;8565;630;2450;985;3556;1615;6006
510335;201407;4547;14415;3984;13653;663;2233;2834;10139;3497;12372
510336;201407;594;1845;498;1655;121;438;244;803;365;1241
510337;201407;2311;7713;1992;7085;816;2903;590;2323;1406;5226
510340;201407;65143;191159;51834;170656;20432;73218;12127;41919;32559;115137
510343;201407;1151;3470;1053;3347;117;358;863;2815;980;3173
510345;201407;1692;5079;1424;4590;373;1326;528;1595;901;2921
510350;201407;3584;10312;2914;9391;790;2743;1440;4731;2230;7474
510360;201407;1934;5046;1368;4341;245;862;913;2835;1158;3697
510370;201407;996;3566;899;3410;235;918;519;2021;754;2939
510380;201407;490;1587;382;1370;153;603;67;222;220;825
510385;201407;969;3597;767;3102;157;678;351;1517;508;2195
510390;201407;1196;3704;1103;3599;280;800;680;2427;960;3227
510395;201407;902;2286;669;1981;119;379;381;1194;500;1573
510410;201407;4255;14067;3976;13536;1095;3937;2085;7194;3180;11131
510420;201407;2377;6241;1789;5250;266;929;969;2814;1235;3743
510450;201407;591;1647;447;1439;120;435;183;569;303;1004
510452;201407;640;2097;459;1663;119;476;170;585;289;1061
510454;201407;869;2772;762;2602;155;552;478;1688;633;2240
510455;201407;1020;3120;772;2623;189;752;272;873;461;1625
510460;201407;2158;6133;1840;5685;328;1168;1201;3606;1529;4774
510480;201407;4370;11916;3247;9774;904;2883;925;2656;1829;5539
510490;201407;1490;4923;1336;4692;295;1196;804;2750;1099;3946
510500;201407;1458;4445;1066;3685;283;1126;470;1561;753;2687
510510;201407;3124;11126;2774;10523;1031;4174;1080;4104;2111;8278
510515;201407;5874;18348;4668;15703;1165;4362;1375;4405;2540;8767
510517;201407;1844;5519;1603;5144;487;1538;836;2841;1323;4379
510520;201407;2276;5776;1715;4998;135;462;1225;3593;1360;4055
510523;201407;1093;3317;936;3048;191;659;558;1832;749;2491
510525;201407;8047;20948;5357;16690;1359;4575;2034;6295;3393;10870
510530;201407;571;1639;494;1521;84;303;281;860;365;1163
510550;201407;2777;9206;2397;8537;704;2600;1057;3859;1761;6459
510558;201407;2159;6272;1723;5618;482;1685;821;2659;1303;4344
510560;201407;1700;5552;1224;4688;408;1682;324;1259;732;2941
510562;201407;5368;16390;4626;14936;1549;5464;1598;5195;3147;10659
510590;201407;3120;8515;2502;7715;693;2204;1223;3889;1916;6093
510600;201407;1500;3911;1003;3094;190;659;447;1252;637;1911
510610;201407;2893;8520;2545;8045;240;863;2020;6390;2260;7253
510615;201407;2311;7428;2031;6973;645;2363;966;3335;1611;5698
510617;201407;629;1903;536;1739;72;227;399;1348;471;1575
510618;201407;1374;4046;997;3296;255;979;440;1414;695;2393
510619;201407;788;2192;510;1667;101;374;140;443;241;817
510620;201407;1375;3590;831;2739;255;970;195;591;450;1561
510621;201407;1068;3770;946;3506;285;1157;312;1088;597;2245
510622;201407;3765;11610;2556;8877;719;2714;421;1254;1140;3968
510623;201407;3829;11066;3157;9917;968;3198;1345;4215;2313;7413
510624;201407;1331;4079;1011;3473;254;992;396;1261;650;2253
510625;201407;2331;6908;1885;6107;581;2073;502;1557;1083;3630
510626;201407;1348;4159;1059;3717;332;1275;523;1852;855;3127
510627;201407;720;2168;562;1874;184;674;175;591;359;1265
510628;201407;1600;4124;1222;3604;142;459;880;2593;1022;3052
510629;201407;1795;5879;1497;5212;468;1799;475;1565;943;3364
510630;201407;2587;8739;2121;7858;663;2750;556;2069;1219;4819
510631;201407;410;1197;368;1131;69;208;247;764;316;972
510637;201407;2836;8469;2519;7926;708;2409;1279;3967;1987;6376
510642;201407;4908;16084;4202;15121;1270;4863;2056;7699;3326;12562
510645;201407;930;2172;631;1772;204;585;228;683;432;1268
510650;201407;6096;20789;5634;20221;1214;4531;3666;13762;4880;18293
510665;201407;1303;3588;886;2820;259;878;293;902;552;1780
510670;201407;374;894;213;657;39;146;91;267;130;413
510675;201407;6788;22008;5595;19635;1851;7195;1480;4994;3331;12189
510677;201407;2570;6556;1914;5694;292;876;1358;4213;1650;5089
510680;201407;851;2655;704;2382;166;617;292;927;458;1544
510682;201407;2465;7706;1967;6800;545;2071;652;2229;1197;4300
510685;201407;996;2699;848;2506;106;354;617;1800;723;2154
510700;201407;4145;11305;3040;9604;680;2297;1702;5466;2382;7763
510704;201407;8783;24582;7248;21989;1807;6095;3716;10977;5523;17072
510706;201407;1929;5936;1463;5191;418;1515;716;2591;1134;4106
510710;201407;3728;10606;2861;8859;844;2828;923;2582;1767;5410
510715;201407;694;1789;468;1416;116;385;185;524;301;909
510718;201407;1792;5336;1541;5018;599;1987;674;2265;1273;4252
510719;201407;464;1067;284;830;38;150;131;350;169;500
510720;201407;1314;3098;984;2710;99;273;771;2168;870;2441
510724;201407;842;2599;709;2345;166;613;376;1193;542;1806
510726;201407;674;1837;549;1622;156;469;202;577;358;1046
510729;201407;776;2056;569;1730;150;494;253;776;403;1270
510730;201407;2415;7607;2128;7064;544;2040;1043;3308;1587;5348
510735;201407;1084;3751;909;3451;258;1018;451;1739;709;2757
510740;201407;1114;2803;853;2423;209;580;478;1407;687;1987
510757;201407;713;2455;632;2299;176;668;316;1152;492;1820
510760;201407;29610;83201;23150;72172;7948;26510;7939;24821;15887;51331
510770;201407;4557;12207;4109;11687;639;1756;2670;8545;3309;10301
510774;201407;441;1210;371;1100;87;299;183;542;270;841
510775;201407;850;2420;679;2151;249;859;255;798;504;1657
510776;201407;460;1316;384;1184;98;343;185;543;283;886
510777;201407;1569;4699;1188;4187;222;890;807;2836;1029;3726
510779;201407;665;1976;495;1665;97;361;210;732;307;1093
510780;201407;4038;11939;3452;11099;796;2644;1879;6308;2675;8952
510785;201407;1982;5885;1596;5227;532;1832;600;2001;1132;3833
510787;201407;2289;7040;1966;6497;675;2400;745;2385;1420;4785
510788;201407;413;1215;341;1095;156;479;109;381;265;860
510790;201407;15857;46607;10825;36918;3211;12513;1501;4991;4712;17504
510792;201407;6230;19871;4510;16334;1160;4830;980;3290;2140;8120
510794;201407;1387;4317;1103;3862;492;1841;270;871;762;2712
510795;201407;9766;31172;7561;26733;2473;9454;2033;7277;4506;16731
510800;201407;1866;5394;1578;5020;486;1706;757;2305;1243;4011
510805;201407;1993;5605;1649;5114;201;663;1232;3851;1433;4514
510810;201407;710;1736;556;1527;156;454;281;751;437;1205
510820;201407;863;2105;630;1758;149;491;263;675;412;1166
510830;201407;596;2037;523;1915;159;621;267;1036;426;1657
510835;201407;715;2195;539;1851;180;674;187;581;367;1255
510840;201407;52677;132989;42470;120031;10385;30711;22872;67001;33257;97712
510850;201407;1724;5085;1351;4474;541;2003;259;711;800;2714
510860;201407;2530;8459;2028;7373;721;2864;334;1142;1055;4006
510880;201407;843;2849;734;2650;244;929;310;1148;554;2077
510885;201407;580;1662;448;1467;82;309;212;686;294;995
510890;201407;925;3077;789;2828;273;1111;225;715;498;1826
510895;201407;1198;3823;1043;3522;302;1165;431;1360;733;2525
520005;201407;1290;4228;1200;4090;373;1328;603;2087;976;3415
520010;201407;1903;6605;1684;6144;711;2871;376;1247;1087;4118
520013;201407;4033;11288;3061;9547;769;2533;1372;4323;2141;6856
520015;201407;572;1597;463;1433;115;376;197;625;312;1001
520017;201407;1277;3971;1106;3686;320;1147;456;1474;776;2621
520020;201407;426;1159;331;1006;89;278;154;489;243;767
520025;201407;24334;78422;23591;77537;2902;9996;19241;63596;22143;73592
520030;201407;4808;15467;4216;14509;1251;4608;1854;6482;3105;11090
520050;201407;348;1054;319;992;61;210;215;650;276;860
520055;201407;733;2229;623;2034;146;467;331;1126;477;1593
520060;201407;1677;5250;1478;4861;364;1310;610;2048;974;3358
520080;201407;1690;5200;1473;4878;379;1249;790;2738;1169;3987
520082;201407;685;2217;638;2137;146;464;390;1353;536;1817
520085;201407;1043;3289;916;3006;231;794;335;1100;566;1894
520090;201407;1019;2425;777;2103;165;394;424;1232;589;1626
520110;201407;42281;126841;33245;113164;13218;49559;8880;30701;22098;80260
520120;201407;264;700;156;507;40;148;38;128;78;276
520130;201407;3852;11321;3554;10872;722;2353;2255;6904;2977;9257
520140;201407;44353;147669;39584;138323;14510;54716;11146;38695;25656;93411
520145;201407;550;1424;407;1217;98;316;169;498;267;814
520150;201407;671;1804;554;1669;154;504;290;863;444;1367
520160;201407;915;2698;776;2488;261;883;300;975;561;1858
520170;201407;4277;10261;3432;9345;516;1460;2555;7142;3071;8602
520180;201407;1930;5826;1618;5312;421;1576;680;2157;1101;3733
520215;201407;1901;4940;1618;4537;265;770;1020;2902;1285;3672
520235;201407;840;2283;656;2019;198;664;281;844;479;1508
520250;201407;1167;3811;1038;3612;316;1177;519;1830;835;3007
520260;201407;789;2076;561;1652;91;310;275;773;366;1083
520280;201407;584;1713;536;1642;264;864;137;461;401;1325
520310;201407;1109;2769;865;2435;208;548;455;1423;663;1971
520320;201407;1718;5485;1406;4863;180;665;882;3137;1062;3802
520330;201407;2896;9084;2236;7909;713;2754;474;1585;1187;4339
520340;201407;1982;5029;1561;4528;205;520;1195;3629;1400;4149
520350;201407;3240;9638;2758;8714;894;3069;1255;3847;2149;6916
520355;201407;1208;4161;1128;4033;406;1548;489;1734;895;3282
520357;201407;910;2498;768;2284;82;270;536;1582;618;1852
520360;201407;622;1755;550;1633;129;388;269;825;398;1213
520380;201407;1250;3448;885;2759;184;630;414;1290;598;1920
520390;201407;1219;3256;862;2766;285;1054;331;969;616;2023
520393;201407;582;1547;518;1445;87;252;344;965;431;1217
520396;201407;749;2414;661;2238;99;373;448;1539;547;1912
520400;201407;1740;4964;1486;4625;274;931;943;2934;1217;3865
520410;201407;1577;4234;1246;3784;346;1135;636;1927;982;3062
520420;201407;349;976;254;793;62;204;86;244;148;448
520425;201407;1489;4152;1360;3933;417;1282;676;1923;1093;3205
520430;201407;2150;5726;1490;4496;327;1097;616;1787;943;2884
520440;201407;3605;9602;2636;7995;935;3105;760;2284;1695;5389
520450;201407;10101;29119;7570;24325;2148;7570;1360;4046;3508;11616
520455;201407;707;2134;578;1916;217;776;178;596;395;1372
520460;201407;906;2620;731;2322;184;658;324;988;508;1646
520465;201407;860;2349;748;2205;177;622;380;1060;557;1682
520470;201407;1747;5730;1590;5491;326;1125;1063;3831;1389;4956
520480;201407;1028;3000;846;2713;193;653;480;1542;673;2195
520485;201407;1255;4216;1138;4007;391;1444;572;2044;963;3488
520490;201407;4466;13824;3554;12416;1269;4727;1412;5026;2681;9753
520495;201407;1430;3863;1163;3536;96;302;989;3043;1085;3345
520500;201407;2078;5571;1850;5259;595;1775;834;2543;1429;4318
520505;201407;904;2587;784;2408;191;608;472;1484;663;2092
520510;201407;11461;32475;7818;26319;2521;9217;2049;7001;4570;16218
520520;201407;1085;3147;911;2907;328;1107;375;1212;703;2319
520530;201407;2400;7472;2056;6908;505;1664;1014;3765;1519;5429
520540;201407;3042;9312;2618;8579;823;2833;1055;3486;1878;6319
520545;201407;1342;4163;1148;3775;343;1211;366;1171;709;2382
520547;201407;846;2692;705;2446;278;1037;213;693;491;1730
520549;201407;9374;28170;7904;26320;2520;8796;3776;12806;6296;21602
520551;201407;3870;11751;3697;11541;1047;3442;2172;6963;3219;10405
520552;201407;730;2408;704;2369;125;462;481;1612;606;2074
520570;201407;590;1711;447;1483;199;704;117;389;316;1093
520580;201407;2150;6168;1754;5598;649;2265;630;1964;1279;4229
520590;201407;1556;4399;1272;3928;340;1102;451;1342;791;2444
520620;201407;7410;23953;6758;22983;1478;5415;4180;14339;5658;19754
520630;201407;670;1911;572;1781;138;432;319;1002;457;1434
520640;201407;2881;8366;2492;7735;797;2582;1070;3448;1867;6030
520650;201407;863;2452;729;2204;256;815;308;938;564;1753
520660;201407;407;1239;345;1140;115;401;112;365;227;766
520670;201407;821;2566;783;2505;65;175;675;2206;740;2381
520680;201407;636;1879;546;1755;177;612;229;736;406;1348
520690;201407;321;849;234;732;31;97;122;402;153;499
520710;201407;506;1301;329;960;10;35;203;588;213;623
520725;201407;1846;4812;1439;4219;338;1080;803;2352;1141;3432
520735;201407;715;2137;569;1860;188;660;182;576;370;1236
520740;201407;1739;5076;1464;4693;385;1313;720;2291;1105;3604
520750;201407;772;2044;580;1778;148;487;317;1004;465;1491
520753;201407;1312;3778;1231;3653;168;450;912;2859;1080;3309
520760;201407;1186;3298;1028;3093;289;925;598;1809;887;2734
520780;201407;2107;5204;1757;4730;232;561;1329;3686;1561;4247
520790;201407;2680;7432;2319;6933;337;999;1663;5126;2000;6125
520800;201407;17841;52647;15885;50318;3703;11430;9668;33057;13371;44487
520810;201407;969;2657;864;2526;142;419;644;1953;786;2372
520815;201407;498;1682;387;1446;190;807;29;90;219;897
520830;201407;1713;4378;1342;3990;55;127;1222;3722;1277;3849
520840;201407;1704;5776;1543;5468;527;1948;575;2112;1102;4060
520850;201407;814;2399;637;2137;190;680;280;920;470;1600
520860;201407;7157;20492;5360;18041;1476;5390;2530;8740;4006;14130
520870;201407;110011;302151;74820;239473;22039;77375;20205;62563;42244;139938
520880;201407;6899;19659;4900;16477;1444;5494;762;2438;2206;7932
520890;201407;4000;11617;3431;10655;759;2489;1794;5594;2553;8083
520910;201407;3506;10738;2719;9110;850;3085;661;2153;1511;5238
520915;201407;934;2699;708;2264;166;571;296;915;462;1486
520920;201407;3456;9223;2393;7516;639;2136;716;2342;1355;4478
520929;201407;474;1367;418;1299;127;395;219;692;346;1087
520940;201407;1012;3063;895;2880;113;414;655;2078;768;2492
520945;201407;699;1726;577;1533;189;469;268;734;457;1203
520960;201407;909;2661;745;2403;131;435;432;1421;563;1856
520970;201407;3454;10244;2842;9133;701;2473;1109;3497;1810;5970
520980;201407;1010;2784;928;2673;263;843;547;1530;810;2373
520990;201407;3709;11581;3381;10986;744;2549;1792;6367;2536;8916
520993;201407;1215;3330;982;2943;131;434;633;1889;764;2323
520995;201407;2656;7323;2384;6962;366;1076;1736;5127;2102;6203
521000;201407;7994;24233;6838;22274;1725;6198;3211;10370;4936;16568
521010;201407;4024;12518;3416;11360;940;3328;1385;4675;2325;8003
521015;201407;712;1992;599;1811;132;397;339;1052;471;1449
521020;201407;3717;10802;2725;8677;866;2998;523;1443;1389;4441
521030;201407;808;2152;699;1997;148;443;439;1272;587;1715
521040;201407;5591;16505;5112;15760;1785;5522;2600;8415;4385;13937
521056;201407;992;3065;843;2814;293;1024;354;1229;647;2253
521060;201407;1131;3194;995;2985;274;770;426;1329;700;2099
521080;201407;1249;3099;814;2370;174;594;296;717;470;1311
521090;201407;3310;9675;2803;8987;982;3330;1096;3617;2078;6947
521100;201407;1460;3792;1319;3633;244;645;928;2651;1172;3296
521120;201407;4981;14248;4435;13391;1194;3647;2305;7147;3499;10794
521130;201407;1140;3223;910;2792;194;687;479;1457;673;2144
521140;201407;968;3208;861;2980;295;1089;230;785;525;1874
521150;201407;13085;34366;8490;25373;2921;9483;2562;7542;5483;17025
521160;201407;786;2017;524;1486;96;299;279;751;375;1050
521170;201407;1394;3376;1157;3055;317;782;664;1792;981;2574
521180;201407;6641;22316;6030;21159;2214;8248;1857;6520;4071;14768
521190;201407;9357;27798;6838;23281;2258;8180;2112;7185;4370;15365
521200;201407;870;2300;795;2191;122;359;546;1503;668;1862
521205;201407;570;1729;461;1527;64;233;264;886;328;1119
521210;201407;913;2640;655;2128;255;932;230;668;485;1600
521220;201407;3920;11110;3259;10197;1052;3528;1352;4208;2404;7736
521225;201407;395;1014;315;913;48;146;212;631;260;777
521230;201407;1374;4358;1264;4124;456;1570;593;1889;1049;3459
521250;201407;26782;89158;25211;86751;9898;36048;10272;36097;20170;72145
521260;201407;827;2030;660;1739;114;378;384;945;498;1323
521270;201407;1856;5806;1703;5561;177;468;1316;4529;1493;4997
521280;201407;1865;5784;1576;5253;498;1773;606;2017;1104;3790
521290;201407;543;1574;399;1334;124;486;144;454;268;940
521295;201407;1151;3161;1046;3020;144;417;840;2452;984;2869
521300;201407;1882;5522;1741;5299;393;1163;1086;3445;1479;4608
521305;201407;868;2330;723;2127;150;422;452;1391;602;1813
521308;201407;5220;15488;4094;13497;896;3206;2093;6819;2989;10025
521310;201407;7663;23466;6093;20419;2042;7247;1584;5128;3626;12375
521340;201407;268;815;241;773;46;164;142;443;188;607
521350;201407;2197;5712;1811;5193;245;721;1211;3696;1456;4417
521370;201407;1024;3299;927;3118;327;1182;316;1006;643;2188
521375;201407;1414;4143;1213;3784;317;1083;614;1863;931;2946
521377;201407;1084;3035;1037;2979;102;244;888;2629;990;2873
521380;201407;4815;13669;3544;11349;819;2841;744;2454;1563;5295
521385;201407;623;1737;550;1638;167;525;268;792;435;1317
521390;201407;1123;2947;829;2534;250;858;288;858;538;1716
521400;201407;2376;6483;2042;6094;334;1096;1511;4484;1845;5580
521405;201407;1410;4080;1150;3599;401;1368;478;1488;879;2856
521410;201407;786;2512;720;2399;278;914;308;1071;586;1985
521440;201407;1496;4176;1479;4157;124;312;1295;3738;1419;4050
521450;201407;5134;15648;4291;14097;1363;4759;1249;4029;2612;8788
521460;201407;7313;22595;6714;21658;1762;6149;3557;11371;5319;17520
521470;201407;746;2116;560;1757;159;561;103;311;262;872
521480;201407;519;1516;383;1268;118;396;124;407;242;803
521483;201407;3174;8446;2571;7405;760;2302;1028;2896;1788;5198
521486;201407;1716;4751;1541;4446;300;944;1062;3017;1362;3961
521487;201407;644;1681;458;1384;86;245;217;704;303;949
521490;201407;853;2450;678;2196;86;333;487;1579;573;1912
521500;201407;1356;4349;1147;3910;224;869;559;1771;783;2640
521520;201407;958;2247;824;2070;273;608;372;1045;645;1653
521523;201407;11560;43273;10812;41924;3735;15670;2389;9961;6124;25631
521525;201407;1129;2951;993;2770;147;467;681;1847;828;2314
521530;201407;2079;6223;1416;4861;531;1924;289;941;820;2865
521540;201407;989;2704;679;2152;183;688;209;610;392;1298
521550;201407;997;2558;885;2393;254;748;461;1194;715;1942
521560;201407;4998;15392;4034;14103;1617;6090;1271;4435;2888;10525
521565;201407;713;1856;608;1724;107;282;417;1225;524;1507
521570;201407;4747;13384;3404;10697;1080;3549;1133;3610;2213;7159
521580;201407;679;1654;494;1397;174;540;163;458;337;998
521590;201407;756;2129;617;1896;226;717;128;416;354;1133
521600;201407;628;1640;448;1333;113;360;158;421;271;781
521630;201407;1803;4880;1501;4409;551;1851;277;665;828;2516
521640;201407;2035;5618;1679;5092;563;1923;591;1826;1154;3749
521645;201407;663;1998;550;1737;108;371;274;814;382;1185
521680;201407;1487;4757;1263;4281;675;2416;220;712;895;3128
521690;201407;598;1771;536;1654;129;465;265;760;394;1225
521710;201407;2354;7389;2053;6778;448;1562;1094;3615;1542;5177
521720;201407;2133;6270;1926;5988;513;1589;1185;3766;1698;5355
521730;201407;3982;13315;3651;12647;1573;5971;1026;3307;2599;9278
521740;201407;3757;10273;2978;9278;1276;4140;1170;3838;2446;7978
521760;201407;12509;42758;11636;41342;2234;8838;7372;26364;9606;35202
521770;201407;2823;8589;2399;7746;1024;3514;677;2083;1701;5597
521800;201407;8961;26290;7562;24149;2531;8539;3297;10903;5828;19442
521805;201407;995;2298;777;1971;216;483;426;1208;642;1691
521810;201407;823;2397;712;2219;176;610;371;1123;547;1733
521830;201407;5494;18560;5143;18023;1080;4080;3349;11737;4429;15817
521839;201407;727;2089;567;1780;130;465;209;620;339;1085
521850;201407;7071;20015;5982;18091;1445;4412;2901;8809;4346;13221
521860;201407;1805;5434;1557;4962;418;1451;576;1777;994;3228
521870;201407;563;1977;516;1852;171;669;144;486;315;1155
521878;201407;649;2070;515;1766;150;578;208;673;358;1251
521880;201407;26397;69918;18029;56080;6053;19963;5632;17870;11685;37833
521890;201407;3775;11689;3124;10407;1184;4242;816;2683;2000;6925
521900;201407;1676;4505;1370;4086;361;1150;561;1591;922;2741
521910;201407;1231;3425;1075;3244;268;853;614;1921;882;2774
521920;201407;407;1231;363;1160;122;417;154;472;276;889
521925;201407;651;2008;579;1861;120;427;247;735;367;1162
521930;201407;4015;12984;3606;12200;1259;4524;1075;3651;2334;8175
521935;201407;658;1983;624;1918;173;557;346;1041;519;1598
521940;201407;1147;3124;933;2761;317;969;348;1035;665;2004
521945;201407;693;2368;646;2305;130;419;452;1734;582;2153
521950;201407;577;1722;479;1559;129;454;210;693;339;1147
521960;201407;942;2771;799;2525;199;682;373;1145;572;1827
521970;201407;2510;7195;2282;6902;342;1018;1666;5191;2008;6209
521971;201407;1087;2938;822;2445;176;559;304;868;480;1427
521973;201407;913;3001;803;2773;249;917;253;838;502;1755
521975;201407;14160;40026;13336;38991;2443;7580;9077;26733;11520;34313
521980;201407;1858;5748;1751;5622;275;805;1363;4574;1638;5379
521990;201407;1144;3448;1001;3222;160;569;647;2076;807;2645
522000;201407;2180;6406;1910;6051;403;1352;1141;3730;1544;5082
522005;201407;381;991;290;846;79;236;141;413;220;649
522010;201407;3106;9220;2615;8405;965;3260;681;2152;1646;5412
522015;201407;1032;3034;857;2767;220;755;428;1410;648;2165
522020;201407;5008;13619;4308;12675;931;2954;2696;7882;3627;10836
522026;201407;676;1923;489;1726;192;747;171;619;363;1366
522028;201407;541;1618;488;1536;114;376;306;955;420;1331
522040;201407;3168;8174;2390;7184;771;2397;1114;3425;1885;5822
522045;201407;13775;45162;11635;40759;3874;14913;2710;9236;6584;24149
522050;201407;1086;3137;870;2772;278;969;351;1046;629;2015
522060;201407;2750;8478;2212;7630;617;2319;1099;3738;1716;6057
522068;201407;1594;5164;1489;5047;129;345;1243;4454;1372;4799
522070;201407;853;2559;763;2418;103;402;518;1627;621;2029
522100;201407;807;2272;720;2140;265;880;333;922;598;1802
522108;201407;953;2834;836;2660;90;296;619;2022;709;2318
522119;201407;1348;4102;1116;3787;182;616;724;2549;906;3165
522130;201407;511;1460;441;1381;132;425;235;755;367;1180
522140;201407;18076;51550;15793;48063;4956;16185;6602;19703;11558;35888
522145;201407;953;2686;884;2575;426;1311;285;817;711;2128
522150;201407;1267;3334;1052;3038;397;1218;375;1120;772;2338
522155;201407;853;2463;753;2315;168;510;469;1505;637;2015
522157;201407;706;2059;609;1905;72;245;473;1485;545;1730
522160;201407;6208;17618;4439;14537;1696;6166;704;2163;2400;8329
522170;201407;3180;8874;2641;8069;799;2454;1087;3463;1886;5917
522180;201407;475;1352;355;1167;149;529;121;409;270;938
522185;201407;15282;47191;13783;45145;3071;10752;8134;27020;11205;37772
522190;201407;974;2554;799;2261;140;398;457;1320;597;1718
522200;201407;1640;5467;1492;5161;524;1957;466;1556;990;3513
522205;201407;1328;3890;1106;3515;300;1010;526;1681;826;2691
522220;201407;1416;3891;1139;3543;280;896;570;1960;850;2856
522230;201407;1204;3622;1078;3419;160;569;733;2325;893;2894
530010;201407;258224;839324;232166;787951;72511;268563;83834;283966;156345;552529
110001;201406;4584;15000;3969;14008;1044;3790;2260;8131;3304;11921
110002;201406;13765;43801;11903;40495;3707;13583;5205;17758;8912;31341
110003;201406;987;3212;905;3063;256;895;344;1148;600;2043
110004;201406;10021;32660;8479;29427;2831;10576;2559;8892;5390;19468
110005;201406;2404;8040;2247;7736;856;3037;933;3249;1789;6286
110006;201406;3434;9241;2159;7448;727;2651;679;2219;1406;4870
110007;201406;1568;4881;1457;4721;297;1023;831;2934;1128;3957
110008;201406;2593;8873;2434;8639;464;1553;1778;6596;2242;8149
110009;201406;5444;15774;4216;13941;1135;4079;1937;6283;3072;10362
110010;201406;8573;24722;7523;23399;1550;4460;4784;16088;6334;20548
110011;201406;11056;33998;9151;30695;3310;11640;3559;11987;6869;23627
110012;201406;17275;53369;14959;48925;5030;17228;5742;18801;10772;36029
110013;201406;5531;17419;4517;15878;1423;5205;2051;7389;3474;12594
110014;201406;4508;13312;3790;12265;824;2768;2280;7523;3104;10291
110015;201406;5474;17321;4369;15334;1536;5841;1539;5401;3075;11242
110018;201406;5315;15587;4317;14284;1359;5027;1979;6313;3338;11340
110020;201406;58934;171407;48764;158621;10667;35870;29312;98240;39979;134110
110025;201406;4648;13529;3867;12139;650;2167;2693;8436;3343;10603
110026;201406;857;2451;719;2287;173;556;471;1538;644;2094
110028;201406;7975;23404;5933;19924;1844;6788;1527;5040;3371;11828
110029;201406;1729;5074;1385;4486;436;1459;629;2081;1065;3540
110030;201406;11659;33715;9601;31080;2472;8492;5339;17936;7811;26428
110032;201406;4294;13916;3823;12877;1185;4129;1550;5236;2735;9365
110033;201406;5648;18193;5254;17575;1586;5203;2726;9740;4312;14943
110034;201406;3948;10318;3296;9522;548;1502;2483;7313;3031;8815
110037;201406;2140;7221;1848;6672;469;1721;1036;3793;1505;5514
110040;201406;3610;11726;3335;11235;1008;3650;1623;5423;2631;9073
110045;201406;5366;18229;4886;17658;1410;5405;2853;10324;4263;15729
110050;201406;1847;5894;1542;5487;483;1737;865;3159;1348;4896
110060;201406;1009;3488;898;3285;261;1025;466;1706;727;2731
110070;201406;2033;6955;1971;6817;332;1166;1413;4949;1745;6115
110080;201406;3699;11718;3523;11507;411;1229;2956;9890;3367;11119
110090;201406;967;2831;769;2516;234;887;341;1011;575;1898
110092;201406;1743;5643;1590;5445;346;1184;975;3513;1321;4697
110094;201406;3371;10496;3083;10087;731;2467;1934;6463;2665;8930
110100;201406;2702;8526;2327;7897;696;2486;1200;4087;1896;6573
110110;201406;1822;5823;1693;5667;700;2372;764;2658;1464;5030
110120;201406;1726;5700;1382;4905;455;1669;429;1542;884;3211
110130;201406;2831;8108;2136;7082;559;1928;1070;3589;1629;5517
110140;201406;2635;9004;2429;8653;542;1976;1517;5518;2059;7494
110143;201406;1591;5100;1241;4489;310;1172;659;2373;969;3545
110145;201406;1012;3077;891;2888;159;549;594;1939;753;2488
110146;201406;480;1527;439;1463;98;341;258;872;356;1213
110147;201406;912;2708;720;2391;203;736;272;821;475;1557
110148;201406;1395;4160;1080;3519;349;1220;378;1196;727;2416
110149;201406;3851;11237;3012;9967;773;2614;1797;6100;2570;8714
110150;201406;2946;8597;2423;7834;304;1068;1655;5454;1959;6522
110155;201406;967;3181;906;3040;282;997;470;1560;752;2557
110160;201406;2232;7011;1825;6280;565;2001;895;3100;1460;5101
110170;201406;3249;9343;2501;8042;541;1821;1510;4875;2051;6696
110175;201406;1746;5506;1348;4992;167;666;951;3585;1118;4251
110180;201406;1711;5296;1452;4881;324;1127;899;3059;1223;4186
120001;201406;2952;10439;2846;10261;637;2440;1772;6478;2409;8918
120005;201406;1597;6337;1555;6258;165;614;1239;5179;1404;5793
120010;201406;4560;16174;4365;15835;861;3018;2978;11216;3839;14234
120013;201406;1912;7464;1862;7381;412;1617;1206;5023;1618;6640
120017;201406;2168;7718;2046;7491;561;2049;1018;4080;1579;6129
120020;201406;14633;64003;14319;63348;2322;9712;10540;48802;12862;58514
120025;201406;2820;9784;2741;9661;613;2277;1717;6146;2330;8423
120030;201406;6239;24726;6136;24597;467;1743;5330;21803;5797;23546
120032;201406;1405;6733;1352;6602;188;1053;986;4869;1174;5922
120033;201406;3684;14105;3656;14054;198;769;3297;12844;3495;13613
120034;201406;1881;7638;1843;7580;119;579;1647;6744;1766;7323
120035;201406;2816;13504;2783;13426;249;1153;2343;11650;2592;12803
120038;201406;3230;11809;3104;11545;826;3134;1764;6749;2590;9883
120039;201406;1555;8166;1524;8088;185;1008;1224;6594;1409;7602
120040;201406;46924;168855;42996;160852;12366;48554;21249;81539;33615;130093
120042;201406;2855;12379;2718;12048;375;1764;1994;9011;2369;10775
120043;201406;864;4140;838;4085;62;263;716;3606;778;3869
120045;201406;4535;15734;4480;15648;921;3212;3274;11670;4195;14882
120050;201406;8272;34038;7955;33344;1341;5365;5458;24183;6799;29548
120060;201406;7339;33371;7220;33143;688;3177;6027;28350;6715;31527
120070;201406;2870;10802;2798;10629;541;1951;1887;7474;2428;9425
120080;201406;3799;14327;3637;14059;577;2194;2708;10837;3285;13031
130002;201406;2881;12229;2718;11952;262;1198;2194;9832;2456;11030
130006;201406;1747;7541;1570;7210;237;1184;1100;5140;1337;6324
130008;201406;2033;8290;1942;8126;177;770;1574;6713;1751;7483
130010;201406;2750;9272;2398;8861;208;717;2046;7739;2254;8456
130014;201406;3516;11325;3039;10607;493;1838;2019;7161;2512;8999
130020;201406;2548;9050;2537;9037;34;125;2490;8883;2524;9008
130030;201406;7065;27665;6845;27369;579;1986;5874;24216;6453;26202
130040;201406;3611;11338;3315;10935;270;1000;2842;9380;3112;10380
130050;201406;5945;23829;5277;22779;722;2945;3805;17542;4527;20487
130060;201406;5927;26262;5580;25751;589;2707;4540;21440;5129;24147
130063;201406;3352;14918;3323;14860;306;1283;2843;13045;3149;14328
130068;201406;3037;12889;2803;12435;364;1791;1976;8867;2340;10658
130070;201406;6716;22322;6112;21543;639;2236;4865;17610;5504;19846
130080;201406;5111;22734;4911;22443;850;3956;3450;16346;4300;20302
130083;201406;2078;8281;1963;8102;308;1444;1412;5825;1720;7269
130090;201406;2548;9192;2429;9032;181;756;2099;7832;2280;8588
130100;201406;5493;20893;5282;20605;395;1667;4549;17926;4944;19593
130110;201406;6849;22012;6396;21472;641;1976;5309;18390;5950;20366
130115;201406;4012;14547;3846;14328;98;309;3668;13773;3766;14082
130120;201406;13650;52284;13190;51650;1160;4108;11194;45258;12354;49366
130130;201406;3572;15071;3467;14881;394;1728;2789;12197;3183;13925
130140;201406;6118;24066;6075;24010;166;445;5862;23466;6028;23911
130150;201406;3512;13261;3437;13166;225;990;3040;11655;3265;12645
130160;201406;3927;16293;3850;16189;236;900;3507;14947;3743;15847
130165;201406;2810;11553;2721;11403;389;1681;2139;9093;2528;10774
130170;201406;9027;32938;7939;31562;1209;4847;5838;24084;7047;28931
130180;201406;3391;10915;3314;10808;109;348;3075;10077;3184;10425
130185;201406;9769;33454;9149;32729;1191;3910;7282;27198;8473;31108
130190;201406;17826;61712;15735;59057;3106;11372;10381;41104;13487;52476
130195;201406;1834;7693;1776;7603;114;474;1563;6808;1677;7282
130200;201406;1977;7178;1835;6939;417;1617;1150;4460;1567;6077
130210;201406;1177;4681;1118;4570;138;565;879;3686;1017;4251
130220;201406;2028;8365;1870;8076;355;1689;1126;4951;1481;6640
130230;201406;3378;15417;3196;15112;365;1731;2419;11964;2784;13695
130240;201406;8430;32383;7780;31421;501;2242;6655;27321;7156;29563
130250;201406;18082;65089;17338;64066;2391;8189;13399;51728;15790;59917
130255;201406;4044;14404;3828;14045;153;473;3473;13034;3626;13507
130260;201406;257220;836318;232452;796536;64754;227943;122131;431817;186885;659760
130270;201406;7365;30580;6645;29441;1006;4448;4865;22470;5871;26918
130280;201406;3273;12848;3202;12744;159;478;2902;11882;3061;12360
130290;201406;10651;37670;10483;37429;226;540;9977;36237;10203;36777
130300;201406;4489;17307;4205;16880;394;1731;3408;13831;3802;15562
130310;201406;5072;19109;4649;18582;491;1912;3743;15380;4234;17292
130320;201406;2942;10182;2686;9839;370;1378;1945;7328;2315;8706
130330;201406;3653;13355;3277;12844;220;957;2781;11063;3001;12020
130340;201406;17766;68560;17179;67635;3416;12581;11544;48543;14960;61124
130350;201406;3296;13350;3161;13189;309;1329;2608;11116;2917;12445
130353;201406;6019;18573;5254;17542;1275;4179;3175;11333;4450;15512
130356;201406;4584;16467;4406;16199;468;1421;3630;14028;4098;15449
130360;201406;2955;8139;2630;7770;49;92;2484;7524;2533;7616
130370;201406;5038;19818;4330;18864;262;1333;3651;16092;3913;17425
130380;201406;6769;28775;6539;28417;486;2252;5580;24539;6066;26791
130390;201406;4719;21173;4420;20645;490;2384;3399;16324;3889;18708
130395;201406;2065;7471;1869;7099;285;1136;1231;4716;1516;5852
130400;201406;2120;7870;2049;7768;172;699;1773;6782;1945;7481
130406;201406;9815;37435;8771;35828;1962;7928;5425;23299;7387;31227
130410;201406;4109;15729;3787;15138;930;3877;2134;8841;3064;12718
130420;201406;10071;42787;9708;42120;2779;11768;5740;26220;8519;37988
130423;201406;3184;12454;3012;12213;271;1256;2530;10311;2801;11567
130426;201406;2078;8958;1999;8817;352;1506;1411;6527;1763;8033
130430;201406;3516;12623;3327;12359;469;1831;2383;9080;2852;10911
130440;201406;4035;14105;3743;13785;201;607;3388;12835;3589;13442
140002;201406;1611;5162;1507;5022;171;562;1137;3895;1308;4457
140005;201406;2675;8178;2514;8004;124;328;2311;7482;2435;7810
140010;201406;44819;145305;40425;138077;9510;34525;22590;78809;32100;113334
140015;201406;2841;9334;2724;9178;315;814;2212;7838;2527;8652
140017;201406;3080;9655;2881;9407;234;661;2411;8129;2645;8790
140020;201406;4471;15271;4172;14871;408;1324;3408;12552;3816;13876
140023;201406;2082;7145;1891;6839;258;956;1367;5046;1625;6002
140028;201406;2175;6058;2118;5991;83;149;1962;5702;2045;5851
140030;201406;3611;11544;3454;11347;384;965;2928;10029;3312;10994
140040;201406;1481;7134;1432;6993;142;758;1072;5358;1214;6116
140045;201406;2481;9007;2315;8765;409;1371;1619;6604;2028;7975
140047;201406;5496;15377;4995;14707;1526;4568;2473;7736;3999;12304
140050;201406;1522;4697;1394;4521;188;641;1001;3300;1189;3941
140060;201406;1451;4573;1313;4364;277;944;851;2910;1128;3854
140070;201406;1455;7219;1443;7183;56;273;1344;6741;1400;7014
150010;201406;33597;107583;32052;105510;2278;7770;27228;90919;29506;98689
150013;201406;1626;4983;1542;4884;148;473;1266;4044;1414;4517
150020;201406;12030;40654;11724;40215;1148;3854;9888;34477;11036;38331
150030;201406;6288;27589;6128;27323;576;2219;5172;23959;5748;26178
150034;201406;4490;12258;4236;11949;222;535;3866;11070;4088;11605
150040;201406;12596;42933;11073;41046;2304;7835;7449;29752;9753;37587
150050;201406;6076;23320;5928;23051;608;2493;4820;18976;5428;21469
150060;201406;16252;53589;15358;52233;3324;10940;10134;35792;13458;46732
150070;201406;5722;23766;5161;23129;437;2047;4430;20132;4867;22179
150080;201406;62496;170991;55173;161567;7830;21377;39849;120748;47679;142125
150085;201406;5044;17912;4814;17576;555;1739;3919;14913;4474;16652
150090;201406;10054;39000;9500;38231;1017;3996;7675;31623;8692;35619
150095;201406;5187;17918;4810;17340;447;1544;3912;14513;4359;16057
150100;201406;3562;13289;3338;12946;274;1268;2715;10478;2989;11746
150110;201406;3224;15526;3212;15495;181;782;2945;14413;3126;15195
150120;201406;6001;23513;5875;23276;834;3222;4569;18438;5403;21660
150125;201406;806;2508;747;2419;151;518;490;1582;641;2100
150130;201406;20892;65691;19741;64032;1818;5828;15953;52762;17771;58590
150140;201406;152866;455444;147341;448552;16935;50607;121055;374059;137990;424666
150145;201406;4888;15428;4535;14986;634;2180;3432;11497;4066;13677
150150;201406;10024;32921;9425;31960;1815;6355;6345;21842;8160;28197
150157;201406;2940;9239;2650;8823;377;1340;2024;6768;2401;8108
150160;201406;2934;9779;2765;9537;657;2209;1738;6255;2395;8464
150170;201406;21992;81897;20854;80325;3905;14953;14914;58418;18819;73371
150172;201406;3093;10781;2786;10311;363;1379;2152;8113;2515;9492
150175;201406;2049;6344;1973;6256;155;411;1728;5656;1883;6067
150178;201406;10891;33757;9294;31854;697;2186;8014;28144;8711;30330
150180;201406;17983;72894;17390;72052;1560;6832;14511;60974;16071;67806
150190;201406;7207;23238;6777;22636;437;1005;5845;20389;6282;21394
150195;201406;4760;16627;4449;16097;400;1474;3672;13461;4072;14935
150200;201406;5125;16675;4964;16477;147;456;4633;15568;4780;16024
150210;201406;22591;87218;22182;86614;2057;7525;18769;75099;20826;82624
150215;201406;6189;20125;5588;19203;1462;5242;2967;10417;4429;15659
150220;201406;12653;40549;11503;38749;2619;9041;6574;22708;9193;31749
150230;201406;11085;38005;10031;36500;865;3733;8067;29281;8932;33014
150240;201406;34546;105672;31249;100128;9706;32068;13633;45376;23339;77444
150250;201406;4082;16475;3952;16281;568;2291;3009;12875;3577;15166
150260;201406;2083;8408;1995;8234;416;1770;1236;5253;1652;7023
150270;201406;9647;29366;7497;26674;1513;5714;4865;17651;6378;23365
150275;201406;5831;21461;5520;20951;806;3097;4082;15823;4888;18920
150276;201406;2134;6452;1970;6230;346;1168;1479;4687;1825;5855
150277;201406;4959;15613;4353;14866;545;1821;3325;11738;3870;13559
150280;201406;5893;25894;5714;25481;916;4004;4185;19254;5101;23258
150285;201406;2605;10577;2560;10479;344;1415;1932;8135;2276;9550
150290;201406;9146;28195;8894;27894;837;2209;7505;24498;8342;26707
150293;201406;8827;26737;7401;24629;2370;8146;3267;11503;5637;19649
150295;201406;6827;21327;5839;20143;1213;3974;3879;14281;5092;18255
150300;201406;1777;6313;1731;6255;125;402;1457;5453;1582;5855
150304;201406;4189;13113;3622;12331;522;1799;2624;9203;3146;11002
150307;201406;6583;22535;6123;21872;469;1722;5079;18540;5548;20262
150309;201406;6835;24164;6321;23470;1561;5751;4064;15861;5625;21612
150310;201406;5124;23806;5018;23643;576;2649;4051;19610;4627;22259
150320;201406;8795;22915;8419;22512;564;1318;7429;20320;7993;21638
150330;201406;13249;48098;12585;47037;1474;5387;9937;38098;11411;43485
150340;201406;2314;7771;2167;7555;380;1368;1510;5372;1890;6740
150345;201406;6457;22625;6035;22050;628;2292;4949;18501;5577;20793
150350;201406;7260;24361;6915;23875;892;3007;5307;18677;6199;21684
150360;201406;21744;68604;18930;65014;3022;10470;13304;47295;16326;57765
150370;201406;10256;38145;9796;37523;1259;4255;7914;31595;9173;35850
150375;201406;2795;11901;2731;11814;315;1191;2280;10262;2595;11453
150380;201406;9640;29129;8629;27742;863;2928;7048;22851;7911;25779
150390;201406;8199;35376;7824;34632;1646;6997;5055;23449;6701;30446
150400;201406;5628;22820;5426;22400;633;2508;4151;17674;4784;20182
150405;201406;8418;26004;7584;24970;1392;4121;5339;18683;6731;22804
150410;201406;1730;6656;1687;6573;297;1211;1116;4442;1413;5653
150420;201406;35132;124589;31369;118329;8400;33056;16163;63680;24563;96736
150430;201406;6488;24180;6264;23784;726;2952;4881;18761;5607;21713
150440;201406;5374;18911;5210;18669;840;2917;3869;14253;4709;17170
150442;201406;21680;63107;19803;60604;3359;10515;13417;42247;16776;52762
150445;201406;5106;18209;4718;17622;608;2187;3649;13972;4257;16159
150450;201406;4292;20626;4142;20406;407;1975;3439;17361;3846;19336
150460;201406;6852;25093;5747;23918;379;1635;5059;21555;5438;23190
150470;201406;17428;53823;16865;53116;1038;2660;15238;49072;16276;51732
150475;201406;1148;3900;1056;3779;161;550;794;2974;955;3524
150480;201406;14171;48690;13584;47809;1175;4064;11334;40811;12509;44875
150490;201406;6484;25233;6354;25054;301;1196;5782;23036;6083;24232
150495;201406;4854;17860;4748;17695;233;845;4344;16339;4577;17184
150497;201406;3283;11573;2995;11075;831;3117;1689;6460;2520;9577
150500;201406;2991;8646;2844;8427;428;1237;2125;6364;2553;7601
150503;201406;3891;12401;3364;11728;1114;3954;1749;6392;2863;10346
150506;201406;12366;44041;11408;42680;2376;8040;7829;31231;10205;39271
150510;201406;9782;38638;9138;37498;1454;6007;6400;27345;7854;33352
150520;201406;6375;25635;6288;25512;318;1059;5809;23972;6127;25031
150530;201406;11755;42006;10693;40361;1378;4973;8044;31341;9422;36314
150540;201406;4625;14401;4217;13806;343;1172;3517;11541;3860;12713
150543;201406;5207;16480;4736;15817;1135;3880;3003;10262;4138;14142
150548;201406;8435;27355;7912;26688;474;1460;7068;24258;7542;25718
150549;201406;2253;7141;2129;6996;107;245;1944;6564;2051;6809
150550;201406;21128;67933;18888;64108;5552;19317;9122;31726;14674;51043
150553;201406;21886;79569;19257;73435;7602;30830;4516;17290;12118;48120
150555;201406;1756;5433;1541;5131;214;750;1129;3802;1343;4552
150560;201406;1985;6449;1903;6266;244;833;1398;4607;1642;5440
150563;201406;2859;9504;2661;9150;618;2254;1586;5477;2204;7731
150565;201406;3498;12397;3246;12016;264;1131;2566;9620;2830;10751
150570;201406;5449;20669;5354;20504;411;1531;4525;17793;4936;19324
150580;201406;9732;40225;9548;39996;751;2651;8362;36202;9113;38853
150590;201406;5496;22324;5350;22147;121;402;5093;21338;5214;21740
150600;201406;7802;30388;7596;30067;575;2076;6610;26832;7185;28908
150610;201406;2404;8353;2218;7968;274;1112;1560;5542;1834;6654
150611;201406;2649;9690;2513;9396;274;1114;1877;7051;2151;8165
150613;201406;11459;35823;10037;33819;3168;10839;5095;18019;8263;28858
150616;201406;3104;9208;2441;8328;621;2252;1279;4313;1900;6565
150618;201406;7296;25612;7008;25065;2181;8005;3635;13398;5816;21403
150619;201406;5259;18300;4948;17847;672;2643;3608;13089;4280;15732
150620;201406;6242;22792;5691;22087;790;2964;4418;17819;5208;20783
150630;201406;5460;17140;5236;16864;408;1294;4476;14690;4884;15984
150635;201406;4491;14876;4235;14394;855;2924;2649;9314;3504;12238
150640;201406;1541;4923;1528;4902;171;512;1280;4243;1451;4755
150650;201406;12212;38006;11080;35977;2980;9965;5733;19111;8713;29076
150655;201406;5318;17800;4898;17183;636;2328;3742;13296;4378;15624
150658;201406;4355;13938;4009;13436;453;1794;2986;10116;3439;11910
150660;201406;5710;18168;5210;17528;1295;4237;3151;11055;4446;15292
150670;201406;6395;18622;5549;17588;1614;5093;3191;10722;4805;15815
150680;201406;51613;201533;48306;195466;16066;64927;23034;99764;39100;164691
150690;201406;1868;6094;1720;5840;299;979;1134;3987;1433;4966
150700;201406;5828;18365;5441;17864;1103;3576;3666;12376;4769;15952
150710;201406;4281;14019;3856;13349;441;1433;3020;10682;3461;12115
150715;201406;5016;16372;4490;15599;575;2061;3451;12172;4026;14233
150720;201406;6535;26841;6185;26211;1021;4201;4440;19656;5461;23857
150730;201406;9277;32172;8728;31440;1029;3494;7162;26452;8191;29946
150740;201406;3704;11953;3378;11377;466;1663;2309;7886;2775;9549
150745;201406;5897;18680;5456;18088;1119;3876;3734;12464;4853;16340
150746;201406;1423;4665;1352;4537;206;740;921;3108;1127;3848
150747;201406;5021;16533;4580;15955;509;1623;3547;12987;4056;14610
150750;201406;2911;9999;2813;9872;132;374;2596;9266;2728;9640
150760;201406;11359;37263;10778;36485;2535;8455;6817;23987;9352;32442
150770;201406;5703;21668;5501;21339;708;2583;4329;17693;5037;20276
150775;201406;1172;3681;1051;3463;214;842;622;1984;836;2826
150780;201406;3067;10296;3037;10264;77;182;2887;9904;2964;10086
150790;201406;5004;16201;4658;15793;363;971;4000;14104;4363;15075
150795;201406;15537;48048;14008;45849;2466;7704;9672;32977;12138;40681
150796;201406;2843;8770;2698;8596;365;1102;2093;6899;2458;8001
150797;201406;3791;12697;3582;12387;200;721;3135;10946;3335;11667
150800;201406;14176;47798;12945;46287;2774;9274;8958;33680;11732;42954
150803;201406;6881;25007;6561;24548;864;3258;4887;18813;5751;22071
150805;201406;2759;9657;2552;9349;383;1352;1881;7093;2264;8445
150808;201406;5920;20381;5099;18851;2170;8504;1229;4657;3399;13161
150810;201406;19606;61933;16544;58166;2493;8339;11899;44104;14392;52443
150812;201406;5381;16771;4944;16125;493;2033;3751;11840;4244;13873
150815;201406;8932;28826;8052;27740;1050;3423;6364;22688;7414;26111
150820;201406;10639;31234;9717;30220;624;1290;8627;27777;9251;29067
150830;201406;12482;48354;11625;46824;705;3018;9723;40286;10428;43304
150835;201406;2052;7563;1910;7234;520;2108;923;3494;1443;5602
150840;201406;7844;22733;6317;20631;1509;5401;3488;11258;4997;16659
160005;201406;710;2709;673;2639;112;523;436;1673;548;2196
160010;201406;1528;5206;1517;5194;130;329;1344;4760;1474;5089
160015;201406;1652;6143;1610;6067;206;694;1259;4973;1465;5667
160020;201406;2296;7655;2140;7438;319;1151;1545;5517;1864;6668
160021;201406;883;3798;864;3767;156;719;613;2735;769;3454
160023;201406;1052;4124;1036;4098;73;255;920;3711;993;3966
160025;201406;1297;3785;1262;3748;20;64;1224;3639;1244;3703
160027;201406;8242;25375;7708;24781;2574;8078;4174;14247;6748;22325
160030;201406;41701;153884;38381;146941;8452;32371;24373;96210;32825;128581
160040;201406;4277;16562;4192;16440;152;683;3904;15323;4056;16006
160050;201406;3557;13243;3213;12747;1142;4322;1638;7028;2780;11350
160053;201406;2680;10507;2622;10421;579;2324;1788;7291;2367;9615
160055;201406;768;2974;754;2956;127;538;561;2215;688;2753
160060;201406;17476;59267;16495;58166;3812;12645;11207;41451;15019;54096
160070;201406;2234;9034;2172;8929;156;625;1906;7983;2062;8608
160080;201406;2692;9999;2679;9976;91;282;2544;9585;2635;9867
170025;201406;563;1919;516;1844;171;632;240;898;411;1530
170030;201406;1184;3919;1070;3704;321;1134;490;1727;811;2861
170035;201406;1554;4656;1288;4153;447;1528;430;1419;877;2947
170040;201406;1874;6210;1644;5866;298;1214;1096;3920;1394;5134
170070;201406;2104;5734;1709;5234;489;1604;885;2763;1374;4367
170100;201406;2576;7298;2270;6785;269;896;1747;5216;2016;6112
170105;201406;749;2419;616;2142;137;567;313;1034;450;1601
170110;201406;1196;3744;1046;3490;232;837;581;1929;813;2766
170130;201406;1447;4558;1265;4291;232;801;812;2863;1044;3664
170190;201406;1680;4842;1344;4331;543;1679;396;1476;939;3155
170200;201406;1596;4862;1212;4146;354;1333;409;1360;763;2693
170210;201406;30607;93324;26199;85796;8873;30916;9375;31931;18248;62847
170215;201406;1146;3637;1028;3459;128;459;776;2641;904;3100
170220;201406;6559;21903;6018;20989;1026;3810;3922;13948;4948;17758
170230;201406;1535;5035;1331;4650;322;1289;660;2237;982;3526
170240;201406;3018;8613;2399;7777;363;1312;1616;5278;1979;6590
170255;201406;3699;11828;3097;10845;936;3365;1391;5125;2327;8490
170270;201406;1061;2731;759;2308;112;381;500;1496;612;1877
170290;201406;2961;8979;2626;8577;194;514;2240;7637;2434;8151
170300;201406;2095;6570;1780;6052;291;1078;1193;4086;1484;5164
170305;201406;781;2459;649;2211;116;430;390;1350;506;1780
170307;201406;1097;3886;946;3599;212;845;472;1898;684;2743
170310;201406;1722;4755;1367;4180;337;1003;685;2247;1022;3250
170320;201406;1083;3160;820;2685;210;738;393;1329;603;2067
170330;201406;861;2649;734;2489;125;454;507;1698;632;2152
170360;201406;456;1565;417;1498;110;414;172;603;282;1017
170370;201406;1437;4223;1173;3813;300;1065;531;1728;831;2793
170380;201406;2111;6651;1717;6052;360;1443;940;3292;1300;4735
170382;201406;563;1884;486;1760;116;474;283;1004;399;1478
170384;201406;1583;6523;1489;6356;364;1613;916;4001;1280;5614
170386;201406;931;2790;801;2604;209;755;408;1336;617;2091
170388;201406;649;1952;559;1802;114;431;239;761;353;1192
170389;201406;945;3161;866;3045;116;494;619;2135;735;2629
170390;201406;1367;4035;1180;3797;158;545;879;2903;1037;3448
170410;201406;489;1620;452;1550;63;261;300;1012;363;1273
170460;201406;530;1459;388;1214;109;368;134;416;243;784
170510;201406;794;2716;662;2492;127;540;350;1324;477;1864
170550;201406;5868;18073;4744;16050;1811;6647;1190;4062;3001;10709
170555;201406;1390;4077;1130;3679;299;1031;599;1970;898;3001
170560;201406;980;3368;806;3145;156;637;524;2122;680;2759
170600;201406;1356;3849;1178;3622;219;662;811;2577;1030;3239
170610;201406;1626;4921;1266;4354;162;628;792;2775;954;3403
170625;201406;438;1375;346;1191;78;281;103;360;181;641
170650;201406;1287;4112;1128;3833;289;1056;546;1897;835;2953
170700;201406;4043;13441;3397;12367;810;3224;1673;6336;2483;9560
170710;201406;1842;5462;1499;4878;235;823;959;3138;1194;3961
170720;201406;1857;4970;1595;4564;287;799;1121;3287;1408;4086
170730;201406;1111;3184;921;2904;268;922;443;1409;711;2331
170740;201406;2261;7990;2000;7528;309;1272;1375;5217;1684;6489
170755;201406;899;2813;757;2510;192;696;293;937;485;1633
170765;201406;1605;4322;1289;3812;348;1079;573;1736;921;2815
170770;201406;1840;6302;1713;6062;360;1312;1044;3780;1404;5092
170820;201406;4209;13495;3808;12859;1058;3753;1731;6005;2789;9758
170825;201406;817;2446;625;2071;149;547;253;821;402;1368
170830;201406;1397;4158;1256;3944;43;82;1133;3618;1176;3700
170900;201406;2919;10178;2781;9918;325;1158;2115;7783;2440;8941
170930;201406;4332;13194;3546;11992;1284;4586;1241;4182;2525;8768
170950;201406;13680;39966;10362;34208;3858;14213;2504;8028;6362;22241
170980;201406;530;1600;419;1423;95;353;255;859;350;1212
171050;201406;1351;4776;1271;4631;73;315;1109;4017;1182;4332
171070;201406;1734;5419;1601;5242;301;1025;1048;3520;1349;4545
171090;201406;970;2803;818;2569;85;285;608;1911;693;2196
171110;201406;666;1942;526;1714;135;481;290;928;425;1409
171150;201406;851;2537;633;2133;129;472;361;1231;490;1703
171180;201406;640;1998;485;1681;133;480;204;755;337;1235
171190;201406;1903;6897;1641;6367;401;1627;804;3252;1205;4879
171195;201406;882;3138;786;2962;140;583;437;1695;577;2278
171200;201406;687;2238;567;2016;138;560;273;922;411;1482
171215;201406;480;1426;367;1221;79;283;160;553;239;836
171240;201406;799;2741;752;2662;65;225;590;2153;655;2378
171245;201406;673;2242;567;1991;129;503;240;816;369;1319
171250;201406;1176;3399;1008;3159;92;332;784;2428;876;2760
171270;201406;440;1779;409;1716;107;412;210;966;317;1378
171280;201406;898;2830;798;2659;185;600;421;1533;606;2133
171320;201406;4169;12677;3553;11737;1044;3633;1810;5999;2854;9632
171330;201406;2884;8647;2499;8066;627;2147;1408;4593;2035;6740
171360;201406;1565;4974;1325;4618;284;1024;788;2799;1072;3823
171370;201406;781;2194;701;2071;139;460;390;1137;529;1597
171380;201406;1323;4394;1131;4018;372;1368;470;1693;842;3061
171395;201406;901;2754;731;2448;144;582;372;1225;516;1807
171420;201406;2286;6955;1833;6148;450;1612;842;2871;1292;4483
171430;201406;1048;3257;901;3025;205;685;534;1827;739;2512
171488;201406;2481;7613;2260;7297;588;1905;1258;4234;1846;6139
171500;201406;894;2753;787;2553;126;405;475;1572;601;1977
171510;201406;965;3383;869;3227;149;569;551;2127;700;2696
171515;201406;621;1778;478;1560;98;341;247;799;345;1140
171525;201406;609;2037;511;1853;96;399;291;1043;387;1442
171550;201406;353;1169;293;1050;114;441;49;183;163;624
171570;201406;1287;3967;1134;3702;204;680;768;2547;972;3227
171575;201406;2048;5851;1601;5040;381;1214;751;2482;1132;3696
171610;201406;6381;21748;5797;20637;1951;7321;2105;7534;4056;14855
171620;201406;2381;7392;2160;7060;164;597;1781;5861;1945;6458
171630;201406;902;2965;749;2694;218;846;297;1050;515;1896
171650;201406;2477;7739;2020;6897;542;1975;878;2968;1420;4943
171660;201406;2666;7326;2132;6389;397;1240;1222;3715;1619;4955
171665;201406;1458;4374;1227;3999;202;723;789;2652;991;3375
171670;201406;2394;6495;1916;5814;443;1455;1066;3155;1509;4610
171700;201406;1167;3829;1031;3582;168;657;654;2265;822;2922
171720;201406;736;2260;646;2093;207;714;295;968;502;1682
171750;201406;1337;4338;1168;4017;380;1348;446;1548;826;2896
171780;201406;1271;3482;925;2989;119;426;546;1808;665;2234
171790;201406;1734;5561;1430;5127;260;931;892;3355;1152;4286
171800;201406;733;2325;664;2226;106;379;453;1549;559;1928
171820;201406;10169;30934;9157;29676;2030;6998;5565;18317;7595;25315
171830;201406;1638;5961;1505;5674;403;1622;707;2676;1110;4298
171840;201406;827;2381;730;2248;62;185;572;1789;634;1974
171845;201406;829;2244;651;1942;99;332;389;1134;488;1466
171850;201406;1015;3636;905;3401;115;524;587;2185;702;2709
171855;201406;1276;4037;1150;3830;114;490;872;2820;986;3310
171865;201406;504;1598;421;1475;109;421;207;713;316;1134
171870;201406;699;2216;580;2005;123;455;276;1006;399;1461
171875;201406;1413;4446;1196;4121;185;731;852;2910;1037;3641
171880;201406;978;3521;957;3484;118;454;720;2705;838;3159
171884;201406;943;2698;698;2325;159;592;264;931;423;1523
171886;201406;1560;5206;1345;4743;463;1732;461;1654;924;3386
171888;201406;707;2176;591;1962;90;307;372;1284;462;1591
171889;201406;493;1611;466;1554;91;299;293;1005;384;1304
171890;201406;1170;3815;1041;3628;144;568;704;2464;848;3032
171900;201406;481;1888;451;1812;134;549;220;902;354;1451
172000;201406;667;2153;563;1989;95;392;330;1152;425;1544
172010;201406;1199;4132;1127;4022;120;479;870;3123;990;3602
172015;201406;363;1378;314;1303;55;233;188;819;243;1052
172020;201406;2421;7991;2177;7623;311;1155;1542;5505;1853;6660
172025;201406;763;2226;601;1937;108;366;316;1027;424;1393
172030;201406;1122;3792;1010;3590;144;599;688;2440;832;3039
172049;201406;1176;3271;1047;3062;141;408;777;2342;918;2750
172065;201406;1297;3747;1080;3474;106;371;898;2905;1004;3276
172080;201406;2620;8077;2214;7384;282;1110;1508;4939;1790;6049
172085;201406;529;1451;410;1226;97;311;140;408;237;719
172090;201406;3549;10574;2749;9470;557;2010;1687;5997;2244;8007
172093;201406;589;1877;462;1648;135;596;225;764;360;1360
172097;201406;716;2111;593;1909;152;555;238;747;390;1302
172100;201406;27666;93301;23953;85772;8425;32850;6751;24173;15176;57023
172110;201406;1713;6245;1566;6023;178;683;1205;4784;1383;5467
172120;201406;5655;16942;4668;15679;518;1796;3514;12071;4032;13867
172125;201406;333;1015;271;923;59;225;131;450;190;675
172130;201406;541;1535;459;1410;72;233;309;988;381;1221
172208;201406;2196;6793;2059;6569;397;1369;1202;3858;1599;5227
172210;201406;2382;7361;2206;7100;366;1291;1508;4759;1874;6050
210005;201406;21904;71360;19583;67675;5685;20901;9918;34531;15603;55432
210010;201406;1638;5847;1461;5584;152;577;1135;4468;1287;5045
210015;201406;3538;10996;3233;10538;289;645;2685;9248;2974;9893
210020;201406;7448;18522;6966;17930;461;1304;5738;14937;6199;16241
210030;201406;5919;19723;5602;19294;465;1904;4644;15934;5109;17838
210040;201406;1991;5700;1818;5496;181;560;1440;4398;1621;4958
210043;201406;6334;18772;5725;17964;525;1548;4557;14806;5082;16354
210047;201406;6737;26437;6277;25623;880;3853;4382;18155;5262;22008
210050;201406;2517;8942;2012;8188;578;2388;942;4032;1520;6420
210055;201406;1727;5938;1601;5761;200;741;1205;4374;1405;5115
210060;201406;7913;29294;7126;28035;764;3317;5311;21375;6075;24692
210070;201406;7042;20988;6615;20455;303;1024;5859;18228;6162;19252
210080;201406;3737;12916;3668;12816;86;339;3454;12109;3540;12448
210083;201406;4179;14422;3992;14212;136;427;3735;13484;3871;13911
210087;201406;2702;8317;2516;8090;174;612;2174;7031;2348;7643
210090;201406;10142;33321;9731;32651;475;1821;8491;28576;8966;30397
210095;201406;6218;23521;6049;23253;577;2223;4985;19591;5562;21814
210100;201406;7610;22753;7158;22225;340;1213;6374;19804;6714;21017
210110;201406;3250;11186;3152;11060;230;842;2665;9527;2895;10369
210120;201406;26104;75017;22296;70402;2609;8333;16983;55065;19592;63398
210125;201406;3422;11175;3282;11020;231;681;2890;9911;3121;10592
210130;201406;4053;12307;3863;12055;356;1134;3177;9973;3533;11107
210135;201406;1677;4932;1488;4653;134;416;1222;3890;1356;4306
210140;201406;18213;57613;15328;53746;3114;11110;9685;35377;12799;46487
210150;201406;4680;11898;4266;11385;129;348;3912;10433;4041;10781
210160;201406;18803;61027;17589;59233;2169;6801;13860;48215;16029;55016
210170;201406;14278;52285;14007;51924;1042;3440;12303;46706;13345;50146
210173;201406;1814;7795;1762;7692;123;597;1533;6731;1656;7328
210177;201406;3010;9682;2849;9480;314;1170;2301;7602;2615;8772
210180;201406;1542;4757;1448;4624;91;324;1225;3911;1316;4235
210190;201406;5224;16775;4884;16190;397;1740;3714;12021;4111;13761
210193;201406;1450;4652;1331;4449;105;383;1076;3652;1181;4035
210197;201406;1967;6569;1819;6406;183;561;1502;5499;1685;6060
210200;201406;9317;31220;8584;30158;1123;3693;6417;23544;7540;27237
210203;201406;6337;21407;5982;20957;433;1356;5232;18687;5665;20043
210207;201406;3077;10241;2886;9900;392;1286;2106;7445;2498;8731
210210;201406;8905;30081;8551;29589;301;1070;7564;26744;7865;27814
210215;201406;1700;6746;1647;6653;176;752;1344;5478;1520;6230
210220;201406;6349;24378;6086;23953;524;2090;4956;19982;5480;22072
210230;201406;5391;18305;5015;17712;412;1528;4101;14646;4513;16174
210232;201406;11996;41134;10559;39368;1795;6698;7379;29128;9174;35826
210235;201406;3574;11084;3216;10643;251;864;2728;9133;2979;9997
210237;201406;2533;9307;2503;9267;52;136;2407;9026;2459;9162
210240;201406;3029;9640;2886;9430;222;691;2398;7968;2620;8659
210250;201406;5111;16180;4893;15910;156;571;4547;14849;4703;15420
210255;201406;2743;8909;2504;8500;525;1883;1561;5368;2086;7251
210260;201406;5263;16832;4806;16133;684;2250;3529;12147;4213;14397
210270;201406;5345;15356;4760;14543;152;537;4228;13023;4380;13560
210275;201406;3567;9093;3339;8845;118;248;3153;8457;3271;8705
210280;201406;6035;17664;5198;16607;394;1340;4289;13843;4683;15183
210290;201406;5798;18774;5333;18199;459;1510;4424;15456;4883;16966
210300;201406;38161;112766;31676;104558;2942;10188;24986;84855;27928;95043
210310;201406;2907;8396;2753;8173;123;349;2428;7247;2551;7596
210312;201406;2200;7117;2153;7040;120;477;1924;6287;2044;6764
210315;201406;2445;8588;2328;8421;144;587;2005;7299;2149;7886
210317;201406;4335;12976;4153;12743;268;783;3670;11428;3938;12211
210320;201406;19652;62133;18405;60639;1089;3513;16151;54221;17240;57734
210325;201406;3630;11544;3260;10992;342;1235;2565;8723;2907;9958
210330;201406;33264;87445;28403;82159;3694;8343;21625;68321;25319;76664
210340;201406;12031;37251;11007;35972;1391;3794;8274;28868;9665;32662
210350;201406;10567;33086;9775;31962;819;2684;7885;26333;8704;29017
210355;201406;3971;14389;3619;13924;134;305;3323;13233;3457;13538
210360;201406;17040;52430;15894;50771;1384;4585;12676;41164;14060;45749
210370;201406;8391;22094;7417;21054;288;701;6686;19435;6974;20136
210375;201406;3246;9959;2809;9427;454;1617;2024;6911;2478;8528
210380;201406;6375;18457;5719;17521;614;1636;4614;14592;5228;16228
210390;201406;2807;9936;2586;9571;124;574;2273;8436;2397;9010
210400;201406;5002;15859;4813;15630;298;904;4250;14029;4548;14933
210405;201406;9067;25049;7357;22714;2203;6724;3479;11823;5682;18547
210407;201406;2114;7462;1883;7098;204;760;1457;5695;1661;6455
210408;201406;2212;8821;2099;8687;82;310;1906;8133;1988;8443
210409;201406;3980;14394;3772;14066;290;1112;3067;11731;3357;12843
210410;201406;3626;11675;3395;11390;299;861;2923;10090;3222;10951
210420;201406;4266;14134;3968;13613;346;1200;3230;11281;3576;12481
210430;201406;2118;6677;2065;6612;141;483;1797;5772;1938;6255
210440;201406;4312;13516;4196;13343;208;651;3764;12102;3972;12753
210450;201406;2933;9309;2656;8895;197;757;2179;7274;2376;8031
210455;201406;4232;12631;3648;11751;654;2158;2449;8090;3103;10248
210460;201406;4074;13148;3814;12798;222;836;3279;11090;3501;11926
210462;201406;1798;6447;1724;6296;174;694;1337;4961;1511;5655
210465;201406;2743;8957;2578;8751;277;793;2119;7475;2396;8268
210467;201406;6318;20883;5903;20373;492;1431;4950;17786;5442;19217
210470;201406;2032;5678;1593;5034;106;345;1262;4043;1368;4388
210480;201406;14039;46738;12421;44547;3571;12577;6748;25995;10319;38572
210490;201406;3475;10468;3211;10079;320;1046;2562;8075;2882;9121
210500;201406;6779;26657;6499;26156;724;2806;5074;21179;5798;23985
210510;201406;6953;23106;6679;22777;398;872;5842;20932;6240;21804
210515;201406;3443;11292;3341;11168;152;443;3072;10421;3224;10864
210520;201406;2752;8708;2564;8436;211;674;2128;7152;2339;7826
210530;201406;41752;135981;35594;126520;10288;39284;17878;65435;28166;104719
210535;201406;3247;11412;3139;11237;179;640;2737;9920;2916;10560
210540;201406;13244;45656;11805;43360;2942;10523;6419;25578;9361;36101
210542;201406;6462;18724;5650;17832;335;855;4974;16137;5309;16992
210545;201406;2254;7559;2139;7364;101;465;1834;6301;1935;6766
210547;201406;3868;13566;3612;13171;298;1013;2934;10997;3232;12010
210550;201406;6421;18159;5586;17233;290;668;5090;16129;5380;16797
210560;201406;4255;13485;3821;12785;286;1072;3164;10572;3450;11644
210565;201406;1552;5349;1344;5039;140;626;1010;3794;1150;4420
210570;201406;12844;36855;11688;35519;995;2459;9819;30936;10814;33395
210580;201406;3171;9659;2808;9199;372;1003;2143;7570;2515;8573
210590;201406;4440;13696;4171;13376;276;863;3635;11860;3911;12723
210592;201406;2522;8065;2440;7938;123;457;2138;6947;2261;7404
210594;201406;2792;8014;2328;7382;150;423;1934;6305;2084;6728
210596;201406;2884;10707;2723;10415;296;1211;2077;8053;2373;9264
210598;201406;2007;6210;1877;6054;119;462;1663;5323;1782;5785
210600;201406;3378;10042;3107;9658;298;979;2461;7660;2759;8639
210610;201406;2717;8671;2442;8337;216;828;2045;6974;2261;7802
210620;201406;1869;5795;1714;5597;53;162;1573;5191;1626;5353
210630;201406;3517;12900;3091;12074;511;1984;1950;7920;2461;9904
210632;201406;4821;16681;4419;16114;441;1651;3571;13188;4012;14839
210635;201406;1928;6820;1842;6691;81;280;1652;6099;1733;6379
210637;201406;2824;9600;2667;9371;148;518;2344;8349;2492;8867
210640;201406;4342;14602;4245;14495;19;55;4133;14217;4152;14272
210650;201406;6942;21203;6823;21059;150;418;6546;20355;6696;20773
210660;201406;7674;23726;7166;22940;287;815;6586;21237;6873;22052
210663;201406;2700;7913;2552;7719;167;561;2182;6633;2349;7194
210667;201406;1737;6240;1659;6122;85;377;1443;5355;1528;5732
210670;201406;4763;17694;4604;17424;454;1744;3613;14077;4067;15821
210675;201406;4874;13701;4597;13350;337;883;3959;11739;4296;12622
210680;201406;4599;12928;4103;12358;233;671;3560;10868;3793;11539
210690;201406;7023;23801;6684;23440;291;942;6106;21754;6397;22696
210700;201406;2686;7668;2382;7320;326;764;1788;6083;2114;6847
210710;201406;4932;16110;4722;15774;193;696;4183;14049;4376;14745
210720;201406;2507;9203;2364;8997;151;669;2056;7795;2207;8464
210725;201406;1190;4396;1027;4098;153;674;625;2524;778;3198
210730;201406;1235;3836;1091;3673;107;305;907;3142;1014;3447
210735;201406;3887;14243;3620;13768;590;2251;2532;9973;3122;12224
210740;201406;5162;14449;4825;14109;235;607;4475;13278;4710;13885
210745;201406;3798;11575;3570;11261;324;850;2954;9514;3278;10364
210750;201406;20334;56752;18548;54694;1984;5815;15039;45119;17023;50934
210760;201406;6034;16543;5697;16173;85;258;5517;15689;5602;15947
210770;201406;6305;17203;5342;16104;251;802;4774;14456;5025;15258
210780;201406;8685;29186;8056;28037;1018;3747;5800;20541;6818;24288
210790;201406;4812;14582;4152;13838;327;813;3532;12330;3859;13143
210800;201406;5118;14427;4649;13910;203;640;3983;12387;4186;13027
210805;201406;3744;15853;3632;15645;196;827;3128;13816;3324;14643
210810;201406;5768;17392;5203;16739;400;861;4536;15247;4936;16108
210820;201406;9085;26214;8491;25385;1555;4576;5802;17866;7357;22442
210825;201406;5554;18782;5374;18554;260;855;4813;16888;5073;17743
210830;201406;8631;26629;8266;26222;300;796;7524;24346;7824;25142
210840;201406;3821;10612;3500;10127;289;744;2787;8149;3076;8893
210845;201406;5610;17737;5401;17505;278;712;4795;16068;5073;16780
210850;201406;6188;22675;5745;21899;845;3615;4087;15659;4932;19274
210860;201406;17541;53966;16306;52316;1373;4651;13219;42858;14592;47509
210870;201406;6678;21705;6009;20862;714;2367;4598;16470;5312;18837
210880;201406;4302;13944;4199;13797;219;699;3766;12518;3985;13217
210890;201406;5402;16342;5056;15907;438;1507;4175;13178;4613;14685
210900;201406;4833;15729;4392;14974;1503;5212;1957;7056;3460;12268
210905;201406;1854;5841;1738;5689;127;324;1470;4967;1597;5291
210910;201406;10661;33589;9969;32497;1828;6354;6677;21989;8505;28343
210920;201406;3393;11407;3295;11272;176;560;2928;10209;3104;10769
210923;201406;1545;5698;1460;5572;216;834;1039;4155;1255;4989
210927;201406;4769;15032;4618;14877;32;96;4547;14693;4579;14789
210930;201406;2682;9718;2562;9564;205;919;2151;8029;2356;8948
210940;201406;2930;11544;2875;11433;306;1148;2336;9495;2642;10643
210945;201406;6005;17741;5792;17522;198;246;5528;17146;5726;17392
210950;201406;5744;17746;5016;16671;627;2152;3685;12503;4312;14655
210955;201406;1959;6499;1759;6185;305;1120;1196;4310;1501;5430
210960;201406;9355;30956;8991;30426;2179;7140;5841;20786;8020;27926
210970;201406;1395;5019;1233;4780;176;795;889;3459;1065;4254
210975;201406;1768;6077;1682;5923;169;611;1320;4722;1489;5333
210980;201406;9245;22940;9013;22681;634;1326;8030;20608;8664;21934
210990;201406;17081;49591;13653;45460;2774;9568;8722;29876;11496;39444
211000;201406;16581;53415;15013;51471;1014;3450;12876;45117;13890;48567
211003;201406;5108;17957;4673;17304;544;2112;3439;13123;3983;15235
211010;201406;6771;23016;6586;22800;133;440;6185;21670;6318;22110
211020;201406;7497;23285;7325;23005;199;480;6883;21806;7082;22286
211023;201406;2477;8344;2408;8224;167;595;2018;7036;2185;7631
211027;201406;3070;11940;2954;11758;289;1074;2357;9769;2646;10843
211030;201406;4311;13153;3880;12664;738;1918;2882;10046;3620;11964
211040;201406;4196;16135;4082;15947;158;657;3594;14340;3752;14997
211050;201406;10338;27604;10169;27411;487;1196;9407;25585;9894;26781
211060;201406;6016;21732;5890;21511;642;2181;4788;17984;5430;20165
211065;201406;1730;5997;1598;5823;55;194;1488;5491;1543;5685
211070;201406;8765;29763;8225;28827;758;2665;6595;23574;7353;26239
211080;201406;1371;4223;1123;3877;93;445;903;3045;996;3490
211085;201406;2069;6929;1789;6538;293;1037;1278;4827;1571;5864
211090;201406;3627;11258;3408;10962;207;783;2895;9254;3102;10037
211100;201406;6879;18037;6711;17838;98;346;6392;16952;6490;17298
211102;201406;3134;11683;3007;11507;302;1089;2506;9855;2808;10944
211105;201406;2860;9136;2512;8648;214;804;2060;7104;2274;7908
211107;201406;4553;14154;4168;13641;260;793;3589;12035;3849;12828
211110;201406;6644;19932;5279;17998;893;2899;3514;12622;4407;15521
211120;201406;32716;91158;28732;86185;4218;11997;20830;65054;25048;77051
211125;201406;2220;7149;2021;6843;153;551;1665;5690;1818;6241
211130;201406;150323;443017;141101;431223;27657;83630;97435;305425;125092;389055
211140;201406;5663;18156;5341;17653;290;1028;4608;15291;4898;16319
211150;201406;10087;30466;9468;29697;709;2259;8071;25627;8780;27886
211153;201406;3181;9546;2918;9243;368;951;2365;7863;2733;8814
211157;201406;1263;4146;1087;3876;136;568;755;2795;891;3363
211160;201406;4260;14490;3658;13473;429;1892;2636;9624;3065;11516
211163;201406;1735;5735;1644;5612;73;227;1472;5141;1545;5368
211167;201406;1522;5141;1417;4971;49;193;1285;4532;1334;4725
211170;201406;6810;18100;6559;17791;173;538;6064;16414;6237;16952
211172;201406;2435;7146;2148;6722;165;641;1773;5430;1938;6071
211174;201406;2880;8468;2630;8153;129;495;2304;7091;2433;7586
211176;201406;5688;16545;4804;15521;593;1676;3686;12471;4279;14147
211178;201406;3339;10118;3264;10035;90;195;3112;9695;3202;9890
211180;201406;4554;16031;4257;15575;409;1625;3401;12636;3810;14261
211190;201406;2838;9572;2598;9227;132;569;2231;7995;2363;8564
211195;201406;1478;4662;1267;4404;108;338;1037;3732;1145;4070
211200;201406;2186;7569;1970;7278;270;935;1457;5664;1727;6599
211210;201406;6990;21815;6771;21505;442;1411;5846;18780;6288;20191
211220;201406;36306;108153;31842;102339;6711;22089;20453;67677;27164;89766
211223;201406;5993;17304;5553;16597;820;2471;3743;11775;4563;14246
211227;201406;1600;5927;1513;5794;138;634;1204;4614;1342;5248
211230;201406;9143;30763;8368;29445;1209;4251;5993;21647;7202;25898
211240;201406;8464;28462;8156;28085;340;1184;7496;26003;7836;27187
211245;201406;5426;15742;5355;15655;178;426;5030;14891;5208;15317
211250;201406;12161;43893;11556;43192;1270;3548;9594;37925;10864;41473
211260;201406;8267;26243;8126;26046;479;1523;7293;23549;7772;25072
211270;201406;10194;36248;9589;35434;666;2687;7976;29954;8642;32641
211280;201406;12421;36743;11848;36049;1055;2515;10161;32070;11216;34585
211285;201406;2007;7029;1730;6528;411;1649;863;3407;1274;5056
211290;201406;7776;25562;7563;25291;749;2207;6266;21561;7015;23768
211300;201406;8733;26857;7943;25722;583;1964;6691;21841;7274;23805
211400;201406;12631;36890;10720;34728;2404;7526;6488;23396;8892;30922
220005;201406;1734;5096;1620;4923;63;272;1400;4125;1463;4397
220010;201406;1771;4653;1329;4088;127;467;1034;3121;1161;3588
220020;201406;3801;11625;3585;11264;611;2052;2405;7534;3016;9586
220025;201406;2189;5445;1982;5128;50;149;1750;4483;1800;4632
220027;201406;1420;3865;1314;3727;89;231;1112;3199;1201;3430
220030;201406;3420;10149;3345;10024;257;849;2847;8546;3104;9395
220040;201406;8614;26749;8200;26078;1636;5401;5209;16675;6845;22076
220045;201406;1470;4718;1330;4486;137;525;964;3207;1101;3732
220050;201406;4866;14135;4269;13262;367;1352;3421;10471;3788;11823
220060;201406;2102;5486;2005;5371;93;247;1824;4896;1917;5143
220070;201406;2628;7730;2349;7329;204;666;1827;5745;2031;6411
220080;201406;837;2604;793;2533;112;445;567;1740;679;2185
220090;201406;1886;4930;1630;4576;137;471;1332;3648;1469;4119
220095;201406;698;1955;668;1906;31;100;621;1758;652;1858
220100;201406;1419;4270;1206;3920;126;429;896;2958;1022;3387
220105;201406;2266;7447;2089;7109;211;762;1518;5188;1729;5950
220110;201406;3610;10522;3191;9910;247;926;2609;7968;2856;8894
220115;201406;2300;8381;2217;8245;270;1052;1786;6682;2056;7734
220117;201406;1433;3811;1176;3430;115;348;910;2655;1025;3003
220120;201406;12982;37287;12052;36117;422;1534;10998;32937;11420;34471
220130;201406;859;3091;761;2967;60;190;664;2664;724;2854
220140;201406;1656;4438;1514;4259;237;486;1212;3603;1449;4089
220150;201406;7297;23067;6980;22626;437;1619;5999;19433;6436;21052
220155;201406;1088;3405;914;3081;82;341;631;2072;713;2413
220157;201406;1069;2764;979;2632;45;118;835;2243;880;2361
220160;201406;2891;8671;2596;8165;204;774;2004;6243;2208;7017
220170;201406;1354;4293;1215;4063;110;437;965;3213;1075;3650
220173;201406;2115;6428;1747;5723;84;380;1409;4560;1493;4940
220177;201406;1754;5155;1723;5105;69;208;1602;4757;1671;4965
220180;201406;1176;3204;1038;2986;59;210;789;2217;848;2427
220190;201406;4736;15542;4169;14820;486;1722;3283;11868;3769;13590
220191;201406;1479;4996;1410;4871;205;721;1042;3609;1247;4330
220192;201406;1779;5100;1425;4481;165;561;992;3112;1157;3673
220194;201406;1750;5150;1585;4873;166;588;1185;3544;1351;4132
220196;201406;2086;6264;1950;6034;212;727;1488;4608;1700;5335
220198;201406;1348;3757;1084;3413;20;64;1005;3200;1025;3264
220200;201406;4702;16177;4439;15775;760;2852;3101;11094;3861;13946
220202;201406;2101;6598;1899;6236;67;275;1672;5456;1739;5731
220205;201406;2974;7796;2618;7327;100;371;2290;6324;2390;6695
220207;201406;921;2847;803;2641;83;325;610;1985;693;2310
220208;201406;1709;5888;1570;5647;249;1019;1079;3856;1328;4875
220209;201406;1591;4959;1444;4713;98;369;1111;3630;1209;3999
220210;201406;1910;5025;1663;4700;99;335;1314;3720;1413;4055
220211;201406;1665;4973;1579;4859;122;499;1309;3974;1431;4473
220213;201406;1850;5376;1724;5145;108;387;1358;3983;1466;4370
220217;201406;1805;5983;1739;5900;67;202;1598;5495;1665;5697
220220;201406;11905;34184;10941;32666;1349;3786;7818;24002;9167;27788
220225;201406;1016;3125;930;2997;45;191;797;2527;842;2718
220230;201406;6196;16298;5141;14885;226;653;4536;13197;4762;13850
220240;201406;2738;8778;2572;8494;209;776;2013;6615;2222;7391
220245;201406;1496;4074;1357;3886;78;242;1158;3331;1236;3573
220250;201406;3400;9225;3052;8758;66;169;2807;8155;2873;8324
220253;201406;1886;5592;1617;5130;138;507;1196;3833;1334;4340
220255;201406;1817;5125;1591;4748;101;398;1294;3751;1395;4149
220260;201406;5276;16969;4727;15933;471;1712;3515;11885;3986;13597
220265;201406;1252;4565;1190;4455;109;479;870;3264;979;3743
220270;201406;6876;22635;6692;22313;425;1913;5677;18491;6102;20404
220271;201406;1563;4408;1468;4267;72;199;1280;3774;1352;3973
220272;201406;1800;5588;1668;5379;113;465;1307;4176;1420;4641
220273;201406;1327;3805;1156;3534;123;403;876;2656;999;3059
220275;201406;2118;5661;1804;5255;94;294;1556;4536;1650;4830
220277;201406;2634;7152;2231;6541;162;520;1744;5147;1906;5667
220280;201406;1799;4706;1568;4368;133;479;1215;3306;1348;3785
220285;201406;1696;4618;1515;4365;101;314;1251;3695;1352;4009
220290;201406;6685;21752;5642;20405;571;2230;4351;15935;4922;18165
220300;201406;1968;6408;1734;6093;99;437;1453;5099;1552;5536
220310;201406;2659;8590;2217;8059;92;276;2001;7523;2093;7799
220320;201406;3425;10151;2880;9236;374;1292;2084;6687;2458;7979
220323;201406;1467;5367;1331;5165;149;650;1011;3940;1160;4590
220325;201406;1291;4104;1182;3890;170;604;785;2646;955;3250
220327;201406;1386;4439;1257;4221;74;354;1008;3333;1082;3687
220330;201406;3799;10777;3593;10506;249;768;3049;9002;3298;9770
220335;201406;2137;6151;1928;5896;107;371;1658;5115;1765;5486
220340;201406;1869;5318;1629;4969;150;511;1243;3754;1393;4265
220342;201406;1231;4016;1165;3913;124;457;855;3030;979;3487
220345;201406;2990;8053;2546;7349;78;222;2222;6426;2300;6648
220350;201406;4528;12163;3992;11443;308;984;3166;9068;3474;10052
220360;201406;1496;4092;1185;3609;120;429;866;2613;986;3042
220370;201406;9257;26748;8441;25666;446;1312;7527;22996;7973;24308
220375;201406;1607;4978;1492;4824;75;273;1340;4327;1415;4600
220380;201406;1435;3909;1233;3627;87;294;967;2841;1054;3135
220385;201406;776;2070;660;1877;29;109;546;1503;575;1612
220390;201406;10330;32574;9408;30771;2507;8570;4163;13678;6670;22248
220400;201406;1490;3556;1296;3268;48;165;1134;2787;1182;2952
220410;201406;1391;4003;1183;3713;112;464;933;2852;1045;3316
220415;201406;899;2426;808;2305;87;244;608;1747;695;1991
220420;201406;2301;6705;2060;6234;141;416;1674;5099;1815;5515
220430;201406;2989;8704;2843;8506;382;1164;2206;6610;2588;7774
220435;201406;1699;4981;1561;4765;86;268;1294;3960;1380;4228
220440;201406;2817;8489;2335;7931;134;422;2069;7088;2203;7510
220450;201406;2750;8169;2375;7651;526;1803;1468;4731;1994;6534
220455;201406;1419;4372;1270;4168;48;159;1151;3819;1199;3978
220460;201406;1059;2913;1006;2839;72;218;869;2436;941;2654
220465;201406;2514;8299;2311;7990;549;2028;1414;4929;1963;6957
220470;201406;4129;12392;3738;11726;280;994;2869;8889;3149;9883
220480;201406;2440;7230;2229;6925;182;593;1799;5587;1981;6180
220490;201406;2482;7141;2317;6933;136;479;1983;5918;2119;6397
220500;201406;3474;9285;2908;8306;164;642;2359;6562;2523;7204
220510;201406;2958;8259;2214;7120;105;457;1697;5408;1802;5865
220515;201406;1994;4996;1759;4702;92;257;1481;3975;1573;4232
220520;201406;5169;14559;4821;14060;212;589;4250;12520;4462;13109
220525;201406;1480;4181;1372;4023;108;397;1114;3191;1222;3588
220527;201406;1472;4646;1348;4387;148;497;1033;3410;1181;3907
220530;201406;1240;3624;1127;3446;92;355;937;2783;1029;3138
220535;201406;919;2846;884;2796;89;323;695;2175;784;2498
220540;201406;3691;12271;3553;12054;288;1092;2925;9936;3213;11028
220545;201406;1457;5008;1400;4912;203;814;999;3456;1202;4270
220550;201406;9551;31166;9004;30225;1408;5002;6254;21027;7662;26029
220551;201406;1451;4945;1347;4769;121;516;1055;3698;1176;4214
220552;201406;1696;5340;1452;4912;127;573;1068;3490;1195;4063
220553;201406;1647;4921;1403;4558;87;331;1146;3714;1233;4045
220554;201406;935;2610;812;2440;103;316;602;1833;705;2149
220555;201406;2468;7266;2313;7072;103;336;1987;6172;2090;6508
220556;201406;1519;4779;1376;4502;109;428;1034;3365;1143;3793
220557;201406;1670;5501;1521;5221;208;793;1008;3460;1216;4253
220558;201406;1068;3357;981;3203;97;376;748;2407;845;2783
220559;201406;1584;4495;1451;4290;87;295;1227;3622;1314;3917
220560;201406;1782;4413;1483;4008;91;247;1237;3329;1328;3576
220570;201406;7630;24375;7144;23677;1119;3559;5203;17740;6322;21299
220580;201406;6632;21656;6465;21458;395;1267;5818;19546;6213;20813
220585;201406;1985;7298;1907;7156;150;597;1583;5977;1733;6574
220590;201406;1459;4547;1318;4337;257;881;847;2838;1104;3719
220595;201406;2537;7319;2337;7052;90;316;2092;6323;2182;6639
220600;201406;1372;3409;1152;3143;203;426;791;2296;994;2722
220605;201406;2096;6217;1846;5824;111;378;1462;4614;1573;4992
220610;201406;2842;8804;2754;8675;172;669;2347;7333;2519;8002
220620;201406;7940;27066;7664;26658;427;1651;6706;23422;7133;25073
220630;201406;423;1293;361;1178;60;223;206;663;266;886
220635;201406;1900;6748;1773;6472;176;783;1151;4184;1327;4967
220640;201406;2852;8392;2704;8170;273;913;2129;6443;2402;7356
220650;201406;2528;7122;2261;6705;155;523;1827;5384;1982;5907
220660;201406;2612;8316;2093;7627;261;1126;1623;5815;1884;6941
220665;201406;1226;4216;1171;4127;54;232;1039;3646;1093;3878
220667;201406;1795;6053;1703;5928;90;347;1459;5081;1549;5428
220669;201406;1918;6287;1788;6045;263;1025;1249;4207;1512;5232
220670;201406;2172;6606;2033;6429;168;418;1747;5721;1915;6139
220672;201406;2419;6969;2321;6841;243;681;1945;5828;2188;6509
220675;201406;1391;4067;1297;3911;126;363;978;2976;1104;3339
220680;201406;2287;7488;2184;7344;230;769;1745;5981;1975;6750
220690;201406;1777;5049;1581;4728;121;435;1255;3712;1376;4147
220695;201406;910;2731;855;2639;71;240;660;2032;731;2272
220700;201406;9188;26729;8358;25493;786;2635;6464;19727;7250;22362
220710;201406;788;2376;677;2187;62;197;493;1618;555;1815
220720;201406;2169;5836;2047;5668;93;215;1812;5089;1905;5304
220730;201406;1405;3899;1204;3593;49;188;1012;2990;1061;3178
220735;201406;1083;2812;903;2505;64;212;677;1878;741;2090
220740;201406;1424;4550;1201;4245;167;579;911;3320;1078;3899
220750;201406;4058;11928;3820;11570;517;1355;2918;9195;3435;10550
220755;201406;1223;3549;1140;3415;73;214;951;2851;1024;3065
220760;201406;2698;9466;2509;9194;134;559;2157;7968;2291;8527
220770;201406;24341;82644;22408;78902;7373;26804;9591;35090;16964;61894
220775;201406;1263;3171;1232;3136;19;38;1200;3069;1219;3107
220777;201406;1721;4883;1600;4698;117;352;1295;3766;1412;4118
220779;201406;1210;3600;1173;3549;71;261;1046;3129;1117;3390
220780;201406;6385;16687;5722;15798;462;1249;4675;13075;5137;14324
220785;201406;1363;3667;1317;3575;61;180;1209;3263;1270;3443
220790;201406;9660;31320;9247;30567;962;3511;7316;24054;8278;27565
220793;201406;940;2675;865;2552;61;209;712;2088;773;2297
220795;201406;1554;4363;1505;4289;120;359;1281;3668;1401;4027
220800;201406;17610;49902;16266;47918;1855;6302;12239;35444;14094;41746
220810;201406;3388;10008;2927;9186;209;820;2325;7211;2534;8031
220820;201406;5706;15866;5218;15224;331;1063;4491;13129;4822;14192
220830;201406;7793;22196;7405;21556;854;2510;5715;16801;6569;19311
220840;201406;15223;48812;13800;45924;3672;12410;6552;22522;10224;34932
220850;201406;2822;10088;2694;9901;291;1145;2184;8084;2475;9229
220855;201406;637;1975;561;1836;48;188;411;1329;459;1517
220860;201406;966;2673;888;2549;55;219;716;2006;771;2225
220865;201406;2687;7529;2183;6696;124;567;1748;5205;1872;5772
220870;201406;2464;8127;2166;7756;120;465;1908;6849;2028;7314
220880;201406;5533;14434;5044;13838;274;855;4429;12155;4703;13010
220885;201406;1356;4802;1195;4518;121;572;884;3323;1005;3895
220887;201406;1414;3682;1232;3432;52;173;1102;3072;1154;3245
220890;201406;1665;5826;1478;5516;137;493;1184;4558;1321;5051
220900;201406;1962;5773;1746;5324;125;364;1407;4351;1532;4715
220910;201406;1734;5151;1540;4866;85;287;1338;4271;1423;4558
220915;201406;1058;3069;932;2848;55;239;733;2174;788;2413
220920;201406;1345;4981;1270;4872;147;650;924;3514;1071;4164
220930;201406;1513;4894;1347;4676;99;396;1101;3850;1200;4246
220935;201406;1076;3321;963;3091;71;313;701;2161;772;2474
220937;201406;1608;4406;1357;3967;78;289;1070;3042;1148;3331
220940;201406;1470;4519;1359;4283;114;433;1038;3246;1152;3679
220945;201406;498;1781;458;1671;61;257;315;1149;376;1406
220950;201406;1289;3293;933;2679;40;160;712;1988;752;2148
220955;201406;1639;4537;1383;4132;114;371;1069;3177;1183;3548
220960;201406;883;2423;746;2188;59;225;571;1642;630;1867
220965;201406;1712;5186;1621;5057;74;298;1405;4359;1479;4657
220970;201406;2166;5818;1594;4864;173;529;1087;3349;1260;3878
220975;201406;640;2254;637;2247;50;186;569;2006;619;2192
220980;201406;1511;4526;1347;4231;144;520;897;2905;1041;3425
220985;201406;1364;3936;1296;3834;141;468;982;2881;1123;3349
220987;201406;1527;4926;1411;4724;119;504;1064;3479;1183;3983
220990;201406;1844;5382;1603;4968;80;328;1247;3804;1327;4132
220995;201406;1271;3778;1008;3375;89;355;765;2579;854;2934
220997;201406;2135;6843;2035;6677;115;412;1836;6014;1951;6426
221000;201406;4531;14072;4211;13528;526;1843;3059;9794;3585;11637
221005;201406;1446;4617;1353;4439;420;1294;712;2454;1132;3748
221010;201406;1261;3401;1094;3180;73;218;918;2675;991;2893
221020;201406;1946;6054;1818;5818;139;597;1369;4300;1508;4897
221030;201406;1824;5114;1588;4773;109;453;1256;3705;1365;4158
221035;201406;1591;4322;1442;4138;97;252;1265;3697;1362;3949
221037;201406;638;1968;576;1860;37;166;461;1426;498;1592
221038;201406;655;1852;522;1627;43;147;355;1115;398;1262
221039;201406;952;2775;885;2675;64;224;751;2242;815;2466
221040;201406;5284;16237;4971;15728;401;1392;3918;12528;4319;13920
221050;201406;3813;11752;3521;11331;223;865;2993;9576;3216;10441
221060;201406;9302;25509;7907;23571;890;2729;5945;17822;6835;20551
221062;201406;1293;4586;1206;4439;33;129;1123;4148;1156;4277
221063;201406;1157;3741;1077;3587;312;997;618;2212;930;3209
221065;201406;2786;8133;2595;7821;311;903;1993;6055;2304;6958
221070;201406;4406;13525;3986;12874;281;1058;3170;10239;3451;11297
221080;201406;3576;9677;3203;9171;213;688;2651;7593;2864;8281
221090;201406;1367;3798;1196;3525;50;207;988;2851;1038;3058
221093;201406;1831;5484;1741;5306;391;1271;955;2847;1346;4118
221095;201406;1016;2717;868;2504;30;77;768;2232;798;2309
221097;201406;816;2357;723;2195;65;264;543;1623;608;1887
221100;201406;126493;387586;119577;376152;24316;83600;78832;243550;103148;327150
221110;201406;10278;34042;9819;33461;699;2660;8312;28353;9011;31013
221120;201406;4459;14845;4268;14502;1022;3470;2744;9576;3766;13046
221130;201406;4755;14166;4180;13013;1145;3723;2156;6693;3301;10416
221135;201406;1498;4761;1402;4617;163;603;1087;3560;1250;4163
221140;201406;1414;3602;1302;3454;110;300;1095;2911;1205;3211
221150;201406;1253;3253;1046;2895;37;159;828;2259;865;2418
221160;201406;909;2411;857;2330;60;186;655;1788;715;1974
221170;201406;1153;3678;1080;3542;74;306;882;2852;956;3158
230010;201406;3453;9435;2833;8367;185;642;2264;6673;2449;7315
230015;201406;2721;9611;2561;9263;405;1706;1717;6090;2122;7796
230020;201406;14561;48133;14058;47202;942;3469;11631;39298;12573;42767
230030;201406;12725;37578;11950;36354;899;3071;9680;29391;10579;32462
230040;201406;4605;13115;3930;11953;313;1132;3034;9117;3347;10249
230050;201406;2590;8997;2158;7868;417;1680;1004;3626;1421;5306
230060;201406;2067;6175;1826;5727;125;465;1382;4284;1507;4749
230070;201406;4365;12200;3842;11436;341;1056;2974;9012;3315;10068
230075;201406;9065;33055;8520;31917;856;3985;6530;24151;7386;28136
230080;201406;2382;6600;2005;6054;130;453;1607;4829;1737;5282
230090;201406;3549;10870;3181;10210;300;1140;2438;7749;2738;8889
230100;201406;17684;54812;16234;52041;4158;14063;8505;27528;12663;41591
230110;201406;14167;46677;13231;44706;2589;9401;7842;26452;10431;35853
230120;201406;8204;22746;7249;21421;845;2565;5421;16238;6266;18803
230125;201406;2959;8754;2469;7819;188;723;1821;5691;2009;6414
230130;201406;5688;19019;4838;17159;497;2096;3388;11851;3885;13947
230140;201406;3566;11645;3081;10747;461;1707;2001;7162;2462;8869
230150;201406;1770;5673;1555;5235;289;1118;977;3156;1266;4274
230160;201406;6505;19686;5685;18459;530;1924;4317;14059;4847;15983
230170;201406;6653;21194;5766;19536;560;2217;4180;14012;4740;16229
230180;201406;1962;5693;1723;5259;152;567;1213;3636;1365;4203
230185;201406;4279;14348;3945;13730;669;2312;2538;9192;3207;11504
230190;201406;12635;41845;11648;39846;2431;9361;6289;21235;8720;30596
230195;201406;5056;15901;4586;15143;340;1472;3601;11517;3941;12989
230200;201406;5799;17051;5211;15916;661;2138;3714;11333;4375;13471
230205;201406;4436;14109;3968;13314;339;1462;2885;9639;3224;11101
230210;201406;9446;27381;8280;25542;2261;6980;4342;13938;6603;20918
230220;201406;13933;41032;12681;38857;1765;6086;8745;26443;10510;32529
230230;201406;7611;25168;6833;23564;1033;3781;4341;15086;5374;18867
230240;201406;13649;39963;12305;37549;854;3244;9582;28691;10436;31935
230250;201406;10301;31916;10084;31598;518;1941;8549;26676;9067;28617
230260;201406;14978;51321;13942;49175;2944;10938;7910;28522;10854;39460
230270;201406;6893;21194;6097;19808;688;2394;4471;14630;5159;17024
230280;201406;19191;58702;17357;55517;2222;7247;12444;40132;14666;47379
230290;201406;5183;16002;4533;14702;657;2217;3042;9948;3699;12165
230300;201406;4849;15044;4644;14731;539;1960;3507;10995;4046;12955
230310;201406;4967;14982;4352;13949;378;1513;3223;10114;3601;11627
230320;201406;7516;24320;7001;23412;800;3003;5160;17313;5960;20316
230330;201406;4834;14469;4293;13430;385;1398;3096;9564;3481;10962
230340;201406;3476;12137;3253;11654;512;2039;2066;7279;2578;9318
230350;201406;18522;57407;16705;54264;2808;9814;10579;34790;13387;44604
230360;201406;3102;9196;2649;8371;322;1148;1861;5804;2183;6952
230365;201406;3060;8774;2702;8180;183;660;2114;6372;2297;7032
230370;201406;56781;188431;52482;180914;15489;55197;25741;91790;41230;146987
230380;201406;7209;21064;6166;19251;568;2007;4378;13681;4946;15688
230390;201406;3699;11751;3297;11091;392;1594;2314;7678;2706;9272
230393;201406;3411;11433;2936;10435;304;1437;2049;7029;2353;8466
230395;201406;5074;16061;4723;15400;713;2587;3108;10124;3821;12711
230400;201406;5259;16493;4585;15481;360;1575;3563;11785;3923;13360
230410;201406;15882;50696;14282;47680;2525;8976;8536;28604;11061;37580
230420;201406;24968;82973;23141;79219;5712;21228;11706;39929;17418;61157
230423;201406;4878;15940;4528;15270;541;2030;3132;10737;3673;12767
230425;201406;5579;18854;5094;17738;724;2728;3439;11946;4163;14674
230426;201406;2860;8053;2350;7108;157;636;1732;5108;1889;5744
230427;201406;1791;5498;1367;4566;141;544;912;2944;1053;3488
230428;201406;9262;30547;9029;30134;1765;6567;5798;19160;7563;25727
230430;201406;4651;15152;4391;14645;459;1834;3194;10492;3653;12326
230435;201406;5125;16859;4598;15918;984;3779;2436;8507;3420;12286
230440;201406;362884;1133666;340990;1094140;86684;297582;172747;557095;259431;854677
230445;201406;4781;13049;4061;12005;361;1061;3047;9203;3408;10264
230450;201406;3755;12110;3220;11135;472;1864;2084;7200;2556;9064
230460;201406;1943;6490;1767;6159;199;799;1261;4373;1460;5172
230465;201406;4284;12886;3501;11460;312;1340;2375;7564;2687;8904
230470;201406;11449;42078;10989;41145;1456;5752;7946;30230;9402;35982
230480;201406;1496;4879;1295;4491;207;759;832;2907;1039;3666
230490;201406;2934;8668;2565;7985;484;1692;1353;4147;1837;5839
230495;201406;5794;19587;5257;18690;902;3733;3092;11036;3994;14769
230500;201406;10768;36900;10300;36088;940;3614;7850;28095;8790;31709
230510;201406;1535;5536;1261;4836;310;1283;501;1994;811;3277
230520;201406;5086;15575;4473;14482;487;1874;3057;9809;3544;11683
230523;201406;14004;47044;12756;44153;3673;13878;3887;13745;7560;27623
230526;201406;4238;13070;3740;12199;399;1525;2693;8768;3092;10293
230530;201406;5400;18031;4937;17398;980;3523;3343;11969;4323;15492
230533;201406;4052;11599;3614;10765;267;888;2792;8225;3059;9113
230535;201406;5519;16557;4849;15352;532;1761;3496;11233;4028;12994
230540;201406;19247;55670;17070;52426;1094;4061;14015;42722;15109;46783
230550;201406;20392;62290;18579;58841;4272;14395;9857;31151;14129;45546
230560;201406;6626;19319;5929;18061;274;1111;4784;14398;5058;15509
230565;201406;3332;9723;2715;8489;255;907;1902;5878;2157;6785
230570;201406;4010;11023;3570;10464;244;879;2956;8568;3200;9447
230580;201406;10540;32579;9998;31815;612;2010;8660;27827;9272;29837
230590;201406;9179;29311;8220;27514;707;2980;6137;20117;6844;23097
230600;201406;3645;10392;2738;8511;197;688;1839;5666;2036;6354
230610;201406;6238;20585;5845;19959;788;2884;4213;14539;5001;17423
230620;201406;2124;6063;1754;5293;159;562;1107;3243;1266;3805
230625;201406;7762;25978;6984;24185;2072;7740;2366;8248;4438;15988
230630;201406;11354;37265;10394;35416;2594;8493;5284;19091;7878;27584
230640;201406;27468;91399;25802;88911;3567;13032;19001;66076;22568;79108
230650;201406;5024;16014;4571;15126;400;1664;3470;11250;3870;12914
230655;201406;8777;33498;8454;32961;688;2796;7114;28108;7802;30904
230660;201406;6453;20328;5693;18966;555;2183;4103;13741;4658;15924
230670;201406;6051;16601;4925;14676;284;1096;3811;11020;4095;12116
230680;201406;2852;8406;2400;7567;362;1239;1473;4634;1835;5873
230690;201406;6329;21061;6196;20805;517;2174;4538;14950;5055;17124
230700;201406;9378;27513;8346;25671;872;3272;5799;17312;6671;20584
230710;201406;7689;25115;6846;23556;841;2936;4967;17435;5808;20371
230720;201406;1980;6253;1713;5741;228;821;1144;3880;1372;4701
230725;201406;3788;12849;3365;11821;742;2772;1748;6069;2490;8841
230730;201406;57551;178122;48880;164258;13461;48852;21414;73457;34875;122309
230740;201406;5600;17619;5208;16919;302;1315;4316;13795;4618;15110
230750;201406;9133;26538;7801;24368;709;2564;5925;18415;6634;20979
230760;201406;9557;29496;9152;28582;1008;3834;6713;20173;7721;24007
230763;201406;4238;13536;3971;13000;308;1414;3031;9562;3339;10976
230765;201406;42129;139474;39155;133381;12559;45670;14369;49717;26928;95387
230770;201406;24042;67839;22275;65323;2236;7205;16556;48549;18792;55754
230780;201406;6076;24001;5812;23372;1462;5945;2985;12761;4447;18706
230790;201406;2613;8905;2482;8680;295;1106;1900;6707;2195;7813
230800;201406;8007;28950;7344;27449;1780;7115;3547;13312;5327;20427
230810;201406;12663;41595;12072;40595;1360;4732;9317;31816;10677;36548
230820;201406;3503;11965;3099;11086;564;2275;1758;6281;2322;8556
230830;201406;7955;24262;7113;22726;781;2862;4970;15802;5751;18664
230835;201406;4201;11489;3546;10570;316;1056;2751;8153;3067;9209
230837;201406;3183;10974;2763;10103;357;1493;1866;6818;2223;8311
230840;201406;9526;31697;8731;30284;1178;4398;6141;21628;7319;26026
230850;201406;11452;34978;10655;33916;1333;4671;7899;25159;9232;29830
230860;201406;5112;15440;4681;14659;378;1418;3586;11146;3964;12564
230870;201406;19226;53496;17273;50297;1604;5291;13048;37758;14652;43049
230880;201406;1938;6788;1804;6519;245;1037;1194;4286;1439;5323
230890;201406;4151;15135;3784;14364;565;2504;2424;9058;2989;11562
230900;201406;3023;10210;2637;9395;570;2007;1385;5068;1955;7075
230910;201406;3028;9201;2475;8144;241;962;1756;5664;1997;6626
230920;201406;4749;13990;4367;13510;318;1060;3649;11453;3967;12513
230930;201406;7903;24306;7117;22845;888;3004;4941;15955;5829;18959
230940;201406;7723;22219;6824;20872;409;1292;5640;17403;6049;18695
230945;201406;5950;18132;5123;16944;585;2128;3619;12150;4204;14278
230950;201406;7080;19538;6075;18184;433;1389;4764;14355;5197;15744
230960;201406;12766;41225;11755;39261;2535;9195;6059;20305;8594;29500
230970;201406;13687;43941;12406;41444;2689;10141;6201;20337;8890;30478
230980;201406;2975;9678;2598;8931;825;2867;1168;4190;1993;7057
230990;201406;1620;5072;1343;4493;157;660;880;2867;1037;3527
231000;201406;2890;7891;2305;6779;278;939;1467;4193;1745;5132
231010;201406;3187;9008;2750;8312;267;1048;2104;6237;2371;7285
231020;201406;8268;27725;7813;26802;1403;4973;4921;17267;6324;22240
231025;201406;7940;25187;7169;23838;1163;4001;4652;15830;5815;19831
231030;201406;8127;26917;6930;24420;1345;5080;4032;14380;5377;19460
231040;201406;3057;10192;2740;9540;248;1053;1946;6666;2194;7719
231050;201406;12300;35961;10734;33112;1063;3755;7803;23960;8866;27715
231060;201406;2450;7918;2248;7553;199;912;1617;5267;1816;6179
231070;201406;9425;30016;8678;28543;1633;5698;5237;17315;6870;23013
231080;201406;4346;13682;3986;13028;260;1191;3000;9446;3260;10637
231085;201406;4806;15595;4663;15356;690;2297;3434;11578;4124;13875
231090;201406;4103;11684;3382;10256;200;753;2462;7334;2662;8087
231095;201406;2256;7606;1962;7008;231;909;1358;4914;1589;5823
231100;201406;3079;9674;2582;8671;234;916;1854;6134;2088;7050
231110;201406;3793;12767;3702;12609;380;1456;2735;9342;3115;10798
231120;201406;2445;8036;2279;7744;380;1340;1496;5157;1876;6497
231123;201406;2246;6151;1915;5597;166;469;1513;4456;1679;4925
231126;201406;6781;18905;5542;17107;439;1646;4185;12743;4624;14389
231130;201406;20466;64426;18747;61422;4499;15105;10364;35376;14863;50481
231135;201406;4713;13910;3975;12755;413;1592;2911;9170;3324;10762
231140;201406;15835;51908;14579;49387;1459;6610;10080;32928;11539;39538
231150;201406;6025;17744;5170;16120;977;3379;2824;8585;3801;11964
231160;201406;5991;20471;5694;19903;1230;4545;3578;12545;4808;17090
231170;201406;4816;15566;4439;14800;518;2038;3005;9874;3523;11912
231180;201406;14618;44691;13353;42230;2387;8219;8338;26047;10725;34266
231190;201406;5105;14352;4264;13144;335;1210;3293;10054;3628;11264
231195;201406;4643;15964;4035;14756;404;1763;2959;10819;3363;12582
231200;201406;7758;27110;6854;25255;689;3228;4858;17569;5547;20797
231210;201406;5214;16192;4507;15188;325;1391;3483;11826;3808;13217
231220;201406;14279;41012;12210;37465;1286;4605;8079;24848;9365;29453
231230;201406;8868;31469;8313;30485;945;3997;6316;23138;7261;27135
231240;201406;12121;38984;10935;36783;1869;6934;6493;22087;8362;29021
231250;201406;2056;6027;1430;4504;303;958;574;1738;877;2696
231260;201406;4055;11596;3673;11055;520;1588;2487;7677;3007;9265
231270;201406;7785;21989;6917;20600;662;2591;5037;14586;5699;17177
231280;201406;1753;5832;1642;5613;158;576;1215;4179;1373;4755
231290;201406;33924;120113;31134;113317;7686;30783;13463;48011;21149;78794
231300;201406;4678;13750;3837;12041;341;1299;2730;8305;3071;9604
231310;201406;7662;22270;6485;19861;1243;3979;3557;10771;4800;14750
231320;201406;7055;22027;6210;20371;436;1739;4635;15153;5071;16892
231325;201406;2581;7976;2312;7501;174;665;1735;5636;1909;6301
231330;201406;14314;44750;12135;40575;2024;6906;7562;25618;9586;32524
231335;201406;5208;15184;4586;14044;331;1288;3626;10872;3957;12160
231340;201406;18222;60048;17086;58428;1428;4742;13842;48632;15270;53374
231350;201406;12480;42413;12227;42025;1340;4468;9932;34823;11272;39291
231355;201406;4305;14210;4140;13929;276;983;3451;11750;3727;12733
231360;201406;7421;24641;6807;23558;1638;5530;4030;14536;5668;20066
231370;201406;2446;6952;1965;6209;116;437;1491;4654;1607;5091
231375;201406;4116;14373;3918;13995;359;1608;3062;10775;3421;12383
231380;201406;5327;17495;5019;17061;779;2778;3453;12038;4232;14816
231390;201406;3497;11106;3300;10809;277;1127;2492;8079;2769;9206
231395;201406;4262;13796;3812;13064;754;2703;2286;7986;3040;10689
231400;201406;10573;31798;9659;30131;1028;3672;6746;21113;7774;24785
231410;201406;13606;47037;12775;45784;1211;4472;9981;36439;11192;40911
240010;201406;2538;7928;2210;7221;539;1955;998;3144;1537;5099
240020;201406;11955;37799;10692;35399;2750;9642;5091;17178;7841;26820
240030;201406;2602;7708;2524;7585;216;784;2017;5967;2233;6751
240040;201406;817;2463;700;2242;47;220;503;1540;550;1760
240050;201406;3786;10365;3261;9464;233;816;2482;7103;2715;7919
240060;201406;1465;4413;1383;4277;137;511;1060;3183;1197;3694
240070;201406;2905;8453;2770;8202;465;1461;1823;5324;2288;6785
240080;201406;3178;8553;2807;8073;274;732;2182;6408;2456;7140
240090;201406;2291;6309;1953;5670;77;306;1551;4406;1628;4712
240100;201406;10474;30295;9710;28808;1301;4544;6067;17786;7368;22330
240110;201406;5232;16091;4664;15066;852;3109;2819;8779;3671;11888
240120;201406;3061;10226;2943;10009;556;2034;1882;6528;2438;8562
240130;201406;2857;7848;2469;7251;217;752;1907;5530;2124;6282
240140;201406;2224;6899;1978;6435;399;1474;1085;3467;1484;4941
240145;201406;6291;19893;5686;18814;1472;5408;2938;9720;4410;15128
240150;201406;1029;3136;849;2779;122;484;516;1626;638;2110
240160;201406;1503;4890;1349;4618;204;787;838;2900;1042;3687
240165;201406;933;3021;828;2804;104;363;542;1878;646;2241
240170;201406;2553;7765;2290;7268;609;2069;1034;3299;1643;5368
240180;201406;3006;9464;2808;9121;719;2416;1503;5070;2222;7486
240185;201406;1516;5066;1464;4971;177;619;1099;3809;1276;4428
240190;201406;925;2861;855;2723;64;275;648;2009;712;2284
240200;201406;14675;38079;12309;35176;2545;7274;7433;22231;9978;29505
240210;201406;2823;8097;2604;7805;222;766;2150;6392;2372;7158
240220;201406;7375;24092;7025;23596;399;1770;6094;20255;6493;22025
240230;201406;5642;15946;5158;15106;448;1467;4039;11721;4487;13188
240240;201406;1864;5830;1418;4662;410;1456;313;913;723;2369
240250;201406;2901;8394;2750;8181;217;761;2218;6521;2435;7282
240260;201406;15084;50759;14379;49605;2457;9469;9433;32625;11890;42094
240270;201406;2462;8000;2292;7723;248;823;1705;5893;1953;6716
240280;201406;1683;4801;1509;4497;133;469;1117;3287;1250;3756
240290;201406;1441;4534;1240;4164;118;565;802;2587;920;3152
240300;201406;2202;6243;1589;4880;415;1373;552;1630;967;3003
240310;201406;10575;30307;9661;28825;2180;7034;5184;15460;7364;22494
240320;201406;2084;6242;1707;5455;113;485;1229;3794;1342;4279
240325;201406;39037;108756;30932;95365;9804;32368;9694;30649;19498;63017
240330;201406;1574;4767;1331;4281;163;658;834;2584;997;3242
240340;201406;1765;5186;1539;4830;204;682;1096;3447;1300;4129
240350;201406;2187;6592;2049;6396;222;793;1654;5120;1876;5913
240360;201406;7505;22745;6585;21383;1164;3991;4142;13814;5306;17805
240370;201406;2062;5697;1795;5245;159;532;1315;3834;1474;4366
240375;201406;906;2407;808;2266;157;495;477;1300;634;1795
240380;201406;2728;8155;2241;7080;314;1053;1318;4122;1632;5175
240390;201406;954;2672;802;2376;78;292;572;1648;650;1940
240400;201406;1495;4028;1272;3683;148;505;928;2601;1076;3106
240410;201406;551;1791;504;1693;82;324;326;1079;408;1403
240420;201406;4947;18806;4750;18365;1377;5243;2447;10068;3824;15311
240430;201406;3579;10361;3316;9911;338;1140;2431;7222;2769;8362
240440;201406;2791;7496;2578;7123;657;1851;1373;3834;2030;5685
240450;201406;4066;12103;3644;11318;543;1976;2277;6950;2820;8926
240460;201406;2969;9403;2839;9222;280;1065;2271;7309;2551;8374
240470;201406;3657;11312;2957;9834;391;1452;1831;6006;2222;7458
240480;201406;457;1198;391;1057;45;120;239;635;284;755
240485;201406;2146;6599;1906;6152;378;1316;1098;3566;1476;4882
240490;201406;1719;4387;1489;4050;89;329;1167;3052;1256;3381
240500;201406;2189;6549;2059;6340;211;705;1574;4856;1785;5561
240510;201406;1820;5569;1690;5330;217;704;1265;4033;1482;4737
240520;201406;1467;4277;1288;4016;198;697;889;2712;1087;3409
240530;201406;2257;7173;2026;6804;271;956;1447;4890;1718;5846
240540;201406;1855;5693;1785;5573;169;592;1355;4234;1524;4826
240550;201406;827;2357;718;2173;64;229;547;1610;611;1839
240560;201406;3324;9741;3150;9483;308;938;2553;7727;2861;8665
240570;201406;3171;9051;2602;7794;586;1989;1181;3253;1767;5242
240580;201406;8251;25623;7776;24821;1173;3962;5740;18264;6913;22226
240590;201406;851;2417;750;2235;58;223;550;1598;608;1821
240600;201406;1571;4655;1245;3987;166;611;718;2201;884;2812
240610;201406;5085;14337;4417;13098;619;1968;2739;7982;3358;9950
240615;201406;1062;3087;884;2748;150;490;508;1581;658;2071
240620;201406;1745;5658;1606;5415;188;721;1234;4147;1422;4868
240630;201406;2092;6435;1985;6256;211;587;1480;4887;1691;5474
240640;201406;953;2807;802;2557;97;391;534;1665;631;2056
240650;201406;3877;11963;3590;11543;302;1084;2879;9300;3181;10384
240660;201406;2536;8128;2425;7946;270;945;1837;6087;2107;7032
240670;201406;2782;8356;2364;7509;356;1277;1338;4153;1694;5430
240680;201406;1531;4534;1251;4027;144;506;773;2508;917;3014
240690;201406;1133;3177;988;2943;106;374;721;2123;827;2497
240700;201406;2708;8185;2276;7371;130;599;1757;5530;1887;6129
240710;201406;18831;48476;16722;45725;3224;8687;10467;29624;13691;38311
240720;201406;5767;16647;5479;16224;1638;5164;2709;7937;4347;13101
240725;201406;1082;3262;836;2713;83;291;484;1537;567;1828
240730;201406;2358;7230;2061;6686;217;779;1454;4690;1671;5469
240740;201406;2280;6861;2050;6440;275;923;1347;4247;1622;5170
240750;201406;2286;8510;2110;8183;431;1835;1219;4796;1650;6631
240760;201406;1282;3770;1206;3668;118;302;953;3067;1071;3369
240770;201406;3617;10537;3292;10055;398;1334;2396;7352;2794;8686
240780;201406;5907;16584;4823;14878;842;2751;2882;9057;3724;11808
240790;201406;870;2706;708;2406;59;242;520;1775;579;2017
240800;201406;41685;121332;37922;114866;10698;34041;16494;50855;27192;84896
240810;201406;97664;292240;91893;281857;28016;88555;44170;137867;72186;226422
240820;201406;7023;21014;6066;19502;1232;4289;3191;10651;4423;14940
240830;201406;9529;29309;8975;28511;708;2367;7385;23850;8093;26217
240840;201406;1328;3704;1147;3401;144;483;695;2038;839;2521
240850;201406;1225;3743;953;3182;188;705;499;1592;687;2297
240860;201406;1337;3802;1142;3484;101;357;843;2519;944;2876
240870;201406;1180;3306;1008;2972;131;456;651;1827;782;2283
240880;201406;1203;4121;1139;4027;154;636;820;2874;974;3510
240890;201406;5499;15632;4802;14392;925;3018;2558;7585;3483;10603
240895;201406;2807;9647;2556;9196;353;1361;1780;6516;2133;7877
240910;201406;2762;8717;2522;8266;239;933;1889;6139;2128;7072
240920;201406;877;2841;794;2653;211;772;384;1234;595;2006
240930;201406;3702;9979;3342;9510;308;901;2646;7641;2954;8542
240933;201406;1528;4485;1363;4202;231;807;830;2563;1061;3370
240940;201406;6728;18962;5673;17116;1094;3483;3159;9525;4253;13008
240950;201406;1180;3716;1118;3609;118;482;799;2563;917;3045
240960;201406;809;2547;722;2378;86;327;517;1691;603;2018
240970;201406;1961;5552;1651;5019;132;475;1222;3645;1354;4120
240980;201406;3354;11076;3138;10668;673;2461;1930;6557;2603;9018
240990;201406;3103;9256;2914;8879;532;1805;1837;5466;2369;7271
241000;201406;1103;3098;961;2854;87;311;700;2043;787;2354
241010;201406;3037;10206;2758;9696;430;1788;1899;6486;2329;8274
241020;201406;2136;6095;1783;5417;151;547;1131;3307;1282;3854
241025;201406;1553;4816;1419;4556;122;509;1018;3185;1140;3694
241030;201406;2569;8487;2326;8055;196;757;1815;6324;2011;7081
241040;201406;2220;7722;2040;7394;217;905;1480;5423;1697;6328
241050;201406;1351;4039;1226;3825;112;441;914;2775;1026;3216
241060;201406;1005;2904;919;2763;113;360;674;2031;787;2391
241070;201406;942;2698;823;2485;99;359;573;1672;672;2031
241080;201406;1210;3620;1040;3310;94;393;723;2226;817;2619
241090;201406;2164;6287;1863;5752;125;527;1519;4613;1644;5140
241100;201406;1224;3682;1066;3326;110;375;697;2146;807;2521
241105;201406;1174;3617;1108;3491;193;664;661;2150;854;2814
241110;201406;870;2778;730;2470;78;345;453;1498;531;1843
241120;201406;7957;24244;7263;23132;1422;4567;4789;15655;6211;20222
241140;201406;3533;9917;3136;9137;411;1274;2143;6155;2554;7429
241142;201406;710;2136;516;1711;137;516;151;454;288;970
241150;201406;5885;17660;5364;16770;835;2768;3608;11396;4443;14164
241160;201406;1136;3319;1068;3189;171;550;742;2208;913;2758
241170;201406;1382;4082;1266;3866;177;591;787;2504;964;3095
241180;201406;1020;2816;808;2409;103;348;476;1361;579;1709
241190;201406;1125;3153;955;2817;77;296;641;1786;718;2082
241200;201406;21268;63686;19642;61079;5162;16824;10164;32272;15326;49096
241210;201406;1553;4551;1310;4054;280;959;645;1973;925;2932
241220;201406;8072;27301;7673;26522;1839;6572;4324;15320;6163;21892
241230;201406;3113;9306;2840;8915;217;823;2300;7162;2517;7985
241240;201406;1128;3320;863;2743;94;305;504;1672;598;1977
241250;201406;5651;17926;4871;16378;308;1504;3886;12747;4194;14251
241255;201406;1869;7153;1772;6938;465;1927;819;3323;1284;5250
241260;201406;5172;14003;4183;12472;338;1279;3001;8784;3339;10063
241270;201406;2090;6314;1835;5820;258;904;1104;3521;1362;4425
241280;201406;2180;6367;2025;6062;321;1029;1345;4056;1666;5085
241290;201406;3339;9267;2689;8221;479;1531;1618;4950;2097;6481
241300;201406;1462;4248;1296;3968;77;245;1007;3121;1084;3366
241310;201406;1558;4927;1484;4813;223;693;1042;3508;1265;4201
241320;201406;927;3126;858;2974;159;601;493;1714;652;2315
241330;201406;1562;4929;1447;4780;148;577;1176;3861;1324;4438
241335;201406;2674;8228;2519;7961;180;582;2118;6716;2298;7298
241340;201406;1979;6164;1758;5685;440;1563;858;2723;1298;4286
241350;201406;1947;6280;1822;6041;180;782;1371;4401;1551;5183
241355;201406;1299;3698;1147;3435;64;210;1003;2986;1067;3196
241360;201406;2167;6010;1903;5509;139;474;1388;3868;1527;4342
241370;201406;1351;4201;1101;3669;194;705;582;1905;776;2610
241380;201406;729;2115;632;1918;100;352;353;1065;453;1417
241390;201406;2984;9949;2813;9632;565;2043;1798;6269;2363;8312
241400;201406;3732;11077;3478;10723;406;1426;2645;8179;3051;9605
241410;201406;2753;8147;2477;7770;401;1349;1742;5490;2143;6839
241415;201406;1623;4978;1507;4772;111;445;1147;3570;1258;4015
241420;201406;2267;7902;1989;7420;679;2824;663;2411;1342;5235
241430;201406;498;1522;430;1364;58;209;278;852;336;1061
241440;201406;6068;22243;5682;21581;1013;4037;3958;15234;4971;19271
241445;201406;1049;3242;991;3155;145;378;771;2606;916;2984
241450;201406;3327;9289;3035;8874;461;1492;2133;6187;2594;7679
241460;201406;3629;10640;3228;9864;282;1044;2309;6975;2591;8019
241470;201406;1351;3867;1172;3647;131;517;866;2632;997;3149
241475;201406;1252;3933;1102;3655;77;369;796;2574;873;2943
241480;201406;3300;10735;2999;10283;1036;3545;1189;4497;2225;8042
241490;201406;643;1733;531;1561;55;214;364;1020;419;1234
241500;201406;750;2385;700;2316;41;196;614;1983;655;2179
250010;201406;2755;8702;2420;8111;246;1008;1789;5867;2035;6875
250020;201406;1693;4909;1303;4201;107;468;853;2641;960;3109
250030;201406;8105;23130;7344;22063;863;2612;5590;17132;6453;19744
250040;201406;4590;15428;4250;14762;787;2895;2662;9335;3449;12230
250050;201406;3693;11650;3478;11341;485;1746;2448;8109;2933;9855
250053;201406;1341;3981;1253;3863;204;652;838;2596;1042;3248
250057;201406;716;2782;698;2760;36;104;619;2572;655;2676
250060;201406;5029;15987;4834;15668;660;2420;3659;11682;4319;14102
250070;201406;3901;12275;3674;11881;257;1122;3019;9496;3276;10618
250073;201406;795;2414;709;2254;79;295;517;1628;596;1923
250077;201406;2294;6744;1925;6150;272;948;1131;3650;1403;4598
250080;201406;4797;14077;4638;13850;569;1758;3496;10498;4065;12256
250090;201406;2659;7958;2557;7791;137;493;2145;6424;2282;6917
250100;201406;4030;13562;3842;13226;444;1723;2947;10114;3391;11837
250110;201406;5753;17546;5502;17193;737;2576;4167;12947;4904;15523
250115;201406;550;1801;485;1651;49;235;289;915;338;1150
250120;201406;2248;6713;1939;6132;194;706;1433;4498;1627;5204
250130;201406;5772;17709;5444;17246;348;1256;4548;14543;4896;15799
250135;201406;1088;3364;1000;3212;118;421;707;2283;825;2704
250140;201406;2148;6977;1982;6754;227;821;1498;5201;1725;6022
250150;201406;5084;17183;4668;16399;492;2044;3387;11779;3879;13823
250153;201406;1581;4239;1424;4012;127;446;1104;3099;1231;3545
250157;201406;1714;5908;1573;5605;333;1195;936;3437;1269;4632
250160;201406;3379;10502;3276;10334;214;757;2812;8939;3026;9696
250170;201406;1620;4789;1515;4624;304;964;963;3009;1267;3973
250180;201406;16952;52896;16390;51948;2437;8904;11652;36048;14089;44952
250190;201406;4053;12030;3761;11538;623;2037;2476;7488;3099;9525
250200;201406;2245;6257;1792;5637;138;511;1469;4584;1607;5095
250205;201406;1009;3346;920;3176;94;429;594;2104;688;2533
250210;201406;1656;5400;1533;5219;183;761;1108;3708;1291;4469
250215;201406;1443;4950;1404;4876;217;839;894;3116;1111;3955
250220;201406;824;2353;682;2172;47;173;584;1843;631;2016
250230;201406;1747;4450;1422;3915;134;429;1116;2990;1250;3419
250240;201406;2691;8622;2385;8150;217;799;1825;6320;2042;7119
250250;201406;4617;13961;4234;13442;377;1234;3445;11068;3822;12302
250260;201406;1922;5868;1682;5465;151;592;1250;4019;1401;4611
250270;201406;1340;4198;1195;4016;154;542;902;3080;1056;3622
250280;201406;3808;11514;3517;11047;680;2172;2272;7447;2952;9619
250290;201406;2145;5730;1768;5240;67;251;1551;4590;1618;4841
250300;201406;5531;16425;5239;16060;614;2521;4182;12266;4796;14787
250310;201406;1166;3711;1058;3528;153;586;769;2532;922;3118
250320;201406;7997;25312;7609;24510;1127;4102;5152;16155;6279;20257
250330;201406;2613;8241;2284;7787;270;1045;1733;5879;2003;6924
250340;201406;1149;3347;1068;3226;56;190;916;2765;972;2955
250350;201406;4581;12538;4181;12045;190;617;3654;10658;3844;11275
250355;201406;2170;6639;1977;6351;157;664;1528;4825;1685;5489
250360;201406;2067;6210;1924;6011;115;431;1526;4795;1641;5226
250370;201406;13726;39078;11906;36901;1035;3329;10046;31385;11081;34714
250375;201406;1114;3529;1049;3418;62;250;884;2878;946;3128
250380;201406;1696;4827;1603;4710;99;335;1399;4100;1498;4435
250390;201406;1953;5254;1603;4672;214;652;1068;3135;1282;3787
250400;201406;71452;197862;62701;184600;15150;47015;33902;101881;49052;148896
250403;201406;1551;5119;1462;4995;185;738;1083;3648;1268;4386
250407;201406;1160;3378;1009;3119;64;217;794;2426;858;2643
250410;201406;684;2182;602;2035;68;283;457;1529;525;1812
250415;201406;1829;5790;1672;5482;138;530;1243;4008;1381;4538
250420;201406;1338;4166;1236;4008;97;391;1024;3249;1121;3640
250430;201406;6737;18894;6310;18269;512;1792;5149;14624;5661;16416
250435;201406;1657;5013;1481;4677;217;792;880;2838;1097;3630
250440;201406;4621;13750;4351;13382;293;973;3617;11172;3910;12145
250450;201406;2089;5958;1857;5653;95;324;1656;5050;1751;5374
250460;201406;6483;19658;6036;19048;751;2527;4546;14494;5297;17021
250470;201406;1634;4544;1473;4315;154;552;1059;3010;1213;3562
250480;201406;4058;12171;3662;11599;166;683;3155;9943;3321;10626
250485;201406;631;1659;535;1499;26;95;423;1144;449;1239
250490;201406;4199;13664;4100;13518;885;3100;2634;8717;3519;11817
250500;201406;1942;5926;1798;5686;352;1137;1099;3552;1451;4689
250510;201406;4985;14041;4414;13256;314;1140;3617;10813;3931;11953
250520;201406;1922;5943;1828;5781;333;1185;1090;3370;1423;4555
250523;201406;1812;5755;1723;5632;240;820;1272;4213;1512;5033
250527;201406;1487;4512;1401;4400;62;261;1258;3911;1320;4172
250530;201406;681;2098;597;1989;51;172;489;1656;540;1828
250535;201406;1330;4260;1266;4129;84;364;1007;3220;1091;3584
250540;201406;2489;7407;2334;7235;83;256;2147;6729;2230;6985
250550;201406;909;3044;837;2932;65;271;643;2222;708;2493
250560;201406;1782;5733;1743;5675;142;504;1480;4836;1622;5340
250570;201406;2555;8424;2302;7929;202;799;1765;6033;1967;6832
250580;201406;1176;3212;965;2874;110;452;679;1916;789;2368
250590;201406;1059;3253;954;3114;87;363;739;2367;826;2730
250600;201406;7188;21110;6832;20585;498;1458;5710;17416;6208;18874
250610;201406;3509;10296;3255;9907;394;1322;2334;7090;2728;8412
250620;201406;869;2526;807;2405;150;490;517;1513;667;2003
250625;201406;2238;7296;2204;7250;85;216;2042;6824;2127;7040
250630;201406;10520;33965;9990;33029;2252;7968;5746;19045;7998;27013
250640;201406;3917;11660;3666;11366;293;1100;3078;9428;3371;10528
250650;201406;950;2791;887;2673;133;467;516;1578;649;2045
250660;201406;2140;5298;1639;4700;26;68;1556;4486;1582;4554
250670;201406;2778;9283;2639;9028;278;1148;1962;6679;2240;7827
250680;201406;5037;14452;4793;14108;269;910;4137;12207;4406;13117
250690;201406;6420;17167;6193;16866;582;1747;5267;14213;5849;15960
250700;201406;5425;16256;5046;15696;816;2731;3435;10605;4251;13336
250710;201406;4649;14752;4268;14251;659;2239;2988;10264;3647;12503
250720;201406;2622;7882;2499;7670;154;608;2086;6349;2240;6957
250730;201406;3732;11627;3558;11370;475;1673;2607;8284;3082;9957
250740;201406;2055;6096;1801;5661;210;774;1291;3986;1501;4760
250750;201406;104594;309704;98682;300630;17621;58778;65512;197397;83133;256175
250760;201406;2282;6776;2119;6532;196;736;1633;4976;1829;5712
250770;201406;4026;13841;3822;13562;709;2736;2455;8756;3164;11492
250780;201406;1920;5759;1665;5284;200;771;1084;3343;1284;4114
250790;201406;2493;8164;2362;7977;553;1824;1515;5298;2068;7122
250800;201406;2817;8150;2464;7558;160;579;1894;5690;2054;6269
250810;201406;1377;4072;1196;3802;114;461;946;2946;1060;3407
250820;201406;2069;6349;1994;6247;130;444;1675;5298;1805;5742
250830;201406;6031;20062;5694;19379;782;3106;3908;13079;4690;16185
250840;201406;1048;3360;914;3087;121;459;585;1984;706;2443
250850;201406;2455;7144;2187;6709;226;877;1433;4561;1659;5438
250855;201406;1106;3361;1046;3268;79;283;850;2621;929;2904
250860;201406;2947;10013;2716;9561;658;2602;1125;3876;1783;6478
250870;201406;1210;3475;1052;3216;74;293;774;2292;848;2585
250880;201406;1429;4190;1301;4007;199;638;905;2795;1104;3433
250890;201406;9759;30988;9106;30082;1570;5935;6077;19766;7647;25701
250900;201406;3103;10229;2763;9592;352;1246;1921;6789;2273;8035
250905;201406;2136;6730;2039;6602;340;1151;1468;4802;1808;5953
250910;201406;5521;16094;5157;15544;508;1685;3994;12037;4502;13722
250915;201406;1734;5186;1593;4979;143;443;1323;4202;1466;4645
250920;201406;3617;10322;3394;10013;465;1307;2443;7474;2908;8781
250930;201406;2007;6562;1921;6430;344;1322;1341;4413;1685;5735
250933;201406;1204;3901;1160;3830;131;452;857;2868;988;3320
250937;201406;878;2744;788;2561;116;453;480;1559;596;2012
250939;201406;1746;5423;1581;5152;221;776;1056;3429;1277;4205
250940;201406;4044;11892;3749;11427;252;898;2966;9107;3218;10005
250950;201406;1390;4330;1270;4177;89;297;1053;3526;1142;3823
250960;201406;1352;4229;1205;4034;75;277;1015;3449;1090;3726
250970;201406;9173;25133;8202;23761;1195;3502;5729;16750;6924;20252
250980;201406;2705;8207;2489;7831;255;1023;1713;5194;1968;6217
250990;201406;2182;7493;2016;7163;298;1223;1393;4887;1691;6110
251000;201406;2589;7398;2131;6740;141;521;1707;5386;1848;5907
251010;201406;2877;8353;2624;7982;200;732;2085;6368;2285;7100
251020;201406;1693;5124;1564;4962;148;515;1298;4149;1446;4664
251030;201406;1339;3767;1215;3560;129;439;795;2343;924;2782
251040;201406;1956;6238;1766;5945;185;857;1269;4126;1454;4983
251050;201406;1160;3454;1028;3218;173;576;587;1909;760;2485
251060;201406;1051;2554;848;2302;89;308;657;1716;746;2024
251065;201406;594;1780;520;1668;70;259;323;992;393;1251
251070;201406;624;1782;578;1716;60;239;450;1251;510;1490
251080;201406;21710;60972;20191;58407;5255;15749;11007;32356;16262;48105
251090;201406;3081;9787;2747;9166;281;1104;1988;6557;2269;7661
251100;201406;1010;3287;898;3075;146;591;561;1855;707;2446
251110;201406;2167;6287;1928;5869;221;741;1330;4053;1551;4794
251120;201406;6010;20736;5825;20407;744;3106;4540;15592;5284;18698
251130;201406;4020;10521;3607;10063;41;122;3480;9733;3521;9855
251140;201406;4519;13940;4198;13436;244;964;3291;10498;3535;11462
251150;201406;2844;9259;2606;8921;341;1292;1894;6573;2235;7865
251160;201406;1904;6340;1824;6228;100;392;1589;5441;1689;5833
251170;201406;1446;4486;1400;4430;130;486;1146;3581;1276;4067
251180;201406;2942;8849;2705;8542;579;1850;1622;5256;2201;7106
251190;201406;4418;12668;4283;12510;278;823;3818;11191;4096;12014
251200;201406;4231;13183;4029;12921;217;767;3545;11416;3762;12183
251203;201406;1354;4266;1267;4082;114;475;790;2645;904;3120
251207;201406;1238;3884;1076;3580;92;388;745;2424;837;2812
251210;201406;8270;23766;7234;22371;989;3000;5351;16954;6340;19954
251220;201406;1324;3592;1159;3337;181;553;761;2258;942;2811
251230;201406;5280;15913;4660;15179;431;1580;3931;12804;4362;14384
251240;201406;3221;10622;3144;10503;334;1270;2514;8353;2848;9623
251250;201406;10719;32253;9979;31111;1419;4992;7198;22143;8617;27135
251260;201406;551;1693;489;1609;36;118;371;1236;407;1354
251270;201406;4313;13407;4027;13051;170;689;3595;11662;3765;12351
251272;201406;1398;4290;1313;4168;133;433;1034;3340;1167;3773
251274;201406;1032;3235;971;3117;131;520;587;1926;718;2446
251275;201406;1431;4057;1358;3946;151;565;1002;2814;1153;3379
251276;201406;1519;4529;1436;4378;214;712;890;2800;1104;3512
251278;201406;652;2087;567;1888;86;316;340;1175;426;1491
251280;201406;2375;7511;2275;7347;282;1006;1706;5493;1988;6499
251290;201406;6163;17693;5863;17312;866;2903;4250;12298;5116;15201
251300;201406;768;2650;711;2564;72;334;513;1808;585;2142
251310;201406;3371;9809;3105;9432;209;788;2489;7475;2698;8263
251315;201406;1742;6159;1686;6057;299;1127;1068;3918;1367;5045
251320;201406;2185;6158;1807;5549;153;529;1290;4028;1443;4557
251330;201406;2082;5421;1726;4959;119;479;1467;4073;1586;4552
251335;201406;1008;3494;953;3389;102;459;692;2401;794;2860
251340;201406;3997;11110;3384;10185;357;1329;2362;6927;2719;8256
251350;201406;1633;5033;1489;4829;238;844;996;3224;1234;4068
251360;201406;1879;6110;1760;5966;129;503;1484;5068;1613;5571
251365;201406;903;2683;726;2312;60;236;471;1477;531;1713
251370;201406;22963;76973;22500;76243;3741;14293;16325;54307;20066;68600
251380;201406;1421;4409;1241;4097;102;432;969;3121;1071;3553
251385;201406;885;2476;805;2350;78;267;557;1591;635;1858
251390;201406;5865;20973;5512;20380;1108;4377;3606;13383;4714;17760
251392;201406;1089;3228;1005;3094;97;311;741;2334;838;2645
251394;201406;623;1928;521;1728;40;159;367;1201;407;1360
251396;201406;879;2539;787;2380;94;320;570;1687;664;2007
251398;201406;1132;3310;946;2962;88;328;644;2002;732;2330
251400;201406;1370;3904;1253;3747;176;663;846;2426;1022;3089
251410;201406;1642;4308;1497;4070;182;558;1024;2838;1206;3396
251420;201406;2225;6418;1900;6058;193;699;1468;4649;1661;5348
251430;201406;1761;6228;1593;5954;124;547;1303;4875;1427;5422
251440;201406;1473;4446;1251;4011;158;568;891;2825;1049;3393
251445;201406;1660;5057;1574;4931;115;434;1322;4101;1437;4535
251450;201406;4859;15297;4341;14633;192;801;3742;12624;3934;13425
251455;201406;1222;3813;1083;3582;91;372;769;2546;860;2918
251460;201406;887;2726;853;2669;121;386;662;2095;783;2481
251465;201406;502;1572;460;1485;53;202;299;949;352;1151
251470;201406;1312;3793;1083;3365;134;480;636;2004;770;2484
251480;201406;1131;3087;1019;2901;67;247;814;2275;881;2522
251490;201406;2101;6221;1824;5845;319;1194;1164;3652;1483;4846
251500;201406;1792;5875;1739;5792;190;712;1363;4489;1553;5201
251510;201406;2657;8911;2467;8499;434;1596;1516;5293;1950;6889
251520;201406;1129;3100;1023;2936;155;474;568;1645;723;2119
251530;201406;12160;35465;11642;34722;748;2753;9942;29270;10690;32023
251540;201406;2892;9513;2664;9024;268;1081;2014;6800;2282;7881
251550;201406;4039;10101;3392;9282;192;660;2779;7427;2971;8087
251560;201406;750;2319;690;2219;105;422;421;1239;526;1661
251570;201406;1078;3170;918;2836;115;433;587;1845;702;2278
251580;201406;2217;6117;2040;5876;333;850;1484;4431;1817;5281
251590;201406;1713;5672;1687;5643;118;443;1451;4909;1569;5352
251593;201406;1041;3307;983;3218;148;549;638;2016;786;2565
251597;201406;2006;6205;1926;6081;185;687;1497;4650;1682;5337
251600;201406;7478;22024;7090;21384;964;2856;5234;16199;6198;19055
251610;201406;3673;11063;3398;10700;352;1217;2639;8404;2991;9621
251615;201406;1221;3526;1043;3215;111;403;670;2113;781;2516
251620;201406;17679;50206;15592;47547;2025;6369;11513;35665;13538;42034
251630;201406;5432;13796;4740;12943;410;1155;3738;10331;4148;11486
251640;201406;2717;7876;2217;6974;238;893;1578;4920;1816;5813
251650;201406;4429;12617;3986;12059;341;1099;3261;10041;3602;11140
251660;201406;3619;12137;3324;11673;286;1307;2627;9056;2913;10363
251670;201406;4082;12107;3676;11555;95;322;3320;10503;3415;10825
251675;201406;769;2547;724;2474;166;607;413;1388;579;1995
251680;201406;2913;8152;2380;7368;147;595;1951;5941;2098;6536
251690;201406;3565;11028;3312;10574;336;1203;2387;7559;2723;8762
251700;201406;2157;7074;2035;6909;214;801;1633;5567;1847;6368
251710;201406;959;2521;727;2111;104;366;383;1064;487;1430
251720;201406;1427;4417;1305;4206;123;489;1001;3167;1124;3656
251740;201406;744;2118;606;1871;105;354;356;1116;461;1470
260005;201406;25325;62887;22301;58678;4751;12654;13666;36051;18417;48705
260010;201406;9745;26641;7837;24265;930;3088;5846;18153;6776;21241
260020;201406;5865;17322;5213;16336;586;1758;3825;12489;4411;14247
260030;201406;5408;16406;5020;15821;495;1726;3931;12322;4426;14048
260040;201406;10322;25054;8549;23040;674;1507;7047;19680;7721;21187
260050;201406;11048;35495;10265;34599;657;2257;8947;30543;9604;32800
260060;201406;4125;11502;3778;10948;341;1015;2980;8729;3321;9744
260070;201406;9704;29179;9241;28500;2012;6506;5837;18113;7849;24619
260080;201406;5325;15319;4741;14472;480;1669;3517;10612;3997;12281
260090;201406;5247;14719;4939;14289;1222;3338;3236;9726;4458;13064
260100;201406;3540;9487;3227;9066;249;864;2600;7371;2849;8235
260105;201406;4684;14000;4508;13665;796;2586;3015;9070;3811;11656
260110;201406;22028;64612;20318;62543;1435;4367;17370;54109;18805;58476
260120;201406;11294;35002;10637;33842;2960;9501;5575;18503;8535;28004
260130;201406;3159;9052;2997;8794;486;1307;2134;6460;2620;7767
260140;201406;13612;35046;11637;32617;1182;3596;8970;25508;10152;29104
260150;201406;3158;9224;2818;8733;229;834;2222;6939;2451;7773
260160;201406;6062;18503;5468;17803;519;1779;4458;14783;4977;16562
260170;201406;17932;49298;17183;48317;1431;3710;14253;40745;15684;44455
260180;201406;3518;10880;3220;10454;242;936;2617;8448;2859;9384
260190;201406;16324;39383;15389;38225;896;2372;13368;33241;14264;35613
260200;201406;11496;33103;10487;31615;1166;3681;7788;24297;8954;27978
260210;201406;11531;35718;10618;34401;867;3077;8605;28175;9472;31252
260220;201406;9287;28862;9028;28488;801;3103;7574;23438;8375;26541
260230;201406;9876;29087;9378;28405;694;2126;7708;23811;8402;25937
260240;201406;2961;9246;2615;8751;375;1341;1861;6271;2236;7612
260250;201406;2766;7454;2549;7184;191;567;2088;5923;2279;6490
260260;201406;11699;34180;11364;33723;1050;3356;9277;28105;10327;31461
260270;201406;3581;10863;3354;10528;387;1469;2569;7919;2956;9388
260280;201406;13066;43106;12025;41486;782;2977;10055;35121;10837;38098
260290;201406;34740;105627;33478;103541;5811;20092;22748;69260;28559;89352
260300;201406;8432;25763;7451;24330;589;2397;5900;19199;6489;21596
260310;201406;5192;15567;4880;15088;1523;4361;2514;8435;4037;12796
260320;201406;6973;23440;6506;22757;541;2055;5242;18586;5783;20641
260330;201406;3177;9832;2945;9445;305;1192;1995;6603;2300;7795
260340;201406;1901;5653;1800;5506;102;365;1571;4773;1673;5138
260345;201406;26725;87514;25564;85201;7364;26651;12405;40013;19769;66664
260350;201406;4349;12512;4123;12152;371;1222;3283;9647;3654;10869
260360;201406;2444;7619;2342;7451;490;1692;1420;4543;1910;6235
260370;201406;6154;19068;5588;18065;731;2541;3985;13060;4716;15601
260380;201406;5035;16466;4650;15953;486;1682;3591;12548;4077;14230
260390;201406;4806;15058;4182;14069;499;1886;2992;9910;3491;11796
260392;201406;3566;11300;3340;11010;154;592;2954;9750;3108;10342
260400;201406;14055;41473;13521;40596;2334;7966;9324;27364;11658;35330
260410;201406;63548;188455;60219;182929;19992;61050;28262;89023;48254;150073
260415;201406;4107;13162;3584;12136;525;2097;2209;7386;2734;9483
260420;201406;12237;28752;11172;27619;834;2164;9507;23585;10341;25749
260430;201406;2753;9227;2493;8815;305;1263;1831;6372;2136;7635
260440;201406;3463;10631;3209;10118;589;2015;1949;6035;2538;8050
260450;201406;5228;15936;4981;15513;454;1546;3976;12423;4430;13969
260460;201406;5894;18254;5540;17718;949;3366;3563;11214;4512;14580
260470;201406;5152;14967;4848;14546;513;1591;3866;11815;4379;13406
260480;201406;3998;11725;3567;11076;616;2114;2401;7413;3017;9527
260490;201406;6136;15963;5394;14764;657;2122;3685;10104;4342;12226
260500;201406;6867;18948;6357;18220;736;2216;4675;13594;5411;15810
260510;201406;10625;28011;9867;26976;830;2328;7849;22153;8679;24481
260515;201406;4648;14583;3643;12461;397;1555;2262;7754;2659;9309
260520;201406;16252;44157;15735;43450;3554;9452;10333;29362;13887;38814
260530;201406;10283;30826;9012;29044;577;1733;7675;25227;8252;26960
260540;201406;5864;15234;5536;14872;685;1548;4446;12327;5131;13875
260545;201406;42;162;29;119;4;19;7;27;11;46
260550;201406;2878;9626;2558;9007;649;2553;1194;4154;1843;6707
260560;201406;6838;17581;6122;16565;328;914;5340;14466;5668;15380
260570;201406;6701;23013;6240;22208;938;3694;4383;15702;5321;19396
260580;201406;3966;11005;3748;10668;298;967;3126;8741;3424;9708
260590;201406;6005;15295;5778;15033;257;560;5263;13897;5520;14457
260600;201406;26327;82175;24974;79891;4299;14576;16603;53682;20902;68258
260610;201406;7143;21427;6807;20961;1225;3966;4776;14697;6001;18663
260620;201406;17572;54560;16921;53472;3257;11491;10869;33648;14126;45139
260630;201406;2375;7033;2053;6504;220;832;1523;4777;1743;5609
260640;201406;17672;48704;16716;47348;2335;7020;12064;34175;14399;41195
260650;201406;5637;17732;5281;17132;752;2422;3582;12407;4334;14829
260660;201406;8527;23834;7688;22765;549;1692;6454;19317;7003;21009
260670;201406;2458;6961;2070;6435;293;1032;1402;4365;1695;5397
260680;201406;23627;65073;22199;62624;5029;14781;12487;34982;17516;49763
260690;201406;3648;10093;3150;9308;205;732;2555;7498;2760;8230
260700;201406;5701;16984;5567;16843;93;179;5393;16528;5486;16707
260710;201406;1341;4117;1222;3945;145;558;922;2932;1067;3490
260720;201406;17427;57525;16610;56062;4369;14988;9082;31534;13451;46522
260730;201406;7414;24464;6660;23341;867;3238;4884;17343;5751;20581
260740;201406;1358;4167;1192;3864;182;642;723;2360;905;3002
260750;201406;6804;21770;6362;21160;580;1801;5315;18071;5895;19872
260760;201406;4831;13423;4541;13046;491;1534;3527;10141;4018;11675
260765;201406;8178;28612;7922;28231;1448;5783;5273;18806;6721;24589
260770;201406;4355;11333;3972;10834;256;895;3175;8480;3431;9375
260775;201406;5361;15597;5077;15169;598;2154;3660;10609;4258;12763
260780;201406;4014;13258;3865;12989;929;3474;2256;7495;3185;10969
260790;201406;121433;314568;116842;307927;25784;69848;72701;192272;98485;262120
260795;201406;3053;9851;2838;9512;474;1685;1887;6427;2361;8112
260800;201406;4797;13148;4456;12694;237;957;3853;10688;4090;11645
260805;201406;4143;12129;3730;11483;522;1741;2577;7951;3099;9692
260810;201406;7467;21673;7280;21429;471;1531;6362;18725;6833;20256
260820;201406;4634;13320;4334;12911;1152;3495;2525;7542;3677;11037
260825;201406;3087;9915;2881;9608;300;989;2294;7772;2594;8761
260830;201406;3764;12238;3493;11746;999;3186;1955;6935;2954;10121
260840;201406;4243;12456;3892;11948;291;1131;3230;9756;3521;10887
260845;201406;4274;12678;3985;12115;669;2173;2700;8221;3369;10394
260850;201406;4997;17081;4539;16096;1124;4467;2245;7775;3369;12242
260860;201406;3159;10241;2929;9855;313;1104;2185;7449;2498;8553
260870;201406;4205;11769;3841;11313;523;1431;2881;8729;3404;10160
260875;201406;7458;20043;6741;18921;1071;3053;4451;12884;5522;15937
260880;201406;9289;29390;8823;28746;907;2988;7165;23633;8072;26621
260890;201406;15037;43360;14339;42292;1652;5421;10661;31522;12313;36943
260900;201406;6180;19076;5294;17525;937;3293;3179;10629;4116;13922
260910;201406;3155;9523;2872;9097;260;949;2279;7235;2539;8184
260915;201406;4599;15382;4443;15159;124;410;4103;14218;4227;14628
260920;201406;3501;10663;3329;10432;493;1642;2458;7890;2951;9532
260930;201406;4260;13434;3786;12743;506;1738;2746;9385;3252;11123
260940;201406;15077;42092;13952;40133;2514;8430;8361;23571;10875;32001
260950;201406;6205;19967;5888;19346;872;3659;3771;11655;4643;15314
260960;201406;67983;190808;64476;185176;14095;42216;38146;110631;52241;152847
260970;201406;5417;17457;5074;16942;608;2357;3717;12361;4325;14718
260980;201406;4056;12984;3863;12727;274;939;3262;10965;3536;11904
260990;201406;18351;57319;16999;55523;2093;6516;12852;43768;14945;50284
261000;201406;15849;44549;12892;39777;2730;8865;7025;22226;9755;31091
261010;201406;2808;7857;2632;7633;226;474;2240;6809;2466;7283
261020;201406;6176;18478;5691;17743;451;1740;4585;13914;5036;15654
261030;201406;3518;11576;3340;11274;348;1299;2640;8870;2988;10169
261040;201406;5445;17602;4708;16392;539;2169;3406;11801;3945;13970
261050;201406;8787;25038;8211;24132;1189;3572;5599;16428;6788;20000
261060;201406;11594;35814;11130;35046;1619;5729;8114;25175;9733;30904
261070;201406;51285;132356;46407;125506;10028;27837;27795;76088;37823;103925
261080;201406;5829;17769;5514;17267;427;1287;4623;14736;5050;16023
261090;201406;16631;46602;15544;45133;1620;4781;12347;36303;13967;41084
261100;201406;7436;23911;6872;23013;700;2708;5231;17484;5931;20192
261110;201406;67859;195735;62085;187365;15254;46157;34719;110870;49973;157027
261120;201406;3684;10022;3347;9598;160;480;2944;8510;3104;8990
261130;201406;7195;18737;6884;18388;265;723;6321;16893;6586;17616
261140;201406;3275;9335;3008;8910;551;1802;1897;5540;2448;7342
261150;201406;5761;17128;5196;16309;735;2505;3669;11640;4404;14145
261153;201406;2003;5819;1691;5381;100;387;1386;4427;1486;4814
261160;201406;227302;596355;216833;582024;48976;132009;129607;358434;178583;490443
261170;201406;6141;17197;5679;16541;826;2412;4234;12471;5060;14883
261180;201406;9700;27668;9343;27136;1141;3341;7126;20922;8267;24263
261190;201406;5559;17498;5255;17105;803;3348;3638;11354;4441;14702
261200;201406;4005;9849;3714;9476;578;1452;2672;6945;3250;8397
261210;201406;1990;5292;1914;5193;133;354;1670;4596;1803;4950
261220;201406;13069;42524;11415;38934;2269;8406;6137;20938;8406;29344
261230;201406;4120;12832;3875;12512;160;559;3456;11227;3616;11786
261240;201406;5002;14811;4748;14343;787;2292;3332;10248;4119;12540
261245;201406;3918;12318;3414;11476;271;1138;2526;8547;2797;9685
261247;201406;3572;11038;3088;10137;399;1388;2163;7174;2562;8562
261250;201406;19583;52938;18846;51965;3393;9239;13988;39147;17381;48386
261255;201406;4422;13527;3970;12788;325;1173;3119;10191;3444;11364
261260;201406;12329;35397;11311;34206;693;1925;9854;30381;10547;32306
261270;201406;3850;11197;3584;10785;488;1588;2523;7576;3011;9164
261280;201406;2768;8566;2530;8218;264;975;1916;6216;2180;7191
261290;201406;3105;8842;2794;8449;229;768;2291;6997;2520;7765
261300;201406;10630;35490;9575;33648;1670;6598;6059;21184;7729;27782
261310;201406;8593;26137;8184;25448;1991;6382;4819;15098;6810;21480
261320;201406;6036;18944;5694;18296;633;2002;4334;14239;4967;16241
261330;201406;5537;16463;5346;16182;548;1701;4253;12968;4801;14669
261340;201406;4630;15186;4411;14831;668;2634;2870;9608;3538;12242
261350;201406;8084;27521;7668;26796;659;2789;6016;20855;6675;23644
261360;201406;9550;24857;8690;23695;1177;3313;6135;17057;7312;20370
261370;201406;21152;63137;20004;61411;4154;13337;12732;39278;16886;52615
261380;201406;4215;14600;3923;14092;623;2332;2666;9771;3289;12103
261390;201406;17345;53556;15890;51049;2784;9774;9865;31578;12649;41352
261400;201406;4929;17241;4510;16406;608;2459;3086;11351;3694;13810
261410;201406;8511;24999;8020;24237;1126;3434;5859;18062;6985;21496
261420;201406;8107;27298;7841;26902;1992;7407;4515;15748;6507;23155
261430;201406;3632;11297;3093;10568;413;1415;2268;7946;2681;9361
261440;201406;1691;5191;1567;5000;114;465;1266;4004;1380;4469
261450;201406;14428;41633;14050;41137;877;2676;12537;36784;13414;39460
261460;201406;8516;24616;7972;23859;844;2318;5977;19300;6821;21618
261470;201406;3974;10865;3653;10487;218;677;3147;9010;3365;9687
261480;201406;3528;12953;3297;12531;402;1703;2476;9289;2878;10992
261485;201406;5009;15539;4606;14834;951;3396;2645;8499;3596;11895
261500;201406;5871;16335;5180;15404;630;1673;3980;12334;4610;14007
261510;201406;2066;6544;1939;6358;170;563;1530;5088;1700;5651
261520;201406;2638;8644;2347;8127;197;792;1683;5854;1880;6646
261530;201406;12551;40881;11166;38193;2475;9249;5327;18278;7802;27527
261540;201406;7424;24089;7154;23607;1390;4503;4862;16432;6252;20935
261550;201406;3508;10574;3360;10358;430;1650;2629;7832;3059;9482
261560;201406;6997;22849;6415;22090;1203;4184;4501;15886;5704;20070
261570;201406;3638;11227;3247;10613;487;1658;2220;7318;2707;8976
261580;201406;5896;18817;5284;17830;465;1706;4204;14455;4669;16161
261590;201406;2902;8078;2558;7611;324;1028;1838;5569;2162;6597
261600;201406;5218;14555;4488;13537;506;1606;3357;10246;3863;11852
261610;201406;2304;6996;2002;6552;128;542;1639;5255;1767;5797
261618;201406;2579;7410;2428;7205;261;815;1907;5636;2168;6451
261620;201406;4636;14303;4396;13931;549;1796;3186;10311;3735;12107
261630;201406;8178;24107;7183;22305;1341;4698;3993;12103;5334;16801
261640;201406;30592;80054;28231;77046;2298;6174;23282;64755;25580;70929
261650;201406;3842;12266;3605;11914;495;1786;2657;8815;3152;10601
270010;201406;4460;17120;4082;16348;515;2356;2805;11289;3320;13645
270020;201406;3995;12177;3736;11779;505;1803;2759;8599;3264;10402
270030;201406;45879;139109;43751;135797;11320;35406;25472;80988;36792;116394
270040;201406;10445;32463;9947;31892;1652;4778;7429;24797;9081;29575
270050;201406;4024;11818;3738;11438;425;1546;2859;8637;3284;10183
270060;201406;1699;5618;1613;5495;366;1352;980;3364;1346;4716
270070;201406;4231;13163;3926;12751;201;878;3384;10837;3585;11715
270080;201406;1327;4201;1192;3988;222;814;766;2536;988;3350
270090;201406;2096;6635;2014;6493;69;268;1826;5846;1895;6114
270100;201406;6463;20188;6186;19818;1275;4281;4098;13127;5373;17408
270110;201406;3484;9896;3207;9576;549;1621;2117;6795;2666;8416
270120;201406;3100;9082;2803;8683;154;534;2415;7549;2569;8083
270130;201406;5167;16215;4904;15908;530;1557;3986;13359;4516;14916
270135;201406;1754;5004;1673;4913;119;206;1500;4577;1619;4783
270140;201406;9761;24686;8642;23252;770;2969;6848;17328;7618;20297
270150;201406;2712;9349;2651;9270;206;802;2295;8035;2501;8837
270160;201406;5059;17046;4661;16550;309;1126;3939;14110;4248;15236
270170;201406;4080;13482;3773;13023;833;3286;2114;7235;2947;10521
270180;201406;2321;7699;2068;7373;172;776;1647;5833;1819;6609
270190;201406;1936;6360;1837;6212;149;586;1448;4930;1597;5516
270200;201406;2770;9328;2595;9052;280;1190;1993;6816;2273;8006
270210;201406;4474;14714;4318;14512;421;1669;3602;12021;4023;13690
270220;201406;1731;5460;1605;5216;310;1134;876;2903;1186;4037
270230;201406;11295;37033;9963;34899;1502;6219;6616;22869;8118;29088
270235;201406;6490;21347;6153;20780;392;1641;5136;17256;5528;18897
270240;201406;9836;29822;8703;28337;1488;5045;5877;19392;7365;24437
270250;201406;3560;9112;3242;8754;176;457;2927;7944;3103;8401
270255;201406;5145;15778;4275;14251;405;1688;3031;9953;3436;11641
270260;201406;6373;20711;6210;20426;882;3287;4611;15273;5493;18560
270270;201406;1221;3541;1129;3403;169;539;745;2205;914;2744
270280;201406;3744;11108;3509;10770;470;1655;2519;7594;2989;9249
270290;201406;8486;29909;8066;29167;886;3707;6247;22470;7133;26177
270300;201406;3304;11513;3134;11312;182;783;2713;9834;2895;10617
270310;201406;7405;22963;6679;21719;446;1977;5415;17206;5861;19183
270320;201406;6465;21035;6256;20679;1552;5757;3544;11799;5096;17556
270330;201406;4913;16235;4632;15855;464;1695;3719;12865;4183;14560
270340;201406;1810;5615;1632;5378;199;696;1229;4132;1428;4828
270350;201406;2099;5858;1946;5668;285;829;1329;4114;1614;4943
270360;201406;2097;6602;2048;6541;250;766;1676;5493;1926;6259
270370;201406;1735;5661;1603;5430;185;712;1089;3818;1274;4530
270375;201406;2948;9041;2732;8727;412;1567;1895;5859;2307;7426
270380;201406;6080;18618;5763;18174;639;2017;4449;14358;5088;16375
270390;201406;1458;3998;1310;3810;205;682;900;2537;1105;3219
270400;201406;6002;18651;5501;17883;511;1983;3942;12608;4453;14591
270410;201406;5098;15792;4857;15340;608;2137;3562;11136;4170;13273
270420;201406;5569;18326;5418;18115;296;1385;4569;15026;4865;16411
270430;201406;142298;416683;136322;408276;35594;107348;77472;239660;113066;347008
270440;201406;5108;15699;4812;15257;391;1433;3810;12179;4201;13612
270450;201406;6630;20815;6414;20533;601;2204;5137;16503;5738;18707
270460;201406;3673;10066;3307;9564;260;918;2697;7668;2957;8586
270470;201406;10952;35764;10439;34880;1591;5262;7178;24740;8769;30002
270480;201406;3123;9966;2881;9530;366;1462;1904;6079;2270;7541
270490;201406;1000;3224;944;3142;95;382;715;2351;810;2733
270500;201406;5434;18687;5243;18414;490;1779;4214;15159;4704;16938
270510;201406;6145;19002;5623;18276;899;3724;4050;12530;4949;16254
270520;201406;3771;12247;3545;11885;897;3259;1906;6478;2803;9737
270530;201406;1571;4618;1392;4388;211;656;960;3134;1171;3790
270540;201406;2087;7197;1924;6955;182;839;1521;5411;1703;6250
270550;201406;7145;21674;6345;20612;1078;3607;4226;14141;5304;17748
270560;201406;3061;9632;2892;9360;523;1966;1983;6237;2506;8203
270570;201406;4423;14437;4050;13852;504;2042;2791;9527;3295;11569
270580;201406;2081;6943;2002;6815;287;1037;1489;5132;1776;6169
270590;201406;1422;4831;1335;4680;82;354;1160;4054;1242;4408
270600;201406;2931;9832;2650;9400;243;1188;2023;6981;2266;8169
270610;201406;3283;10434;3050;10092;330;1177;2397;7913;2727;9090
270620;201406;1490;5047;1358;4849;158;718;1034;3601;1192;4319
270630;201406;18548;51958;17378;50144;2533;7386;12567;36814;15100;44200
270640;201406;6013;18671;5446;17968;463;1886;4421;14355;4884;16241
270642;201406;2515;8656;2349;8387;402;1590;1550;5588;1952;7178
270644;201406;2440;7163;2205;6903;173;501;1901;6057;2074;6558
270650;201406;4123;13157;3962;12933;866;3392;2373;7477;3239;10869
270660;201406;2459;6407;1991;5686;153;529;1418;4006;1571;4535
270670;201406;16100;43601;14036;41127;1768;5265;10471;31603;12239;36868
270680;201406;4216;12947;4075;12778;220;624;3633;11552;3853;12176
270690;201406;9087;25816;8443;25045;2751;7779;4269;13569;7020;21348
270700;201406;799;2500;757;2432;139;540;482;1499;621;2039
270710;201406;5821;19497;5583;19174;634;2277;4448;15434;5082;17711
270720;201406;3411;11603;3153;11158;261;1207;2531;8823;2792;10030
270730;201406;6722;20834;6389;20419;959;3075;4848;15776;5807;18851
270740;201406;2418;7142;2272;6932;369;1253;1520;4586;1889;5839
270750;201406;4894;15866;4567;15366;531;1905;3504;11833;4035;13738
270760;201406;3603;10822;3259;10252;397;1338;2397;7574;2794;8912
270770;201406;18207;49630;15583;46414;2986;9237;9849;30084;12835;39321
270780;201406;1969;6397;1834;6191;261;946;1298;4429;1559;5375
270790;201406;1737;5480;1587;5238;384;1367;869;2850;1253;4217
270800;201406;11469;34577;10753;33635;1026;3441;8725;27390;9751;30831
270810;201406;3464;10708;2843;9576;377;1469;1786;6019;2163;7488
270820;201406;1905;6445;1741;6149;270;1090;1163;4089;1433;5179
270830;201406;5482;16781;4998;16156;1076;3873;3118;10139;4194;14012
270840;201406;7609;25989;6932;25132;478;2252;5796;20799;6274;23051
270850;201406;7633;25278;7465;25074;1381;5608;5209;16774;6590;22382
270860;201406;11721;35405;10974;34381;1663;6061;8050;24677;9713;30738
270870;201406;2320;6882;1890;5972;308;1023;1142;3625;1450;4648
270880;201406;7917;25973;7478;25326;550;2371;6176;20607;6726;22978
270890;201406;2689;8213;2498;7896;407;1499;1743;5390;2150;6889
270895;201406;3060;11361;2907;11161;251;1025;2408;9386;2659;10411
270900;201406;1940;5320;1583;4805;107;413;1211;3588;1318;4001
270910;201406;3278;11491;3211;11358;336;1537;2565;8809;2901;10346
270915;201406;10062;34349;9141;32673;1803;7383;5287;18705;7090;26088
270920;201406;6483;20311;6093;19766;302;1373;5340;17127;5642;18500
270930;201406;17330;47619;14433;44000;2774;8978;8645;26999;11419;35977
270940;201406;5930;20165;5694;19884;695;2729;4374;15320;5069;18049
280010;201406;720;2145;631;2001;73;292;409;1271;482;1563
280020;201406;5090;15202;4514;14151;914;2986;2772;8738;3686;11724
280030;201406;75240;200719;67014;188357;16741;49129;34812;99503;51553;148632
280040;201406;3224;10115;2894;9652;369;1244;2134;7341;2503;8585
280050;201406;4157;13422;3881;12992;1129;3852;2008;7015;3137;10867
280060;201406;4341;14628;4159;14319;889;3293;2526;8786;3415;12079
280067;201406;7696;22011;6550;20452;744;2522;4863;15200;5607;17722
280070;201406;1927;6656;1839;6520;321;1222;1306;4670;1627;5892
280100;201406;4107;12930;3676;12158;988;3349;1806;6161;2794;9510
280110;201406;1447;4389;1332;4202;87;343;1097;3436;1184;3779
280120;201406;8055;25466;7465;24546;1202;3601;5253;18206;6455;21807
280130;201406;8048;23127;7510;22346;1279;4226;5033;14921;6312;19147
280140;201406;5628;15570;5096;14853;575;1699;3949;11639;4524;13338
280150;201406;3443;10722;3174;10232;490;1869;2064;6402;2554;8271
280160;201406;1553;4427;1400;4197;176;602;1021;3042;1197;3644
280170;201406;4736;14205;4311;13628;507;1519;3361;10978;3868;12497
280190;201406;1180;3386;1045;3170;98;386;752;2189;850;2575
280200;201406;1111;3498;1041;3380;170;674;718;2236;888;2910
280210;201406;12974;41184;12365;40301;2481;8183;8168;27411;10649;35594
280220;201406;1599;4906;1518;4790;103;387;1301;4093;1404;4480
280230;201406;3910;11543;3517;10885;695;2172;2104;6732;2799;8904
280240;201406;3552;10590;3240;10105;276;825;2563;8114;2839;8939
280250;201406;814;2184;713;2032;138;459;426;1113;564;1572
280260;201406;2104;5548;1923;5323;121;325;1668;4657;1789;4982
280270;201406;2269;7087;1989;6625;136;529;1553;5111;1689;5640
280280;201406;4136;13716;3845;13235;914;2670;2176;8373;3090;11043
280290;201406;17175;54904;15698;52448;2791;9943;10274;34836;13065;44779
280300;201406;10186;31089;9445;30241;815;2673;7835;25489;8650;28162
280310;201406;1464;4149;1279;3865;120;459;868;2532;988;2991
280320;201406;8061;26790;7461;25709;1460;5580;4041;13953;5501;19533
280330;201406;4784;13594;4478;13190;587;1892;3439;10095;4026;11987
280340;201406;3846;11460;3656;11209;342;1124;2908;9114;3250;10238
280350;201406;21920;64076;20387;61815;2864;8815;14640;45241;17504;54056
280360;201406;5979;19073;5654;18566;1169;4299;3441;11184;4610;15483
280370;201406;1990;5690;1810;5405;214;734;1337;3923;1551;4657
280380;201406;1023;3124;946;3026;103;394;735;2322;838;2716
280390;201406;3303;9780;2889;9038;622;1842;1759;5636;2381;7478
280400;201406;4532;13043;4135;12510;951;2749;2598;8242;3549;10991
280410;201406;2444;7964;2167;7437;388;1518;1294;4327;1682;5845
280420;201406;4293;12444;3987;11974;260;807;3433;10396;3693;11203
280430;201406;2291;5988;2116;5772;157;515;1767;4803;1924;5318
280440;201406;5114;15049;4769;14627;482;1446;3947;12305;4429;13751
280445;201406;2465;7129;2274;6797;111;424;1870;5494;1981;5918
280450;201406;9212;24878;8507;24048;744;1712;7169;21017;7913;22729
280460;201406;7192;19478;6420;18407;1023;3028;4508;13228;5531;16256
280470;201406;1860;5577;1686;5320;201;652;1266;4036;1467;4688
280480;201406;31391;95037;30211;93325;5113;17966;20459;62035;25572;80001
280490;201406;3788;11667;3398;10934;398;1431;2449;7835;2847;9266
280500;201406;867;2331;818;2270;24;74;738;2034;762;2108
280510;201406;2776;8177;2398;7675;311;1106;1778;5747;2089;6853
280520;201406;1761;5034;1617;4846;184;489;1276;3975;1460;4464
280530;201406;2166;6594;2056;6452;238;796;1633;5201;1871;5997
280540;201406;9350;25403;8749;24597;342;1142;7817;21867;8159;23009
280550;201406;6674;18300;5854;16990;623;2061;4305;12362;4928;14423
280560;201406;8022;23718;7564;22982;631;2034;6126;18627;6757;20661
280570;201406;6907;19262;6229;18383;872;2885;4371;12851;5243;15736
280580;201406;5497;17059;4701;15695;856;2905;2985;10255;3841;13160
280590;201406;2415;7345;2218;7109;288;1190;1609;5078;1897;6268
280600;201406;4045;12503;3809;12099;416;1563;2767;8681;3183;10244
280610;201406;2391;6982;2239;6757;317;1081;1535;4576;1852;5657
280620;201406;5246;16081;4672;14990;794;2574;3060;10018;3854;12592
280630;201406;3829;12593;3668;12343;398;1181;2931;10265;3329;11446
280640;201406;2294;6599;2152;6436;106;245;1961;5983;2067;6228
280650;201406;1164;3604;1055;3407;176;626;705;2288;881;2914
280660;201406;2671;7806;2563;7643;298;955;2108;6231;2406;7186
280670;201406;14923;39789;14073;38640;1602;4670;10693;29331;12295;34001
280680;201406;2861;7617;2449;7046;149;488;2070;5952;2219;6440
280690;201406;1023;2925;881;2719;139;465;580;1757;719;2222
280700;201406;1193;3500;1038;3268;102;308;767;2465;869;2773
280710;201406;11081;30344;10352;29471;749;2015;8851;25441;9600;27456
280720;201406;2436;6689;2176;6383;222;658;1661;4977;1883;5635
280730;201406;959;2902;920;2848;82;252;777;2441;859;2693
280740;201406;13020;35754;11350;33297;1821;5142;7708;23299;9529;28441
280750;201406;3648;11273;3350;10745;328;1272;2419;7681;2747;8953
280760;201406;5845;18150;5356;17507;704;2224;3982;13591;4686;15815
290010;201406;3056;6860;2237;5603;79;324;1781;4207;1860;4531
290020;201406;5019;15848;4586;15406;395;1111;3997;13794;4392;14905
290030;201406;3293;10512;3164;10310;437;1539;2395;7744;2832;9283
290035;201406;4667;12524;4186;11899;304;912;3472;10026;3776;10938
290040;201406;3834;11143;3491;10735;278;1083;2855;8642;3133;9725
290050;201406;2738;8975;2555;8696;252;969;1961;6706;2213;7675
290060;201406;1339;3462;1121;3202;209;688;787;2176;996;2864
290070;201406;31389;82523;27262;77321;5837;16731;15220;45357;21057;62088
290080;201406;5959;18345;5273;17462;649;2160;3989;13582;4638;15742
290090;201406;2289;5078;1836;4603;201;496;1514;3868;1715;4364
290100;201406;10290;29653;9106;27697;1706;5151;5523;17545;7229;22696
290110;201406;5323;16138;5125;15808;876;2987;3504;10659;4380;13646
290115;201406;4983;14931;4402;14159;344;1188;3440;11255;3784;12443
290120;201406;6911;18908;6395;18261;429;1215;5541;15926;5970;17141
290130;201406;4590;12138;3974;11404;338;1034;3231;9254;3569;10288
290135;201406;5261;13545;4602;12512;461;1510;3138;8405;3599;9915
290140;201406;4042;12985;3556;12362;332;1226;2944;10283;3276;11509
290150;201406;2123;6347;2028;6221;181;574;1703;5244;1884;5818
290160;201406;3551;9702;3466;9599;302;570;3065;8781;3367;9351
290170;201406;2861;9604;2635;9246;259;1019;2161;7597;2420;8616
290180;201406;3094;8853;2714;8288;288;986;1997;6129;2285;7115
290190;201406;4184;13878;4047;13643;448;1564;3076;10495;3524;12059
290195;201406;2227;6239;1907;5761;147;524;1501;4553;1648;5077
290200;201406;3900;12526;3573;11955;382;1350;2717;9152;3099;10502
290205;201406;2987;9366;2737;8970;375;1486;1965;6289;2340;7775
290210;201406;15838;43832;14767;42541;2624;6362;10321;32125;12945;38487
290220;201406;2447;7448;2344;7289;287;1056;1711;5189;1998;6245
290225;201406;3083;8270;2892;8066;186;369;2589;7453;2775;7822
290230;201406;2374;7897;2319;7825;231;816;1929;6576;2160;7392
290240;201406;3915;10410;3534;9877;380;1140;2652;7322;3032;8462
290250;201406;3858;12247;3285;11357;286;1051;2539;8889;2825;9940
290260;201406;4892;14820;4435;14125;455;1606;3465;11046;3920;12652
290265;201406;3438;11128;3232;10765;319;1227;2475;8248;2794;9475
290270;201406;12255;44932;11546;43870;1553;6182;8575;33208;10128;39390
290280;201406;5219;17375;4942;16864;600;2139;3581;12509;4181;14648
290290;201406;9731;31530;8907;30178;1610;5581;5893;20459;7503;26040
290300;201406;4334;12550;3157;10341;294;908;2166;7394;2460;8302
290310;201406;1542;4735;1441;4587;242;870;963;3021;1205;3891
290320;201406;27281;83857;24250;79820;5416;18852;14505;48532;19921;67384
290323;201406;4143;11166;3426;10401;216;760;2945;8910;3161;9670
290327;201406;4105;13155;3761;12504;563;1977;2577;8583;3140;10560
290330;201406;1926;5099;1841;5006;236;722;1500;4027;1736;4749
290340;201406;5103;16165;4727;15665;1131;3781;2741;9333;3872;13114
290350;201406;5040;15279;4164;14092;577;1978;2870;10003;3447;11981
290360;201406;4322;13602;3828;12913;225;790;3255;11161;3480;11951
290370;201406;4596;13730;4246;13286;457;1433;3459;10979;3916;12412
290380;201406;5602;16502;4957;15579;429;1459;3966;12495;4395;13954
290390;201406;15403;49172;14539;47746;2985;9388;9070;31365;12055;40753
290395;201406;2808;9107;2541;8648;244;982;1909;6510;2153;7492
290400;201406;3701;11320;3286;10747;394;1353;2471;8128;2865;9481
290405;201406;4531;14559;3949;13525;497;1761;2658;9363;3155;11124
290410;201406;6094;18198;5147;16808;578;2312;3711;11834;4289;14146
290420;201406;3374;9976;2805;9168;274;1032;2200;7141;2474;8173
290430;201406;3564;11207;3203;10657;679;2336;1968;6702;2647;9038
290440;201406;3128;8245;2538;7467;248;787;2000;5961;2248;6748
290450;201406;3634;10636;3209;10031;569;1784;2092;6674;2661;8458
290460;201406;13644;41773;12670;40156;3718;12485;5792;18307;9510;30792
290470;201406;4826;13439;3791;12055;823;2912;2036;6597;2859;9509
290475;201406;4992;17637;4559;16872;552;2224;3307;12424;3859;14648
290480;201406;2639;6904;2343;6517;361;1051;1601;4530;1962;5581
290485;201406;4882;15682;4370;14926;472;2055;3405;11482;3877;13537
290490;201406;8213;22129;7928;21746;746;2189;6528;17886;7274;20075
290500;201406;4671;14947;4016;13732;831;3047;2027;6907;2858;9954
290510;201406;3491;10208;3063;9613;244;894;2446;7718;2690;8612
290515;201406;2927;9115;2732;8817;277;871;2077;6910;2354;7781
290520;201406;11852;36839;9679;32820;1104;4440;6146;20689;7250;25129
290530;201406;5333;15435;4565;14343;420;1359;3647;11536;4067;12895
290540;201406;3975;11547;3787;11308;440;1230;2993;9170;3433;10400
290550;201406;4433;12012;3917;11383;166;471;3520;10304;3686;10775
290560;201406;6244;18529;5528;17492;1194;4056;3283;10542;4477;14598
290570;201406;40814;118972;38365;115326;4892;15808;28290;84520;33182;100328
290580;201406;7393;25886;7088;25415;1456;5107;4744;17649;6200;22756
290590;201406;7634;24212;6412;22183;464;1916;5026;17332;5490;19248
290600;201406;18247;56786;17193;55155;2903;9143;11562;38503;14465;47646
290610;201406;2416;8402;2049;7678;206;973;1498;5506;1704;6479
290620;201406;7251;21625;6510;20560;505;1741;5367;17027;5872;18768
290630;201406;8268;22410;7299;21376;827;2385;5923;17583;6750;19968
290640;201406;2728;8097;2278;7337;243;840;1619;5242;1862;6082
290650;201406;11912;35507;11248;34519;2865;8746;6711;21274;9576;30020
290660;201406;3767;10468;3115;9534;221;775;2456;7549;2677;8324
290670;201406;6739;21147;6185;20294;857;2706;4661;15800;5518;18506
290680;201406;10500;31286;9686;30316;601;1991;8219;25938;8820;27929
290682;201406;4489;13314;4045;12699;204;802;3361;10461;3565;11263
290685;201406;3345;8597;2509;7424;312;984;1552;4712;1864;5696
290687;201406;8304;22541;6587;20437;1279;4221;3981;12655;5260;16876
290689;201406;3172;9106;2691;8348;248;806;2112;6629;2360;7435
290690;201406;5520;16229;5062;15640;564;1817;4017;12501;4581;14318
290700;201406;2262;7168;2169;7034;219;786;1696;5522;1915;6308
290710;201406;7816;25015;7239;24119;468;1547;6244;21040;6712;22587
290720;201406;18958;55961;16934;53485;1846;5311;13730;44733;15576;50044
290730;201406;7396;20753;6741;19907;1255;3614;4537;13693;5792;17307
290740;201406;945;2860;808;2632;123;409;515;1719;638;2128
290750;201406;10293;29682;8936;27243;1675;5931;5042;14572;6717;20503
290755;201406;2438;6918;2048;6269;129;475;1596;4860;1725;5335
290760;201406;4503;13363;3690;12152;377;1210;2706;9038;3083;10248
290770;201406;2623;9205;2439;8963;139;634;2000;7404;2139;8038
290780;201406;8991;23558;7983;22181;881;2111;6115;17635;6996;19746
290790;201406;4735;14224;4404;13752;446;1330;3466;11176;3912;12506
290800;201406;7454;16286;5707;14426;871;1930;4322;11418;5193;13348
290810;201406;4982;15995;4345;14999;335;1282;3300;11522;3635;12804
290820;201406;5516;15890;4952;15129;487;1648;3837;11760;4324;13408
290830;201406;4198;12020;3947;11620;291;1143;3137;8956;3428;10099
290840;201406;17942;50991;16389;48840;2548;7280;11526;35780;14074;43060
290850;201406;6771;20373;6634;20168;1155;3397;4931;15460;6086;18857
290860;201406;4858;17381;4613;17063;708;2651;3412;12970;4120;15621
290870;201406;4836;14568;4073;13535;437;1741;3003;9893;3440;11634
290880;201406;1415;3966;1170;3584;105;326;809;2515;914;2841
290890;201406;6924;18694;6105;17767;721;2110;4794;14122;5515;16232
290900;201406;2477;7304;1882;6324;289;1085;1009;3366;1298;4451
290910;201406;4882;13613;4200;12627;270;882;3492;10557;3762;11439
290920;201406;4844;14434;4366;13784;330;923;3590;11574;3920;12497
290930;201406;7476;24251;6756;22993;782;3001;4861;16397;5643;19398
290940;201406;3604;11467;3366;11162;280;895;2861;9709;3141;10604
290950;201406;1578;4481;1431;4267;211;650;987;2983;1198;3633
290960;201406;6063;17310;5554;16642;418;1274;4506;13681;4924;14955
290970;201406;3745;12190;3422;11615;484;1643;2274;7978;2758;9621
290980;201406;10754;32106;9485;29628;2676;8739;3907;12171;6583;20910
290990;201406;9308;28109;8258;26402;931;3145;6230;19938;7161;23083
291000;201406;3239;9833;2983;9500;369;1190;2328;7559;2697;8749
291005;201406;13967;39065;12569;37059;2104;6500;8511;25471;10615;31971
291010;201406;3140;10176;2533;8818;321;1216;1606;5618;1927;6834
291020;201406;1425;3781;1096;3202;132;465;658;1847;790;2312
291030;201406;2192;6196;1729;5237;176;596;1115;3296;1291;3892
291040;201406;5653;17641;5199;16990;695;2453;3827;12574;4522;15027
291050;201406;8062;26985;7390;25708;1966;7373;3821;13284;5787;20657
291060;201406;6326;23325;6014;22922;896;3865;4340;16478;5236;20343
291070;201406;16319;48539;14961;46597;1767;5380;11202;35704;12969;41084
291072;201406;22159;68642;19045;62482;6176;21384;7340;24962;13516;46346
291075;201406;5367;15497;4862;14821;404;1109;3738;11828;4142;12937
291077;201406;1562;4568;1310;4180;157;573;877;2774;1034;3347
291080;201406;83403;258259;74875;242748;22835;76564;29866;96090;52701;172654
291085;201406;5810;15576;5069;14579;583;1740;3938;11436;4521;13176
291090;201406;1475;3738;1301;3514;105;416;1059;2745;1164;3161
291100;201406;2737;7237;2266;6747;118;458;1904;5648;2022;6106
291110;201406;5076;18313;4568;17517;660;2849;3162;12058;3822;14907
291120;201406;7670;20709;7197;20039;946;2705;5447;15258;6393;17963
291125;201406;1735;3763;1399;3407;153;380;1051;2648;1204;3028
291130;201406;3013;9299;2639;8672;261;1011;1883;6125;2144;7136
291140;201406;4157;12587;3854;12030;553;1800;2686;8433;3239;10233
291150;201406;2013;5281;1917;5165;188;526;1480;3970;1668;4496
291160;201406;5618;17277;4953;16264;1177;3965;2873;9529;4050;13494
291165;201406;2506;7341;2001;6394;143;606;1431;4432;1574;5038
291170;201406;21058;54863;18217;51333;1189;3956;14554;40780;15743;44736
291180;201406;6606;17455;5360;15679;635;2036;3812;11075;4447;13111
291185;201406;3935;10722;3669;10366;315;969;3050;8571;3365;9540
291190;201406;7497;21104;6749;20185;834;2420;5177;15937;6011;18357
291200;201406;2697;8278;2253;7462;181;646;1664;5554;1845;6200
291210;201406;7610;18059;6614;16930;565;1514;5320;13677;5885;15191
291220;201406;4262;13614;4014;13194;575;2102;2874;9355;3449;11457
291230;201406;4038;10579;3636;10111;132;323;3303;9296;3435;9619
291240;201406;4900;13324;4146;12013;269;829;3295;9449;3564;10278
291250;201406;3815;11476;3018;10130;328;1133;2086;7109;2414;8242
291260;201406;1183;3496;1104;3382;111;380;852;2605;963;2985
291270;201406;4410;14681;4109;14127;1034;3728;2385;8304;3419;12032
291280;201406;2474;6438;1876;5648;465;1443;1060;3200;1525;4643
291290;201406;6011;16965;5413;16216;892;2691;3557;10950;4449;13641
291300;201406;4563;13420;3830;12197;493;1748;2606;8251;3099;9999
291310;201406;5492;15806;4837;14721;436;1391;3716;11326;4152;12717
291320;201406;6110;19758;5325;18276;1352;5083;2734;9269;4086;14352
291330;201406;1675;5142;1570;4977;224;822;1023;3132;1247;3954
291340;201406;3962;11697;3188;10600;313;1188;2486;8239;2799;9427
291345;201406;3569;11708;3370;11486;225;742;2960;10303;3185;11045
291350;201406;6184;18277;5512;17243;534;1774;3927;12490;4461;14264
291360;201406;36088;104813;33665;101269;7913;23400;20960;65308;28873;88708
291370;201406;9178;26859;8784;26334;971;2820;6786;20883;7757;23703
291380;201406;3880;12043;3394;11244;295;993;2500;8514;2795;9507
291390;201406;10612;29581;9682;28481;1385;3920;7364;22030;8749;25950
291400;201406;17235;45422;14089;41221;2382;6966;9075;27658;11457;34624
291410;201406;3344;8768;2478;7510;196;791;1851;5460;2047;6251
291420;201406;2283;6040;2019;5724;112;319;1806;5163;1918;5482
291430;201406;3394;10023;3007;9515;242;958;2375;7417;2617;8375
291440;201406;6167;19566;5302;18029;553;2001;4046;13940;4599;15941
291450;201406;7768;23828;6982;22658;360;1166;5809;19262;6169;20428
291460;201406;13564;41284;12098;39077;2228;7714;7814;25417;10042;33131
291465;201406;8368;24292;7611;23424;823;2773;6096;18781;6919;21554
291470;201406;15918;44221;14096;41976;1391;3976;10817;33448;12208;37424
291480;201406;36021;97857;32109;92452;5089;16180;21151;60730;26240;76910
291490;201406;4428;14747;4335;14620;441;1492;3617;12353;4058;13845
291500;201406;4249;12381;3671;11562;296;1090;2925;9176;3221;10266
291510;201406;3661;11253;3382;10885;146;475;3050;9917;3196;10392
291520;201406;4146;11236;3645;10562;515;1418;2491;7551;3006;8969
291530;201406;2130;6208;1819;5724;463;1543;937;3033;1400;4576
291535;201406;4406;12833;3975;12200;358;1133;3034;9651;3392;10784
291540;201406;2257;5446;1930;5104;177;380;1632;4454;1809;4834
291550;201406;5728;15491;5151;14704;1255;3553;2921;8487;4176;12040
291560;201406;17499;44703;13618;40312;1391;4175;10480;31863;11871;36038
291570;201406;2470;6631;2349;6485;157;385;2090;5887;2247;6272
291580;201406;5990;18362;5340;17370;732;2821;3632;11821;4364;14642
291590;201406;2028;6298;1820;5957;301;1029;1188;4032;1489;5061
291600;201406;5597;15580;4190;13518;988;3521;2102;6679;3090;10200
291610;201406;5253;15726;5101;15524;379;1244;4340;13291;4719;14535
291620;201406;3122;7435;2581;6862;192;466;2055;5672;2247;6138
291630;201406;3215;8080;2807;7616;277;696;2298;6384;2575;7080
291640;201406;17983;49359;14951;45322;4006;12946;6440;19822;10446;32768
291650;201406;8284;24618;7613;23822;710;1778;6385;20768;7095;22546
291660;201406;2380;6329;2110;5952;259;888;1445;3897;1704;4785
291670;201406;2514;7022;2320;6719;389;1133;1371;4260;1760;5393
291680;201406;5039;14380;4538;13580;1137;3760;2210;6856;3347;10616
291685;201406;4605;11674;3961;10868;517;1346;2904;8288;3421;9634
291690;201406;4096;11233;3392;10134;323;959;2410;7284;2733;8243
291700;201406;9641;30084;8891;28863;1051;3502;6601;21825;7652;25327
291710;201406;6078;16202;5273;15169;950;2840;3263;9866;4213;12706
291720;201406;3864;13518;3515;12782;397;1673;2563;9182;2960;10855
291730;201406;6018;19103;5608;18560;1038;3553;3888;13199;4926;16752
291733;201406;2655;7832;2260;7316;307;1057;1528;4994;1835;6051
291735;201406;2473;7170;2117;6627;136;506;1749;5431;1885;5937
291740;201406;4060;11865;3235;10601;346;1306;2301;7524;2647;8830
291750;201406;22527;59136;17810;52057;3873;11774;9690;28808;13563;40582
291760;201406;12496;39711;11438;37829;4259;15357;4479;14820;8738;30177
291770;201406;8176;23735;7364;22346;1210;3982;4855;14560;6065;18542
291780;201406;4384;13544;4114;13055;476;1521;3141;10012;3617;11533
291790;201406;2548;7958;2404;7761;133;544;2064;6602;2197;7146
291800;201406;32183;93622;29151;89307;5770;18275;18289;57485;24059;75760
291810;201406;10998;31274;9415;29365;662;2329;7662;24093;8324;26422
291820;201406;3720;11125;3361;10602;326;1046;2630;8380;2956;9426
291830;201406;4431;12021;4147;11613;508;1495;3166;8911;3674;10406
291835;201406;6200;19458;5104;17632;1173;4349;3050;10539;4223;14888
291840;201406;50300;137554;42788;129438;5324;15450;32976;102928;38300;118378
291845;201406;3005;8742;2704;8395;221;614;2364;7473;2585;8087
291850;201406;4855;13663;4075;12570;462;1380;3061;9716;3523;11096
291855;201406;1729;4555;1495;4253;195;670;1097;3025;1292;3695
291860;201406;2096;6252;1798;5676;190;650;1163;3668;1353;4318
291870;201406;1409;3818;1103;3270;117;440;714;2095;831;2535
291875;201406;2924;9314;2633;8862;239;1001;1893;6254;2132;7255
291880;201406;4763;15148;4510;14748;339;1136;3780;12465;4119;13601
291890;201406;1440;3634;1226;3378;297;840;739;2099;1036;2939
291900;201406;1344;3813;1148;3507;116;417;879;2660;995;3077
291905;201406;2997;7934;2503;7145;227;730;1787;5157;2014;5887
291910;201406;2693;7338;2315;6880;180;649;1898;5596;2078;6245
291915;201406;6774;21072;6043;19662;500;1674;4959;16362;5459;18036
291920;201406;32922;97297;30463;93666;6235;19678;18564;58601;24799;78279
291930;201406;2594;7712;2346;7328;244;861;1746;5447;1990;6308
291940;201406;3619;10364;2721;8775;413;1496;1548;4853;1961;6349
291950;201406;9395;31721;8537;30318;1926;6808;4814;17689;6740;24497
291955;201406;8820;28165;8435;27583;2029;6548;5045;17176;7074;23724
291960;201406;3429;10166;2908;9420;343;1034;2087;7114;2430;8148
291970;201406;4433;13357;3947;12739;588;2018;2750;8947;3338;10965
291980;201406;11574;33560;8871;29667;968;3401;6331;21683;7299;25084
291990;201406;2199;7065;2026;6797;201;700;1539;5288;1740;5988
291992;201406;2851;8839;2785;8703;445;1462;2028;6316;2473;7778
291995;201406;2159;6379;1926;6041;244;804;1437;4563;1681;5367
292000;201406;2413;7188;2184;6853;397;1384;1447;4522;1844;5906
292010;201406;6503;16694;4983;14462;488;1446;3815;11134;4303;12580
292020;201406;4551;15372;4223;14840;690;2537;2944;10533;3634;13070
292030;201406;2268;7065;2015;6708;263;942;1303;4392;1566;5334
292040;201406;4680;13072;4147;12514;334;886;3515;11017;3849;11903
292045;201406;2674;9348;2646;9304;86;277;2510;8860;2596;9137
292050;201406;6462;20224;5692;18693;575;2299;3892;12581;4467;14880
292060;201406;11256;31486;10667;30732;1029;2961;8752;25352;9781;28313
292070;201406;4428;14141;4313;13991;414;1202;3654;12063;4068;13265
292080;201406;3723;9813;3216;9163;294;865;2602;7498;2896;8363
292090;201406;4346;11561;3725;10857;341;1135;3026;8855;3367;9990
292100;201406;11129;30929;9542;28805;2556;7956;4887;15389;7443;23345
292105;201406;3235;9916;2805;9304;233;915;2242;7419;2475;8334
292110;201406;7162;18952;5500;16485;1187;3608;3181;9817;4368;13425
292120;201406;8742;24542;7780;22848;1628;4831;4161;12959;5789;17790
292130;201406;3200;8635;2860;8157;554;1490;1907;5603;2461;7093
292140;201406;5555;14403;4823;13428;691;1868;3305;9601;3996;11469
292145;201406;2716;8356;2476;7986;214;668;1877;6340;2091;7008
292150;201406;13703;41862;12714;40291;924;3270;10000;32089;10924;35359
292160;201406;2798;8041;2414;7531;173;504;2043;6527;2216;7031
292170;201406;9103;26815;7765;24520;1180;4077;4881;15645;6061;19722
292180;201406;3584;10342;2886;9247;452;1449;1859;6078;2311;7527
292190;201406;3403;9569;2889;8829;575;1832;1845;5735;2420;7567
292200;201406;6222;20609;5506;19187;1635;6079;2298;8041;3933;14120
292205;201406;4000;12502;3663;12043;278;1069;2953;9704;3231;10773
292210;201406;6758;19144;5829;17907;564;1796;4543;14294;5107;16090
292220;201406;1925;5466;1817;5303;368;1015;1130;3337;1498;4352
292225;201406;3131;9758;2885;9399;191;685;2384;7852;2575;8537
292230;201406;6293;19118;6021;18693;635;2412;4592;13855;5227;16267
292240;201406;4519;14326;4167;13571;635;2238;2632;8489;3267;10727
292250;201406;5332;16507;4980;15863;1072;3550;2728;8723;3800;12273
292260;201406;3185;9834;3038;9612;307;1021;2434;7728;2741;8749
292265;201406;2895;9491;2622;9007;190;787;2015;6863;2205;7650
292270;201406;4053;10911;3306;10029;249;922;2713;8195;2962;9117
292273;201406;2837;6906;2184;6089;289;760;1586;4651;1875;5411
292275;201406;1921;5025;1767;4792;199;599;1353;3649;1552;4248
292280;201406;2101;6241;1907;6030;198;482;1490;5048;1688;5530
292285;201406;2650;7466;2349;7036;218;729;1830;5568;2048;6297
292290;201406;7521;22517;6306;20903;453;1741;4975;16715;5428;18456
292300;201406;8644;26552;7586;25369;1946;6622;4662;16075;6608;22697
292303;201406;2872;8991;2683;8735;129;484;2317;7544;2446;8028
292305;201406;3195;8697;3040;8493;125;380;2725;7637;2850;8017
292310;201406;6035;17967;5490;17222;252;893;4641;14612;4893;15505
292320;201406;6247;18773;5518;17508;577;2029;4199;13316;4776;15345
292330;201406;2041;5776;1916;5608;202;641;1508;4380;1710;5021
292335;201406;5405;14229;4831;13474;525;1437;3901;10990;4426;12427
292340;201406;6683;19029;5718;17494;632;2014;4070;12563;4702;14577
292350;201406;2201;6693;2032;6478;242;865;1581;5048;1823;5913
292360;201406;5001;14501;4811;13979;197;561;4238;12593;4435;13154
292370;201406;8947;26672;8110;25424;1058;3172;5780;18947;6838;22119
292380;201406;7563;22058;7052;21257;558;1566;5820;17780;6378;19346
292390;201406;3791;8560;3346;8079;110;186;3131;7660;3241;7846
292400;201406;22439;66785;21410;65141;3205;10205;15230;47164;18435;57369
292405;201406;4448;11843;3852;11105;264;772;3215;9359;3479;10131
292410;201406;1955;5280;1855;5164;143;403;1618;4517;1761;4920
292420;201406;3866;12390;3712;12200;169;454;3380;11353;3549;11807
292430;201406;5606;17039;4462;15431;288;1182;3446;11890;3734;13072
292440;201406;8629;28531;8034;27662;298;1185;7025;24558;7323;25743
292450;201406;4453;13252;3655;11985;344;1205;2685;8958;3029;10163
292460;201406;5718;17140;5047;15941;960;3127;3150;10074;4110;13201
292465;201406;2456;7472;2095;6897;245;906;1498;4992;1743;5898
292467;201406;2144;7042;2035;6859;409;1461;1331;4562;1740;6023
292470;201406;3222;8621;2680;7753;244;824;2019;5763;2263;6587
292480;201406;6297;17003;5410;15793;356;1171;4544;13273;4900;14444
292490;201406;2365;6546;1983;5985;181;646;1529;4554;1710;5200
292500;201406;6665;20148;5816;18692;609;2154;4232;13751;4841;15905
292510;201406;13429;38598;11874;36395;1277;4110;9101;28394;10378;32504
292520;201406;6054;18302;5474;17385;1528;4927;2834;9150;4362;14077
292525;201406;5590;14661;4870;13815;388;1128;3971;11417;4359;12545
292530;201406;26244;78350;23909;75396;5590;18103;14094;46017;19684;64120
292540;201406;2927;8484;2644;8091;358;1278;1971;5970;2329;7248
292550;201406;6649;21535;5915;20482;845;3083;4213;14963;5058;18046
292560;201406;4212;11675;3609;10885;311;1157;2905;8607;3216;9764
292570;201406;4105;12199;3947;12033;159;461;3497;11015;3656;11476
292575;201406;6105;20971;5962;20712;936;3373;4451;15512;5387;18885
292580;201406;7199;21353;6667;20686;540;1690;5551;17453;6091;19143
292590;201406;7340;23262;7007;22717;856;2836;5302;17303;6158;20139
292593;201406;3325;8709;2818;7965;274;788;2189;6183;2463;6971
292595;201406;6111;17051;5316;16008;511;1643;4055;12344;4566;13987
292600;201406;10708;30352;9998;29445;1020;2368;8165;24971;9185;27339
292610;201406;4418;12886;3624;11561;483;1594;2373;7741;2856;9335
292620;201406;5904;17886;5187;17041;290;971;4632;15359;4922;16330
292630;201406;10055;25539;8676;23486;834;2333;6540;18016;7374;20349
292640;201406;8366;27049;7437;25807;645;2357;5728;20359;6373;22716
292650;201406;5041;13707;4840;13474;536;1043;3970;11789;4506;12832
292660;201406;11267;34235;10681;33386;1289;4127;8147;25985;9436;30112
292665;201406;2849;8349;2783;8256;80;189;2614;7863;2694;8052
292670;201406;3959;11237;3072;9731;324;1120;2014;6432;2338;7552
292680;201406;3692;11186;3458;10839;357;1106;2773;8754;3130;9860
292690;201406;3425;9315;2470;7819;295;1007;1667;5388;1962;6395
292700;201406;9413;28421;8177;26630;1160;3513;5828;19860;6988;23373
292710;201406;1954;6462;1856;6317;91;340;1654;5654;1745;5994
292720;201406;9645;25027;8519;23755;735;2052;7129;20145;7864;22197
292730;201406;3456;10700;3351;10528;497;1520;2405;7748;2902;9268
292740;201406;360420;1013497;342725;987871;78811;238502;210735;608533;289546;847035
292750;201406;6099;16748;5450;15879;416;1205;4428;13106;4844;14311
292760;201406;4308;13781;3978;13206;587;2115;2613;8777;3200;10892
292770;201406;6198;18986;5798;18346;1282;4049;3620;11827;4902;15876
292780;201406;1910;4626;1502;4118;182;600;1095;2958;1277;3558
292790;201406;3445;9115;3285;8943;254;554;2808;7967;3062;8521
292800;201406;9644;29064;9008;28042;895;3065;7023;21839;7918;24904
292805;201406;3214;9429;2944;9046;572;1877;1970;6072;2542;7949
292810;201406;10184;30823;8612;28740;1135;3976;6344;21653;7479;25629
292820;201406;7534;21624;5519;18750;418;1616;4391;15012;4809;16628
292830;201406;1927;5736;1748;5488;116;453;1431;4461;1547;4914
292840;201406;7376;24232;6905;23581;432;1620;5982;20456;6414;22076
292850;201406;3305;8764;2736;7923;317;968;1968;5667;2285;6635
292860;201406;15341;41955;14711;41160;1859;5263;11471;32411;13330;37674
292870;201406;19801;55201;17558;51726;3039;9771;10623;31004;13662;40775
292880;201406;12096;36003;10926;34190;1665;5409;7161;22497;8826;27906
292890;201406;5741;19724;5177;18664;963;3653;3076;11383;4039;15036
292895;201406;2790;7031;2242;6200;308;851;1616;4464;1924;5315
292900;201406;3098;9719;2934;9455;386;1537;2032;6321;2418;7858
292905;201406;4345;12616;3657;11742;276;781;3071;10159;3347;10940
292910;201406;5204;16076;4776;15307;856;2941;2967;9440;3823;12381
292920;201406;8786;26279;8359;25613;860;2953;6486;19376;7346;22329
292925;201406;5172;16157;4591;15342;444;1534;3568;12032;4012;13566
292930;201406;6562;21310;6260;20757;707;2919;4636;15014;5343;17933
292935;201406;2145;6154;1805;5782;123;318;1529;5092;1652;5410
292937;201406;3338;8546;2834;7916;314;1005;2200;6072;2514;7077
292940;201406;3145;8732;2488;7818;313;1003;1696;5517;2009;6520
292950;201406;8278;25334;7898;24681;976;3624;5756;17513;6732;21137
292960;201406;4976;13518;4381;12685;474;1505;3161;9074;3635;10579
292970;201406;4334;13373;3956;12874;204;826;3315;10782;3519;11608
292975;201406;3429;9437;3305;9254;359;993;2740;7762;3099;8755
292980;201406;3631;9909;2942;9055;407;1441;2051;6258;2458;7699
292990;201406;12344;35593;11201;33849;729;2290;9520;28863;10249;31153
293000;201406;2977;7831;2440;7156;127;434;2119;6212;2246;6646
293010;201406;19082;54125;16703;50371;3066;10077;10365;31254;13431;41331
293015;201406;7905;25920;6452;23750;1057;4269;4174;15267;5231;19536
293020;201406;9597;31805;8980;30930;631;2485;7411;25739;8042;28224
293030;201406;5682;16576;4597;14953;478;1628;3205;10818;3683;12446
293040;201406;3740;12190;3555;11835;219;759;3105;10347;3324;11106
293050;201406;20519;58051;18250;55131;2905;8874;12239;38004;15144;46878
293060;201406;4372;11253;3693;10183;428;1262;2552;7000;2980;8262
293070;201406;20668;63168;19135;60528;5123;16533;10132;32828;15255;49361
293075;201406;3473;11211;3141;10787;242;860;2598;9033;2840;9893
293076;201406;3761;10625;3494;10235;275;765;2925;8736;3200;9501
293077;201406;5085;15825;4409;14944;937;3305;2656;9154;3593;12459
293080;201406;4914;15446;4508;14790;349;1477;3543;11383;3892;12860
293090;201406;3602;11334;2960;10418;288;1039;2255;8060;2543;9099
293100;201406;5830;17790;5004;16335;539;1857;3675;12192;4214;14049
293105;201406;3918;13153;3464;12277;507;1894;2354;8465;2861;10359
293110;201406;1983;5985;1847;5763;131;474;1507;4676;1638;5150
293120;201406;4097;13605;3802;13183;336;1151;3049;10766;3385;11917
293130;201406;3984;11405;3255;10581;187;680;2862;9449;3049;10129
293135;201406;29803;76980;23046;67855;4459;15215;11800;34470;16259;49685
293140;201406;2125;6323;2049;6213;223;810;1570;4637;1793;5447
293150;201406;5883;19394;5290;18249;1044;3732;3138;11182;4182;14914
293160;201406;3587;9719;3355;9453;475;979;2593;7767;3068;8746
293170;201406;3476;10626;3225;10248;490;1673;2282;7340;2772;9013
293180;201406;5433;15370;4497;13923;379;1384;3483;10644;3862;12028
293190;201406;13938;42680;13196;41547;635;2849;11361;35054;11996;37903
293200;201406;6478;18990;5730;17954;277;1039;4912;15375;5189;16414
293210;201406;4982;14873;4592;14229;507;1700;3381;10552;3888;12252
293220;201406;5292;16026;4759;15168;1182;3897;2508;8155;3690;12052
293230;201406;3986;12530;3683;12109;453;1661;2817;9268;3270;10929
293240;201406;4564;12020;3600;10632;202;605;2810;8290;3012;8895
293245;201406;4517;13037;4127;12416;522;1572;2947;9188;3469;10760
293250;201406;6016;16965;5517;16236;681;2104;3998;11768;4679;13872
293260;201406;4788;14382;4003;13246;378;1381;2949;9873;3327;11254
293270;201406;5898;16170;5601;15851;541;1340;4830;14001;5371;15341
293280;201406;5728;16162;4971;15170;453;1252;3857;12184;4310;13436
293290;201406;16696;56018;15791;54213;3598;12745;8893;31224;12491;43969
293300;201406;6604;16508;5680;15469;473;1224;4625;12764;5098;13988
293305;201406;4808;12129;4212;11312;286;818;3494;9391;3780;10209
293310;201406;2778;7160;2265;6323;241;726;1572;4338;1813;5064
293315;201406;4971;12654;4513;11970;759;1951;2850;8008;3609;9959
293317;201406;2607;7662;2343;7173;284;914;1559;4806;1843;5720
293320;201406;8173;26909;7984;26666;764;2755;6650;22244;7414;24999
293325;201406;1951;5683;1626;5184;268;929;1078;3463;1346;4392
293330;201406;55517;176454;50125;167394;11192;40145;27612;93591;38804;133736
293340;201406;2737;7829;2181;6876;296;1050;1513;4686;1809;5736
293345;201406;3583;10762;3026;9971;351;1146;2201;7507;2552;8653
293350;201406;6814;19008;6519;18665;399;995;5810;16992;6209;17987
293360;201406;13910;42474;12668;40852;848;2653;10778;35501;11626;38154
310010;201406;1224;3321;885;2781;229;873;363;1034;592;1907
310020;201406;3866;12333;3227;10925;1145;4190;626;1930;1771;6120
310030;201406;2559;8437;2235;7831;659;2445;1085;3799;1744;6244
310040;201406;1023;2807;866;2595;90;324;646;1904;736;2228
310050;201406;1946;6792;1735;6283;340;1457;892;3172;1232;4629
310060;201406;3257;10963;2954;10549;378;1421;2213;8034;2591;9455
310070;201406;316;917;242;777;39;167;123;353;162;520
310080;201406;773;2407;629;2125;177;686;208;649;385;1335
310090;201406;4934;14722;4273;13586;692;2435;2645;8414;3337;10849
310100;201406;3390;10418;2837;9496;284;1141;2105;6999;2389;8140
310110;201406;5969;16988;5032;15570;1117;3926;2794;8566;3911;12492
310120;201406;602;1960;562;1889;210;832;241;697;451;1529
310130;201406;470;1484;431;1423;105;403;218;673;323;1076
310140;201406;267;931;233;868;84;349;54;178;138;527
310150;201406;4977;15521;4512;14676;963;3566;2371;7666;3334;11232
310160;201406;7372;24053;6448;22383;1952;7466;2482;8502;4434;15968
310163;201406;839;2809;727;2584;193;774;294;1001;487;1775
310170;201406;9955;28552;9177;27386;1646;5038;6010;18535;7656;23573
310180;201406;1903;5522;1553;5036;403;1469;756;2366;1159;3835
310190;201406;2591;8763;2353;8363;733;2890;403;1490;1136;4380
310200;201406;1957;6615;1651;5984;493;1956;571;2053;1064;4009
310205;201406;1046;3194;893;2923;183;604;529;1783;712;2387
310210;201406;2553;8062;2357;7765;350;1287;1702;5584;2052;6871
310220;201406;1281;3680;1031;3352;231;819;586;1875;817;2694
310230;201406;2984;9823;2572;8901;779;3088;1000;3199;1779;6287
310240;201406;1037;3662;885;3371;164;687;448;1797;612;2484
310250;201406;976;3395;952;3356;203;806;601;2059;804;2865
310260;201406;3269;10639;2760;9551;735;2844;1025;3462;1760;6306
310270;201406;2443;7313;2183;6923;207;713;1705;5481;1912;6194
310280;201406;2183;6319;1953;5950;523;1887;941;2723;1464;4610
310285;201406;2242;7860;2106;7660;297;1128;1580;5870;1877;6998
310290;201406;1339;4226;1249;4087;383;1444;593;1756;976;3200
310300;201406;1917;6579;1817;6379;488;1878;1026;3564;1514;5442
310310;201406;400;1104;291;879;51;157;144;430;195;587
310320;201406;396;1329;343;1211;76;318;155;531;231;849
310330;201406;506;1295;376;1067;45;168;206;523;251;691
310340;201406;8546;26888;7479;25101;1474;5185;4284;14776;5758;19961
310350;201406;15638;45037;12228;39039;4208;14451;3463;11213;7671;25664
310360;201406;473;1487;457;1460;82;307;308;935;390;1242
310370;201406;1485;5260;1432;5161;421;1576;768;2793;1189;4369
310375;201406;1425;3846;970;3028;172;613;437;1303;609;1916
310380;201406;401;1135;319;1019;130;463;130;379;260;842
310390;201406;503;1807;429;1633;122;506;74;245;196;751
310400;201406;10433;31553;8393;27879;2711;9790;2517;8407;5228;18197
310410;201406;1051;3392;687;2800;249;1082;141;571;390;1653
310420;201406;5892;17153;3542;11750;842;3141;624;1831;1466;4972
310430;201406;1682;5762;1396;5167;462;1824;371;1354;833;3178
310440;201406;621;1820;543;1698;149;509;228;686;377;1195
310445;201406;1222;4137;1043;3815;147;602;677;2488;824;3090
310450;201406;4680;13554;3841;12326;721;2458;2428;7992;3149;10450
310460;201406;1635;5314;1423;4938;485;1838;329;1194;814;3032
310470;201406;3759;9815;3203;9124;316;1035;2523;7215;2839;8250
310480;201406;1131;3526;956;3182;240;951;389;1167;629;2118
310490;201406;3353;11417;2951;10644;990;3901;1116;4001;2106;7902
310500;201406;1529;5329;1418;5110;429;1669;592;2120;1021;3789
310510;201406;2557;8464;2220;7697;793;2973;495;1651;1288;4624
310520;201406;1400;3817;1145;3402;86;266;780;2327;866;2593
310530;201406;880;2843;563;2017;123;483;104;353;227;836
310540;201406;3778;12527;3503;12113;1220;4421;1427;5021;2647;9442
310550;201406;1224;3721;1021;3367;290;1142;421;1270;711;2412
310560;201406;16570;52170;14321;47811;4574;16944;5014;15958;9588;32902
310570;201406;1287;4004;1204;3895;171;616;893;2892;1064;3508
310590;201406;4169;12390;3354;10839;661;2384;1350;4217;2011;6601
310600;201406;1645;5569;1542;5346;539;2077;540;1753;1079;3830
310610;201406;568;1943;522;1848;167;697;173;547;340;1244
310620;201406;191147;609591;158370;543375;43200;164938;61819;203983;105019;368921
310630;201406;4243;13902;4024;13495;787;2978;2648;8685;3435;11663
310640;201406;1466;4560;1198;4087;414;1516;359;1180;773;2696
310650;201406;2935;9432;2400;8516;487;1872;1290;4717;1777;6589
310660;201406;1335;4123;1165;3881;178;638;842;2787;1020;3425
310665;201406;1219;3841;1122;3703;193;678;773;2591;966;3269
310670;201406;57172;181101;52837;171509;15777;53897;23197;74458;38974;128355
310680;201406;810;2407;742;2297;180;610;382;1162;562;1772
310690;201406;1309;4394;1061;3899;330;1383;279;958;609;2341
310700;201406;526;1476;445;1354;127;429;221;642;348;1071
310710;201406;7342;24078;5862;21597;1584;6491;1835;6649;3419;13140
310720;201406;861;2674;785;2534;234;870;356;1066;590;1936
310730;201406;9677;30793;8886;29538;2040;7342;5259;17544;7299;24886
310740;201406;5225;17914;4489;16332;1655;6503;1021;3536;2676;10039
310750;201406;1648;4293;1355;3903;237;699;903;2636;1140;3335
310760;201406;645;2011;554;1849;135;492;242;794;377;1286
310770;201406;775;2853;759;2824;284;1173;331;1179;615;2352
310780;201406;3736;10781;3329;10055;587;1813;2054;6228;2641;8041
310790;201406;1848;5932;1671;5643;459;1610;847;2942;1306;4552
310800;201406;3132;10265;2530;9040;1005;3926;425;1466;1430;5392
310810;201406;1533;4329;1398;4101;332;1054;696;1968;1028;3022
310820;201406;1502;4295;1098;3584;315;1124;348;1090;663;2214
310825;201406;2448;8401;1984;7582;161;828;1469;5567;1630;6395
310830;201406;1469;5035;1235;4531;413;1633;390;1345;803;2978
310840;201406;2353;7712;2011;7050;744;2885;549;1805;1293;4690
310850;201406;1571;4754;1350;4460;210;754;967;3205;1177;3959
310855;201406;3190;10422;2868;9908;668;2450;1703;6006;2371;8456
310860;201406;7780;24700;6958;23282;1223;4313;4097;14081;5320;18394
310870;201406;1044;3006;881;2731;191;633;431;1328;622;1961
310880;201406;1264;3931;962;3365;204;828;451;1546;655;2374
310890;201406;2805;8983;2241;7920;689;2755;632;2092;1321;4847
310900;201406;4453;15062;3876;13913;1165;4611;1572;5499;2737;10110
310910;201406;2107;6098;1453;4848;425;1586;366;1155;791;2741
310920;201406;1951;5965;1556;5396;412;1632;758;2616;1170;4248
310925;201406;965;3225;883;3087;338;1305;282;981;620;2286
310930;201406;5441;16117;4417;14523;866;3026;2572;8693;3438;11719
310940;201406;6360;18769;5461;17406;1110;3771;3020;9681;4130;13452
310945;201406;1317;3775;1075;3438;229;839;618;1898;847;2737
310950;201406;2042;6804;1625;5887;541;2189;479;1617;1020;3806
310960;201406;475;1645;420;1539;152;599;150;557;302;1156
310970;201406;1476;5262;1146;4360;421;1752;152;508;573;2260
310980;201406;489;1303;338;1012;64;239;149;390;213;629
310990;201406;1209;4196;1040;3824;259;1073;363;1248;622;2321
311000;201406;4312;15147;3851;14144;1186;4903;1369;4791;2555;9694
311010;201406;973;3172;868;2985;279;1024;411;1388;690;2412
311020;201406;901;2844;770;2629;191;743;313;998;504;1741
311030;201406;1932;5778;1497;4896;468;1704;516;1518;984;3222
311040;201406;502;1706;434;1526;105;387;104;360;209;747
311050;201406;2654;8645;2272;7891;701;2678;909;3138;1610;5816
311060;201406;2456;7767;1993;6750;602;2195;488;1606;1090;3801
311070;201406;1744;6207;1543;5795;446;1898;500;1845;946;3743
311080;201406;1226;3334;1097;3136;160;502;739;2144;899;2646
311090;201406;1731;6548;1505;6083;554;2543;285;1072;839;3615
311100;201406;2415;8470;2135;7885;957;3736;545;2014;1502;5750
311110;201406;4122;9982;2949;8323;600;1872;1510;4192;2110;6064
311115;201406;1116;3467;973;3250;131;536;623;2116;754;2652
311120;201406;7719;22194;6069;19133;1633;5799;1680;4934;3313;10733
311130;201406;2383;7346;1916;6722;554;2266;840;2835;1394;5101
311140;201406;1372;3956;1162;3681;177;661;795;2451;972;3112
311150;201406;2443;8199;2257;7888;612;2209;1113;3975;1725;6184
311160;201406;4977;16899;4206;15565;1544;6123;1360;5002;2904;11125
311170;201406;762;2378;607;2078;77;262;327;1181;404;1443
311180;201406;1638;4587;1198;3714;385;1305;272;762;657;2067
311190;201406;1112;3377;947;3043;260;952;371;1107;631;2059
311200;201406;2584;8035;2221;7270;826;2918;564;1691;1390;4609
311205;201406;1205;3937;1065;3660;278;1083;410;1439;688;2522
311210;201406;960;3145;883;3024;161;559;626;2202;787;2761
311220;201406;933;3013;749;2594;208;761;256;876;464;1637
311230;201406;9058;27934;7659;25427;1615;5836;3814;12969;5429;18805
311240;201406;1359;4205;1133;3835;370;1366;378;1269;748;2635
311250;201406;984;3265;888;3115;251;1005;315;969;566;1974
311260;201406;2973;8193;2264;6948;717;2409;688;2050;1405;4459
311265;201406;1341;3621;1037;3190;153;575;695;2127;848;2702
311270;201406;3504;11491;3121;10972;607;2495;2037;6994;2644;9489
311280;201406;1456;4096;1084;3376;303;1046;333;1008;636;2054
311290;201406;2334;7678;2159;7311;425;1422;1263;4417;1688;5839
311300;201406;5083;16896;4589;16088;735;2888;3013;10674;3748;13562
311310;201406;496;1773;480;1746;115;482;211;729;326;1211
311320;201406;4164;14081;3656;12933;958;3873;1319;4421;2277;8294
311330;201406;5592;17223;4818;15977;1774;6274;1631;5400;3405;11674
311340;201406;12431;40506;11348;38459;3883;14080;3631;12272;7514;26352
311350;201406;2356;7020;2016;6410;467;1695;927;2818;1394;4513
311360;201406;1353;3865;1086;3511;501;1684;292;979;793;2663
311370;201406;4634;13847;4115;12974;1072;4008;1766;5251;2838;9259
311380;201406;485;1607;410;1467;124;517;125;404;249;921
311390;201406;2015;7469;1901;7271;849;3594;621;2270;1470;5864
311400;201406;1724;5826;1592;5594;477;1883;713;2341;1190;4224
311410;201406;2052;7450;1911;7246;625;2547;997;3813;1622;6360
311420;201406;2426;8434;2040;7474;744;2919;491;1626;1235;4545
311430;201406;4063;12816;3069;10631;770;2945;619;2109;1389;5054
311440;201406;2390;8212;1944;7407;729;3137;482;1794;1211;4931
311450;201406;1880;6673;1592;5960;482;2000;382;1331;864;3331
311455;201406;1619;4423;1389;4079;315;1030;758;2153;1073;3183
311460;201406;661;2193;518;1892;128;578;135;466;263;1044
311470;201406;621;1991;500;1726;146;599;158;497;304;1096
311480;201406;825;2316;784;2252;253;737;372;1023;625;1760
311490;201406;320;1265;310;1233;117;483;110;430;227;913
311500;201406;525;1596;433;1423;155;548;163;524;318;1072
311510;201406;3190;10009;2648;8983;1046;4028;727;2300;1773;6328
311520;201406;703;2414;663;2329;252;950;251;856;503;1806
311530;201406;11519;30707;7968;24528;2210;8074;2348;6922;4558;14996
311535;201406;761;2325;550;1897;138;558;109;357;247;915
311540;201406;708;2569;676;2521;223;867;341;1257;564;2124
311545;201406;2238;7062;2108;6882;314;1139;1487;4857;1801;5996
311547;201406;1673;4689;1421;4305;145;474;968;2968;1113;3442
311550;201406;3435;11233;2971;10265;899;3464;1002;3383;1901;6847
311560;201406;280;760;250;722;63;209;141;385;204;594
311570;201406;2132;5391;1728;4889;121;353;1388;3996;1509;4349
311580;201406;2441;5375;2009;4862;580;1318;1157;2942;1737;4260
311590;201406;409;1307;358;1239;117;480;104;352;221;832
311600;201406;1352;4131;1182;3914;296;958;684;2361;980;3319
311610;201406;3442;11999;3193;11598;1039;3794;1450;5636;2489;9430
311615;201406;2757;9081;2388;8441;310;1283;1654;5819;1964;7102
311620;201406;465;1502;420;1440;109;415;220;735;329;1150
311630;201406;1468;4398;1254;4012;297;937;665;2180;962;3117
311640;201406;901;2822;746;2571;136;512;492;1698;628;2210
311650;201406;2459;7029;2009;6318;293;1018;1205;3862;1498;4880
311660;201406;2646;9412;2327;8674;709;2949;442;1450;1151;4399
311670;201406;1455;4515;1255;4156;436;1589;520;1684;956;3273
311680;201406;2339;7323;1957;6769;485;1757;1098;3890;1583;5647
311690;201406;555;1537;469;1435;84;285;316;957;400;1242
311700;201406;2208;6372;1954;5997;191;752;1502;4500;1693;5252
311710;201406;1757;5476;1390;4811;558;2115;416;1409;974;3524
311720;201406;414;1422;380;1354;65;262;244;854;309;1116
311730;201406;5384;14302;3492;10995;1059;3714;1286;3767;2345;7481
311740;201406;1006;2899;881;2752;373;1144;426;1389;799;2533
311750;201406;3961;13424;3616;12895;644;2572;2247;8055;2891;10627
311760;201406;805;2776;754;2668;232;965;302;946;534;1911
311770;201406;2591;8234;2127;7401;573;2234;688;2318;1261;4552
311780;201406;1109;4181;957;3806;368;1627;204;769;572;2396
311783;201406;2062;6767;1843;6369;224;888;1215;4327;1439;5215
311787;201406;652;2289;482;1783;99;399;106;337;205;736
311790;201406;1309;4239;1087;3795;332;1246;289;965;621;2211
311800;201406;3938;13567;2885;10331;699;2673;219;655;918;3328
311810;201406;1044;3542;996;3456;49;234;829;2845;878;3079
311820;201406;829;2743;710;2461;226;912;334;1062;560;1974
311830;201406;10664;38532;9722;36152;3908;15222;2398;8896;6306;24118
311840;201406;3490;10485;3012;9763;946;3390;1299;4124;2245;7514
311850;201406;319;967;277;898;75;252;136;447;211;699
311860;201406;50488;158395;44125;146214;11654;42479;19784;63691;31438;106170
311870;201406;2416;7269;1930;6347;513;1920;647;1978;1160;3898
311880;201406;7160;21457;6480;20635;962;2999;4596;15302;5558;18301
311890;201406;1633;5158;1369;4591;388;1424;543;1777;931;3201
311900;201406;808;2535;736;2436;145;480;465;1632;610;2112
311910;201406;4791;14132;3925;12940;1134;4013;1662;5542;2796;9555
311920;201406;2108;6913;1813;6461;226;905;1221;4312;1447;5217
311930;201406;4873;14598;4349;13746;1749;5798;1373;4406;3122;10204
311940;201406;11575;35774;9765;31964;3040;10883;2422;7568;5462;18451
311950;201406;2329;6940;1979;6485;129;407;1604;5341;1733;5748
311960;201406;406;1391;374;1323;118;473;160;515;278;988
311970;201406;484;1735;415;1583;129;549;81;286;210;835
311980;201406;784;2191;575;1857;137;472;219;720;356;1192
311990;201406;521;1595;463;1506;189;654;162;494;351;1148
311995;201406;1144;3561;794;2684;177;668;188;535;365;1203
312000;201406;704;2196;661;2130;128;461;376;1203;504;1664
312010;201406;1050;3405;948;3187;204;746;436;1455;640;2201
312015;201406;1596;4953;1381;4578;207;801;821;2755;1028;3556
312020;201406;956;3096;852;2945;223;879;465;1576;688;2455
312030;201406;1836;5482;1651;5246;185;669;1287;4060;1472;4729
312040;201406;693;2657;595;2361;177;794;126;466;303;1260
312050;201406;1485;5171;1301;4787;402;1645;295;1033;697;2678
312060;201406;755;2323;669;2202;315;1087;197;592;512;1679
312070;201406;985;3079;654;2340;167;652;240;841;407;1493
312080;201406;2665;7520;2083;6600;474;1800;992;2885;1466;4685
312083;201406;946;2731;793;2506;133;488;470;1460;603;1948
312087;201406;2346;7201;2101;6858;323;1122;1477;4895;1800;6017
312090;201406;9975;32596;9140;31144;2876;10808;3845;12705;6721;23513
312100;201406;1378;4695;1211;4411;244;991;682;2547;926;3538
312110;201406;1197;4285;1071;4008;408;1682;218;743;626;2425
312120;201406;930;3264;837;3055;275;1100;225;752;500;1852
312125;201406;1270;4129;1131;3835;314;1120;531;1838;845;2958
312130;201406;845;2606;688;2269;167;628;277;869;444;1497
312140;201406;1140;3613;954;3174;217;786;359;1096;576;1882
312150;201406;558;1607;471;1418;44;151;317;929;361;1080
312160;201406;8203;28196;7523;26808;2427;9386;2712;9755;5139;19141
312170;201406;1029;3091;928;2894;137;451;575;1826;712;2277
312180;201406;1618;5041;1480;4800;435;1480;595;1893;1030;3373
312190;201406;685;2263;537;1965;221;891;105;364;326;1255
312200;201406;4847;14652;4222;13611;572;1950;2883;9358;3455;11308
312210;201406;1191;3318;949;2962;266;919;441;1322;707;2241
312220;201406;1941;6420;1751;6200;248;908;1320;4858;1568;5766
312230;201406;18297;61411;15517;55807;7206;27334;3321;12405;10527;39739
312235;201406;1760;5079;1477;4644;157;622;1006;3154;1163;3776
312240;201406;1126;3866;965;3523;295;1153;347;1260;642;2413
312245;201406;2395;7085;2074;6651;186;541;1656;5425;1842;5966
312247;201406;930;2770;716;2423;183;705;353;1216;536;1921
312250;201406;1165;3448;1001;3160;232;819;468;1433;700;2252
312260;201406;936;3004;785;2789;119;517;545;1915;664;2432
312270;201406;802;2521;680;2289;164;666;254;740;418;1406
312280;201406;476;1657;438;1567;196;743;57;201;253;944
312290;201406;829;2905;783;2838;332;1329;197;703;529;2032
312300;201406;1127;3790;951;3382;296;1124;145;462;441;1586
312310;201406;962;3686;880;3477;263;1129;361;1388;624;2517
312320;201406;2448;7051;1962;6051;565;1955;494;1269;1059;3224
312330;201406;1173;3569;1036;3364;273;1011;566;1831;839;2842
312340;201406;312;839;291;808;44;163;218;570;262;733
312350;201406;382;995;354;960;46;149;287;746;333;895
312352;201406;1679;5498;1543;5304;434;1506;922;3281;1356;4787
312360;201406;3736;12804;3290;11879;1108;4325;922;3308;2030;7633
312370;201406;1684;5501;1558;5291;567;2148;561;1802;1128;3950
312380;201406;2031;5965;1844;5675;259;809;1324;4202;1583;5011
312385;201406;1267;3967;1142;3747;163;681;773;2424;936;3105
312390;201406;2066;6980;1746;6270;542;2052;357;1214;899;3266
312400;201406;3461;11467;3056;10666;1115;4048;1093;3981;2208;8029
312410;201406;10757;36218;9688;34077;3010;11519;3558;12214;6568;23733
312420;201406;4097;13130;3900;12894;739;2437;2670;9124;3409;11561
312430;201406;8601;25628;7649;24210;1341;4334;5002;16322;6343;20656
312440;201406;662;2141;578;1994;148;561;284;987;432;1548
312450;201406;1178;4291;1080;4083;476;1854;390;1474;866;3328
312460;201406;399;1226;358;1180;83;308;193;620;276;928
312470;201406;774;2221;538;1750;131;491;138;441;269;932
312480;201406;1361;4062;1134;3799;381;1373;526;1718;907;3091
312490;201406;1996;5377;1621;4829;237;860;996;2831;1233;3691
312500;201406;627;2171;593;2114;141;606;322;1105;463;1711
312510;201406;2520;8348;2077;7355;549;2215;768;2475;1317;4690
312520;201406;400;1372;353;1273;119;445;126;463;245;908
312530;201406;589;1946;561;1890;113;466;328;1033;441;1499
312540;201406;1485;4736;1181;4127;298;1148;596;2029;894;3177
312550;201406;642;2079;581;1951;62;240;389;1281;451;1521
312560;201406;2198;5876;1918;5510;225;725;1452;4199;1677;4924
312570;201406;2797;8499;2414;7826;763;2634;791;2491;1554;5125
312580;201406;533;1809;436;1613;105;453;175;617;280;1070
312590;201406;1860;6271;1639;5786;482;1946;555;1784;1037;3730
312595;201406;2043;6939;1824;6410;517;1955;828;2842;1345;4797
312600;201406;810;2938;741;2788;216;929;332;1176;548;2105
312610;201406;8605;27285;7429;24980;2777;9984;2317;7607;5094;17591
312620;201406;2100;6092;1612;5446;108;383;1309;4560;1417;4943
312630;201406;512;1742;475;1672;129;505;215;734;344;1239
312640;201406;601;1988;499;1774;128;535;203;668;331;1203
312650;201406;2383;7088;1737;5878;209;815;944;3152;1153;3967
312660;201406;1276;3554;1099;3331;156;559;746;2216;902;2775
312670;201406;6111;18910;5528;18036;1378;5041;2808;9012;4186;14053
312675;201406;1469;4658;1263;4245;222;820;717;2434;939;3254
312680;201406;1723;5291;1542;4998;249;905;931;3083;1180;3988
312690;201406;2415;6666;1988;6068;389;1387;1112;3241;1501;4628
312695;201406;916;3288;862;3207;178;653;572;2201;750;2854
312700;201406;2202;6502;1715;5567;310;1135;893;2853;1203;3988
312705;201406;1423;4200;1241;3938;199;647;841;2686;1040;3333
312707;201406;1773;5508;1472;5001;248;1020;808;2686;1056;3706
312710;201406;8219;23408;6101;19670;2259;8067;1459;4412;3718;12479
312720;201406;769;2652;700;2520;185;737;303;1046;488;1783
312730;201406;1911;4791;1426;4246;223;786;861;2538;1084;3324
312733;201406;1766;4778;1343;3984;120;436;963;2753;1083;3189
312735;201406;910;2705;806;2553;274;946;391;1210;665;2156
312737;201406;1053;2595;746;2179;249;748;308;942;557;1690
312738;201406;539;1735;429;1516;129;535;166;552;295;1087
312740;201406;508;1469;348;1261;120;471;108;400;228;871
312750;201406;1303;4748;1248;4631;333;1414;588;2127;921;3541
312760;201406;2436;7908;1927;6893;573;2271;467;1689;1040;3960
312770;201406;45868;127693;35977;112486;10837;36708;12198;37846;23035;74554
312780;201406;2829;10101;2538;9594;513;2111;1458;5650;1971;7761
312790;201406;379;1007;233;743;75;273;61;170;136;443
312800;201406;5290;18073;4600;16651;1465;5667;1494;5529;2959;11196
312810;201406;2238;6977;1656;5901;557;2186;376;1268;933;3454
312820;201406;2190;6477;1974;6119;264;972;1271;3830;1535;4802
312825;201406;1541;4211;1350;3980;135;433;1073;3154;1208;3587
312830;201406;2818;9174;2059;7588;597;2408;390;1442;987;3850
312840;201406;1203;3994;1017;3633;207;887;460;1571;667;2458
312850;201406;659;2159;557;1949;132;548;208;703;340;1251
312860;201406;1323;3879;1015;3397;338;1320;320;942;658;2262
312870;201406;5716;18318;4479;15956;1258;5062;1304;4466;2562;9528
312880;201406;1264;3837;1069;3501;216;797;576;1872;792;2669
312890;201406;1641;5048;1247;4249;404;1542;433;1436;837;2978
312900;201406;1484;4795;1369;4636;349;1222;833;2876;1182;4098
312910;201406;1511;3481;1167;3012;300;892;552;1324;852;2216
312920;201406;1038;3393;912;3214;286;1124;394;1344;680;2468
312930;201406;2251;6728;1993;6357;460;1547;1029;3362;1489;4909
312940;201406;935;3167;843;2994;247;1039;267;874;514;1913
312950;201406;3541;10177;2889;9185;977;3356;1122;3527;2099;6883
312960;201406;1965;5989;1775;5735;215;703;1341;4445;1556;5148
312965;201406;1828;5874;1554;5376;318;1180;886;3122;1204;4302
312970;201406;1147;3990;1030;3821;418;1742;202;722;620;2464
312980;201406;21397;75484;20572;73463;7858;30030;7649;26674;15507;56704
312990;201406;399;1223;303;1050;113;437;91;311;204;748
313000;201406;534;1795;454;1638;141;618;167;533;308;1151
313005;201406;2646;8659;2361;8186;394;1503;1465;5082;1859;6585
313010;201406;4162;14085;3736;13362;1173;4632;1549;5308;2722;9940
313020;201406;1048;3617;953;3390;317;1267;289;902;606;2169
313030;201406;1594;4523;1289;4103;339;1224;670;2041;1009;3265
313040;201406;984;3477;842;3073;223;889;257;899;480;1788
313050;201406;1938;6347;1600;5855;540;2206;575;2021;1115;4227
313055;201406;1527;5098;1405;4922;150;547;1049;3755;1199;4302
313060;201406;989;3445;896;3229;394;1484;163;566;557;2050
313065;201406;1962;6527;1774;6232;305;1215;1258;4397;1563;5612
313070;201406;1274;3795;1039;3354;264;982;506;1547;770;2529
313080;201406;480;1528;396;1362;122;478;123;362;245;840
313090;201406;5491;16497;4971;15636;806;2683;3350;10683;4156;13366
313100;201406;1169;3789;1091;3674;175;651;788;2629;963;3280
313110;201406;1742;5163;1370;4455;334;1244;515;1564;849;2808
313115;201406;2894;10230;2769;9975;860;3455;1316;4537;2176;7992
313120;201406;3921;11272;3415;10555;960;3128;1923;5967;2883;9095
313130;201406;27617;87815;24567;81356;7394;26892;8925;28087;16319;54979
313140;201406;729;1915;540;1621;45;164;357;1054;402;1218
313150;201406;1681;5286;1512;4987;682;2329;424;1439;1106;3768
313160;201406;1182;3600;1054;3388;208;775;635;1961;843;2736
313170;201406;9848;36494;9110;34653;3654;14484;2108;8066;5762;22550
313180;201406;2798;7367;2116;6458;644;2161;768;2264;1412;4425
313190;201406;3605;13274;3212;12131;927;3797;1097;4023;2024;7820
313200;201406;1518;4804;1356;4538;234;927;848;2854;1082;3781
313210;201406;4632;14728;3963;13834;945;3808;2188;7400;3133;11208
313220;201406;1304;4002;978;3284;262;1009;269;802;531;1811
313230;201406;2530;9053;2376;8818;425;1648;1540;5921;1965;7569
313240;201406;8425;28632;7235;26395;2058;8260;3009;10980;5067;19240
313250;201406;7825;24548;7086;23311;1303;4372;4293;14537;5596;18909
313260;201406;632;1977;527;1776;132;509;154;490;286;999
313270;201406;5751;16984;5135;16055;755;2502;3596;11378;4351;13880
313280;201406;552;1806;430;1509;84;342;111;362;195;704
313290;201406;1044;3770;869;3415;290;1240;221;814;511;2054
313300;201406;2008;6908;1719;6193;548;2162;346;1116;894;3278
313310;201406;1084;3847;989;3644;284;1192;192;645;476;1837
313320;201406;2461;7485;2038;6765;430;1510;905;3049;1335;4559
313330;201406;3950;13000;3480;12102;737;2908;1788;6168;2525;9076
313340;201406;2348;5708;1811;4956;389;1114;994;2700;1383;3814
313350;201406;3420;10782;2666;9073;702;2571;568;1772;1270;4343
313360;201406;1202;3700;935;3197;297;1190;407;1280;704;2470
313370;201406;1505;5284;1429;5070;300;1238;677;2250;977;3488
313375;201406;2127;5734;1439;4698;387;1521;515;1616;902;3137
313380;201406;6911;23812;6053;21926;2280;8947;1878;6518;4158;15465
313390;201406;926;3384;895;3336;131;560;607;2240;738;2800
313400;201406;3742;10997;3476;10670;433;1400;2672;8364;3105;9764
313410;201406;1376;3959;1175;3688;245;839;725;2286;970;3125
313420;201406;20331;50337;13102;37561;3238;10444;3169;8791;6407;19235
313430;201406;1328;4365;1194;4115;378;1437;452;1492;830;2929
313440;201406;6663;16158;4999;14199;740;2271;3423;9783;4163;12054
313450;201406;740;2224;596;1923;153;591;209;619;362;1210
313460;201406;2597;9271;2342;8817;788;3224;729;2650;1517;5874
313470;201406;3489;9791;3313;9590;353;880;2767;8254;3120;9134
313480;201406;1148;3393;885;2927;161;603;384;1222;545;1825
313490;201406;1628;5383;1200;4642;450;1763;334;1321;784;3084
313500;201406;447;1452;427;1417;91;356;258;827;349;1183
313505;201406;9042;26907;8453;26208;531;1202;7594;24330;8125;25532
313507;201406;1395;4061;1240;3837;240;867;738;2297;978;3164
313510;201406;16007;47888;14409;45881;2301;7414;10319;33688;12620;41102
313520;201406;16533;50005;14046;45804;2164;8005;8991;29234;11155;37239
313530;201406;580;1990;507;1849;93;391;192;653;285;1044
313535;201406;2602;7818;2328;7365;355;1161;1515;4876;1870;6037
313540;201406;1144;3639;903;3030;269;948;237;734;506;1682
313545;201406;1407;5162;1250;4875;224;1059;767;2865;991;3924
313550;201406;1973;6759;1869;6539;541;2029;942;3196;1483;5225
313560;201406;2326;5764;2032;5427;279;664;1558;4358;1837;5022
313570;201406;826;3035;726;2842;275;1164;258;957;533;2121
313580;201406;6324;17975;5433;16765;758;2534;3910;12152;4668;14686
313590;201406;1090;3262;881;3013;411;1492;329;1109;740;2601
313600;201406;3993;12247;3513;11487;650;2255;2104;7032;2754;9287
313610;201406;1169;3678;1017;3384;267;972;448;1466;715;2438
313620;201406;7514;25344;7103;24473;2515;9221;2482;8435;4997;17656
313630;201406;9070;27940;7661;25695;2324;8573;2834;9922;5158;18495
313640;201406;879;2770;753;2593;268;987;302;1042;570;2029
313650;201406;2350;7719;2090;7300;298;1030;1532;5491;1830;6521
313652;201406;1029;3725;949;3564;175;701;574;2167;749;2868
313655;201406;1023;3375;848;3081;170;701;514;1818;684;2519
313657;201406;1218;3991;1091;3772;164;740;735;2326;899;3066
313660;201406;919;3180;850;3056;221;910;416;1431;637;2341
313665;201406;3177;10624;2946;10110;718;2798;1446;4794;2164;7592
313670;201406;48012;137902;33209;112514;9778;36950;10545;34682;20323;71632
313680;201406;1137;3423;991;3198;139;455;698;2285;837;2740
313690;201406;986;3562;885;3350;263;1028;359;1405;622;2433
313695;201406;1514;4960;1292;4593;164;669;902;3214;1066;3883
313700;201406;3980;13270;3391;12463;555;2129;2374;8877;2929;11006
313710;201406;1438;4082;1205;3739;345;1158;587;1790;932;2948
313720;201406;5498;18625;4776;17078;1338;5334;1472;4781;2810;10115
313730;201406;1311;3592;1024;3244;143;503;668;2131;811;2634
313740;201406;2120;7729;1768;6815;620;2668;254;921;874;3589
313750;201406;3002;9307;2636;8606;890;3093;803;2474;1693;5567
313753;201406;1917;5817;1588;5243;502;1763;627;2099;1129;3862
313760;201406;4339;14518;3733;13261;1186;4608;1136;3864;2322;8472
313770;201406;3745;12684;3562;12268;1240;4501;1182;4057;2422;8558
313780;201406;4039;11579;3288;10481;834;3075;1577;4900;2411;7975
313790;201406;559;1958;542;1934;127;462;311;1133;438;1595
313800;201406;1277;3667;1134;3439;191;647;718;2174;909;2821
313810;201406;1585;4787;1525;4699;196;580;1174;3715;1370;4295
313820;201406;13436;39817;11339;36092;3171;11248;4593;14634;7764;25882
313830;201406;453;1549;390;1418;125;516;124;438;249;954
313835;201406;1085;3583;1036;3509;251;907;577;1944;828;2851
313840;201406;7748;23513;6540;21458;1968;7189;2208;6963;4176;14152
313850;201406;1292;3649;1166;3430;293;975;619;1724;912;2699
313860;201406;2751;8600;2280;7578;688;2577;534;1605;1222;4182
313862;201406;1184;3174;829;2589;250;824;269;856;519;1680
313865;201406;2264;7240;2106;6966;322;1193;1460;4811;1782;6004
313867;201406;1094;3827;936;3499;342;1357;318;1201;660;2558
313868;201406;1583;5617;1409;5248;183;788;942;3506;1125;4294
313870;201406;928;2932;834;2794;246;949;326;1013;572;1962
313880;201406;2273;7372;2084;7120;525;2077;1058;3368;1583;5445
313890;201406;2034;5586;1723;5194;277;828;1143;3522;1420;4350
313900;201406;4859;17836;4527;17074;1712;7091;1318;4942;3030;12033
313910;201406;782;2679;674;2451;279;1097;126;429;405;1526
313920;201406;3791;12250;3433;11646;619;2080;2135;7554;2754;9634
313925;201406;2140;5703;1514;4512;138;464;1001;2953;1139;3417
313930;201406;5447;17975;4568;16426;812;3168;2648;9768;3460;12936
313940;201406;7669;26635;6620;24926;2296;9389;2518;9788;4814;19177
313950;201406;4941;14516;4136;13199;1337;4775;1500;4614;2837;9389
313960;201406;6211;16808;5081;15258;1705;5679;1451;4325;3156;10004
313970;201406;1522;4477;1275;4199;237;847;837;2789;1074;3636
313980;201406;1250;4173;1076;3859;370;1464;343;1209;713;2673
313990;201406;2020;7681;1800;7178;658;2828;466;1726;1124;4554
314000;201406;8378;28781;7796;27647;2185;8746;4115;14240;6300;22986
314010;201406;1155;3360;960;3115;163;635;565;1773;728;2408
314015;201406;1608;6056;1483;5776;536;2191;481;1880;1017;4071
314020;201406;514;1650;425;1443;131;492;116;370;247;862
314030;201406;854;2781;682;2384;129;491;250;859;379;1350
314040;201406;650;1927;563;1774;179;605;283;875;462;1480
314050;201406;1956;6478;1646;5828;518;2030;507;1670;1025;3700
314053;201406;1530;5086;1422;4954;234;802;1000;3623;1234;4425
314055;201406;2278;6853;2022;6495;193;638;1525;5012;1718;5650
314060;201406;1142;3646;956;3323;109;455;621;2151;730;2606
314070;201406;3765;11923;2903;10178;829;3192;766;2533;1595;5725
314080;201406;1953;6086;1397;4865;296;1187;354;1096;650;2283
314085;201406;1910;6692;1654;6322;530;2211;603;2312;1133;4523
314090;201406;3580;12312;3230;11624;1094;4230;1190;4372;2284;8602
314100;201406;3599;9734;3145;9091;392;1108;2401;7111;2793;8219
314110;201406;4518;15020;4002;13944;1003;4019;1534;4966;2537;8985
314120;201406;1081;2662;587;1865;176;636;154;466;330;1102
314130;201406;704;2074;414;1400;80;286;89;302;169;588
314140;201406;5149;16213;4571;15100;991;3528;2235;7452;3226;10980
314150;201406;1799;4814;1408;4194;273;913;694;2030;967;2943
314160;201406;2484;6691;1990;6033;146;472;1638;5070;1784;5542
314170;201406;1120;3484;938;3085;166;637;489;1537;655;2174
314180;201406;6580;20963;5816;19812;1568;5846;2677;9318;4245;15164
314190;201406;831;2638;740;2487;241;923;282;907;523;1830
314200;201406;3121;10141;2803;9559;415;1642;1899;6380;2314;8022
314210;201406;2053;6380;1840;5989;352;1290;1048;3283;1400;4573
314220;201406;1762;5808;1484;5222;507;1986;355;1102;862;3088
314225;201406;1196;3731;1080;3570;78;233;942;3187;1020;3420
314230;201406;721;2536;668;2434;220;860;236;824;456;1684
314240;201406;1165;3743;1028;3529;223;738;662;2369;885;3107
314250;201406;539;1645;421;1402;111;426;167;517;278;943
314260;201406;1311;4788;1241;4634;427;1681;469;1755;896;3436
314270;201406;2749;9578;2579;9281;323;1340;1789;6471;2112;7811
314280;201406;3363;9685;2453;7979;775;2869;688;1993;1463;4862
314290;201406;5511;15500;4702;14200;1039;3443;2931;8737;3970;12180
314300;201406;1992;6760;1837;6394;624;2255;695;2376;1319;4631
314310;201406;6766;21755;5971;20130;2283;8157;1794;5895;4077;14052
314315;201406;982;3764;918;3641;174;784;537;2158;711;2942
314320;201406;3616;10879;2896;9891;1012;3764;1153;3897;2165;7661
314330;201406;55911;180685;52295;174506;15807;57386;24185;79883;39992;137269
314340;201406;2515;7078;1389;4701;386;1423;126;273;512;1696
314345;201406;1377;4639;1218;4386;381;1414;635;2340;1016;3754
314350;201406;1439;4258;1175;3827;505;1778;317;1024;822;2802
314360;201406;728;2342;515;1884;150;636;135;466;285;1102
314370;201406;571;2020;532;1965;154;627;270;989;424;1616
314380;201406;1207;3692;897;3129;328;1216;255;907;583;2123
314390;201406;16101;48664;12928;42595;4006;14358;3789;12023;7795;26381
314400;201406;5546;15938;4569;14589;1410;4522;2436;8153;3846;12675
314410;201406;2780;9054;2398;8250;789;3090;824;2656;1613;5746
314420;201406;793;2319;638;2104;88;342;475;1558;563;1900
314430;201406;8328;24895;7501;23394;2570;8541;2496;7976;5066;16517
314435;201406;1292;4218;1155;3970;170;720;748;2515;918;3235
314437;201406;1221;3210;1076;2997;99;279;842;2365;941;2644
314440;201406;761;2120;537;1810;203;756;112;342;315;1098
314450;201406;1813;5398;1555;5027;517;1878;720;2207;1237;4085
314460;201406;4698;16423;4143;15156;1482;5847;842;3067;2324;8914
314465;201406;2430;7823;2239;7482;226;916;1680;5520;1906;6436
314467;201406;1153;3285;992;3010;150;438;659;2057;809;2495
314470;201406;2452;8085;1962;6952;563;2298;485;1466;1048;3764
314480;201406;7435;25892;5511;20619;1432;5785;594;2014;2026;7799
314490;201406;998;3013;819;2658;238;863;357;1111;595;1974
314500;201406;2886;8317;2401;7406;752;2553;872;2710;1624;5263
314505;201406;1810;5659;1714;5491;364;1265;1039;3355;1403;4620
314510;201406;2050;5811;1441;4898;513;1911;388;1272;901;3183
314520;201406;3831;14741;3205;13121;1133;5070;619;2332;1752;7402
314530;201406;7285;25600;6719;24717;1284;4876;3994;15280;5278;20156
314535;201406;2907;8229;2504;7684;353;1173;1772;5457;2125;6630
314537;201406;1450;4399;1220;3984;262;960;601;1994;863;2954
314540;201406;463;1447;410;1330;133;508;135;395;268;903
314545;201406;1389;4484;1238;4247;260;978;712;2443;972;3421
314550;201406;619;1793;480;1603;127;526;149;447;276;973
314560;201406;5415;19395;4774;17707;1285;5214;1263;4558;2548;9772
314570;201406;374;1169;333;1081;100;355;157;491;257;846
314580;201406;485;1713;405;1525;141;601;91;326;232;927
314585;201406;838;2839;613;2333;177;752;176;667;353;1419
314587;201406;1771;5692;1582;5351;292;1002;873;3006;1165;4008
314590;201406;4331;15183;3227;12140;890;3564;439;1538;1329;5102
314600;201406;2150;7506;1800;6877;717;3017;388;1419;1105;4436
314610;201406;8589;30767;8073;29546;2655;10612;2880;10101;5535;20713
314620;201406;1871;5481;1664;5222;238;705;1235;4020;1473;4725
314625;201406;1580;5291;1542;5242;182;617;1234;4282;1416;4899
314630;201406;5246;15597;4605;14576;612;2140;3157;10148;3769;12288
314640;201406;841;2433;715;2205;260;843;197;568;457;1411
314650;201406;1350;4035;1057;3496;279;1052;425;1288;704;2340
314655;201406;1699;5071;1308;4338;263;934;674;2241;937;3175
314660;201406;216;603;170;510;25;92;98;279;123;371
314670;201406;1526;4264;1234;3751;227;756;707;2139;934;2895
314675;201406;1934;5978;1735;5635;230;837;1110;3638;1340;4475
314690;201406;2777;8908;2370;8177;704;2797;708;2279;1412;5076
314700;201406;10695;40024;9402;37101;4130;17084;2276;9271;6406;26355
314710;201406;8793;28308;6262;22615;1609;6577;909;2971;2518;9548
314720;201406;2716;9172;2288;8303;685;2737;925;3316;1610;6053
314730;201406;2547;7933;2132;7326;779;2922;690;2281;1469;5203
314740;201406;3145;10584;2858;10043;883;3404;1128;3815;2011;7219
314750;201406;343;1126;309;1050;67;266;146;476;213;742
314760;201406;1729;6020;1259;4768;276;1238;278;881;554;2119
314770;201406;1198;3832;757;2605;96;403;107;268;203;671
314780;201406;327;907;246;796;87;325;105;331;192;656
314790;201406;13808;42618;10662;37072;3957;15583;2817;9330;6774;24913
314795;201406;1533;4739;1359;4452;159;672;1019;3208;1178;3880
314800;201406;17491;53948;14478;47805;5895;20381;3123;10562;9018;30943
314810;201406;13276;40302;10466;35236;3419;12777;2700;9094;6119;21871
314820;201406;1131;3143;790;2633;273;997;264;806;537;1803
314830;201406;1743;5957;1535;5550;542;2126;586;2176;1128;4302
314840;201406;1131;4002;900;3659;181;845;549;2244;730;3089
314850;201406;2304;6662;1903;5956;384;1395;1072;3322;1456;4717
314860;201406;3335;11527;3063;11086;645;2587;1869;6801;2514;9388
314870;201406;5820;18822;5200;17984;764;2939;3702;13011;4466;15950
314875;201406;1745;5986;1701;5921;254;842;1361;4833;1615;5675
314880;201406;839;2462;745;2315;73;233;534;1676;607;1909
314890;201406;574;1764;425;1466;104;412;125;373;229;785
314900;201406;430;1373;350;1231;103;378;162;567;265;945
314910;201406;1777;6240;1562;5862;641;2630;404;1434;1045;4064
314915;201406;2553;8100;2257;7666;229;907;1750;5900;1979;6807
314920;201406;654;1903;495;1669;112;431;231;726;343;1157
314930;201406;5299;18228;4697;16913;1583;6212;1126;4001;2709;10213
314940;201406;423;1260;400;1217;92;307;216;630;308;937
314950;201406;402;1370;335;1238;92;380;80;290;172;670
314960;201406;834;2724;672;2384;215;822;169;565;384;1387
314970;201406;895;3213;808;3037;305;1245;216;778;521;2023
314980;201406;2290;7083;2070;6727;878;3011;349;1081;1227;4092
314990;201406;3232;10501;2629;9170;980;3769;491;1552;1471;5321
314995;201406;1614;5043;1461;4829;218;865;1005;3251;1223;4116
315000;201406;1104;3254;911;2959;172;660;557;1777;729;2437
315010;201406;502;1623;415;1437;129;520;156;489;285;1009
315015;201406;1960;6101;1782;5885;299;989;1281;4399;1580;5388
315020;201406;764;2491;643;2237;154;599;280;918;434;1517
315030;201406;1018;3143;872;2865;348;1204;207;676;555;1880
315040;201406;959;2984;882;2847;167;565;550;1765;717;2330
315050;201406;1664;4989;1386;4526;456;1627;494;1583;950;3210
315053;201406;1170;3495;1018;3251;255;965;421;1294;676;2259
315057;201406;1934;6629;1574;6069;255;1018;983;3915;1238;4933
315060;201406;980;3314;803;2885;250;974;201;749;451;1723
315070;201406;715;2193;663;2117;180;644;366;1112;546;1756
315080;201406;3514;12185;3170;11454;853;3301;1498;5445;2351;8746
315090;201406;765;2798;682;2620;182;745;248;997;430;1742
315100;201406;1192;4134;966;3627;296;1237;241;847;537;2084
315110;201406;1708;5270;1496;4885;400;1425;684;2216;1084;3641
315120;201406;13999;34125;10141;29144;1922;5810;5523;16764;7445;22574
315130;201406;1847;6173;1668;5809;575;2195;436;1479;1011;3674
315140;201406;2612;8817;2187;7889;635;2652;701;2258;1336;4910
315150;201406;4918;13647;3690;11483;884;3184;1381;4145;2265;7329
315160;201406;1359;3927;1222;3733;250;837;710;2133;960;2970
315170;201406;1386;4124;1188;3834;231;815;664;2294;895;3109
315180;201406;14449;45151;11095;37988;3216;12416;2749;9060;5965;21476
315190;201406;2413;6492;1977;5859;593;1862;935;2781;1528;4643
315200;201406;4592;15647;3846;13971;1215;4800;1065;3776;2280;8576
315210;201406;9037;27877;7637;25122;2563;9159;2649;8576;5212;17735
315213;201406;1150;3745;1102;3677;106;307;931;3203;1037;3510
315217;201406;2769;9362;2325;8595;382;1602;1345;4983;1727;6585
315220;201406;10329;30771;9159;29152;2183;6949;5333;17591;7516;24540
315230;201406;2560;6947;2324;6669;145;339;2048;6019;2193;6358
315240;201406;3399;10891;3070;10348;617;2237;1878;6346;2495;8583
315250;201406;9815;31751;7534;27422;2503;10162;2399;8689;4902;18851
315260;201406;1135;3713;902;3200;340;1333;171;541;511;1874
315270;201406;890;3201;772;2953;261;1070;201;746;462;1816
315280;201406;4041;12451;3196;10552;1114;3879;820;2582;1934;6461
315290;201406;1296;3733;1003;3261;372;1342;211;671;583;2013
315300;201406;546;1563;425;1413;205;706;145;468;350;1174
315310;201406;1250;4178;1117;3946;165;675;734;2537;899;3212
315320;201406;899;2922;747;2708;206;815;356;1341;562;2156
315330;201406;783;2801;555;2209;192;862;83;305;275;1167
315340;201406;4258;12524;3641;11555;947;3242;1689;5468;2636;8710
315350;201406;1903;5380;1514;4837;250;811;1025;3375;1275;4186
315360;201406;1752;5925;1435;5087;352;1364;488;1625;840;2989
315370;201406;618;1881;545;1770;129;456;306;990;435;1446
315380;201406;293;1032;252;929;92;372;41;137;133;509
315390;201406;1968;7067;1726;6493;622;2499;441;1643;1063;4142
315400;201406;4768;14784;4190;13629;989;3480;2161;7030;3150;10510
315410;201406;1822;5090;1541;4647;278;1046;928;2678;1206;3724
315415;201406;1216;4094;1118;3940;450;1577;492;1828;942;3405
315420;201406;1543;4890;1164;4158;392;1465;210;719;602;2184
315430;201406;4090;11316;3103;9642;851;2996;962;2877;1813;5873
315440;201406;989;3059;886;2897;174;640;492;1603;666;2243
315445;201406;2233;6369;1879;5895;280;1018;1290;4016;1570;5034
315450;201406;2529;8086;2357;7827;480;1573;1516;5223;1996;6796
315460;201406;39806;134676;35677;125816;12634;47977;9389;32240;22023;80217
315470;201406;565;1782;505;1680;77;282;329;1083;406;1365
315480;201406;1469;4640;1013;3588;224;898;207;685;431;1583
315490;201406;3308;9514;2833;8833;493;1791;1614;4920;2107;6711
315500;201406;473;1503;312;1115;62;270;109;324;171;594
315510;201406;1462;4231;1255;3897;101;350;908;2830;1009;3180
315520;201406;1178;3658;975;3383;166;667;601;2023;767;2690
315530;201406;509;1806;478;1750;221;859;171;596;392;1455
315540;201406;1278;3931;1023;3508;236;987;367;1226;603;2213
315550;201406;1830;5313;1505;4902;512;1859;606;1971;1118;3830
315560;201406;7342;24229;6718;23403;986;3738;4606;16213;5592;19951
315570;201406;2412;7629;2254;7395;498;1848;1317;4261;1815;6109
315580;201406;2772;8639;2261;7663;646;2546;848;2681;1494;5227
315590;201406;910;2668;824;2543;127;454;536;1613;663;2067
315600;201406;2669;9421;2218;8651;407;1665;1266;5172;1673;6837
315610;201406;1034;3104;871;2754;201;785;322;849;523;1634
315620;201406;342;1219;334;1203;102;359;172;645;274;1004
315630;201406;1010;3285;875;3062;256;967;247;838;503;1805
315640;201406;813;2480;696;2255;212;767;261;805;473;1572
315645;201406;884;2863;769;2588;311;1149;193;617;504;1766
315650;201406;1987;5756;1753;5421;163;654;1312;3966;1475;4620
315660;201406;2702;7368;2397;6917;459;1376;1475;4237;1934;5613
315670;201406;12217;43706;11214;41649;4117;16284;3690;13546;7807;29830
315680;201406;2932;10310;2423;9340;911;3585;617;2516;1528;6101
315690;201406;3426;10887;2790;9720;975;3703;821;2910;1796;6613
315700;201406;7501;24027;6502;22001;1393;5421;3147;10186;4540;15607
315710;201406;1845;5505;1501;4965;207;815;904;2960;1111;3775
315720;201406;3098;10075;2837;9584;716;2781;1370;4367;2086;7148
315725;201406;1683;5209;1369;4796;390;1413;720;2569;1110;3982
315727;201406;664;2105;592;1957;137;494;289;939;426;1433
315730;201406;1009;3139;919;2968;200;692;521;1691;721;2383
315733;201406;1194;3876;1103;3693;463;1629;367;1211;830;2840
315737;201406;1394;4247;1131;3780;125;481;724;2447;849;2928
315740;201406;1068;3442;927;3164;214;870;455;1451;669;2321
315750;201406;1165;3642;1049;3479;109;450;781;2537;890;2987
315760;201406;966;2722;935;2681;26;80;864;2482;890;2562
315765;201406;1527;4689;1420;4521;146;490;1099;3545;1245;4035
315770;201406;1721;5623;1565;5287;451;1646;576;1902;1027;3548
315780;201406;24160;80510;22432;76724;7469;27210;7101;24370;14570;51580
315790;201406;3314;11441;2975;10714;377;1308;2003;7433;2380;8741
315800;201406;1566;6146;1301;5361;407;1845;264;1045;671;2890
315810;201406;1525;4378;1300;4020;218;733;838;2536;1056;3269
315820;201406;3068;10104;2619;9424;766;2881;1291;4781;2057;7662
315830;201406;1482;5064;1367;4823;348;1376;441;1463;789;2839
315840;201406;764;2084;592;1769;114;400;215;588;329;988
315850;201406;1352;4813;1303;4712;359;1365;579;2046;938;3411
315860;201406;470;1708;378;1523;113;533;76;295;189;828
315870;201406;485;1464;411;1349;123;448;146;440;269;888
315880;201406;1126;3112;938;2873;237;832;470;1423;707;2255
315890;201406;1718;5877;1553;5625;505;1905;764;2852;1269;4757
315895;201406;5298;16699;4906;15974;1313;4763;2328;7392;3641;12155
315900;201406;798;2557;748;2470;167;656;441;1351;608;2007
315910;201406;629;2235;587;2154;219;831;274;999;493;1830
315920;201406;1499;4449;1082;3572;310;1166;333;1001;643;2167
315930;201406;1132;3197;926;2829;265;885;334;995;599;1880
315935;201406;1180;4024;1098;3844;353;1355;354;1205;707;2560
315940;201406;667;2141;601;2013;181;684;248;802;429;1486
315950;201406;1276;3967;1186;3788;294;954;699;2287;993;3241
315960;201406;2844;9614;2198;8317;1055;4555;151;499;1206;5054
315970;201406;813;2295;655;2073;74;227;480;1575;554;1802
315980;201406;4417;10990;2921;8422;760;2497;919;2337;1679;4834
315990;201406;4442;13348;3909;12521;859;3213;2111;6693;2970;9906
316000;201406;599;1974;535;1872;236;894;160;538;396;1432
316010;201406;462;1695;409;1579;113;518;120;407;233;925
316020;201406;1199;3823;965;3415;180;749;544;1908;724;2657
316030;201406;3757;10685;2695;8941;392;1407;1440;4939;1832;6346
316040;201406;3577;11369;2566;9061;462;1872;308;812;770;2684
316045;201406;2152;6954;1994;6686;290;898;1435;5057;1725;5955
316050;201406;380;1238;331;1165;80;315;173;584;253;899
316060;201406;793;2394;650;2188;124;517;368;1165;492;1682
316070;201406;6233;20815;5716;19744;1765;6767;2451;8091;4216;14858
316080;201406;751;2825;680;2631;189;815;140;546;329;1361
316090;201406;652;1935;483;1569;123;457;133;389;256;846
316095;201406;1334;4435;1203;4188;260;924;770;2755;1030;3679
316100;201406;2737;9306;2146;7781;587;2429;452;1518;1039;3947
316105;201406;979;2775;735;2373;167;596;350;1150;517;1746
316110;201406;12640;44492;11490;42364;1612;6472;7923;29993;9535;36465
316120;201406;1311;4507;1190;4214;388;1424;445;1556;833;2980
316130;201406;1472;3368;1006;2741;199;636;525;1402;724;2038
316140;201406;1098;3271;852;2874;124;467;513;1755;637;2222
316150;201406;1400;4259;1333;4157;342;1238;744;2239;1086;3477
316160;201406;1268;3832;1002;3298;135;512;561;1826;696;2338
316165;201406;996;2760;836;2511;169;583;477;1410;646;1993
316170;201406;1417;4142;1069;3521;239;904;450;1394;689;2298
316180;201406;1285;4142;1006;3552;289;1195;273;870;562;2065
316190;201406;2742;8553;1469;5206;342;1286;267;824;609;2110
316200;201406;3933;12855;3050;11061;801;3347;913;3218;1714;6565
316210;201406;5478;17495;4795;16203;2171;7877;1008;3406;3179;11283
316220;201406;681;2135;476;1732;121;517;61;229;182;746
316225;201406;1107;3271;988;3112;137;517;683;2106;820;2623
316230;201406;464;1395;383;1251;79;278;197;673;276;951
316240;201406;6609;20700;5764;19593;661;2290;4429;15273;5090;17563
316245;201406;3174;11206;2985;10886;280;1250;2290;8336;2570;9586
316250;201406;9479;30016;8293;27585;3118;11297;2436;7656;5554;18953
316255;201406;2418;7673;2146;7343;362;1209;1520;5320;1882;6529
316257;201406;1442;4092;1120;3516;283;991;411;1252;694;2243
316260;201406;1900;5453;1427;4760;300;1112;774;2621;1074;3733
316265;201406;1201;3502;1036;3174;103;357;746;2255;849;2612
316270;201406;5231;16883;4842;16081;1390;4898;2207;7425;3597;12323
316280;201406;3393;11334;3065;10669;606;2334;1721;5994;2327;8328
316290;201406;3266;10829;2958;10237;776;3078;1323;4362;2099;7440
316292;201406;3878;13031;3564;12436;1066;4080;1571;5244;2637;9324
316294;201406;865;2819;564;2092;139;606;76;255;215;861
316295;201406;2024;7239;1902;6992;440;1875;1049;3661;1489;5536
316300;201406;1003;3131;870;2890;81;282;601;2041;682;2323
316310;201406;701;2230;547;1911;134;531;196;669;330;1200
316320;201406;579;1967;518;1880;135;527;160;568;295;1095
316330;201406;1033;3153;828;2717;135;448;494;1650;629;2098
316340;201406;1173;3851;1019;3539;319;1270;325;1030;644;2300
316350;201406;1497;4825;1363;4593;285;972;735;2643;1020;3615
316360;201406;790;2069;617;1830;73;225;470;1404;543;1629
316370;201406;5169;17205;4595;16023;1630;6106;1120;3985;2750;10091
316380;201406;1509;4274;1246;3888;130;469;883;2771;1013;3240
316390;201406;950;2877;793;2602;255;910;344;1147;599;2057
316400;201406;1502;5077;1321;4753;374;1442;543;1966;917;3408
316410;201406;1229;4128;1149;3999;265;991;669;2333;934;3324
316420;201406;2057;6885;1896;6669;280;1117;1242;4394;1522;5511
316430;201406;983;3031;810;2712;251;933;297;941;548;1874
316440;201406;660;2216;579;2110;242;1004;210;732;452;1736
316443;201406;719;2203;608;1985;156;557;255;813;411;1370
316447;201406;1373;4534;1313;4429;132;459;1094;3713;1226;4172
316450;201406;2272;7878;2017;7379;410;1570;1236;4630;1646;6200
316460;201406;898;2898;842;2806;249;921;471;1493;720;2414
316470;201406;8303;27533;6596;23690;2095;8547;2003;6879;4098;15426
316480;201406;252;877;227;832;65;256;76;267;141;523
316490;201406;380;1229;362;1187;125;428;153;484;278;912
316500;201406;1077;3952;748;2930;169;723;51;188;220;911
316510;201406;977;3556;872;3325;347;1364;233;887;580;2251
316520;201406;1236;3883;1031;3565;277;1092;387;1218;664;2310
316530;201406;1164;3805;974;3406;251;1080;372;1088;623;2168
316540;201406;1022;3369;920;3197;267;1101;335;1058;602;2159
316550;201406;1298;4436;1197;4277;254;981;750;2704;1004;3685
316553;201406;2336;8622;1974;7751;700;2958;477;1798;1177;4756
316555;201406;2911;10127;2578;9748;240;880;2068;8018;2308;8898
316556;201406;622;1746;511;1546;49;197;359;1028;408;1225
316557;201406;730;2707;705;2666;332;1330;208;749;540;2079
316560;201406;369;1268;311;1134;87;368;78;248;165;616
316570;201406;1455;4649;1274;4267;256;936;676;2261;932;3197
316580;201406;293;858;227;731;59;227;81;242;140;469
316590;201406;1508;4273;1158;3679;213;806;663;2027;876;2833
316600;201406;1188;3928;1078;3697;180;670;658;2228;838;2898
316610;201406;616;2297;576;2224;145;625;330;1259;475;1884
316620;201406;2255;7206;1982;6659;492;1821;1007;3318;1499;5139
316630;201406;1565;5259;1380;4869;580;2115;424;1511;1004;3626
316640;201406;260;856;226;780;60;236;92;303;152;539
316650;201406;968;3731;863;3554;193;831;479;2092;672;2923
316660;201406;140;434;122;399;29;112;57;175;86;287
316670;201406;1907;5602;1550;4919;599;2118;385;1091;984;3209
316680;201406;2055;6045;1773;5615;231;715;1371;4441;1602;5156
316690;201406;1196;4107;1082;3901;370;1514;401;1408;771;2922
316695;201406;1267;3950;1132;3714;121;393;747;2564;868;2957
316700;201406;358;1221;334;1162;88;353;158;510;246;863
316710;201406;3518;13393;3075;12416;1069;4549;976;4144;2045;8693
316720;201406;20153;68858;17415;62715;6235;23828;4818;17250;11053;41078
316730;201406;445;1416;392;1314;98;385;202;622;300;1007
316740;201406;776;2675;701;2522;273;1058;214;738;487;1796
316750;201406;434;1523;390;1428;113;471;127;427;240;898
316760;201406;3648;12390;3112;11777;1718;6474;1025;4143;2743;10617
316770;201406;1514;4498;1349;4275;209;711;923;3031;1132;3742
316780;201406;723;2522;674;2426;258;996;194;663;452;1659
316790;201406;864;2572;642;2180;179;692;233;770;412;1462
316800;201406;5954;19980;5419;18983;1162;4735;2768;9272;3930;14007
316805;201406;903;2449;852;2382;155;412;633;1828;788;2240
316810;201406;601;1873;524;1708;172;615;230;721;402;1336
316820;201406;399;1151;274;938;98;360;65;221;163;581
316830;201406;637;2270;615;2233;217;849;254;897;471;1746
316840;201406;2989;9145;2584;8399;705;2596;1080;3326;1785;5922
316850;201406;2211;7010;2020;6664;447;1613;1112;3684;1559;5297
316860;201406;24240;76103;22084;72089;6181;22198;9929;32167;16110;54365
316870;201406;7309;24658;6387;22409;2387;8980;1370;4697;3757;13677
316880;201406;912;3103;883;3056;361;1374;286;931;647;2305
316890;201406;1479;3847;1180;3437;479;1533;474;1320;953;2853
316900;201406;2794;8904;2441;8187;800;2975;812;2490;1612;5465
316905;201406;479;1662;430;1548;191;725;131;450;322;1175
316910;201406;749;2580;603;2262;153;602;203;789;356;1391
316920;201406;1601;4890;1300;4415;239;866;646;2213;885;3079
316930;201406;9830;34170;8346;30833;2611;10696;1830;6354;4441;17050
316935;201406;5014;15194;3564;12335;1238;4754;746;2460;1984;7214
316940;201406;7186;24424;6080;22001;1688;6793;1642;5733;3330;12526
316950;201406;1550;4636;1359;4374;210;800;920;2939;1130;3739
316960;201406;5588;14486;4645;13269;1020;3133;2727;7810;3747;10943
316970;201406;3633;11968;3448;11639;1202;4568;1133;3569;2335;8137
316980;201406;1118;3313;809;2780;344;1295;214;742;558;2037
316990;201406;10231;34491;9197;32114;3843;14570;1265;4196;5108;18766
317000;201406;2749;9657;2660;9551;222;682;2137;8400;2359;9082
317005;201406;2552;8251;2378;8020;384;1302;1727;5940;2111;7242
317010;201406;32327;86508;21114;67771;6157;21877;5454;18370;11611;40247
317020;201406;53607;158212;35596;120041;9628;35764;8795;27966;18423;63730
317030;201406;887;2543;747;2333;124;448;432;1356;556;1804
317040;201406;13431;41084;11764;37949;4052;13602;4778;15695;8830;29297
317043;201406;868;2509;736;2331;162;537;445;1434;607;1971
317047;201406;1181;3249;917;2792;182;618;435;1313;617;1931
317050;201406;1910;6806;1629;6136;496;2009;588;2138;1084;4147
317052;201406;2505;8086;2232;7672;271;1029;1658;5753;1929;6782
317057;201406;1814;5298;1412;4597;221;856;758;2403;979;3259
317060;201406;392;1176;304;983;76;281;108;315;184;596
317065;201406;1235;4137;1121;3949;132;533;872;3054;1004;3587
317070;201406;9143;30497;7066;25720;2145;8648;1576;5768;3721;14416
317075;201406;1286;4039;1099;3683;377;1361;386;1255;763;2616
317080;201406;7304;21119;6620;19970;2048;6629;2615;7893;4663;14522
317090;201406;4949;16922;4630;16363;737;2626;3149;11414;3886;14040
317100;201406;3384;9997;2903;9180;966;3391;1202;3606;2168;6997
317103;201406;2037;7142;1724;6486;362;1673;782;2861;1144;4534
317107;201406;1374;4301;1188;3924;257;979;642;1999;899;2978
317110;201406;764;2091;534;1650;157;563;205;585;362;1148
317115;201406;1111;3598;972;3287;147;523;631;2148;778;2671
317120;201406;13686;46852;11764;42272;3973;15237;4439;15774;8412;31011
317130;201406;9127;29324;8203;27650;2288;8630;3630;12008;5918;20638
317140;201406;670;2319;630;2242;87;338;410;1459;497;1797
317150;201406;1074;2983;909;2795;111;390;671;2059;782;2449
317160;201406;3873;10454;2936;9255;431;1601;1967;6134;2398;7735
317170;201406;2036;5986;1814;5590;267;944;1094;3223;1361;4167
317180;201406;1860;6353;1482;5491;440;1796;455;1634;895;3430
317190;201406;1331;3952;1156;3703;149;483;843;2712;992;3195
317200;201406;4802;15994;4362;15080;1499;5634;1340;4488;2839;10122
317210;201406;1115;3485;945;3219;268;1010;449;1536;717;2546
317220;201406;360;1292;349;1279;122;449;187;710;309;1159
320010;201406;5996;19002;5334;17506;1012;3560;2754;9029;3766;12589
320013;201406;2095;6227;1484;5080;231;835;813;2858;1044;3693
320016;201406;3568;10017;3015;9218;472;1444;2111;6584;2583;8028
320020;201406;4296;14019;3953;13268;1317;4692;1491;4970;2808;9662
320030;201406;1525;4986;1300;4504;396;1458;537;1801;933;3259
320035;201406;1844;5725;1672;5442;554;1981;702;2195;1256;4176
320040;201406;3259;11113;2728;9827;766;3038;814;2796;1580;5834
320050;201406;1944;5401;1676;4876;303;992;980;2795;1283;3787
320060;201406;11616;36939;9057;30909;2272;8563;3341;10906;5613;19469
320070;201406;1853;6279;1616;5704;545;2034;435;1443;980;3477
320080;201406;5724;16973;4610;14747;1438;4917;1535;4872;2973;9789
320090;201406;9210;26543;7199;22589;1989;6668;3200;9757;5189;16425
320100;201406;3310;10070;2748;8936;676;2349;1320;4237;1996;6586
320110;201406;1560;4799;1417;4520;385;1305;515;1623;900;2928
320115;201406;1818;6662;1721;6453;834;3207;589;2269;1423;5476
320120;201406;18616;62395;15759;56596;5711;21886;4666;16971;10377;38857
320130;201406;42043;140972;39028;134516;11060;41466;18465;62238;29525;103704
320140;201406;4070;13329;2919;10469;796;3188;320;1063;1116;4251
320150;201406;18556;53158;13959;44318;4466;15309;2723;8538;7189;23847
320160;201406;5355;16619;4647;15424;1268;4761;2000;6181;3268;10942
320170;201406;2005;6607;1768;6079;603;2153;611;2154;1214;4307
320180;201406;919;3043;826;2900;305;1110;332;1180;637;2290
320190;201406;4551;16107;3898;14470;1300;5051;1224;4501;2524;9552
320200;201406;1170;3809;1030;3529;302;1096;459;1617;761;2713
320210;201406;6146;17016;5320;15597;1334;4319;2766;7844;4100;12163
320220;201406;2973;9153;2366;8065;708;2629;913;3159;1621;5788
320225;201406;1530;5432;1325;4899;501;1954;301;1173;802;3127
320230;201406;4297;14533;4016;13980;1380;5111;1489;5328;2869;10439
320240;201406;10251;31346;8082;27126;2484;8961;2280;7750;4764;16711
320245;201406;4181;14370;3891;13650;1271;4683;1432;4957;2703;9640
320250;201406;1835;5764;1369;4681;368;1405;302;927;670;2332
320255;201406;2054;6907;1784;6435;724;2797;641;2371;1365;5168
320260;201406;1149;3596;883;2897;241;890;312;884;553;1774
320265;201406;2543;7907;2169;7459;289;1002;1603;5687;1892;6689
320270;201406;2765;8548;2142;7300;548;2020;944;3187;1492;5207
320280;201406;7323;22470;6701;21350;1554;5337;3495;10983;5049;16320
320290;201406;1725;5745;1387;4888;503;1870;368;1188;871;3058
320300;201406;4356;14841;4038;14098;1279;4703;1379;4835;2658;9538
320305;201406;4856;16092;4425;15103;1160;4326;2088;6960;3248;11286
320310;201406;2049;6254;1818;5826;487;1690;827;2580;1314;4270
320313;201406;2423;7318;1739;5726;504;1915;306;904;810;2819
320316;201406;2250;7096;2117;6784;651;2179;933;2982;1584;5161
320320;201406;19399;63155;16720;57926;5121;19801;6568;22113;11689;41914
320330;201406;3035;9292;2643;8623;558;1781;1555;5262;2113;7043
320332;201406;5139;17570;4646;16633;1549;5815;1902;7023;3451;12838
320334;201406;1639;5552;1269;4725;456;1887;256;873;712;2760
320335;201406;2291;6952;1638;5462;575;2088;341;1094;916;3182
320340;201406;5869;16774;4746;14813;1168;4005;2236;6905;3404;10910
320350;201406;5687;14863;4194;12291;851;2748;2011;5828;2862;8576
320360;201406;1795;4841;1368;4035;274;924;655;1791;929;2715
320370;201406;3543;11778;3055;10791;971;3494;1218;4355;2189;7849
320380;201406;2866;8823;2565;8243;521;1818;1471;4657;1992;6475
320390;201406;8413;25744;6969;22802;2163;7777;2370;7460;4533;15237
320400;201406;4181;12157;3493;11140;890;3182;1769;5401;2659;8583
320405;201406;4139;12430;3800;11977;1078;3699;2182;6743;3260;10442
320410;201406;6356;15746;4605;13724;810;2495;3013;9062;3823;11557
320420;201406;1495;4697;1095;3981;376;1527;205;698;581;2225
320425;201406;2490;6415;2033;5734;360;1113;1230;3452;1590;4565
320430;201406;2420;7175;2185;6699;443;1452;1160;3524;1603;4976
320435;201406;2590;8792;2219;7994;1025;3851;714;2650;1739;6501
320440;201406;1458;4912;1303;4476;397;1468;416;1352;813;2820
320450;201406;2563;8312;2187;7500;655;2434;931;3114;1586;5548
320455;201406;4742;16785;3735;14194;1291;5132;851;3218;2142;8350
320460;201406;3164;10385;2562;9065;760;2875;936;3230;1696;6105
320465;201406;1667;5324;1320;4484;310;1144;519;1693;829;2837
320470;201406;4723;14639;3398;11675;1111;4151;536;1696;1647;5847
320480;201406;2002;6128;1671;5479;422;1593;734;2285;1156;3878
320490;201406;18016;57797;15260;52303;5229;19037;5189;18263;10418;37300
320495;201406;1468;4678;1177;4002;485;1739;278;931;763;2670
320500;201406;47776;150218;41683;138500;12814;46145;18521;60313;31335;106458
320501;201406;3746;12395;3449;11886;1156;4421;1535;5134;2691;9555
320503;201406;2007;7227;1705;6454;566;2339;510;1744;1076;4083
320506;201406;3419;10888;2362;8186;756;2808;286;891;1042;3699
320510;201406;8819;28385;7770;26271;2523;9163;3159;10543;5682;19706
320515;201406;2161;6246;1915;5763;561;1783;702;2068;1263;3851
320517;201406;2309;7617;1928;6792;756;2867;443;1469;1199;4336
320520;201406;34626;111746;29644;101849;9475;35549;12362;42354;21837;77903
320530;201406;28721;90618;24820;82728;6700;25281;11043;34999;17743;60280
330010;201406;18024;56881;16689;54148;3390;12400;10156;31943;13546;44343
330015;201406;2002;5639;1738;5138;469;1538;655;1885;1124;3423
330020;201406;17078;51704;15636;49350;3712;12562;8880;27847;12592;40409
330022;201406;1708;5506;1522;5146;329;1307;826;2665;1155;3972
330023;201406;3521;11545;3304;11091;924;3387;1390;4469;2314;7856
330025;201406;3477;10617;3157;10144;801;2769;1870;5915;2671;8684
330030;201406;7877;27322;7192;25892;2015;7982;3257;11262;5272;19244
330040;201406;14624;42447;12468;38946;3338;11208;6337;19463;9675;30671
330045;201406;68803;199139;62787;189964;9347;30376;43544;131032;52891;161408
330050;201406;3010;9640;2690;8997;942;3504;776;2440;1718;5944
330060;201406;5708;17546;5143;16711;1238;4458;2968;9682;4206;14140
330070;201406;25852;80878;23699;76949;6606;22724;11053;36022;17659;58746
330080;201406;9558;27561;9103;26927;1720;4918;6327;19330;8047;24248
330090;201406;3333;9318;3100;8915;864;2674;1503;4261;2367;6935
330093;201406;2040;6089;1723;5479;449;1516;598;1821;1047;3337
330095;201406;1220;4253;1134;4055;435;1704;214;692;649;2396
330100;201406;56152;186381;51975;178954;11895;45203;27117;94253;39012;139456
330110;201406;2709;8635;2485;8223;801;2876;853;2820;1654;5696
330115;201406;2516;7575;2316;7230;708;2428;1054;3172;1762;5600
330120;201406;2557;7513;2341;7215;736;2421;1093;3284;1829;5705
330130;201406;4117;13642;3720;12871;1237;4583;1490;5153;2727;9736
330140;201406;3452;10667;3156;10261;871;3031;1575;5181;2446;8212
330150;201406;2641;7960;2050;6719;550;1949;495;1589;1045;3538
330160;201406;1419;4956;1317;4737;477;1850;487;1719;964;3569
330170;201406;106025;324280;99292;313660;15162;51341;69761;220654;84923;271995
330180;201406;1848;5673;1646;5287;230;950;1037;3104;1267;4054
330185;201406;8157;26042;7569;25013;1984;6827;4177;14154;6161;20981
330187;201406;4475;12919;3964;12055;865;2887;2333;7098;3198;9985
330190;201406;28833;87450;27484;85230;6546;21444;16861;51840;23407;73284
330200;201406;14143;44925;12738;42245;3001;10181;6948;23452;9949;33633
330205;201406;2641;7223;2344;6716;588;1877;1172;3248;1760;5125
330210;201406;4692;12301;3349;9816;1027;3249;808;2342;1835;5591
330220;201406;11792;37394;10852;35415;3614;12709;3496;10928;7110;23637
330225;201406;4177;13207;3927;12830;527;1991;2831;9322;3358;11313
330227;201406;18080;51768;16293;49282;4031;12929;9339;27836;13370;40765
330230;201406;1534;4560;1405;4324;406;1396;587;1688;993;3084
330240;201406;20929;65485;18680;61359;7545;26720;3750;12172;11295;38892
330245;201406;1279;4084;1060;3633;323;1219;246;835;569;2054
330250;201406;38128;112694;35626;108531;10300;31602;18492;57662;28792;89264
330260;201406;3980;12662;3670;11992;944;3377;1723;5440;2667;8817
330270;201406;14566;42760;12268;39092;3714;12514;4731;15382;8445;27896
330280;201406;2088;6558;1777;5922;386;1430;846;2678;1232;4108
330285;201406;19429;57717;17866;55462;3684;12246;11384;35461;15068;47707
330290;201406;3681;10411;3262;9819;674;2317;1946;5602;2620;7919
330300;201406;4199;13715;3930;13221;945;3398;2137;7212;3082;10610
330310;201406;2852;8285;2580;7823;621;1929;1325;4014;1946;5943
330320;201406;12709;38293;11933;37092;1835;6197;8545;26476;10380;32673
330330;201406;32621;94187;29959;89950;7000;22467;18340;54500;25340;76967
330340;201406;15105;46916;12394;41506;4003;14350;3816;12723;7819;27073
330350;201406;95282;303433;92158;298804;16714;54672;66154;217621;82868;272293
330360;201406;5684;18041;5555;17843;745;2589;4307;13796;5052;16385
330370;201406;3904;14547;3691;14020;1423;5660;1289;4938;2712;10598
330380;201406;4669;15226;4099;14154;1031;3822;2103;7222;3134;11044
330385;201406;4159;14518;3853;13887;1301;4971;1523;5472;2824;10443
330390;201406;24470;82924;22469;78911;5548;21766;11636;40013;17184;61779
330395;201406;3444;10312;3189;9865;586;1994;1944;5976;2530;7970
330400;201406;2649;8883;2421;8449;529;2140;1259;4074;1788;6214
330410;201406;3116;9978;2692;9118;620;2217;1373;4667;1993;6884
330411;201406;2637;8372;2327;7743;482;1874;1244;3918;1726;5792
330412;201406;1418;4920;1132;4355;313;1391;402;1447;715;2838
330414;201406;26261;75085;22599;70147;4273;13908;14537;45460;18810;59368
330415;201406;3730;11761;3299;10959;863;3126;1439;4774;2302;7900
330420;201406;8767;27543;6440;22831;1952;7636;1198;4208;3150;11844
330430;201406;8388;24953;7544;23471;1781;6128;3838;11712;5619;17840
330440;201406;2131;7161;1795;6456;643;2577;409;1342;1052;3919
330450;201406;1650;5758;1559;5567;508;2027;659;2299;1167;4326
330452;201406;10532;32873;8789;29401;2503;9300;3645;11713;6148;21013
330455;201406;488153;1433090;418030;1318199;109740;368962;214811;676079;324551;1045041
330460;201406;1416;4770;1319;4593;334;1335;643;2215;977;3550
330470;201406;4644;15175;4291;14459;1513;5525;1504;4933;3017;10458
330475;201406;8482;26902;7634;25463;2099;7549;3697;12384;5796;19933
330480;201406;6697;20117;6161;19268;1723;5787;2870;8923;4593;14710
330490;201406;102893;289526;95601;278912;12474;38156;73532;215492;86006;253648
330500;201406;6981;21446;6568;20621;1468;4937;3605;11564;5073;16501
330510;201406;43665;140853;40977;136368;13154;44541;20641;70250;33795;114791
330513;201406;1613;4874;1476;4609;526;1666;587;1861;1113;3527
330515;201406;3138;9971;2858;9438;958;3352;1050;3424;2008;6776
330520;201406;13534;40765;12383;38833;3179;10425;6604;20852;9783;31277
330530;201406;1583;4735;1454;4503;371;1251;724;2192;1095;3443
330540;201406;3460;10463;2986;9695;862;3007;1244;3987;2106;6994
330550;201406;9145;30245;8069;28221;3306;12228;2140;7577;5446;19805
330555;201406;10629;32526;9560;30893;1890;6286;6116;20149;8006;26435
330560;201406;4283;13164;3996;12685;868;3128;2214;6846;3082;9974
330570;201406;3718;10791;3169;9853;814;2605;1646;5192;2460;7797
330575;201406;5644;16950;5152;16078;1151;3922;3032;9184;4183;13106
330580;201406;17515;56679;15360;52311;5065;18083;5876;20420;10941;38503
330590;201406;1993;6043;1861;5811;537;1689;978;3118;1515;4807
330600;201406;10490;30890;8671;27919;1393;5359;5152;15954;6545;21313
330610;201406;9203;29917;8509;28621;2113;7933;4329;14381;6442;22314
330615;201406;1686;6075;1558;5721;696;2661;452;1722;1148;4383
330620;201406;4118;14465;3784;13798;1395;5410;1111;4194;2506;9604
330630;201406;22053;71914;19661;67112;5279;20081;9752;31948;15031;52029
350010;201406;3031;9499;2370;8104;805;2881;472;1542;1277;4423
350020;201406;623;1772;482;1510;141;504;192;565;333;1069
350030;201406;4865;15637;4058;13805;1476;5479;1159;3786;2635;9265
350040;201406;606;2190;525;2007;179;739;117;401;296;1140
350050;201406;1426;4688;1198;4252;342;1390;407;1344;749;2734
350055;201406;640;2125;610;2078;199;750;298;962;497;1712
350060;201406;89;311;82;298;25;107;33;112;58;219
350070;201406;2843;9449;2266;8087;558;2194;445;1377;1003;3571
350075;201406;558;1947;481;1817;166;703;133;455;299;1158
350080;201406;616;1816;478;1525;121;426;188;595;309;1021
350090;201406;587;1681;443;1432;127;437;125;370;252;807
350100;201406;2079;7080;1694;6178;580;2257;510;1803;1090;4060
350110;201406;487;1498;383;1259;101;377;137;410;238;787
350115;201406;1393;4521;1233;4128;252;973;597;1837;849;2810
350120;201406;555;1495;293;930;72;249;59;177;131;426
350130;201406;3833;11761;3467;11032;878;3121;1617;4805;2495;7926
350140;201406;704;2230;634;2092;155;586;280;883;435;1469
350150;201406;435;1505;400;1424;156;582;106;376;262;958
350160;201406;6324;20036;4854;16804;1476;5671;1821;5786;3297;11457
350170;201406;2303;8216;2066;7607;730;2794;501;1775;1231;4569
350180;201406;1470;3883;1222;3459;319;927;540;1513;859;2440
350190;201406;3376;11463;2919;10541;813;3431;1405;4591;2218;8022
350200;201406;417;1426;379;1360;130;523;136;471;266;994
350210;201406;7697;21697;6142;18985;2331;7777;2073;6135;4404;13912
350220;201406;3189;10285;2903;9762;1040;3957;905;2767;1945;6724
350230;201406;774;2635;710;2528;239;923;254;900;493;1823
350240;201406;602;1840;521;1706;123;465;295;931;418;1396
350250;201406;2805;10454;2715;10273;1119;4482;963;3613;2082;8095
350260;201406;1100;2948;905;2603;215;634;401;1180;616;1814
350270;201406;5426;16737;4780;15379;985;3484;2338;7422;3323;10906
350275;201406;2071;6933;1865;6621;564;2226;740;2470;1304;4696
350280;201406;23519;61943;15476;47291;4110;13367;3662;11327;7772;24694
350290;201406;1851;6446;1643;5956;508;1889;528;1976;1036;3865
350300;201406;535;1667;481;1563;147;493;196;652;343;1145
350310;201406;957;3224;877;3033;217;848;364;1196;581;2044
350315;201406;570;1817;472;1610;89;386;153;493;242;879
350320;201406;11843;38930;10669;36308;3406;12363;1923;6547;5329;18910
350330;201406;11259;33036;8514;26481;1994;6736;3679;10677;5673;17413
350335;201406;563;1670;521;1583;136;431;222;735;358;1166
350340;201406;1099;3488;871;3062;245;942;266;903;511;1845
350350;201406;770;2461;680;2309;176;688;247;833;423;1521
350360;201406;871;3126;766;2871;254;998;271;1031;525;2029
350370;201406;719;2244;550;1844;123;460;108;306;231;766
350380;201406;3907;12782;3282;11771;1370;5312;845;2897;2215;8209
350390;201406;8836;28622;7856;26795;2242;8219;3669;12155;5911;20374
350395;201406;345;1071;250;874;72;272;58;197;130;469
350400;201406;8617;25363;7120;22629;2072;7205;2763;8430;4835;15635
350410;201406;8018;29433;6969;26916;2476;10272;1704;6400;4180;16672
350420;201406;1027;3282;836;2909;415;1491;108;372;523;1863
350430;201406;874;2772;751;2553;210;836;381;1251;591;2087
350440;201406;1485;4785;1395;4605;449;1581;683;2179;1132;3760
350450;201406;8125;24875;6511;21622;2049;7361;1842;5876;3891;13237
350460;201406;1612;4783;1182;3857;359;1319;365;1065;724;2384
350470;201406;255;718;212;648;56;198;102;285;158;483
350480;201406;785;2455;535;1852;104;411;90;262;194;673
350490;201406;2156;6330;1842;5904;529;1942;860;2587;1389;4529
350500;201406;613;1821;532;1696;137;489;226;681;363;1170
350510;201406;1125;3605;936;3155;284;1080;328;996;612;2076
350520;201406;910;3422;784;3155;251;1096;222;838;473;1934
350530;201406;2630;7963;2173;6966;792;2738;618;1826;1410;4564
350535;201406;1507;4503;1450;4420;93;338;1224;3718;1317;4056
350540;201406;2102;6032;1771;5436;502;1649;709;2187;1211;3836
350550;201406;11133;32954;8994;29223;2478;9043;3586;11038;6064;20081
350560;201406;3610;12163;3270;11438;631;2369;1698;6001;2329;8370
350570;201406;21961;76134;20101;71788;6559;25015;7403;25513;13962;50528
350580;201406;2138;7058;1723;6069;579;2248;283;869;862;3117
350590;201406;4301;13892;3324;11782;1012;4003;1156;3715;2168;7718
350600;201406;40662;104397;28495;84796;5892;19299;14264;41009;20156;60308
350610;201406;9337;27667;7522;24530;2016;7318;3454;10886;5470;18204
350620;201406;500;1518;410;1377;106;400;174;553;280;953
350630;201406;1731;5403;1362;4643;413;1573;254;776;667;2349
350635;201406;5271;17150;4282;15204;1341;5027;1643;5853;2984;10880
350640;201406;689;2252;553;1876;158;577;160;506;318;1083
350650;201406;5273;16740;3387;12165;1190;4719;355;1249;1545;5968
350660;201406;3838;12198;3351;11337;882;3233;1693;5633;2575;8866
350670;201406;1898;5947;1777;5728;373;1309;1123;3506;1496;4815
350680;201406;1253;3916;1009;3407;296;1177;409;1314;705;2491
350690;201406;1104;3695;933;3330;291;1154;255;833;546;1987
350700;201406;2828;9778;2462;8945;950;3815;864;2797;1814;6612
350710;201406;2276;7241;2076;6919;342;1270;1392;4592;1734;5862
350715;201406;1130;3479;1000;3231;286;1053;372;1117;658;2170
350720;201406;140;430;127;404;40;144;50;137;90;281
350730;201406;439;1689;413;1614;134;584;128;464;262;1048
350740;201406;2486;7572;2194;6938;567;1937;933;2945;1500;4882
350745;201406;375;1202;308;1046;66;267;139;427;205;694
350750;201406;10257;31647;7930;26950;2279;8492;2169;6930;4448;15422
350760;201406;12611;40483;11381;38216;3587;13380;5157;16510;8744;29890
350770;201406;933;2771;673;2252;159;600;257;847;416;1447
350775;201406;674;1961;600;1836;153;530;277;831;430;1361
350780;201406;2192;6700;1638;5518;509;1892;225;700;734;2592
350790;201406;2181;7182;1754;6256;571;2199;381;1217;952;3416
350800;201406;3177;10863;3030;10617;657;2567;1865;6400;2522;8967
350810;201406;2636;7763;2316;7196;832;2802;742;2314;1574;5116
350820;201406;573;1589;425;1274;100;353;169;447;269;800
350830;201406;919;2926;667;2308;134;515;150;443;284;958
350840;201406;2393;8628;1986;7593;656;2764;405;1333;1061;4097
350850;201406;6788;23249;5672;20586;2029;7833;1394;4842;3423;12675
350860;201406;3440;11195;3292;10961;509;1911;2439;8070;2948;9981
350870;201406;2538;8637;2252;8187;693;2697;1223;4502;1916;7199
350880;201406;1723;5891;1481;5347;493;1881;319;1164;812;3045
350890;201406;656;1971;523;1682;101;389;171;458;272;847
350900;201406;4686;15834;3899;14038;1089;4261;1125;3844;2214;8105
350910;201406;902;2793;845;2667;339;1109;306;955;645;2064
350920;201406;10157;30594;9336;29224;1820;6263;5977;18142;7797;24405
350925;201406;5402;16926;4800;15716;1407;5028;2098;6598;3505;11626
350930;201406;1597;4467;1345;4052;160;596;955;2760;1115;3356
350940;201406;2353;7916;2149;7576;473;1937;1289;4356;1762;6293
350945;201406;964;3227;855;2995;217;834;379;1276;596;2110
350950;201406;73528;237419;62539;214882;18217;68217;26071;87189;44288;155406
350960;201406;4725;16746;4206;15561;833;3556;2345;8350;3178;11906
350970;201406;4535;16456;4044;15230;1460;5928;1230;4437;2690;10365
350980;201406;709;2305;646;2197;315;1138;163;555;478;1693
350990;201406;1848;6488;1627;6061;568;2243;545;1999;1113;4242
350995;201406;838;2999;794;2914;224;933;404;1426;628;2359
351000;201406;3726;11372;3210;10372;522;1929;1827;5690;2349;7619
351010;201406;432;1316;316;1077;124;467;71;242;195;709
351015;201406;972;3261;842;3013;306;1219;293;990;599;2209
351020;201406;8061;26254;7140;24820;1921;7167;3588;12591;5509;19758
351030;201406;1538;5648;1422;5384;420;1847;544;1924;964;3771
351040;201406;3865;12405;3572;11881;807;3124;2116;6634;2923;9758
351050;201406;10019;32226;8093;28436;2683;10266;2809;9802;5492;20068
351060;201406;35501;111598;29808;100873;9466;34085;11232;37800;20698;71885
351070;201406;1915;5487;1391;4550;504;1818;258;734;762;2552
351080;201406;2875;8779;2283;8042;674;2622;1083;3722;1757;6344
351090;201406;376;1322;304;1167;106;465;65;239;171;704
351100;201406;2093;6708;1788;6093;705;2486;553;1908;1258;4394
351110;201406;8857;23523;5312;17305;1610;5776;1458;4507;3068;10283
351120;201406;625;1918;534;1709;72;270;271;780;343;1050
351130;201406;911;2560;479;1643;94;386;121;382;215;768
351140;201406;2048;7123;1869;6730;709;2754;598;2104;1307;4858
351150;201406;2280;7975;1851;6804;555;2245;447;1510;1002;3755
351160;201406;1573;5568;1421;5210;483;1963;497;1748;980;3711
351170;201406;1674;5559;1353;4802;359;1388;558;1841;917;3229
351190;201406;713;2329;582;1979;150;546;126;370;276;916
351200;201406;2386;7163;2004;6391;429;1590;872;2537;1301;4127
351210;201406;1137;3578;956;3214;291;1062;330;1042;621;2104
351220;201406;3629;12364;3216;11496;854;3285;1494;5303;2348;8588
351230;201406;1972;6633;1775;6241;542;2098;883;3026;1425;5124
351240;201406;1039;3360;751;2684;210;844;175;541;385;1385
351250;201406;903;2642;675;2180;140;506;328;1011;468;1517
351260;201406;1202;3599;1083;3349;274;930;451;1333;725;2263
351270;201406;405;1458;373;1392;122;519;126;421;248;940
351280;201406;5471;16615;4028;13302;1072;3810;1285;3858;2357;7668
351290;201406;1156;3430;916;2959;300;1005;304;922;604;1927
351300;201406;10683;39190;9179;35666;2795;11716;3441;13289;6236;25005
351310;201406;3482;11000;2933;9975;726;2840;1406;4444;2132;7284
351320;201406;1030;3646;901;3339;309;1246;224;727;533;1973
351330;201406;297;861;258;792;112;346;65;201;177;547
351340;201406;6781;23788;6132;22446;1757;6785;2996;10998;4753;17783
351350;201406;8087;26718;7166;24743;2179;7920;2686;8964;4865;16884
351360;201406;4919;15162;4623;14640;1281;4401;2221;6867;3502;11268
351370;201406;2135;6936;1729;6076;547;2148;493;1594;1040;3742
351380;201406;37995;119675;35145;113939;9285;32801;17039;53085;26324;85886
351385;201406;256;812;249;801;86;281;105;333;191;614
351390;201406;1294;4371;1140;4045;416;1603;439;1470;855;3073
351400;201406;1245;4041;1177;3886;461;1623;367;1228;828;2851
351410;201406;3050;9324;2709;8723;619;2134;1444;4578;2063;6712
351420;201406;459;1366;334;1089;100;332;62;201;162;533
351430;201406;927;2963;850;2824;141;496;595;1986;736;2482
351440;201406;4806;14816;4120;13320;1555;5218;1094;3349;2649;8567
351450;201406;1847;5300;1631;5008;510;1608;818;2584;1328;4192
351460;201406;856;2711;727;2458;343;1242;216;695;559;1937
351470;201406;1123;3479;1002;3242;389;1372;311;977;700;2349
351480;201406;3031;9980;2762;9519;652;2629;1411;4736;2063;7365
351490;201406;2056;6985;1845;6523;381;1568;1007;3402;1388;4970
351492;201406;191;614;132;469;25;112;52;167;77;279
351495;201406;160;557;130;477;44;174;43;146;87;320
351500;201406;21215;68774;18807;63875;5969;22046;7696;25460;13665;47506
351510;201406;7907;25830;6801;23825;1730;6565;3477;12087;5207;18652
351512;201406;432;1303;370;1183;91;309;170;536;261;845
351515;201406;2155;7164;1688;6076;543;2118;461;1565;1004;3683
351518;201406;1710;5929;1286;5152;391;1751;293;1090;684;2841
351519;201406;855;2750;725;2447;211;819;284;876;495;1695
351520;201406;826;2311;404;1443;79;323;61;190;140;513
351530;201406;478;1526;403;1335;82;290;135;400;217;690
351535;201406;2677;7018;2173;6306;245;815;1528;4389;1773;5204
351540;201406;2215;7138;1981;6694;931;3341;419;1385;1350;4726
351550;201406;4807;14470;3566;11950;951;3601;1146;3675;2097;7276
351560;201406;442;1448;388;1322;139;519;76;249;215;768
351565;201406;245;830;228;785;74;292;93;289;167;581
351570;201406;13106;42778;11445;39397;3323;12050;5460;18684;8783;30734
351580;201406;415;1162;307;939;55;167;105;309;160;476
351590;201406;532;1471;408;1215;124;394;91;252;215;646
351600;201406;1928;5599;1724;5235;393;1367;844;2380;1237;3747
351610;201406;645;1833;537;1647;110;396;279;805;389;1201
351620;201406;17220;56726;13290;48125;3507;14104;3464;11201;6971;25305
351630;201406;15721;53331;14514;51284;3750;13843;8152;29113;11902;42956
351640;201406;8767;28345;7302;25756;1751;6747;3825;13293;5576;20040
351650;201406;411;1242;251;840;78;277;34;108;112;385
351660;201406;872;2752;675;2282;163;600;201;606;364;1206
351670;201406;4344;13773;3657;12297;764;2974;1808;5737;2572;8711
351680;201406;668;2077;421;1430;106;390;68;194;174;584
351685;201406;466;1426;380;1271;102;354;155;530;257;884
351690;201406;1378;4120;1080;3441;437;1397;300;911;737;2308
351700;201406;1537;4635;1377;4322;469;1528;498;1516;967;3044
351710;201406;813;2566;683;2269;180;627;219;672;399;1299
351720;201406;1733;5526;1297;4383;325;1193;434;1396;759;2589
351730;201406;1153;3428;975;3184;411;1471;315;967;726;2438
351740;201406;4773;13746;4016;12147;1116;3583;1328;3775;2444;7358
351750;201406;1534;5094;1330;4671;446;1745;372;1210;818;2955
351760;201406;3852;12502;3394;11483;922;3368;1463;4753;2385;8121
351770;201406;2351;7669;2058;7128;648;2358;1012;3476;1660;5834
351780;201406;1636;4686;1096;3501;314;1095;228;662;542;1757
351790;201406;1190;3551;1016;3299;375;1282;414;1320;789;2602
351800;201406;386;875;304;753;38;113;190;439;228;552
351810;201406;1229;3764;1155;3666;280;1032;737;2241;1017;3273
351820;201406;1989;6338;1633;5693;565;2093;201;677;766;2770
351830;201406;4376;14305;3784;12940;940;3533;1812;5983;2752;9516
351840;201406;9166;31945;8226;29967;2864;11040;2821;10183;5685;21223
351850;201406;1442;4760;1181;4195;353;1431;338;1039;691;2470
351860;201406;3728;12121;3392;11433;953;3552;1590;5104;2543;8656
351870;201406;35973;112140;32806;106506;7836;27153;18866;61186;26702;88339
351880;201406;103045;338770;90777;312071;29207;106342;28011;95556;57218;201898
351885;201406;670;2461;625;2357;183;756;284;1030;467;1786
351890;201406;833;2507;668;2158;202;706;175;536;377;1242
351900;201406;1441;4488;1259;4199;381;1354;490;1643;871;2997
351905;201406;444;1520;380;1402;97;428;192;646;289;1074
351907;201406;15631;49670;13657;45837;3046;11559;7142;23021;10188;34580
351910;201406;1217;3912;1125;3759;288;1101;429;1346;717;2447
351920;201406;1232;3562;1154;3438;267;887;684;2002;951;2889
351925;201406;1021;3014;942;2873;147;556;614;1742;761;2298
351930;201406;3213;11026;2985;10543;852;3488;1399;4510;2251;7998
351940;201406;1032;3202;964;3079;279;971;573;1764;852;2735
351950;201406;1440;4020;1050;3261;208;732;521;1543;729;2275
351960;201406;4302;13159;3345;11415;990;3523;1541;5348;2531;8871
351970;201406;7082;26983;6427;25548;2376;9901;2194;8762;4570;18663
351980;201406;1018;3149;845;2812;205;761;335;1012;540;1773
351990;201406;1647;4769;1326;4124;392;1389;361;980;753;2369
352000;201406;2520;8181;2297;7722;618;2244;1029;3307;1647;5551
352010;201406;2320;7957;2106;7414;761;2807;465;1630;1226;4437
352020;201406;1584;5112;1419;4781;449;1602;509;1693;958;3295
352030;201406;4704;14691;4211;14015;1015;3508;2370;8057;3385;11565
352040;201406;1953;6879;1678;6186;496;1958;412;1420;908;3378
352042;201406;2495;7078;1840;5702;442;1512;931;2813;1373;4325
352044;201406;1469;4999;1166;4203;280;1080;249;823;529;1903
352050;201406;6620;21763;4599;17089;1412;5818;915;2979;2327;8797
352060;201406;842;2528;738;2351;197;744;310;900;507;1644
352070;201406;758;2069;702;1981;276;815;257;769;533;1584
352080;201406;554;1712;469;1566;143;543;158;471;301;1014
352090;201406;1766;5764;1432;5048;373;1498;434;1378;807;2876
352100;201406;2209;7180;1757;6254;538;2160;643;2075;1181;4235
352110;201406;468;1763;419;1644;128;548;144;542;272;1090
352115;201406;393;1286;334;1159;91;357;154;499;245;856
352120;201406;931;2852;814;2672;160;579;459;1504;619;2083
352130;201406;1875;5414;1364;4440;383;1356;505;1498;888;2854
352140;201406;1583;5041;1184;4149;341;1283;494;1712;835;2995
352150;201406;676;2086;534;1794;160;530;233;776;393;1306
352160;201406;1265;3596;1162;3452;259;814;697;2093;956;2907
352170;201406;2584;7977;2342;7522;562;1999;1261;3833;1823;5832
352180;201406;3666;10611;3225;9795;864;2897;1441;4138;2305;7035
352190;201406;1153;3553;1056;3381;231;869;563;1691;794;2560
352200;201406;448;1565;377;1423;80;324;191;747;271;1071
352210;201406;15857;43143;12704;38463;2340;7446;7834;24256;10174;31702
352215;201406;583;1851;528;1777;78;308;304;1020;382;1328
352220;201406;15082;50669;13993;48408;4786;17568;5418;18703;10204;36271
352230;201406;13878;48004;12254;44878;3849;15310;4761;17212;8610;32522
352240;201406;9699;31143;8886;29686;2963;11105;3594;11354;6557;22459
352250;201406;22992;74933;20346;69499;5630;20964;8076;27235;13706;48199
352260;201406;5802;17879;4023;14095;1053;4083;1353;4392;2406;8475
352265;201406;958;3041;820;2819;127;509;492;1642;619;2151
352270;201406;2562;8794;2206;7976;874;3288;513;1794;1387;5082
352280;201406;2513;7878;2122;7198;599;2287;712;2302;1311;4589
352290;201406;1341;4365;1166;3975;306;1190;356;1086;662;2276
352300;201406;1022;3089;847;2772;247;881;374;1183;621;2064
352310;201406;34303;114566;30794;108440;7904;30143;18203;63265;26107;93408
352320;201406;5760;17968;5004;16514;1551;5595;1746;5227;3297;10822
352330;201406;2244;7356;1954;6986;682;2572;690;2525;1372;5097
352340;201406;5970;20558;4908;17976;1674;6653;988;3315;2662;9968
352350;201406;1816;6723;1652;6349;480;1986;598;2219;1078;4205
352360;201406;1215;4029;1085;3767;288;1212;610;1957;898;3169
352370;201406;925;3170;843;2988;206;827;389;1331;595;2158
352380;201406;1044;3335;922;3125;333;1250;290;959;623;2209
352390;201406;13651;40244;10103;33277;2170;8279;4903;15136;7073;23415
352400;201406;3502;10597;2382;8337;664;2561;881;2910;1545;5471
352410;201406;3834;11342;2961;9829;955;3415;951;3028;1906;6443
352420;201406;1300;3756;1217;3609;442;1449;497;1457;939;2906
352430;201406;6455;20475;5711;19245;2220;8092;1999;6603;4219;14695
352440;201406;16401;52048;13545;46345;3766;13964;5305;17674;9071;31638
352450;201406;676;2002;462;1587;128;491;106;324;234;815
352460;201406;2213;7442;1926;6904;673;2688;608;1994;1281;4682
352470;201406;4947;14113;3017;10026;622;2265;1195;3873;1817;6138
352480;201406;5552;15774;4531;13889;1151;4065;1931;5479;3082;9544
352490;201406;761;2737;647;2470;169;713;140;518;309;1231
352500;201406;9042;29335;8510;28428;4010;14475;2708;8335;6718;22810
352510;201406;3515;12205;2917;10913;1085;4361;750;2759;1835;7120
352520;201406;2478;8826;2220;8219;579;2326;1179;4277;1758;6603
352530;201406;6683;21722;5016;18057;1544;6013;830;2745;2374;8758
352540;201406;484;1617;386;1395;85;339;119;434;204;773
352550;201406;996;3341;734;2704;225;923;155;518;380;1441
352560;201406;646;1946;494;1600;99;372;203;594;302;966
352570;201406;1594;5189;1157;4148;274;1136;293;935;567;2071
352580;201406;951;2882;819;2651;290;1051;342;1028;632;2079
352585;201406;251;837;199;722;64;254;46;153;110;407
352590;201406;13049;42532;11643;39774;2653;10111;6519;21553;9172;31664
352600;201406;1979;6432;1832;6110;629;2215;709;2303;1338;4518
352610;201406;3694;11834;3279;11145;1243;4603;1094;3538;2337;8141
352620;201406;5601;17994;5312;17600;1124;3954;3505;11639;4629;15593
352630;201406;876;2916;829;2800;263;952;383;1276;646;2228
352640;201406;3183;10234;2626;8995;575;2179;1187;3960;1762;6139
352650;201406;863;2583;644;2126;140;512;223;686;363;1198
352660;201406;1107;3883;897;3372;279;1144;253;936;532;2080
352670;201406;9272;30050;6875;24733;2447;9250;1555;5560;4002;14810
352680;201406;3461;12175;2697;10272;655;2757;697;2378;1352;5135
352690;201406;26658;79284;20360;66499;5169;18555;8725;27498;13894;46053
352700;201406;791;2353;634;2111;189;720;289;914;478;1634
352710;201406;5437;16255;4025;13363;1076;3939;1517;4813;2593;8752
352720;201406;9094;30740;8481;29437;2801;10192;3439;11885;6240;22077
352725;201406;421;1255;280;934;58;235;84;251;142;486
352730;201406;2711;9468;2385;8579;677;2685;751;2435;1428;5120
352740;201406;2317;6960;1971;6349;524;1976;939;2770;1463;4746
352750;201406;420;1292;311;1042;102;378;71;204;173;582
352760;201406;1002;3511;920;3367;303;1199;459;1624;762;2823
352770;201406;955;2976;895;2866;281;960;330;1047;611;2007
352780;201406;639;2178;556;1984;149;601;175;559;324;1160
352790;201406;665;1939;514;1669;145;520;112;348;257;868
352800;201406;1181;4450;953;3805;318;1299;184;649;502;1948
352810;201406;1076;2860;768;2283;151;530;277;775;428;1305
352820;201406;607;1829;498;1650;211;729;102;343;313;1072
352830;201406;466;1349;343;1093;87;296;67;184;154;480
352840;201406;3750;13151;3295;12138;1020;4018;1084;3959;2104;7977
352850;201406;10172;33185;8918;30938;2722;9937;3404;11957;6126;21894
352860;201406;1062;3546;989;3386;405;1449;283;909;688;2358
352870;201406;1134;2884;880;2419;145;497;473;1190;618;1687
352880;201406;2425;7269;1888;6077;474;1639;501;1467;975;3106
352885;201406;318;1092;303;1059;94;356;128;423;222;779
352890;201406;826;2301;674;1999;158;521;275;740;433;1261
352900;201406;19794;60641;15196;50969;4050;14767;6160;19837;10210;34604
352910;201406;287;926;252;846;89;299;31;88;120;387
352920;201406;3424;10593;2925;9607;1021;3648;1042;3194;2063;6842
352930;201406;7243;23201;5796;19912;1776;6607;1108;3623;2884;10230
352940;201406;27290;92532;23540;83463;8625;32119;4563;15583;13188;47702
352950;201406;318;1004;229;809;61;261;67;200;128;461
352960;201406;609;1933;415;1462;85;335;73;237;158;572
352965;201406;376;1078;305;942;82;275;54;153;136;428
352970;201406;3417;9010;3029;8487;438;1303;2162;6134;2600;7437
352980;201406;1526;4588;1299;4227;400;1321;593;2037;993;3358
352990;201406;3553;11868;3279;11387;1066;4105;1206;3987;2272;8092
353000;201406;551;1559;403;1247;96;326;104;287;200;613
353010;201406;2916;8315;2186;6816;589;2057;777;2236;1366;4293
353020;201406;4509;12592;3183;9728;548;1879;1340;3766;1888;5645
353030;201406;3963;11738;3277;10404;1024;3546;875;2603;1899;6149
353040;201406;720;2075;624;1926;203;682;244;735;447;1417
353050;201406;5692;19832;4864;18074;1770;7056;1549;5525;3319;12581
353060;201406;34596;112365;32323;108752;5483;21728;22126;71554;27609;93282
353070;201406;9023;31013;7187;26730;2465;9706;1927;7166;4392;16872
353080;201406;5249;17763;4132;15214;1344;5362;1164;3998;2508;9360
353090;201406;609;2057;541;1913;99;419;265;857;364;1276
353100;201406;286;858;224;712;103;336;52;161;155;497
353110;201406;8021;25285;7216;23800;1779;6227;3999;13347;5778;19574
353120;201406;478;1620;405;1458;139;561;98;311;237;872
353130;201406;3068;9611;2690;8958;1030;3760;995;3140;2025;6900
353140;201406;2699;7650;2175;6591;686;2289;721;1966;1407;4255
353150;201406;2010;6384;1668;5736;604;2195;442;1545;1046;3740
353160;201406;681;2017;536;1714;168;551;102;301;270;852
353170;201406;523;1860;472;1760;179;750;186;662;365;1412
353180;201406;5396;16989;4716;15706;655;2526;3054;9940;3709;12466
353190;201406;3704;11913;3223;10806;779;2926;1518;4710;2297;7636
353200;201406;833;2871;726;2624;219;894;287;981;506;1875
353205;201406;549;1784;456;1573;103;362;164;567;267;929
353210;201406;1080;2898;877;2533;117;401;574;1614;691;2015
353215;201406;579;1826;500;1650;114;421;166;529;280;950
353220;201406;941;2899;833;2664;233;784;267;833;500;1617
353230;201406;969;3109;892;2978;244;905;290;893;534;1798
353240;201406;2264;7569;2058;7138;642;2472;888;2878;1530;5350
353250;201406;1290;3663;1069;3272;301;981;404;1186;705;2167
353260;201406;1175;3459;1038;3238;333;1121;424;1255;757;2376
353270;201406;681;2069;589;1887;180;629;176;515;356;1144
353280;201406;605;2005;531;1872;183;708;154;513;337;1221
353282;201406;1752;5870;1701;5790;310;1177;1145;3801;1455;4978
353284;201406;346;946;257;779;64;189;81;245;145;434
353286;201406;152;465;103;347;32;108;12;45;44;153
353290;201406;464;1640;411;1541;176;706;153;547;329;1253
353300;201406;1840;5880;1587;5313;531;1936;539;1618;1070;3554
353310;201406;352;1119;333;1070;154;518;95;284;249;802
353320;201406;573;1633;492;1501;114;394;247;718;361;1112
353325;201406;564;1964;472;1760;136;554;74;253;210;807
353330;201406;587;1742;423;1373;99;373;192;562;291;935
353340;201406;3260;10549;2795;9626;958;3521;1054;3566;2012;7087
353350;201406;3584;10939;3144;10145;1104;3824;1374;4292;2478;8116
353360;201406;464;1624;411;1493;114;480;222;758;336;1238
353370;201406;722;2368;657;2204;164;575;334;1112;498;1687
353380;201406;410;1358;364;1272;101;403;158;527;259;930
353390;201406;5637;15202;3985;12195;905;3111;1485;4112;2390;7223
353400;201406;643;2011;539;1793;138;488;154;447;292;935
353410;201406;690;2129;586;1964;178;667;297;968;475;1635
353420;201406;704;2110;540;1706;179;596;174;508;353;1104
353430;201406;2538;8882;1833;6827;518;2018;155;496;673;2514
353440;201406;61563;203731;54653;187050;17187;61839;18255;60955;35442;122794
353450;201406;468;1443;417;1353;126;456;157;493;283;949
353460;201406;3637;10264;3070;9266;551;1820;1663;5008;2214;6828
353470;201406;11589;36891;9145;31754;3001;11264;2276;7676;5277;18940
353475;201406;1771;5164;1302;4110;325;1120;383;1085;708;2205
353480;201406;1581;4746;1414;4437;319;1115;787;2380;1106;3495
353490;201406;1671;4802;1392;4237;406;1383;408;1108;814;2491
353500;201406;1250;3619;1141;3437;497;1593;403;1139;900;2732
353510;201406;1408;4572;1172;3954;348;1297;347;1009;695;2306
353520;201406;1272;3806;1032;3374;359;1262;329;1076;688;2338
353530;201406;2819;8510;2535;7991;647;2254;1169;3552;1816;5806
353540;201406;2101;6471;1906;6125;628;2116;800;2578;1428;4694
353550;201406;6903;19965;6102;18658;1122;4039;3506;10066;4628;14105
353560;201406;2209;7365;1845;6689;475;1922;694;2452;1169;4374
353570;201406;539;1718;438;1506;102;388;232;731;334;1119
353580;201406;2527;8284;2366;7997;705;2663;1307;4262;2012;6925
353590;201406;842;2427;690;2148;258;867;172;547;430;1414
353600;201406;1950;5625;1764;5289;412;1355;908;2699;1320;4054
353610;201406;605;2156;534;2009;150;656;169;594;319;1250
353620;201406;2390;8305;2141;7822;707;2778;735;2566;1442;5344
353625;201406;382;1065;274;874;108;385;74;212;182;597
353630;201406;1739;6021;1368;5067;357;1429;261;866;618;2295
353640;201406;1663;4844;1462;4418;374;1173;650;1984;1024;3157
353650;201406;6885;21122;4970;16817;1110;4087;1844;5876;2954;9963
353657;201406;343;1114;306;1033;63;249;115;368;178;617
353660;201406;1420;3677;1049;3081;445;1428;192;423;637;1851
353670;201406;4959;16476;4357;15162;1459;5571;1440;4705;2899;10276
353680;201406;686;2438;653;2380;317;1192;202;740;519;1932
353690;201406;575;1542;377;1215;102;377;136;401;238;778
353700;201406;2424;7766;2116;7103;520;1939;757;2408;1277;4347
353710;201406;3485;9442;1842;6577;556;2187;553;1963;1109;4150
353715;201406;497;1489;418;1336;93;325;183;566;276;891
353720;201406;2155;6756;1856;6306;371;1346;1062;3646;1433;4992
353730;201406;4537;14278;3654;12228;983;3557;1032;3179;2015;6736
353740;201406;2358;7243;1915;6293;676;2294;546;1729;1222;4023
353750;201406;799;2825;640;2418;184;765;180;682;364;1447
353760;201406;7984;24505;6494;21830;1721;6176;3023;10178;4744;16354
353770;201406;812;2560;539;1875;130;503;59;140;189;643
353780;201406;5995;21432;5442;20292;2508;9573;1508;5874;4016;15447
353790;201406;3162;11330;2821;10597;1047;4219;598;2354;1645;6573
353800;201406;14892;48142;11969;42410;3365;13127;4796;16437;8161;29564
353810;201406;1207;4037;1063;3699;329;1214;399;1372;728;2586
353820;201406;1265;4486;1214;4396;383;1583;536;1794;919;3377
353830;201406;807;2207;640;1900;133;430;270;789;403;1219
353850;201406;1886;6235;1768;6029;450;1674;868;2830;1318;4504
353860;201406;2516;8611;2103;7632;687;2673;638;2239;1325;4912
353870;201406;24120;75817;18317;63784;4405;17240;6158;19468;10563;36708
353880;201406;2182;7247;1991;6946;367;1491;1235;4194;1602;5685
353890;201406;2646;6897;1929;5695;477;1563;917;2584;1394;4147
353900;201406;1158;3649;864;2979;233;897;201;603;434;1500
353910;201406;2177;7715;2072;7435;678;2617;929;3327;1607;5944
353920;201406;2517;7538;1894;6223;450;1558;352;1045;802;2603
353930;201406;4156;14700;3489;13206;1279;5125;829;3118;2108;8243
353940;201406;1542;4982;1339;4547;350;1363;550;1723;900;3086
353950;201406;3706;12095;3403;11543;579;2273;2172;7169;2751;9442
353960;201406;630;2030;506;1756;128;493;152;458;280;951
353970;201406;541;1601;470;1505;49;199;340;1056;389;1255
353980;201406;14715;43909;12367;39952;3006;10441;6470;20579;9476;31020
353990;201406;525;1653;482;1549;144;514;196;569;340;1083
354000;201406;1987;5926;1381;4716;357;1345;151;453;508;1798
354010;201406;394;1230;354;1164;143;478;130;437;273;915
354020;201406;4427;13494;3978;12549;1085;3748;1824;5369;2909;9117
354025;201406;1126;3207;889;2791;246;830;224;687;470;1517
354030;201406;664;1782;473;1494;137;483;173;502;310;985
354040;201406;802;2196;627;1866;98;346;355;977;453;1323
354050;201406;990;3349;913;3182;342;1294;269;919;611;2213
354060;201406;4810;15650;3760;13310;1033;3967;1500;5108;2533;9075
354070;201406;3716;12509;3243;11408;1143;4282;838;2923;1981;7205
354075;201406;2269;8580;2170;8401;738;3118;954;3638;1692;6756
354080;201406;1973;6099;1530;5032;449;1533;448;1343;897;2876
354085;201406;314;858;279;788;32;120;201;519;233;639
354090;201406;1222;3707;1157;3602;148;523;877;2704;1025;3227
354100;201406;17111;59100;14792;54675;4036;15844;6789;25018;10825;40862
354105;201406;928;2947;793;2685;208;820;347;1054;555;1874
354110;201406;853;2465;698;2227;207;757;229;666;436;1423
354120;201406;2332;6606;1956;5929;539;1833;737;2072;1276;3905
354130;201406;5525;16801;4699;15168;1850;6351;1285;3894;3135;10245
354140;201406;21973;57554;14149;42642;2741;9346;5785;16155;8526;25501
354150;201406;4621;12946;3627;11143;1028;3463;1585;4678;2613;8141
354160;201406;4086;13565;3598;12508;1070;4011;1509;5083;2579;9094
354165;201406;420;1562;382;1464;148;612;99;384;247;996
354170;201406;1653;5378;1349;4637;305;1179;484;1479;789;2658
354180;201406;526;1592;505;1556;76;272;327;942;403;1214
354190;201406;1671;5641;1456;5145;509;1926;482;1643;991;3569
354200;201406;1187;3486;969;3068;204;741;399;1143;603;1884
354210;201406;868;3012;776;2814;186;800;324;1080;510;1880
354220;201406;3222;10141;2894;9494;951;3386;1213;3819;2164;7205
354230;201406;808;2691;764;2613;223;798;380;1298;603;2096
354240;201406;1386;4731;1129;4147;345;1374;286;997;631;2371
354250;201406;558;1796;457;1625;209;823;130;427;339;1250
354260;201406;9149;27912;8279;26532;2621;9106;3489;11024;6110;20130
354270;201406;1177;4187;1089;3990;336;1374;436;1580;772;2954
354280;201406;851;2556;787;2443;158;568;468;1417;626;1985
354290;201406;1349;4809;1249;4587;395;1543;412;1498;807;3041
354300;201406;3285;11383;3176;11167;868;3263;1644;5714;2512;8977
354310;201406;796;2658;634;2263;185;729;192;683;377;1412
354320;201406;860;2612;737;2360;217;789;237;684;454;1473
354323;201406;381;1120;315;1010;97;339;103;296;200;635
354325;201406;1318;4521;1178;4205;300;1215;491;1629;791;2844
354330;201406;8179;25701;7315;24013;1962;6905;3754;11944;5716;18849
354340;201406;30924;101236;26360;92857;9792;36997;9506;32740;19298;69737
354350;201406;1189;3584;1118;3454;291;978;623;1854;914;2832
354360;201406;458;1504;372;1336;115;444;41;127;156;571
354370;201406;1169;3953;1023;3646;148;659;692;2369;840;3028
354380;201406;1338;4072;1124;3689;430;1553;219;641;649;2194
354390;201406;11873;38724;9005;32253;2407;9413;2492;8498;4899;17911
354400;201406;2189;7863;1915;7196;547;2194;601;2167;1148;4361
354410;201406;6568;20151;5473;18347;1287;4640;2867;9595;4154;14235
354420;201406;1699;5086;1415;4463;443;1469;504;1539;947;3008
354425;201406;3540;10275;3102;9468;1069;3448;1072;3341;2141;6789
354430;201406;1355;4492;1248;4316;344;1333;612;2019;956;3352
354440;201406;578;1730;456;1477;92;325;198;626;290;951
354450;201406;520;1518;334;1110;50;216;88;244;138;460
354460;201406;844;2527;737;2327;261;865;341;1055;602;1920
354470;201406;525;1500;407;1261;73;294;184;491;257;785
354480;201406;793;2388;703;2239;160;586;362;1057;522;1643
354490;201406;780;2673;624;2283;159;629;208;682;367;1311
354500;201406;2572;8787;2353;8385;908;3596;623;2166;1531;5762
354510;201406;745;2446;672;2294;177;653;345;1157;522;1810
354515;201406;365;1290;300;1134;72;313;97;337;169;650
354520;201406;6374;22459;4767;17953;1501;6295;1768;6365;3269;12660
354530;201406;2898;10514;2717;10157;756;3083;1452;5358;2208;8441
354540;201406;1411;4388;1236;4072;408;1433;506;1700;914;3133
354550;201406;593;1922;526;1771;105;364;225;718;330;1082
354560;201406;1545;4692;1181;3875;332;1126;401;1267;733;2393
354570;201406;714;2203;567;1856;187;653;125;386;312;1039
354580;201406;9459;27987;7662;24550;1659;6015;3555;10763;5214;16778
354600;201406;1747;6030;1557;5646;475;2002;683;2302;1158;4304
354610;201406;491;1389;341;1081;74;248;94;259;168;507
354620;201406;428;1486;353;1340;113;502;118;413;231;915
354625;201406;285;958;241;867;68;267;68;239;136;506
354630;201406;1952;6851;1769;6414;760;2828;548;1882;1308;4710
354640;201406;4213;14220;3598;12835;1106;4480;825;2685;1931;7165
354650;201406;1025;3154;924;2939;187;683;531;1634;718;2317
354660;201406;2092;6326;1656;5532;415;1522;766;2533;1181;4055
354670;201406;1649;5412;1327;4586;402;1512;348;1062;750;2574
354680;201406;5418;18314;4978;17366;1440;5375;1992;6732;3432;12107
354690;201406;875;2964;626;2341;132;521;184;634;316;1155
354700;201406;1221;3470;848;2679;160;612;357;963;517;1575
354710;201406;627;1862;536;1673;139;492;202;578;341;1070
354720;201406;199;581;165;512;63;191;42;132;105;323
354730;201406;6139;21529;5414;20031;1501;6072;2474;8881;3975;14953
354740;201406;265;814;197;693;54;194;45;163;99;357
354750;201406;2372;7674;2021;7170;689;2657;802;2809;1491;5466
354760;201406;2236;7510;1886;6688;638;2417;428;1433;1066;3850
354765;201406;311;831;203;636;49;182;32;94;81;276
354770;201406;2847;8429;2292;7509;1073;3777;424;1316;1497;5093
354780;201406;37687;119258;34464;111908;8434;30288;17389;53794;25823;84082
354790;201406;873;2881;768;2696;220;852;334;1083;554;1935
354800;201406;1668;4955;1492;4722;291;1047;989;3117;1280;4164
354805;201406;945;2945;726;2450;128;479;141;432;269;911
354810;201406;709;2397;521;1924;173;701;95;317;268;1018
354820;201406;1102;3919;996;3704;295;1248;276;930;571;2178
354830;201406;447;1385;395;1287;138;501;146;437;284;938
354840;201406;829;2461;749;2320;233;764;318;977;551;1741
354850;201406;15003;48604;11452;41109;3072;12182;4176;14040;7248;26222
354860;201406;1301;4301;1187;4101;308;1262;558;1806;866;3068
354870;201406;44056;142959;41082;136579;12460;44073;19770;64412;32230;108485
354880;201406;4156;13089;3004;10470;876;3327;725;2250;1601;5577
354890;201406;15560;48276;13506;44163;3906;13854;4799;15125;8705;28979
354900;201406;626;1785;506;1605;177;592;194;613;371;1205
354910;201406;6605;20439;3907;14211;935;3760;453;1556;1388;5316
354920;201406;520;1555;402;1342;119;443;109;343;228;786
354925;201406;373;1082;224;772;47;186;36;103;83;289
354930;201406;283;841;242;761;85;286;78;244;163;530
354940;201406;2293;8198;1773;6730;670;2672;272;964;942;3636
354950;201406;1511;5092;1383;4900;255;1042;856;2992;1111;4034
354960;201406;791;2536;690;2370;202;771;271;899;473;1670
354970;201406;4073;13734;3637;12841;786;3226;1970;6643;2756;9869
354980;201406;33160;83290;19015;58668;4344;15098;6513;18565;10857;33663
354990;201406;40978;134354;36304;124522;8378;31763;18988;63399;27366;95162
354995;201406;1999;6357;1879;6180;482;1674;1004;3329;1486;5003
355000;201406;1700;5742;1496;5362;532;2066;377;1311;909;3377
355010;201406;3718;11956;3162;10695;878;3280;1335;4434;2213;7714
355020;201406;3368;12069;2874;11089;1406;5710;789;3079;2195;8789
355030;201406;942188;2762238;857915;2594977;224903;735933;387666;1145779;612569;1881712
355040;201406;3011;9954;2714;9405;840;3220;1364;4549;2204;7769
355050;201406;1296;4134;1063;3650;365;1321;258;887;623;2208
355060;201406;5082;17610;4101;15373;1125;4699;1011;3515;2136;8214
355070;201406;6484;20619;5816;19477;1344;5277;3167;9981;4511;15258
355080;201406;1396;4980;1080;4167;350;1482;159;520;509;2002
355090;201406;1132;4081;962;3675;232;974;405;1488;637;2462
355100;201406;29144;94073;25684;88098;9026;32576;9611;33471;18637;66047
355110;201406;1343;4709;1227;4453;427;1670;423;1497;850;3167
355120;201406;673;2178;583;2001;172;645;253;848;425;1493
355130;201406;591;1614;363;1112;96;336;131;339;227;675
355140;201406;1046;3819;1000;3713;281;1145;483;1770;764;2915
355150;201406;3559;12049;3136;11234;1010;3799;1256;4382;2266;8181
355160;201406;1601;5502;1378;5115;576;2396;382;1274;958;3670
355170;201406;10084;29143;7235;23967;2455;8789;1952;6389;4407;15178
355180;201406;2945;9184;2532;8421;696;2662;1005;3134;1701;5796
355190;201406;1329;4707;1216;4446;518;1924;361;1293;879;3217
355200;201406;945;3497;894;3388;429;1705;226;835;655;2540
355210;201406;2889;10041;2638;9496;771;3130;1144;3828;1915;6958
355220;201406;31120;106454;28483;100968;12018;43949;8341;30456;20359;74405
355230;201406;1270;3718;774;2573;146;554;187;531;333;1085
355240;201406;22926;70997;17591;59068;4163;15585;6934;21667;11097;37252
355250;201406;25908;87748;23307;82528;7047;26507;10179;35728;17226;62235
355255;201406;913;2575;670;2074;136;453;206;608;342;1061
355260;201406;1644;4845;1481;4547;417;1450;579;1633;996;3083
355270;201406;1702;5272;1620;5141;247;960;1138;3449;1385;4409
355280;201406;24120;73549;20937;67298;5133;18641;9503;29105;14636;47746
355290;201406;883;2901;820;2784;197;731;391;1274;588;2005
355300;201406;934;3090;736;2644;189;722;215;731;404;1453
355310;201406;1092;3352;943;3091;241;813;455;1552;696;2365
355320;201406;747;2419;661;2212;198;748;235;683;433;1431
355330;201406;1737;6132;1411;5472;523;2258;429;1556;952;3814
355340;201406;3166;8673;2933;8271;714;2238;1690;4574;2404;6812
355350;201406;1433;5055;1266;4689;428;1697;384;1396;812;3093
355360;201406;1252;4386;1157;4190;243;979;783;2828;1026;3807
355365;201406;316;1008;268;910;80;305;70;227;150;532
355370;201406;7463;19517;5445;17027;1843;6294;2186;6873;4029;13167
355380;201406;3711;11391;2885;9446;836;2993;624;1751;1460;4744
355385;201406;1017;3326;959;3219;426;1538;263;822;689;2360
355390;201406;1458;4104;1261;3724;354;1144;482;1365;836;2509
355395;201406;1830;5667;1398;4660;269;1023;559;1692;828;2715
355400;201406;9385;32484;8474;30617;2984;11720;3214;11204;6198;22924
355410;201406;13874;50566;12636;47957;4881;19658;3734;14401;8615;34059
355420;201406;840;3083;791;2959;297;1167;277;1066;574;2233
355430;201406;3790;11241;3280;10343;780;2703;1632;5005;2412;7708
355440;201406;930;3117;766;2685;225;838;225;696;450;1534
355450;201406;2690;9059;2246;8056;688;2726;735;2495;1423;5221
355460;201406;592;1682;450;1419;117;453;154;411;271;864
355465;201406;454;1407;388;1278;122;427;101;333;223;760
355470;201406;981;3045;796;2718;271;1027;284;912;555;1939
355475;201406;137;528;121;479;39;156;40;169;79;325
355480;201406;3309;12189;3121;11770;982;3927;1401;5190;2383;9117
355490;201406;850;2532;674;2152;190;649;161;512;351;1161
355495;201406;751;2531;700;2432;197;763;290;980;487;1743
355500;201406;8814;26501;5996;20203;1481;5512;1321;4099;2802;9611
355510;201406;2213;6153;1482;4699;363;1318;434;1263;797;2581
355520;201406;444;1133;278;817;64;216;86;210;150;426
355530;201406;259;613;109;334;11;37;35;116;46;153
355535;201406;691;2154;561;1894;163;642;157;448;320;1090
355540;201406;10433;34036;9906;33157;2877;10329;5013;16418;7890;26747
355550;201406;763;2357;685;2227;185;657;339;1080;524;1737
355560;201406;1457;4399;1084;3610;300;1115;227;607;527;1722
355570;201406;220;717;172;605;37;130;38;117;75;247
355580;201406;1304;3971;1121;3608;392;1371;437;1375;829;2746
355590;201406;261;741;232;681;54;182;115;328;169;510
355600;201406;1097;3552;919;3139;370;1376;216;708;586;2084
355610;201406;1484;4377;1268;4032;351;1242;566;1729;917;2971
355620;201406;4098;13323;3331;11568;809;3207;1362;4308;2171;7515
355630;201406;3445;10060;2168;7308;483;1819;702;2169;1185;3988
355635;201406;1016;3388;883;3144;161;643;568;2006;729;2649
355640;201406;3848;13006;3250;11569;1169;4327;648;2276;1817;6603
355645;201406;3477;12536;3265;12150;650;2646;2008;7461;2658;10107
355650;201406;6823;21810;5980;20143;1217;4939;3503;11023;4720;15962
355660;201406;1383;4504;1158;4052;375;1478;458;1513;833;2991
355670;201406;2404;7770;1679;6055;459;1895;575;1827;1034;3722
355680;201406;1790;6173;1449;5330;552;2107;311;1099;863;3206
355690;201406;415;1350;324;1184;216;846;24;60;240;906
355695;201406;351;1079;246;813;38;125;19;46;57;171
355700;201406;6648;23782;6008;22202;1843;7399;2569;9143;4412;16542
355710;201406;13067;33651;8219;24769;2687;8590;2210;6392;4897;14982
355715;201406;263;813;177;629;43;166;39;125;82;291
355720;201406;1516;5016;1248;4429;402;1562;392;1250;794;2812
355730;201406;789;2795;714;2632;289;1116;186;684;475;1800
410010;201406;1652;5309;1504;4995;431;1542;478;1558;909;3100
410020;201406;1285;4376;1188;4176;371;1377;446;1542;817;2919
410030;201406;1109;3841;942;3432;307;1166;192;697;499;1863
410040;201406;13213;44624;12106;42326;4358;16189;3658;12744;8016;28933
410045;201406;1127;3226;823;2627;248;845;269;807;517;1652
410050;201406;2936;8477;1986;6621;643;2324;525;1661;1168;3985
410060;201406;2059;6629;1860;6236;555;2071;711;2323;1266;4394
410070;201406;2211;6336;1808;5520;705;2289;404;1118;1109;3407
410080;201406;1503;4555;1250;4078;313;1095;613;1918;926;3013
410090;201406;1155;3702;1050;3481;356;1303;371;1165;727;2468
410100;201406;2608;7862;1878;6181;560;2128;397;1171;957;3299
410105;201406;520;1655;388;1340;93;364;47;121;140;485
410110;201406;2780;8520;2386;7765;607;2222;865;2717;1472;4939
410115;201406;587;1687;502;1505;123;412;171;480;294;892
410120;201406;2942;10191;2789;9962;1047;3894;1219;4494;2266;8388
410130;201406;1423;4791;1294;4486;412;1412;572;2008;984;3420
410140;201406;16142;44920;11469;36282;3271;11461;4038;12680;7309;24141
410150;201406;18322;46398;8900;26956;1889;6375;1777;4786;3666;11161
410160;201406;3434;11021;3137;10529;1043;3810;1149;3911;2192;7721
410165;201406;689;2054;554;1754;126;431;269;808;395;1239
410170;201406;1865;5787;1585;5173;590;2084;486;1545;1076;3629
410180;201406;9068;29421;7934;26935;2010;7773;3591;11371;5601;19144
410185;201406;662;1832;601;1725;141;447;361;1039;502;1486
410190;201406;2308;6944;1991;6209;655;2205;549;1613;1204;3818
410200;201406;3864;11174;2945;9258;852;2979;492;1407;1344;4386
410210;201406;2713;8403;2158;7169;551;2051;458;1320;1009;3371
410220;201406;664;1954;502;1608;117;408;165;492;282;900
410230;201406;1893;6174;1732;5896;668;2481;649;2156;1317;4637
410240;201406;5310;16726;4882;15816;1609;5599;1803;5754;3412;11353
410250;201406;2448;6993;1675;5333;522;1844;357;1022;879;2866
410260;201406;1772;5535;1553;5132;483;1696;579;1874;1062;3570
410270;201406;566;1687;480;1512;129;452;204;629;333;1081
410275;201406;953;2875;667;2246;113;405;346;1169;459;1574
410280;201406;2930;8845;2123;7088;524;1995;406;1263;930;3258
410290;201406;3354;10468;2941;9677;773;2739;1329;4376;2102;7115
410300;201406;642;1855;570;1701;87;316;296;790;383;1106
410302;201406;601;1723;480;1520;60;209;286;911;346;1120
410304;201406;1496;4909;1372;4648;430;1492;568;2015;998;3507
410305;201406;2225;5966;1913;5508;477;1448;1150;3376;1627;4824
410310;201406;2393;8004;2187;7605;664;2492;818;2876;1482;5368
410315;201406;658;2003;505;1703;122;428;168;523;290;951
410320;201406;1251;3712;817;2771;176;691;75;208;251;899
410322;201406;616;1845;443;1454;130;429;127;406;257;835
410330;201406;1539;4358;1309;3919;403;1296;437;1284;840;2580
410335;201406;1092;3225;919;2921;234;838;365;1095;599;1933
410337;201406;844;2270;711;2042;144;489;297;785;441;1274
410340;201406;599;1808;473;1481;98;350;142;377;240;727
410345;201406;1950;5923;1583;5121;532;1871;411;1228;943;3099
410347;201406;846;2404;611;1962;182;643;179;546;361;1189
410350;201406;868;2710;584;2100;161;679;110;350;271;1029
410360;201406;3602;11068;3204;10371;1017;3531;1107;3579;2124;7110
410370;201406;13321;39699;10131;32653;2756;10064;2999;8929;5755;18993
410380;201406;1436;4623;1314;4358;335;1199;609;1950;944;3149
410390;201406;2901;8560;2361;7566;898;3074;655;1952;1553;5026
410395;201406;924;3137;829;2928;216;878;397;1378;613;2256
410400;201406;5337;17446;4730;16241;1517;5819;1550;5151;3067;10970
410405;201406;999;2950;805;2559;207;749;323;982;530;1731
410410;201406;1359;4652;1297;4550;511;1987;361;1195;872;3182
410420;201406;9698;32030;8566;29426;2995;11123;2266;7331;5261;18454
410425;201406;3263;10607;2386;8527;589;2318;352;1199;941;3517
410430;201406;16034;44797;12235;37686;3490;11782;3886;11927;7376;23709
410440;201406;3629;11572;3311;10971;855;3044;1597;5289;2452;8333
410442;201406;3023;10474;2737;9798;931;3527;877;3124;1808;6651
410445;201406;2414;8089;2081;7481;602;2346;798;2989;1400;5335
410450;201406;2650;7700;2148;6765;742;2473;446;1312;1188;3785
410460;201406;2433;7368;2038;6557;555;1920;773;2354;1328;4274
410465;201406;2060;7465;1783;6802;613;2476;629;2241;1242;4717
410470;201406;1950;6328;1702;5738;531;1914;555;1869;1086;3783
410480;201406;31073;91890;24931;79589;9029;31282;6551;20218;15580;51500
410490;201406;11702;38366;9730;34011;3069;11704;3194;10967;6263;22671
410500;201406;1581;5044;1294;4411;491;1805;365;1247;856;3052
410510;201406;2504;6752;1834;5414;448;1429;764;2063;1212;3492
410520;201406;3267;11519;3103;11164;1183;4478;1151;4136;2334;8614
410530;201406;1716;4970;1446;4429;366;1288;615;1767;981;3055
410540;201406;3907;11459;2754;9138;737;2585;946;3098;1683;5683
410550;201406;6863;21358;5339;17849;1746;6419;931;2838;2677;9257
410560;201406;1319;4262;1046;3568;278;1045;269;744;547;1789
410570;201406;2985;9852;2725;9391;806;2843;1226;4545;2032;7388
410580;201406;26217;83752;23019;77003;7953;28982;7026;22337;14979;51319
410590;201406;1297;4122;824;2771;160;584;191;553;351;1137
410600;201406;2008;6026;1704;5422;460;1540;764;2426;1224;3966
410610;201406;839;2597;717;2370;181;651;314;1002;495;1653
410620;201406;1771;6442;1571;5933;525;2081;367;1338;892;3419
410630;201406;2587;7798;2077;6693;597;2123;635;1913;1232;4036
410640;201406;5178;15236;4138;13252;1421;5150;990;3009;2411;8159
410645;201406;1298;4622;1240;4510;539;2094;398;1449;937;3543
410650;201406;2537;7829;2070;6862;738;2589;515;1639;1253;4228
410655;201406;936;2885;784;2576;225;804;254;824;479;1628
410657;201406;696;2096;552;1789;164;598;206;593;370;1191
410660;201406;3924;11527;3080;9660;1137;3754;708;2080;1845;5834
410670;201406;1004;2877;776;2431;219;746;212;628;431;1374
410680;201406;2483;8735;2090;7699;620;2295;725;2795;1345;5090
410685;201406;693;2099;631;1993;103;320;442;1410;545;1730
410690;201406;111148;325966;78080;256319;20005;72760;19749;58690;39754;131450
410700;201406;2397;7665;2240;7350;713;2543;937;2969;1650;5512
410710;201406;1117;3518;890;2978;284;1036;260;804;544;1840
410712;201406;812;2519;703;2304;302;1089;208;693;510;1782
410715;201406;1088;3455;933;3100;257;925;349;1124;606;2049
410720;201406;3212;9690;2415;7984;651;2407;743;2240;1394;4647
410725;201406;1105;3212;791;2575;181;625;187;525;368;1150
410730;201406;738;2259;673;2115;286;964;190;581;476;1545
410740;201406;988;2989;723;2436;165;646;323;1064;488;1710
410750;201406;1920;5780;1652;5219;527;1820;518;1540;1045;3360
410752;201406;265;784;213;676;54;202;92;264;146;466
410753;201406;481;1452;364;1193;78;301;145;446;223;747
410754;201406;985;3035;870;2846;92;333;602;2019;694;2352
410755;201406;788;2138;623;1861;106;373;360;1016;466;1389
410760;201406;2519;8260;2405;8039;903;3149;948;3123;1851;6272
410765;201406;16169;48979;12123;40637;3097;11597;2042;6535;5139;18132
410770;201406;939;2695;765;2358;254;856;227;661;481;1517
410773;201406;1263;3883;1127;3648;286;1062;571;1733;857;2795
410775;201406;1851;5476;1760;5330;473;1392;1056;3335;1529;4727
410780;201406;511;1489;388;1266;116;386;157;567;273;953
410785;201406;931;3032;750;2502;270;933;255;851;525;1784
410790;201406;612;1913;512;1677;142;518;115;316;257;834
410800;201406;2609;7152;2140;6354;800;2628;740;2048;1540;4676
410810;201406;309;967;253;840;34;130;114;374;148;504
410820;201406;1088;3329;906;2888;276;927;222;694;498;1621
410830;201406;32158;96900;26647;86940;8313;29643;9438;30435;17751;60078
410832;201406;1200;3635;1086;3429;252;928;540;1582;792;2510
410840;201406;7675;23575;5785;19442;1888;6959;1090;3311;2978;10270
410845;201406;1579;4746;1363;4285;309;1080;669;2050;978;3130
410850;201406;2849;8472;2551;8023;599;2165;1381;4322;1980;6487
410855;201406;736;2085;613;1828;180;576;228;669;408;1245
410860;201406;3935;11419;3368;10373;781;2526;1661;5238;2442;7764
410865;201406;1713;5947;1550;5628;393;1513;820;3072;1213;4585
410870;201406;1369;4265;1286;4128;659;2260;369;1140;1028;3400
410880;201406;4540;13660;3692;12057;981;3677;914;2627;1895;6304
410890;201406;1096;3426;826;2908;263;986;84;262;347;1248
410895;201406;1067;3765;960;3522;358;1397;316;1116;674;2513
410900;201406;930;2637;704;2257;155;574;228;688;383;1262
410910;201406;350;1064;310;994;65;225;162;501;227;726
410920;201406;865;2655;713;2382;211;783;237;741;448;1524
410930;201406;2118;6623;1842;6118;528;2065;726;2333;1254;4398
410940;201406;21483;72795;19159;68379;6124;23769;7815;28115;13939;51884
410950;201406;1908;6381;1739;6064;365;1327;1066;3778;1431;5105
410960;201406;6994;19772;4782;15612;1564;5563;1462;4711;3026;10274
410965;201406;1096;3460;974;3198;327;1126;385;1259;712;2385
410970;201406;5334;16236;4378;14283;1517;5522;998;3245;2515;8767
410975;201406;1504;4437;1253;4008;232;875;623;1994;855;2869
410980;201406;5374;15717;3448;11656;821;3080;756;2435;1577;5515
410990;201406;1115;3397;815;2754;265;997;212;624;477;1621
411000;201406;436;1351;296;1015;65;259;43;118;108;377
411005;201406;522;1560;364;1151;108;350;65;180;173;530
411007;201406;2067;6736;1871;6307;545;1952;808;2757;1353;4709
411010;201406;4045;14048;3744;13360;1407;5517;962;3194;2369;8711
411020;201406;2544;8189;2304;7763;783;2932;821;2776;1604;5708
411030;201406;881;2401;736;2127;238;751;220;598;458;1349
411040;201406;466;1472;350;1182;112;407;93;299;205;706
411050;201406;2165;7753;1927;7221;666;2717;341;1180;1007;3897
411060;201406;2123;6797;1852;6201;589;2117;326;1002;915;3119
411065;201406;401;1236;326;1084;71;245;121;381;192;626
411070;201406;4912;15728;3629;12816;1112;4338;544;1747;1656;6085
411080;201406;2060;6421;1859;5984;540;1935;599;1836;1139;3771
411090;201406;651;1656;509;1455;111;379;137;359;248;738
411095;201406;1645;4796;1287;4091;315;1122;357;1071;672;2193
411100;201406;1522;4431;1148;3700;276;1006;262;785;538;1791
411110;201406;953;2907;717;2363;223;772;130;376;353;1148
411120;201406;1798;5665;1560;5152;490;1741;507;1643;997;3384
411125;201406;4778;15740;4640;15462;1556;5469;2174;7120;3730;12589
411130;201406;798;2437;657;2139;196;647;222;753;418;1400
411140;201406;2126;7681;1832;6937;672;2654;473;1870;1145;4524
411150;201406;6074;17285;4951;15041;1515;4984;1342;3760;2857;8744
411155;201406;1263;3712;1083;3357;361;1230;423;1227;784;2457
411160;201406;317;967;287;910;111;359;98;307;209;666
411170;201406;849;2874;745;2629;231;859;239;841;470;1700
411180;201406;6370;19624;5597;18159;1727;6109;1837;5930;3564;12039
411190;201406;1866;5535;1602;5049;480;1678;505;1522;985;3200
411200;201406;4463;13666;3726;12433;1204;4431;1475;4768;2679;9199
411210;201406;2592;7632;2104;6711;846;2880;392;1223;1238;4103
411220;201406;1205;3515;983;3098;245;904;426;1216;671;2120
411230;201406;1292;3719;837;2747;269;975;198;590;467;1565
411240;201406;1438;3622;860;2674;261;861;236;674;497;1535
411250;201406;2563;7634;2147;6813;618;2099;693;2177;1311;4276
411260;201406;298;839;212;695;60;229;87;266;147;495
411270;201406;2096;6721;1927;6395;596;2199;856;2772;1452;4971
411275;201406;1577;4775;1374;4307;411;1341;403;1208;814;2549
411280;201406;1766;5527;1421;4771;452;1692;234;702;686;2394
411290;201406;1038;2915;874;2591;250;761;318;991;568;1752
411295;201406;1105;3298;1022;3151;247;822;429;1312;676;2134
411300;201406;1089;2852;789;2253;86;284;378;1013;464;1297
411310;201406;878;2521;672;2159;132;490;284;887;416;1377
411320;201406;5838;17864;4663;15531;1387;4886;1219;3924;2606;8810
411325;201406;1579;5089;1420;4789;238;889;899;3034;1137;3923
411330;201406;3657;11998;3283;11295;1266;4725;1018;3441;2284;8166
411340;201406;1007;2973;668;2170;159;577;259;830;418;1407
411342;201406;902;2612;742;2261;219;743;212;569;431;1312
411345;201406;1076;3458;996;3302;301;1079;485;1605;786;2684
411350;201406;2933;9000;2081;7206;655;2502;282;875;937;3377
411360;201406;573;1413;337;973;47;183;151;357;198;540
411370;201406;45532;133608;35057;113407;7839;29719;12622;37508;20461;67227
411373;201406;1483;4712;1247;4237;358;1378;352;1150;710;2528
411375;201406;1138;3232;903;2762;241;784;322;921;563;1705
411380;201406;1297;3522;815;2501;157;515;248;743;405;1258
411390;201406;1844;5717;1634;5376;416;1522;844;2672;1260;4194
411400;201406;1799;5479;1417;4590;333;1233;433;1302;766;2535
411410;201406;2566;8044;2174;7120;711;2638;568;1590;1279;4228
411420;201406;4638;13656;3589;11300;996;3496;751;2059;1747;5555
411430;201406;2954;9622;2545;8859;779;2937;1099;3753;1878;6690
411435;201406;589;1895;501;1675;132;485;193;620;325;1105
411440;201406;2587;8494;2351;8017;863;3087;741;2637;1604;5724
411450;201406;2140;6595;1963;6298;441;1475;1172;3792;1613;5267
411460;201406;4742;14946;3479;11847;1290;4652;740;2410;2030;7062
411470;201406;934;2895;665;2227;169;623;127;367;296;990
411480;201406;4983;15364;3945;13288;1619;5900;867;2817;2486;8717
411490;201406;1692;5365;1532;5073;616;2309;416;1244;1032;3553
411500;201406;1682;4838;1204;3908;353;1261;299;948;652;2209
411510;201406;2488;7366;1985;6358;666;2355;457;1313;1123;3668
411520;201406;29488;84665;19898;64388;6445;22868;4359;13420;10804;36288
411530;201406;934;2726;642;2174;250;941;105;297;355;1238
411535;201406;464;1402;231;825;40;169;26;69;66;238
411540;201406;3156;8625;2521;7474;457;1408;1402;4231;1859;5639
411545;201406;1049;3684;967;3525;198;770;631;2329;829;3099
411550;201406;752;2118;610;1877;259;867;140;407;399;1274
411560;201406;2673;8190;2163;6957;638;2224;505;1489;1143;3713
411570;201406;6238;17453;4718;14850;1419;4966;1195;3883;2614;8849
411573;201406;1004;3071;947;2972;207;696;541;1731;748;2427
411575;201406;1498;4885;1299;4438;340;1245;504;1710;844;2955
411580;201406;3760;11280;2783;9251;749;2871;477;1316;1226;4187
411585;201406;497;1730;385;1409;108;421;73;243;181;664
411590;201406;597;1791;534;1663;149;516;183;548;332;1064
411600;201406;373;1148;310;1021;88;344;84;280;172;624
411605;201406;2367;6670;1766;5520;463;1583;718;2185;1181;3768
411610;201406;2380;6864;2149;6511;470;1536;1403;4202;1873;5738
411620;201406;2839;9342;2672;9054;853;3098;1185;4100;2038;7198
411630;201406;722;1922;433;1456;135;526;88;260;223;786
411640;201406;602;1890;503;1677;150;539;191;606;341;1145
411650;201406;188;629;165;583;44;176;57;184;101;360
411660;201406;853;2469;708;2187;189;620;307;952;496;1572
411670;201406;1717;5053;1523;4671;492;1681;561;1619;1053;3300
411680;201406;1752;5391;1528;5008;378;1199;902;3118;1280;4317
411690;201406;3719;11315;3138;10224;1034;3527;913;3049;1947;6576
411695;201406;841;2731;710;2455;155;563;342;1206;497;1769
411700;201406;1876;5517;1429;4682;369;1346;401;1226;770;2572
411705;201406;2314;7934;2026;7369;474;1746;1163;4351;1637;6097
411710;201406;2201;6798;1784;5878;539;1907;454;1365;993;3272
411720;201406;705;2143;549;1764;115;408;146;437;261;845
411721;201406;729;2220;617;1985;194;695;155;443;349;1138
411722;201406;708;2171;566;1867;141;527;163;489;304;1016
411725;201406;1378;4474;925;3340;237;933;208;754;445;1687
411727;201406;2313;6701;1880;5779;471;1565;816;2373;1287;3938
411729;201406;561;1555;435;1345;117;408;143;384;260;792
411730;201406;5737;17044;4909;15467;1892;6240;1615;5132;3507;11372
411740;201406;571;1672;438;1386;107;382;173;517;280;899
411745;201406;908;2870;762;2523;211;730;203;647;414;1377
411750;201406;4709;14772;3621;12065;1107;4065;709;2185;1816;6250
411760;201406;8931;26827;8007;25237;2936;9816;2633;8508;5569;18324
411770;201406;3958;13961;3486;12819;1388;5349;831;3092;2219;8441
411780;201406;3074;10086;2951;9942;410;1255;2196;7868;2606;9123
411790;201406;2611;7600;1931;6235;577;2155;632;1962;1209;4117
411800;201406;1280;3891;853;2865;173;653;156;424;329;1077
411810;201406;1595;4997;1406;4578;408;1520;431;1225;839;2745
411820;201406;16774;53216;14108;48210;5023;17568;4527;16270;9550;33838
411830;201406;427;1170;347;1052;103;301;145;474;248;775
411840;201406;9130;27595;7339;24072;2221;7954;2065;6530;4286;14484
411845;201406;551;1785;419;1464;110;411;87;301;197;712
411850;201406;5957;18350;4975;16311;1320;4652;1470;4774;2790;9426
411860;201406;903;2904;760;2597;219;803;223;718;442;1521
411870;201406;1063;3751;830;3108;151;592;222;809;373;1401
411880;201406;2511;7275;2135;6609;580;2013;860;2619;1440;4632
411885;201406;1482;4145;1203;3678;372;1270;416;1166;788;2436
411890;201406;1359;4211;978;3312;287;1046;197;592;484;1638
411900;201406;962;3117;716;2491;218;774;126;428;344;1202
411910;201406;1231;4254;1064;3863;341;1370;339;1153;680;2523
411915;201406;12305;35266;8170;26580;1976;7135;2008;5948;3984;13083
411920;201406;1064;3752;944;3439;277;1115;220;757;497;1872
411925;201406;650;1872;480;1558;138;470;152;481;290;951
411930;201406;6292;20969;5577;19495;1874;6996;1925;6732;3799;13728
411940;201406;3641;12377;3269;11570;1101;4088;932;3252;2033;7340
411950;201406;10199;33287;8819;30553;2533;9607;4092;13952;6625;23559
411960;201406;5277;16136;4910;15436;1285;4506;2361;7229;3646;11735
411965;201406;581;1752;447;1529;105;403;160;557;265;960
411970;201406;764;2209;615;1965;212;742;179;542;391;1284
411980;201406;2124;5953;1512;4945;280;972;676;2191;956;3163
411990;201406;30036;103722;26267;95547;9508;36910;7602;27885;17110;64795
411995;201406;3130;9977;2829;9352;1171;4158;773;2516;1944;6674
412000;201406;2087;5817;1682;5114;380;1329;743;2045;1123;3374
412010;201406;748;2527;633;2256;174;645;165;565;339;1210
412015;201406;671;2083;543;1800;105;376;286;942;391;1318
412020;201406;439;1304;333;1090;120;420;129;399;249;819
412030;201406;624;1989;418;1476;96;400;117;373;213;773
412033;201406;768;2384;573;1921;147;530;121;365;268;895
412035;201406;1019;2928;786;2494;204;714;322;964;526;1678
412040;201406;761;2529;692;2348;256;894;225;752;481;1646
412050;201406;1618;4930;1255;4124;333;1220;269;844;602;2064
412060;201406;6869;24321;6284;23010;1959;7641;2513;9199;4472;16840
412065;201406;1000;3097;841;2757;257;954;248;758;505;1712
412070;201406;1218;3419;1027;3035;216;691;411;1195;627;1886
412080;201406;1793;5643;1205;4271;319;1239;133;399;452;1638
412085;201406;338;966;175;592;45;174;47;143;92;317
412090;201406;4925;16215;4710;15814;1036;3700;2977;10115;4013;13815
412100;201406;2214;7062;1959;6608;643;2272;711;2384;1354;4656
412110;201406;1106;3244;784;2545;252;874;235;744;487;1618
412120;201406;2140;7375;1948;6915;520;2064;921;3123;1441;5187
412125;201406;974;3048;871;2874;253;889;354;1189;607;2078
412130;201406;703;2071;522;1712;121;441;131;403;252;844
412135;201406;557;1613;415;1324;104;371;163;472;267;843
412140;201406;1863;5763;1577;5167;465;1630;465;1526;930;3156
412150;201406;2946;8793;2562;8006;421;1476;1509;4599;1930;6075
412160;201406;1246;3965;941;3211;273;1043;354;1182;627;2225
412170;201406;4533;15172;3876;13844;1343;5138;1428;5033;2771;10171
412175;201406;1470;5161;1325;4834;380;1513;542;1992;922;3505
412180;201406;1779;5698;1399;5008;514;2016;404;1388;918;3404
412190;201406;3141;9432;2550;8423;889;3131;688;2335;1577;5466
412200;201406;2334;7797;1677;6003;401;1572;545;1937;946;3509
412210;201406;771;2197;462;1523;112;418;80;241;192;659
412215;201406;3333;10854;3026;10284;492;1697;1991;6987;2483;8684
412217;201406;1225;3619;1144;3475;221;776;733;2106;954;2882
412220;201406;5833;19491;5588;19002;1790;6363;2944;10055;4734;16418
412230;201406;3043;10440;2672;9661;809;3256;872;3023;1681;6279
412240;201406;9481;24992;5495;17467;1277;4560;934;2673;2211;7233
412250;201406;2212;6810;1967;6281;712;2446;537;1595;1249;4041
412260;201406;1343;4036;922;3114;202;784;297;891;499;1675
412265;201406;1226;3915;1125;3718;288;1101;547;1765;835;2866
412270;201406;812;2693;632;2248;154;607;125;422;279;1029
412280;201406;705;2174;546;1850;260;949;123;384;383;1333
412290;201406;1275;3609;1056;3173;234;788;406;1159;640;1947
412300;201406;1814;5481;1515;4890;489;1772;401;1219;890;2991
412310;201406;1217;3488;1083;3306;206;541;723;2453;929;2994
412320;201406;716;1975;522;1636;137;481;180;552;317;1033
412330;201406;2023;5593;1572;4805;369;1214;745;2265;1114;3479
412340;201406;784;2497;540;1861;107;395;106;342;213;737
412350;201406;2600;8325;2146;7312;717;2601;444;1410;1161;4011
412360;201406;356;1134;284;946;54;202;90;251;144;453
412370;201406;1131;3587;897;3119;323;1189;272;932;595;2121
412380;201406;2052;6285;1768;5649;540;1811;523;1645;1063;3456
412382;201406;726;2100;536;1697;135;468;153;445;288;913
412385;201406;2535;8099;2329;7636;747;2601;823;2676;1570;5277
412390;201406;2453;7397;2249;7046;782;2634;886;2771;1668;5405
412395;201406;978;2757;791;2464;121;386;494;1559;615;1945
412400;201406;1193;3724;1060;3471;340;1150;420;1439;760;2589
412402;201406;2106;6554;1765;5806;576;2064;509;1512;1085;3576
412405;201406;4198;12304;2773;9213;779;2911;363;1121;1142;4032
412410;201406;6404;20924;5793;19680;2493;9245;1292;4308;3785;13553
412420;201406;548;1633;439;1407;142;500;137;363;279;863
412430;201406;481;1438;394;1260;107;373;164;479;271;852
412440;201406;4071;12299;3533;11360;741;2609;1460;4900;2201;7509
412450;201406;374;1198;286;967;51;188;49;128;100;316
412460;201406;1002;2871;717;2329;183;699;172;524;355;1223
412470;201406;1866;6430;1661;5917;559;2085;607;2201;1166;4286
412480;201406;1314;3918;938;3071;234;835;160;426;394;1261
412490;201406;1298;3852;1140;3479;321;1037;335;991;656;2028
412500;201406;2074;6222;1773;5619;509;1827;482;1349;991;3176
412510;201406;2781;9485;2460;8633;757;2866;931;3231;1688;6097
412520;201406;1875;5313;1421;4527;437;1495;489;1516;926;3011
412530;201406;802;2417;677;2134;211;682;199;618;410;1300
412535;201406;481;1481;324;1057;84;304;93;260;177;564
412540;201406;1235;3635;956;3035;187;684;356;1114;543;1798
412545;201406;939;2713;781;2378;155;542;297;804;452;1346
412550;201406;25307;77287;17631;60008;4954;18264;3683;11805;8637;30069
412555;201406;328;1024;238;795;59;214;43;117;102;331
412560;201406;4700;15436;3819;13605;1143;4572;925;2990;2068;7562
412570;201406;4486;13781;3442;11345;1007;3664;769;2431;1776;6095
412575;201406;1063;3358;875;2919;231;863;269;829;500;1692
412580;201406;1489;4150;1090;3435;280;929;345;1033;625;1962
412590;201406;510;1557;404;1354;140;504;118;409;258;913
412600;201406;1533;4890;1326;4467;435;1626;426;1345;861;2971
412610;201406;815;2632;654;2241;238;926;177;520;415;1446
412620;201406;1298;4319;1100;3892;383;1463;259;883;642;2346
412625;201406;14059;40413;11810;36160;4387;14337;2821;8554;7208;22891
412627;201406;1032;3231;731;2567;260;973;84;286;344;1259
412630;201406;3565;11477;3141;10545;889;3183;1029;3333;1918;6516
412635;201406;552;1689;399;1341;104;365;61;186;165;551
412640;201406;854;2592;591;1969;143;506;101;302;244;808
412650;201406;2329;6736;1929;5979;528;1828;681;1918;1209;3746
412660;201406;3101;9452;2581;8360;707;2564;645;1961;1352;4525
412665;201406;738;1996;466;1506;149;528;139;425;288;953
412667;201406;1501;4536;1209;3949;340;1262;333;1006;673;2268
412670;201406;679;2144;480;1669;113;447;77;203;190;650
412680;201406;1544;5076;1270;4418;361;1351;349;1088;710;2439
412690;201406;724;2325;592;2028;228;839;116;385;344;1224
412700;201406;1877;6178;1648;5791;627;2434;599;2059;1226;4493
412710;201406;8872;28097;7505;25257;2223;8194;2013;6494;4236;14688
412720;201406;1696;5417;1200;4106;303;1116;154;430;457;1546
412730;201406;2870;8755;2005;6864;656;2407;279;842;935;3249
412740;201406;2183;7199;1923;6596;807;2899;319;1117;1126;4016
412750;201406;3456;11433;3160;10926;588;2364;2106;7087;2694;9451
412760;201406;2364;7943;2257;7755;696;2673;990;3260;1686;5933
412770;201406;12361;36432;8207;27227;1959;7254;1840;5607;3799;12861
412780;201406;1507;5001;1338;4607;416;1534;438;1445;854;2979
412785;201406;2559;7567;1890;6137;508;1811;860;2712;1368;4523
412788;201406;1378;4571;1278;4374;350;1383;495;1533;845;2916
412790;201406;1206;3788;1004;3349;259;930;317;980;576;1910
412795;201406;1046;3124;906;2867;305;1026;306;931;611;1957
412796;201406;2653;8524;2456;8111;684;2515;1045;3268;1729;5783
412800;201406;3633;10906;2910;9448;837;2971;911;2811;1748;5782
412810;201406;10677;30333;6557;21111;1731;6067;1536;4512;3267;10579
412820;201406;6587;20269;4974;17036;1484;5567;1113;3857;2597;9424
412830;201406;408;1323;348;1196;99;398;95;273;194;671
412840;201406;2229;6444;1847;5679;526;1753;501;1524;1027;3277
412850;201406;2640;8048;2272;7499;427;1654;1174;3706;1601;5360
412853;201406;1643;4838;1463;4517;203;831;865;2455;1068;3286
412855;201406;1680;4904;1362;4250;431;1530;378;1037;809;2567
412860;201406;1328;4034;1131;3660;297;1087;499;1549;796;2636
412862;201406;873;2389;660;1968;180;593;251;700;431;1293
412863;201406;1228;4217;1181;4134;178;670;824;2866;1002;3536
412865;201406;679;2153;503;1714;109;399;195;679;304;1078
412870;201406;1037;3018;880;2766;301;1003;317;1007;618;2010
412880;201406;1594;4418;1360;4041;417;1347;355;1020;772;2367
420005;201406;523;1595;351;1194;75;279;143;458;218;737
420010;201406;3319;10359;2825;9545;437;1593;1970;6724;2407;8317
420020;201406;792;2624;472;1756;85;369;64;199;149;568
420030;201406;564;1624;321;1140;97;389;58;197;155;586
420040;201406;1003;3151;680;2501;223;904;150;485;373;1389
420050;201406;837;2661;675;2279;196;696;281;914;477;1610
420055;201406;319;1031;223;799;59;226;47;154;106;380
420060;201406;383;1366;294;1125;91;386;40;136;131;522
420070;201406;2072;6589;1728;5742;368;1334;707;2454;1075;3788
420075;201406;201;599;115;390;30;120;35;102;65;222
420080;201406;619;2057;528;1861;190;738;126;427;316;1165
420090;201406;690;2466;540;2110;157;630;104;405;261;1035
420100;201406;1509;4914;1392;4750;359;1251;837;2913;1196;4164
420110;201406;457;1583;416;1491;125;458;195;713;320;1171
420120;201406;338;1197;284;1080;107;450;63;224;170;674
420125;201406;370;1533;350;1487;151;687;108;421;259;1108
420127;201406;609;1904;279;1052;98;391;41;151;139;542
420130;201406;2738;9485;2417;8816;738;2936;900;3071;1638;6007
420140;201406;5282;15614;3692;12535;1057;4033;752;2384;1809;6417
420150;201406;805;2429;553;1841;166;602;166;500;332;1102
420160;201406;308;920;199;670;49;193;43;124;92;317
420165;201406;224;727;152;539;34;138;38;132;72;270
420170;201406;243;805;171;654;69;303;20;56;89;359
420180;201406;477;1529;299;1089;82;314;73;253;155;567
420190;201406;589;1879;372;1374;123;495;65;222;188;717
420195;201406;1440;4193;1154;3795;278;985;582;1977;860;2962
420200;201406;2979;9831;1955;7443;657;2752;352;1217;1009;3969
420205;201406;1102;3709;990;3504;291;1089;448;1594;739;2683
420207;201406;1407;4227;1012;3386;322;1223;301;913;623;2136
420208;201406;513;1535;351;1221;134;512;104;346;238;858
420209;201406;372;1199;232;843;47;178;67;238;114;416
420210;201406;1832;6023;1277;4901;396;1753;189;654;585;2407
420213;201406;910;3364;864;3259;184;721;567;2156;751;2877
420215;201406;525;1733;387;1365;116;431;80;269;196;700
420220;201406;431;1690;403;1625;172;739;104;380;276;1119
420230;201406;4653;14485;3626;12576;924;3599;1809;6142;2733;9741
420240;201406;13585;40689;8930;31562;2095;8824;3552;11424;5647;20248
420243;201406;591;1849;479;1608;117;450;167;544;284;994
420245;201406;1218;3854;861;3104;249;1031;196;625;445;1656
420250;201406;845;2726;790;2636;273;992;345;1164;618;2156
420253;201406;668;1805;552;1640;131;386;270;891;401;1277
420257;201406;440;1369;334;1160;92;331;157;540;249;871
420260;201406;1413;4690;1242;4383;346;1327;584;2073;930;3400
420270;201406;592;1927;257;955;51;188;35;114;86;302
420280;201406;2474;6990;1608;5416;427;1705;568;1694;995;3399
420285;201406;165;488;62;232;10;44;3;10;13;54
420287;201406;658;2042;573;1881;154;537;221;724;375;1261
420290;201406;6668;20046;4378;14728;1032;3824;1531;4845;2563;8669
420300;201406;5826;18274;3872;14039;999;4121;810;2930;1809;7051
420310;201406;890;2723;852;2660;184;609;541;1656;725;2265
420315;201406;976;3238;782;2828;222;898;316;1126;538;2024
420320;201406;4924;15570;4125;14132;1189;4563;1769;5902;2958;10465
420325;201406;467;1514;451;1479;146;522;162;513;308;1035
420330;201406;1316;4635;1040;3864;364;1442;237;784;601;2226
420340;201406;1515;4767;1182;3959;294;1079;333;1056;627;2135
420350;201406;1647;5372;1428;4911;404;1489;633;2197;1037;3686
420360;201406;3846;12423;2899;10231;1092;4224;534;1718;1626;5942
420370;201406;2090;5924;1766;5411;213;673;1405;4295;1618;4968
420380;201406;5550;18818;4698;16800;1534;5896;1347;4811;2881;10707
420390;201406;2139;6458;1325;4712;397;1516;342;1159;739;2675
420395;201406;2088;6564;1585;5419;400;1517;345;1067;745;2584
420400;201406;1528;4601;1141;3840;352;1377;337;1042;689;2419
420410;201406;845;2385;604;1981;151;560;315;1016;466;1576
420415;201406;524;1688;416;1413;129;464;142;473;271;937
420417;201406;814;2668;692;2370;147;537;343;1167;490;1704
420419;201406;468;1493;324;1207;141;572;86;322;227;894
420420;201406;15200;47187;12030;40602;3842;14107;4028;13402;7870;27509
420425;201406;1251;3497;779;2501;95;375;323;946;418;1321
420430;201406;4191;13311;2914;10266;904;3460;836;2913;1740;6373
420435;201406;253;822;185;657;65;268;59;188;124;456
420440;201406;1491;4387;916;3165;356;1335;168;519;524;1854
420445;201406;455;1322;353;1141;89;290;176;585;265;875
420450;201406;1300;3885;783;2798;195;794;155;472;350;1266
420455;201406;2304;7200;2059;6768;570;2131;934;2995;1504;5126
420460;201406;10054;32054;8189;28451;2399;9382;3082;10282;5481;19664
420470;201406;1242;3510;836;2717;250;910;240;741;490;1651
420475;201406;182;592;119;435;41;152;30;114;71;266
420480;201406;6158;18517;5112;16682;2071;7506;935;3014;3006;10520
420490;201406;870;2692;614;2212;193;738;158;545;351;1283
420500;201406;2134;6639;1759;5947;534;1934;875;2962;1409;4896
420510;201406;201;848;188;811;78;350;54;214;132;564
420515;201406;162;589;131;515;43;179;23;93;66;272
420517;201406;969;3008;890;2857;159;531;582;1882;741;2413
420519;201406;458;1300;340;1056;67;217;129;409;196;626
420520;201406;809;2301;643;2060;187;664;295;903;482;1567
420530;201406;1406;4892;1141;4225;374;1520;295;970;669;2490
420535;201406;259;794;175;608;56;220;32;90;88;310
420540;201406;19584;59402;14949;49595;5050;18400;4640;14595;9690;32995
420543;201406;500;1377;367;1154;47;174;220;729;267;903
420545;201406;1676;5495;1373;4800;382;1509;460;1511;842;3020
420550;201406;5003;16383;4135;14418;1217;4761;1348;4589;2565;9350
420555;201406;474;1552;398;1385;141;532;121;410;262;942
420560;201406;594;1772;494;1561;89;312;266;840;355;1152
420570;201406;2039;6830;1658;5879;491;1941;522;1753;1013;3694
420580;201406;1234;4111;1027;3720;301;1200;483;1756;784;2956
420590;201406;3437;10915;2517;8775;704;2682;528;1691;1232;4373
420600;201406;964;3360;874;3143;240;930;361;1327;601;2257
420610;201406;627;2068;446;1651;146;589;75;249;221;838
420620;201406;1221;3874;1084;3620;413;1470;296;970;709;2440
420630;201406;1145;3783;899;3142;256;961;286;891;542;1852
420640;201406;700;2201;326;1250;81;363;21;59;102;422
420650;201406;2145;6635;1231;4406;267;1096;227;666;494;1762
420660;201406;683;2051;554;1804;123;449;276;881;399;1330
420665;201406;835;2440;539;1809;110;413;174;517;284;930
420670;201406;1800;5767;1359;4770;356;1394;260;831;616;2225
420675;201406;257;820;184;647;48;194;75;246;123;440
420680;201406;518;1287;314;964;64;214;107;315;171;529
420690;201406;826;2899;602;2269;133;551;182;634;315;1185
420700;201406;3833;11279;3000;9587;744;2741;1031;3180;1775;5921
420710;201406;814;2944;675;2653;269;1133;195;739;464;1872
420720;201406;1998;6217;1729;5849;465;1645;1020;3462;1485;5107
420730;201406;4758;15006;4151;13867;1467;5231;1598;5284;3065;10515
420740;201406;818;2704;782;2654;173;607;535;1826;708;2433
420750;201406;2531;8344;1819;6590;439;1805;555;1771;994;3576
420757;201406;123;407;98;367;32;131;28;98;60;229
420760;201406;454;1489;339;1172;75;278;105;343;180;621
420765;201406;668;2249;427;1622;128;533;97;358;225;891
420768;201406;1301;4600;1083;4088;366;1439;405;1567;771;3006
420770;201406;912;2901;596;2176;199;784;159;547;358;1331
420775;201406;711;2303;485;1687;158;562;116;381;274;943
420780;201406;1728;5335;1172;3962;313;1144;327;1024;640;2168
420785;201406;325;1004;227;749;44;158;79;238;123;396
420790;201406;1388;5020;1138;4325;332;1396;456;1640;788;3036
420800;201406;951;2825;573;1947;178;672;133;407;311;1079
420810;201406;2679;9350;2155;8107;775;3229;586;2141;1361;5370
420820;201406;8521;28893;6884;25919;2377;9882;2380;9028;4757;18910
420830;201406;2818;9597;2447;8882;920;3619;890;3129;1810;6748
420840;201406;964;2904;577;2115;159;657;168;568;327;1225
420845;201406;1312;4432;1070;3932;399;1649;229;755;628;2404
420850;201406;2090;6909;1411;5449;502;2089;301;1161;803;3250
420860;201406;690;2028;468;1621;167;651;190;644;357;1295
420870;201406;1418;4141;1126;3721;437;1573;359;1135;796;2708
420880;201406;1485;5036;1226;4359;367;1371;248;836;615;2207
420890;201406;13214;32023;6176;19652;1275;4712;2261;6428;3536;11140
420895;201406;241;671;118;391;42;150;31;98;73;248
420900;201406;2404;7037;1600;5413;458;1680;415;1334;873;3014
420910;201406;24379;75246;16396;58069;4171;16851;4451;14818;8622;31669
420915;201406;679;2665;620;2512;192;787;282;1187;474;1974
420917;201406;464;1451;249;807;57;217;89;237;146;454
420920;201406;208;618;111;391;51;191;16;56;67;247
420930;201406;20766;63536;17667;58079;5519;19764;6562;21530;12081;41294
420940;201406;4507;13919;3895;12574;1151;4139;1203;3527;2354;7666
420945;201406;244;770;160;557;51;196;42;138;93;334
420950;201406;650;1901;315;1173;79;336;60;202;139;538
420960;201406;1484;4675;1281;4309;420;1596;477;1492;897;3088
420970;201406;2756;8678;2425;8138;621;2228;1310;4526;1931;6754
420980;201406;478;1548;394;1395;121;423;193;749;314;1172
420985;201406;605;1814;360;1282;115;448;104;349;219;797
420990;201406;937;2795;642;2266;173;672;186;611;359;1283
421000;201406;687;2475;490;1951;158;682;68;216;226;898
421003;201406;699;2019;301;1048;71;276;55;156;126;432
421005;201406;266;852;220;769;69;261;105;360;174;621
421010;201406;7039;21759;5368;18425;1744;6500;1648;5384;3392;11884
421020;201406;501;1615;380;1372;65;237;212;807;277;1044
421030;201406;1040;3857;964;3665;345;1389;325;1257;670;2646
421040;201406;962;2905;782;2583;254;910;294;901;548;1811
421050;201406;2069;5565;1200;4035;340;1310;348;1049;688;2359
421055;201406;286;927;189;680;59;232;47;142;106;374
421060;201406;571;2101;476;1832;132;551;129;476;261;1027
421070;201406;815;2584;545;1932;145;583;147;519;292;1102
421080;201406;700;2286;631;2136;190;681;298;998;488;1679
421085;201406;586;1596;327;1133;81;304;85;314;166;618
421090;201406;482;1369;331;1034;80;262;145;442;225;704
421100;201406;1087;3344;769;2646;222;819;184;550;406;1369
421105;201406;1503;4854;1298;4475;334;1256;543;1923;877;3179
421110;201406;1668;5530;1451;5155;533;2062;481;1606;1014;3668
421120;201406;1705;5542;1253;4460;300;1238;389;1248;689;2486
421125;201406;456;1392;346;1179;112;422;124;400;236;822
421130;201406;3480;11669;2900;10568;1074;4322;999;3684;2073;8006
421140;201406;439;1385;353;1200;97;364;139;444;236;808
421145;201406;594;1966;451;1578;79;315;199;665;278;980
421150;201406;566;1875;441;1635;116;463;196;724;312;1187
421160;201406;910;2833;634;2236;152;608;212;678;364;1286
421165;201406;337;1196;271;990;67;254;115;421;182;675
421170;201406;1876;6128;1604;5406;445;1579;814;2702;1259;4281
421175;201406;1448;4391;1152;3895;360;1417;414;1275;774;2692
421180;201406;583;1703;339;1152;95;367;124;380;219;747
421185;201406;492;1405;362;1149;73;218;183;605;256;823
421187;201406;333;1057;265;917;82;293;109;367;191;660
421189;201406;540;1648;487;1545;134;450;190;596;324;1046
421190;201406;10922;34839;8006;28642;2420;9247;2330;8257;4750;17504
421200;201406;1094;3701;957;3397;273;1062;347;1191;620;2253
421205;201406;249;793;187;654;46;193;46;132;92;325
421210;201406;2172;6785;1819;5902;628;2143;567;1788;1195;3931
421220;201406;2547;8762;2245;8107;802;3152;665;2374;1467;5526
421223;201406;790;2270;503;1766;143;534;236;815;379;1349
421225;201406;1245;3907;1038;3472;284;1005;430;1441;714;2446
421227;201406;973;3260;869;3098;225;796;512;1891;737;2687
421230;201406;751;2558;677;2382;194;736;249;837;443;1573
421240;201406;574;1913;367;1304;88;328;71;224;159;552
421250;201406;1980;6190;1384;5088;511;2042;376;1361;887;3403
421260;201406;356;1082;165;638;47;187;37;136;84;323
421265;201406;354;1237;316;1130;72;273;91;326;163;599
421270;201406;733;2013;449;1524;158;588;102;387;260;975
421280;201406;1657;5293;1358;4828;484;1924;421;1509;905;3433
421290;201406;2091;5959;1331;4436;436;1570;315;942;751;2512
421300;201406;323;1023;279;930;100;376;111;349;211;725
421310;201406;536;1844;461;1641;159;574;124;429;283;1003
421315;201406;388;1161;223;805;50;188;38;139;88;327
421320;201406;581;2005;405;1524;82;353;76;229;158;582
421330;201406;655;2295;572;2119;237;988;81;282;318;1270
421335;201406;580;1936;474;1722;128;510;103;378;231;888
421340;201406;1978;6315;1729;5867;445;1698;904;3042;1349;4740
421350;201406;1132;3876;946;3460;317;1302;288;1001;605;2303
421360;201406;3356;10120;2237;7888;533;2150;743;2455;1276;4605
421370;201406;1104;3941;958;3612;334;1381;278;1013;612;2394
421380;201406;1081;3152;880;2762;175;603;440;1377;615;1980
421390;201406;201;658;155;535;27;92;43;161;70;253
421400;201406;419;1590;338;1395;137;599;85;331;222;930
421410;201406;372;1163;301;1015;64;222;153;526;217;748
421415;201406;376;1244;214;825;71;292;62;218;133;510
421420;201406;1436;4511;1082;3643;256;928;238;732;494;1660
421430;201406;307;1019;241;885;80;336;49;173;129;509
421440;201406;865;2628;598;2109;172;651;225;759;397;1410
421450;201406;620;2097;448;1688;157;643;91;324;248;967
421460;201406;733;2326;483;1813;134;558;118;421;252;979
421470;201406;549;2019;466;1833;136;556;191;752;327;1308
421480;201406;3074;9679;2108;7705;694;2829;584;1972;1278;4801
421490;201406;342;1146;193;757;74;316;52;204;126;520
421500;201406;2769;9944;2454;9271;1021;4284;577;2116;1598;6400
421505;201406;407;1410;372;1320;115;430;148;516;263;946
421507;201406;667;2211;505;1821;121;456;195;701;316;1157
421510;201406;311;1176;285;1123;94;425;123;424;217;849
421520;201406;828;2228;542;1640;62;237;284;780;346;1017
421530;201406;536;1803;342;1348;93;416;115;437;208;853
421535;201406;741;2316;458;1692;88;333;237;869;325;1202
421540;201406;428;1273;369;1160;96;336;152;445;248;781
421545;201406;1250;4401;1034;3943;351;1495;227;821;578;2316
421550;201406;2283;7805;2054;7361;721;2852;664;2324;1385;5176
421555;201406;336;1026;146;518;26;110;40;127;66;237
421560;201406;205;622;99;351;24;96;23;77;47;173
421565;201406;1103;3512;1007;3344;436;1548;345;1115;781;2663
421567;201406;955;3595;830;3260;396;1594;176;697;572;2291
421568;201406;502;1644;389;1390;113;420;119;422;232;842
421569;201406;209;691;127;487;31;132;30;109;61;241
421570;201406;1221;4064;827;3070;282;1161;204;717;486;1878
421575;201406;619;2109;550;1968;118;451;303;1089;421;1540
421580;201406;4339;14589;3491;12656;1318;5332;871;2875;2189;8207
421590;201406;264;848;214;741;47;173;102;333;149;506
421600;201406;580;1756;430;1428;129;464;103;324;232;788
421605;201406;712;2235;507;1812;130;531;140;476;270;1007
421610;201406;1875;4932;1474;4355;194;634;964;2842;1158;3476
421620;201406;5262;16399;3794;13225;1262;4713;1297;4567;2559;9280
421625;201406;420;1356;253;927;66;271;88;309;154;580
421630;201406;2842;8628;1783;6209;519;1958;378;1271;897;3229
421635;201406;356;1206;264;991;73;300;103;355;176;655
421640;201406;1137;3678;993;3430;210;732;621;2205;831;2937
421650;201406;2378;8073;2070;7354;854;3313;350;1165;1204;4478
421660;201406;9590;32559;7851;29047;2635;10734;2541;8959;5176;19693
421670;201406;1255;4131;933;3372;296;1167;275;989;571;2156
421680;201406;1522;5039;1341;4594;535;1925;275;909;810;2834
421690;201406;2101;7001;1646;5883;472;1819;288;963;760;2782
421700;201406;755;2357;470;1691;147;595;145;454;292;1049
421710;201406;367;1313;278;1059;114;440;73;271;187;711
421715;201406;320;920;196;661;57;205;59;196;116;401
421720;201406;1803;5590;1329;4639;498;1974;409;1288;907;3262
421725;201406;134;475;129;464;40;159;58;208;98;367
421730;201406;661;2074;344;1269;89;360;77;228;166;588
421740;201406;746;2356;552;1892;167;671;143;402;310;1073
421750;201406;1509;4589;1168;3865;332;1200;458;1387;790;2587
421755;201406;471;1506;341;1173;106;405;99;304;205;709
421760;201406;570;1919;336;1255;90;374;134;486;224;860
421770;201406;3844;11807;3130;10341;1253;4307;884;3019;2137;7326
421775;201406;602;1783;394;1396;86;316;127;441;213;757
421780;201406;1799;6254;1427;5386;555;2265;420;1496;975;3761
421790;201406;1035;2971;655;2317;210;851;163;514;373;1365
421795;201406;412;1275;283;949;49;182;90;300;139;482
421800;201406;2827;9254;2208;7993;645;2616;780;2567;1425;5183
421810;201406;688;2233;503;1796;158;595;93;324;251;919
421820;201406;1290;4014;944;3331;221;926;290;940;511;1866
421825;201406;1412;4815;1306;4556;230;927;767;2591;997;3518
421830;201406;3222;11120;3020;10708;761;2822;1571;5748;2332;8570
421835;201406;193;612;152;541;50;212;71;228;121;440
421840;201406;529;1886;469;1741;166;671;177;630;343;1301
421850;201406;608;1809;444;1496;149;531;148;512;297;1043
421860;201406;398;1291;263;990;61;250;62;224;123;474
421870;201406;5425;16220;3893;12998;1208;4358;806;2605;2014;6963
421875;201406;427;1312;219;819;58;247;53;174;111;421
421880;201406;1129;3727;910;3199;278;1116;245;796;523;1912
421885;201406;365;1276;324;1182;87;317;132;484;219;801
421890;201406;1106;3817;959;3497;329;1317;308;1095;637;2412
421895;201406;442;1507;409;1443;112;396;223;816;335;1212
421900;201406;905;2970;754;2600;213;783;274;869;487;1652
421910;201406;555;1790;398;1414;109;432;115;362;224;794
421915;201406;631;1945;484;1603;113;402;167;518;280;920
421917;201406;612;1919;483;1690;156;639;183;587;339;1226
421920;201406;799;2477;634;2246;290;1096;215;724;505;1820
421930;201406;4152;11847;2876;9499;935;3437;528;1680;1463;5117
421935;201406;912;3208;723;2767;203;862;270;1002;473;1864
421940;201406;355;1281;252;995;79;345;62;217;141;562
421950;201406;4524;13050;2568;8890;794;2934;575;2022;1369;4956
421960;201406;268;871;215;749;58;219;62;208;120;427
421970;201406;2192;6732;1657;5525;610;2236;342;995;952;3231
421985;201406;502;1386;283;941;55;206;94;319;149;525
422000;201406;557;1603;420;1355;81;290;234;781;315;1071
430003;201406;915;2683;729;2359;217;783;233;734;450;1517
430005;201406;326;1099;280;1002;55;214;159;555;214;769
430010;201406;2242;6480;1741;5516;540;1782;669;2162;1209;3944
430020;201406;1116;3019;984;2819;228;760;569;1549;797;2309
430030;201406;1596;4381;1350;3934;396;1248;574;1583;970;2831
430040;201406;13087;34410;11084;31188;3452;9997;4357;12413;7809;22410
430045;201406;760;2114;612;1818;116;384;352;1021;468;1405
430047;201406;245;653;167;511;35;106;79;238;114;344
430050;201406;1130;3159;755;2423;161;598;305;923;466;1521
430055;201406;297;875;197;633;37;135;104;329;141;464
430057;201406;81;217;37;126;7;29;10;22;17;51
430060;201406;15998;52631;14218;49412;4217;15305;7019;24907;11236;40212
430063;201406;1105;3319;898;2868;243;796;438;1439;681;2235
430064;201406;1724;5160;1444;4683;411;1364;653;2191;1064;3555
430066;201406;178;453;131;378;27;88;72;197;99;285
430070;201406;680;2039;416;1455;111;422;123;399;234;821
430080;201406;647;2122;515;1815;138;539;151;497;289;1036
430085;201406;714;2036;520;1692;161;600;210;645;371;1245
430087;201406;1015;3117;967;3027;105;369;762;2362;867;2731
430090;201406;818;2212;303;1004;41;155;70;232;111;387
430100;201406;1099;3478;839;2918;298;1144;199;579;497;1723
430105;201406;820;2626;640;2264;209;816;165;549;374;1365
430107;201406;265;897;209;729;45;172;81;269;126;441
430110;201406;2293;6764;2094;6428;700;2300;935;2840;1635;5140
430120;201406;1840;5666;1477;4880;322;1124;854;2780;1176;3904
430130;201406;4635;11952;4190;11325;748;2168;2609;7093;3357;9261
430140;201406;1237;4027;971;3387;300;1080;341;1165;641;2245
430150;201406;954;2593;651;2022;166;547;200;615;366;1162
430155;201406;521;1646;397;1360;90;301;187;653;277;954
430160;201406;18845;55970;17573;53858;3909;12940;10034;31523;13943;44463
430163;201406;1953;5941;1688;5443;380;1355;848;2767;1228;4122
430165;201406;338;1108;251;946;106;419;60;216;166;635
430170;201406;809;2379;389;1365;86;307;80;243;166;550
430175;201406;975;3106;782;2657;178;561;384;1389;562;1950
430180;201406;1158;3180;994;2906;247;801;482;1385;729;2186
430185;201406;774;1951;400;1218;63;214;132;361;195;575
430187;201406;743;2325;642;2125;190;714;219;690;409;1404
430190;201406;2385;7154;2090;6582;525;1890;1025;3211;1550;5101
430192;201406;196;613;103;329;15;53;34;103;49;156
430195;201406;283;871;81;304;13;49;14;43;27;92
430200;201406;1879;6029;1568;5384;489;1787;373;1278;862;3065
430205;201406;525;1542;410;1334;54;199;268;870;322;1069
430210;201406;6655;19058;3760;12727;1033;3777;761;2367;1794;6144
430215;201406;350;1030;268;858;60;203;120;369;180;572
430220;201406;698;1843;341;1136;70;255;61;194;131;449
430222;201406;326;1008;255;853;61;237;112;353;173;590
430223;201406;352;1061;312;997;63;201;211;684;274;885
430225;201406;60;176;36;117;7;19;8;22;15;41
430230;201406;2159;6867;2035;6737;332;968;1608;5530;1940;6498
430235;201406;279;937;224;796;68;265;62;208;130;473
430237;201406;442;1231;364;1091;52;192;239;689;291;881
430240;201406;1150;3454;909;2979;311;1144;300;902;611;2046
430245;201406;957;3121;751;2664;214;793;328;1188;542;1981
430250;201406;1628;4536;1471;4258;618;1840;482;1434;1100;3274
430258;201406;211;598;145;463;22;73;69;225;91;298
430260;201406;860;2450;577;1855;81;306;320;1029;401;1335
430265;201406;331;1058;274;918;83;271;44;135;127;406
430270;201406;3622;10332;3254;9691;791;2655;1702;4993;2493;7648
430280;201406;5500;15684;4710;14207;1347;4322;2118;6353;3465;10675
430290;201406;2532;7008;2408;6874;300;846;2003;5825;2303;6671
430300;201406;10319;31648;8753;28619;3105;10673;3594;12051;6699;22724
430310;201406;8955;28365;7903;26289;2576;9171;3369;10943;5945;20114
430320;201406;871;2584;600;2028;93;276;314;1113;407;1389
430330;201406;1026;2825;867;2524;265;815;351;946;616;1761
430340;201406;774;1980;448;1509;105;403;218;718;323;1121
430350;201406;6387;20494;5474;18464;1976;7047;1983;6571;3959;13618
430355;201406;257;681;160;499;35;125;39;106;74;231
430360;201406;1177;3145;1011;2839;188;591;575;1588;763;2179
430367;201406;351;975;235;759;42;142;69;216;111;358
430370;201406;644;1907;510;1636;183;625;136;401;319;1026
430380;201406;886;2297;495;1582;129;438;182;601;311;1039
430390;201406;4514;13412;3411;11021;895;3165;1028;3156;1923;6321
430400;201406;1359;3266;952;2670;272;854;452;1196;724;2050
430410;201406;715;1952;561;1700;98;331;290;879;388;1210
430420;201406;4736;13913;3835;11839;1145;3608;1578;4911;2723;8519
430430;201406;830;2312;537;1745;172;607;149;466;321;1073
430435;201406;2104;5745;1724;5063;384;1181;947;2801;1331;3982
430440;201406;4968;15488;4055;13601;884;3138;1918;6708;2802;9846
430450;201406;9193;26609;7420;22936;2812;9170;2229;6840;5041;16010
430460;201406;27505;84529;22626;75497;7184;25682;8325;27878;15509;53560
430461;201406;487;1361;172;557;36;132;45;138;81;270
430462;201406;358;1063;293;951;119;418;102;322;221;740
430463;201406;4034;13379;3596;12479;908;3427;1817;6316;2725;9743
430465;201406;674;1843;571;1668;128;420;369;1054;497;1474
430466;201406;4460;13231;4206;12776;1178;3851;2182;6629;3360;10480
430467;201406;605;1861;532;1741;133;480;265;846;398;1326
430468;201406;1501;4383;1307;4076;528;1788;382;1165;910;2953
430469;201406;180;503;56;207;8;33;14;54;22;87
430470;201406;7711;20745;5653;17256;1902;6285;1566;4706;3468;10991
430471;201406;916;3070;819;2856;300;1095;214;744;514;1839
430480;201406;939;2567;509;1662;88;318;115;327;203;645
430485;201406;248;775;140;503;27;93;52;191;79;284
430490;201406;540;1611;381;1305;114;399;135;483;249;882
430495;201406;440;1331;304;1034;66;242;88;296;154;538
430500;201406;1673;4704;1421;4267;435;1405;669;2000;1104;3405
430510;201406;27240;84368;21084;69787;7176;25982;6086;19270;13262;45252
430511;201406;482;1474;250;846;47;166;46;129;93;295
430512;201406;1362;3603;1204;3337;342;955;487;1411;829;2366
430513;201406;698;1969;497;1542;80;259;237;738;317;997
430515;201406;619;1839;489;1560;103;334;214;706;317;1040
430517;201406;1444;4818;1279;4453;249;919;811;2808;1060;3727
430520;201406;1821;5379;1442;4564;478;1636;560;1696;1038;3332
430530;201406;960;2728;523;1688;110;413;143;408;253;821
430535;201406;2526;8170;2128;7290;589;2251;735;2451;1324;4702
430537;201406;632;1843;446;1530;46;146;345;1214;391;1360
430540;201406;769;1875;583;1628;141;436;333;904;474;1340
430543;201406;608;1605;547;1543;131;391;369;1052;500;1443
430544;201406;759;2503;641;2219;138;523;337;1132;475;1655
430545;201406;1444;4700;1260;4464;406;1425;681;2587;1087;4012
430550;201406;719;2147;496;1681;104;378;211;714;315;1092
430558;201406;121;367;82;280;38;145;11;29;49;174
430560;201406;402;1022;250;740;45;169;108;300;153;469
430570;201406;1239;3249;877;2572;212;727;450;1199;662;1926
430580;201406;1103;3191;765;2513;269;907;209;715;478;1622
430583;201406;156;431;54;178;10;38;5;14;15;52
430585;201406;374;1014;245;738;82;272;102;278;184;550
430587;201406;299;935;255;841;104;358;79;258;183;616
430590;201406;1544;4391;1466;4267;347;1110;869;2504;1216;3614
430593;201406;37;145;35;137;12;56;11;34;23;90
430595;201406;241;690;105;381;34;140;15;44;49;184
430597;201406;403;1241;316;1036;59;213;128;399;187;612
430600;201406;2176;6034;1371;4243;311;1026;502;1514;813;2540
430605;201406;1388;4384;1121;3805;287;1069;474;1631;761;2700
430607;201406;756;2047;624;1825;108;334;386;1136;494;1470
430610;201406;8528;23157;6725;20255;1673;5530;2970;8986;4643;14516
430613;201406;255;641;132;398;29;91;43;115;72;206
430620;201406;1000;3094;827;2689;244;875;332;1012;576;1887
430630;201406;475;1435;298;993;94;319;59;181;153;500
430632;201406;747;2106;480;1530;90;337;252;744;342;1081
430635;201406;703;1944;498;1545;122;398;238;735;360;1133
430637;201406;552;1587;502;1487;85;302;333;942;418;1244
430640;201406;2000;5732;1051;3514;248;881;213;592;461;1473
430642;201406;503;1349;326;1038;64;217;147;461;211;678
430645;201406;195;583;110;385;27;106;28;92;55;198
430650;201406;2158;7142;1880;6541;408;1432;1051;3792;1459;5224
430655;201406;316;956;277;870;74;249;105;280;179;529
430660;201406;6190;18415;4989;16184;1514;5390;2077;6701;3591;12091
430670;201406;501;1481;456;1393;41;120;347;1093;388;1213
430673;201406;801;1964;450;1371;122;384;186;564;308;948
430675;201406;203;619;126;434;29;114;51;167;80;281
430676;201406;4738;14449;4267;13646;1345;4578;1768;5869;3113;10447
430680;201406;1252;3737;926;3016;205;752;372;1116;577;1868
430690;201406;4605;13473;3824;11937;1220;3959;1465;4685;2685;8644
430692;201406;297;1028;216;858;32;125;128;521;160;646
430693;201406;1833;5187;1361;4137;307;1010;410;1208;717;2218
430695;201406;512;1498;426;1327;85;312;222;651;307;963
430697;201406;484;1384;374;1195;117;365;152;521;269;886
430700;201406;11132;29504;5595;18337;1168;4274;723;2188;1891;6462
430705;201406;415;1318;386;1267;129;451;165;548;294;999
430710;201406;1886;4946;1495;4292;306;940;772;2305;1078;3245
430720;201406;931;2333;610;1854;174;569;246;776;420;1345
430730;201406;1945;5268;1519;4593;359;1044;830;2661;1189;3705
430740;201406;615;1798;389;1306;136;496;58;170;194;666
430745;201406;548;1592;354;1138;68;225;114;375;182;600
430750;201406;1898;5404;1597;4885;385;1300;822;2428;1207;3728
430755;201406;662;1864;476;1459;101;365;216;594;317;959
430760;201406;3747;9600;2957;8611;699;2178;1586;4792;2285;6970
430770;201406;7075;21406;6008;19542;1447;5160;3050;9810;4497;14970
430780;201406;2642;7549;1796;5831;504;1780;681;2107;1185;3887
430781;201406;668;1997;484;1609;140;485;166;541;306;1026
430783;201406;579;1516;453;1293;98;313;209;554;307;867
430786;201406;127;434;103;365;37;134;20;75;57;209
430790;201406;4089;11501;2756;8709;564;2073;1211;3564;1775;5637
430800;201406;835;2556;624;2044;171;586;209;657;380;1243
430805;201406;497;1425;363;1175;43;137;225;760;268;897
430807;201406;303;905;225;731;58;235;75;213;133;448
430810;201406;745;2100;382;1301;78;295;74;230;152;525
430820;201406;1106;3560;838;2883;238;861;254;825;492;1686
430825;201406;466;1319;247;781;50;168;78;217;128;385
430830;201406;2735;8087;2537;7778;374;1144;1680;5469;2054;6613
430840;201406;1026;3210;932;3008;242;799;442;1475;684;2274
430843;201406;118;361;77;252;16;50;34;106;50;156
430845;201406;394;1187;321;1042;120;421;45;136;165;557
430850;201406;3419;10508;3052;9824;860;2926;1339;4320;2199;7246
430860;201406;767;2488;593;2086;194;794;150;475;344;1269
430865;201406;743;2045;682;1939;224;669;328;919;552;1588
430870;201406;690;1987;429;1448;137;481;108;344;245;825
430880;201406;1448;4217;1168;3665;461;1507;333;1085;794;2592
430885;201406;189;592;159;543;51;188;53;168;104;356
430890;201406;1708;4578;1312;3863;68;227;812;2357;880;2584
430900;201406;3355;9047;3095;8664;621;1808;1957;5540;2578;7348
430905;201406;1153;3420;794;2628;264;956;209;664;473;1620
430910;201406;1990;6302;1600;5540;587;2167;604;2032;1191;4199
430912;201406;602;1684;470;1467;74;266;269;819;343;1085
430915;201406;440;1506;316;1243;102;422;89;372;191;794
430920;201406;18682;59372;17158;56482;5219;17955;9715;31908;14934;49863
430925;201406;88;255;71;221;19;62;37;117;56;179
430930;201406;9744;30783;7951;27038;2419;8699;3089;10907;5508;19606
430940;201406;1250;3936;940;3230;241;911;282;931;523;1842
430950;201406;1660;4704;1268;3874;398;1287;393;1150;791;2437
430955;201406;115;380;87;302;30;114;24;75;54;189
430957;201406;330;1115;269;980;68;260;121;446;189;706
430960;201406;1839;5310;1602;4894;597;1933;559;1747;1156;3680
430965;201406;1434;4303;1241;3949;131;477;954;3021;1085;3498
430970;201406;555;1603;342;1134;87;316;101;332;188;648
430975;201406;659;2170;507;1793;92;353;272;954;364;1307
430980;201406;583;1419;349;1064;94;329;143;386;237;715
430990;201406;686;2221;522;1803;177;625;136;466;313;1091
430995;201406;746;2246;662;2078;224;735;265;821;489;1556
431000;201406;1785;4847;1013;3233;247;892;148;399;395;1291
431010;201406;2956;8817;2046;6928;553;2063;648;2047;1201;4110
431020;201406;14889;37397;10448;29294;2909;8371;3479;10108;6388;18479
431030;201406;405;1226;230;809;55;200;57;203;112;403
431033;201406;2886;8448;2637;8067;650;2050;1475;4731;2125;6781
431036;201406;239;672;113;378;25;90;32;98;57;188
431040;201406;1053;3082;886;2791;234;814;467;1440;701;2254
431041;201406;601;1689;538;1597;187;566;203;653;390;1219
431043;201406;420;1406;321;1174;153;614;106;343;259;957
431046;201406;124;387;92;309;28;97;34;112;62;209
431050;201406;1918;4900;1553;4295;365;1080;879;2421;1244;3501
431053;201406;651;2159;549;1944;179;685;189;678;368;1363
431055;201406;699;1986;646;1893;81;239;459;1362;540;1601
431057;201406;351;1024;215;756;54;198;94;334;148;532
431060;201406;6379;18922;6029;18471;1579;4682;3682;11769;5261;16451
431065;201406;461;1399;431;1339;48;163;292;906;340;1069
431070;201406;774;2279;476;1596;101;357;127;388;228;745
431075;201406;289;884;194;675;36;136;59;210;95;346
431080;201406;721;2353;602;2101;172;644;130;435;302;1079
431085;201406;971;2586;787;2281;141;436;474;1365;615;1801
431087;201406;634;1829;562;1691;77;219;372;1132;449;1351
431090;201406;581;1493;316;986;111;370;63;180;174;550
431100;201406;4849;13587;4079;12218;1197;3762;1701;5228;2898;8990
431110;201406;1668;4488;1262;3668;313;980;626;1770;939;2750
431112;201406;664;2098;633;2045;205;658;309;1008;514;1666
431113;201406;685;2039;514;1650;157;510;155;506;312;1016
431115;201406;1566;4651;1405;4363;296;972;849;2618;1145;3590
431120;201406;2864;9149;2468;8373;763;2830;1040;3426;1803;6256
431123;201406;551;1711;449;1514;125;451;229;783;354;1234
431125;201406;1441;4463;1107;3750;344;1174;418;1511;762;2685
431127;201406;131;368;68;224;8;22;9;31;17;53
431130;201406;4053;11738;3270;10366;908;3136;1393;4407;2301;7543
431140;201406;4097;10580;2288;7427;463;1746;627;1781;1090;3527
431142;201406;557;1701;506;1605;73;228;324;1057;397;1285
431150;201406;1372;4195;1118;3700;320;1110;421;1406;741;2516
431160;201406;1029;3053;868;2713;173;547;430;1448;603;1995
431162;201406;468;1263;232;781;29;121;38;108;67;229
431164;201406;144;391;42;157;16;59;1;4;17;63
431170;201406;985;2894;763;2449;264;863;227;736;491;1599
431171;201406;922;2764;794;2501;289;958;206;618;495;1576
431173;201406;505;1521;466;1452;106;340;282;887;388;1227
431175;201406;1327;3712;1154;3452;377;1186;483;1451;860;2637
431177;201406;1081;3484;915;3149;302;1148;400;1358;702;2506
431179;201406;170;419;83;257;20;72;24;58;44;130
431180;201406;2789;8425;2219;7123;624;2153;693;2119;1317;4272
431190;201406;787;2195;471;1556;131;484;152;490;283;974
431198;201406;394;1300;344;1196;164;617;73;242;237;859
431200;201406;341;975;116;388;26;91;14;42;40;133
431205;201406;346;1129;239;833;55;197;96;320;151;517
431210;201406;806;2287;696;2069;180;548;376;1124;556;1672
431213;201406;317;993;265;892;81;302;94;304;175;606
431215;201406;343;1017;178;602;36;122;21;57;57;179
431217;201406;250;760;194;628;62;217;54;183;116;400
431220;201406;1218;3166;874;2500;134;438;458;1249;592;1687
431225;201406;1416;4218;1229;3895;296;991;674;2155;970;3146
431230;201406;974;2919;757;2465;132;466;397;1290;529;1756
431235;201406;76;183;36;110;9;30;12;35;21;65
431237;201406;461;1507;407;1430;115;464;192;652;307;1116
431238;201406;54;171;44;146;10;36;14;45;24;81
431240;201406;2867;8820;2459;8113;883;3133;750;2430;1633;5563
431242;201406;439;1422;416;1377;177;636;62;196;239;832
431244;201406;480;1180;340;954;76;255;159;410;235;665
431245;201406;1146;3156;961;2854;184;580;609;1816;793;2396
431247;201406;229;733;184;638;72;269;67;224;139;493
431250;201406;1940;6163;1730;5848;545;1974;747;2595;1292;4569
431260;201406;410;1198;284;947;79;299;74;228;153;527
431261;201406;228;808;195;732;42;169;61;233;103;402
431262;201406;384;1063;162;553;29;124;66;223;95;347
431265;201406;1409;3801;838;2581;207;734;255;666;462;1400
431267;201406;205;624;171;558;51;185;75;229;126;414
431270;201406;2705;7274;2113;6385;609;1950;962;2970;1571;4920
431275;201406;229;751;149;537;44;157;30;94;74;251
431280;201406;204;632;116;393;23;89;26;71;49;160
431290;201406;366;1196;286;984;81;322;69;222;150;544
431295;201406;226;723;134;456;26;99;34;96;60;195
431300;201406;242;731;91;352;28;113;7;28;35;141
431301;201406;254;830;176;625;49;179;41;129;90;308
431303;201406;763;2068;536;1609;127;452;196;549;323;1001
431306;201406;2177;6176;1704;5282;329;1220;600;1679;929;2899
431308;201406;57;197;53;186;34;117;15;56;49;173
431310;201406;777;2451;546;1924;118;444;204;736;322;1180
431320;201406;935;2755;590;2047;174;675;155;502;329;1177
431330;201406;2444;6270;1230;3938;371;1289;214;666;585;1955
431333;201406;442;1192;209;645;38;131;70;183;108;314
431335;201406;100;295;83;256;20;57;32;96;52;153
431337;201406;2690;8319;2096;7001;580;2004;565;1859;1145;3863
431339;201406;675;1918;503;1539;113;365;234;706;347;1071
431340;201406;28398;76714;20865;63665;5301;17849;7656;22773;12957;40622
431342;201406;651;1715;548;1541;159;473;295;806;454;1279
431344;201406;409;1119;304;935;32;102;190;598;222;700
431346;201406;342;912;199;592;60;176;55;166;115;342
431349;201406;657;1912;478;1484;100;316;165;504;265;820
431350;201406;4054;12315;3607;11500;713;2614;2064;6366;2777;8980
431360;201406;831;2243;630;1914;170;546;255;784;425;1330
431365;201406;1448;4439;1262;4127;474;1660;506;1670;980;3330
431370;201406;5700;16496;4777;14913;1426;4752;1964;6207;3390;10959
431380;201406;1137;3469;1066;3316;187;621;733;2244;920;2865
431390;201406;3812;10928;2629;8597;816;2994;791;2403;1607;5397
431395;201406;1644;4960;1471;4678;441;1489;614;1961;1055;3450
431400;201406;210;689;140;530;44;179;15;40;59;219
431402;201406;1286;3221;806;2351;169;513;388;1108;557;1621
431403;201406;329;990;251;848;87;320;63;218;150;538
431405;201406;4775;13752;3833;12314;913;3435;1853;5696;2766;9131
431406;201406;828;2616;650;2181;214;734;267;882;481;1616
431407;201406;687;2059;472;1578;151;521;118;365;269;886
431410;201406;17322;53918;13924;47129;5200;18739;3622;12832;8822;31571
431413;201406;211;521;103;321;13;45;44;130;57;175
431415;201406;958;2748;781;2411;196;650;360;1063;556;1713
431417;201406;702;1807;567;1603;101;293;307;901;408;1194
431420;201406;1646;4593;1453;4278;335;1025;811;2477;1146;3502
431430;201406;610;1692;452;1419;119;408;167;492;286;900
431440;201406;33447;98576;29882;92653;9656;30814;13729;44534;23385;75348
431442;201406;211;677;169;575;62;233;24;60;86;293
431445;201406;534;1467;351;1073;66;213;139;411;205;624
431446;201406;513;1520;377;1230;90;298;170;561;260;859
431447;201406;861;2465;619;1920;136;446;275;872;411;1318
431449;201406;958;2720;779;2408;127;431;429;1350;556;1781
431450;201406;2336;6193;2150;5901;494;1421;1379;3767;1873;5188
431455;201406;679;1766;415;1206;133;397;120;329;253;726
431460;201406;3726;10588;3221;9605;965;2955;1225;3750;2190;6705
431470;201406;1935;5759;1542;4877;422;1323;671;2228;1093;3551
431475;201406;174;515;62;246;15;65;4;15;19;80
431477;201406;712;1968;514;1579;94;317;285;852;379;1169
431478;201406;237;631;98;294;23;68;38;112;61;180
431480;201406;2921;8529;2324;7430;739;2594;829;2572;1568;5166
431490;201406;115248;327461;101594;306833;17753;60652;67527;200696;85280;261348
431500;201406;1198;3150;966;2714;283;784;366;1050;649;1834
431505;201406;418;1135;361;1050;37;101;291;863;328;964
431507;201406;468;1155;372;977;71;182;231;615;302;797
431510;201406;2262;6287;1879;5607;386;1269;966;2787;1352;4056
431513;201406;246;688;120;391;25;85;59;195;84;280
431514;201406;111;285;41;133;7;27;3;6;10;33
431515;201406;779;2344;562;1798;124;449;252;728;376;1177
431517;201406;94;310;87;293;41;147;24;71;65;218
431520;201406;496;1503;318;1058;72;265;84;271;156;536
431530;201406;4746;11626;3679;10385;1059;2983;1906;5720;2965;8703
431531;201406;298;858;209;678;55;188;83;275;138;463
431532;201406;575;1646;509;1506;164;524;200;582;364;1106
431535;201406;393;1165;280;877;67;232;81;229;148;461
431540;201406;2281;7378;2037;7022;299;955;1346;4968;1645;5923
431545;201406;184;512;64;230;6;23;14;61;20;84
431550;201406;2516;7631;2315;7263;553;1966;1154;3561;1707;5527
431555;201406;802;2118;702;1971;165;458;376;1073;541;1531
431560;201406;25069;78357;21249;70535;8354;28047;6955;24273;15309;52320
431570;201406;5817;16637;5224;15721;1595;4861;2838;8677;4433;13538
431575;201406;490;1320;349;1077;66;242;116;332;182;574
431580;201406;777;2465;616;2071;174;651;212;649;386;1300
431590;201406;1027;2889;711;2234;108;353;344;1081;452;1434
431595;201406;643;1832;525;1566;137;429;194;577;331;1006
431600;201406;2342;6978;1745;5731;489;1822;353;1002;842;2824
431610;201406;1758;5008;1298;4150;306;1039;636;2040;942;3079
431620;201406;414;1316;263;861;84;294;108;321;192;615
431630;201406;1488;4067;1118;3299;297;900;549;1641;846;2541
431640;201406;6314;18837;5730;17892;1441;4934;3214;9912;4655;14846
431642;201406;559;1631;467;1448;76;275;255;758;331;1033
431643;201406;225;604;192;544;31;105;115;302;146;407
431645;201406;1867;5643;1698;5339;384;1238;983;3164;1367;4402
431647;201406;182;522;130;397;43;136;31;78;74;214
431650;201406;258;819;183;656;40;163;43;135;83;298
431660;201406;1566;4677;1172;3858;374;1286;428;1362;802;2648
431670;201406;1440;4027;1155;3508;320;1071;514;1510;834;2581
431673;201406;248;745;159;545;44;160;44;151;88;311
431675;201406;355;1117;240;823;61;215;67;201;128;416
431680;201406;10884;30435;8390;26053;2541;8454;3042;9572;5583;18026
431690;201406;26828;77468;21942;69721;6795;23092;9004;29127;15799;52219
431695;201406;153;521;114;420;24;93;31;88;55;181
431697;201406;527;1499;469;1391;137;410;207;641;344;1051
431700;201406;1706;4833;1459;4352;282;920;786;2287;1068;3207
431710;201406;13468;39833;11155;35796;3422;11447;4351;14488;7773;25935
431720;201406;7431;21157;6135;18680;1411;4813;3116;9299;4527;14112
431725;201406;35;124;33;120;15;56;11;41;26;97
431730;201406;3984;12313;3250;10902;950;3503;1102;3766;2052;7269
431740;201406;6150;18178;5420;16775;2000;6671;1553;4630;3553;11301
431750;201406;10797;30985;9291;28522;2014;6688;4931;15469;6945;22157
431755;201406;279;741;81;283;18;70;15;47;33;117
431760;201406;4212;12796;3503;11427;989;3515;1119;3511;2108;7026
431770;201406;2417;6638;2036;6026;519;1606;1068;3145;1587;4751
431775;201406;246;686;183;569;72;235;46;126;118;361
431780;201406;2417;6522;1840;5437;521;1660;556;1567;1077;3227
431790;201406;1251;3957;1110;3705;280;995;589;1957;869;2952
431795;201406;502;1486;391;1232;81;278;195;617;276;895
431800;201406;9923;29547;8333;26558;2819;9696;2534;7934;5353;17630
431805;201406;314;762;90;304;13;52;18;58;31;110
431810;201406;3683;10356;3044;9032;657;2073;1459;4288;2116;6361
431820;201406;2938;9318;2594;8640;751;2692;1006;3307;1757;5999
431830;201406;11933;30969;9738;27585;3176;9640;3836;11030;7012;20670
431840;201406;3684;11048;3248;10214;986;3191;1482;4761;2468;7952
431842;201406;780;2025;430;1319;88;301;142;406;230;707
431843;201406;368;1081;330;1015;71;244;193;579;264;823
431844;201406;170;513;132;441;38;146;44;138;82;284
431845;201406;553;1685;504;1580;59;193;339;1079;398;1272
431846;201406;547;1638;470;1499;91;329;277;885;368;1214
431848;201406;203;560;110;373;23;92;23;73;46;165
431849;201406;412;1034;119;367;27;88;33;87;60;175
431850;201406;5071;15090;4529;14050;1095;3698;2249;6831;3344;10529
431860;201406;1001;2816;801;2480;168;589;431;1278;599;1867
431861;201406;99;305;61;211;13;42;7;20;20;62
431862;201406;507;1719;418;1520;157;629;105;353;262;982
431870;201406;26800;76414;22457;68599;6246;20854;9744;29115;15990;49969
431880;201406;5010;15863;4173;13937;1216;4423;1718;5593;2934;10016
431890;201406;6272;17667;5223;15780;1955;6184;1729;5379;3684;11563
431900;201406;1026;3094;794;2663;235;890;310;934;545;1824
431910;201406;1011;2407;489;1422;104;340;194;513;298;853
431912;201406;632;1844;497;1571;161;492;175;581;336;1073
431915;201406;1440;3958;1084;3310;286;933;428;1321;714;2254
431920;201406;1567;4420;1433;4234;193;525;1111;3378;1304;3903
431930;201406;1371;3800;1060;3294;171;504;630;2091;801;2595
431935;201406;119;443;109;421;47;206;31;98;78;304
431936;201406;495;1422;441;1318;69;197;285;924;354;1121
431937;201406;354;967;206;645;59;200;38;105;97;305
431940;201406;2853;7891;1918;6050;520;1745;564;1757;1084;3502
431950;201406;1981;6348;1770;5960;508;1857;730;2362;1238;4219
431960;201406;3795;11307;3478;10691;1070;3471;1272;3930;2342;7401
431970;201406;525;1455;281;921;48;178;84;264;132;442
431971;201406;138;402;115;368;31;104;51;156;82;260
431973;201406;498;1744;440;1621;68;249;261;1023;329;1272
431975;201406;17;69;13;58;4;21;4;16;8;37
431980;201406;1597;4668;1409;4271;368;1249;575;1633;943;2882
431990;201406;9006;25240;7119;22164;1601;5693;2974;8829;4575;14522
432000;201406;11557;34048;9503;30384;3024;10156;4073;13066;7097;23222
432010;201406;2583;7700;2239;7042;522;1873;1094;3331;1616;5204
432020;201406;2430;6148;1995;5578;304;921;1343;3741;1647;4662
432023;201406;556;1623;408;1298;106;375;150;446;256;821
432026;201406;1239;3880;1037;3418;221;762;525;1735;746;2497
432030;201406;440;1300;361;1128;98;311;157;473;255;784
432032;201406;576;1526;389;1173;71;243;214;620;285;863
432035;201406;891;2835;797;2651;183;634;468;1552;651;2186
432040;201406;974;2554;566;1856;151;546;136;352;287;898
432045;201406;216;709;175;629;49;184;68;256;117;440
432050;201406;819;2389;731;2222;142;455;427;1323;569;1778
432055;201406;868;2703;740;2431;162;587;443;1408;605;1995
432057;201406;475;1250;374;1058;44;150;239;630;283;780
432060;201406;481;1364;210;727;58;228;53;164;111;392
432065;201406;249;727;192;621;48;169;89;267;137;436
432067;201406;1057;3432;789;2801;214;787;376;1334;590;2121
432070;201406;2721;7375;2007;5973;620;2060;672;1912;1292;3972
432080;201406;4408;12932;3856;11919;1202;3934;1633;4960;2835;8894
432085;201406;287;897;235;806;72;283;97;317;169;600
432090;201406;1825;5680;1552;5090;595;2107;497;1459;1092;3566
432100;201406;1284;3810;721;2503;190;687;134;402;324;1089
432110;201406;3181;9629;2543;8274;848;3033;504;1570;1352;4603
432120;201406;5564;16922;4808;15507;1777;6105;1582;5112;3359;11217
432130;201406;2460;7252;2135;6813;567;1967;1192;3845;1759;5812
432132;201406;431;1358;260;923;48;186;98;305;146;491
432135;201406;808;2451;767;2380;122;395;535;1660;657;2055
432140;201406;2983;8810;2430;7784;697;2286;973;3418;1670;5704
432143;201406;1445;4398;1246;4066;300;1004;701;2362;1001;3366
432145;201406;1167;3719;803;2859;269;1040;163;516;432;1556
432146;201406;285;903;207;710;73;262;54;178;127;440
432147;201406;847;2691;681;2324;197;688;276;959;473;1647
432149;201406;427;1276;301;972;95;327;101;312;196;639
432150;201406;3968;11633;3099;9957;1006;3532;1025;3138;2031;6670
432160;201406;4826;15739;4333;14909;1512;5414;1759;6358;3271;11772
432162;201406;347;859;96;313;27;96;24;67;51;163
432163;201406;393;1026;107;341;16;50;23;77;39;127
432166;201406;831;2497;680;2177;147;536;323;960;470;1496
432170;201406;890;2996;637;2419;143;577;141;514;284;1091
432180;201406;2947;7876;2099;6441;634;2086;645;1937;1279;4023
432183;201406;467;1514;392;1356;170;603;97;342;267;945
432185;201406;929;2665;622;2030;139;515;244;773;383;1288
432190;201406;3701;10326;2734;8176;766;2390;873;2468;1639;4858
432195;201406;1328;3800;1189;3584;207;678;756;2256;963;2934
432200;201406;3332;10338;2738;9270;763;2766;1297;4502;2060;7268
432210;201406;451;1345;388;1247;107;399;191;566;298;965
432215;201406;926;2897;815;2709;151;474;510;1794;661;2268
432218;201406;334;927;256;777;49;161;118;333;167;494
432220;201406;4101;11080;3412;9958;457;1571;2223;6368;2680;7939
432225;201406;66;222;56;202;27;101;13;47;40;148
432230;201406;1227;3458;885;2724;270;913;353;979;623;1892
432232;201406;595;1761;471;1520;111;407;228;721;339;1128
432234;201406;563;1561;415;1210;101;299;178;496;279;795
432235;201406;76;237;46;164;15;66;7;23;22;89
432237;201406;515;1441;467;1366;34;135;371;1052;405;1187
432240;201406;16186;53725;14157;50982;3182;12589;8496;31313;11678;43902
432250;201406;5759;20224;5421;19527;2326;9033;1570;5713;3896;14746
432252;201406;495;1481;415;1324;130;440;188;611;318;1051
432253;201406;1321;4357;991;3494;320;1178;327;1168;647;2346
432254;201406;696;1903;216;706;51;185;35;99;86;284
432255;201406;220;553;124;404;41;145;37;115;78;260
432260;201406;7532;19358;5366;15744;1312;4048;2430;7221;3742;11269
432270;201406;2840;8801;2478;8161;732;2466;1149;3852;1881;6318
432280;201406;1335;3891;812;2735;190;717;190;569;380;1286
432285;201406;170;536;71;244;23;86;12;32;35;118
432290;201406;624;1901;417;1418;96;354;163;534;259;888
432300;201406;24799;76238;22597;72443;5716;19486;12420;39828;18136;59314
432310;201406;1015;3158;880;2909;198;731;464;1495;662;2226
432320;201406;287;801;180;582;52;167;60;198;112;365
432330;201406;276;780;110;387;19;67;14;42;33;109
432335;201406;207;607;91;320;27;101;10;31;37;132
432340;201406;323;844;165;511;42;135;52;155;94;290
432345;201406;780;2243;722;2151;166;580;395;1101;561;1681
432350;201406;493;1383;325;1065;88;305;86;264;174;569
432360;201406;52;171;39;142;15;61;13;42;28;103
432370;201406;494;1411;400;1223;38;115;270;844;308;959
432375;201406;906;2339;724;2035;127;370;431;1227;558;1597
432377;201406;81;276;41;133;9;34;13;30;22;64
432380;201406;916;3223;839;3067;333;1360;329;1129;662;2489
500020;201406;2079;6452;1528;5349;422;1693;513;1660;935;3353
500025;201406;1053;2655;674;1989;126;382;325;948;451;1330
500060;201406;6472;19069;5263;17146;761;2483;3536;11997;4297;14480
500070;201406;4194;12466;3576;11395;862;3108;1707;5355;2569;8463
500080;201406;1810;5386;1362;4571;460;1676;433;1507;893;3183
500085;201406;2179;5886;1640;5059;212;740;1012;3016;1224;3756
500090;201406;2483;7316;1906;6262;407;1386;976;3305;1383;4691
500100;201406;2584;7891;2404;7601;784;2805;1119;3378;1903;6183
500110;201406;8313;24625;6866;22430;1131;4002;4034;13851;5165;17853
500124;201406;1940;6288;1672;5838;298;1001;1021;3845;1319;4846
500150;201406;1553;4023;1196;3455;290;956;577;1561;867;2517
500190;201406;5081;13516;4012;12193;921;2984;2252;7097;3173;10081
500200;201406;2675;6844;1985;5859;379;1276;1161;3335;1540;4611
500210;201406;5026;15088;4323;13987;1015;3462;2219;7345;3234;10807
500215;201406;1614;5073;1339;4534;284;1102;570;1825;854;2927
500220;201406;2840;8992;2330;8038;581;2156;901;3194;1482;5350
500230;201406;2716;7185;2110;6265;670;2130;845;2539;1515;4669
500240;201406;5059;15673;3771;13090;751;2821;1620;5939;2371;8760
500260;201406;2554;6959;2064;6157;400;1334;1036;2905;1436;4239
500270;201406;112456;296230;76193;234041;22069;73602;20394;62616;42463;136218
500280;201406;1405;4071;1201;3786;196;644;808;2613;1004;3257
500290;201406;4158;10581;2695;8147;801;2784;867;2387;1668;5171
500295;201406;2588;8018;1864;6234;460;1746;520;1554;980;3300
500310;201406;851;2305;741;2141;173;548;368;1019;541;1567
500315;201406;3086;9802;2665;9194;538;1825;1702;6165;2240;7990
500320;201406;14370;48043;12573;44787;4073;15231;4976;18830;9049;34061
500325;201406;4349;11574;3304;9890;881;2900;1571;4572;2452;7472
500330;201406;6059;16802;4758;14368;1362;4402;2086;6233;3448;10635
500345;201406;2493;7317;2102;6671;530;1865;1067;3292;1597;5157
500348;201406;2589;7508;2312;7046;252;869;1714;5209;1966;6078
500350;201406;1244;3818;804;2815;140;528;245;871;385;1399
500370;201406;24126;75679;19015;65688;4990;19124;6800;23624;11790;42748
500375;201406;2840;7778;2077;6371;517;1715;888;2788;1405;4503
500380;201406;3036;8800;2559;7925;899;2934;820;2487;1719;5421
500390;201406;608;1321;407;1038;50;160;289;696;339;856
500400;201406;1378;4354;1097;3671;304;1138;327;1009;631;2147
500410;201406;2175;6185;1767;5583;465;1609;845;2670;1310;4279
500430;201406;2782;8258;2248;7476;540;1931;1040;3604;1580;5535
500440;201406;1384;4036;1159;3675;272;954;607;1882;879;2836
500450;201406;2213;6932;1760;6018;467;1800;382;1176;849;2976
500460;201406;3769;11460;3018;10243;908;3354;1004;3416;1912;6770
500470;201406;2980;8915;2142;7057;620;2220;364;1083;984;3303
500480;201406;2051;6608;1900;6383;199;671;1506;5211;1705;5882
500490;201406;1108;3169;919;2842;289;991;325;1014;614;2005
500500;201406;3668;11434;2956;10345;1092;4301;972;3374;2064;7675
500510;201406;919;2463;606;1927;126;466;258;751;384;1217
500515;201406;1995;5337;1606;4816;268;760;1018;3293;1286;4053
500520;201406;2879;10092;2580;9674;543;2143;1596;6206;2139;8349
500525;201406;1251;3991;1039;3574;235;859;530;1913;765;2772
500540;201406;5500;16063;3503;12045;1106;4328;726;2306;1832;6634
500560;201406;4871;16157;4389;15445;863;3230;2962;10545;3825;13775
500568;201406;4008;10544;3000;9040;730;2303;1509;4610;2239;6913
500570;201406;7816;21824;5650;17974;1711;5832;2128;6810;3839;12642
500580;201406;3568;10498;2855;9240;434;1526;1857;6019;2291;7545
500600;201406;3181;8917;2390;7537;639;2219;980;3052;1619;5271
500620;201406;8103;22855;5979;19196;1320;4769;3045;9757;4365;14526
500625;201406;742;2220;492;1687;118;442;167;542;285;984
500627;201406;452;1305;342;1090;75;248;99;338;174;586
500630;201406;6271;17716;5027;15871;1688;5827;1655;5216;3343;11043
500635;201406;2514;9878;2155;9318;313;1265;1406;6638;1719;7903
500640;201406;1588;3980;1267;3519;146;468;915;2483;1061;2951
500660;201406;17101;51147;13916;45641;3702;13622;6092;19815;9794;33437
500690;201406;3061;8809;2509;8121;874;2876;1032;3611;1906;6487
500710;201406;3837;11664;3387;10926;843;2949;1755;5682;2598;8631
500720;201406;5997;16446;3960;12725;1169;4108;1165;3657;2334;7765
500730;201406;1015;2941;781;2480;177;621;322;990;499;1611
500740;201406;3752;10601;2756;8786;617;2238;1252;3795;1869;6033
500750;201406;862;2536;787;2438;180;584;479;1532;659;2116
500755;201406;1285;3800;959;3156;245;901;346;1048;591;1949
500769;201406;4857;13250;3219;9904;719;2436;980;2733;1699;5169
500770;201406;1783;5328;1390;4566;422;1481;492;1626;914;3107
500780;201406;1106;3472;967;3199;289;1054;429;1359;718;2413
500790;201406;8931;25451;7514;22959;1449;5167;4190;12257;5639;17424
500793;201406;2384;6955;1918;6178;345;1245;967;3011;1312;4256
500795;201406;2454;7342;2180;6941;301;814;1621;5515;1922;6329
500797;201406;955;2619;730;2249;160;535;332;1016;492;1551
500800;201406;2633;7520;2112;6767;747;2678;801;2606;1548;5284
500830;201406;16729;49192;12401;40347;3655;12811;3838;12199;7493;25010
500840;201406;1424;4126;1071;3433;214;743;499;1576;713;2319
510010;201406;1369;4205;1205;3933;393;1325;543;1821;936;3146
510020;201406;2987;8781;2135;7130;623;2198;627;2033;1250;4231
510025;201406;9364;28286;8089;26065;2395;8519;3502;11009;5897;19528
510030;201406;2161;5928;1812;5393;543;1693;820;2416;1363;4109
510035;201406;913;2705;759;2466;150;491;441;1503;591;1994
510040;201406;1746;4918;1389;4385;309;1088;719;2271;1028;3359
510050;201406;1872;5511;1386;4607;370;1353;536;1760;906;3113
510060;201406;1323;3928;1015;3330;268;955;362;1155;630;2110
510080;201406;1262;3927;1043;3534;326;1257;333;1035;659;2292
510100;201406;668;1818;453;1385;93;310;175;501;268;811
510120;201406;299;621;178;475;20;60;118;308;138;368
510125;201406;3150;8438;2490;7293;502;1786;1198;3306;1700;5092
510130;201406;2144;5980;1831;5479;535;1688;795;2413;1330;4101
510140;201406;2952;9702;2464;8930;963;3777;678;2358;1641;6135
510160;201406;1341;4510;1254;4402;97;397;1061;3713;1158;4110
510170;201406;6136;19036;5185;17286;1190;4399;2572;8345;3762;12744
510180;201406;11499;31608;8578;26851;2586;8524;3246;11041;5832;19565
510185;201406;1249;4084;1145;3928;202;662;808;2921;1010;3583
510190;201406;1887;6148;1415;5346;362;1484;588;2323;950;3807
510250;201406;13988;44350;12137;41740;3689;13466;5885;20838;9574;34304
510260;201406;2576;9873;2330;9340;723;3063;1016;4286;1739;7349
510263;201406;4273;12050;3249;10323;948;3299;1132;3438;2080;6737
510267;201406;5394;15727;3929;12547;935;3241;1361;4177;2296;7418
510268;201406;876;2571;749;2389;203;702;393;1251;596;1953
510269;201406;827;2657;752;2545;227;792;355;1239;582;2031
510270;201406;2560;8078;2305;7640;400;1407;1368;4663;1768;6070
510279;201406;2080;6683;1888;6351;653;2448;701;2192;1354;4640
510285;201406;1506;4615;1257;4160;364;1306;461;1445;825;2751
510300;201406;3243;9894;2834;9316;359;1281;2126;7049;2485;8330
510305;201406;1646;5268;1350;4703;409;1548;415;1430;824;2978
510310;201406;1109;3224;877;2843;309;1098;293;911;602;2009
510320;201406;3667;10907;2847;9255;845;3170;595;1713;1440;4883
510325;201406;5473;17682;4777;16682;608;2038;3687;13334;4295;15372
510330;201406;2779;9240;2402;8540;624;2437;986;3585;1610;6022
510335;201406;4517;14379;3976;13651;664;2237;2833;10151;3497;12388
510336;201406;586;1823;492;1638;123;446;240;787;363;1233
510337;201406;2296;7693;1988;7081;816;2916;604;2359;1420;5275
510340;201406;64459;189777;51434;169759;20360;73080;12036;41771;32396;114851
510343;201406;1154;3477;1057;3357;117;358;866;2823;983;3181
510345;201406;1684;5070;1425;4599;371;1318;531;1615;902;2933
510350;201406;3562;10301;2912;9401;786;2736;1441;4743;2227;7479
510360;201406;1918;5031;1371;4358;249;873;915;2844;1164;3717
510370;201406;955;3438;859;3284;237;935;476;1875;713;2810
510380;201406;490;1591;384;1377;154;606;69;231;223;837
510385;201406;965;3606;769;3114;152;657;356;1541;508;2198
510390;201406;1185;3679;1092;3574;274;783;675;2416;949;3199
510395;201406;883;2258;661;1967;117;376;378;1188;495;1564
510410;201406;4215;13964;3948;13463;1089;3932;2057;7103;3146;11035
510420;201406;2359;6198;1784;5230;264;920;965;2806;1229;3726
510450;201406;591;1652;447;1444;122;441;182;571;304;1012
510452;201406;634;2087;456;1661;116;474;167;576;283;1050
510454;201406;854;2722;748;2553;149;532;471;1667;620;2199
510455;201406;1024;3143;784;2668;194;771;279;899;473;1670
510460;201406;2118;6049;1825;5641;322;1149;1204;3624;1526;4773
510480;201406;4330;11872;3241;9784;887;2856;957;2772;1844;5628
510490;201406;1486;4913;1335;4689;302;1220;805;2753;1107;3973
510500;201406;1451;4443;1067;3694;283;1130;472;1571;755;2701
510510;201406;3097;11047;2753;10453;1023;4139;1060;4036;2083;8175
510515;201406;6007;18812;4821;16230;1247;4664;1419;4556;2666;9220
510517;201406;1833;5495;1600;5133;469;1464;872;2975;1341;4439
510520;201406;2266;5767;1709;4993;132;452;1234;3618;1366;4070
510523;201406;1092;3319;935;3052;203;704;548;1801;751;2505
510525;201406;8039;20932;5347;16668;1352;4548;2033;6301;3385;10849
510530;201406;570;1632;494;1517;83;295;283;871;366;1166
510550;201406;2758;9182;2385;8524;688;2538;1074;3949;1762;6487
510558;201406;2130;6216;1695;5565;487;1720;789;2570;1276;4290
510560;201406;1685;5531;1218;4680;414;1700;316;1240;730;2940
510562;201406;5334;16300;4615;14900;1554;5485;1606;5224;3160;10709
510590;201406;2891;8239;2318;7485;631;2153;1111;3702;1742;5855
510600;201406;1493;3888;1003;3087;187;653;448;1250;635;1903
510610;201406;2869;8472;2528;8007;238;858;2019;6396;2257;7254
510615;201406;2264;7295;1997;6858;635;2338;940;3236;1575;5574
510617;201406;578;1779;503;1662;68;229;377;1286;445;1515
510618;201406;1366;4046;994;3307;260;1006;441;1434;701;2440
510619;201406;790;2198;511;1671;101;374;141;447;242;821
510620;201406;1325;3495;825;2723;256;976;201;604;457;1580
510621;201406;1063;3750;942;3491;290;1175;311;1088;601;2263
510622;201406;3744;11553;2537;8830;704;2669;424;1273;1128;3942
510623;201406;3826;11059;3157;9912;976;3219;1347;4216;2323;7435
510624;201406;1319;4048;1002;3448;246;961;412;1316;658;2277
510625;201406;2322;6902;1888;6126;581;2104;514;1578;1095;3682
510626;201406;1339;4141;1055;3704;332;1273;522;1850;854;3123
510627;201406;722;2174;564;1879;184;674;177;596;361;1270
510628;201406;1587;4087;1212;3568;146;461;871;2570;1017;3031
510629;201406;1884;6203;1606;5592;542;2071;493;1618;1035;3689
510630;201406;2606;8782;2158;7955;669;2762;574;2124;1243;4886
510631;201406;407;1190;366;1126;67;202;246;762;313;964
510637;201406;2776;8341;2481;7826;708;2415;1238;3846;1946;6261
510642;201406;4882;16031;4185;15084;1270;4859;2048;7689;3318;12548
510645;201406;819;2014;618;1753;203;586;229;706;432;1292
510650;201406;6066;20697;5615;20143;1224;4562;3640;13656;4864;18218
510665;201406;1297;3582;890;2839;246;832;300;921;546;1753
510670;201406;368;883;213;658;41;150;90;266;131;416
510675;201406;6593;21568;5524;19497;1869;7238;1543;5294;3412;12532
510677;201406;2558;6544;1912;5695;288;866;1366;4243;1654;5109
510680;201406;851;2651;704;2378;164;604;298;953;462;1557
510682;201406;2457;7707;1965;6811;544;2074;667;2296;1211;4370
510685;201406;984;2670;839;2486;110;370;607;1775;717;2145
510700;201406;4151;11324;3046;9629;690;2332;1698;5454;2388;7786
510704;201406;8560;24145;7096;21657;1813;6152;3582;10654;5395;16806
510706;201406;1852;5762;1441;5099;415;1506;708;2538;1123;4044
510710;201406;3721;10569;2864;8846;845;2833;937;2614;1782;5447
510715;201406;694;1797;470;1431;118;395;182;517;300;912
510718;201406;1763;5297;1531;5000;576;1917;695;2333;1271;4250
510719;201406;463;1063;283;827;37;145;131;351;168;496
510720;201406;1303;3072;974;2686;98;271;762;2146;860;2417
510724;201406;840;2585;706;2328;165;606;369;1165;534;1771
510726;201406;670;1820;548;1611;153;456;203;574;356;1030
510729;201406;749;2001;569;1724;151;500;255;774;406;1274
510730;201406;2392;7529;2118;7022;532;1997;1066;3371;1598;5368
510735;201406;1076;3726;903;3427;263;1032;447;1734;710;2766
510740;201406;1081;2741;844;2393;197;544;488;1432;685;1976
510757;201406;710;2453;629;2297;177;672;313;1150;490;1822
510760;201406;29368;82769;23068;72025;7923;26447;7983;25046;15906;51493
510770;201406;4545;12201;4099;11683;643;1764;2655;8528;3298;10292
510774;201406;421;1191;355;1085;79;288;184;553;263;841
510775;201406;849;2419;676;2144;252;873;255;793;507;1666
510776;201406;450;1286;375;1155;94;330;180;526;274;856
510777;201406;1558;4655;1181;4155;223;897;796;2788;1019;3685
510779;201406;655;1963;493;1667;97;360;212;747;309;1107
510780;201406;4040;11947;3458;11116;793;2644;1894;6343;2687;8987
510785;201406;1971;5867;1597;5230;529;1824;607;2022;1136;3846
510787;201406;2255;6929;1947;6422;666;2378;753;2407;1419;4785
510788;201406;409;1212;337;1092;152;473;111;388;263;861
510790;201406;15696;46242;10782;36825;3254;12704;1499;4996;4753;17700
510792;201406;5925;19185;4320;15852;1133;4768;887;3042;2020;7810
510794;201406;1380;4297;1098;3851;492;1839;264;851;756;2690
510795;201406;9674;30975;7517;26624;2463;9425;2011;7214;4474;16639
510800;201406;1868;5400;1584;5030;490;1725;760;2301;1250;4026
510805;201406;1969;5561;1634;5084;216;709;1207;3790;1423;4499
510810;201406;711;1739;557;1530;153;441;287;773;440;1214
510820;201406;867;2120;636;1775;153;502;265;681;418;1183
510830;201406;592;2031;521;1911;161;629;264;1026;425;1655
510835;201406;720;2217;546;1878;179;672;196;614;375;1286
510840;201406;52274;132199;42237;119498;10329;30577;22821;66927;33150;97504
510850;201406;1716;5056;1358;4486;547;2028;254;693;801;2721
510860;201406;2520;8453;2034;7404;729;2926;352;1189;1081;4115
510880;201406;834;2837;734;2659;249;956;305;1129;554;2085
510885;201406;582;1672;450;1479;83;310;212;697;295;1007
510890;201406;920;3087;785;2839;274;1124;213;681;487;1805
510895;201406;1195;3823;1040;3524;303;1164;432;1372;735;2536
520005;201406;1283;4208;1194;4073;370;1320;601;2079;971;3399
520010;201406;1900;6611;1681;6150;713;2885;371;1234;1084;4119
520013;201406;4028;11288;3065;9573;769;2524;1388;4383;2157;6907
520015;201406;573;1599;464;1435;116;378;197;626;313;1004
520017;201406;1268;3948;1098;3666;316;1131;454;1475;770;2606
520020;201406;427;1152;332;1000;91;281;172;547;263;828
520025;201406;24096;77855;23375;76999;2918;10057;19016;63010;21934;73067
520030;201406;4777;15443;4199;14503;1266;4676;1831;6434;3097;11110
520050;201406;345;1047;316;985;62;215;212;642;274;857
520055;201406;671;2062;577;1901;139;455;310;1057;449;1512
520060;201406;1672;5243;1473;4849;363;1305;608;2055;971;3360
520080;201406;1682;5192;1466;4870;375;1239;787;2738;1162;3977
520082;201406;679;2203;632;2123;140;449;393;1361;533;1810
520085;201406;1041;3276;912;2987;228;783;333;1089;561;1872
520090;201406;1019;2428;777;2106;165;395;425;1235;590;1630
520110;201406;41921;126091;33031;112664;13141;49343;8882;30855;22023;80198
520120;201406;264;700;156;507;40;148;38;128;78;276
520130;201406;3837;11289;3545;10846;710;2308;2257;6921;2967;9229
520140;201406;44043;147018;39414;137923;14471;54629;11200;38933;25671;93562
520145;201406;544;1409;402;1203;94;302;169;498;263;800
520150;201406;673;1815;556;1680;154;504;290;869;444;1373
520160;201406;906;2673;768;2462;260;885;292;943;552;1828
520170;201406;4256;10222;3421;9319;519;1472;2539;7100;3058;8572
520180;201406;1925;5807;1610;5286;424;1592;674;2134;1098;3726
520215;201406;1874;4883;1605;4504;260;757;1017;2899;1277;3656
520235;201406;836;2274;653;2012;199;664;282;853;481;1517
520250;201406;1128;3749;1020;3586;318;1186;508;1816;826;3002
520260;201406;790;2079;562;1656;91;310;275;774;366;1084
520280;201406;582;1703;534;1632;264;863;136;454;400;1317
520310;201406;1107;2768;865;2438;205;543;458;1431;663;1974
520320;201406;1693;5426;1396;4834;184;683;874;3103;1058;3786
520330;201406;2882;9057;2232;7895;715;2762;475;1586;1190;4348
520340;201406;1978;5019;1562;4526;203;512;1201;3646;1404;4158
520350;201406;3213;9570;2740;8668;892;3066;1237;3797;2129;6863
520355;201406;1166;4096;1118;4005;395;1503;496;1767;891;3270
520357;201406;903;2475;765;2268;80;263;537;1577;617;1840
520360;201406;622;1756;550;1634;131;398;267;816;398;1214
520380;201406;1239;3425;884;2760;187;643;411;1281;598;1924
520390;201406;1216;3244;858;2752;281;1043;333;976;614;2019
520393;201406;581;1540;517;1438;88;254;342;956;430;1210
520396;201406;739;2401;659;2239;99;371;451;1555;550;1926
520400;201406;1723;4933;1468;4587;269;906;932;2924;1201;3830
520410;201406;1570;4228;1247;3788;344;1126;636;1933;980;3059
520420;201406;347;967;255;792;57;193;98;277;155;470
520425;201406;1482;4137;1354;3920;415;1283;675;1920;1090;3203
520430;201406;2134;5690;1490;4498;322;1069;634;1861;956;2930
520440;201406;3588;9562;2628;7973;936;3111;755;2275;1691;5386
520450;201406;9966;28857;7541;24247;2160;7641;1388;4131;3548;11772
520455;201406;705;2132;579;1921;217;774;178;598;395;1372
520460;201406;898;2608;728;2316;184;655;321;988;505;1643
520465;201406;857;2342;745;2198;176;619;375;1043;551;1662
520470;201406;1746;5736;1591;5501;324;1115;1066;3847;1390;4962
520480;201406;1026;2998;846;2711;191;645;488;1572;679;2217
520485;201406;1219;4152;1131;3990;393;1457;562;2013;955;3470
520490;201406;4442;13808;3554;12437;1291;4828;1394;4958;2685;9786
520495;201406;1419;3855;1163;3543;92;279;991;3068;1083;3347
520500;201406;2077;5573;1853;5268;598;1788;833;2537;1431;4325
520505;201406;900;2573;780;2394;190;604;470;1477;660;2081
520510;201406;11439;32405;7804;26267;2517;9217;2045;6981;4562;16198
520520;201406;1078;3128;905;2889;328;1107;373;1208;701;2315
520530;201406;2396;7471;2053;6908;498;1641;1019;3788;1517;5429
520540;201406;3030;9280;2621;8574;816;2809;1096;3614;1912;6423
520545;201406;1339;4160;1147;3777;351;1238;367;1169;718;2407
520547;201406;832;2639;691;2394;271;1010;207;669;478;1679
520549;201406;9134;27844;7839;26209;2516;8802;3748;12760;6264;21562
520551;201406;3843;11699;3676;11499;1047;3432;2155;6939;3202;10371
520552;201406;725;2384;701;2350;125;462;478;1593;603;2055
520570;201406;590;1715;447;1487;199;707;117;388;316;1095
520580;201406;2074;6029;1720;5506;626;2191;628;1953;1254;4144
520590;201406;1555;4391;1276;3929;340;1097;460;1365;800;2462
520620;201406;7356;23856;6728;22922;1473;5403;4172;14336;5645;19739
520630;201406;672;1915;575;1789;139;437;322;1008;461;1445
520640;201406;2828;8263;2457;7671;786;2560;1067;3472;1853;6032
520650;201406;854;2432;725;2193;259;823;304;930;563;1753
520660;201406;405;1235;344;1137;114;398;112;365;226;763
520670;201406;823;2538;784;2476;65;174;683;2203;748;2377
520680;201406;634;1877;543;1750;177;616;227;730;404;1346
520690;201406;322;854;235;737;31;97;123;407;154;504
520710;201406;503;1288;329;952;11;36;202;575;213;611
520725;201406;1838;4815;1439;4234;341;1091;798;2343;1139;3434
520735;201406;705;2113;565;1855;189;663;182;580;371;1243
520740;201406;1730;5055;1457;4675;389;1325;716;2279;1105;3604
520750;201406;771;2043;580;1778;148;486;318;1007;466;1493
520753;201406;1296;3734;1218;3615;168;448;903;2834;1071;3282
520760;201406;1180;3288;1024;3085;289;926;595;1800;884;2726
520780;201406;2096;5199;1754;4737;232;564;1327;3692;1559;4256
520790;201406;2604;7326;2288;6886;337;1041;1645;5067;1982;6108
520800;201406;17785;52586;15846;50277;3657;11293;9697;33205;13354;44498
520810;201406;967;2653;863;2524;143;420;642;1950;785;2370
520815;201406;493;1664;382;1430;187;798;30;94;217;892
520830;201406;1706;4362;1338;3977;56;132;1219;3708;1275;3840
520840;201406;1695;5765;1541;5462;528;1953;576;2112;1104;4065
520850;201406;807;2379;633;2124;189;673;276;913;465;1586
520860;201406;7133;20420;5338;17971;1466;5355;2524;8724;3990;14079
520870;201406;109055;299690;74090;237333;21608;75845;20072;62251;41680;138096
520880;201406;6872;19586;4876;16404;1443;5506;747;2371;2190;7877
520890;201406;3936;11487;3400;10589;763;2514;1785;5575;2548;8089
520910;201406;3488;10709;2715;9115;850;3094;667;2178;1517;5272
520915;201406;932;2697;705;2256;169;584;290;898;459;1482
520920;201406;3440;9173;2380;7470;633;2126;709;2301;1342;4427
520929;201406;464;1350;409;1281;118;377;218;687;336;1064
520940;201406;1003;3039;892;2863;112;403;654;2067;766;2470
520945;201406;675;1687;579;1540;195;493;263;715;458;1208
520960;201406;910;2669;747;2413;132;438;434;1432;566;1870
520970;201406;3443;10217;2831;9104;703;2487;1107;3495;1810;5982
520980;201406;1009;2781;930;2676;261;831;560;1578;821;2409
520990;201406;3692;11569;3377;10994;735;2539;1802;6412;2537;8951
520993;201406;1213;3331;983;2946;131;434;634;1892;765;2326
520995;201406;2655;7320;2385;6961;365;1071;1737;5127;2102;6198
521000;201406;7957;24138;6815;22209;1709;6131;3251;10520;4960;16651
521010;201406;3997;12460;3412;11347;931;3300;1398;4717;2329;8017
521015;201406;702;1978;591;1801;132;403;333;1041;465;1444
521020;201406;3813;11145;2831;9050;908;3152;570;1600;1478;4752
521030;201406;810;2175;701;2020;147;441;445;1300;592;1741
521040;201406;5555;16424;5082;15689;1759;5450;2614;8471;4373;13921
521056;201406;989;3063;842;2817;290;1019;356;1235;646;2254
521060;201406;1131;3194;994;2984;268;750;429;1340;697;2090
521080;201406;1233;3083;806;2366;173;586;286;699;459;1285
521090;201406;3285;9619;2788;8945;974;3309;1085;3581;2059;6890
521100;201406;1434;3752;1313;3616;246;653;923;2638;1169;3291
521120;201406;4818;13978;4394;13313;1174;3587;2412;7508;3586;11095
521130;201406;1135;3218;910;2796;194;686;483;1473;677;2159
521140;201406;951;3168;855;2960;289;1067;233;791;522;1858
521150;201406;13018;34195;8477;25327;2886;9389;2589;7620;5475;17009
521160;201406;779;2002;521;1478;95;296;278;746;373;1042
521170;201406;1378;3344;1147;3031;308;758;663;1796;971;2554
521180;201406;6587;22192;5980;21033;2200;8214;1839;6489;4039;14703
521190;201406;9091;27097;6719;22884;2251;8140;2159;7371;4410;15511
521200;201406;860;2270;788;2167;117;345;547;1501;664;1846
521205;201406;574;1738;463;1533;66;239;265;889;331;1128
521210;201406;911;2634;655;2124;254;926;231;671;485;1597
521220;201406;3877;11011;3237;10128;1054;3526;1336;4160;2390;7686
521225;201406;393;1012;314;912;48;146;211;630;259;776
521230;201406;1370;4344;1263;4118;456;1570;593;1886;1049;3456
521250;201406;26494;88435;24995;86145;9679;35269;10435;36744;20114;72013
521260;201406;827;2039;661;1749;114;380;384;950;498;1330
521270;201406;1841;5782;1688;5535;173;463;1309;4512;1482;4975
521280;201406;1860;5775;1574;5248;502;1787;604;2017;1106;3804
521290;201406;543;1575;399;1335;125;490;144;454;269;944
521295;201406;1150;3172;1046;3033;146;424;837;2454;983;2878
521300;201406;1849;5442;1710;5223;391;1161;1057;3364;1448;4525
521305;201406;864;2321;724;2125;153;428;449;1380;602;1808
521308;201406;5198;15442;4089;13491;877;3160;2127;6954;3004;10114
521310;201406;7566;23262;6060;20346;2049;7254;1593;5189;3642;12443
521340;201406;267;815;239;772;47;170;139;436;186;606
521350;201406;2201;5706;1815;5187;246;721;1212;3686;1458;4407
521370;201406;1027;3316;931;3137;327;1184;318;1014;645;2198
521375;201406;1406;4125;1214;3789;312;1062;619;1886;931;2948
521377;201406;1062;3014;1016;2959;94;234;879;2623;973;2857
521380;201406;4789;13604;3531;11306;817;2827;729;2418;1546;5245
521385;201406;618;1733;547;1636;166;522;266;791;432;1313
521390;201406;1123;2953;829;2540;250;861;291;867;541;1728
521400;201406;2376;6490;2043;6103;335;1097;1513;4495;1848;5592
521405;201406;1391;4050;1146;3594;402;1374;472;1470;874;2844
521410;201406;780;2493;714;2380;279;918;305;1058;584;1976
521440;201406;1495;4153;1478;4134;121;302;1296;3721;1417;4023
521450;201406;5094;15553;4263;14026;1362;4759;1242;4018;2604;8777
521460;201406;7224;22463;6649;21567;1773;6201;3500;11293;5273;17494
521470;201406;745;2112;559;1752;159;563;104;311;263;874
521480;201406;518;1515;382;1267;118;396;122;403;240;799
521483;201406;3133;8385;2561;7387;763;2316;1041;2935;1804;5251
521486;201406;1694;4701;1521;4398;303;959;1037;2944;1340;3903
521487;201406;637;1672;459;1388;84;240;228;733;312;973
521490;201406;845;2436;674;2191;90;345;480;1566;570;1911
521500;201406;1350;4343;1145;3915;222;864;563;1790;785;2654
521520;201406;953;2242;823;2070;273;605;374;1052;647;1657
521523;201406;11529;43223;10811;41944;3654;15325;2540;10600;6194;25925
521525;201406;1126;2936;990;2756;151;473;680;1842;831;2315
521530;201406;2078;6227;1419;4876;537;1949;288;937;825;2886
521540;201406;988;2702;678;2150;185;693;204;597;389;1290
521550;201406;993;2547;885;2389;244;717;480;1254;724;1971
521560;201406;4988;15380;4026;14098;1622;6136;1256;4365;2878;10501
521565;201406;710;1849;606;1718;105;278;420;1231;525;1509
521570;201406;4733;13349;3395;10672;1083;3555;1131;3603;2214;7158
521580;201406;678;1660;496;1408;173;541;164;460;337;1001
521590;201406;757;2137;618;1904;227;722;128;419;355;1141
521600;201406;629;1644;451;1340;115;366;159;422;274;788
521630;201406;1805;4892;1505;4425;551;1852;277;664;828;2516
521640;201406;2002;5566;1666;5064;556;1896;588;1823;1144;3719
521645;201406;662;1997;550;1738;106;364;276;824;382;1188
521680;201406;1480;4741;1257;4264;676;2413;218;708;894;3121
521690;201406;598;1776;536;1659;130;471;263;755;393;1226
521710;201406;2339;7346;2045;6750;440;1541;1103;3640;1543;5181
521720;201406;2081;6189;1907;5945;546;1686;1132;3624;1678;5310
521730;201406;3944;13234;3625;12587;1570;5947;1030;3343;2600;9290
521740;201406;3720;10177;2948;9192;1275;4126;1140;3754;2415;7880
521760;201406;12440;42612;11604;41249;2168;8561;7487;26827;9655;35388
521770;201406;2800;8548;2385;7715;1029;3539;659;2026;1688;5565
521800;201406;8887;26229;7557;24183;2570;8704;3279;10849;5849;19553
521805;201406;997;2304;780;1979;216;489;428;1208;644;1697
521810;201406;820;2393;711;2218;177;615;371;1119;548;1734
521830;201406;5477;18558;5145;18050;1082;4090;3357;11772;4439;15862
521839;201406;724;2081;566;1776;132;473;210;620;342;1093
521850;201406;7059;19998;5973;18080;1442;4394;2916;8864;4358;13258
521860;201406;1798;5427;1552;4959;422;1468;573;1775;995;3243
521870;201406;562;1974;515;1849;170;666;144;486;314;1152
521878;201406;633;2037;503;1736;148;573;200;651;348;1224
521880;201406;26291;69717;17969;55979;6042;19982;5615;17854;11657;37836
521890;201406;3762;11658;3119;10399;1185;4253;818;2689;2003;6942
521900;201406;1674;4505;1369;4087;359;1146;562;1593;921;2739
521910;201406;1234;3436;1078;3255;269;855;617;1931;886;2786
521920;201406;404;1218;361;1150;124;420;156;478;280;898
521925;201406;650;2011;579;1868;123;439;248;742;371;1181
521930;201406;4001;12981;3612;12233;1265;4544;1092;3706;2357;8250
521935;201406;658;1989;624;1924;177;569;346;1049;523;1618
521940;201406;1140;3106;928;2748;316;971;348;1037;664;2008
521945;201406;689;2363;642;2300;131;424;449;1728;580;2152
521950;201406;559;1692;470;1542;127;450;205;683;332;1133
521960;201406;943;2767;800;2524;196;665;376;1158;572;1823
521970;201406;2509;7207;2284;6918;342;1017;1670;5214;2012;6231
521971;201406;1041;2833;796;2376;177;573;303;873;480;1446
521973;201406;892;2948;792;2741;241;887;252;843;493;1730
521975;201406;13946;39648;13140;38632;2441;7622;8856;26241;11297;33863
521980;201406;1828;5692;1735;5587;264;776;1363;4577;1627;5353
521990;201406;1121;3409;990;3205;163;583;639;2055;802;2638
522000;201406;2158;6353;1890;6005;397;1322;1133;3734;1530;5056
522005;201406;382;995;291;850;78;232;142;417;220;649
522010;201406;3101;9209;2613;8398;959;3249;701;2217;1660;5466
522015;201406;1029;3027;860;2772;224;769;427;1406;651;2175
522020;201406;4947;13492;4277;12599;933;2968;2678;7832;3611;10800
522026;201406;651;1872;466;1678;191;740;162;602;353;1342
522028;201406;540;1617;488;1537;114;376;306;956;420;1332
522040;201406;3154;8141;2375;7152;775;2417;1093;3366;1868;5783
522045;201406;13586;44657;11522;40413;3835;14800;2710;9235;6545;24035
522050;201406;1070;3107;863;2760;278;980;349;1039;627;2019
522060;201406;3063;9591;2545;8773;736;2735;1290;4396;2026;7131
522068;201406;1593;5164;1490;5049;129;345;1245;4457;1374;4802
522070;201406;850;2562;761;2423;104;402;516;1635;620;2037
522100;201406;806;2261;720;2131;264;873;334;922;598;1795
522108;201406;949;2824;837;2658;87;288;622;2025;709;2313
522119;201406;1331;4068;1106;3762;174;600;720;2531;894;3131
522130;201406;511;1462;441;1383;132;425;235;757;367;1182
522140;201406;18035;51478;15776;48038;4952;16167;6620;19808;11572;35975
522145;201406;950;2678;883;2570;424;1304;286;819;710;2123
522150;201406;1266;3341;1051;3045;399;1224;377;1132;776;2356
522155;201406;797;2341;711;2213;160;499;443;1431;603;1930
522157;201406;706;2064;611;1913;72;245;475;1492;547;1737
522160;201406;6164;17564;4431;14546;1697;6170;719;2224;2416;8394
522170;201406;3185;8899;2649;8098;799;2452;1097;3503;1896;5955
522180;201406;463;1327;344;1143;142;516;119;400;261;916
522185;201406;15123;46873;13713;44959;2969;10404;8219;27339;11188;37743
522190;201406;969;2539;796;2251;136;381;461;1333;597;1714
522200;201406;1580;5371;1465;5125;522;1961;475;1599;997;3560
522205;201406;1330;3890;1108;3515;299;1004;531;1696;830;2700
522220;201406;1408;3890;1136;3550;276;899;577;1979;853;2878
522230;201406;1191;3585;1070;3388;161;571;728;2304;889;2875
530010;201406;257248;837559;231589;786986;72401;268467;83639;283902;156040;552369
110001;201405;4559;14960;3961;13991;1040;3779;2259;8131;3299;11910
110002;201405;13497;43279;11783;40281;3687;13527;5298;18230;8985;31757
110003;201405;984;3212;906;3067;257;899;343;1144;600;2043
110004;201405;9867;32292;8383;29186;2767;10383;2623;9166;5390;19549
110005;201405;2385;8021;2259;7769;857;3035;945;3297;1802;6332
110006;201405;3427;9230;2161;7463;728;2671;682;2232;1410;4903
110007;201405;1529;4846;1419;4687;291;1004;842;2976;1133;3980
110008;201405;2588;8872;2429;8639;468;1569;1767;6570;2235;8139
110009;201405;5417;15716;4220;13943;1114;3987;1973;6412;3087;10399
110010;201405;8508;24570;7502;23330;1517;4347;4841;16251;6358;20598
110011;201405;11002;33887;9112;30622;3312;11654;3544;11985;6856;23639
110012;201405;17228;53307;14931;48908;5002;17172;5815;19069;10817;36241
110013;201405;5410;17135;4457;15706;1373;4999;2088;7535;3461;12534
110014;201405;4444;13205;3756;12215;828;2801;2282;7556;3110;10357
110015;201405;5447;17294;4357;15327;1535;5846;1534;5402;3069;11248
110018;201405;5278;15524;4297;14243;1362;5028;1977;6341;3339;11369
110020;201405;58286;170230;48432;157876;10555;35462;29383;98733;39938;134195
110025;201405;4593;13405;3850;12097;639;2131;2706;8485;3345;10616
110026;201405;847;2456;716;2299;169;536;475;1576;644;2112
110028;201405;7859;23167;5897;19852;1844;6798;1567;5196;3411;11994
110029;201405;1717;5046;1377;4462;439;1468;618;2050;1057;3518
110030;201405;11577;33571;9560;30997;2446;8420;5336;17949;7782;26369
110032;201405;4276;13902;3818;12900;1146;3997;1623;5520;2769;9517
110033;201405;5596;18073;5211;17471;1627;5383;2628;9392;4255;14775
110034;201405;3940;10324;3299;9545;533;1465;2501;7369;3034;8834
110037;201405;2128;7204;1842;6667;473;1736;1033;3795;1506;5531
110040;201405;3578;11675;3313;11200;1001;3630;1619;5437;2620;9067
110045;201405;5320;18178;4872;17645;1397;5356;2868;10409;4265;15765
110050;201405;1838;5883;1532;5475;482;1741;862;3164;1344;4905
110060;201405;1012;3499;901;3296;262;1029;467;1710;729;2739
110070;201405;2021;6917;1960;6779;324;1142;1413;4951;1737;6093
110080;201405;3604;11497;3439;11300;438;1318;2850;9601;3288;10919
110090;201405;964;2828;766;2513;235;890;337;1003;572;1893
110092;201405;1752;5681;1599;5483;348;1192;979;3528;1327;4720
110094;201405;3343;10451;3062;10050;734;2482;1918;6435;2652;8917
110100;201405;2696;8568;2328;7950;700;2499;1205;4143;1905;6642
110110;201405;1821;5867;1698;5719;702;2392;788;2756;1490;5148
110120;201405;1706;5677;1393;4941;429;1580;472;1695;901;3275
110130;201405;2812;8074;2134;7075;559;1927;1077;3607;1636;5534
110140;201405;2599;8919;2409;8595;515;1881;1561;5676;2076;7557
110143;201405;1581;5086;1235;4480;309;1170;662;2396;971;3566
110145;201405;1014;3081;892;2891;159;549;595;1942;754;2491
110146;201405;477;1518;436;1455;98;339;255;866;353;1205
110147;201405;910;2713;719;2400;197;719;276;841;473;1560
110148;201405;1392;4162;1082;3528;349;1219;379;1203;728;2422
110149;201405;3828;11191;3000;9935;750;2538;1819;6177;2569;8715
110150;201405;2919;8589;2410;7844;296;1050;1669;5505;1965;6555
110155;201405;953;3158;897;3027;281;998;466;1553;747;2551
110160;201405;2233;7029;1833;6311;558;1973;919;3189;1477;5162
110170;201405;3224;9313;2497;8061;529;1786;1531;4979;2060;6765
110175;201405;1729;5491;1340;4991;160;640;959;3641;1119;4281
110180;201405;1707;5319;1454;4910;318;1123;911;3104;1229;4227
120001;201405;2929;10394;2830;10225;648;2479;1732;6369;2380;8848
120005;201405;1593;6338;1551;6259;166;617;1234;5176;1400;5793
120010;201405;4561;16183;4372;15856;877;3068;2989;11251;3866;14319
120013;201405;1903;7435;1852;7349;401;1574;1217;5065;1618;6639
120017;201405;2152;7688;2034;7468;556;2041;1018;4090;1574;6131
120020;201405;14422;63376;14172;62818;2298;9629;10484;48566;12782;58195
120025;201405;2790;9700;2712;9578;604;2237;1706;6103;2310;8340
120030;201405;6168;24584;6091;24482;474;1777;5278;21649;5752;23426
120032;201405;1410;6764;1358;6634;193;1089;992;4883;1185;5972
120033;201405;3678;14051;3651;14001;199;775;3286;12768;3485;13543
120034;201405;1847;7484;1817;7438;94;438;1656;6779;1750;7217
120035;201405;2817;13508;2784;13430;251;1163;2342;11643;2593;12806
120038;201405;3220;11819;3099;11564;819;3114;1773;6815;2592;9929
120039;201405;1491;8018;1463;7950;175;961;1180;6539;1355;7500
120040;201405;46275;167096;42529;159436;12248;48178;21197;81514;33445;129692
120042;201405;2837;12376;2707;12063;379;1775;1982;9017;2361;10792
120043;201405;860;4118;834;4063;59;256;715;3592;774;3848
120045;201405;4487;15625;4435;15542;932;3230;3211;11524;4143;14754
120050;201405;8242;33961;7930;33277;1339;5344;5467;24243;6806;29587
120060;201405;7190;32980;7072;32757;697;3194;5876;27959;6573;31153
120070;201405;2846;10740;2786;10592;547;1964;1875;7434;2422;9398
120080;201405;3779;14271;3618;14004;580;2197;2689;10784;3269;12981
130002;201405;2861;12142;2700;11870;268;1205;2171;9726;2439;10931
130006;201405;1731;7494;1556;7166;234;1170;1094;5130;1328;6300
130008;201405;2037;8305;1949;8146;177;759;1580;6747;1757;7506
130010;201405;2722;9169;2371;8759;218;744;2006;7592;2224;8336
130014;201405;3485;11267;3013;10560;483;1798;2007;7156;2490;8954
130020;201405;2509;8918;2498;8905;36;132;2448;8743;2484;8875
130030;201405;7027;27595;6809;27301;551;1896;5884;24291;6435;26187
130040;201405;3571;11225;3309;10867;270;1021;2848;9336;3118;10357
130050;201405;5931;23792;5264;22747;731;2988;3781;17460;4512;20448
130060;201405;5912;26129;5573;25642;600;2728;4541;21392;5141;24120
130063;201405;3304;14763;3278;14713;306;1269;2801;12913;3107;14182
130068;201405;3009;12777;2786;12343;355;1716;1986;8911;2341;10627
130070;201405;6659;22252;6063;21484;640;2240;4823;17558;5463;19798
130080;201405;5092;22664;4910;22402;834;3876;3497;16533;4331;20409
130083;201405;2044;8170;1936;8004;310;1441;1382;5728;1692;7169
130090;201405;2506;9105;2390;8947;189;791;2047;7693;2236;8484
130100;201405;5418;20743;5216;20471;406;1728;4473;17725;4879;19453
130110;201405;6741;21794;6300;21267;644;2010;5211;18148;5855;20158
130115;201405;3908;14294;3745;14078;108;346;3553;13472;3661;13818
130120;201405;13523;52032;13167;51517;1154;4064;11206;45259;12360;49323
130130;201405;3532;14954;3430;14768;399;1739;2749;12070;3148;13809
130140;201405;6007;23789;5965;23735;158;431;5760;23205;5918;23636
130150;201405;3504;13183;3430;13085;227;996;3032;11572;3259;12568
130160;201405;3893;16206;3819;16105;237;908;3476;14858;3713;15766
130165;201405;2776;11503;2712;11389;394;1708;2136;9085;2530;10793
130170;201405;8905;32713;7835;31352;1247;5024;5691;23676;6938;28700
130180;201405;3380;10861;3302;10754;102;325;3065;10029;3167;10354
130185;201405;9605;33170;9062;32526;1218;4031;7176;26865;8394;30896
130190;201405;17404;60697;15371;58120;3021;11076;10167;40614;13188;51690
130195;201405;1818;7627;1761;7539;113;471;1550;6752;1663;7223
130200;201405;1965;7166;1827;6932;398;1565;1168;4528;1566;6093
130210;201405;1161;4623;1106;4520;144;562;862;3633;1006;4195
130220;201405;2030;8361;1871;8071;355;1694;1129;4949;1484;6643
130230;201405;3350;15325;3171;15023;371;1760;2401;11889;2772;13649
130240;201405;8371;32276;7733;31335;504;2268;6606;27205;7110;29473
130250;201405;17631;64408;17019;63546;2409;8423;13108;51013;15517;59436
130255;201405;3995;14336;3792;13998;154;469;3436;12991;3590;13460
130260;201405;254540;829296;230533;790983;63928;224919;122468;433735;186396;658654
130270;201405;7300;30429;6589;29299;1017;4516;4802;22260;5819;26776
130280;201405;3238;12703;3168;12602;164;507;2861;11703;3025;12210
130290;201405;10635;37787;10471;37552;231;583;9945;36264;10176;36847
130300;201405;4461;17255;4185;16841;396;1743;3391;13796;3787;15539
130310;201405;5005;18886;4584;18361;502;1945;3667;15123;4169;17068
130320;201405;2910;10102;2663;9772;358;1335;1940;7309;2298;8644
130330;201405;3608;13248;3235;12741;228;988;2739;10949;2967;11937
130340;201405;17502;67825;16920;66909;3315;12238;11406;48184;14721;60422
130350;201405;3264;13268;3134;13114;311;1322;2578;11041;2889;12363
130353;201405;5951;18452;5196;17431;1274;4209;3131;11212;4405;15421
130356;201405;4506;16229;4337;15978;467;1424;3579;13855;4046;15279
130360;201405;2940;8096;2621;7733;49;85;2476;7497;2525;7582
130370;201405;4997;19710;4299;18776;264;1362;3630;16026;3894;17388
130380;201405;6768;28762;6538;28404;480;2219;5589;24573;6069;26792
130390;201405;4672;20999;4385;20498;496;2369;3378;16283;3874;18652
130395;201405;2042;7438;1863;7100;292;1168;1220;4694;1512;5862
130400;201405;2131;7870;2058;7765;171;686;1783;6794;1954;7480
130406;201405;9771;37268;8741;35691;1931;7770;5435;23367;7366;31137
130410;201405;4100;15718;3782;15133;909;3784;2193;9095;3102;12879
130420;201405;9957;42583;9639;41962;2722;11623;5697;26086;8419;37709
130423;201405;3120;12322;2952;12090;264;1233;2479;10219;2743;11452
130426;201405;2068;8895;1992;8761;348;1493;1410;6492;1758;7985
130430;201405;3487;12559;3305;12306;445;1745;2405;9177;2850;10922
130440;201405;4019;14059;3730;13743;190;566;3389;12845;3579;13411
140002;201405;1537;4963;1439;4826;166;554;1068;3679;1234;4233
140005;201405;2580;7961;2421;7789;128;362;2211;7225;2339;7587
140010;201405;44585;145146;40341;138181;9455;34307;22809;79948;32264;114255
140015;201405;2848;9358;2731;9202;316;821;2215;7850;2531;8671
140017;201405;2986;9391;2818;9179;223;622;2393;8022;2616;8644
140020;201405;4424;15122;4135;14737;415;1336;3355;12379;3770;13715
140023;201405;2040;7070;1853;6768;259;976;1325;4949;1584;5925
140028;201405;2177;6058;2120;5991;82;147;1966;5705;2048;5852
140030;201405;3572;11485;3426;11299;384;967;2906;9996;3290;10963
140040;201405;1486;7163;1437;7022;143;761;1075;5378;1218;6139
140045;201405;2444;8895;2285;8665;399;1314;1609;6596;2008;7910
140047;201405;5418;15245;4958;14629;1538;4639;2407;7550;3945;12189
140050;201405;1523;4699;1405;4537;186;623;1020;3354;1206;3977
140060;201405;1443;4567;1310;4370;277;945;852;2923;1129;3868
140070;201405;1433;7090;1430;7083;46;208;1360;6789;1406;6997
150010;201405;33418;107311;31909;105296;2264;7718;27138;90861;29402;98579
150013;201405;1615;4977;1536;4884;143;464;1266;4056;1409;4520
150020;201405;11727;40070;11436;39655;1228;4161;9505;33572;10733;37733
150030;201405;6266;27539;6108;27276;573;2207;5159;23931;5732;26138
150034;201405;4462;12196;4220;11901;197;464;3887;11125;4084;11589
150040;201405;12515;42875;11012;41011;2278;7786;7424;29780;9702;37566
150050;201405;6031;23207;5889;22948;614;2524;4783;18867;5397;21391
150060;201405;15984;52854;15123;51550;3324;10955;9940;35213;13264;46168
150070;201405;5657;23592;5110;22973;442;2104;4372;19904;4814;22008
150080;201405;61285;168399;54357;159581;7416;20160;39880;121071;47296;141231
150085;201405;5064;18024;4835;17689;565;1775;3942;15029;4507;16804
150090;201405;9980;38881;9437;38130;1033;4089;7601;31441;8634;35530
150095;201405;5172;17899;4798;17327;454;1575;3891;14458;4345;16033
150100;201405;3543;13254;3322;12912;276;1272;2701;10458;2977;11730
150110;201405;3196;15378;3185;15350;179;774;2927;14303;3106;15077
150120;201405;5966;23476;5840;23238;848;3262;4520;18351;5368;21613
150125;201405;808;2516;749;2427;153;531;489;1575;642;2106
150130;201405;20678;65330;19573;63732;1770;5707;15882;52686;17652;58393
150140;201405;151291;452310;145963;445692;16763;50249;120109;372287;136872;422536
150145;201405;4870;15425;4522;14988;639;2208;3414;11479;4053;13687
150150;201405;9857;32477;9279;31556;1837;6438;6202;21412;8039;27850
150157;201405;2924;9215;2647;8823;377;1320;2040;6846;2417;8166
150160;201405;2904;9741;2748;9512;641;2162;1735;6270;2376;8432
150170;201405;21905;81643;20781;80112;3957;15143;14813;58102;18770;73245
150172;201405;3064;10712;2770;10270;342;1291;2184;8262;2526;9553
150175;201405;2042;6366;1974;6287;156;413;1737;5698;1893;6111
150178;201405;10813;33715;9291;31904;637;1975;8118;28562;8755;30537
150180;201405;17816;72418;17273;71652;1554;6815;14446;60758;16000;67573
150190;201405;7194;23191;6763;22586;440;1011;5827;20321;6267;21332
150195;201405;4728;16590;4420;16062;408;1499;3632;13386;4040;14885
150200;201405;5101;16617;4943;16423;143;446;4617;15527;4760;15973
150210;201405;22493;86818;22101;86236;2030;7420;18768;74998;20798;82418
150215;201405;6068;19747;5521;18927;1414;5025;3048;10699;4462;15724
150220;201405;12640;40591;11533;38870;2626;9029;6652;23035;9278;32064
150230;201405;11054;38008;10019;36541;860;3728;8105;29481;8965;33209
150240;201405;34084;104675;30924;99365;9498;31437;13775;45915;23273;77352
150250;201405;4030;16352;3903;16162;576;2328;2965;12768;3541;15096
150260;201405;2036;8284;1952;8119;409;1745;1209;5188;1618;6933
150270;201405;9571;29257;7449;26608;1514;5738;4829;17597;6343;23335
150275;201405;5801;21394;5493;20890;815;3136;4051;15746;4866;18882
150276;201405;2115;6394;1961;6189;331;1103;1481;4701;1812;5804
150277;201405;4939;15652;4357;14942;532;1768;3365;11933;3897;13701
150280;201405;5867;25796;5695;25387;882;3847;4215;19371;5097;23218
150285;201405;2611;10595;2568;10500;313;1281;1991;8370;2304;9651
150290;201405;9018;27997;8776;27710;831;2223;7399;24314;8230;26537
150293;201405;8621;26618;7339;24680;2361;8141;3301;11730;5662;19871
150295;201405;6377;20716;5601;19765;1142;3887;3767;14053;4909;17940
150300;201405;1773;6294;1734;6245;117;398;1472;5460;1589;5858
150304;201405;4145;13038;3587;12277;506;1748;2612;9225;3118;10973
150307;201405;6524;22395;6071;21742;462;1673;5038;18456;5500;20129
150309;201405;6730;23937;6245;23284;1544;5723;4027;15748;5571;21471
150310;201405;5032;23573;4932;23420;559;2582;3996;19502;4555;22084
150320;201405;8717;22964;8345;22565;557;1316;7368;20388;7925;21704
150330;201405;13159;47971;12511;46937;1468;5377;9880;38027;11348;43404
150340;201405;2256;7638;2119;7437;372;1338;1471;5276;1843;6614
150345;201405;6391;22522;5980;21958;625;2296;4904;18416;5529;20712
150350;201405;7275;24430;6930;23941;892;3024;5325;18738;6217;21762
150360;201405;21568;68231;18802;64716;2978;10347;13284;47300;16262;57647
150370;201405;10240;38201;9798;37602;1183;3976;8002;31995;9185;35971
150375;201405;2777;11846;2716;11763;301;1118;2278;10279;2579;11397
150380;201405;9553;29074;8589;27746;852;2933;7047;22933;7899;25866
150390;201405;8153;35249;7782;34510;1634;6980;5038;23397;6672;30377
150400;201405;5479;22559;5292;22174;639;2570;4028;17438;4667;20008
150405;201405;8372;25950;7567;24952;1381;4156;5330;18614;6711;22770
150410;201405;1722;6632;1683;6566;300;1224;1109;4419;1409;5643
150420;201405;34830;123956;31183;117936;8242;32460;16409;64874;24651;97334
150430;201405;6470;24232;6252;23847;717;2936;4887;18857;5604;21793
150440;201405;5340;18849;5198;18633;809;2816;3910;14377;4719;17193
150442;201405;21569;62831;19711;60355;3301;10365;13479;42447;16780;52812
150445;201405;5071;18144;4691;17578;594;2150;3660;14037;4254;16187
150450;201405;4299;20646;4151;20433;413;2010;3440;17346;3853;19356
150460;201405;6828;25051;5726;23878;389;1672;5036;21484;5425;23156
150470;201405;17295;53581;16747;52893;1091;2824;15071;48696;16162;51520
150475;201405;1053;3592;960;3470;159;545;705;2673;864;3218
150480;201405;14123;48618;13558;47776;1139;3915;11375;41023;12514;44938
150490;201405;6468;25237;6346;25068;309;1218;5785;23091;6094;24309
150495;201405;4801;17725;4701;17567;233;858;4295;16191;4528;17049
150497;201405;3265;11538;2980;11049;825;3083;1707;6546;2532;9629
150500;201405;2927;8568;2800;8374;409;1170;2104;6387;2513;7557
150503;201405;3830;12228;3308;11562;1103;3940;1689;6183;2792;10123
150506;201405;12276;43843;11341;42524;2365;8005;7810;31220;10175;39225
150510;201405;9691;38411;9082;37327;1448;5960;6380;27327;7828;33287
150520;201405;6240;25476;6153;25351;354;1198;5632;23647;5986;24845
150530;201405;11651;41797;10643;40254;1347;4803;8081;31599;9428;36402
150540;201405;4607;14362;4200;13767;341;1160;3507;11527;3848;12687
150543;201405;5139;16326;4694;15698;1147;3904;2961;10131;4108;14035
150548;201405;8275;27002;7776;26363;497;1527;6912;23875;7409;25402
150549;201405;2232;7107;2120;6975;109;251;1935;6539;2044;6790
150550;201405;21018;67682;18824;63924;5508;19172;9146;31803;14654;50975
150553;201405;21327;78019;18863;72241;7525;30657;4309;16600;11834;47257
150555;201405;1737;5428;1523;5127;229;815;1104;3750;1333;4565
150560;201405;1976;6436;1899;6263;248;850;1396;4608;1644;5458
150563;201405;2857;9520;2663;9172;614;2247;1599;5527;2213;7774
150565;201405;3435;12306;3206;11964;276;1174;2528;9576;2804;10750
150570;201405;5423;20627;5335;20478;411;1532;4529;17840;4940;19372
150580;201405;9653;39990;9474;39768;768;2713;8273;35917;9041;38630
150590;201405;5466;22196;5321;22022;121;412;5065;21206;5186;21618
150600;201405;7749;30309;7550;29999;578;2094;6565;26755;7143;28849
150610;201405;2386;8322;2204;7941;266;1088;1558;5558;1824;6646
150611;201405;2632;9671;2510;9401;284;1149;1867;7028;2151;8177
150613;201405;11339;35505;9960;33581;3095;10600;5149;18206;8244;28806
150616;201405;3104;9190;2452;8335;606;2181;1347;4544;1953;6725
150618;201405;7294;25690;7010;25155;2138;7904;3699;13656;5837;21560
150619;201405;5235;18284;4932;17836;686;2670;3582;13073;4268;15743
150620;201405;6174;22623;5634;21928;793;2990;4363;17650;5156;20640
150630;201405;5405;17102;5199;16848;406;1292;4438;14659;4844;15951
150635;201405;4486;14855;4234;14381;824;2804;2713;9550;3537;12354
150640;201405;1480;4777;1467;4756;126;384;1281;4254;1407;4638
150650;201405;12044;37597;10961;35673;2935;9866;5778;19257;8713;29123
150655;201405;5317;17795;4901;17187;643;2356;3740;13272;4383;15628
150658;201405;4318;13866;3976;13368;438;1748;2978;10129;3416;11877
150660;201405;5686;18145;5197;17521;1310;4292;3146;11063;4456;15355
150670;201405;6276;18397;5463;17409;1582;5002;3169;10726;4751;15728
150680;201405;51220;200691;48040;194850;16009;64645;23079;100291;39088;164936
150690;201405;1837;6052;1701;5811;293;968;1126;3977;1419;4945
150700;201405;5832;18407;5452;17913;1108;3575;3682;12449;4790;16024
150710;201405;4279;13896;3862;13243;430;1341;3053;10729;3483;12070
150715;201405;4984;16367;4476;15625;571;2051;3445;12215;4016;14266
150720;201405;6491;26761;6147;26139;1004;4093;4420;19696;5424;23789
150730;201405;9190;31980;8658;31268;1002;3427;7146;26433;8148;29860
150740;201405;3669;11897;3365;11355;467;1672;2304;7882;2771;9554
150745;201405;5892;18739;5465;18164;1076;3761;3803;12711;4879;16472
150746;201405;1420;4655;1349;4527;206;739;915;3086;1121;3825
150747;201405;5022;16542;4587;15975;479;1543;3605;13154;4084;14697
150750;201405;2854;9839;2782;9750;105;251;2621;9351;2726;9602
150760;201405;11314;37204;10760;36459;2555;8531;6779;23869;9334;32400
150770;201405;5668;21568;5469;21243;696;2558;4313;17628;5009;20186
150775;201405;1119;3597;1012;3396;194;798;627;2008;821;2806
150780;201405;3027;10213;2998;10182;76;179;2856;9840;2932;10019
150790;201405;4976;16106;4644;15710;358;953;3991;14040;4349;14993
150795;201405;15370;47692;13908;45589;2365;7383;9748;33268;12113;40651
150796;201405;2823;8730;2681;8559;372;1132;2080;6864;2452;7996
150797;201405;3758;12615;3564;12325;172;630;3161;11016;3333;11646
150800;201405;14112;47722;12914;46255;2802;9357;8895;33541;11697;42898
150803;201405;6856;24925;6539;24472;866;3272;4864;18725;5730;21997
150805;201405;2736;9613;2535;9308;381;1343;1873;7081;2254;8424
150808;201405;5851;20217;5050;18725;2145;8414;1247;4754;3392;13168
150810;201405;19478;61751;16485;58070;2453;8183;11912;44247;14365;52430
150812;201405;5340;16680;4924;16080;488;2018;3757;11884;4245;13902
150815;201405;8867;28661;8005;27598;1062;3459;6319;22536;7381;25995
150820;201405;10592;31264;9686;30272;614;1275;8648;27950;9262;29225
150830;201405;12394;48161;11617;46769;721;3067;9663;40072;10384;43139
150835;201405;2042;7531;1903;7211;517;2106;922;3498;1439;5604
150840;201405;7540;22029;6062;20025;1433;5253;3408;11038;4841;16291
160005;201405;709;2708;674;2640;113;526;435;1673;548;2199
160010;201405;1534;5236;1523;5224;131;331;1349;4788;1480;5119
160015;201405;1637;6140;1597;6068;210;716;1238;4941;1448;5657
160020;201405;2277;7621;2122;7408;315;1127;1537;5522;1852;6649
160021;201405;862;3714;841;3679;146;654;601;2705;747;3359
160023;201405;1038;4061;1022;4035;75;261;906;3646;981;3907
160025;201405;1255;3649;1219;3611;19;62;1181;3501;1200;3563
160027;201405;8100;25191;7609;24635;2465;7838;4165;14264;6630;22102
160030;201405;40491;150365;37358;143682;8194;31539;23852;94467;32046;126006
160040;201405;4234;16436;4152;16318;147;656;3875;15250;4022;15906
160050;201405;3449;12941;3119;12465;1058;3951;1647;7173;2705;11124
160053;201405;2633;10364;2576;10281;600;2388;1730;7118;2330;9506
160055;201405;764;2982;750;2964;132;574;552;2187;684;2761
160060;201405;17407;59036;16428;57937;3917;12964;11036;40918;14953;53882
160070;201405;2158;8910;2117;8833;167;674;1841;7827;2008;8501
160080;201405;2661;9937;2648;9914;92;290;2513;9521;2605;9811
170025;201405;564;1927;517;1852;173;644;240;897;413;1541
170030;201405;1191;3934;1079;3724;326;1157;495;1731;821;2888
170035;201405;1534;4660;1279;4178;447;1538;424;1417;871;2955
170040;201405;1861;6190;1633;5851;301;1228;1081;3885;1382;5113
170070;201405;2098;5736;1711;5247;486;1594;895;2795;1381;4389
170100;201405;2573;7286;2278;6786;263;874;1758;5232;2021;6106
170105;201405;751;2444;629;2195;144;593;316;1043;460;1636
170110;201405;1199;3749;1048;3496;227;807;601;2004;828;2811
170130;201405;1443;4555;1264;4294;212;722;832;2948;1044;3670
170190;201405;1669;4820;1342;4325;548;1702;397;1485;945;3187
170200;201405;1572;4819;1214;4167;366;1376;400;1336;766;2712
170210;201405;30023;92299;25871;85199;8907;31202;9232;31573;18139;62775
170215;201405;1148;3644;1029;3464;129;466;779;2652;908;3118
170220;201405;6528;21795;5999;20914;979;3638;3996;14230;4975;17868
170230;201405;1525;5024;1327;4650;327;1306;660;2255;987;3561
170240;201405;3005;8577;2397;7761;360;1291;1611;5256;1971;6547
170255;201405;3678;11813;3097;10871;961;3464;1389;5123;2350;8587
170270;201405;1060;2731;763;2326;115;390;497;1489;612;1879
170290;201405;2956;8980;2626;8583;197;521;2237;7636;2434;8157
170300;201405;2045;6493;1777;6043;294;1089;1192;4077;1486;5166
170305;201405;779;2458;646;2207;112;423;391;1350;503;1773
170307;201405;1097;3889;952;3616;214;855;477;1923;691;2778
170310;201405;1711;4732;1360;4168;339;1015;676;2212;1015;3227
170320;201405;1067;3118;816;2668;206;709;400;1357;606;2066
170330;201405;856;2626;725;2463;124;447;499;1676;623;2123
170360;201405;459;1577;424;1515;114;426;170;593;284;1019
170370;201405;1397;4160;1148;3773;278;1017;527;1734;805;2751
170380;201405;2118;6692;1727;6100;367;1470;952;3336;1319;4806
170382;201405;557;1871;489;1768;115;462;287;1018;402;1480
170384;201405;1579;6522;1486;6355;363;1608;921;4033;1284;5641
170386;201405;934;2801;805;2616;208;761;410;1333;618;2094
170388;201405;653;1964;564;1815;114;433;244;771;358;1204
170389;201405;939;3143;860;3024;122;513;607;2094;729;2607
170390;201405;1360;4025;1177;3793;157;540;882;2915;1039;3455
170410;201405;477;1583;446;1524;57;240;302;1015;359;1255
170460;201405;529;1458;388;1213;107;363;139;431;246;794
170510;201405;779;2690;660;2502;137;576;349;1331;486;1907
170550;201405;5779;17903;4714;15995;1799;6612;1241;4265;3040;10877
170555;201405;1383;4059;1125;3665;302;1046;599;1964;901;3010
170560;201405;978;3357;808;3143;160;652;535;2147;695;2799
170600;201405;1355;3866;1184;3649;205;634;836;2647;1041;3281
170610;201405;1662;5066;1313;4512;185;707;798;2798;983;3505
170625;201405;439;1378;347;1194;81;291;102;357;183;648
170650;201405;1283;4098;1129;3831;296;1083;556;1929;852;3012
170700;201405;4028;13441;3394;12388;810;3231;1678;6375;2488;9606
170710;201405;1821;5395;1489;4831;216;775;976;3167;1192;3942
170720;201405;1861;5016;1602;4614;283;800;1131;3331;1414;4131
170730;201405;1116;3202;925;2921;269;925;446;1422;715;2347
170740;201405;2246;7959;1986;7497;307;1277;1370;5200;1677;6477
170755;201405;898;2817;759;2523;196;714;294;938;490;1652
170765;201405;1597;4320;1286;3818;336;1043;583;1783;919;2826
170770;201405;1832;6300;1711;6076;355;1277;1051;3846;1406;5123
170820;201405;4184;13455;3786;12825;1063;3788;1713;5969;2776;9757
170825;201405;797;2399;611;2040;150;551;245;796;395;1347
170830;201405;1400;4160;1260;3944;42;80;1141;3628;1183;3708
170900;201405;2916;10183;2782;9932;324;1142;2115;7808;2439;8950
170930;201405;4287;13093;3519;11951;1289;4590;1280;4346;2569;8936
170950;201405;13565;39677;10311;34086;3873;14272;2511;8075;6384;22347
170980;201405;532;1604;421;1427;95;353;259;875;354;1228
171050;201405;1337;4754;1262;4618;65;283;1109;4030;1174;4313
171070;201405;1720;5399;1591;5228;299;1013;1044;3523;1343;4536
171090;201405;971;2804;819;2571;85;282;609;1916;694;2198
171110;201405;659;1935;528;1723;136;487;296;947;432;1434
171150;201405;848;2539;633;2140;127;467;363;1241;490;1708
171180;201405;639;2005;488;1697;133;477;203;755;336;1232
171190;201405;1897;6893;1640;6370;405;1645;804;3264;1209;4909
171195;201405;871;3132;786;2976;134;558;459;1788;593;2346
171200;201405;691;2249;570;2027;139;564;276;934;415;1498
171215;201405;477;1416;367;1220;77;281;162;554;239;835
171240;201405;793;2723;748;2648;67;231;591;2154;658;2385
171245;201405;669;2232;564;1985;126;492;245;841;371;1333
171250;201405;1182;3423;1016;3187;93;340;792;2458;885;2798
171270;201405;428;1748;399;1687;106;406;201;939;307;1345
171280;201405;907;2856;807;2685;185;604;430;1561;615;2165
171320;201405;4147;12626;3544;11720;1047;3641;1813;6016;2860;9657
171330;201405;2856;8614;2498;8084;635;2185;1414;4613;2049;6798
171360;201405;1549;4961;1315;4611;283;1023;779;2791;1062;3814
171370;201405;776;2171;695;2046;139;460;387;1124;526;1584
171380;201405;1320;4408;1133;4039;369;1349;476;1736;845;3085
171395;201405;902;2767;741;2476;139;562;384;1266;523;1828
171420;201405;2277;6964;1841;6187;456;1647;845;2881;1301;4528
171430;201405;1035;3240;900;3033;204;686;539;1850;743;2536
171488;201405;2453;7570;2248;7269;569;1843;1260;4250;1829;6093
171500;201405;885;2737;784;2547;125;404;472;1563;597;1967
171510;201405;963;3397;869;3245;148;579;557;2155;705;2734
171515;201405;625;1796;484;1585;101;351;251;815;352;1166
171525;201405;608;2036;511;1854;95;391;293;1054;388;1445
171550;201405;344;1160;292;1055;114;450;51;192;165;642
171570;201405;1276;3944;1125;3687;205;682;760;2537;965;3219
171575;201405;2028;5822;1601;5041;388;1233;751;2482;1139;3715
171610;201405;6305;21561;5751;20512;1947;7311;2112;7578;4059;14889
171620;201405;2372;7377;2155;7051;162;597;1778;5853;1940;6450
171630;201405;896;2959;746;2693;217;846;294;1047;511;1893
171650;201405;2443;7654;2022;6898;542;1988;889;2984;1431;4972
171660;201405;2664;7332;2134;6402;409;1280;1219;3710;1628;4990
171665;201405;1453;4363;1223;3990;204;734;788;2639;992;3373
171670;201405;2387;6483;1917;5820;439;1436;1083;3219;1522;4655
171700;201405;1153;3813;1027;3584;169;657;648;2259;817;2916
171720;201405;734;2257;644;2091;208;719;290;949;498;1668
171750;201405;1315;4290;1157;3987;380;1352;445;1544;825;2896
171780;201405;1249;3460;913;2975;123;450;528;1750;651;2200
171790;201405;1734;5572;1428;5136;258;925;895;3375;1153;4300
171800;201405;730;2319;663;2221;104;373;452;1546;556;1919
171820;201405;10079;30839;9142;29680;2046;7089;5544;18262;7590;25351
171830;201405;1617;5928;1491;5658;404;1636;705;2693;1109;4329
171840;201405;820;2381;725;2252;62;191;570;1794;632;1985
171845;201405;827;2239;649;1939;102;356;386;1112;488;1468
171850;201405;1015;3648;907;3419;113;500;597;2251;710;2751
171855;201405;1266;3997;1142;3794;114;491;862;2781;976;3272
171865;201405;499;1579;417;1457;111;431;205;701;316;1132
171870;201405;699;2239;583;2033;124;464;282;1029;406;1493
171875;201405;1411;4451;1194;4125;184;725;849;2912;1033;3637
171880;201405;979;3526;959;3492;118;452;722;2713;840;3165
171884;201405;937;2675;691;2305;154;578;265;930;419;1508
171886;201405;1521;5126;1337;4735;466;1747;475;1713;941;3460
171888;201405;698;2158;584;1947;91;317;368;1269;459;1586
171889;201405;493;1614;465;1552;89;293;292;1001;381;1294
171890;201405;1137;3779;1028;3622;144;569;696;2472;840;3041
171900;201405;471;1880;446;1817;131;546;225;929;356;1475
172000;201405;661;2147;564;2001;94;388;329;1151;423;1539
172010;201405;1196;4124;1124;4014;118;466;874;3146;992;3612
172015;201405;359;1360;310;1285;58;244;184;801;242;1045
172020;201405;2397;7925;2159;7569;310;1152;1533;5483;1843;6635
172025;201405;755;2219;600;1941;107;360;317;1033;424;1393
172030;201405;1111;3778;1001;3576;143;597;675;2410;818;3007
172049;201405;1157;3226;1041;3051;142;416;776;2342;918;2758
172065;201405;1287;3743;1075;3475;111;386;887;2886;998;3272
172080;201405;2620;8059;2214;7368;282;1109;1507;4922;1789;6031
172085;201405;522;1421;406;1211;97;310;134;392;231;702
172090;201405;3536;10565;2743;9474;549;1985;1699;6063;2248;8048
172093;201405;589;1872;463;1645;140;611;222;747;362;1358
172097;201405;712;2103;590;1903;154;562;234;734;388;1296
172100;201405;27158;92085;23694;85087;8348;32596;6775;24373;15123;56969
172110;201405;1710;6246;1570;6038;172;660;1216;4826;1388;5486
172120;201405;5627;16908;4657;15666;517;1804;3509;12075;4026;13879
172125;201405;330;1016;270;926;59;227;129;447;188;674
172130;201405;524;1512;458;1411;72;233;310;996;382;1229
172208;201405;2188;6790;2052;6567;403;1389;1189;3826;1592;5215
172210;201405;2358;7273;2187;7022;348;1224;1522;4795;1870;6019
210005;201405;21851;71386;19580;67793;5650;20731;10090;35298;15740;56029
210010;201405;1631;5814;1463;5575;155;572;1135;4473;1290;5045
210015;201405;3523;10966;3228;10527;280;614;2680;9241;2960;9855
210020;201405;7408;18459;6932;17876;469;1324;5705;14889;6174;16213
210030;201405;5885;19659;5576;19242;453;1846;4653;16008;5106;17854
210040;201405;1967;5657;1793;5450;193;601;1402;4311;1595;4912
210043;201405;6223;18566;5667;17817;510;1513;4555;14778;5065;16291
210047;201405;6697;26364;6252;25581;878;3854;4357;18088;5235;21942
210050;201405;2506;8919;2008;8191;487;1955;1044;4528;1531;6483
210055;201405;1725;5937;1600;5762;203;744;1202;4372;1405;5116
210060;201405;7908;29307;7130;28066;777;3375;5312;21392;6089;24767
210070;201405;6995;20885;6581;20365;306;1031;5818;18118;6124;19149
210080;201405;3740;12912;3671;12812;87;341;3456;12105;3543;12446
210083;201405;4134;14267;3959;14070;149;482;3684;13269;3833;13751
210087;201405;2657;8246;2486;8036;171;594;2150;6999;2321;7593
210090;201405;10035;33134;9634;32480;485;1862;8390;28378;8875;30240
210095;201405;6174;23468;6013;23211;589;2283;4960;19562;5549;21845
210100;201405;7593;22700;7153;22189;339;1201;6386;19825;6725;21026
210110;201405;3220;11142;3130;11025;228;833;2648;9515;2876;10348
210120;201405;25960;74961;22259;70451;2572;8280;17006;55187;19578;63467
210125;201405;3407;11129;3267;10975;233;687;2876;9864;3109;10551
210130;201405;4012;12219;3834;11982;364;1156;3138;9877;3502;11033
210135;201405;1668;4904;1483;4631;134;416;1220;3878;1354;4294
210140;201405;17975;57074;15170;53329;3138;11196;9554;35030;12692;46226
210150;201405;4656;11852;4256;11359;128;347;3908;10425;4036;10772
210160;201405;18655;60759;17461;59001;2198;6933;13729;47920;15927;54853
210170;201405;14076;52174;13857;51869;1015;3377;12215;46757;13230;50134
210173;201405;1801;7751;1750;7649;126;602;1523;6703;1649;7305
210177;201405;2995;9702;2835;9500;330;1229;2264;7543;2594;8772
210180;201405;1524;4731;1437;4606;93;333;1217;3896;1310;4229
210190;201405;5184;16694;4857;16129;400;1753;3695;11985;4095;13738
210193;201405;1442;4638;1332;4451;104;377;1078;3662;1182;4039
210197;201405;1950;6545;1807;6386;174;546;1509;5528;1683;6074
210200;201405;9286;31154;8560;30103;1121;3675;6412;23547;7533;27222
210203;201405;6278;21344;5924;20895;411;1327;5199;18662;5610;19989
210207;201405;3065;10233;2876;9893;391;1291;2102;7447;2493;8738
210210;201405;8869;30023;8520;29539;307;1097;7525;26658;7832;27755
210215;201405;1706;6775;1653;6682;175;747;1351;5512;1526;6259
210220;201405;6324;24366;6086;23970;528;2101;4961;20029;5489;22130
210230;201405;5382;18314;5005;17717;423;1574;4084;14616;4507;16190
210232;201405;11884;41015;10514;39323;1802;6714;7335;29076;9137;35790
210235;201405;3557;11054;3204;10616;264;896;2705;9086;2969;9982
210237;201405;2529;9275;2500;9236;51;134;2403;8993;2454;9127
210240;201405;2996;9569;2869;9378;217;672;2388;7933;2605;8605
210250;201405;5055;16035;4840;15766;157;562;4503;14738;4660;15300
210255;201405;2737;8929;2503;8532;546;1980;1551;5350;2097;7330
210260;201405;5254;16831;4801;16138;682;2249;3531;12159;4213;14408
210270;201405;5303;15250;4733;14477;153;543;4196;12935;4349;13478
210275;201405;3540;9067;3330;8842;121;255;3145;8458;3266;8713
210280;201405;6014;17606;5197;16576;389;1317;4302;13864;4691;15181
210290;201405;5805;18734;5347;18169;464;1521;4427;15398;4891;16919
210300;201405;37640;112299;31441;104429;2951;10288;24871;84907;27822;95195
210310;201405;2892;8359;2747;8148;123;348;2422;7223;2545;7571
210312;201405;2200;7125;2154;7051;119;474;1927;6301;2046;6775
210315;201405;2406;8517;2295;8356;145;602;1973;7221;2118;7823
210317;201405;4319;12941;4142;12714;273;799;3642;11359;3915;12158
210320;201405;19592;62013;18369;60553;1085;3487;16134;54207;17219;57694
210325;201405;3597;11480;3239;10947;343;1244;2551;8699;2894;9943
210330;201405;32992;87203;28285;82076;3706;8424;21578;68273;25284;76697
210340;201405;11978;37270;10977;36025;1359;3720;8320;29087;9679;32807
210350;201405;10495;32959;9724;31865;818;2688;7841;26242;8659;28930
210355;201405;3949;14323;3619;13894;130;297;3338;13240;3468;13537
210360;201405;16815;52098;15732;50527;1422;4690;12531;40966;13953;45656
210370;201405;8315;21945;7372;20938;303;732;6622;19277;6925;20009
210375;201405;3242;9965;2810;9440;443;1588;2057;7026;2500;8614
210380;201405;6334;18470;5696;17554;617;1662;4598;14623;5215;16285
210390;201405;2796;9919;2581;9567;123;568;2270;8443;2393;9011
210400;201405;4945;15771;4764;15550;299;907;4198;13933;4497;14840
210405;201405;8887;24839;7273;22632;2172;6680;3491;11911;5663;18591
210407;201405;2104;7437;1876;7079;206;746;1451;5693;1657;6439
210408;201405;2176;8776;2075;8655;84;321;1889;8099;1973;8420
210409;201405;3951;14340;3756;14038;290;1106;3063;11741;3353;12847
210410;201405;3608;11607;3375;11320;317;899;2878;9951;3195;10850
210420;201405;4244;14116;3961;13621;342;1184;3231;11314;3573;12498
210430;201405;2095;6654;2049;6598;138;466;1782;5772;1920;6238
210440;201405;4288;13485;4188;13328;212;671;3756;12077;3968;12748
210450;201405;2913;9276;2654;8881;200;771;2177;7256;2377;8027
210455;201405;4217;12633;3641;11768;675;2218;2415;8022;3090;10240
210460;201405;4064;13129;3812;12794;224;838;3275;11081;3499;11919
210462;201405;1790;6448;1721;6310;174;689;1335;4982;1509;5671
210465;201405;2689;8835;2537;8643;281;808;2078;7362;2359;8170
210467;201405;6270;20865;5873;20375;465;1333;4974;17950;5439;19283
210470;201405;1988;5613;1598;5043;111;360;1256;4020;1367;4380
210480;201405;13873;46377;12306;44244;3561;12579;6656;25692;10217;38271
210490;201405;3460;10487;3220;10129;331;1082;2559;8090;2890;9172
210500;201405;6764;26643;6489;26151;686;2638;5123;21417;5809;24055
210510;201405;6932;23053;6676;22760;393;855;5860;20981;6253;21836
210515;201405;3452;11299;3348;11170;156;458;3069;10392;3225;10850
210520;201405;2748;8710;2565;8445;215;687;2122;7141;2337;7828
210530;201405;41275;135381;35452;126408;10290;39372;18023;66146;28313;105518
210535;201405;3213;11309;3111;11142;178;634;2719;9861;2897;10495
210540;201405;13166;45493;11745;43224;2930;10511;6388;25505;9318;36016
210542;201405;6453;18743;5653;17871;331;849;5008;16269;5339;17118
210545;201405;2245;7569;2134;7382;100;461;1836;6335;1936;6796
210547;201405;3829;13481;3584;13108;290;1003;2926;10975;3216;11978
210550;201405;6407;18163;5573;17238;294;681;5073;16122;5367;16803
210560;201405;4208;13363;3786;12683;287;1091;3137;10481;3424;11572
210565;201405;1547;5333;1340;5023;140;627;1008;3784;1148;4411
210570;201405;12793;36802;11653;35483;990;2440;9799;30936;10789;33376
210580;201405;3153;9628;2793;9171;363;988;2140;7564;2503;8552
210590;201405;4443;13719;4175;13398;279;852;3643;11914;3922;12766
210592;201405;2483;7971;2409;7856;123;455;2112;6883;2235;7338
210594;201405;2765;7962;2320;7361;153;435;1933;6293;2086;6728
210596;201405;2865;10697;2713;10423;302;1237;2069;8058;2371;9295
210598;201405;2008;6223;1880;6069;117;462;1673;5353;1790;5815
210600;201405;3360;10010;3100;9645;300;993;2457;7650;2757;8643
210610;201405;2704;8656;2429;8320;225;851;2025;6939;2250;7790
210620;201405;1855;5755;1712;5571;54;163;1569;5159;1623;5322
210630;201405;3490;12864;3073;12054;512;2010;1937;7896;2449;9906
210632;201405;4814;16664;4422;16113;441;1632;3575;13207;4016;14839
210635;201405;1925;6835;1847;6719;87;296;1655;6127;1742;6423
210637;201405;2798;9565;2650;9351;143;501;2346;8396;2489;8897
210640;201405;4330;14485;4232;14376;20;59;4112;14073;4132;14132
210650;201405;6922;21156;6804;21013;152;423;6520;20290;6672;20713
210660;201405;7619;23648;7120;22871;279;796;6551;21194;6830;21990
210663;201405;2688;7899;2543;7709;167;564;2174;6622;2341;7186
210667;201405;1717;6220;1644;6109;83;385;1431;5335;1514;5720
210670;201405;4758;17693;4602;17427;459;1764;3608;14063;4067;15827
210675;201405;4875;13688;4605;13345;331;854;3976;11773;4307;12627
210680;201405;4586;12943;4099;12382;233;677;3561;10898;3794;11575
210690;201405;6892;23611;6604;23303;284;945;6048;21633;6332;22578
210700;201405;2658;7550;2365;7213;261;538;1844;6231;2105;6769
210710;201405;4921;16100;4721;15783;188;675;4186;14071;4374;14746
210720;201405;2470;9139;2352;8965;155;682;2048;7783;2203;8465
210725;201405;1182;4401;1025;4115;152;675;635;2587;787;3262
210730;201405;1229;3829;1088;3671;112;315;906;3153;1018;3468
210735;201405;3874;14236;3617;13784;592;2284;2545;10022;3137;12306
210740;201405;5131;14354;4794;14014;226;576;4449;13209;4675;13785
210745;201405;3748;11505;3533;11206;318;837;2920;9458;3238;10295
210750;201405;20291;56676;18537;54661;1979;5777;15076;45253;17055;51030
210760;201405;6002;16474;5678;16116;85;264;5493;15613;5578;15877
210770;201405;6282;17184;5338;16110;262;844;4758;14414;5020;15258
210780;201405;8664;29259;8068;28156;1028;3783;5808;20649;6836;24432
210790;201405;4824;14636;4164;13892;328;818;3546;12390;3874;13208
210800;201405;5071;14348;4621;13851;203;647;3960;12344;4163;12991
210805;201405;3735;15864;3638;15675;198;833;3133;13842;3331;14675
210810;201405;5712;17292;5158;16657;402;870;4497;15167;4899;16037
210820;201405;9029;26074;8467;25306;1551;4565;5784;17808;7335;22373
210825;201405;5529;18671;5354;18449;254;829;4807;16835;5061;17664
210830;201405;8557;26528;8203;26134;307;827;7456;24231;7763;25058
210840;201405;3803;10592;3505;10165;304;775;2802;8246;3106;9021
210845;201405;5568;17700;5365;17473;278;728;4760;16024;5038;16752
210850;201405;6100;22505;5678;21767;848;3629;4035;15571;4883;19200
210860;201405;17368;53804;16242;52296;1330;4530;13294;43190;14624;47720
210870;201405;6617;21604;5994;20814;727;2415;4579;16391;5306;18806
210880;201405;4247;13836;4156;13711;216;691;3733;12466;3949;13157
210890;201405;5405;16349;5061;15918;441;1521;4181;13190;4622;14711
210900;201405;4802;15662;4379;14937;1497;5197;1984;7144;3481;12341
210905;201405;1841;5812;1731;5668;121;305;1469;4962;1590;5267
210910;201405;10633;33560;9970;32512;1835;6388;6697;22059;8532;28447
210920;201405;3404;11440;3308;11311;176;556;2952;10286;3128;10842
210923;201405;1542;5707;1461;5589;217;835;1040;4177;1257;5012
210927;201405;4743;15006;4604;14863;30;87;4535;14688;4565;14775
210930;201405;2680;9727;2563;9572;205;910;2156;8061;2361;8971
210940;201405;2925;11568;2876;11471;308;1154;2339;9545;2647;10699
210945;201405;5971;17663;5762;17449;195;244;5503;17081;5698;17325
210950;201405;5687;17730;4983;16695;631;2186;3657;12508;4288;14694
210955;201405;1954;6497;1757;6186;300;1106;1199;4327;1499;5433
210960;201405;9325;30914;8970;30398;2131;6983;5882;20945;8013;27928
210970;201405;1384;5013;1225;4777;178;810;883;3449;1061;4259
210975;201405;1758;6059;1674;5911;170;608;1313;4714;1483;5322
210980;201405;9131;22770;8911;22524;628;1299;7930;20475;8558;21774
210990;201405;16916;49049;13523;44982;2714;9369;8721;29816;11435;39185
211000;201405;16518;53363;14995;51466;1015;3464;12866;45106;13881;48570
211003;201405;5066;17859;4638;17211;557;2153;3393;12990;3950;15143
211010;201405;6761;22959;6591;22760;132;438;6200;21660;6332;22098
211020;201405;7493;23243;7339;22994;192;451;6937;21925;7129;22376
211023;201405;2447;8320;2376;8194;167;597;1993;7022;2160;7619
211027;201405;3064;11934;2949;11755;289;1083;2356;9783;2645;10866
211030;201405;4289;13122;3861;12636;734;1921;2874;10024;3608;11945
211040;201405;4170;16037;4057;15850;157;654;3572;14254;3729;14908
211050;201405;10277;27612;10118;27430;465;1169;9398;25663;9863;26832
211060;201405;5959;21620;5836;21401;646;2204;4729;17844;5375;20048
211065;201405;1720;5980;1592;5811;53;194;1486;5480;1539;5674
211070;201405;8728;29718;8214;28821;754;2667;6592;23572;7346;26239
211080;201405;1361;4224;1116;3883;88;431;902;3067;990;3498
211085;201405;2069;6935;1792;6549;296;1039;1279;4836;1575;5875
211090;201405;3602;11255;3386;10962;215;819;2867;9224;3082;10043
211100;201405;6851;18021;6684;17823;97;340;6366;16944;6463;17284
211102;201405;3131;11658;3012;11492;303;1102;2510;9828;2813;10930
211105;201405;2831;9047;2495;8582;207;774;2053;7077;2260;7851
211107;201405;4550;14146;4171;13640;255;772;3605;12074;3860;12846
211110;201405;6595;19832;5242;17915;897;2911;3480;12552;4377;15463
211120;201405;32439;90521;28473;85571;4151;11849;20662;64648;24813;76497
211125;201405;2218;7153;2022;6851;153;544;1669;5720;1822;6264
211130;201405;149687;441948;140647;430400;27531;83255;97505;306111;125036;389366
211140;201405;5648;18166;5342;17685;291;1040;4620;15343;4911;16383
211150;201405;10034;30386;9445;29652;719;2283;8066;25651;8785;27934
211153;201405;3186;9596;2925;9296;336;854;2406;8018;2742;8872
211157;201405;1253;4108;1078;3842;136;564;748;2778;884;3342
211160;201405;4236;14481;3653;13499;421;1850;2654;9741;3075;11591
211163;201405;1740;5748;1650;5626;73;223;1479;5161;1552;5384
211167;201405;1511;5132;1407;4967;52;208;1269;4502;1321;4710
211170;201405;6761;18061;6526;17774;163;517;6057;16462;6220;16979
211172;201405;2416;7123;2135;6703;165;650;1757;5392;1922;6042
211174;201405;2851;8455;2621;8164;135;522;2286;7065;2421;7587
211176;201405;5634;16467;4788;15488;578;1604;3734;12635;4312;14239
211178;201405;3278;10053;3205;9971;87;186;3055;9641;3142;9827
211180;201405;4505;15966;4220;15523;411;1642;3365;12574;3776;14216
211190;201405;2834;9568;2596;9226;132;569;2234;8005;2366;8574
211195;201405;1467;4645;1265;4399;107;341;1037;3725;1144;4066
211200;201405;2175;7558;1962;7273;270;936;1450;5670;1720;6606
211210;201405;6973;21968;6767;21673;454;1463;5842;18932;6296;20395
211220;201405;36161;107908;31767;102196;6707;22061;20391;67587;27098;89648
211223;201405;5960;17238;5534;16553;800;2431;3752;11787;4552;14218
211227;201405;1602;5950;1518;5824;138;633;1212;4657;1350;5290
211230;201405;9096;30756;8344;29479;1209;4272;5988;21713;7197;25985
211240;201405;8415;28368;8160;28066;346;1214;7516;26035;7862;27249
211245;201405;5343;15626;5275;15542;176;425;4949;14772;5125;15197
211250;201405;12110;43970;11513;43277;1269;3589;9561;37980;10830;41569
211260;201405;8251;26199;8117;26009;458;1432;7345;23730;7803;25162
211270;201405;10149;36186;9564;35407;669;2701;7957;29934;8626;32635
211280;201405;12366;36589;11822;35939;1071;2571;10133;31932;11204;34503
211285;201405;2008;7047;1739;6565;408;1635;875;3459;1283;5094
211290;201405;7768;25549;7568;25301;716;2096;6330;21755;7046;23851
211300;201405;8707;26806;7921;25675;601;2025;6645;21720;7246;23745
211400;201405;12428;36600;10665;34602;2387;7450;6516;23440;8903;30890
220005;201405;1709;5064;1633;4947;57;254;1426;4195;1483;4449
220010;201405;1756;4641;1329;4103;137;507;1038;3135;1175;3642
220020;201405;3774;11568;3573;11229;627;2100;2377;7455;3004;9555
220025;201405;2173;5432;1972;5121;51;151;1742;4481;1793;4632
220027;201405;1416;3859;1311;3722;87;224;1113;3206;1200;3430
220030;201405;3409;10148;3337;10028;262;855;2837;8555;3099;9410
220040;201405;8576;26699;8184;26061;1618;5357;5229;16755;6847;22112
220045;201405;1462;4714;1327;4490;140;536;962;3210;1102;3746
220050;201405;4856;14084;4272;13239;360;1318;3443;10520;3803;11838
220060;201405;2088;5466;1991;5351;92;248;1815;4886;1907;5134
220070;201405;2619;7725;2340;7324;204;667;1818;5740;2022;6407
220080;201405;831;2593;789;2524;113;448;561;1725;674;2173
220090;201405;1867;4926;1636;4602;141;489;1330;3645;1471;4134
220095;201405;685;1932;655;1879;31;99;606;1726;637;1825
220100;201405;1412;4279;1203;3936;126;426;899;2997;1025;3423
220105;201405;2248;7425;2084;7114;217;780;1515;5205;1732;5985
220110;201405;3592;10503;3172;9891;259;963;2597;7979;2856;8942
220115;201405;2276;8336;2194;8201;280;1095;1752;6590;2032;7685
220117;201405;1429;3807;1180;3447;87;280;961;2793;1048;3073
220120;201405;12885;37164;11976;36024;428;1560;10925;32847;11353;34407
220130;201405;855;3076;757;2952;62;194;658;2645;720;2839
220140;201405;1641;4419;1507;4249;235;484;1208;3594;1443;4078
220150;201405;7300;23084;6987;22647;443;1655;5993;19392;6436;21047
220155;201405;1069;3377;910;3076;84;346;627;2072;711;2418
220157;201405;1059;2743;971;2613;45;119;826;2221;871;2340
220160;201405;2885;8650;2592;8148;203;768;2005;6247;2208;7015
220170;201405;1332;4271;1212;4067;107;420;961;3218;1068;3638
220173;201405;2116;6432;1747;5724;85;388;1409;4555;1494;4943
220177;201405;1752;5149;1721;5099;73;225;1596;4733;1669;4958
220180;201405;1171;3201;1037;2991;60;214;786;2215;846;2429
220190;201405;4712;15459;4148;14741;482;1719;3264;11790;3746;13509
220191;201405;1479;4997;1412;4876;206;721;1044;3615;1250;4336
220192;201405;1776;5115;1425;4504;164;563;1000;3152;1164;3715
220194;201405;1739;5118;1578;4843;165;584;1175;3507;1340;4091
220196;201405;2084;6268;1950;6040;213;736;1491;4618;1704;5354
220198;201405;1342;3741;1084;3403;22;68;1003;3186;1025;3254
220200;201405;4680;16176;4431;15793;761;2875;3096;11105;3857;13980
220202;201405;2083;6560;1887;6212;68;278;1659;5427;1727;5705
220205;201405;2972;7804;2617;7336;100;371;2288;6330;2388;6701
220207;201405;921;2851;803;2645;83;326;610;1988;693;2314
220208;201405;1712;5901;1573;5660;249;1021;1080;3857;1329;4878
220209;201405;1585;4982;1449;4750;106;406;1107;3633;1213;4039
220210;201405;1892;5012;1656;4703;100;342;1300;3701;1400;4043
220211;201405;1667;4989;1581;4875;122;499;1310;3987;1432;4486
220213;201405;1846;5371;1720;5139;108;387;1350;3964;1458;4351
220217;201405;1806;5967;1741;5885;65;190;1602;5490;1667;5680
220220;201405;11857;34131;10904;32627;1351;3807;7807;24001;9158;27808
220225;201405;1006;3113;923;2988;47;202;788;2509;835;2711
220230;201405;6140;16222;5109;14839;228;661;4498;13136;4726;13797
220240;201405;2712;8725;2560;8462;211;805;2008;6568;2219;7373
220245;201405;1466;4010;1349;3849;68;188;1176;3390;1244;3578
220250;201405;3393;9217;3051;8758;63;157;2812;8173;2875;8330
220253;201405;1881;5591;1621;5139;130;486;1208;3859;1338;4345
220255;201405;1795;5103;1584;4743;102;401;1287;3743;1389;4144
220260;201405;5263;16954;4728;15949;467;1713;3526;11918;3993;13631
220265;201405;1248;4563;1186;4453;105;474;871;3273;976;3747
220270;201405;6821;22572;6648;22270;421;1904;5646;18479;6067;20383
220271;201405;1558;4393;1467;4260;74;204;1274;3755;1348;3959
220272;201405;1792;5595;1660;5386;116;476;1300;4183;1416;4659
220273;201405;1319;3799;1154;3541;124;411;872;2651;996;3062
220275;201405;2106;5630;1802;5239;91;278;1558;4542;1649;4820
220277;201405;2624;7147;2222;6535;161;526;1736;5134;1897;5660
220280;201405;1793;4699;1567;4371;130;470;1221;3330;1351;3800
220285;201405;1695;4606;1520;4364;98;296;1266;3733;1364;4029
220290;201405;6659;21693;5629;20366;559;2153;4362;16011;4921;18164
220300;201405;1938;6368;1710;6061;101;445;1431;5076;1532;5521
220310;201405;2661;8605;2219;8074;92;277;2002;7534;2094;7811
220320;201405;3431;10163;2887;9251;382;1318;2083;6678;2465;7996
220323;201405;1448;5343;1319;5155;154;674;994;3904;1148;4578
220325;201405;1284;4068;1179;3863;170;595;782;2634;952;3229
220327;201405;1383;4428;1257;4215;73;349;1011;3337;1084;3686
220330;201405;3789;10750;3586;10482;253;776;3047;8998;3300;9774
220335;201405;2127;6131;1919;5879;108;378;1647;5088;1755;5466
220340;201405;1869;5326;1633;4983;150;513;1250;3775;1400;4288
220342;201405;1225;4013;1165;3919;128;470;854;3032;982;3502
220345;201405;2961;8021;2528;7336;77;217;2205;6417;2282;6634
220350;201405;4506;12163;3982;11461;305;977;3164;9100;3469;10077
220360;201405;1490;4088;1180;3606;116;409;867;2633;983;3042
220370;201405;9266;26763;8456;25690;448;1306;7537;23022;7985;24328
220375;201405;1598;4972;1485;4820;76;276;1331;4318;1407;4594
220380;201405;1430;3900;1231;3621;87;294;963;2830;1050;3124
220385;201405;753;2036;661;1876;28;108;549;1509;577;1617
220390;201405;10348;32743;9475;31042;2498;8576;4340;14309;6838;22885
220400;201405;1471;3542;1303;3299;51;174;1135;2801;1186;2975
220410;201405;1390;4004;1185;3719;112;468;937;2860;1049;3328
220415;201405;895;2412;804;2292;88;248;603;1733;691;1981
220420;201405;2290;6683;2058;6224;140;409;1672;5091;1812;5500
220430;201405;2987;8709;2842;8514;384;1172;2204;6613;2588;7785
220435;201405;1695;4981;1563;4774;85;267;1297;3970;1382;4237
220440;201405;2824;8523;2346;7974;138;438;2081;7137;2219;7575
220450;201405;2740;8159;2371;7653;537;1829;1466;4740;2003;6569
220455;201405;1421;4378;1274;4177;48;159;1156;3832;1204;3991
220460;201405;1054;2906;1002;2833;72;216;865;2432;937;2648
220465;201405;2508;8288;2308;7985;549;2036;1417;4941;1966;6977
220470;201405;4111;12353;3724;11693;273;980;2872;8899;3145;9879
220480;201405;2411;7188;2211;6897;182;600;1784;5558;1966;6158
220490;201405;2470;7123;2309;6919;139;495;1972;5888;2111;6383
220500;201405;3468;9280;2906;8307;166;647;2356;6562;2522;7209
220510;201405;2959;8273;2220;7148;102;450;1725;5506;1827;5956
220515;201405;1989;4982;1759;4694;89;252;1486;3981;1575;4233
220520;201405;5144;14546;4815;14075;217;610;4243;12523;4460;13133
220525;201405;1476;4180;1369;4023;109;402;1110;3183;1219;3585
220527;201405;1466;4627;1348;4379;144;475;1044;3447;1188;3922
220530;201405;1224;3602;1123;3444;95;363;931;2773;1026;3136
220535;201405;910;2827;878;2780;85;317;698;2177;783;2494
220540;201405;3677;12258;3543;12048;287;1094;2919;9938;3206;11032
220545;201405;1452;4997;1396;4902;202;810;994;3447;1196;4257
220550;201405;9506;31083;8970;30158;1430;5098;6220;20935;7650;26033
220551;201405;1446;4940;1352;4782;125;528;1052;3689;1177;4217
220552;201405;1692;5341;1449;4915;129;582;1065;3492;1194;4074
220553;201405;1643;4906;1405;4555;90;338;1144;3700;1234;4038
220554;201405;933;2604;812;2436;104;320;601;1825;705;2145
220555;201405;2461;7256;2306;7061;103;340;1979;6152;2082;6492
220556;201405;1512;4762;1374;4494;114;454;1029;3346;1143;3800
220557;201405;1650;5464;1508;5202;209;807;998;3439;1207;4246
220558;201405;1060;3335;975;3184;100;386;742;2392;842;2778
220559;201405;1575;4486;1444;4285;86;286;1226;3638;1312;3924
220560;201405;1773;4404;1477;4001;88;242;1233;3326;1321;3568
220570;201405;7614;24343;7145;23685;1093;3439;5276;18000;6369;21439
220580;201405;6626;21667;6461;21471;398;1277;5811;19552;6209;20829
220585;201405;1976;7283;1902;7147;152;614;1580;5975;1732;6589
220590;201405;1454;4539;1315;4331;259;887;840;2817;1099;3704
220595;201405;2513;7293;2316;7029;91;318;2071;6302;2162;6620
220600;201405;1368;3417;1155;3160;205;433;791;2301;996;2734
220605;201405;2094;6221;1848;5838;111;378;1460;4617;1571;4995
220610;201405;2839;8805;2752;8678;174;679;2339;7315;2513;7994
220620;201405;7889;26946;7623;26553;432;1658;6667;23326;7099;24984
220630;201405;420;1287;360;1177;60;223;203;658;263;881
220635;201405;1897;6756;1772;6484;176;802;1164;4226;1340;5028
220640;201405;2844;8385;2701;8173;278;934;2123;6428;2401;7362
220650;201405;2522;7087;2257;6672;154;521;1829;5374;1983;5895
220660;201405;2574;8262;2075;7613;240;1028;1640;5947;1880;6975
220665;201405;1220;4211;1168;4128;54;229;1035;3642;1089;3871
220667;201405;1786;6034;1697;5913;89;342;1454;5067;1543;5409
220669;201405;1898;6252;1770;6015;260;1003;1239;4211;1499;5214
220670;201405;2171;6614;2033;6438;165;406;1752;5749;1917;6155
220672;201405;2375;6878;2289;6767;236;656;1924;5782;2160;6438
220675;201405;1386;4058;1296;3910;128;369;974;2969;1102;3338
220680;201405;2272;7474;2180;7341;227;754;1748;6006;1975;6760
220690;201405;1762;5030;1574;4723;121;440;1248;3699;1369;4139
220695;201405;901;2721;849;2634;71;241;655;2029;726;2270
220700;201405;9174;26741;8349;25519;782;2621;6466;19783;7248;22404
220710;201405;781;2368;677;2191;65;210;491;1610;556;1820
220720;201405;2164;5836;2045;5673;95;223;1809;5090;1904;5313
220730;201405;1403;3897;1206;3597;50;197;1015;2990;1065;3187
220735;201405;1079;2817;908;2529;66;216;681;1898;747;2114
220740;201405;1415;4536;1202;4245;173;603;901;3282;1074;3885
220750;201405;4035;11871;3800;11515;511;1348;2904;9146;3415;10494
220755;201405;1220;3555;1142;3430;72;207;954;2868;1026;3075
220760;201405;2690;9452;2505;9184;130;538;2159;7987;2289;8525
220770;201405;24225;82527;22385;79004;7364;26820;9646;35381;17010;62201
220775;201405;1241;3117;1211;3083;18;37;1182;3020;1200;3057
220777;201405;1710;4870;1597;4699;117;356;1293;3768;1410;4124
220779;201405;1203;3598;1167;3548;73;276;1039;3121;1112;3397
220780;201405;6328;16583;5703;15763;463;1254;4668;13061;5131;14315
220785;201405;1361;3662;1318;3573;61;179;1210;3262;1271;3441
220790;201405;9624;31279;9224;30549;965;3524;7298;24039;8263;27563
220793;201405;933;2670;860;2550;60;208;706;2081;766;2289
220795;201405;1549;4351;1501;4278;124;367;1274;3652;1398;4019
220800;201405;17518;49778;16207;47842;1854;6300;12243;35549;14097;41849
220810;201405;3389;10022;2936;9216;211;821;2326;7220;2537;8041
220820;201405;5688;15894;5208;15266;336;1074;4474;13154;4810;14228
220830;201405;7778;22149;7394;21513;852;2494;5714;16795;6566;19289
220840;201405;15139;48693;13769;45919;3640;12302;6558;22621;10198;34923
220850;201405;2816;10093;2696;9914;296;1160;2180;8078;2476;9238
220855;201405;633;1969;559;1835;51;193;409;1331;460;1524
220860;201405;957;2653;888;2543;50;199;724;2028;774;2227
220865;201405;2686;7535;2185;6712;123;559;1754;5240;1877;5799
220870;201405;2453;8130;2163;7769;121;469;1901;6848;2022;7317
220880;201405;5496;14366;5014;13779;275;853;4410;12129;4685;12982
220885;201405;1352;4792;1192;4509;121;571;881;3319;1002;3890
220887;201405;1406;3674;1224;3424;52;173;1093;3060;1145;3233
220890;201405;1643;5782;1460;5479;139;499;1167;4527;1306;5026
220900;201405;1949;5752;1738;5319;125;364;1401;4340;1526;4704
220910;201405;1731;5147;1539;4865;87;293;1334;4263;1421;4556
220915;201405;1058;3071;932;2850;55;239;734;2178;789;2417
220920;201405;1343;4971;1274;4876;147;643;929;3521;1076;4164
220930;201405;1499;4869;1334;4652;98;395;1092;3836;1190;4231
220935;201405;1068;3302;956;3074;72;315;694;2143;766;2458
220937;201405;1589;4388;1348;3964;79;290;1061;3035;1140;3325
220940;201405;1472;4526;1361;4290;115;436;1040;3254;1155;3690
220945;201405;496;1779;456;1669;61;258;315;1150;376;1408
220950;201405;1283;3287;929;2679;40;162;709;1992;749;2154
220955;201405;1632;4529;1383;4144;119;391;1071;3195;1190;3586
220960;201405;873;2407;746;2190;60;230;570;1642;630;1872
220965;201405;1703;5175;1612;5046;73;290;1397;4356;1470;4646
220970;201405;2159;5804;1589;4852;169;523;1084;3337;1253;3860
220975;201405;631;2243;628;2236;50;190;560;1991;610;2181
220980;201405;1508;4524;1346;4232;144;520;899;2917;1043;3437
220985;201405;1362;3948;1296;3850;141;471;979;2883;1120;3354
220987;201405;1511;4931;1407;4749;122;506;1059;3501;1181;4007
220990;201405;1827;5378;1603;4987;80;328;1244;3809;1324;4137
220995;201405;1251;3745;1010;3379;86;348;763;2573;849;2921
220997;201405;2129;6832;2030;6667;117;417;1831;6004;1948;6421
221000;201405;4519;14069;4206;13533;542;1886;3049;9796;3591;11682
221005;201405;1441;4611;1352;4438;413;1272;716;2471;1129;3743
221010;201405;1260;3400;1101;3190;73;216;927;2696;1000;2912
221020;201405;1940;6052;1815;5821;141;606;1370;4314;1511;4920
221030;201405;1823;5098;1588;4758;108;446;1261;3706;1369;4152
221035;201405;1585;4321;1437;4138;96;251;1261;3698;1357;3949
221037;201405;639;1970;577;1862;38;174;462;1428;500;1602
221038;201405;650;1845;519;1628;42;156;352;1107;394;1263
221039;201405;945;2778;884;2685;64;224;748;2243;812;2467
221040;201405;5249;16191;4968;15732;407;1412;3915;12540;4322;13952
221050;201405;3800;11746;3511;11329;229;889;2978;9549;3207;10438
221060;201405;9279;25446;7906;23548;890;2717;5941;17789;6831;20506
221062;201405;1291;4575;1207;4437;33;129;1127;4158;1160;4287
221063;201405;1148;3722;1070;3574;318;1027;608;2182;926;3209
221065;201405;2761;8126;2580;7832;326;945;1963;6025;2289;6970
221070;201405;4396;13515;3986;12880;285;1074;3168;10233;3453;11307
221080;201405;3545;9644;3185;9156;215;689;2635;7587;2850;8276
221090;201405;1360;3792;1194;3527;49;202;985;2851;1034;3053
221093;201405;1826;5477;1738;5304;392;1278;953;2840;1345;4118
221095;201405;1006;2704;864;2503;32;85;765;2232;797;2317
221097;201405;817;2358;723;2195;65;264;543;1623;608;1887
221100;201405;125942;386721;119216;375602;24258;83515;78778;243828;103036;327343
221110;201405;10205;33919;9758;33350;696;2667;8263;28260;8959;30927
221120;201405;4432;14798;4241;14455;1041;3537;2697;9455;3738;12992
221130;201405;4736;14158;4178;13037;1117;3629;2223;6925;3340;10554
221135;201405;1485;4737;1391;4594;167;617;1072;3521;1239;4138
221140;201405;1414;3605;1305;3461;110;300;1096;2914;1206;3214
221150;201405;1252;3254;1045;2896;37;159;829;2263;866;2422
221160;201405;910;2417;858;2336;61;187;655;1793;716;1980
221170;201405;1136;3663;1074;3542;74;304;879;2860;953;3164
230010;201405;3450;9429;2830;8360;187;651;2268;6686;2455;7337
230015;201405;2703;9596;2548;9259;401;1706;1750;6217;2151;7923
230020;201405;14479;48125;13992;47222;945;3490;11593;39374;12538;42864
230030;201405;12649;37527;11888;36331;923;3159;9600;29283;10523;32442
230040;201405;4586;13116;3920;11967;313;1135;3036;9157;3349;10292
230050;201405;2569;8939;2176;7926;398;1575;1058;3850;1456;5425
230060;201405;2042;6135;1817;5718;132;487;1377;4289;1509;4776
230070;201405;4740;13138;4196;12353;438;1327;3120;9406;3558;10733
230075;201405;8942;32892;8421;31806;876;4084;6422;23964;7298;28048
230080;201405;2350;6594;1992;6074;126;437;1618;4912;1744;5349
230090;201405;3514;10816;3153;10166;293;1133;2424;7723;2717;8856
230100;201405;17519;54471;16119;51812;4282;14467;8323;27079;12605;41546
230110;201405;14118;46695;13201;44764;2580;9422;7848;26574;10428;35996
230120;201405;8143;22625;7206;21333;826;2533;5398;16172;6224;18705
230125;201405;2956;8759;2474;7841;200;775;1837;5753;2037;6528
230130;201405;5676;19042;4837;17203;497;2092;3397;11927;3894;14019
230140;201405;3544;11588;3066;10705;463;1711;1993;7141;2456;8852
230150;201405;1772;5681;1559;5243;288;1111;983;3176;1271;4287
230160;201405;6441;19621;5659;18458;553;1993;4266;13984;4819;15977
230170;201405;6648;21233;5767;19585;568;2243;4178;14042;4746;16285
230180;201405;1959;5684;1725;5262;152;569;1214;3630;1366;4199
230185;201405;4232;14292;3924;13714;668;2310;2533;9214;3201;11524
230190;201405;12495;41657;11545;39749;2347;9122;6395;21761;8742;30883
230195;201405;5005;15822;4546;15078;340;1473;3556;11435;3896;12908
230200;201405;5765;17007;5184;15880;659;2112;3706;11380;4365;13492
230205;201405;4412;14063;3953;13286;348;1505;2880;9625;3228;11130
230210;201405;9356;27206;8236;25433;2296;7089;4274;13733;6570;20822
230220;201405;13754;40882;12569;38814;1773;6135;8667;26462;10440;32597
230230;201405;7531;25038;6779;23471;1046;3813;4278;14947;5324;18760
230240;201405;13549;39903;12264;37596;861;3308;9538;28702;10399;32010
230250;201405;10301;31918;10086;31606;523;1967;8554;26685;9077;28652
230260;201405;14925;51287;13901;49172;2959;10993;7846;28397;10805;39390
230270;201405;6860;21154;6085;19813;679;2395;4483;14680;5162;17075
230280;201405;19470;59629;17703;56564;2360;7709;12599;40586;14959;48295
230290;201405;5163;15979;4521;14695;654;2201;3029;9947;3683;12148
230300;201405;4814;15045;4622;14748;545;1989;3484;10991;4029;12980
230310;201405;4951;14981;4350;13974;386;1537;3220;10131;3606;11668
230320;201405;7471;24239;6975;23366;805;3014;5135;17279;5940;20293
230330;201405;4792;14427;4276;13424;388;1408;3075;9548;3463;10956
230340;201405;3442;12070;3233;11616;526;2124;2043;7183;2569;9307
230350;201405;18475;57333;16665;54198;2816;9811;10577;34836;13393;44647
230360;201405;3072;9167;2636;8371;334;1191;1870;5871;2204;7062
230365;201405;3025;8746;2674;8160;186;675;2082;6326;2268;7001
230370;201405;56188;187513;52076;180392;15319;54933;25823;92453;41142;147386
230380;201405;7179;21005;6162;19258;581;2046;4377;13695;4958;15741
230390;201405;3661;11715;3268;11071;399;1615;2286;7647;2685;9262
230393;201405;3404;11431;2930;10434;302;1442;2048;7036;2350;8478
230395;201405;4989;15909;4660;15278;707;2602;3078;10057;3785;12659
230400;201405;5216;16424;4559;15450;375;1626;3543;11762;3918;13388
230410;201405;15883;50794;14305;47828;2540;9053;8554;28711;11094;37764
230420;201405;24592;82328;23004;79063;5726;21344;11714;40130;17440;61474
230423;201405;4856;15930;4516;15285;542;2035;3132;10784;3674;12819
230425;201405;5528;18780;5076;17737;706;2690;3463;12059;4169;14749
230426;201405;2850;8038;2349;7110;162;653;1733;5114;1895;5767
230427;201405;1786;5494;1363;4562;136;524;914;2959;1050;3483
230428;201405;9228;30529;9001;30134;1767;6594;5796;19223;7563;25817
230430;201405;4639;15174;4385;14676;459;1837;3189;10521;3648;12358
230435;201405;5093;16820;4578;15903;1013;3890;2406;8446;3419;12336
230440;201405;360950;1130914;339902;1092930;86516;297731;172808;558528;259324;856259
230445;201405;4759;12999;4044;11964;362;1062;3039;9189;3401;10251
230450;201405;3727;12089;3209;11153;471;1870;2079;7227;2550;9097
230460;201405;1940;6484;1773;6166;201;814;1264;4361;1465;5175
230465;201405;4266;12888;3488;11467;320;1377;2350;7514;2670;8891
230470;201405;11416;42034;10987;41174;1467;5777;7989;30448;9456;36225
230480;201405;1486;4855;1293;4480;212;769;829;2896;1041;3665
230490;201405;2976;8774;2617;8115;498;1732;1377;4212;1875;5944
230495;201405;5755;19524;5235;18661;899;3721;3085;11058;3984;14779
230500;201405;10734;36806;10273;36010;939;3617;7842;28073;8781;31690
230510;201405;1530;5531;1269;4873;312;1299;526;2082;838;3381
230520;201405;5067;15541;4458;14457;491;1883;3053;9821;3544;11704
230523;201405;13897;46752;12719;44041;3732;14145;3883;13694;7615;27839
230526;201405;4214;13068;3722;12203;411;1553;2656;8720;3067;10273
230530;201405;5362;17959;4917;17362;979;3513;3324;11924;4303;15437
230533;201405;4039;11575;3605;10752;263;876;2775;8181;3038;9057
230535;201405;5474;16485;4836;15337;527;1752;3520;11295;4047;13047
230540;201405;19149;55528;17020;52355;1106;4094;13977;42685;15083;46779
230550;201405;20139;61843;18414;58567;4197;14325;9936;31387;14133;45712
230560;201405;6594;19254;5922;18040;281;1133;4779;14389;5060;15522
230565;201405;3309;9703;2706;8494;272;957;1876;5832;2148;6789
230570;201405;4004;11019;3571;10469;246;887;2952;8556;3198;9443
230580;201405;10490;32521;9979;31794;596;1962;8675;27921;9271;29883
230590;201405;9381;30010;8474;28348;801;3306;6275;20596;7076;23902
230600;201405;3647;10423;2747;8551;204;717;1854;5705;2058;6422
230610;201405;6214;20576;5831;19969;781;2866;4216;14593;4997;17459
230620;201405;2105;6035;1747;5291;160;575;1115;3282;1275;3857
230625;201405;7699;25889;6946;24152;2080;7799;2360;8262;4440;16061
230630;201405;11297;37230;10368;35426;2562;8392;5328;19297;7890;27689
230640;201405;27215;91122;25597;88699;3608;13252;18796;65726;22404;78978
230650;201405;4980;16010;4569;15196;401;1673;3475;11339;3876;13012
230655;201405;8750;33424;8431;32895;685;2798;7101;28056;7786;30854
230660;201405;6414;20281;5667;18941;559;2187;4087;13750;4646;15937
230670;201405;6019;16555;4924;14686;287;1103;3807;11024;4094;12127
230680;201405;2839;8374;2394;7551;368;1252;1477;4657;1845;5909
230690;201405;6334;21117;6200;20860;523;2200;4529;14959;5052;17159
230700;201405;9335;27493;8319;25688;867;3291;5779;17332;6646;20623
230710;201405;7692;25159;6860;23622;843;2928;5009;17617;5852;20545
230720;201405;1971;6240;1709;5737;228;829;1139;3857;1367;4686
230725;201405;3792;12895;3379;11884;721;2716;1799;6238;2520;8954
230730;201405;57133;177175;48720;163896;13322;48414;22073;75736;35395;124150
230740;201405;5553;17557;5190;16899;304;1316;4294;13772;4598;15088
230750;201405;9104;26527;7791;24393;711;2588;5911;18409;6622;20997
230760;201405;10002;31015;9610;30130;1152;4410;6965;20951;8117;25361
230763;201405;4211;13510;3961;13007;315;1434;3015;9537;3330;10971
230765;201405;42017;139409;39137;133519;12618;45931;14510;50294;27128;96225
230770;201405;23931;67663;22210;65207;2202;7136;16536;48504;18738;55640
230780;201405;6047;23993;5803;23397;1440;5837;3029;12992;4469;18829
230790;201405;2588;8883;2473;8681;292;1103;1905;6746;2197;7849
230800;201405;7958;28907;7325;27468;1792;7203;3564;13430;5356;20633
230810;201405;12603;41517;12032;40553;1385;4815;9264;31728;10649;36543
230820;201405;3483;11949;3095;11108;576;2333;1749;6273;2325;8606
230830;201405;7926;24257;7107;22757;777;2859;4978;15874;5755;18733
230835;201405;4169;11481;3553;10623;311;1036;2757;8208;3068;9244
230837;201405;3167;10977;2761;10136;373;1559;1845;6796;2218;8355
230840;201405;9488;31663;8698;30254;1194;4447;6083;21500;7277;25947
230850;201405;11412;34941;10636;33921;1333;4689;7901;25192;9234;29881
230860;201405;5078;15457;4680;14710;383;1440;3566;11131;3949;12571
230870;201405;19138;53415;17231;50278;1618;5333;13009;37753;14627;43086
230880;201405;1933;6784;1799;6513;246;1045;1190;4278;1436;5323
230890;201405;4137;15116;3781;14372;561;2493;2428;9086;2989;11579
230900;201405;3013;10211;2644;9432;561;1947;1414;5207;1975;7154
230910;201405;3005;9181;2465;8144;253;1006;1739;5636;1992;6642
230920;201405;4724;13974;4354;13513;326;1088;3622;11412;3948;12500
230930;201405;7853;24230;7085;22803;888;3017;4928;15942;5816;18959
230940;201405;7713;22202;6835;20901;403;1270;5675;17505;6078;18775
230945;201405;5907;18100;5107;16951;586;2120;3617;12199;4203;14319
230950;201405;7011;19479;6029;18146;432;1420;4718;14280;5150;15700
230960;201405;12720;41194;11723;39260;2553;9316;6008;20199;8561;29515
230970;201405;13603;43869;12357;41426;2658;10083;6261;20590;8919;30673
230980;201405;2920;9620;2604;8973;820;2852;1164;4202;1984;7054
230990;201405;1618;5070;1339;4485;155;646;885;2894;1040;3540
231000;201405;2882;7874;2304;6773;286;963;1460;4163;1746;5126
231010;201405;3142;8965;2718;8292;273;1076;2059;6162;2332;7238
231020;201405;8191;27556;7745;26654;1372;4886;4914;17289;6286;22175
231025;201405;7894;25145;7128;23799;1158;3992;4643;15864;5801;19856
231030;201405;8101;26864;6919;24399;1360;5139;4016;14349;5376;19488
231040;201405;3016;10132;2735;9555;251;1065;1939;6671;2190;7736
231050;201405;12223;35898;10709;33141;1088;3842;7770;23965;8858;27807
231060;201405;2441;7888;2246;7536;195;888;1623;5288;1818;6176
231070;201405;9378;29944;8665;28532;1598;5558;5308;17623;6906;23181
231080;201405;4333;13692;3989;13082;273;1224;2994;9480;3267;10704
231085;201405;4795;15587;4654;15349;688;2310;3447;11610;4135;13920
231090;201405;4100;11698;3391;10294;203;766;2473;7375;2676;8141
231095;201405;2239;7579;1953;7011;230;904;1357;4935;1587;5839
231100;201405;3055;9622;2565;8631;225;872;1850;6145;2075;7017
231110;201405;3776;12752;3685;12594;379;1432;2725;9375;3104;10807
231120;201405;2435;8009;2269;7717;381;1343;1489;5143;1870;6486
231123;201405;2240;6154;1910;5604;159;457;1514;4469;1673;4926
231126;201405;6768;18897;5545;17135;432;1626;4212;12843;4644;14469
231130;201405;20366;64361;18707;61444;4538;15249;10298;35273;14836;50522
231135;201405;4685;13875;3961;12744;416;1604;2902;9176;3318;10780
231140;201405;15728;51717;14533;49304;1454;6583;10095;33045;11549;39628
231150;201405;5977;17681;5147;16116;989;3432;2818;8606;3807;12038
231160;201405;5901;20272;5617;19729;1250;4644;3530;12431;4780;17075
231170;201405;4806;15572;4439;14824;520;2050;3019;9943;3539;11993
231180;201405;15117;46341;13867;43918;2650;9047;8533;26762;11183;35809
231190;201405;5105;14339;4269;13142;334;1197;3308;10085;3642;11282
231195;201405;4630;15969;4033;14790;398;1725;2969;10915;3367;12640
231200;201405;7710;27088;6850;25344;719;3366;4850;17607;5569;20973
231210;201405;5178;16114;4487;15137;325;1382;3470;11795;3795;13177
231220;201405;14258;41057;12204;37542;1312;4703;8060;24869;9372;29572
231230;201405;8789;31369;8250;30407;943;3986;6265;23092;7208;27078
231240;201405;12001;38806;10860;36684;1786;6750;6589;22466;8375;29216
231250;201405;2060;6046;1436;4530;297;939;592;1786;889;2725
231260;201405;4043;11592;3674;11072;514;1578;2503;7722;3017;9300
231270;201405;7751;21963;6900;20591;653;2533;5037;14646;5690;17179
231280;201405;1753;5835;1646;5620;159;577;1220;4197;1379;4774
231290;201405;33691;119714;30967;113069;7752;31162;13377;47837;21129;78999
231300;201405;4661;13752;3833;12074;347;1337;2732;8336;3079;9673
231310;201405;7599;22143;6452;19807;1250;4004;3510;10677;4760;14681
231320;201405;7004;21936;6198;20349;445;1765;4630;15152;5075;16917
231325;201405;2588;8001;2320;7527;174;666;1742;5659;1916;6325
231330;201405;14276;44723;12131;40615;2011;6874;7587;25739;9598;32613
231335;201405;5192;15146;4573;14015;333;1294;3624;10870;3957;12164
231340;201405;18163;59944;17069;58395;1442;4771;13846;48677;15288;53448
231350;201405;12414;42351;12169;41975;1338;4487;9889;34780;11227;39267
231355;201405;4292;14167;4128;13888;276;983;3460;11775;3736;12758
231360;201405;7346;24464;6769;23451;1641;5549;4003;14460;5644;20009
231370;201405;2427;6927;1953;6200;117;441;1481;4646;1598;5087
231375;201405;4109;14331;3913;13957;362;1616;3057;10740;3419;12356
231380;201405;5291;17421;4981;16988;798;2828;3406;11933;4204;14761
231390;201405;3477;11070;3283;10780;279;1127;2475;8050;2754;9177
231395;201405;4252;13794;3809;13070;761;2743;2299;8026;3060;10769
231400;201405;10517;31719;9625;30096;1039;3726;6714;21074;7753;24800
231410;201405;13527;46920;12708;45691;1219;4513;9905;36273;11124;40786
240010;201405;2500;7850;2198;7189;554;2001;990;3125;1544;5126
240020;201405;11934;37754;10685;35389;2760;9680;5087;17174;7847;26854
240030;201405;2583;7681;2510;7565;215;789;2002;5932;2217;6721
240040;201405;814;2461;696;2235;49;228;499;1532;548;1760
240050;201405;3748;10315;3249;9463;233;819;2474;7111;2707;7930
240060;201405;1460;4400;1381;4267;137;509;1058;3175;1195;3684
240070;201405;2885;8405;2752;8159;466;1461;1809;5283;2275;6744
240080;201405;3171;8543;2806;8066;276;745;2185;6415;2461;7160
240090;201405;2266;6257;1933;5622;76;304;1534;4364;1610;4668
240100;201405;10407;30188;9681;28775;1311;4595;6040;17744;7351;22339
240110;201405;5234;16093;4674;15085;842;3075;2857;8900;3699;11975
240120;201405;3037;10165;2927;9965;560;2040;1867;6495;2427;8535
240130;201405;2838;7819;2451;7227;215;752;1894;5517;2109;6269
240140;201405;2206;6891;1968;6430;396;1460;1085;3494;1481;4954
240145;201405;6266;19811;5663;18738;1464;5390;2927;9681;4391;15071
240150;201405;1024;3142;846;2788;125;494;512;1626;637;2120
240160;201405;1490;4873;1348;4622;193;749;870;3009;1063;3758
240165;201405;933;3032;830;2820;106;374;543;1886;649;2260
240170;201405;2550;7765;2298;7292;612;2086;1059;3380;1671;5466
240180;201405;2999;9468;2809;9137;718;2418;1507;5098;2225;7516
240185;201405;1515;5069;1465;4981;182;647;1093;3781;1275;4428
240190;201405;910;2824;848;2700;67;289;642;1983;709;2272
240200;201405;14639;38048;12297;35194;2466;6981;7621;22893;10087;29874
240210;201405;2802;8053;2590;7770;232;794;2136;6365;2368;7159
240220;201405;7340;24010;7008;23543;407;1788;6080;20199;6487;21987
240230;201405;5591;15880;5135;15088;460;1507;4013;11687;4473;13194
240240;201405;1850;5819;1422;4694;416;1477;313;921;729;2398
240250;201405;2886;8400;2744;8196;219;772;2209;6518;2428;7290
240260;201405;15035;50691;14347;49565;2432;9390;9461;32793;11893;42183
240270;201405;2451;7986;2283;7711;248;823;1699;5889;1947;6712
240280;201405;1672;4785;1498;4481;133;469;1105;3267;1238;3736
240290;201405;1437;4526;1239;4163;118;564;799;2578;917;3142
240300;201405;2200;6229;1594;4884;420;1391;559;1645;979;3036
240310;201405;10541;30284;9631;28804;2214;7173;5145;15395;7359;22568
240320;201405;2070;6204;1703;5439;119;504;1218;3756;1337;4260
240325;201405;38744;108185;30799;95078;9707;32053;9850;31234;19557;63287
240330;201405;1569;4763;1330;4285;165;668;831;2578;996;3246
240340;201405;1740;5154;1526;4814;205;687;1085;3432;1290;4119
240350;201405;2174;6586;2038;6393;225;811;1642;5101;1867;5912
240360;201405;7488;22733;6580;21394;1122;3829;4207;14074;5329;17903
240370;201405;2053;5688;1798;5261;153;519;1326;3867;1479;4386
240375;201405;903;2405;806;2266;156;486;476;1306;632;1792
240380;201405;2719;8142;2245;7093;322;1082;1318;4126;1640;5208
240390;201405;948;2665;797;2370;78;295;568;1641;646;1936
240400;201405;1486;4022;1275;3701;145;497;933;2623;1078;3120
240410;201405;549;1790;502;1693;80;319;324;1077;404;1396
240420;201405;4940;18825;4751;18398;1363;5183;2486;10240;3849;15423
240430;201405;3560;10337;3299;9887;341;1148;2422;7218;2763;8366
240440;201405;2772;7467;2575;7121;656;1871;1406;3917;2062;5788
240450;201405;4019;12014;3622;11278;543;1968;2257;6930;2800;8898
240460;201405;2933;9352;2818;9186;282;1079;2249;7262;2531;8341
240470;201405;3651;11306;2961;9844;391;1452;1831;5999;2222;7451
240480;201405;451;1182;391;1055;42;109;243;644;285;753
240485;201405;2150;6598;1913;6155;369;1291;1118;3609;1487;4900
240490;201405;1692;4326;1476;4017;89;328;1157;3031;1246;3359
240500;201405;2137;6485;2043;6325;209;708;1567;4857;1776;5565
240510;201405;1816;5567;1686;5328;217;714;1263;4026;1480;4740
240520;201405;1461;4270;1288;4018;200;705;889;2710;1089;3415
240530;201405;2236;7132;2009;6769;261;923;1441;4895;1702;5818
240540;201405;1861;5714;1791;5594;169;599;1361;4249;1530;4848
240550;201405;818;2340;717;2170;63;224;549;1616;612;1840
240560;201405;3323;9732;3149;9474;307;936;2554;7722;2861;8658
240570;201405;3136;8997;2588;7790;591;2033;1184;3269;1775;5302
240580;201405;8231;25638;7762;24842;1172;3964;5734;18298;6906;22262
240590;201405;850;2425;754;2255;60;227;553;1619;613;1846
240600;201405;1541;4606;1240;3986;171;638;714;2199;885;2837
240610;201405;5071;14340;4422;13143;619;1984;2747;8008;3366;9992
240615;201405;1065;3088;887;2749;155;505;508;1571;663;2076
240620;201405;1716;5612;1591;5389;200;758;1208;4089;1408;4847
240630;201405;2079;6424;1974;6248;206;581;1479;4897;1685;5478
240640;201405;936;2782;792;2544;97;396;527;1652;624;2048
240650;201405;3785;11850;3509;11445;302;1082;2799;9200;3101;10282
240660;201405;2532;8140;2423;7961;271;958;1833;6091;2104;7049
240670;201405;2775;8359;2360;7522;345;1253;1355;4224;1700;5477
240680;201405;1527;4520;1246;4011;146;512;767;2488;913;3000
240690;201405;1121;3155;981;2929;109;382;710;2097;819;2479
240700;201405;2695;8136;2265;7326;131;604;1744;5475;1875;6079
240710;201405;18783;48314;16709;45643;3222;8672;10479;29638;13701;38310
240720;201405;5692;16545;5434;16155;1606;5076;2711;8013;4317;13089
240725;201405;1085;3274;838;2723;83;293;485;1542;568;1835
240730;201405;2331;7195;2057;6686;217;783;1453;4693;1670;5476
240740;201405;2281;6870;2052;6451;274;918;1350;4262;1624;5180
240750;201405;2279;8482;2103;8153;417;1783;1236;4851;1653;6634
240760;201405;1274;3781;1200;3681;116;297;952;3090;1068;3387
240770;201405;3598;10517;3285;10053;404;1358;2387;7332;2791;8690
240780;201405;5863;16566;4800;14900;810;2671;2902;9148;3712;11819
240790;201405;869;2705;707;2405;59;242;519;1771;578;2013
240800;201405;41496;120937;37787;114593;10619;33890;16580;51145;27199;85035
240810;201405;96483;289954;90910;279897;27953;88584;43689;137047;71642;225631
240820;201405;6990;20963;6058;19496;1201;4174;3246;10848;4447;15022
240830;201405;9509;29275;8971;28501;716;2409;7376;23803;8092;26212
240840;201405;1318;3689;1141;3395;132;446;699;2063;831;2509
240850;201405;1210;3722;949;3179;193;718;492;1581;685;2299
240860;201405;1330;3788;1141;3481;103;361;839;2508;942;2869
240870;201405;1179;3299;1007;2965;132;467;654;1824;786;2291
240880;201405;1202;4137;1138;4043;154;638;820;2892;974;3530
240890;201405;5487;15617;4804;14400;911;2975;2609;7744;3520;10719
240895;201405;2807;9635;2561;9192;352;1362;1786;6517;2138;7879
240910;201405;2731;8661;2510;8243;240;941;1883;6133;2123;7074
240920;201405;877;2853;799;2677;205;755;403;1305;608;2060
240930;201405;3701;9982;3343;9516;309;902;2646;7642;2955;8544
240933;201405;1520;4473;1358;4196;242;847;815;2521;1057;3368
240940;201405;6671;18899;5670;17146;1114;3533;3138;9500;4252;13033
240950;201405;1182;3723;1122;3625;117;478;804;2583;921;3061
240960;201405;796;2518;718;2364;85;327;518;1691;603;2018
240970;201405;1953;5558;1650;5036;130;471;1222;3661;1352;4132
240980;201405;3343;11062;3133;10665;675;2465;1931;6590;2606;9055
240990;201405;3085;9232;2901;8866;528;1808;1847;5516;2375;7324
241000;201405;1101;3115;967;2885;91;330;702;2055;793;2385
241010;201405;3023;10196;2743;9683;440;1809;1865;6426;2305;8235
241020;201405;2121;6058;1775;5393;164;597;1117;3266;1281;3863
241025;201405;1563;4852;1433;4602;122;502;1028;3231;1150;3733
241030;201405;2569;8480;2331;8057;193;745;1827;6357;2020;7102
241040;201405;2202;7689;2028;7371;215;901;1484;5446;1699;6347
241050;201405;1347;4029;1224;3816;113;443;912;2767;1025;3210
241060;201405;1004;2901;918;2760;115;368;675;2030;790;2398
241070;201405;929;2679;815;2471;101;368;565;1654;666;2022
241080;201405;1194;3592;1042;3313;93;388;726;2235;819;2623
241090;201405;2163;6288;1864;5755;122;516;1524;4629;1646;5145
241100;201405;1215;3663;1058;3304;101;355;712;2196;813;2551
241105;201405;1168;3614;1106;3495;185;629;671;2190;856;2819
241110;201405;862;2758;730;2473;79;349;450;1486;529;1835
241120;201405;7964;24281;7275;23182;1372;4426;4897;15992;6269;20418
241140;201405;3510;9883;3126;9129;412;1280;2130;6135;2542;7415
241142;201405;708;2136;515;1712;135;515;154;467;289;982
241150;201405;5841;17634;5361;16798;856;2859;3592;11353;4448;14212
241160;201405;1135;3322;1069;3197;169;551;744;2211;913;2762
241170;201405;1376;4058;1261;3843;177;590;783;2486;960;3076
241180;201405;1029;2819;818;2434;108;360;482;1372;590;1732
241190;201405;1117;3138;951;2811;76;298;638;1782;714;2080
241200;201405;21124;63451;19568;60949;5151;16792;10208;32479;15359;49271
241210;201405;1546;4534;1306;4048;273;938;647;1985;920;2923
241220;201405;8032;27243;7650;26501;1843;6624;4323;15355;6166;21979
241230;201405;3086;9266;2817;8878;219;821;2272;7117;2491;7938
241240;201405;1118;3293;860;2727;94;306;497;1644;591;1950
241250;201405;5590;17801;4857;16332;308;1510;3877;12704;4185;14214
241255;201405;1866;7156;1772;6947;470;1940;812;3309;1282;5249
241260;201405;5142;13930;4169;12418;343;1286;2991;8745;3334;10031
241270;201405;2084;6300;1834;5814;265;934;1090;3470;1355;4404
241280;201405;2171;6355;2021;6061;327;1047;1337;4049;1664;5096
241290;201405;3318;9251;2683;8234;481;1532;1605;4941;2086;6473
241300;201405;1446;4217;1289;3956;76;251;1011;3129;1087;3380
241310;201405;1556;4925;1482;4806;218;669;1051;3537;1269;4206
241320;201405;922;3103;856;2963;161;605;490;1706;651;2311
241330;201405;1540;4911;1449;4786;150;587;1176;3857;1326;4444
241335;201405;2663;8229;2515;7974;185;601;2112;6718;2297;7319
241340;201405;1968;6143;1757;5688;444;1566;859;2741;1303;4307
241350;201405;1953;6308;1834;6078;177;762;1387;4460;1564;5222
241355;201405;1286;3663;1139;3409;66;219;998;2963;1064;3182
241360;201405;2152;5991;1896;5504;140;486;1383;3860;1523;4346
241370;201405;1353;4199;1104;3669;194;713;586;1906;780;2619
241380;201405;729;2120;632;1923;101;360;352;1064;453;1424
241390;201405;2966;9926;2803;9620;574;2077;1779;6226;2353;8303
241400;201405;3720;11048;3465;10692;405;1416;2636;8152;3041;9568
241410;201405;2738;8110;2470;7749;409;1375;1727;5439;2136;6814
241415;201405;1617;4964;1504;4761;112;448;1141;3550;1253;3998
241420;201405;2249;7863;1977;7387;672;2799;672;2454;1344;5253
241430;201405;489;1503;428;1356;56;204;280;856;336;1060
241440;201405;6036;22190;5658;21537;989;3956;3980;15339;4969;19295
241445;201405;1048;3234;990;3147;145;378;771;2600;916;2978
241450;201405;3305;9265;3032;8877;461;1495;2132;6182;2593;7677
241460;201405;3609;10605;3227;9868;289;1070;2329;7051;2618;8121
241470;201405;1345;3847;1170;3633;130;507;868;2633;998;3140
241475;201405;1242;3911;1093;3636;76;365;788;2557;864;2922
241480;201405;3273;10699;2991;10271;1029;3521;1200;4544;2229;8065
241490;201405;639;1729;527;1557;55;220;363;1017;418;1237
241500;201405;748;2347;700;2284;27;128;643;2069;670;2197
250010;201405;2745;8691;2418;8114;247;1011;1784;5862;2031;6873
250020;201405;1688;4897;1304;4202;113;494;852;2636;965;3130
250030;201405;8048;23072;7299;22029;873;2646;5552;17106;6425;19752
250040;201405;4532;15321;4199;14674;784;2896;2632;9294;3416;12190
250050;201405;3680;11634;3465;11325;488;1759;2429;8075;2917;9834
250053;201405;1337;3964;1249;3846;202;646;835;2584;1037;3230
250057;201405;715;2755;697;2733;37;108;617;2541;654;2649
250060;201405;5013;15934;4819;15617;662;2424;3643;11630;4305;14054
250070;201405;3899;12267;3673;11876;265;1148;3014;9480;3279;10628
250073;201405;795;2415;710;2257;78;284;515;1628;593;1912
250077;201405;2296;6752;1927;6158;273;951;1132;3653;1405;4604
250080;201405;4787;14061;4628;13834;564;1753;3491;10491;4055;12244
250090;201405;2657;7965;2560;7810;137;494;2151;6454;2288;6948
250100;201405;4006;13541;3829;13222;446;1738;2936;10107;3382;11845
250110;201405;5755;17568;5507;17218;744;2599;4167;12953;4911;15552
250115;201405;550;1817;486;1669;50;237;293;944;343;1181
250120;201405;2245;6701;1937;6124;193;704;1432;4491;1625;5195
250130;201405;5756;17635;5434;17182;331;1177;4554;14560;4885;15737
250135;201405;1081;3357;993;3205;121;434;703;2282;824;2716
250140;201405;2132;6939;1968;6721;242;871;1473;5132;1715;6003
250150;201405;5058;17170;4651;16399;496;2063;3376;11784;3872;13847
250153;201405;1582;4232;1430;4011;127;445;1112;3104;1239;3549
250157;201405;1686;5859;1557;5582;340;1221;912;3379;1252;4600
250160;201405;3355;10501;3254;10335;216;773;2790;8929;3006;9702
250170;201405;1616;4763;1514;4602;306;971;964;3004;1270;3975
250180;201405;16859;52843;16321;51923;2444;8981;11584;35982;14028;44963
250190;201405;4038;12013;3751;11525;611;1991;2505;7607;3116;9598
250200;201405;2229;6228;1780;5613;140;518;1464;4578;1604;5096
250205;201405;1008;3349;920;3180;95;438;594;2103;689;2541
250210;201405;1647;5401;1526;5222;178;745;1104;3716;1282;4461
250215;201405;1435;4934;1397;4861;215;835;891;3107;1106;3942
250220;201405;819;2340;677;2159;49;182;581;1833;630;2015
250230;201405;1740;4444;1420;3915;135;431;1112;2986;1247;3417
250240;201405;2682;8588;2375;8114;219;806;1813;6276;2032;7082
250250;201405;4598;13941;4219;13427;379;1253;3429;11034;3808;12287
250260;201405;1916;5851;1681;5455;152;593;1252;4022;1404;4615
250270;201405;1311;4162;1190;4007;156;551;896;3062;1052;3613
250280;201405;3812;11536;3524;11073;683;2178;2277;7471;2960;9649
250290;201405;2146;5732;1772;5248;64;234;1556;4605;1620;4839
250300;201405;5518;16422;5227;16058;603;2473;4181;12307;4784;14780
250310;201405;1167;3715;1059;3532;153;586;769;2532;922;3118
250320;201405;7955;25202;7571;24409;1125;4093;5130;16112;6255;20205
250330;201405;2599;8199;2271;7746;274;1065;1722;5835;1996;6900
250340;201405;1150;3342;1069;3221;57;192;914;2754;971;2946
250350;201405;4577;12535;4178;12043;192;623;3648;10645;3840;11268
250355;201405;2162;6617;1970;6331;156;659;1521;4804;1677;5463
250360;201405;2061;6197;1919;5999;114;430;1520;4776;1634;5206
250370;201405;13718;39062;11918;36904;1005;3208;10118;31596;11123;34804
250375;201405;1111;3522;1049;3417;65;261;881;2866;946;3127
250380;201405;1679;4799;1593;4691;96;323;1392;4093;1488;4416
250390;201405;1958;5270;1617;4704;210;642;1083;3179;1293;3821
250400;201405;70239;195426;62330;183764;15016;46671;34265;103154;49281;149825
250403;201405;1540;5105;1460;4992;184;732;1086;3654;1270;4386
250407;201405;1160;3378;1009;3119;64;217;794;2426;858;2643
250410;201405;684;2182;602;2035;69;286;456;1526;525;1812
250415;201405;1822;5788;1676;5507;125;486;1266;4095;1391;4581
250420;201405;1333;4172;1232;4015;98;395;1018;3249;1116;3644
250430;201405;6684;18797;6298;18233;515;1796;5144;14614;5659;16410
250435;201405;1654;5016;1480;4684;216;788;882;2853;1098;3641
250440;201405;4617;13755;4357;13402;287;973;3639;11218;3926;12191
250450;201405;2088;5953;1860;5652;97;327;1659;5051;1756;5378
250460;201405;6420;19566;5994;18984;727;2445;4556;14591;5283;17036
250470;201405;1617;4500;1466;4284;151;540;1057;2999;1208;3539
250480;201405;4042;12128;3649;11560;167;686;3145;9913;3312;10599
250485;201405;628;1655;533;1496;27;99;421;1138;448;1237
250490;201405;4191;13677;4092;13531;848;2997;2673;8864;3521;11861
250500;201405;1918;5901;1790;5684;335;1094;1111;3605;1446;4699
250510;201405;4974;14034;4405;13255;316;1140;3613;10828;3929;11968
250520;201405;1913;5933;1819;5771;333;1187;1084;3364;1417;4551
250523;201405;1811;5761;1722;5638;233;793;1284;4262;1517;5055
250527;201405;1489;4516;1403;4404;62;261;1260;3915;1322;4176
250530;201405;678;2099;595;1991;50;171;488;1659;538;1830
250535;201405;1318;4241;1255;4112;83;361;1001;3218;1084;3579
250540;201405;2487;7397;2335;7228;85;265;2146;6714;2231;6979
250550;201405;910;3042;840;2931;67;277;643;2217;710;2494
250560;201405;1769;5701;1731;5646;143;513;1467;4796;1610;5309
250570;201405;2544;8407;2296;7924;203;806;1756;6015;1959;6821
250580;201405;1159;3201;955;2871;117;471;664;1898;781;2369
250590;201405;1059;3252;956;3116;86;356;744;2380;830;2736
250600;201405;7171;21077;6820;20561;500;1467;5702;17393;6202;18860
250610;201405;3484;10246;3243;9879;393;1318;2315;7037;2708;8355
250620;201405;867;2525;804;2400;143;465;520;1528;663;1993
250625;201405;2219;7268;2185;7222;83;215;2025;6796;2108;7011
250630;201405;10472;33939;9952;33018;2265;8048;5712;18996;7977;27044
250640;201405;3907;11647;3659;11356;294;1106;3072;9420;3366;10526
250650;201405;938;2772;880;2661;154;546;505;1557;659;2103
250660;201405;2147;5286;1647;4690;27;70;1563;4474;1590;4544
250670;201405;2751;9261;2614;9008;287;1182;1932;6635;2219;7817
250680;201405;5023;14423;4779;14079;270;909;4120;12171;4390;13080
250690;201405;6384;17112;6170;16825;578;1740;5247;14176;5825;15916
250700;201405;5386;16190;5022;15650;827;2786;3432;10603;4259;13389
250710;201405;4616;14719;4248;14237;672;2296;2990;10306;3662;12602
250720;201405;2588;7831;2471;7629;155;608;2053;6289;2208;6897
250730;201405;3718;11607;3553;11359;481;1689;2596;8250;3077;9939
250740;201405;2049;6095;1797;5662;211;771;1282;3979;1493;4750
250750;201405;103945;308801;98289;300081;17838;59594;65046;196432;82884;256026
250760;201405;2268;6761;2111;6523;197;743;1620;4942;1817;5685
250770;201405;4001;13785;3806;13517;718;2761;2435;8699;3153;11460
250780;201405;1913;5747;1662;5281;207;801;1081;3333;1288;4134
250790;201405;2484;8160;2353;7973;552;1837;1517;5316;2069;7153
250800;201405;2804;8140;2457;7554;159;580;1891;5692;2050;6272
250810;201405;1373;4070;1196;3809;111;450;950;2962;1061;3412
250820;201405;2036;6311;1988;6236;129;439;1667;5286;1796;5725
250830;201405;5998;19994;5681;19350;782;3105;3915;13112;4697;16217
250840;201405;1046;3362;912;3089;124;475;581;1975;705;2450
250850;201405;2450;7134;2185;6705;225;878;1424;4525;1649;5403
250855;201405;1099;3323;1041;3232;76;271;857;2625;933;2896
250860;201405;2930;10004;2709;9577;654;2564;1163;4056;1817;6620
250870;201405;1224;3506;1061;3242;75;291;773;2293;848;2584
250880;201405;1420;4175;1295;3997;198;634;899;2780;1097;3414
250890;201405;9616;30795;8971;29903;1569;5964;5983;19673;7552;25637
250900;201405;3092;10249;2756;9618;340;1215;1931;6857;2271;8072
250905;201405;2124;6721;2027;6593;351;1188;1445;4759;1796;5947
250910;201405;5485;16071;5127;15528;521;1721;3954;11990;4475;13711
250915;201405;1738;5199;1597;4992;145;452;1324;4205;1469;4657
250920;201405;3598;10306;3384;10005;466;1317;2435;7463;2901;8780
250930;201405;1992;6520;1909;6393;348;1340;1321;4347;1669;5687
250933;201405;1207;3907;1162;3833;135;467;856;2859;991;3326
250937;201405;877;2739;787;2556;115;452;482;1562;597;2014
250939;201405;1738;5405;1571;5136;226;787;1040;3396;1266;4183
250940;201405;4026;11878;3740;11430;252;889;2957;9111;3209;10000
250950;201405;1377;4308;1260;4158;89;295;1039;3492;1128;3787
250960;201405;1357;4256;1209;4059;75;277;1019;3472;1094;3749
250970;201405;9131;25077;8188;23749;1210;3548;5705;16699;6915;20247
250980;201405;2688;8198;2484;7841;259;1032;1720;5239;1979;6271
250990;201405;2150;7438;2018;7175;304;1244;1394;4889;1698;6133
251000;201405;2590;7404;2133;6749;142;523;1707;5385;1849;5908
251010;201405;2874;8359;2624;7993;201;726;2081;6372;2282;7098
251020;201405;1678;5124;1553;4968;147;513;1287;4154;1434;4667
251030;201405;1338;3761;1214;3554;131;445;792;2331;923;2776
251040;201405;1951;6231;1764;5944;185;858;1268;4125;1453;4983
251050;201405;1158;3447;1028;3218;174;578;586;1907;760;2485
251060;201405;1069;2599;866;2346;94;325;665;1727;759;2052
251065;201405;595;1782;521;1670;70;259;324;994;394;1253
251070;201405;616;1766;575;1710;62;247;444;1234;506;1481
251080;201405;21611;60704;20159;58281;5279;15788;11052;32501;16331;48289
251090;201405;3069;9778;2744;9179;280;1096;1990;6591;2270;7687
251100;201405;1012;3288;908;3102;134;546;609;2020;743;2566
251110;201405;2158;6271;1927;5870;219;737;1335;4073;1554;4810
251120;201405;5999;20695;5820;20380;756;3126;4538;15605;5294;18731
251130;201405;4019;10532;3606;10074;45;136;3476;9733;3521;9869
251140;201405;4487;13881;4178;13399;246;969;3268;10455;3514;11424
251150;201405;2828;9235;2594;8905;337;1287;1885;6560;2222;7847
251160;201405;1903;6337;1825;6232;102;401;1588;5439;1690;5840
251170;201405;1436;4495;1393;4442;132;492;1139;3591;1271;4083
251180;201405;2937;8845;2701;8539;578;1855;1624;5264;2202;7119
251190;201405;4387;12635;4258;12483;285;858;3788;11133;4073;11991
251200;201405;4243;13178;4042;12916;232;819;3547;11378;3779;12197
251203;201405;1348;4243;1261;4059;117;489;783;2617;900;3106
251207;201405;1241;3881;1079;3577;93;389;747;2419;840;2808
251210;201405;8248;23722;7226;22345;992;3005;5332;16895;6324;19900
251220;201405;1309;3566;1147;3314;181;556;748;2229;929;2785
251230;201405;5244;15893;4638;15177;438;1610;3907;12784;4345;14394
251240;201405;3208;10610;3131;10491;330;1274;2504;8334;2834;9608
251250;201405;10641;32135;9930;31036;1416;4969;7157;22095;8573;27064
251260;201405;544;1680;484;1598;36;118;368;1226;404;1344
251270;201405;4268;13327;4045;13035;170;689;3631;11691;3801;12380
251272;201405;1396;4288;1310;4164;133;427;1034;3350;1167;3777
251274;201405;1015;3203;960;3094;133;532;574;1890;707;2422
251275;201405;1422;4057;1349;3946;153;575;993;2805;1146;3380
251276;201405;1514;4523;1434;4379;215;719;887;2793;1102;3512
251278;201405;648;2073;563;1874;85;312;335;1161;420;1473
251280;201405;2356;7491;2258;7330;283;1010;1692;5482;1975;6492
251290;201405;6141;17673;5857;17310;865;2904;4251;12307;5116;15211
251300;201405;766;2643;711;2561;72;336;514;1806;586;2142
251310;201405;3343;9776;3086;9408;213;798;2464;7438;2677;8236
251315;201405;1730;6125;1683;6035;301;1137;1060;3877;1361;5014
251320;201405;2175;6133;1804;5538;151;523;1293;4038;1444;4561
251330;201405;2074;5406;1722;4951;122;490;1459;4051;1581;4541
251335;201405;1005;3488;950;3383;101;460;692;2399;793;2859
251340;201405;3985;11104;3378;10188;349;1296;2371;6982;2720;8278
251350;201405;1637;5067;1494;4866;255;901;992;3236;1247;4137
251360;201405;1864;6091;1750;5955;134;517;1473;5054;1607;5571
251365;201405;902;2676;726;2307;59;231;473;1477;532;1708
251370;201405;22658;76387;22235;75709;3767;14443;16040;53606;19807;68049
251380;201405;1416;4404;1239;4100;101;427;966;3117;1067;3544
251385;201405;881;2465;802;2341;78;265;555;1585;633;1850
251390;201405;5840;20924;5509;20379;1058;4194;3665;13597;4723;17791
251392;201405;1082;3212;1004;3083;100;326;738;2314;838;2640
251394;201405;624;1928;524;1734;41;161;369;1207;410;1368
251396;201405;878;2532;788;2377;90;300;577;1710;667;2010
251398;201405;1130;3308;944;2960;89;332;641;1995;730;2327
251400;201405;1368;3931;1255;3778;171;649;868;2515;1039;3164
251410;201405;1642;4308;1498;4071;183;561;1024;2835;1207;3396
251420;201405;2212;6406;1897;6058;192;695;1464;4639;1656;5334
251430;201405;1759;6238;1595;5971;121;525;1312;4930;1433;5455
251440;201405;1473;4461;1250;4023;161;576;889;2836;1050;3412
251445;201405;1642;5022;1558;4900;113;424;1312;4087;1425;4511
251450;201405;4855;15296;4339;14634;192;800;3738;12620;3930;13420
251455;201405;1222;3818;1083;3587;89;363;769;2552;858;2915
251460;201405;882;2716;850;2661;118;377;661;2091;779;2468
251465;201405;501;1574;459;1486;54;208;298;948;352;1156
251470;201405;1308;3781;1084;3366;137;494;633;1987;770;2481
251480;201405;1128;3092;1019;2907;68;253;815;2284;883;2537
251490;201405;2100;6221;1824;5847;327;1221;1165;3658;1492;4879
251500;201405;1779;5857;1727;5777;191;714;1349;4466;1540;5180
251510;201405;2647;8874;2459;8468;437;1611;1510;5261;1947;6872
251520;201405;1122;3090;1023;2936;154;473;570;1655;724;2128
251530;201405;12036;35323;11537;34601;766;2842;9847;29135;10613;31977
251540;201405;2882;9510;2659;9024;272;1093;2001;6773;2273;7866
251550;201405;4028;10078;3393;9278;195;670;2774;7402;2969;8072
251560;201405;749;2317;689;2217;107;429;420;1235;527;1664
251570;201405;1075;3160;916;2828;116;440;585;1832;701;2272
251580;201405;2208;6091;2034;5855;328;834;1491;4444;1819;5278
251590;201405;1716;5682;1690;5653;118;444;1453;4913;1571;5357
251593;201405;1033;3289;978;3205;148;549;635;2009;783;2558
251597;201405;1994;6188;1914;6064;186;694;1482;4619;1668;5313
251600;201405;7445;21974;7077;21360;956;2846;5229;16185;6185;19031
251610;201405;3677;11077;3402;10714;353;1219;2643;8417;2996;9636
251615;201405;1225;3532;1047;3221;113;407;671;2114;784;2521
251620;201405;17606;50105;15557;47508;2046;6446;11467;35562;13513;42008
251630;201405;5411;13764;4732;12931;410;1162;3732;10311;4142;11473
251640;201405;2715;7894;2218;6999;244;922;1567;4900;1811;5822
251650;201405;4406;12574;3971;12036;339;1110;3258;10043;3597;11153
251660;201405;3628;12202;3338;11745;289;1316;2643;9141;2932;10457
251670;201405;4072;12049;3666;11498;99;337;3292;10382;3391;10719
251675;201405;759;2537;720;2470;165;602;409;1385;574;1987
251680;201405;2904;8118;2373;7336;147;595;1944;5910;2091;6505
251690;201405;3546;11017;3295;10568;352;1268;2351;7470;2703;8738
251700;201405;2146;7061;2029;6905;216;816;1623;5538;1839;6354
251710;201405;955;2511;726;2109;106;377;382;1057;488;1434
251720;201405;1412;4401;1299;4209;123;491;998;3174;1121;3665
251740;201405;744;2116;606;1869;101;337;358;1122;459;1459
260005;201405;25192;62658;22261;58621;4700;12551;13742;36274;18442;48825
260010;201405;9721;26610;7826;24249;893;2974;5884;18283;6777;21257
260020;201405;5854;17324;5209;16353;598;1789;3813;12483;4411;14272
260030;201405;5464;16582;5063;15986;505;1759;3947;12415;4452;14174
260040;201405;10289;25019;8529;23014;658;1464;7064;19724;7722;21188
260050;201405;10983;35556;10213;34675;662;2306;8889;30571;9551;32877
260060;201405;4110;11469;3774;10943;339;1004;2981;8744;3320;9748
260070;201405;9652;29178;9197;28514;2058;6672;5758;17988;7816;24660
260080;201405;5279;15270;4704;14433;473;1668;3490;10587;3963;12255
260090;201405;5235;14688;4938;14270;1242;3389;3207;9640;4449;13029
260100;201405;3538;9471;3233;9063;243;833;2615;7406;2858;8239
260105;201405;4630;13916;4460;13587;822;2680;2941;8893;3763;11573
260110;201405;21929;64574;20249;62545;1452;4438;17307;54108;18759;58546
260120;201405;11385;35341;10779;34251;3000;9642;5629;18667;8629;28309
260130;201405;3143;9041;2984;8786;493;1312;2112;6437;2605;7749
260140;201405;13549;34985;11587;32572;1194;3636;8911;25420;10105;29056
260150;201405;3148;9223;2807;8729;230;840;2212;6936;2442;7776
260160;201405;6032;18445;5455;17773;533;1857;4437;14684;4970;16541
260170;201405;17846;49176;17131;48239;1446;3768;14210;40695;15656;44463
260180;201405;3516;10880;3220;10457;242;945;2619;8447;2861;9392
260190;201405;16249;39267;15340;38144;899;2383;13332;33197;14231;35580
260200;201405;11435;33081;10453;31623;1172;3704;7740;24253;8912;27957
260210;201405;11454;35616;10587;34366;856;3032;8628;28328;9484;31360
260220;201405;9144;28701;8913;28366;803;3134;7467;23308;8270;26442
260230;201405;9824;29093;9353;28445;702;2155;7683;23846;8385;26001
260240;201405;2963;9289;2622;8806;383;1374;1848;6254;2231;7628
260250;201405;2763;7469;2549;7202;191;562;2103;5988;2294;6550
260260;201405;11615;34087;11332;33718;958;3024;9373;28531;10331;31555
260270;201405;3580;10868;3358;10541;390;1471;2586;7985;2976;9456
260280;201405;12972;43047;11957;41461;797;3019;9989;35102;10786;38121
260290;201405;34419;104942;33226;102974;5770;20004;22685;69238;28455;89242
260300;201405;8390;25738;7437;24346;583;2339;5926;19381;6509;21720
260310;201405;5174;15543;4869;15072;1502;4305;2521;8470;4023;12775
260320;201405;6932;23392;6479;22733;543;2067;5219;18562;5762;20629
260330;201405;3162;9811;2930;9424;308;1203;1978;6576;2286;7779
260340;201405;1893;5637;1795;5496;103;362;1564;4764;1667;5126
260345;201405;26621;87397;25501;85165;7297;26502;12486;40344;19783;66846
260350;201405;4317;12456;4095;12099;371;1213;3259;9607;3630;10820
260360;201405;2424;7613;2324;7448;514;1758;1369;4435;1883;6193
260370;201405;6142;19059;5584;18070;729;2508;3991;13120;4720;15628
260380;201405;5005;16427;4641;15953;483;1662;3618;12684;4101;14346
260390;201405;4803;15045;4194;14091;501;1900;3012;9968;3513;11868
260392;201405;3520;11240;3324;10985;164;638;2930;9678;3094;10316
260400;201405;13927;41289;13407;40432;2362;8090;9233;27209;11595;35299
260410;201405;63248;188169;60011;182803;19735;60313;28624;90498;48359;150811
260415;201405;4093;13160;3578;12146;537;2140;2201;7387;2738;9527
260420;201405;12225;28745;11161;27614;839;2179;9492;23565;10331;25744
260430;201405;2728;9203;2501;8838;303;1249;1845;6419;2148;7668
260440;201405;3446;10627;3211;10158;591;2023;1955;6087;2546;8110
260450;201405;5193;15885;4947;15463;460;1578;3937;12343;4397;13921
260460;201405;5875;18230;5526;17703;937;3328;3593;11343;4530;14671
260470;201405;5123;14935;4825;14526;515;1604;3841;11781;4356;13385
260480;201405;3959;11675;3536;11036;618;2109;2369;7361;2987;9470
260490;201405;6090;15908;5362;14736;676;2196;3638;10011;4314;12207
260500;201405;6835;18955;6344;18259;707;2135;4708;13759;5415;15894
260510;201405;10554;27897;9811;26884;836;2353;7792;22043;8628;24396
260515;201405;4638;14575;3639;12469;410;1599;2241;7709;2651;9308
260520;201405;16173;44042;15679;43365;3586;9514;10286;29331;13872;38845
260530;201405;10286;30834;9030;29091;565;1684;7749;25468;8314;27152
260540;201405;5855;15256;5540;14909;699;1572;4429;12322;5128;13894
260545;201405;42;162;29;119;4;19;7;27;11;46
260550;201405;2858;9603;2551;9013;655;2581;1214;4250;1869;6831
260560;201405;6794;17531;6090;16534;335;936;5308;14436;5643;15372
260570;201405;6674;22966;6225;22180;944;3714;4366;15661;5310;19375
260580;201405;3948;11002;3735;10672;306;979;3120;8778;3426;9757
260590;201405;5990;15363;5774;15114;255;551;5287;14064;5542;14615
260600;201405;26161;81908;24858;79712;4407;14920;16417;53306;20824;68226
260610;201405;7115;21385;6784;20927;1211;3905;4783;14781;5994;18686
260620;201405;17524;54536;16892;53486;3259;11506;10877;33756;14136;45262
260630;201405;2372;7038;2051;6509;228;868;1517;4761;1745;5629
260640;201405;17598;48598;16682;47290;2311;6964;12103;34302;14414;41266
260650;201405;5616;17711;5279;17147;761;2464;3575;12381;4336;14845
260660;201405;8490;23797;7672;22750;560;1730;6428;19264;6988;20994
260670;201405;2443;6970;2061;6455;299;1056;1393;4373;1692;5429
260680;201405;23543;64863;22174;62552;5094;14978;12498;35057;17592;50035
260690;201405;3623;10046;3139;9286;216;782;2529;7415;2745;8197
260700;201405;5669;16883;5546;16753;96;188;5367;16424;5463;16612
260710;201405;1337;4110;1218;3938;146;561;917;2922;1063;3483
260720;201405;17406;57518;16593;56059;4372;15019;9098;31614;13470;46633
260730;201405;7374;24396;6631;23292;816;3049;4951;17632;5767;20681
260740;201405;1356;4165;1190;3864;181;634;736;2414;917;3048
260750;201405;6755;21703;6340;21129;569;1753;5320;18125;5889;19878
260760;201405;4817;13402;4529;13026;498;1545;3509;10115;4007;11660
260765;201405;8119;28551;7872;28191;1458;5844;5221;18705;6679;24549
260770;201405;4331;11301;3959;10814;256;895;3169;8483;3425;9378
260775;201405;5358;15620;5080;15199;597;2144;3670;10671;4267;12815
260780;201405;3984;13232;3854;12996;931;3470;2253;7541;3184;11011
260790;201405;120722;313396;116256;306961;25662;69708;72543;192274;98205;261982
260795;201405;3051;9853;2839;9516;480;1699;1892;6451;2372;8150
260800;201405;4764;13107;4435;12667;237;944;3840;10698;4077;11642
260805;201405;4141;12141;3733;11503;526;1756;2574;7946;3100;9702
260810;201405;7460;21686;7267;21439;457;1508;6360;18742;6817;20250
260820;201405;4612;13330;4320;12931;1149;3506;2505;7508;3654;11014
260825;201405;3077;9912;2888;9626;304;1000;2299;7791;2603;8791
260830;201405;3733;12162;3470;11686;999;3190;1945;6913;2944;10103
260840;201405;4238;12471;3894;11971;285;1101;3243;9820;3528;10921
260845;201405;4261;12691;3978;12139;671;2196;2693;8229;3364;10425
260850;201405;4968;17045;4529;16109;1137;4550;2248;7795;3385;12345
260860;201405;3106;10110;2886;9741;317;1122;2143;7335;2460;8457
260870;201405;4191;11758;3828;11302;530;1454;2850;8666;3380;10120
260875;201405;7453;20036;6743;18929;1074;3044;4457;12901;5531;15945
260880;201405;9238;29275;8781;28641;916;3035;7120;23490;8036;26525
260890;201405;14990;43296;14310;42254;1648;5401;10680;31640;12328;37041
260900;201405;6151;19045;5280;17522;949;3332;3176;10656;4125;13988
260910;201405;3136;9530;2856;9106;273;1010;2251;7170;2524;8180
260915;201405;4583;15333;4436;15120;123;404;4095;14180;4218;14584
260920;201405;3506;10687;3334;10456;494;1644;2462;7912;2956;9556
260930;201405;4228;13381;3777;12730;510;1743;2732;9373;3242;11116
260940;201405;14796;41600;13701;39685;2505;8471;8206;23287;10711;31758
260950;201405;6163;19913;5864;19326;867;3671;3796;11756;4663;15427
260960;201405;67761;190462;64339;184973;14053;42097;38168;110876;52221;152973
260970;201405;5399;17492;5058;16981;625;2438;3681;12298;4306;14736
260980;201405;4060;12960;3868;12705;273;936;3267;10945;3540;11881
260990;201405;18309;57230;16984;55465;2150;6678;12783;43551;14933;50229
261000;201405;15665;44332;12815;39733;2728;8933;6982;22187;9710;31120
261010;201405;2812;7890;2638;7668;233;498;2239;6820;2472;7318
261020;201405;6194;18536;5714;17811;452;1742;4610;13993;5062;15735
261030;201405;3499;11547;3324;11252;345;1286;2630;8868;2975;10154
261040;201405;5428;17607;4711;16443;546;2198;3404;11845;3950;14043
261050;201405;8765;24993;8199;24105;1203;3630;5577;16363;6780;19993
261060;201405;11488;35732;11063;35017;1658;5841;8013;25026;9671;30867
261070;201405;50926;131971;46267;125476;10204;28394;27603;75836;37807;104230
261080;201405;5786;17733;5488;17252;439;1341;4590;14685;5029;16026
261090;201405;16547;46501;15488;45070;1622;4793;12322;36298;13944;41091
261100;201405;7369;23720;6836;22881;646;2536;5310;17709;5956;20245
261110;201405;67422;194764;61760;186572;15226;46095;34532;110463;49758;156558
261120;201405;3666;10028;3339;9616;157;454;2938;8551;3095;9005
261130;201405;7170;18688;6863;18343;267;737;6298;16835;6565;17572
261140;201405;3263;9316;3005;8904;563;1829;1883;5508;2446;7337
261150;201405;5712;17055;5149;16241;740;2550;3619;11535;4359;14085
261153;201405;1986;5771;1680;5342;104;398;1386;4423;1490;4821
261160;201405;226172;594471;216083;580749;48376;130444;130357;360910;178733;491354
261170;201405;6106;17141;5656;16499;838;2455;4192;12368;5030;14823
261180;201405;9647;27570;9315;27075;1147;3377;7138;20956;8285;24333
261190;201405;5509;17444;5253;17117;807;3362;3645;11387;4452;14749
261200;201405;3973;9819;3709;9477;588;1478;2659;6916;3247;8394
261210;201405;1977;5298;1907;5206;134;366;1662;4598;1796;4964
261220;201405;12859;42235;11321;38841;2235;8367;6177;21155;8412;29522
261230;201405;4088;12781;3854;12477;164;579;3441;11198;3605;11777
261240;201405;4975;14761;4731;14310;788;2291;3317;10233;4105;12524
261245;201405;3899;12310;3400;11476;268;1124;2509;8546;2777;9670
261247;201405;3564;11035;3081;10138;403;1399;2149;7145;2552;8544
261250;201405;19584;52966;18857;52002;3395;9244;14012;39192;17407;48436
261255;201405;4407;13510;3963;12783;328;1185;3106;10164;3434;11349
261260;201405;12261;35384;11263;34212;678;1877;9841;30489;10519;32366
261270;201405;3843;11188;3583;10786;486;1584;2531;7605;3017;9189
261280;201405;2765;8564;2527;8216;263;972;1912;6213;2175;7185
261290;201405;3050;8744;2751;8367;235;787;2252;6933;2487;7720
261300;201405;10551;35422;9525;33627;1665;6611;6057;21293;7722;27904
261310;201405;8568;26123;8169;25457;1968;6332;4845;15183;6813;21515
261320;201405;6003;18886;5666;18247;654;2080;4292;14136;4946;16216
261330;201405;5507;16451;5327;16192;534;1667;4270;13072;4804;14739
261340;201405;4610;15138;4401;14809;673;2634;2869;9633;3542;12267
261350;201405;8041;27449;7634;26741;662;2802;5983;20798;6645;23600
261360;201405;9532;24800;8684;23653;1182;3310;6119;17011;7301;20321
261370;201405;21109;63140;19985;61454;4062;13062;12900;39887;16962;52949
261380;201405;4186;14570;3903;14080;613;2249;2670;9901;3283;12150
261390;201405;17207;53299;15787;50842;2768;9756;9817;31484;12585;41240
261400;201405;4913;17207;4504;16393;611;2464;3078;11345;3689;13809
261410;201405;8430;24860;7960;24125;1111;3384;5823;18024;6934;21408
261420;201405;8050;27186;7788;26794;1936;7205;4563;15981;6499;23186
261430;201405;3616;11268;3081;10548;400;1390;2268;7942;2668;9332
261440;201405;1680;5144;1563;4967;120;484;1261;3968;1381;4452
261450;201405;14369;41590;13991;41093;897;2746;12454;36654;13351;39400
261460;201405;8526;24698;7988;23948;847;2335;5989;19366;6836;21701
261470;201405;3965;10861;3645;10484;222;693;3140;9007;3362;9700
261480;201405;3513;12905;3287;12492;405;1716;2463;9233;2868;10949
261485;201405;4996;15544;4612;14880;960;3403;2649;8570;3609;11973
261500;201405;5868;16337;5208;15438;640;1674;4006;12390;4646;14064
261510;201405;2060;6539;1936;6360;171;568;1525;5080;1696;5648
261520;201405;2628;8636;2338;8121;201;806;1676;5849;1877;6655
261530;201405;12515;40856;11160;38234;2478;9279;5392;18533;7870;27812
261540;201405;7417;24087;7157;23624;1417;4577;4863;16474;6280;21051
261550;201405;3500;10586;3357;10378;441;1699;2619;7815;3060;9514
261560;201405;6970;22797;6403;22057;1182;4098;4496;15885;5678;19983
261570;201405;3581;11171;3242;10633;483;1658;2229;7382;2712;9040
261580;201405;5887;18883;5273;17891;463;1702;4198;14538;4661;16240
261590;201405;2895;8081;2558;7624;330;1047;1834;5565;2164;6612
261600;201405;5191;14540;4474;13538;505;1611;3351;10257;3856;11868
261610;201405;2297;7002;2002;6574;140;584;1645;5295;1785;5879
261618;201405;2563;7391;2417;7194;259;813;1901;5639;2160;6452
261620;201405;4625;14305;4389;13942;530;1734;3213;10429;3743;12163
261630;201405;8158;24075;7201;22359;1374;4822;3996;12121;5370;16943
261640;201405;30563;80121;28213;77130;2341;6338;23233;64698;25574;71036
261650;201405;3844;12298;3607;11946;488;1760;2670;8889;3158;10649
270010;201405;4458;17119;4085;16357;517;2371;2807;11300;3324;13671
270020;201405;3982;12196;3723;11798;506;1797;2745;8619;3251;10416
270030;201405;45904;139352;43826;136147;11380;35593;25569;81422;36949;117015
270040;201405;10431;32464;9947;31907;1634;4719;7450;24870;9084;29589
270050;201405;4020;11836;3735;11455;428;1558;2847;8619;3275;10177
270060;201405;1678;5581;1599;5464;362;1341;977;3364;1339;4705
270070;201405;4221;13123;3921;12716;196;863;3379;10804;3575;11667
270080;201405;1327;4202;1194;3995;225;825;764;2523;989;3348
270090;201405;2082;6628;2004;6490;69;275;1813;5827;1882;6102
270100;201405;6451;20220;6182;19859;1280;4314;4097;13152;5377;17466
270110;201405;3471;9882;3200;9567;547;1619;2115;6805;2662;8424
270120;201405;3083;9067;2789;8669;154;541;2397;7520;2551;8061
270130;201405;5140;16186;4897;15899;526;1549;3985;13361;4511;14910
270135;201405;1749;4997;1668;4906;111;192;1507;4593;1618;4785
270140;201405;9658;24663;8586;23296;786;3035;6789;17328;7575;20363
270150;201405;2692;9301;2631;9222;208;808;2271;7968;2479;8776
270160;201405;5044;17037;4655;16551;313;1134;3935;14125;4248;15259
270170;201405;4070;13480;3767;13024;827;3274;2121;7272;2948;10546
270180;201405;2294;7675;2052;7359;175;788;1632;5821;1807;6609
270190;201405;1912;6329;1820;6190;151;591;1433;4909;1584;5500
270200;201405;2763;9301;2591;9031;284;1215;1995;6801;2279;8016
270210;201405;4412;14673;4271;14489;421;1656;3560;12025;3981;13681
270220;201405;1722;5450;1598;5207;310;1146;883;2938;1193;4084
270230;201405;11271;37038;9958;34931;1516;6296;6639;22983;8155;29279
270235;201405;6487;21493;6165;20955;378;1595;5215;17656;5593;19251
270240;201405;9812;29752;8699;28292;1480;5007;5924;19507;7404;24514
270250;201405;3540;9093;3226;8739;175;456;2914;7936;3089;8392
270255;201405;5143;15792;4279;14283;405;1698;3034;9972;3439;11670
270260;201405;6339;20653;6178;20370;883;3298;4583;15220;5466;18518
270270;201405;1212;3521;1121;3384;169;539;737;2185;906;2724
270280;201405;3742;11138;3512;10807;470;1664;2519;7610;2989;9274
270290;201405;8418;29762;8011;29041;883;3700;6213;22409;7096;26109
270300;201405;3308;11516;3138;11315;186;795;2721;9846;2907;10641
270310;201405;7334;22841;6643;21632;439;1927;5383;17153;5822;19080
270320;201405;6425;20992;6218;20635;1583;5855;3471;11643;5054;17498
270330;201405;4898;16213;4622;15840;451;1658;3727;12907;4178;14565
270340;201405;1793;5586;1628;5368;199;700;1227;4127;1426;4827
270350;201405;2096;5863;1943;5672;289;842;1326;4113;1615;4955
270360;201405;2094;6581;2047;6522;247;749;1677;5485;1924;6234
270370;201405;1729;5666;1603;5448;187;722;1088;3828;1275;4550
270375;201405;2928;9058;2735;8774;403;1553;1919;5950;2322;7503
270380;201405;6100;18694;5785;18251;646;2043;4463;14403;5109;16446
270390;201405;1453;3999;1310;3820;208;694;896;2532;1104;3226
270400;201405;5972;18631;5492;17904;513;2009;3980;12755;4493;14764
270410;201405;5072;15735;4834;15290;611;2155;3544;11094;4155;13249
270420;201405;5532;18235;5381;18022;293;1372;4544;14968;4837;16340
270430;201405;142124;416377;136283;408192;35310;106223;78329;242392;113639;348615
270440;201405;5084;15683;4803;15259;374;1362;3830;12278;4204;13640
270450;201405;6604;20803;6393;20528;598;2195;5136;16551;5734;18746
270460;201405;3651;10053;3293;9560;258;924;2685;7659;2943;8583
270470;201405;10923;35696;10416;34823;1601;5305;7182;24746;8783;30051
270480;201405;3108;9954;2875;9540;369;1491;1898;6069;2267;7560
270490;201405;1003;3240;948;3159;96;391;719;2360;815;2751
270500;201405;5443;18762;5255;18494;489;1779;4229;15241;4718;17020
270510;201405;6092;18870;5574;18148;903;3748;4012;12419;4915;16167
270520;201405;3750;12190;3531;11842;884;3218;1927;6547;2811;9765
270530;201405;1569;4616;1386;4381;213;662;957;3129;1170;3791
270540;201405;2083;7201;1921;6960;180;833;1521;5424;1701;6257
270550;201405;7130;21674;6340;20624;1074;3616;4237;14186;5311;17802
270560;201405;3045;9600;2885;9344;532;1986;1971;6208;2503;8194
270570;201405;4380;14352;4029;13811;499;2017;2777;9522;3276;11539
270580;201405;2071;6936;1993;6809;289;1042;1479;5122;1768;6164
270590;201405;1416;4810;1330;4660;84;363;1153;4025;1237;4388
270600;201405;2916;9826;2641;9412;231;1153;2031;7033;2262;8186
270610;201405;3275;10427;3047;10095;329;1180;2397;7915;2726;9095
270620;201405;1490;5046;1359;4850;158;719;1034;3600;1192;4319
270630;201405;18490;51810;17355;50060;2542;7415;12614;36931;15156;44346
270640;201405;5937;18553;5391;17877;452;1839;4409;14409;4861;16248
270642;201405;2515;8660;2350;8392;405;1595;1530;5523;1935;7118
270644;201405;2408;7101;2181;6849;181;525;1866;5961;2047;6486
270650;201405;4096;13131;3940;12916;871;3415;2348;7425;3219;10840
270660;201405;2461;6428;1992;5703;157;542;1414;4005;1571;4547
270670;201405;15889;43342;13892;40943;1722;5187;10416;31554;12138;36741
270680;201405;4200;12940;4065;12779;224;636;3622;11544;3846;12180
270690;201405;8999;25681;8391;24945;2750;7784;4236;13494;6986;21278
270700;201405;799;2506;759;2444;141;549;483;1503;624;2052
270710;201405;5768;19431;5537;19118;629;2268;4419;15415;5048;17683
270720;201405;3393;11615;3141;11178;272;1254;2515;8827;2787;10081
270730;201405;6693;20829;6377;20431;983;3151;4809;15697;5792;18848
270740;201405;2407;7144;2267;6938;369;1241;1506;4585;1875;5826
270750;201405;4844;15785;4528;15302;528;1895;3478;11814;4006;13709
270760;201405;3585;10806;3251;10253;404;1365;2386;7557;2790;8922
270770;201405;18081;49377;15486;46198;2955;9153;9822;30030;12777;39183
270780;201405;1952;6354;1819;6151;262;952;1291;4418;1553;5370
270790;201405;1724;5444;1574;5202;394;1393;845;2788;1239;4181
270800;201405;11431;34538;10726;33611;1022;3428;8717;27430;9739;30858
270810;201405;3461;10688;2844;9564;382;1487;1782;5999;2164;7486
270820;201405;1903;6447;1744;6160;266;1071;1173;4126;1439;5197
270830;201405;5447;16774;4978;16169;1093;3946;3087;10077;4180;14023
270840;201405;7622;26062;6949;25209;477;2245;5810;20867;6287;23112
270850;201405;7647;25366;7482;25166;1381;5612;5234;16884;6615;22496
270860;201405;11682;35387;10951;34391;1657;6033;8070;24825;9727;30858
270870;201405;2313;6866;1886;5959;307;1012;1136;3615;1443;4627
270880;201405;7860;25766;7425;25121;557;2406;6119;20378;6676;22784
270890;201405;2671;8204;2485;7892;409;1512;1730;5382;2139;6894
270895;201405;3050;11357;2901;11161;253;1028;2400;9382;2653;10410
270900;201405;1935;5345;1588;4841;106;403;1219;3630;1325;4033
270910;201405;3244;11426;3180;11295;333;1530;2536;8749;2869;10279
270915;201405;10068;34495;9165;32855;1861;7589;5285;18777;7146;26366
270920;201405;6436;20255;6050;19716;311;1413;5293;17059;5604;18472
270930;201405;17266;47515;14378;43903;2772;9017;8591;26859;11363;35876
270940;201405;5836;20048;5659;19830;751;2926;4297;15093;5048;18019
280010;201405;721;2150;634;2010;71;285;414;1286;485;1571
280020;201405;5057;15171;4497;14151;920;3015;2755;8730;3675;11745
280030;201405;74642;199577;66657;187573;16574;48665;34966;100095;51540;148760
280040;201405;3208;10115;2887;9674;365;1237;2137;7381;2502;8618
280050;201405;4162;13441;3890;13027;1092;3712;2076;7257;3168;10969
280060;201405;4317;14612;4149;14329;903;3355;2530;8824;3433;12179
280067;201405;7678;22021;6544;20481;743;2529;4862;15240;5605;17769
280070;201405;1911;6630;1837;6520;323;1222;1293;4632;1616;5854
280100;201405;4091;12915;3672;12164;992;3370;1804;6173;2796;9543
280110;201405;1438;4373;1324;4188;91;368;1085;3397;1176;3765
280120;201405;8078;25584;7508;24700;1219;3652;5290;18346;6509;21998
280130;201405;7995;23088;7476;22340;1293;4299;5007;14910;6300;19209
280140;201405;5580;15483;5051;14774;582;1721;3893;11523;4475;13244
280150;201405;3415;10685;3161;10225;488;1864;2055;6404;2543;8268
280160;201405;1549;4432;1407;4219;179;606;1021;3051;1200;3657
280170;201405;4707;14182;4298;13638;495;1488;3368;11039;3863;12527
280190;201405;1161;3349;1038;3154;98;388;746;2175;844;2563
280200;201405;1109;3498;1038;3377;164;649;725;2271;889;2920
280210;201405;12912;41134;12314;40266;2488;8222;8147;27447;10635;35669
280220;201405;1591;4899;1520;4804;105;396;1298;4085;1403;4481
280230;201405;3901;11541;3513;10887;698;2189;2107;6740;2805;8929
280240;201405;3530;10574;3225;10103;270;808;2551;8120;2821;8928
280250;201405;807;2163;713;2023;137;457;429;1117;566;1574
280260;201405;2097;5534;1918;5311;120;323;1663;4646;1783;4969
280270;201405;2250;7079;1986;6635;131;521;1551;5116;1682;5637
280280;201405;4119;13726;3844;13281;919;2706;2174;8388;3093;11094
280290;201405;16846;54670;15539;52442;2773;9956;10344;35360;13117;45316
280300;201405;10167;31065;9445;30242;812;2648;7858;25554;8670;28202
280310;201405;1454;4121;1276;3851;121;468;871;2525;992;2993
280320;201405;7936;26550;7360;25518;1448;5612;3971;13765;5419;19377
280330;201405;4741;13526;4444;13138;589;1895;3420;10079;4009;11974
280340;201405;3818;11502;3640;11264;339;1084;2911;9252;3250;10336
280350;201405;21899;64294;20433;62137;2905;8937;14647;45431;17552;54368
280360;201405;5958;19044;5636;18542;1170;4301;3445;11233;4615;15534
280370;201405;1969;5658;1797;5384;217;744;1324;3901;1541;4645
280380;201405;1015;3124;944;3032;102;394;736;2329;838;2723
280390;201405;3290;9753;2885;9031;638;1884;1743;5595;2381;7479
280400;201405;4477;12948;4103;12444;938;2692;2586;8249;3524;10941
280410;201405;2440;7962;2170;7452;391;1529;1300;4357;1691;5886
280420;201405;4251;12385;3954;11927;260;804;3407;10372;3667;11176
280430;201405;2239;5937;2100;5761;160;525;1757;4812;1917;5337
280440;201405;5101;15025;4767;14614;485;1461;3941;12272;4426;13733
280445;201405;2464;7126;2274;6799;108;419;1875;5504;1983;5923
280450;201405;9140;24782;8473;23997;738;1693;7158;21015;7896;22708
280460;201405;7135;19430;6383;18389;1027;3051;4482;13226;5509;16277
280470;201405;1845;5547;1675;5293;199;648;1260;4019;1459;4667
280480;201405;31106;94560;29975;92928;5112;18058;20324;61824;25436;79882
280490;201405;3744;11610;3389;10923;402;1449;2441;7817;2843;9266
280500;201405;900;2412;849;2349;34;108;755;2069;789;2177
280510;201405;2773;8190;2397;7691;312;1119;1778;5753;2090;6872
280520;201405;1741;5021;1608;4845;181;497;1269;3959;1450;4456
280530;201405;2133;6559;2029;6421;239;803;1603;5158;1842;5961
280540;201405;9286;25339;8721;24584;342;1143;7801;21876;8143;23019
280550;201405;7214;19479;6398;18190;722;2343;4592;12960;5314;15303
280560;201405;7978;23651;7532;22934;622;2027;6121;18636;6743;20663
280570;201405;6883;19257;6229;18410;868;2866;4386;12914;5254;15780
280580;201405;5681;17447;4912;16164;881;2965;3145;10607;4026;13572
280590;201405;2418;7355;2222;7122;284;1170;1620;5124;1904;6294
280600;201405;4035;12501;3808;12105;415;1566;2770;8691;3185;10257
280610;201405;2369;6959;2230;6756;328;1118;1505;4507;1833;5625
280620;201405;5220;16026;4656;14957;795;2580;3047;9989;3842;12569
280630;201405;3815;12569;3660;12330;394;1167;2921;10255;3315;11422
280640;201405;2291;6576;2150;6414;117;265;1944;5924;2061;6189
280650;201405;1145;3565;1052;3390;176;623;703;2279;879;2902
280660;201405;2645;7793;2547;7639;290;940;2108;6257;2398;7197
280670;201405;16013;42899;15175;41780;1930;5596;11382;31415;13312;37011
280680;201405;2841;7573;2440;7032;142;470;2076;5972;2218;6442
280690;201405;1020;2920;882;2720;139;466;580;1756;719;2222
280700;201405;1184;3493;1037;3275;106;330;766;2470;872;2800
280710;201405;10967;30186;10268;29345;734;2001;8782;25327;9516;27328
280720;201405;2470;6796;2216;6488;220;635;1699;5090;1919;5725
280730;201405;960;2903;921;2849;83;259;777;2435;860;2694
280740;201405;12900;35530;11263;33124;1802;5111;7674;23255;9476;28366
280750;201405;3595;11200;3321;10712;326;1279;2406;7680;2732;8959
280760;201405;5821;18092;5340;17463;700;2218;3991;13623;4691;15841
290010;201405;3046;6854;2239;5619;81;331;1781;4220;1862;4551
290020;201405;5011;15860;4579;15419;390;1107;4000;13823;4390;14930
290030;201405;3276;10505;3154;10314;436;1546;2398;7777;2834;9323
290035;201405;4655;12546;4184;11936;303;913;3474;10062;3777;10975
290040;201405;3812;11135;3484;10746;278;1087;2852;8655;3130;9742
290050;201405;2722;8954;2554;8696;255;980;1960;6709;2215;7689
290060;201405;1330;3438;1118;3189;208;678;790;2187;998;2865
290070;201405;31303;82377;27208;77241;5827;16705;15238;45511;21065;62216
290080;201405;5950;18353;5273;17482;636;2131;4007;13639;4643;15770
290090;201405;2289;5098;1836;4623;195;481;1520;3902;1715;4383
290100;201405;10282;29645;9100;27689;1724;5193;5494;17483;7218;22676
290110;201405;5293;16084;5101;15764;876;2975;3486;10653;4362;13628
290115;201405;4935;14898;4383;14161;346;1193;3424;11253;3770;12446
290120;201405;6830;18830;6357;18238;426;1203;5506;15916;5932;17119
290130;201405;4569;12100;3969;11388;335;1008;3266;9384;3601;10392
290135;201405;5255;13570;4603;12545;472;1556;3141;8445;3613;10001
290140;201405;4004;12926;3535;12326;334;1234;2925;10247;3259;11481
290150;201405;2121;6342;2029;6220;182;580;1711;5257;1893;5837
290160;201405;3526;9710;3444;9611;310;593;3032;8757;3342;9350
290170;201405;2856;9603;2630;9245;255;1000;2157;7606;2412;8606
290180;201405;3078;8819;2706;8266;291;993;1989;6109;2280;7102
290190;201405;4183;13897;4047;13664;442;1549;3094;10569;3536;12118
290195;201405;2228;6243;1912;5774;149;521;1506;4575;1655;5096
290200;201405;3882;12496;3559;11931;384;1369;2704;9116;3088;10485
290205;201405;2948;9317;2708;8937;372;1484;1949;6281;2321;7765
290210;201405;15778;43794;14770;42590;2546;6099;10461;32584;13007;38683
290220;201405;2438;7442;2336;7284;293;1079;1700;5167;1993;6246
290225;201405;3069;8288;2880;8086;192;385;2567;7445;2759;7830
290230;201405;2360;7880;2315;7820;233;823;1930;6586;2163;7409
290240;201405;3891;10383;3514;9855;384;1155;2630;7289;3014;8444
290250;201405;3852;12259;3282;11374;286;1055;2524;8861;2810;9916
290260;201405;4820;14718;4414;14106;454;1598;3458;11070;3912;12668
290265;201405;3417;11094;3213;10733;318;1221;2461;8226;2779;9447
290270;201405;12172;44860;11486;43850;1535;6107;8568;33402;10103;39509
290280;201405;5197;17356;4931;16868;616;2197;3549;12436;4165;14633
290290;201405;9673;31447;8871;30138;1600;5565;5901;20527;7501;26092
290300;201405;4373;12648;3294;10692;302;957;2280;7654;2582;8611
290310;201405;1528;4693;1430;4550;244;879;958;2996;1202;3875
290320;201405;27162;83723;24204;79798;5377;18759;14572;48828;19949;67587
290323;201405;4123;11148;3409;10386;217;769;2928;8886;3145;9655
290327;201405;4051;13079;3757;12512;563;1979;2580;8604;3143;10583
290330;201405;1919;5102;1834;5009;242;741;1487;4009;1729;4750
290340;201405;5090;16153;4724;15672;1129;3790;2756;9393;3885;13183
290350;201405;5002;15235;4135;14065;570;1972;2865;10030;3435;12002
290360;201405;4273;13542;3802;12880;218;769;3242;11164;3460;11933
290370;201405;4559;13692;4237;13279;453;1432;3455;10973;3908;12405
290380;201405;5597;16516;4960;15611;416;1421;3997;12613;4413;14034
290390;201405;15297;49107;14485;47751;2962;9368;9100;31571;12062;40939
290395;201405;2786;9086;2526;8642;247;1009;1890;6467;2137;7476
290400;201405;3689;11380;3280;10815;410;1393;2447;8135;2857;9528
290405;201405;4517;14535;3952;13541;500;1782;2671;9408;3171;11190
290410;201405;6068;18170;5139;16806;572;2301;3717;11863;4289;14164
290420;201405;3369;9974;2806;9175;279;1042;2196;7132;2475;8174
290430;201405;3551;11194;3199;10661;695;2387;1951;6670;2646;9057
290440;201405;3100;8201;2530;7460;252;798;1995;5960;2247;6758
290450;201405;3618;10617;3209;10034;570;1778;2088;6672;2658;8450
290460;201405;13537;41723;12620;40195;3713;12500;5820;18496;9533;30996
290470;201405;4824;13498;3806;12134;820;2931;2052;6656;2872;9587
290475;201405;4998;17715;4576;16977;545;2176;3355;12660;3900;14836
290480;201405;2628;6876;2333;6495;358;1056;1607;4545;1965;5601
290485;201405;4835;15635;4349;14909;465;2025;3397;11513;3862;13538
290490;201405;8169;22078;7894;21710;758;2211;6499;17872;7257;20083
290500;201405;4665;14977;4025;13790;840;3088;2028;6933;2868;10021
290510;201405;3477;10216;3067;9648;247;906;2441;7717;2688;8623
290515;201405;2901;9079;2717;8792;244;759;2100;7014;2344;7773
290520;201405;11806;36747;9650;32756;1100;4420;6139;20705;7239;25125
290530;201405;5310;15404;4554;14329;412;1337;3649;11566;4061;12903
290540;201405;3966;11520;3778;11281;443;1236;2983;9141;3426;10377
290550;201405;4431;12016;3925;11399;166;473;3530;10322;3696;10795
290560;201405;6201;18455;5502;17439;1146;3867;3340;10765;4486;14632
290570;201405;40604;118691;38187;115089;4885;15785;28221;84606;33106;100391
290580;201405;7366;25863;7064;25391;1513;5271;4661;17444;6174;22715
290590;201405;7568;24129;6368;22141;478;1978;4989;17282;5467;19260
290600;201405;18189;56701;17168;55130;2852;9022;11619;38701;14471;47723
290610;201405;2407;8400;2045;7684;205;961;1501;5546;1706;6507
290620;201405;7210;21548;6494;20520;513;1772;5353;16982;5866;18754
290630;201405;8243;22423;7275;21390;835;2420;5895;17561;6730;19981
290640;201405;2724;8091;2275;7334;245;850;1614;5225;1859;6075
290650;201405;11850;35383;11189;34396;2886;8804;6630;21092;9516;29896
290660;201405;3756;10481;3109;9554;221;783;2458;7576;2679;8359
290670;201405;6687;21064;6140;20225;872;2768;4631;15749;5503;18517
290680;201405;10428;31172;9679;30280;601;1970;8222;25962;8823;27932
290682;201405;4449;13245;4016;12651;206;807;3336;10424;3542;11231
290685;201405;3322;8567;2507;7423;314;987;1554;4718;1868;5705
290687;201405;8277;22463;6583;20404;1250;4131;4026;12767;5276;16898
290689;201405;3160;9090;2678;8329;254;837;2093;6576;2347;7413
290690;201405;5506;16222;5056;15640;567;1836;4007;12478;4574;14314
290700;201405;2249;7147;2160;7020;221;787;1688;5505;1909;6292
290710;201405;7735;24884;7195;24023;463;1540;6220;20985;6683;22525
290720;201405;18889;55899;16890;53446;1868;5400;13665;44602;15533;50002
290730;201405;7398;20772;6751;19938;1256;3610;4542;13711;5798;17321
290740;201405;943;2866;806;2638;126;422;512;1714;638;2136
290750;201405;10223;29527;8882;27129;1655;5878;5023;14560;6678;20438
290755;201405;2436;6928;2050;6285;130;480;1599;4877;1729;5357
290760;201405;4489;13329;3691;12154;366;1182;2731;9112;3097;10294
290770;201405;2595;9140;2414;8903;140;632;1976;7345;2116;7977
290780;201405;8946;23535;7964;22188;877;2112;6103;17634;6980;19746
290790;201405;4710;14207;4384;13742;441;1324;3449;11165;3890;12489
290800;201405;7425;16292;5683;14438;881;1963;4298;11422;5179;13385
290810;201405;4937;15943;4310;14965;329;1265;3280;11532;3609;12797
290820;201405;5502;15890;4947;15145;498;1686;3829;11753;4327;13439
290830;201405;4172;12005;3933;11620;293;1164;3123;8939;3416;10103
290840;201405;17808;50787;16303;48699;2470;7076;11559;35930;14029;43006
290850;201405;6754;20356;6624;20159;1166;3437;4905;15395;6071;18832
290860;201405;4830;17352;4595;17045;713;2665;3395;12961;4108;15626
290870;201405;4810;14519;4056;13501;446;1775;2989;9863;3435;11638
290880;201405;1410;3961;1167;3582;107;330;803;2506;910;2836
290890;201405;6735;18461;6047;17668;715;2114;4765;14057;5480;16171
290900;201405;2462;7276;1873;6304;288;1081;1005;3362;1293;4443
290910;201405;4860;13604;4184;12628;276;898;3476;10555;3752;11453
290920;201405;4840;14437;4371;13796;330;924;3603;11615;3933;12539
290930;201405;7433;24207;6747;23005;793;3023;4848;16410;5641;19433
290940;201405;3600;11461;3367;11167;285;916;2860;9696;3145;10612
290950;201405;1574;4490;1432;4285;206;646;996;3005;1202;3651
290960;201405;6053;17333;5551;16676;416;1273;4513;13738;4929;15011
290970;201405;3734;12189;3428;11646;489;1670;2283;8001;2772;9671
290980;201405;10879;32616;9636;30208;2741;8989;4020;12588;6761;21577
290990;201405;9244;27981;8233;26326;912;3079;6245;19985;7157;23064
291000;201405;3243;9875;2990;9543;376;1217;2327;7575;2703;8792
291005;201405;13817;38853;12452;36892;2087;6495;8440;25370;10527;31865
291010;201405;3123;10187;2534;8866;330;1252;1597;5610;1927;6862
291020;201405;1414;3763;1097;3202;131;462;655;1833;786;2295
291030;201405;2178;6194;1739;5280;179;602;1124;3344;1303;3946
291040;201405;5631;17610;5189;16975;695;2435;3825;12596;4520;15031
291050;201405;8047;26958;7386;25719;1947;7319;3877;13497;5824;20816
291060;201405;6281;23279;5982;22898;882;3816;4357;16627;5239;20443
291070;201405;16197;48444;14871;46551;1815;5472;11093;35659;12908;41131
291072;201405;22129;68797;19107;62825;6270;21698;7372;25177;13642;46875
291075;201405;5335;15490;4840;14828;409;1140;3734;11870;4143;13010
291077;201405;1567;4586;1318;4204;157;576;887;2804;1044;3380
291080;201405;83025;257297;74720;242282;22581;75690;30441;98152;53022;173842
291085;201405;5796;15589;5064;14607;579;1733;3955;11510;4534;13243
291090;201405;1454;3723;1291;3512;114;447;1040;2710;1154;3157
291100;201405;2730;7236;2265;6750;120;466;1916;5684;2036;6150
291110;201405;5055;18241;4560;17472;682;2935;3134;11938;3816;14873
291120;201405;7642;20658;7187;20020;943;2694;5460;15299;6403;17993
291125;201405;1730;3767;1395;3411;153;380;1047;2651;1200;3031
291130;201405;3011;9311;2641;8692;264;1018;1886;6162;2150;7180
291140;201405;4136;12547;3851;12039;550;1767;2707;8537;3257;10304
291150;201405;2010;5278;1915;5163;187;521;1478;3968;1665;4489
291160;201405;5604;17253;4949;16274;1154;3902;2897;9624;4051;13526
291165;201405;2477;7309;1995;6410;149;633;1421;4421;1570;5054
291170;201405;20964;54707;18160;51226;1203;4004;14565;40860;15768;44864
291180;201405;6577;17406;5349;15682;628;1992;3813;11140;4441;13132
291185;201405;3924;10718;3668;10376;313;960;3059;8612;3372;9572
291190;201405;7458;21124;6726;20236;831;2423;5171;16034;6002;18457
291200;201405;3113;9400;2591;8481;300;1086;1798;5898;2098;6984
291210;201405;7572;18020;6597;16912;565;1509;5307;13678;5872;15187
291220;201405;4244;13565;4003;13158;571;2092;2874;9357;3445;11449
291230;201405;4027;10572;3629;10108;138;346;3288;9263;3426;9609
291240;201405;4880;13300;4135;12004;276;854;3274;9407;3550;10261
291250;201405;3794;11433;3011;10115;321;1110;2093;7144;2414;8254
291260;201405;1184;3503;1107;3391;110;381;855;2611;965;2992
291270;201405;4420;14823;4148;14329;949;3425;2544;8912;3493;12337
291280;201405;2470;6437;1875;5659;466;1432;1067;3253;1533;4685
291290;201405;5993;16935;5402;16198;901;2719;3548;10936;4449;13655
291300;201405;4527;13392;3801;12183;501;1778;2578;8237;3079;10015
291310;201405;5462;15763;4818;14696;441;1414;3697;11296;4138;12710
291320;201405;6066;19709;5296;18256;1354;5116;2712;9242;4066;14358
291330;201405;1640;5096;1543;4944;224;844;1005;3096;1229;3940
291340;201405;3950;11701;3180;10609;321;1205;2468;8217;2789;9422
291345;201405;3541;11623;3354;11417;228;749;2947;10236;3175;10985
291350;201405;6185;18341;5526;17342;552;1843;3914;12494;4466;14337
291360;201405;36031;104965;33681;101525;7754;22936;21381;66749;29135;89685
291370;201405;9161;26868;8769;26344;982;2861;6778;20902;7760;23763
291380;201405;3847;11991;3377;11219;292;990;2499;8534;2791;9524
291390;201405;10582;29587;9675;28515;1374;3914;7374;22077;8748;25991
291400;201405;17164;45274;14033;41099;2348;6888;9061;27616;11409;34504
291410;201405;3323;8734;2467;7493;201;807;1838;5431;2039;6238
291420;201405;2282;6032;2019;5717;108;303;1817;5191;1925;5494
291430;201405;3382;10011;2994;9501;237;926;2371;7455;2608;8381
291440;201405;6136;19536;5278;18006;556;2013;4025;13914;4581;15927
291450;201405;7662;23667;6964;22606;374;1223;5779;19151;6153;20374
291460;201405;13491;41173;12059;39033;2269;7871;7746;25254;10015;33125
291465;201405;8349;24277;7602;23421;818;2770;6097;18788;6915;21558
291470;201405;15796;44171;14037;42000;1348;3882;10858;33699;12206;37581
291480;201405;35832;97585;31984;92282;5140;16360;21014;60514;26154;76874
291490;201405;4340;14605;4254;14488;448;1516;3531;12200;3979;13716
291500;201405;4233;12368;3668;11568;300;1095;2917;9172;3217;10267
291510;201405;3644;11255;3382;10909;149;493;3075;10003;3224;10496
291520;201405;4129;11199;3647;10549;530;1434;2522;7658;3052;9092
291530;201405;2126;6215;1816;5732;460;1546;939;3039;1399;4585
291535;201405;4384;12800;3957;12175;357;1143;3019;9615;3376;10758
291540;201405;2229;5423;1916;5096;173;374;1619;4443;1792;4817
291550;201405;5709;15460;5142;14683;1261;3579;2920;8478;4181;12057
291560;201405;17244;44465;13556;40302;1416;4289;10447;31853;11863;36142
291570;201405;2447;6577;2328;6432;156;405;2077;5823;2233;6228
291580;201405;5961;18331;5326;17362;730;2813;3627;11840;4357;14653
291590;201405;2022;6304;1818;5970;290;1003;1199;4083;1489;5086
291600;201405;5550;15526;4198;13574;967;3464;2152;6838;3119;10302
291610;201405;5237;15632;5088;15434;388;1276;4309;13132;4697;14408
291620;201405;3103;7395;2575;6834;193;467;2050;5651;2243;6118
291630;201405;3217;8100;2815;7645;275;687;2317;6451;2592;7138
291640;201405;17922;49301;14933;45345;3946;12798;6546;20174;10492;32972
291650;201405;8229;24551;7578;23781;697;1767;6370;20757;7067;22524
291660;201405;2387;6335;2120;5961;262;891;1453;3905;1715;4796
291670;201405;2512;7041;2319;6741;393;1149;1370;4273;1763;5422
291680;201405;5023;14352;4526;13559;1139;3776;2201;6836;3340;10612
291685;201405;4517;11497;3930;10790;488;1265;2925;8382;3413;9647
291690;201405;4073;11189;3376;10099;319;956;2395;7247;2714;8203
291700;201405;9580;29975;8850;28798;1053;3528;6571;21770;7624;25298
291710;201405;6040;16169;5246;15150;970;2895;3223;9801;4193;12696
291720;201405;3848;13496;3514;12793;387;1629;2576;9250;2963;10879
291730;201405;5952;19015;5567;18506;1064;3663;3828;13039;4892;16702
291733;201405;2649;7846;2260;7336;312;1074;1527;5013;1839;6087
291735;201405;2440;7106;2091;6577;134;498;1732;5398;1866;5896
291740;201405;4051;11843;3228;10581;346;1300;2293;7506;2639;8806
291750;201405;22355;58908;17728;51986;3811;11618;9785;29172;13596;40790
291760;201405;12395;39558;11400;37792;4202;15177;4563;15162;8765;30339
291770;201405;8107;23632;7327;22301;1199;3940;4836;14560;6035;18500
291780;201405;4360;13534;4106;13071;483;1533;3134;10033;3617;11566
291790;201405;2503;7903;2364;7715;132;537;2026;6565;2158;7102
291800;201405;31921;93245;28980;89054;5765;18295;18199;57387;23964;75682
291810;201405;10951;31262;9397;29393;661;2334;7652;24141;8313;26475
291820;201405;3652;11026;3301;10518;338;1083;2541;8207;2879;9290
291830;201405;4426;12024;4145;11621;508;1500;3168;8932;3676;10432
291835;201405;6197;19443;5135;17686;1164;4320;3094;10655;4258;14975
291840;201405;50098;137264;42672;129248;5271;15382;33021;103112;38292;118494
291845;201405;2999;8728;2701;8387;226;636;2354;7438;2580;8074
291850;201405;4843;13656;4077;12584;462;1394;3069;9734;3531;11128
291855;201405;1717;4535;1486;4236;194;663;1094;3024;1288;3687
291860;201405;2080;6225;1790;5664;186;640;1159;3655;1345;4295
291870;201405;1389;3789;1092;3264;120;454;703;2069;823;2523
291875;201405;2915;9300;2624;8848;246;1034;1868;6167;2114;7201
291880;201405;4689;15027;4485;14694;345;1175;3749;12379;4094;13554
291890;201405;1434;3626;1220;3369;286;802;735;2103;1021;2905
291900;201405;1343;3814;1147;3510;115;415;879;2663;994;3078
291905;201405;2990;7923;2505;7152;230;742;1782;5141;2012;5883
291910;201405;2656;7288;2304;6857;177;640;1890;5580;2067;6220
291915;201405;6759;21053;6033;19646;501;1678;4954;16357;5455;18035
291920;201405;32719;96853;30340;93351;6197;19505;18652;58986;24849;78491
291930;201405;2585;7700;2343;7332;245;874;1744;5455;1989;6329
291940;201405;3612;10354;2722;8779;416;1509;1551;4862;1967;6371
291950;201405;9366;31701;8521;30324;1951;6912;4783;17620;6734;24532
291955;201405;8578;27607;8236;27088;1977;6397;4964;16996;6941;23393
291960;201405;3420;10144;2913;9422;342;1031;2092;7120;2434;8151
291970;201405;4434;13352;3946;12730;589;2015;2756;8965;3345;10980
291980;201405;11555;33578;8858;29687;978;3401;6333;21773;7311;25174
291990;201405;2192;7076;2020;6810;207;723;1527;5272;1734;5995
291992;201405;2838;8828;2772;8692;467;1544;1998;6229;2465;7773
291995;201405;2151;6374;1921;6039;242;798;1434;4566;1676;5364
292000;201405;2400;7161;2174;6832;399;1394;1441;4501;1840;5895
292010;201405;6444;16615;4956;14426;485;1450;3797;11113;4282;12563
292020;201405;4518;15330;4194;14808;671;2502;2933;10529;3604;13031
292030;201405;2247;7039;1996;6684;258;939;1312;4437;1570;5376
292040;201405;4656;13049;4132;12502;332;883;3508;11022;3840;11905
292045;201405;2653;9287;2626;9244;89;288;2487;8790;2576;9078
292050;201405;6443;20221;5690;18724;573;2301;3920;12696;4493;14997
292060;201405;11079;31280;10606;30655;1016;2956;8724;25326;9740;28282
292070;201405;4423;14151;4310;14007;417;1185;3666;12162;4083;13347
292080;201405;3710;9827;3219;9197;296;875;2603;7523;2899;8398
292090;201405;4329;11586;3725;10899;339;1131;3037;8922;3376;10053
292100;201405;11094;30955;9572;28988;2509;7818;5079;16074;7588;23892
292105;201405;3229;9903;2803;9300;239;937;2239;7407;2478;8344
292110;201405;7119;18911;5469;16467;1138;3452;3231;10052;4369;13504
292120;201405;8667;24502;7729;22841;1586;4767;4195;13121;5781;17888
292130;201405;3203;8641;2868;8174;564;1518;1928;5671;2492;7189
292140;201405;5533;14365;4811;13402;668;1817;3322;9649;3990;11466
292145;201405;2715;8358;2475;7988;218;679;1875;6338;2093;7017
292150;201405;13671;41830;12693;40274;923;3267;9993;32116;10916;35383
292160;201405;2784;8015;2407;7511;176;524;2034;6487;2210;7011
292170;201405;8980;26644;7686;24425;1164;4042;4848;15653;6012;19695
292180;201405;3570;10327;2882;9251;450;1446;1862;6095;2312;7541
292190;201405;3345;9464;2887;8815;577;1842;1847;5733;2424;7575
292200;201405;5945;20034;5349;18813;1601;6016;2253;7952;3854;13968
292205;201405;3997;12505;3668;12061;277;1055;2960;9741;3237;10796
292210;201405;6754;19247;5843;18037;561;1779;4566;14457;5127;16236
292220;201405;1924;5473;1822;5325;343;934;1172;3471;1515;4405
292225;201405;3096;9730;2857;9379;191;690;2368;7848;2559;8538
292230;201405;6284;19101;6015;18680;649;2455;4587;13844;5236;16299
292240;201405;4497;14303;4163;13572;639;2245;2630;8493;3269;10738
292250;201405;5298;16430;4959;15817;1070;3544;2727;8726;3797;12270
292260;201405;3167;9792;3022;9575;309;1034;2419;7690;2728;8724
292265;201405;2875;9463;2608;8990;189;775;2002;6861;2191;7636
292270;201405;4008;10894;3275;10031;249;936;2680;8173;2929;9109
292273;201405;2825;6903;2179;6092;291;771;1580;4644;1871;5415
292275;201405;1902;4978;1778;4805;200;605;1364;3661;1564;4266
292280;201405;2095;6235;1904;6028;198;485;1486;5040;1684;5525
292285;201405;2646;7472;2352;7048;224;752;1828;5557;2052;6309
292290;201405;7484;22497;6284;20911;453;1747;4966;16771;5419;18518
292300;201405;8612;26530;7566;25363;1945;6617;4660;16109;6605;22726
292303;201405;2848;8972;2665;8722;128;487;2300;7529;2428;8016
292305;201405;3179;8689;3026;8489;123;372;2720;7661;2843;8033
292310;201405;5985;17930;5456;17197;264;955;4606;14565;4870;15520
292320;201405;6195;18721;5492;17508;583;2074;4180;13313;4763;15387
292330;201405;2028;5769;1907;5607;215;691;1499;4367;1714;5058
292335;201405;5377;14198;4815;13458;528;1459;3889;10971;4417;12430
292340;201405;6641;19027;5721;17580;649;2074;4073;12653;4722;14727
292350;201405;2177;6660;2010;6448;248;884;1560;5014;1808;5898
292360;201405;4978;14489;4791;13972;197;565;4217;12581;4414;13146
292370;201405;8905;26635;8080;25405;1054;3188;5752;18905;6806;22093
292380;201405;7519;21951;7018;21162;553;1553;5796;17707;6349;19260
292390;201405;3782;8570;3347;8101;108;183;3140;7702;3248;7885
292400;201405;22319;66503;21338;64932;3135;9996;15250;47227;18385;57223
292405;201405;4429;11849;3840;11121;266;785;3208;9388;3474;10173
292410;201405;1943;5260;1848;5153;142;404;1612;4500;1754;4904
292420;201405;3858;12376;3719;12215;173;463;3412;11446;3585;11909
292430;201405;5562;17010;4448;15446;289;1184;3455;11994;3744;13178
292440;201405;8608;28490;8019;27629;304;1204;7008;24517;7312;25721
292450;201405;4455;13265;3658;11999;345;1210;2689;8972;3034;10182
292460;201405;5701;17161;5043;15985;958;3110;3156;10153;4114;13263
292465;201405;2429;7427;2089;6884;241;899;1500;4996;1741;5895
292467;201405;2146;7055;2037;6872;411;1469;1332;4569;1743;6038
292470;201405;3211;8620;2678;7761;245;834;2018;5766;2263;6600
292480;201405;6190;16904;5329;15718;363;1198;4456;13173;4819;14371
292490;201405;2348;6533;1977;5988;184;657;1518;4535;1702;5192
292500;201405;6644;20108;5809;18677;593;2084;4246;13831;4839;15915
292510;201405;13369;38559;11857;36426;1285;4157;9090;28415;10375;32572
292520;201405;5951;18169;5455;17348;1535;4940;2823;9138;4358;14078
292525;201405;5570;14650;4860;13814;401;1171;3946;11379;4347;12550
292530;201405;25951;77920;23701;75099;5470;17712;14229;46732;19699;64444
292540;201405;2893;8485;2624;8107;373;1346;1940;5924;2313;7270
292550;201405;6579;21429;5878;20414;860;3131;4170;14865;5030;17996
292560;201405;4196;11626;3600;10846;312;1162;2909;8605;3221;9767
292570;201405;4080;12165;3929;12006;158;465;3480;10986;3638;11451
292575;201405;6066;20924;5926;20670;941;3402;4400;15410;5341;18812
292580;201405;7182;21337;6659;20685;539;1685;5549;17467;6088;19152
292590;201405;7300;23211;6970;22673;875;2894;5250;17213;6125;20107
292593;201405;3305;8694;2803;7959;274;788;2172;6168;2446;6956
292595;201405;6081;16999;5300;15977;507;1618;4060;12369;4567;13987
292600;201405;10688;30325;9995;29448;1016;2354;8177;25030;9193;27384
292610;201405;4400;12865;3616;11558;492;1629;2365;7732;2857;9361
292620;201405;5914;17998;5201;17156;303;1020;4626;15394;4929;16414
292630;201405;10015;25466;8669;23474;826;2300;6560;18089;7386;20389
292640;201405;8289;26942;7372;25715;642;2353;5689;20338;6331;22691
292650;201405;5013;13656;4814;13426;550;1065;3926;11715;4476;12780
292660;201405;11203;34184;10651;33376;1305;4191;8119;25965;9424;30156
292665;201405;2847;8355;2782;8263;82;204;2610;7854;2692;8058
292670;201405;3939;11228;3058;9730;326;1130;2009;6444;2335;7574
292680;201405;3678;11165;3454;10836;350;1096;2783;8780;3133;9876
292690;201405;3412;9301;2467;7826;298;1023;1663;5381;1961;6404
292700;201405;9357;28422;8147;26664;1147;3449;5847;20055;6994;23504
292710;201405;1950;6455;1857;6316;92;345;1661;5668;1753;6013
292720;201405;9611;24984;8501;23735;741;2071;7112;20123;7853;22194
292730;201405;3435;10651;3331;10480;503;1534;2384;7703;2887;9237
292740;201405;357191;1007985;340017;983093;78519;238081;209286;606757;287805;844838
292750;201405;5978;16576;5405;15804;418;1206;4388;13051;4806;14257
292760;201405;4292;13758;3971;13201;586;2115;2611;8790;3197;10905
292770;201405;6151;18892;5765;18285;1277;4034;3605;11811;4882;15845
292780;201405;1893;4606;1498;4116;184;610;1091;2952;1275;3562
292790;201405;3421;9117;3269;8953;258;561;2782;7959;3040;8520
292800;201405;9585;29012;8977;28035;904;3101;6990;21823;7894;24924
292805;201405;3216;9464;2951;9086;574;1875;1981;6126;2555;8001
292810;201405;10137;30770;8583;28715;1122;3927;6351;21735;7473;25662
292820;201405;7506;21602;5513;18756;411;1601;4394;15038;4805;16639
292830;201405;1902;5680;1725;5435;117;462;1410;4406;1527;4868
292840;201405;7352;24222;6884;23575;434;1628;5961;20445;6395;22073
292850;201405;3287;8727;2732;7907;321;975;1961;5650;2282;6625
292860;201405;15347;41981;14715;41183;1860;5262;11476;32440;13336;37702
292870;201405;19726;55061;17507;51616;3078;9911;10600;30942;13678;40853
292880;201405;12020;35887;10869;34099;1727;5577;7066;22330;8793;27907
292890;201405;5659;19565;5118;18542;964;3671;3037;11299;4001;14970
292895;201405;2780;7019;2251;6219;303;841;1634;4510;1937;5351
292900;201405;3075;9675;2913;9414;402;1596;1997;6218;2399;7814
292905;201405;4305;12567;3648;11735;280;781;3067;10178;3347;10959
292910;201405;5186;16077;4769;15333;862;2963;2993;9570;3855;12533
292920;201405;8743;26178;8319;25515;872;2980;6463;19338;7335;22318
292925;201405;5134;16108;4574;15325;434;1508;3570;12065;4004;13573
292930;201405;6543;21271;6248;20728;709;2921;4629;15002;5338;17923
292935;201405;2151;6182;1814;5816;120;304;1543;5143;1663;5447
292937;201405;3331;8540;2831;7914;314;1010;2200;6080;2514;7090
292940;201405;3125;8709;2477;7807;317;1018;1678;5473;1995;6491
292950;201405;8260;25284;7886;24652;980;3626;5767;17567;6747;21193
292960;201405;4913;13448;4357;12662;476;1527;3135;9024;3611;10551
292970;201405;4306;13344;3941;12864;201;810;3311;10804;3512;11614
292975;201405;3428;9443;3304;9260;359;999;2740;7762;3099;8761
292980;201405;3614;9998;2952;9187;395;1424;2088;6474;2483;7898
292990;201405;12333;35570;11216;33869;734;2304;9547;28921;10281;31225
293000;201405;2972;7843;2436;7169;130;446;2112;6214;2242;6660
293010;201405;19011;54053;16659;50341;3066;10110;10349;31262;13415;41372
293015;201405;7829;25732;6391;23597;1051;4260;4135;15164;5186;19424
293020;201405;9532;31694;8921;30835;626;2461;7363;25690;7989;28151
293030;201405;5626;16506;4579;14950;480;1638;3201;10813;3681;12451
293040;201405;3728;12148;3555;11829;223;775;3103;10343;3326;11118
293050;201405;20378;57844;18154;54991;2866;8775;12237;38153;15103;46928
293060;201405;4359;11225;3685;10161;427;1260;2546;6988;2973;8248
293070;201405;20565;63025;19064;60442;5121;16570;10129;32893;15250;49463
293075;201405;3456;11143;3130;10733;238;854;2593;8998;2831;9852
293076;201405;3752;10631;3491;10253;279;791;2925;8745;3204;9536
293077;201405;5086;15869;4413;14995;922;3248;2697;9311;3619;12559
293080;201405;4910;15448;4511;14804;354;1491;3550;11409;3904;12900
293090;201405;3593;11320;2962;10424;286;1020;2268;8118;2554;9138
293100;201405;5799;17756;4986;16325;550;1893;3664;12189;4214;14082
293105;201405;3905;13114;3455;12245;502;1880;2354;8461;2856;10341
293110;201405;1973;5966;1841;5754;133;485;1501;4660;1634;5145
293120;201405;4074;13620;3783;13204;334;1158;3038;10798;3372;11956
293130;201405;3956;11391;3235;10574;191;691;2838;9423;3029;10114
293135;201405;29336;76093;22792;67310;4371;14981;11861;34809;16232;49790
293140;201405;2114;6308;2043;6206;221;803;1568;4645;1789;5448
293150;201405;5875;19368;5288;18240;1051;3747;3137;11184;4188;14931
293160;201405;3564;9683;3345;9431;479;997;2582;7735;3061;8732
293170;201405;3458;10602;3217;10244;477;1602;2299;7449;2776;9051
293180;201405;5403;15316;4486;13901;381;1400;3480;10636;3861;12036
293190;201405;13906;42633;13192;41540;633;2833;11358;35047;11991;37880
293200;201405;6440;18934;5717;17919;278;1043;4912;15366;5190;16409
293210;201405;4896;14786;4538;14188;515;1748;3321;10466;3836;12214
293220;201405;5271;15990;4751;15151;1177;3894;2526;8211;3703;12105
293230;201405;3955;12488;3661;12081;436;1601;2831;9348;3267;10949
293240;201405;4560;12031;3605;10662;207;626;2814;8306;3021;8932
293245;201405;4495;13018;4110;12403;517;1575;2935;9166;3452;10741
293250;201405;6006;16978;5518;16265;693;2151;3997;11771;4690;13922
293260;201405;4763;14358;3997;13265;376;1382;2962;9963;3338;11345
293270;201405;5888;16161;5592;15841;542;1348;4823;13985;5365;15333
293280;201405;5697;16143;4961;15174;454;1263;3856;12208;4310;13471
293290;201405;16613;55870;15735;54119;3569;12650;8938;31451;12507;44101
293300;201405;6532;16430;5616;15402;473;1241;4575;12706;5048;13947
293305;201405;4787;12104;4216;11319;293;837;3493;9387;3786;10224
293310;201405;2754;7140;2267;6338;249;751;1572;4352;1821;5103
293315;201405;4950;12648;4500;11971;754;1925;2850;8048;3604;9973
293317;201405;2596;7638;2338;7167;292;926;1550;4798;1842;5724
293320;201405;8171;26891;7983;26649;775;2809;6647;22200;7422;25009
293325;201405;1948;5688;1624;5189;274;954;1075;3451;1349;4405
293330;201405;55422;176274;50078;167329;11157;40030;27732;94117;38889;134147
293340;201405;2727;7815;2173;6867;287;1032;1519;4711;1806;5743
293345;201405;3557;10745;3016;9970;350;1147;2190;7500;2540;8647
293350;201405;6790;18936;6504;18604;407;1031;5785;16888;6192;17919
293360;201405;13894;42446;12678;40853;828;2543;10813;35640;11641;38183
310010;201405;1248;3413;910;2876;244;934;369;1057;613;1991
310020;201405;3858;12327;3230;10944;1144;4177;630;1953;1774;6130
310030;201405;2517;8380;2227;7825;665;2459;1072;3766;1737;6225
310040;201405;1013;2788;857;2578;92;334;633;1869;725;2203
310050;201405;1948;6805;1737;6296;338;1453;896;3188;1234;4641
310060;201405;3236;10975;2957;10592;384;1432;2217;8092;2601;9524
310070;201405;314;912;238;770;39;167;120;349;159;516
310080;201405;775;2419;631;2137;179;692;207;650;386;1342
310090;201405;4885;14641;4236;13526;694;2442;2620;8392;3314;10834
310100;201405;3365;10385;2820;9473;283;1139;2102;7020;2385;8159
310110;201405;5941;16939;5025;15583;1116;3937;2796;8594;3912;12531
310120;201405;590;1946;559;1887;212;843;237;685;449;1528
310130;201405;467;1475;428;1414;102;392;218;674;320;1066
310140;201405;267;930;233;867;84;349;54;177;138;526
310150;201405;4930;15435;4492;14648;955;3546;2380;7717;3335;11263
310160;201405;7320;23921;6403;22262;1937;7414;2493;8552;4430;15966
310163;201405;827;2778;720;2561;193;772;289;988;482;1760
310170;201405;9901;28463;9146;27333;1655;5067;6003;18541;7658;23608
310180;201405;1879;5478;1534;4995;392;1444;748;2358;1140;3802
310190;201405;2572;8714;2339;8322;729;2872;391;1448;1120;4320
310200;201405;1932;6565;1628;5940;492;1963;555;2017;1047;3980
310205;201405;1023;3156;888;2911;185;604;525;1779;710;2383
310210;201405;2529;8019;2347;7736;357;1312;1684;5528;2041;6840
310220;201405;1273;3665;1025;3340;224;791;586;1888;810;2679
310230;201405;2965;9780;2561;8876;775;3085;1001;3202;1776;6287
310240;201405;1034;3660;883;3372;162;675;456;1836;618;2511
310250;201405;977;3402;953;3363;204;813;602;2062;806;2875
310260;201405;3237;10558;2744;9503;738;2870;1024;3451;1762;6321
310270;201405;2419;7280;2170;6909;211;728;1687;5449;1898;6177
310280;201405;2163;6311;1950;5967;545;1960;919;2671;1464;4631
310285;201405;2229;7847;2096;7650;299;1134;1570;5856;1869;6990
310290;201405;1339;4226;1249;4087;381;1438;593;1755;974;3193
310300;201405;1914;6582;1816;6385;487;1862;1026;3587;1513;5449
310310;201405;399;1106;291;881;50;155;146;437;196;592
310320;201405;394;1327;342;1211;78;323;154;529;232;852
310330;201405;503;1292;375;1070;45;171;206;522;251;693
310340;201405;8478;26902;7476;25221;1474;5226;4298;14920;5772;20146
310350;201405;15311;44586;12108;38898;4267;14755;3456;11279;7723;26034
310360;201405;465;1477;452;1454;83;319;302;917;385;1236
310370;201405;1477;5240;1424;5141;430;1619;753;2739;1183;4358
310375;201405;1305;3619;946;2956;171;616;455;1374;626;1990
310380;201405;399;1133;320;1021;129;459;131;383;260;842
310390;201405;499;1805;426;1631;120;506;73;238;193;744
310400;201405;10350;31405;8356;27809;2746;9962;2481;8286;5227;18248
310410;201405;1047;3386;684;2797;250;1094;141;571;391;1665
310420;201405;5790;16975;3515;11695;849;3165;612;1818;1461;4983
310430;201405;1659;5695;1383;5130;463;1832;374;1367;837;3199
310440;201405;621;1823;543;1701;144;494;230;686;374;1180
310445;201405;1212;4126;1043;3834;147;603;688;2564;835;3167
310450;201405;4615;13491;3830;12334;732;2495;2397;7931;3129;10426
310460;201405;1623;5287;1414;4915;485;1841;331;1204;816;3045
310470;201405;3743;9800;3198;9126;318;1050;2522;7224;2840;8274
310480;201405;1114;3490;950;3168;233;922;384;1153;617;2075
310490;201405;3336;11387;2936;10616;973;3840;1112;4000;2085;7840
310500;201405;1522;5318;1413;5104;426;1654;593;2136;1019;3790
310510;201405;2548;8465;2225;7724;798;2990;504;1685;1302;4675
310520;201405;1388;3818;1149;3420;88;277;783;2338;871;2615
310530;201405;876;2827;566;2025;129;509;107;369;236;878
310540;201405;3753;12468;3482;12060;1206;4389;1429;5035;2635;9424
310550;201405;1211;3699;1022;3379;292;1151;419;1269;711;2420
310560;201405;16414;51898;14261;47717;4571;16979;5043;16133;9614;33112
310570;201405;1280;3996;1198;3888;168;608;891;2895;1059;3503
310590;201405;4126;12298;3320;10771;650;2363;1327;4163;1977;6526
310600;201405;1641;5570;1548;5370;541;2098;553;1783;1094;3881
310610;201405;560;1926;516;1832;162;670;176;568;338;1238
310620;201405;190235;608086;157790;542523;43222;165495;61745;204341;104967;369836
310630;201405;4216;13884;4003;13484;795;3034;2617;8609;3412;11643
310640;201405;1462;4563;1202;4103;416;1524;373;1225;789;2749
310650;201405;2934;9436;2404;8530;495;1900;1291;4714;1786;6614
310660;201405;1338;4139;1167;3896;179;643;845;2803;1024;3446
310665;201405;1206;3800;1111;3665;193;678;761;2555;954;3233
310670;201405;56574;179815;52396;170542;15721;53855;23166;74595;38887;128450
310680;201405;806;2407;742;2300;180;610;383;1166;563;1776
310690;201405;1295;4373;1057;3898;329;1386;278;960;607;2346
310700;201405;528;1480;448;1361;128;432;223;645;351;1077
310710;201405;7339;24069;5891;21666;1574;6474;1950;7025;3524;13499
310720;201405;857;2675;782;2537;236;879;353;1065;589;1944
310730;201405;9596;30659;8836;29462;2043;7367;5230;17522;7273;24889
310740;201405;5177;17806;4462;16264;1648;6473;1042;3626;2690;10099
310750;201405;1643;4298;1354;3912;240;709;897;2627;1137;3336
310760;201405;647;2022;557;1862;136;493;243;802;379;1295
310770;201405;761;2824;748;2800;286;1179;320;1145;606;2324
310780;201405;3687;10712;3309;10028;598;1841;2041;6209;2639;8050
310790;201405;1836;5896;1666;5619;454;1594;852;2955;1306;4549
310800;201405;3118;10242;2532;9052;1010;3932;430;1491;1440;5423
310810;201405;1534;4334;1400;4111;332;1055;704;1992;1036;3047
310820;201405;1497;4291;1096;3587;315;1131;353;1112;668;2243
310825;201405;2430;8359;1984;7579;160;812;1482;5616;1642;6428
310830;201405;1449;4975;1228;4503;411;1627;398;1367;809;2994
310840;201405;2346;7724;2011;7075;753;2928;538;1767;1291;4695
310850;201405;1557;4738;1339;4449;208;759;959;3185;1167;3944
310855;201405;3161;10381;2859;9902;671;2463;1687;5973;2358;8436
310860;201405;7710;24562;6912;23187;1233;4333;4062;14049;5295;18382
310870;201405;1041;3010;879;2737;191;635;430;1335;621;1970
310880;201405;1262;3936;963;3379;205;828;459;1585;664;2413
310890;201405;2801;8982;2236;7918;684;2736;627;2082;1311;4818
310900;201405;4411;14967;3854;13856;1157;4573;1576;5516;2733;10089
310910;201405;2095;6080;1457;4873;429;1600;370;1180;799;2780
310920;201405;1927;5941;1545;5388;409;1634;755;2618;1164;4252
310925;201405;962;3219;881;3082;335;1297;282;984;617;2281
310930;201405;5394;16043;4387;14475;876;3064;2542;8637;3418;11701
310940;201405;6314;18750;5448;17448;1096;3764;3066;9875;4162;13639
310945;201405;1313;3766;1071;3429;231;846;612;1882;843;2728
310950;201405;2019;6770;1625;5909;547;2219;482;1638;1029;3857
310960;201405;461;1605;415;1515;154;610;147;542;301;1152
310970;201405;1477;5271;1155;4396;434;1804;151;506;585;2310
310980;201405;485;1290;336;1004;64;239;148;386;212;625
310990;201405;1189;4154;1028;3802;261;1090;362;1255;623;2345
311000;201405;4294;15110;3836;14118;1187;4918;1361;4773;2548;9691
311010;201405;971;3166;866;2979;281;1026;410;1387;691;2413
311020;201405;896;2837;765;2619;184;713;321;1036;505;1749
311030;201405;1901;5740;1478;4872;470;1712;511;1529;981;3241
311040;201405;501;1712;436;1537;113;416;109;373;222;789
311050;201405;2644;8621;2265;7875;699;2666;905;3135;1604;5801
311060;201405;2434;7718;1991;6745;598;2176;501;1655;1099;3831
311070;201405;1737;6193;1540;5790;444;1893;503;1853;947;3746
311080;201405;1218;3323;1095;3131;161;506;735;2135;896;2641
311090;201405;1716;6522;1501;6069;551;2526;286;1079;837;3605
311100;201405;2397;8417;2124;7850;962;3753;545;2012;1507;5765
311110;201405;4113;9964;2952;8339;599;1869;1517;4217;2116;6086
311115;201405;1105;3447;965;3233;134;549;613;2090;747;2639
311120;201405;7671;22102;6071;19154;1647;5851;1700;5019;3347;10870
311130;201405;2370;7331;1910;6715;558;2279;837;2842;1395;5121
311140;201405;1318;3839;1145;3627;182;673;813;2523;995;3196
311150;201405;2444;8193;2260;7886;616;2217;1116;3984;1732;6201
311160;201405;4956;16875;4205;15584;1548;6153;1368;5033;2916;11186
311170;201405;755;2372;602;2074;77;267;330;1196;407;1463
311180;201405;1631;4581;1194;3716;385;1320;265;741;650;2061
311190;201405;1112;3380;947;3047;261;957;381;1146;642;2103
311200;201405;2554;7961;2217;7266;849;3018;569;1720;1418;4738
311205;201405;1191;3911;1058;3651;284;1109;405;1424;689;2533
311210;201405;956;3143;884;3029;163;566;628;2209;791;2775
311220;201405;932;3014;749;2598;207;759;257;878;464;1637
311230;201405;9035;27877;7658;25424;1604;5784;3851;13122;5455;18906
311240;201405;1359;4211;1137;3847;368;1361;379;1266;747;2627
311250;201405;1336;4500;1222;4327;413;1627;388;1212;801;2839
311260;201405;2973;8192;2266;6951;720;2413;683;2032;1403;4445
311265;201405;1328;3589;1030;3172;152;570;692;2121;844;2691
311270;201405;3459;11450;3103;10975;617;2549;2006;6923;2623;9472
311280;201405;1447;4076;1079;3366;298;1023;339;1031;637;2054
311290;201405;2326;7662;2152;7296;425;1422;1261;4418;1686;5840
311300;201405;5065;16896;4586;16119;740;2901;3004;10680;3744;13581
311310;201405;495;1774;479;1747;117;494;206;715;323;1209
311320;201405;4137;14039;3638;12911;976;3944;1289;4339;2265;8283
311330;201405;5560;17164;4791;15933;1766;6261;1606;5347;3372;11608
311340;201405;12357;40378;11305;38394;3916;14230;3625;12273;7541;26503
311350;201405;2340;6994;2006;6393;468;1706;928;2830;1396;4536
311360;201405;1344;3835;1078;3485;496;1670;303;1018;799;2688
311370;201405;4573;13766;4081;12925;1051;3947;1756;5263;2807;9210
311380;201405;480;1598;407;1461;124;518;122;397;246;915
311390;201405;2007;7472;1899;7283;831;3520;637;2345;1468;5865
311400;201405;1708;5769;1580;5541;473;1863;714;2338;1187;4201
311410;201405;2035;7438;1908;7251;626;2561;996;3813;1622;6374
311420;201405;2391;8378;2045;7502;774;3030;499;1676;1273;4706
311430;201405;3956;12598;3044;10586;766;2944;620;2118;1386;5062
311440;201405;2394;8297;1967;7546;753;3239;497;1874;1250;5113
311450;201405;1870;6630;1586;5930;474;1963;389;1362;863;3325
311455;201405;1609;4404;1387;4076;313;1025;759;2158;1072;3183
311460;201405;637;2122;512;1866;127;575;136;466;263;1041
311470;201405;618;1977;496;1712;146;598;154;484;300;1082
311480;201405;820;2316;781;2254;255;749;360;993;615;1742
311490;201405;320;1270;310;1238;118;491;110;431;228;922
311500;201405;525;1596;433;1423;155;549;162;522;317;1071
311510;201405;3175;9981;2643;8979;1045;4013;729;2314;1774;6327
311520;201405;696;2407;656;2322;251;948;247;854;498;1802
311530;201405;11466;30644;7948;24516;2212;8098;2331;6902;4543;15000
311535;201405;746;2298;545;1888;140;565;112;373;252;938
311540;201405;710;2580;678;2532;226;882;339;1251;565;2133
311545;201405;2233;7070;2111;6898;317;1151;1486;4861;1803;6012
311547;201405;1673;4701;1423;4320;148;487;970;2980;1118;3467
311550;201405;3392;11144;2963;10246;911;3501;985;3342;1896;6843
311560;201405;282;763;252;725;63;209;143;388;206;597
311570;201405;2087;5296;1711;4832;117;344;1387;3980;1504;4324
311580;201405;2408;5349;2003;4864;569;1298;1168;2977;1737;4275
311590;201405;400;1291;351;1227;115;483;100;339;215;822
311600;201405;1349;4120;1179;3903;297;960;680;2350;977;3310
311610;201405;3450;12062;3206;11674;1024;3748;1497;5829;2521;9577
311615;201405;2740;9045;2384;8423;307;1267;1656;5825;1963;7092
311620;201405;461;1494;417;1434;110;421;218;729;328;1150
311630;201405;1464;4395;1252;4011;298;937;662;2175;960;3112
311640;201405;896;2823;748;2582;131;490;507;1756;638;2246
311650;201405;2432;7039;2030;6392;319;1098;1210;3878;1529;4976
311660;201405;2632;9376;2321;8650;723;2997;451;1480;1174;4477
311670;201405;1440;4497;1251;4151;438;1588;515;1681;953;3269
311680;201405;2298;7280;1959;6777;479;1738;1104;3908;1583;5646
311690;201405;550;1534;466;1432;85;287;312;952;397;1239
311700;201405;2170;6334;1929;5978;194;768;1475;4465;1669;5233
311710;201405;1756;5490;1392;4831;560;2119;418;1430;978;3549
311720;201405;412;1414;378;1346;64;259;244;853;308;1112
311730;201405;5318;14173;3479;10968;1053;3687;1282;3775;2335;7462
311740;201405;1010;2913;884;2765;373;1146;426;1394;799;2540
311750;201405;3918;13352;3605;12878;622;2473;2291;8252;2913;10725
311760;201405;800;2771;750;2666;240;998;289;901;529;1899
311770;201405;2587;8236;2126;7406;570;2229;697;2356;1267;4585
311780;201405;1072;4081;939;3742;362;1609;201;765;563;2374
311783;201405;2055;6772;1850;6397;234;942;1215;4321;1449;5263
311787;201405;645;2273;480;1779;101;409;102;322;203;731
311790;201405;1292;4215;1079;3790;330;1245;280;947;610;2192
311800;201405;3914;13524;2897;10383;701;2701;237;706;938;3407
311810;201405;1043;3554;999;3473;47;227;839;2884;886;3111
311820;201405;829;2750;711;2469;230;930;331;1051;561;1981
311830;201405;10562;38270;9673;36034;3942;15386;2398;8921;6340;24307
311840;201405;3488;10497;3011;9777;951;3419;1295;4111;2246;7530
311850;201405;320;971;278;902;75;252;136;447;211;699
311860;201405;50049;157511;43825;145565;11666;42645;19609;63309;31275;105954
311870;201405;2399;7230;1929;6344;514;1927;651;1992;1165;3919
311880;201405;7149;21507;6487;20709;965;3018;4613;15390;5578;18408
311890;201405;1622;5131;1365;4580;391;1439;546;1788;937;3227
311900;201405;805;2528;733;2429;145;479;464;1629;609;2108
311910;201405;4752;14107;3906;12941;1135;4043;1653;5536;2788;9579
311920;201405;2089;6867;1808;6447;224;891;1233;4357;1457;5248
311930;201405;4841;14571;4329;13738;1728;5743;1380;4463;3108;10206
311940;201405;11577;35882;9833;32230;3068;11030;2480;7767;5548;18797
311950;201405;2318;6917;1974;6471;126;394;1616;5381;1742;5775
311960;201405;400;1383;368;1315;117;471;155;512;272;983
311970;201405;476;1722;411;1576;133;566;75;270;208;836
311980;201405;750;2136;570;1844;144;506;226;736;370;1242
311990;201405;520;1589;463;1502;188;650;162;493;350;1143
311995;201405;1133;3543;798;2700;180;679;193;552;373;1231
312000;201405;703;2194;659;2127;128;460;377;1209;505;1669
312010;201405;1049;3397;948;3191;206;749;440;1475;646;2224
312015;201405;1600;4973;1385;4599;205;786;825;2784;1030;3570
312020;201405;939;3064;838;2921;217;866;462;1580;679;2446
312030;201405;1821;5455;1641;5226;186;673;1278;4039;1464;4712
312040;201405;692;2652;594;2356;172;773;129;477;301;1250
312050;201405;1482;5171;1298;4782;404;1661;295;1033;699;2694
312060;201405;754;2318;670;2201;316;1092;197;589;513;1681
312070;201405;980;3065;655;2342;166;644;240;845;406;1489
312080;201405;2634;7463;2062;6564;472;1807;975;2843;1447;4650
312083;201405;942;2733;790;2512;135;501;469;1461;604;1962
312087;201405;2345;7200;2102;6861;324;1119;1480;4910;1804;6029
312090;201405;9907;32451;9103;31072;2837;10701;3866;12796;6703;23497
312100;201405;1364;4658;1205;4394;241;982;681;2549;922;3531
312110;201405;1193;4286;1071;4018;412;1700;219;742;631;2442
312120;201405;922;3241;833;3039;280;1138;225;736;505;1874
312125;201405;1253;4101;1119;3815;309;1111;526;1831;835;2942
312130;201405;833;2580;680;2247;166;633;272;855;438;1488
312140;201405;1148;3631;964;3199;217;782;368;1125;585;1907
312150;201405;552;1590;465;1399;46;157;312;918;358;1075
312160;201405;8147;28083;7482;26728;2419;9354;2720;9829;5139;19183
312170;201405;1024;3081;924;2880;140;461;572;1815;712;2276
312180;201405;1616;5048;1483;4819;441;1502;598;1908;1039;3410
312190;201405;679;2254;535;1966;222;901;107;377;329;1278
312200;201405;4810;14600;4199;13580;592;2019;2826;9215;3418;11234
312210;201405;1169;3290;943;2955;265;915;435;1314;700;2229
312220;201405;1928;6394;1747;6185;252;917;1312;4830;1564;5747
312230;201405;18195;61217;15464;55710;7198;27337;3307;12396;10505;39733
312235;201405;1758;5080;1474;4642;157;620;1003;3153;1160;3773
312240;201405;1126;3873;965;3530;292;1143;350;1277;642;2420
312245;201405;2382;7067;2070;6645;184;530;1659;5437;1843;5967
312247;201405;929;2768;714;2419;182;701;358;1236;540;1937
312250;201405;1147;3402;1002;3153;233;811;473;1451;706;2262
312260;201405;938;3017;787;2802;120;522;546;1923;666;2445
312270;201405;789;2517;683;2307;175;705;249;730;424;1435
312280;201405;473;1643;436;1555;195;737;55;193;250;930
312290;201405;820;2877;774;2810;328;1308;194;706;522;2014
312300;201405;1125;3788;951;3383;295;1123;146;463;441;1586
312310;201405;957;3675;874;3465;260;1119;356;1381;616;2500
312320;201405;2443;7049;1973;6104;572;1983;511;1331;1083;3314
312330;201405;1159;3554;1035;3369;272;1005;564;1836;836;2841
312340;201405;312;843;292;813;45;164;219;576;264;740
312350;201405;384;1009;356;974;46;149;289;760;335;909
312352;201405;1676;5509;1545;5320;444;1545;917;3267;1361;4812
312360;201405;3714;12740;3283;11854;1118;4355;912;3285;2030;7640
312370;201405;1679;5502;1554;5291;564;2129;558;1802;1122;3931
312380;201405;2016;5959;1835;5677;257;805;1316;4206;1573;5011
312385;201405;1253;3950;1143;3750;164;684;773;2426;937;3110
312390;201405;2043;6930;1743;6264;540;2046;361;1230;901;3276
312400;201405;3429;11408;3054;10660;1115;4043;1108;4036;2223;8079
312410;201405;10707;36192;9679;34127;3015;11581;3552;12235;6567;23816
312420;201405;4078;13098;3885;12870;756;2492;2637;9041;3393;11533
312430;201405;8546;25579;7612;24183;1326;4334;4988;16346;6314;20680
312440;201405;638;2101;570;1971;151;571;272;947;423;1518
312450;201405;1170;4279;1075;4078;475;1848;387;1476;862;3324
312460;201405;400;1229;359;1183;83;308;194;623;277;931
312470;201405;769;2213;537;1747;133;500;134;426;267;926
312480;201405;1300;4007;1120;3791;377;1359;521;1730;898;3089
312490;201405;1996;5378;1623;4837;238;856;995;2836;1233;3692
312500;201405;619;2176;588;2122;143;613;318;1114;461;1727
312510;201405;2442;8154;2016;7193;554;2230;712;2328;1266;4558
312520;201405;403;1380;356;1281;121;450;126;465;247;915
312530;201405;581;1931;554;1876;112;461;320;1017;432;1478
312540;201405;1470;4709;1179;4136;302;1166;600;2057;902;3223
312550;201405;640;2075;579;1947;63;249;386;1270;449;1519
312560;201405;2191;5870;1913;5506;225;734;1447;4187;1672;4921
312570;201405;2755;8448;2413;7832;765;2658;795;2494;1560;5152
312580;201405;535;1812;438;1616;103;445;179;629;282;1074
312590;201405;1854;6275;1638;5796;496;2001;543;1742;1039;3743
312595;201405;2038;6939;1820;6411;521;1981;821;2816;1342;4797
312600;201405;822;2984;754;2837;224;955;334;1185;558;2140
312610;201405;8583;27248;7423;24978;2779;10002;2335;7672;5114;17674
312620;201405;2096;6081;1611;5450;100;357;1322;4610;1422;4967
312630;201405;512;1751;474;1678;129;509;214;737;343;1246
312640;201405;596;1986;496;1776;127;533;202;674;329;1207
312650;201405;2368;7076;1743;5910;213;838;939;3151;1152;3989
312660;201405;1267;3534;1091;3310;160;576;733;2177;893;2753
312670;201405;6003;18786;5515;18037;1379;5063;2827;9082;4206;14145
312675;201405;1469;4662;1268;4262;227;838;720;2445;947;3283
312680;201405;1720;5305;1541;5016;247;902;937;3114;1184;4016
312690;201405;2416;6697;1995;6105;385;1375;1124;3293;1509;4668
312695;201405;910;3271;856;3188;174;632;570;2203;744;2835
312700;201405;2196;6481;1710;5544;310;1127;900;2883;1210;4010
312705;201405;1419;4201;1240;3948;197;644;846;2708;1043;3352
312707;201405;1775;5518;1475;5012;249;1021;815;2710;1064;3731
312710;201405;8135;23290;6101;19716;2324;8301;1469;4471;3793;12772
312720;201405;765;2641;698;2515;191;765;302;1041;493;1806
312730;201405;1905;4788;1430;4258;221;766;872;2593;1093;3359
312733;201405;1761;4791;1354;4033;123;448;965;2771;1088;3219
312735;201405;899;2718;800;2573;261;898;406;1298;667;2196
312737;201405;1050;2592;744;2177;252;756;307;941;559;1697
312738;201405;520;1699;421;1508;129;542;165;560;294;1102
312740;201405;506;1460;347;1253;117;456;108;399;225;855
312750;201405;1302;4763;1247;4646;324;1375;593;2170;917;3545
312760;201405;2432;7924;1930;6925;585;2338;474;1708;1059;4046
312770;201405;45494;126910;35775;112039;10835;36694;12150;37856;22985;74550
312780;201405;2819;10098;2530;9594;512;2118;1462;5667;1974;7785
312790;201405;376;1011;238;767;81;298;64;182;145;480
312800;201405;5263;18031;4593;16652;1471;5695;1504;5590;2975;11285
312810;201405;2222;6934;1651;5890;558;2193;377;1269;935;3462
312820;201405;2143;6432;1973;6149;268;993;1266;3839;1534;4832
312825;201405;1539;4227;1354;4003;134;432;1078;3178;1212;3610
312830;201405;2804;9133;2055;7572;618;2493;385;1417;1003;3910
312840;201405;1192;3977;1007;3617;207;895;446;1532;653;2427
312850;201405;653;2146;554;1941;133;559;202;685;335;1244
312860;201405;1312;3867;1023;3421;347;1348;328;976;675;2324
312870;201405;5683;18252;4468;15934;1259;5095;1302;4438;2561;9533
312880;201405;1238;3768;1046;3439;224;834;548;1776;772;2610
312890;201405;1643;5086;1266;4339;421;1618;446;1482;867;3100
312900;201405;1468;4769;1357;4615;343;1206;830;2875;1173;4081
312910;201405;1504;3496;1175;3050;309;919;548;1333;857;2252
312920;201405;1043;3405;917;3226;287;1127;398;1357;685;2484
312930;201405;2231;6679;1981;6321;454;1514;1038;3406;1492;4920
312940;201405;938;3174;847;3003;248;1040;268;876;516;1916
312950;201405;3539;10187;2902;9228;959;3305;1164;3661;2123;6966
312960;201405;1943;5963;1759;5720;205;677;1342;4473;1547;5150
312965;201405;1809;5857;1552;5397;327;1217;881;3129;1208;4346
312970;201405;1143;3987;1029;3824;428;1783;202;718;630;2501
312980;201405;21206;75030;20408;73067;7803;29864;7631;26695;15434;56559
312990;201405;396;1221;300;1047;109;426;90;312;199;738
313000;201405;521;1761;448;1624;140;617;164;528;304;1145
313005;201405;2640;8656;2357;8187;387;1502;1486;5160;1873;6662
313010;201405;4137;14024;3720;13311;1169;4624;1541;5282;2710;9906
313020;201405;1045;3619;949;3392;319;1281;289;909;608;2190
313030;201405;1589;4531;1288;4119;343;1240;682;2087;1025;3327
313040;201405;981;3474;838;3066;228;907;248;881;476;1788
313050;201405;1918;6320;1598;5849;541;2205;570;2009;1111;4214
313055;201405;1518;5093;1404;4928;152;555;1045;3752;1197;4307
313060;201405;982;3431;895;3229;397;1495;166;580;563;2075
313065;201405;1945;6511;1773;6243;301;1202;1266;4435;1567;5637
313070;201405;1270;3795;1032;3346;259;966;500;1534;759;2500
313080;201405;476;1511;393;1347;121;478;121;350;242;828
313090;201405;5406;16368;4953;15601;797;2674;3345;10670;4142;13344
313100;201405;1162;3776;1084;3660;176;657;780;2617;956;3274
313110;201405;1718;5128;1360;4449;330;1239;508;1561;838;2800
313115;201405;2888;10236;2765;9985;861;3459;1308;4527;2169;7986
313120;201405;3861;11205;3365;10498;1017;3350;1793;5615;2810;8965
313130;201405;27134;86966;24395;81077;7393;26971;8827;27952;16220;54923
313140;201405;725;1910;538;1620;51;187;352;1043;403;1230
313150;201405;1665;5251;1507;4968;677;2307;430;1461;1107;3768
313160;201405;1175;3590;1055;3391;206;770;641;1986;847;2756
313170;201405;9797;36374;9085;34611;3677;14588;2108;8120;5785;22708
313180;201405;2754;7288;2093;6422;644;2167;759;2244;1403;4411
313190;201405;3565;13164;3194;12082;925;3804;1115;4114;2040;7918
313200;201405;1521;4821;1364;4573;233;926;859;2902;1092;3828
313210;201405;4616;14727;3960;13845;934;3752;2189;7442;3123;11194
313220;201405;1306;4008;980;3290;261;1007;271;807;532;1814
313230;201405;2533;9067;2381;8835;424;1647;1547;5944;1971;7591
313240;201405;8315;28410;7171;26260;2059;8282;2971;10901;5030;19183
313250;201405;7783;24489;7060;23297;1287;4335;4317;14662;5604;18997
313260;201405;629;1965;524;1763;133;512;154;489;287;1001
313270;201405;5701;16899;5113;16020;738;2430;3604;11461;4342;13891
313280;201405;544;1790;426;1495;86;349;109;351;195;700
313290;201405;1043;3783;868;3425;294;1257;219;817;513;2074
313300;201405;1988;6872;1708;6174;541;2145;352;1146;893;3291
313310;201405;1083;3851;989;3649;284;1196;195;656;479;1852
313320;201405;2444;7476;2035;6774;426;1495;909;3073;1335;4568
313330;201405;3913;12932;3466;12088;733;2913;1787;6184;2520;9097
313340;201405;2204;5449;1736;4789;373;1082;990;2699;1363;3781
313350;201405;3396;10720;2654;9042;705;2579;561;1753;1266;4332
313360;201405;1200;3700;932;3194;297;1184;406;1282;703;2466
313370;201405;1497;5261;1422;5047;306;1264;665;2203;971;3467
313375;201405;2102;5680;1422;4659;388;1522;505;1600;893;3122
313380;201405;6859;23681;6024;21847;2297;9027;1848;6410;4145;15437
313390;201405;918;3379;888;3332;131;560;602;2239;733;2799
313400;201405;3751;11033;3488;10710;434;1405;2682;8396;3116;9801
313410;201405;1383;3981;1182;3710;244;837;733;2310;977;3147
313420;201405;19969;49766;13025;37426;3243;10488;3173;8834;6416;19322
313430;201405;1322;4358;1191;4118;376;1432;449;1491;825;2923
313440;201405;6629;16141;4990;14217;739;2270;3434;9838;4173;12108
313450;201405;739;2223;596;1922;155;600;210;617;365;1217
313460;201405;2596;9286;2348;8842;797;3273;753;2735;1550;6008
313470;201405;3479;9779;3302;9575;359;888;2754;8245;3113;9133
313480;201405;1148;3399;888;2939;163;615;390;1243;553;1858
313490;201405;1614;5348;1197;4630;452;1768;331;1313;783;3081
313500;201405;449;1448;429;1413;88;340;267;852;355;1192
313505;201405;9000;26847;8426;26167;534;1217;7564;24274;8098;25491
313507;201405;1347;3998;1210;3794;235;861;725;2280;960;3141
313510;201405;15951;47912;14395;45972;2298;7394;10395;34065;12693;41459
313520;201405;16463;49898;14015;45770;2175;8099;9007;29315;11182;37414
313530;201405;559;1943;498;1818;93;387;192;655;285;1042
313535;201405;2566;7744;2302;7311;373;1233;1482;4786;1855;6019
313540;201405;1144;3650;905;3046;265;931;240;749;505;1680
313545;201405;1403;5169;1248;4884;228;1076;769;2887;997;3963
313550;201405;1965;6757;1873;6561;540;2029;952;3229;1492;5258
313560;201405;2325;5784;2039;5454;274;649;1575;4411;1849;5060
313570;201405;821;3033;722;2841;275;1171;252;942;527;2113
313580;201405;6283;17966;5423;16795;758;2534;3911;12219;4669;14753
313590;201405;1089;3271;883;3027;413;1500;328;1112;741;2612
313600;201405;3969;12208;3510;11475;624;2155;2142;7163;2766;9318
313610;201405;1168;3688;1019;3399;272;996;449;1475;721;2471
313620;201405;7491;25340;7089;24489;2511;9212;2492;8500;5003;17712
313630;201405;9003;27870;7626;25669;2329;8623;2819;9903;5148;18526
313640;201405;866;2755;747;2588;274;996;302;1059;576;2055
313650;201405;2324;7652;2068;7245;298;1041;1510;5421;1808;6462
313652;201405;1026;3719;946;3558;176;706;574;2176;750;2882
313655;201405;1017;3363;844;3072;172;712;511;1813;683;2525
313657;201405;1202;3970;1085;3772;162;733;724;2300;886;3033
313660;201405;911;3167;844;3049;221;916;414;1433;635;2349
313665;201405;3128;10473;2906;9980;701;2739;1450;4809;2151;7548
313670;201405;48764;141158;34183;116268;10375;39314;10729;35367;21104;74681
313680;201405;1118;3395;985;3192;133;443;702;2305;835;2748
313690;201405;982;3554;882;3345;257;1008;364;1427;621;2435
313695;201405;1498;4939;1290;4602;167;685;899;3214;1066;3899
313700;201405;3983;13294;3396;12492;557;2142;2380;8901;2937;11043
313710;201405;1430;4059;1206;3729;348;1174;587;1776;935;2950
313720;201405;5447;18497;4740;16980;1342;5359;1464;4762;2806;10121
313730;201405;1316;3623;1036;3285;142;493;688;2207;830;2700
313740;201405;2114;7719;1764;6812;630;2711;255;932;885;3643
313750;201405;2995;9308;2635;8617;890;3090;799;2471;1689;5561
313753;201405;1900;5782;1584;5231;505;1751;624;2102;1129;3853
313760;201405;4347;14585;3747;13344;1206;4700;1155;3949;2361;8649
313770;201405;3715;12610;3537;12208;1238;4516;1161;3978;2399;8494
313780;201405;4017;11536;3271;10441;832;3045;1575;4917;2407;7962
313790;201405;558;1956;541;1932;127;464;309;1126;436;1590
313800;201405;1272;3659;1130;3433;190;646;716;2171;906;2817
313810;201405;1561;4752;1501;4664;203;608;1138;3634;1341;4242
313820;201405;13272;39456;11209;35783;3205;11383;4454;14269;7659;25652
313830;201405;453;1551;390;1420;125;516;125;443;250;959
313835;201405;1083;3587;1034;3513;249;904;575;1938;824;2842
313840;201405;7694;23447;6519;21441;1950;7132;2227;7050;4177;14182
313850;201405;1290;3644;1164;3425;287;953;625;1744;912;2697
313860;201405;2734;8583;2281;7607;696;2620;536;1620;1232;4240
313862;201405;1148;3114;821;2568;255;846;264;836;519;1682
313865;201405;2260;7264;2103;6991;324;1203;1459;4833;1783;6036
313867;201405;1087;3816;931;3492;343;1363;318;1203;661;2566
313868;201405;1577;5605;1403;5236;185;798;936;3494;1121;4292
313870;201405;927;2941;833;2803;243;944;328;1027;571;1971
313880;201405;2273;7377;2084;7125;525;2079;1058;3367;1583;5446
313890;201405;2022;5591;1728;5218;282;844;1153;3562;1435;4406
313900;201405;4839;17787;4516;17053;1714;7082;1315;4958;3029;12040
313910;201405;777;2666;669;2437;279;1096;127;433;406;1529
313920;201405;3754;12177;3416;11603;617;2070;2124;7535;2741;9605
313925;201405;2137;5719;1539;4595;142;492;1024;3031;1166;3523
313930;201405;5417;17940;4561;16439;813;3186;2656;9820;3469;13006
313940;201405;7616;26551;6606;24889;2285;9355;2543;9883;4828;19238
313950;201405;4921;14464;4131;13174;1338;4768;1496;4599;2834;9367
313960;201405;6181;16844;5095;15351;1719;5744;1470;4418;3189;10162
313970;201405;1520;4488;1274;4211;240;860;832;2785;1072;3645
313980;201405;1234;4145;1070;3847;373;1484;337;1188;710;2672
313990;201405;2015;7666;1798;7172;656;2816;475;1777;1131;4593
314000;201405;8315;28664;7738;27542;2172;8698;4062;14142;6234;22840
314010;201405;1119;3302;948;3088;171;662;549;1723;720;2385
314015;201405;1612;6088;1487;5808;540;2218;481;1884;1021;4102
314020;201405;512;1652;422;1440;133;500;118;380;251;880
314030;201405;848;2764;678;2373;130;498;244;840;374;1338
314040;201405;645;1926;561;1777;177;606;281;870;458;1476
314050;201405;1921;6376;1624;5760;513;2020;499;1654;1012;3674
314053;201405;1504;5041;1412;4927;230;785;999;3622;1229;4407
314055;201405;2270;6843;2015;6488;199;652;1515;4995;1714;5647
314060;201405;1113;3623;959;3341;111;469;624;2165;735;2634
314070;201405;3663;11795;2900;10215;840;3262;789;2613;1629;5875
314080;201405;1933;6042;1394;4862;302;1209;340;1066;642;2275
314085;201405;1897;6679;1649;6325;535;2230;617;2378;1152;4608
314090;201405;3576;12311;3230;11630;1106;4285;1189;4344;2295;8629
314100;201405;3559;9695;3116;9066;371;1088;2395;7111;2766;8199
314110;201405;4483;14949;3976;13897;1026;4125;1527;4964;2553;9089
314120;201405;1077;2661;595;1892;178;644;158;477;336;1121
314130;201405;699;2050;413;1389;77;275;88;298;165;573
314140;201405;5124;16189;4559;15104;1016;3639;2241;7490;3257;11129
314150;201405;1787;4796;1401;4184;275;923;691;2024;966;2947
314160;201405;2468;6672;1990;6037;151;482;1636;5067;1787;5549
314170;201405;1101;3448;937;3100;169;656;492;1551;661;2207
314180;201405;6586;21019;5829;19884;1565;5841;2702;9416;4267;15257
314190;201405;826;2637;740;2495;241;929;281;905;522;1834
314200;201405;3115;10141;2801;9569;412;1621;1903;6420;2315;8041
314210;201405;2041;6370;1827;5976;365;1336;1023;3221;1388;4557
314220;201405;1758;5808;1480;5219;499;1964;358;1108;857;3072
314225;201405;1193;3739;1078;3579;73;219;944;3204;1017;3423
314230;201405;717;2524;666;2426;222;865;233;815;455;1680
314240;201405;1149;3708;1025;3512;228;757;655;2337;883;3094
314250;201405;531;1621;419;1394;115;450;163;503;278;953
314260;201405;1313;4799;1247;4652;426;1673;484;1812;910;3485
314270;201405;2727;9535;2569;9261;329;1359;1778;6450;2107;7809
314280;201405;3301;9566;2425;7915;776;2879;689;1995;1465;4874
314290;201405;5478;15470;4680;14186;880;2917;3082;9285;3962;12202
314300;201405;1992;6767;1842;6414;630;2280;706;2418;1336;4698
314310;201405;6704;21628;5933;20048;2286;8173;1761;5811;4047;13984
314315;201405;981;3765;918;3642;174;782;540;2172;714;2954
314320;201405;3588;10818;2879;9848;1012;3780;1135;3828;2147;7608
314330;201405;55252;179454;51883;173687;15659;56986;24299;80573;39958;137559
314340;201405;2494;7050;1386;4712;389;1440;128;281;517;1721
314345;201405;1369;4620;1212;4374;379;1412;627;2313;1006;3725
314350;201405;1420;4224;1161;3799;492;1735;314;1025;806;2760
314360;201405;723;2328;517;1891;147;624;137;473;284;1097
314370;201405;568;2019;530;1965;156;636;271;994;427;1630
314380;201405;1171;3614;893;3118;330;1219;255;913;585;2132
314390;201405;15970;48449;12907;42594;4050;14522;3813;12156;7863;26678
314400;201405;5521;15894;4550;14554;1357;4339;2512;8424;3869;12763
314410;201405;2753;9002;2389;8234;792;3098;828;2672;1620;5770
314420;201405;785;2301;639;2100;90;348;480;1571;570;1919
314430;201405;8274;24828;7467;23364;2546;8455;2520;8108;5066;16563
314435;201405;1266;4150;1136;3915;167;705;738;2484;905;3189
314437;201405;1215;3186;1072;2980;98;277;839;2352;937;2629
314440;201405;760;2119;536;1809;206;770;114;349;320;1119
314450;201405;1807;5384;1550;5013;512;1867;720;2206;1232;4073
314460;201405;4685;16394;4148;15173;1505;5948;849;3090;2354;9038
314465;201405;2424;7822;2233;7479;230;935;1673;5508;1903;6443
314467;201405;1135;3251;978;2986;154;455;639;2009;793;2464
314470;201405;2440;8070;1953;6941;570;2333;481;1454;1051;3787
314480;201405;7392;25764;5490;20565;1445;5841;597;2037;2042;7878
314490;201405;1002;3026;825;2680;235;852;367;1149;602;2001
314500;201405;2850;8257;2383;7371;746;2550;866;2697;1612;5247
314505;201405;1802;5629;1708;5465;366;1283;1033;3317;1399;4600
314510;201405;2018;5738;1432;4857;510;1897;386;1257;896;3154
314520;201405;3807;14719;3200;13126;1149;5159;618;2339;1767;7498
314530;201405;7263;25636;6708;24770;1279;4872;4004;15387;5283;20259
314535;201405;2875;8180;2488;7662;365;1204;1740;5403;2105;6607
314537;201405;1449;4395;1222;3984;266;976;600;1982;866;2958
314540;201405;464;1452;410;1331;133;508;133;387;266;895
314545;201405;1384;4460;1235;4229;263;1007;708;2407;971;3414
314550;201405;614;1787;478;1601;130;537;146;439;276;976
314560;201405;5379;19313;4750;17666;1305;5302;1269;4618;2574;9920
314570;201405;375;1179;335;1095;98;352;160;501;258;853
314580;201405;477;1684;400;1513;145;624;93;331;238;955
314585;201405;810;2762;604;2303;177;750;170;645;347;1395
314587;201405;1757;5675;1578;5355;296;1016;862;2970;1158;3986
314590;201405;4303;15128;3220;12143;899;3604;436;1534;1335;5138
314600;201405;2139;7458;1792;6840;713;3004;391;1421;1104;4425
314610;201405;8534;30644;8034;29461;2661;10640;2876;10132;5537;20772
314620;201405;1860;5469;1653;5211;232;687;1233;4035;1465;4722
314625;201405;1575;5264;1539;5219;186;634;1225;4234;1411;4868
314630;201405;5209;15552;4579;14547;621;2170;3125;10095;3746;12265
314640;201405;840;2430;715;2204;262;851;197;571;459;1422
314650;201405;1340;4017;1055;3493;284;1070;427;1296;711;2366
314655;201405;1698;5080;1319;4378;275;978;673;2244;948;3222
314660;201405;217;605;171;512;25;92;99;281;124;373
314670;201405;1512;4250;1236;3763;225;754;711;2156;936;2910
314675;201405;1906;5912;1713;5585;223;815;1104;3633;1327;4448
314690;201405;2745;8845;2368;8160;709;2810;710;2284;1419;5094
314700;201405;10553;39788;9355;37089;4158;17226;2280;9371;6438;26597
314710;201405;8657;27976;6192;22420;1609;6600;890;2947;2499;9547
314720;201405;2708;9147;2284;8286;689;2748;925;3317;1614;6065
314730;201405;2548;7941;2133;7334;780;2930;691;2286;1471;5216
314740;201405;3136;10586;2852;10050;891;3431;1116;3793;2007;7224
314750;201405;340;1124;308;1051;69;277;146;477;215;754
314760;201405;1738;6068;1280;4856;289;1285;283;890;572;2175
314770;201405;1204;3849;762;2625;98;407;110;283;208;690
314780;201405;323;898;244;790;87;324;103;325;190;649
314790;201405;13754;42538;10651;37086;3990;15750;2805;9303;6795;25053
314795;201405;1529;4728;1359;4451;158;670;1022;3212;1180;3882
314800;201405;17417;53849;14479;47869;5945;20574;3148;10661;9093;31235
314810;201405;13181;40172;10436;35193;3390;12717;2710;9156;6100;21873
314820;201405;1126;3144;789;2643;274;1006;266;821;540;1827
314830;201405;1717;5917;1525;5537;544;2149;582;2161;1126;4310
314840;201405;1124;3990;899;3654;180;845;549;2240;729;3085
314850;201405;2290;6644;1918;6003;395;1434;1077;3348;1472;4782
314860;201405;3330;11520;3063;11087;640;2557;1874;6827;2514;9384
314870;201405;5808;18847;5203;18026;771;2982;3699;13011;4470;15993
314875;201405;1742;5968;1701;5907;256;845;1356;4804;1612;5649
314880;201405;833;2459;741;2314;72;231;534;1679;606;1910
314890;201405;616;1938;467;1640;137;544;126;387;263;931
314900;201405;428;1370;349;1229;102;379;162;563;264;942
314910;201405;1772;6237;1560;5866;644;2652;398;1414;1042;4066
314915;201405;2540;8083;2249;7658;228;899;1751;5926;1979;6825
314920;201405;652;1902;495;1670;110;419;233;740;343;1159
314930;201405;5274;18174;4682;16887;1591;6272;1121;3984;2712;10256
314940;201405;418;1248;395;1205;91;305;212;620;303;925
314950;201405;390;1360;334;1241;94;393;76;276;170;669
314960;201405;830;2725;673;2399;220;850;168;558;388;1408
314970;201405;883;3193;806;3024;308;1255;210;756;518;2011
314980;201405;2282;7066;2064;6713;882;3020;351;1092;1233;4112
314990;201405;3207;10451;2622;9160;989;3785;484;1538;1473;5323
314995;201405;1606;5035;1457;4825;226;893;997;3228;1223;4121
315000;201405;1087;3235;905;2964;167;658;566;1820;733;2478
315010;201405;502;1626;415;1440;133;536;156;489;289;1025
315015;201405;1951;6085;1778;5875;296;980;1282;4406;1578;5386
315020;201405;752;2449;635;2203;154;603;268;875;422;1478
315030;201405;1018;3137;873;2861;347;1196;210;686;557;1882
315040;201405;956;2972;882;2843;167;562;551;1763;718;2325
315050;201405;1654;4969;1382;4519;458;1639;493;1578;951;3217
315053;201405;1158;3467;1012;3233;264;999;414;1260;678;2259
315057;201405;1938;6636;1583;6090;257;1010;993;3955;1250;4965
315060;201405;980;3316;803;2885;253;986;202;752;455;1738
315070;201405;695;2150;647;2079;171;618;360;1105;531;1723
315080;201405;3504;12209;3172;11511;885;3448;1491;5452;2376;8900
315090;201405;764;2791;681;2613;180;725;253;1033;433;1758
315100;201405;1192;4134;970;3645;298;1245;245;865;543;2110
315110;201405;1694;5235;1488;4865;404;1432;677;2195;1081;3627
315120;201405;13877;33962;10113;29108;1947;5899;5500;16729;7447;22628
315130;201405;1841;6155;1667;5801;574;2194;427;1433;1001;3627
315140;201405;2577;8730;2164;7826;634;2654;690;2227;1324;4881
315150;201405;4851;13559;3682;11490;888;3209;1387;4165;2275;7374
315160;201405;1353;3908;1223;3730;253;848;720;2166;973;3014
315170;201405;1443;4320;1256;4060;265;934;714;2451;979;3385
315180;201405;14238;44707;11039;37899;3242;12517;2757;9160;5999;21677
315190;201405;2412;6497;1977;5865;590;1861;938;2792;1528;4653
315200;201405;4571;15598;3828;13923;1205;4769;1061;3764;2266;8533
315210;201405;8969;27745;7619;25110;2596;9291;2626;8528;5222;17819
315213;201405;1151;3736;1105;3671;105;305;934;3194;1039;3499
315217;201405;2750;9353;2319;8611;375;1563;1348;5034;1723;6597
315220;201405;10311;30789;9162;29209;1995;6397;5571;18351;7566;24748
315230;201405;2538;6882;2317;6623;146;342;2043;5973;2189;6315
315240;201405;3342;10846;3057;10352;620;2255;1865;6332;2485;8587
315250;201405;9591;31190;7417;27087;2503;10188;2371;8631;4874;18819
315260;201405;1128;3701;911;3234;353;1387;174;549;527;1936
315270;201405;886;3193;770;2948;259;1065;201;745;460;1810
315280;201405;4018;12410;3196;10560;1119;3899;825;2597;1944;6496
315290;201405;1289;3715;998;3247;375;1358;208;658;583;2016
315300;201405;544;1558;423;1408;206;712;144;464;350;1176
315310;201405;1240;4170;1114;3954;161;664;736;2554;897;3218
315320;201405;888;2915;747;2717;210;832;357;1346;567;2178
315330;201405;783;2804;571;2269;201;903;91;333;292;1236
315340;201405;4249;12516;3651;11584;995;3433;1670;5384;2665;8817
315350;201405;1887;5380;1518;4863;230;738;1066;3531;1296;4269
315360;201405;1733;5892;1423;5074;354;1366;480;1627;834;2993
315370;201405;618;1887;545;1776;130;459;305;993;435;1452
315380;201405;289;1033;256;941;93;373;42;140;135;513
315390;201405;1964;7065;1725;6500;622;2499;441;1645;1063;4144
315400;201405;4724;14712;4181;13638;1007;3539;2148;7028;3155;10567
315410;201405;1808;5058;1531;4622;281;1056;912;2635;1193;3691
315415;201405;1206;4073;1108;3919;450;1578;483;1799;933;3377
315420;201405;1528;4860;1158;4146;397;1496;206;709;603;2205
315430;201405;4081;11285;3104;9630;849;2983;985;2950;1834;5933
315440;201405;986;3054;883;2892;176;655;494;1608;670;2263
315445;201405;2215;6348;1868;5880;282;1025;1281;3997;1563;5022
315450;201405;2525;8106;2362;7862;479;1586;1524;5262;2003;6848
315460;201405;39556;134094;35509;125415;12517;47624;9498;32707;22015;80331
315470;201405;563;1774;504;1674;79;289;326;1070;405;1359
315480;201405;1449;4603;1011;3594;231;940;210;700;441;1640
315490;201405;3298;9496;2842;8849;505;1841;1640;4990;2145;6831
315500;201405;468;1501;317;1126;66;285;113;328;179;613
315510;201405;1509;4386;1304;4055;112;393;938;2919;1050;3312
315520;201405;1177;3670;979;3405;172;695;599;2019;771;2714
315530;201405;502;1785;472;1731;217;847;168;586;385;1433
315540;201405;1277;3938;1024;3523;242;1014;364;1217;606;2231
315550;201405;1739;5163;1478;4824;496;1796;613;1991;1109;3787
315560;201405;7285;24176;6685;23375;989;3765;4582;16175;5571;19940
315570;201405;2403;7618;2255;7398;500;1860;1323;4272;1823;6132
315580;201405;2749;8600;2254;7659;653;2580;844;2688;1497;5268
315590;201405;902;2657;817;2533;128;462;531;1604;659;2066
315600;201405;2644;9395;2204;8650;388;1593;1296;5325;1684;6918
315610;201405;1030;3103;872;2767;203;793;322;859;525;1652
315620;201405;342;1217;334;1201;103;362;171;640;274;1002
315630;201405;1010;3283;875;3060;258;971;247;845;505;1816
315640;201405;770;2422;670;2225;205;761;251;790;456;1551
315645;201405;879;2850;766;2579;311;1151;190;606;501;1757
315650;201405;1921;5660;1719;5372;167;674;1289;3927;1456;4601
315660;201405;2698;7381;2407;6956;460;1378;1491;4292;1951;5670
315670;201405;12081;43359;11118;41393;4117;16377;3680;13540;7797;29917
315680;201405;2898;10244;2402;9287;897;3558;624;2550;1521;6108
315690;201405;3383;10793;2760;9652;974;3719;820;2906;1794;6625
315700;201405;7472;24004;6492;22011;1399;5451;3139;10200;4538;15651
315710;201405;1842;5503;1500;4966;209;821;902;2963;1111;3784
315720;201405;3056;9962;2796;9469;723;2811;1323;4224;2046;7035
315725;201405;1663;5169;1355;4765;388;1408;706;2538;1094;3946
315727;201405;661;2096;591;1950;137;484;295;965;432;1449
315730;201405;1004;3138;916;2970;197;679;523;1719;720;2398
315733;201405;1186;3866;1095;3684;460;1626;365;1215;825;2841
315737;201405;1392;4257;1130;3793;126;471;728;2482;854;2953
315740;201405;1062;3429;926;3166;216;878;455;1454;671;2332
315750;201405;1163;3634;1048;3474;109;454;780;2525;889;2979
315760;201405;961;2713;930;2672;27;82;858;2472;885;2554
315765;201405;1521;4683;1415;4516;150;508;1089;3519;1239;4027
315770;201405;1702;5569;1548;5235;447;1634;574;1896;1021;3530
315780;201405;23948;79974;22279;76360;7497;27383;7082;24399;14579;51782
315790;201405;3295;11393;2968;10695;378;1316;1991;7401;2369;8717
315800;201405;1555;6116;1305;5384;415;1887;269;1065;684;2952
315810;201405;1520;4379;1297;4025;222;748;831;2518;1053;3266
315820;201405;3069;10130;2625;9457;755;2841;1319;4894;2074;7735
315830;201405;1486;5079;1372;4842;352;1393;444;1475;796;2868
315840;201405;759;2078;587;1763;117;407;202;556;319;963
315850;201405;1349;4830;1302;4735;366;1392;577;2061;943;3453
315860;201405;449;1653;368;1482;113;530;77;302;190;832
315870;201405;482;1461;409;1346;120;444;150;448;270;892
315880;201405;1121;3106;935;2870;235;823;472;1438;707;2261
315890;201405;1710;5859;1549;5615;494;1864;774;2891;1268;4755
315895;201405;5225;16560;4867;15886;1314;4762;2300;7336;3614;12098
315900;201405;796;2571;748;2488;174;690;428;1314;602;2004
315910;201405;621;2218;578;2134;219;831;263;970;482;1801
315920;201405;1493;4452;1079;3585;315;1171;328;1008;643;2179
315930;201405;1133;3203;928;2836;264;881;340;1012;604;1893
315935;201405;1181;4028;1099;3848;354;1361;354;1200;708;2561
315940;201405;657;2128;596;2008;176;666;255;832;431;1498
315950;201405;1269;3953;1184;3785;304;986;695;2276;999;3262
315960;201405;2833;9635;2198;8350;1050;4538;161;562;1211;5100
315970;201405;807;2297;657;2081;73;225;487;1597;560;1822
315980;201405;4136;10572;2906;8434;797;2630;932;2380;1729;5010
315990;201405;4430;13329;3908;12528;853;3196;2129;6750;2982;9946
316000;201405;595;1964;531;1862;234;888;158;534;392;1422
316010;201405;459;1687;409;1573;115;527;121;406;236;933
316020;201405;1202;3836;968;3427;181;752;544;1911;725;2663
316030;201405;3727;10648;2702;8990;399;1437;1440;4946;1839;6383
316040;201405;3551;11308;2553;9024;459;1857;309;824;768;2681
316045;201405;2137;6941;1984;6682;294;915;1420;5038;1714;5953
316050;201405;381;1245;332;1171;79;306;178;608;257;914
316060;201405;787;2408;649;2209;122;511;376;1214;498;1725
316070;201405;6144;20670;5693;19755;1788;6891;2489;8254;4277;15145
316080;201405;749;2805;678;2610;181;786;149;570;330;1356
316090;201405;640;1908;481;1567;121;446;133;391;254;837
316095;201405;1326;4419;1201;4181;262;932;769;2748;1031;3680
316100;201405;2734;9315;2159;7828;598;2463;463;1561;1061;4024
316105;201405;970;2754;733;2363;167;598;350;1146;517;1744
316110;201405;12561;44398;11432;42304;1573;6376;7921;30099;9494;36475
316120;201405;1305;4505;1197;4247;396;1453;449;1578;845;3031
316130;201405;1324;3173;975;2695;195;622;549;1505;744;2127
316140;201405;1095;3269;852;2877;130;488;516;1763;646;2251
316150;201405;1385;4230;1319;4130;346;1251;723;2185;1069;3436
316160;201405;1258;3797;998;3278;138;522;556;1804;694;2326
316165;201405;986;2739;829;2494;162;555;476;1417;638;1972
316170;201405;1408;4125;1065;3514;243;916;442;1373;685;2289
316180;201405;1279;4134;1014;3579;298;1231;276;881;574;2112
316190;201405;2725;8512;1471;5219;338;1271;265;819;603;2090
316200;201405;3902;12767;3043;11033;813;3388;917;3243;1730;6631
316210;201405;5113;16881;4713;16029;2167;7854;1001;3408;3168;11262
316220;201405;671;2097;467;1696;114;490;59;222;173;712
316225;201405;1090;3234;974;3081;138;521;670;2075;808;2596
316230;201405;464;1395;383;1251;79;278;197;673;276;951
316240;201405;6522;20581;5707;19510;659;2303;4384;15198;5043;17501
316245;201405;3150;11183;2978;10900;285;1267;2290;8368;2575;9635
316250;201405;9353;29747;8220;27440;3148;11413;2400;7570;5548;18983
316255;201405;2407;7671;2140;7351;354;1191;1525;5347;1879;6538
316257;201405;1428;4054;1113;3498;280;981;409;1244;689;2225
316260;201405;1869;5410;1415;4746;308;1145;760;2582;1068;3727
316265;201405;1199;3505;1044;3197;107;370;746;2259;853;2629
316270;201405;5213;16871;4845;16112;1403;4963;2196;7394;3599;12357
316280;201405;3372;11301;3045;10639;605;2345;1708;5970;2313;8315
316290;201405;3246;10805;2949;10235;778;3095;1321;4369;2099;7464
316292;201405;3847;12974;3550;12402;1062;4069;1563;5226;2625;9295
316294;201405;809;2680;533;2004;132;590;78;271;210;861
316295;201405;2010;7193;1890;6948;441;1873;1041;3632;1482;5505
316300;201405;984;3081;855;2849;81;283;585;1997;666;2280
316310;201405;704;2241;550;1922;135;533;198;678;333;1211
316320;201405;577;1963;517;1877;137;540;158;570;295;1110
316330;201405;1006;3086;827;2725;135;450;491;1647;626;2097
316340;201405;1162;3833;1020;3540;329;1305;317;998;646;2303
316350;201405;1494;4834;1361;4607;279;952;745;2688;1024;3640
316360;201405;785;2073;620;1850;74;227;467;1410;541;1637
316370;201405;5129;17100;4572;15971;1628;6112;1128;4005;2756;10117
316380;201405;1494;4251;1239;3875;132;473;877;2759;1009;3232
316390;201405;943;2870;790;2599;254;912;342;1139;596;2051
316400;201405;1492;5067;1322;4758;373;1437;542;1966;915;3403
316410;201405;1230;4132;1150;4003;264;989;671;2341;935;3330
316420;201405;2025;6854;1874;6650;281;1128;1223;4380;1504;5508
316430;201405;975;2995;807;2704;261;965;301;964;562;1929
316440;201405;656;2210;575;2103;243;1012;209;730;452;1742
316443;201405;706;2170;599;1958;158;567;244;773;402;1340
316447;201405;1353;4519;1294;4415;130;469;1077;3689;1207;4158
316450;201405;2260;7856;2013;7373;416;1592;1226;4598;1642;6190
316460;201405;895;2892;840;2802;246;915;470;1491;716;2406
316470;201405;8292;27531;6603;23720;2110;8623;2004;6871;4114;15494
316480;201405;253;882;228;837;66;262;76;268;142;530
316490;201405;378;1226;361;1187;122;417;155;495;277;912
316500;201405;1075;3948;749;2935;170;721;53;197;223;918
316510;201405;978;3562;875;3336;346;1353;238;909;584;2262
316520;201405;1232;3882;1031;3573;278;1098;388;1229;666;2327
316530;201405;1162;3817;972;3417;254;1098;374;1104;628;2202
316540;201405;1022;3376;919;3202;268;1113;330;1040;598;2153
316550;201405;1285;4408;1185;4251;253;979;743;2691;996;3670
316553;201405;2310;8560;1960;7713;695;2936;474;1802;1169;4738
316555;201405;2893;10110;2567;9738;243;900;2071;8035;2314;8935
316556;201405;602;1723;498;1528;52;209;342;991;394;1200
316557;201405;730;2713;705;2672;324;1309;229;832;553;2141
316560;201405;369;1269;311;1135;87;367;80;257;167;624
316570;201405;1451;4640;1272;4262;263;958;671;2246;934;3204
316580;201405;294;860;232;743;60;228;84;251;144;479
316590;201405;1442;4201;1156;3697;225;847;656;2028;881;2875
316600;201405;1190;3945;1083;3727;180;668;665;2260;845;2928
316610;201405;611;2284;571;2211;145;624;327;1253;472;1877
316620;201405;2212;7131;1953;6610;507;1893;943;3134;1450;5027
316630;201405;1557;5242;1376;4863;592;2159;419;1503;1011;3662
316640;201405;261;860;227;784;58;227;93;305;151;532
316650;201405;960;3731;866;3571;191;820;481;2101;672;2921
316660;201405;139;431;121;396;28;110;58;177;86;287
316670;201405;1899;5614;1542;4924;599;2139;383;1096;982;3235
316680;201405;2045;6056;1773;5638;228;710;1373;4465;1601;5175
316690;201405;1184;4066;1074;3872;371;1512;396;1392;767;2904
316695;201405;1265;3950;1130;3712;122;399;748;2567;870;2966
316700;201405;352;1203;329;1145;86;344;158;509;244;853
316710;201405;3486;13332;3061;12398;1062;4539;978;4159;2040;8698
316720;201405;20342;69701;17653;63702;6373;24354;4971;17895;11344;42249
316730;201405;441;1406;390;1307;98;386;201;620;299;1006
316740;201405;768;2655;696;2508;275;1063;211;734;486;1797
316750;201405;426;1506;389;1426;115;480;123;412;238;892
316760;201405;3644;12400;3111;11790;1716;6469;1029;4170;2745;10639
316770;201405;1508;4500;1347;4284;212;719;920;3035;1132;3754
316780;201405;723;2523;674;2427;258;995;194;661;452;1656
316790;201405;862;2573;642;2185;179;692;235;780;414;1472
316800;201405;5918;19927;5396;18955;1144;4678;2768;9314;3912;13992
316805;201405;902;2455;853;2390;154;409;634;1836;788;2245
316810;201405;591;1846;513;1681;166;596;230;732;396;1328
316820;201405;396;1148;274;941;100;369;66;222;166;591
316830;201405;632;2253;610;2216;217;847;251;888;468;1735
316840;201405;2978;9133;2586;8406;715;2626;1085;3343;1800;5969
316850;201405;2194;7001;2009;6665;457;1657;1090;3623;1547;5280
316860;201405;24159;75982;22028;72017;6194;22242;9928;32289;16122;54531
316870;201405;7257;24536;6367;22366;2398;9048;1390;4780;3788;13828
316880;201405;908;3096;878;3048;366;1396;279;913;645;2309
316890;201405;1461;3810;1163;3401;480;1539;456;1278;936;2817
316900;201405;2778;8879;2435;8180;806;3000;812;2503;1618;5503
316905;201405;476;1658;428;1547;191;727;129;446;320;1173
316910;201405;738;2543;593;2228;152;598;204;794;356;1392
316920;201405;1589;4873;1292;4403;224;820;655;2250;879;3070
316930;201405;9799;34082;8361;30869;2629;10780;1876;6507;4505;17287
316935;201405;4840;14738;3538;12298;1270;4895;746;2482;2016;7377
316940;201405;7118;24303;6051;21984;1696;6884;1648;5762;3344;12646
316950;201405;1538;4611;1354;4365;215;812;919;2931;1134;3743
316960;201405;5532;14412;4632;13252;1014;3090;2733;7870;3747;10960
316970;201405;3610;11923;3429;11607;1219;4654;1124;3555;2343;8209
316980;201405;1117;3319;810;2791;349;1314;210;734;559;2048
316990;201405;10144;34296;9195;32151;3868;14673;1322;4404;5190;19077
317000;201405;2734;9647;2645;9540;223;687;2139;8404;2362;9091
317005;201405;2517;8197;2361;7990;382;1295;1719;5934;2101;7229
317010;201405;32015;86013;21029;67670;6158;21953;5473;18464;11631;40417
317020;201405;52788;156027;35239;119055;9517;35431;8768;28044;18285;63475
317030;201405;887;2538;749;2330;126;456;434;1352;560;1808
317040;201405;13268;40817;11736;37954;4068;13692;4799;15807;8867;29499
317043;201405;865;2503;733;2324;166;550;440;1419;606;1969
317047;201405;1175;3229;917;2783;185;629;434;1307;619;1936
317050;201405;1890;6767;1626;6145;499;2029;585;2129;1084;4158
317052;201405;2470;8043;2212;7648;266;1022;1649;5758;1915;6780
317057;201405;1801;5265;1405;4574;225;874;752;2385;977;3259
317060;201405;394;1183;306;990;78;288;111;324;189;612
317065;201405;1230;4135;1116;3947;136;545;861;3031;997;3576
317070;201405;9742;32788;7740;28245;2468;9928;1796;6623;4264;16551
317075;201405;1286;4037;1102;3693;373;1348;391;1268;764;2616
317080;201405;7229;20948;6580;19866;2068;6701;2584;7806;4652;14507
317090;201405;4937;16943;4623;16389;732;2608;3143;11439;3875;14047
317100;201405;3351;9971;2896;9198;968;3415;1211;3652;2179;7067
317103;201405;2012;7078;1709;6441;360;1671;779;2847;1139;4518
317107;201405;1360;4276;1179;3907;265;1000;621;1954;886;2954
317110;201405;758;2086;534;1651;159;569;206;591;365;1160
317115;201405;1105;3585;968;3277;148;527;627;2135;775;2662
317120;201405;13608;46661;11727;42179;3959;15181;4426;15748;8385;30929
317130;201405;9057;29224;8187;27635;2291;8670;3627;11988;5918;20658
317140;201405;670;2324;630;2247;87;338;410;1464;497;1802
317150;201405;1061;2946;899;2760;111;385;662;2032;773;2417
317160;201405;3849;10446;2924;9270;432;1614;1957;6133;2389;7747
317170;201405;2036;6012;1828;5656;270;956;1112;3297;1382;4253
317180;201405;1848;6325;1478;5476;435;1772;458;1649;893;3421
317190;201405;1331;3974;1161;3739;140;472;870;2806;1010;3278
317200;201405;4705;15798;4295;14923;1498;5677;1284;4307;2782;9984
317210;201405;1103;3486;942;3229;275;1041;441;1520;716;2561
317220;201405;358;1297;349;1287;125;465;188;714;313;1179
320010;201405;5967;18945;5318;17483;1009;3555;2749;9037;3758;12592
320013;201405;2085;6185;1483;5068;227;824;825;2889;1052;3713
320016;201405;3564;10028;3012;9229;471;1440;2111;6598;2582;8038
320020;201405;4276;13963;3936;13218;1308;4669;1502;5004;2810;9673
320030;201405;1502;4945;1304;4517;388;1434;553;1859;941;3293
320035;201405;1837;5698;1670;5422;552;1965;695;2166;1247;4131
320040;201405;3208;10958;2702;9737;755;3002;813;2806;1568;5808
320050;201405;1943;5415;1675;4889;307;1003;978;2803;1285;3806
320060;201405;11597;36927;9097;31060;2330;8796;3359;10954;5689;19750
320070;201405;1853;6279;1623;5724;548;2048;445;1470;993;3518
320080;201405;5687;16900;4595;14708;1430;4913;1548;4897;2978;9810
320090;201405;9212;26576;7221;22665;2011;6751;3210;9787;5221;16538
320100;201405;3287;10029;2739;8927;662;2305;1322;4258;1984;6563
320110;201405;1552;4789;1415;4520;401;1365;512;1606;913;2971
320115;201405;1818;6698;1737;6514;834;3197;613;2369;1447;5566
320120;201405;18423;62111;15793;56794;5781;22180;4739;17283;10520;39463
320130;201405;41713;140220;38785;133962;11112;41742;18334;61943;29446;103685
320140;201405;4092;13433;2945;10581;801;3222;331;1104;1132;4326
320150;201405;18445;52970;13943;44312;4450;15260;2740;8616;7190;23876
320160;201405;5325;16584;4636;15429;1264;4757;2022;6266;3286;11023
320170;201405;2004;6631;1779;6132;603;2162;616;2175;1219;4337
320180;201405;923;3063;830;2920;305;1110;336;1200;641;2310
320190;201405;4412;15981;3954;14729;1334;5181;1245;4602;2579;9783
320200;201405;1147;3795;1024;3533;311;1141;453;1593;764;2734
320210;201405;6104;16911;5300;15541;1320;4279;2800;7945;4120;12224
320220;201405;2933;9047;2334;7980;696;2597;906;3137;1602;5734
320225;201405;1524;5422;1325;4904;506;1979;299;1156;805;3135
320230;201405;4298;14559;4021;14019;1376;5093;1509;5430;2885;10523
320240;201405;9923;30580;7920;26668;2470;8921;2245;7669;4715;16590
320245;201405;4186;14419;3904;13720;1283;4728;1453;5060;2736;9788
320250;201405;1831;5761;1368;4683;371;1424;301;924;672;2348
320255;201405;2048;6909;1780;6439;715;2755;651;2426;1366;5181
320260;201405;1146;3607;898;2944;246;910;316;893;562;1803
320265;201405;2550;7933;2174;7483;289;1002;1609;5713;1898;6715
320270;201405;2733;8474;2132;7269;536;1974;958;3236;1494;5210
320280;201405;7296;22393;6695;21327;1532;5243;3591;11319;5123;16562
320290;201405;1675;5649;1388;4903;511;1904;372;1208;883;3112
320300;201405;4331;14812;4028;14107;1274;4690;1407;4953;2681;9643
320305;201405;4812;15955;4404;15027;1154;4324;2091;6955;3245;11279
320310;201405;2048;6260;1822;5839;484;1679;836;2609;1320;4288
320313;201405;2410;7321;1730;5740;507;1930;306;916;813;2846
320316;201405;2242;7095;2118;6807;644;2166;957;3074;1601;5240
320320;201405;19209;62761;16676;57817;5079;19625;6645;22433;11724;42058
320330;201405;3017;9273;2629;8608;550;1765;1556;5278;2106;7043
320332;201405;5147;17611;4654;16675;1548;5805;1921;7103;3469;12908
320334;201405;1584;5461;1258;4706;456;1888;256;880;712;2768
320335;201405;2276;6907;1644;5473;580;2105;346;1113;926;3218
320340;201405;5844;16753;4732;14820;1162;3993;2240;6948;3402;10941
320350;201405;5678;14845;4195;12300;855;2771;2009;5823;2864;8594
320360;201405;1790;4829;1374;4052;276;936;670;1835;946;2771
320370;201405;3540;11772;3062;10816;973;3507;1224;4378;2197;7885
320380;201405;2838;8764;2544;8199;538;1886;1437;4563;1975;6449
320390;201405;8376;25678;6962;22817;2155;7765;2402;7587;4557;15352
320400;201405;4184;12175;3502;11169;861;3064;1844;5688;2705;8752
320405;201405;4158;12500;3819;12047;1082;3719;2195;6782;3277;10501
320410;201405;6301;15700;4608;13743;778;2410;3078;9270;3856;11680
320420;201405;1454;4575;1073;3895;374;1520;201;679;575;2199
320425;201405;2481;6384;2023;5704;362;1129;1222;3419;1584;4548
320430;201405;2405;7164;2170;6685;439;1443;1145;3496;1584;4939
320435;201405;2565;8738;2200;7953;1012;3808;722;2691;1734;6499
320440;201405;1453;4905;1302;4481;404;1493;417;1359;821;2852
320450;201405;2554;8276;2183;7477;640;2365;962;3239;1602;5604
320455;201405;4725;16755;3730;14192;1298;5174;850;3208;2148;8382
320460;201405;3141;10353;2552;9064;760;2892;930;3224;1690;6116
320465;201405;1673;5359;1326;4519;311;1148;524;1720;835;2868
320470;201405;4656;14478;3371;11628;1121;4192;539;1719;1660;5911
320480;201405;1994;6122;1675;5495;421;1583;745;2332;1166;3915
320490;201405;17976;57751;15255;52345;5214;19014;5226;18453;10440;37467
320495;201405;1453;4629;1164;3961;487;1742;280;939;767;2681
320500;201405;47346;149302;41343;137752;12812;46236;18320;59911;31132;106147
320501;201405;3699;12274;3416;11793;1152;4406;1528;5133;2680;9539
320503;201405;2006;7244;1712;6491;572;2370;519;1774;1091;4144
320506;201405;3337;10690;2357;8160;772;2861;285;898;1057;3759
320510;201405;8786;28281;7758;26218;2532;9194;3146;10481;5678;19675
320515;201405;2151;6220;1913;5765;559;1794;703;2074;1262;3868
320517;201405;2281;7551;1912;6742;747;2844;452;1515;1199;4359
320520;201405;33679;109439;29013;100200;9330;35260;12250;42166;21580;77426
320530;201405;28431;89893;24617;82209;6689;25295;10922;34748;17611;60043
330010;201405;17560;55829;16338;53307;3365;12415;9940;31386;13305;43801
330015;201405;1989;5617;1729;5123;467;1537;647;1868;1114;3405
330020;201405;16926;51420;15522;49135;3711;12597;8830;27807;12541;40404
330022;201405;1689;5471;1510;5124;330;1310;818;2656;1148;3966
330023;201405;3474;11427;3268;10988;920;3386;1364;4410;2284;7796
330025;201405;3432;10517;3128;10065;787;2742;1872;5925;2659;8667
330030;201405;7699;26980;7123;25766;2040;8135;3231;11208;5271;19343
330040;201405;14602;42396;12455;38920;3344;11229;6330;19453;9674;30682
330045;201405;67812;197080;62088;188321;9337;30383;43034;129974;52371;160357
330050;201405;2989;9611;2676;8985;936;3511;771;2427;1707;5938
330060;201405;5661;17452;5102;16634;1182;4293;3021;9883;4203;14176
330070;201405;25790;80826;23663;76948;6627;22838;11037;36025;17664;58863
330080;201405;9514;27475;9076;26877;1723;4928;6304;19298;8027;24226
330090;201405;3296;9261;3077;8874;864;2681;1500;4257;2364;6938
330093;201405;2024;6017;1727;5468;447;1495;647;1987;1094;3482
330095;201405;1214;4248;1131;4058;439;1720;209;679;648;2399
330100;201405;55369;185622;51644;179104;12154;46452;27144;94875;39298;141327
330110;201405;2696;8618;2479;8222;805;2893;864;2860;1669;5753
330115;201405;2500;7569;2313;7244;713;2440;1053;3187;1766;5627
330120;201405;2556;7523;2337;7219;732;2404;1086;3273;1818;5677
330130;201405;4052;13492;3674;12756;1224;4546;1479;5135;2703;9681
330140;201405;3453;10676;3156;10269;871;3032;1574;5188;2445;8220
330150;201405;2621;7911;2041;6699;556;1979;489;1574;1045;3553
330160;201405;1414;4948;1313;4733;478;1854;482;1708;960;3562
330170;201405;104732;321487;98271;311389;14771;50261;69720;221240;84491;271501
330180;201405;1798;5565;1628;5231;243;1002;1024;3056;1267;4058
330185;201405;8085;25842;7520;24864;1965;6776;4178;14178;6143;20954
330187;201405;4435;12844;3936;12004;854;2865;2333;7111;3187;9976
330190;201405;28683;87162;27361;84988;6558;21508;16750;51601;23308;73109
330200;201405;14015;44580;12632;41944;2956;10046;6897;23303;9853;33349
330205;201405;2615;7177;2329;6686;578;1854;1169;3245;1747;5099
330210;201405;4702;12337;3349;9834;1026;3237;811;2361;1837;5598
330220;201405;11651;37126;10773;35287;3628;12788;3495;10983;7123;23771
330225;201405;4129;13129;3901;12780;531;2010;2820;9301;3351;11311
330227;201405;17835;51276;16122;48905;4006;12870;9249;27643;13255;40513
330230;201405;1523;4547;1397;4316;400;1390;589;1696;989;3086
330240;201405;20779;65101;18563;61041;7526;26688;3742;12162;11268;38850
330245;201405;1268;4063;1054;3620;321;1223;244;830;565;2053
330250;201405;37918;112195;35489;108170;10102;31027;18773;58557;28875;89584
330260;201405;3954;12589;3662;11956;947;3382;1716;5416;2663;8798
330270;201405;14484;42656;12223;39038;3697;12494;4742;15440;8439;27934
330280;201405;2058;6498;1761;5895;382;1433;843;2668;1225;4101
330285;201405;19231;57258;17696;55050;3706;12299;11245;35146;14951;47445
330290;201405;3660;10345;3253;9777;668;2289;1952;5611;2620;7900
330300;201405;4178;13695;3923;13223;956;3436;2129;7222;3085;10658
330310;201405;2818;8251;2561;7814;637;2000;1309;3985;1946;5985
330320;201405;12544;37914;11783;36737;1837;6218;8411;26165;10248;32383
330330;201405;32371;93689;29794;89601;7046;22657;18193;54157;25239;76814
330340;201405;14943;46515;12303;41246;3964;14215;3850;12865;7814;27080
330350;201405;93629;300701;90908;296746;16354;53667;65795;218125;82149;271792
330360;201405;5650;17967;5522;17768;752;2612;4259;13671;5011;16283
330370;201405;3884;14489;3682;13990;1405;5576;1306;5024;2711;10600
330380;201405;4579;15000;4033;13978;1037;3856;2045;7051;3082;10907
330385;201405;4133;14448;3837;13843;1295;4960;1526;5477;2821;10437
330390;201405;24361;82645;22391;78712;5529;21721;11635;40025;17164;61746
330395;201405;3418;10262;3180;9850;585;1989;1961;6053;2546;8042
330400;201405;2609;8798;2384;8370;540;2197;1221;3980;1761;6177
330410;201405;3112;9989;2694;9137;620;2224;1379;4699;1999;6923
330411;201405;2599;8277;2310;7702;487;1895;1231;3889;1718;5784
330412;201405;1399;4864;1122;4320;312;1381;394;1432;706;2813
330414;201405;26138;74877;22517;70004;4317;14071;14439;45246;18756;59317
330415;201405;3715;11748;3299;10982;868;3163;1472;4888;2340;8051
330420;201405;8563;27115;6363;22660;1956;7676;1201;4249;3157;11925
330430;201405;8275;24721;7461;23303;1752;6077;3824;11715;5576;17792
330440;201405;2127;7163;1792;6457;646;2599;414;1365;1060;3964
330450;201405;1641;5747;1552;5559;505;2026;655;2293;1160;4319
330452;201405;10529;32896;8811;29485;2501;9313;3697;11887;6198;21200
330455;201405;483487;1423965;415063;1311935;109138;368001;214169;675904;323307;1043905
330460;201405;1409;4768;1319;4600;339;1356;642;2217;981;3573
330470;201405;4601;15082;4260;14389;1524;5560;1480;4880;3004;10440
330475;201405;8406;26778;7586;25408;2086;7551;3753;12604;5839;20155
330480;201405;6522;19930;6162;19283;1741;5837;2851;8874;4592;14711
330490;201405;102276;288592;95116;278135;12490;38315;73074;214643;85564;252958
330500;201405;6957;21399;6549;20589;1471;4931;3596;11577;5067;16508
330510;201405;43289;140076;40691;135765;13105;44498;20598;70295;33703;114793
330513;201405;1612;4880;1477;4617;529;1678;586;1858;1115;3536
330515;201405;3115;9930;2844;9416;971;3423;1076;3512;2047;6935
330520;201405;13479;40647;12412;38903;3155;10344;6796;21464;9951;31808
330530;201405;1576;4725;1450;4498;360;1215;738;2243;1098;3458
330540;201405;3390;10326;2944;9624;876;3062;1219;3944;2095;7006
330550;201405;9174;30465;8116;28460;3329;12334;2205;7858;5534;20192
330555;201405;10570;32487;9527;30898;1901;6341;6092;20156;7993;26497
330560;201405;4258;13124;3984;12671;863;3135;2216;6850;3079;9985
330570;201405;3712;10794;3175;9879;810;2584;1668;5288;2478;7872
330575;201405;5612;16899;5120;16028;1143;3907;3014;9166;4157;13073
330580;201405;17404;56472;15303;52213;5088;18223;5853;20387;10941;38610
330590;201405;1983;6021;1854;5792;535;1691;977;3113;1512;4804
330600;201405;10221;30393;8572;27710;1381;5317;5164;16054;6545;21371
330610;201405;9111;29685;8429;28414;2135;8032;4214;14015;6349;22047
330615;201405;1668;6011;1541;5657;682;2611;461;1746;1143;4357
330620;201405;4080;14388;3768;13757;1371;5310;1132;4293;2503;9603
330630;201405;21891;71674;19603;67025;5301;20181;9701;31838;15002;52019
350010;201405;3023;9502;2367;8119;812;2914;480;1593;1292;4507
350020;201405;618;1763;480;1508;144;515;187;554;331;1069
350030;201405;4800;15465;4015;13691;1465;5432;1180;3895;2645;9327
350040;201405;605;2191;528;2021;183;760;117;401;300;1161
350050;201405;1419;4677;1195;4256;347;1412;404;1334;751;2746
350055;201405;641;2130;611;2083;195;737;303;976;498;1713
350060;201405;87;302;80;289;22;94;33;112;55;206
350070;201405;2765;9282;2249;8056;548;2168;451;1421;999;3589
350075;201405;554;1935;479;1807;166;689;136;473;302;1162
350080;201405;614;1811;478;1525;124;441;189;598;313;1039
350090;201405;588;1693;444;1444;128;443;127;380;255;823
350100;201405;2030;6953;1686;6140;581;2250;511;1807;1092;4057
350110;201405;484;1488;382;1257;102;379;137;409;239;788
350115;201405;1387;4522;1226;4122;255;989;595;1849;850;2838
350120;201405;549;1483;291;931;76;264;56;172;132;436
350130;201405;3780;11663;3434;10983;889;3175;1585;4744;2474;7919
350140;201405;705;2233;636;2097;162;609;278;874;440;1483
350150;201405;437;1512;402;1431;157;585;107;380;264;965
350160;201405;6224;19771;4793;16628;1482;5705;1780;5682;3262;11387
350170;201405;2310;8263;2073;7658;744;2858;503;1790;1247;4648
350180;201405;1467;3855;1222;3441;328;950;531;1475;859;2425
350190;201405;3320;11371;2891;10505;824;3479;1373;4520;2197;7999
350200;201405;419;1438;381;1372;129;522;140;485;269;1007
350210;201405;7695;21717;6147;19018;2344;7830;2076;6150;4420;13980
350220;201405;3163;10262;2904;9766;1033;3936;901;2773;1934;6709
350230;201405;762;2596;701;2496;238;921;251;882;489;1803
350240;201405;599;1836;521;1711;127;491;295;927;422;1418
350250;201405;2786;10406;2694;10219;1114;4482;959;3601;2073;8083
350260;201405;1085;2928;905;2600;215;629;402;1184;617;1813
350270;201405;5382;16668;4751;15354;988;3501;2321;7424;3309;10925
350275;201405;2062;6902;1855;6585;565;2233;739;2467;1304;4700
350280;201405;23452;61878;15486;47368;4129;13439;3654;11342;7783;24781
350290;201405;1833;6387;1630;5911;510;1897;517;1934;1027;3831
350300;201405;509;1617;474;1543;145;490;196;654;341;1144
350310;201405;947;3183;874;3009;205;800;373;1220;578;2020
350315;201405;571;1817;473;1610;88;383;154;494;242;877
350320;201405;12007;39861;11032;37645;3634;13186;2125;7204;5759;20390
350330;201405;10122;29905;8452;26214;2088;7065;3986;11658;6074;18723
350335;201405;564;1673;522;1586;136;431;223;738;359;1169
350340;201405;1068;3414;856;3024;240;931;261;891;501;1822
350350;201405;766;2448;677;2298;174;680;246;831;420;1511
350360;201405;855;3073;753;2828;259;1022;258;976;517;1998
350370;201405;714;2239;550;1848;122;460;111;320;233;780
350380;201405;3860;12659;3253;11685;1367;5308;839;2883;2206;8191
350390;201405;8791;28592;7824;26800;2195;8088;3710;12374;5905;20462
350395;201405;331;1041;249;870;74;282;58;198;132;480
350400;201405;8517;25168;7062;22527;2058;7183;2737;8393;4795;15576
350410;201405;7790;28914;6918;26822;2510;10436;1721;6509;4231;16945
350420;201405;1023;3279;834;2909;416;1498;107;370;523;1868
350430;201405;869;2762;751;2552;211;843;376;1230;587;2073
350440;201405;1470;4728;1384;4561;453;1604;681;2162;1134;3766
350450;201405;7981;24573;6460;21510;2051;7364;1851;5950;3902;13314
350460;201405;1581;4705;1165;3810;356;1303;351;1025;707;2328
350470;201405;246;705;208;642;57;199;98;281;155;480
350480;201405;795;2483;545;1879;112;444;91;258;203;702
350490;201405;2155;6320;1844;5895;532;1948;866;2595;1398;4543
350500;201405;625;1859;543;1733;142;504;231;697;373;1201
350510;201405;1115;3596;943;3197;296;1138;347;1055;643;2193
350520;201405;1352;5287;1224;5011;469;2014;336;1352;805;3366
350530;201405;2607;7924;2164;6953;785;2717;620;1844;1405;4561
350535;201405;1505;4491;1456;4423;88;315;1249;3790;1337;4105
350540;201405;2083;6006;1763;5438;490;1628;721;2239;1211;3867
350550;201405;11063;32813;8982;29207;2485;9100;3605;11096;6090;20196
350560;201405;3528;11937;3203;11253;622;2338;1688;6006;2310;8344
350570;201405;21738;75565;19965;71454;6495;24830;7518;26017;14013;50847
350580;201405;2113;6990;1725;6079;580;2249;286;878;866;3127
350590;201405;4277;13855;3305;11748;1017;4021;1147;3724;2164;7745
350600;201405;40231;103436;28260;84305;5909;19372;14099;40736;20008;60108
350610;201405;9308;27606;7513;24514;2001;7256;3469;10948;5470;18204
350620;201405;483;1489;405;1367;106;396;173;556;279;952
350630;201405;1727;5399;1359;4643;414;1581;245;756;659;2337
350635;201405;5197;16980;4227;15063;1327;4989;1622;5808;2949;10797
350640;201405;684;2229;555;1875;165;597;164;520;329;1117
350650;201405;4843;15665;3318;11964;1219;4862;354;1256;1573;6118
350660;201405;3800;12107;3322;11269;876;3215;1667;5574;2543;8789
350670;201405;1895;5939;1777;5730;365;1282;1135;3545;1500;4827
350680;201405;1246;3911;1001;3397;296;1186;410;1327;706;2513
350690;201405;1097;3699;935;3350;297;1182;254;832;551;2014
350700;201405;2792;9708;2442;8912;934;3790;891;2914;1825;6704
350710;201405;2257;7185;2063;6879;341;1284;1400;4608;1741;5892
350715;201405;1130;3482;1005;3244;282;1041;387;1162;669;2203
350720;201405;139;429;127;404;40;144;50;137;90;281
350730;201405;437;1678;412;1605;134;583;126;452;260;1035
350740;201405;2450;7501;2190;6920;576;1972;932;2943;1508;4915
350745;201405;362;1169;298;1019;68;276;130;402;198;678
350750;201405;10153;31410;7897;26856;2293;8560;2177;6988;4470;15548
350760;201405;12507;40241;11334;38093;3595;13435;5170;16563;8765;29998
350770;201405;932;2771;672;2252;163;615;259;858;422;1473
350775;201405;640;1900;585;1809;152;530;269;826;421;1356
350780;201405;2175;6663;1631;5501;511;1901;225;702;736;2603
350790;201405;2162;7123;1739;6203;567;2185;376;1193;943;3378
350800;201405;3146;10798;3000;10552;651;2541;1852;6393;2503;8934
350810;201405;2626;7767;2317;7219;843;2837;736;2308;1579;5145
350820;201405;574;1590;425;1274;100;353;169;447;269;800
350830;201405;900;2886;654;2273;129;501;146;435;275;936
350840;201405;2359;8573;1982;7596;669;2824;412;1373;1081;4197
350850;201405;6784;23228;5667;20560;2027;7820;1393;4831;3420;12651
350860;201405;3428;11181;3286;10958;510;1916;2430;8051;2940;9967
350870;201405;2513;8591;2239;8165;698;2728;1208;4456;1906;7184
350880;201405;1718;5885;1477;5345;493;1889;318;1161;811;3050
350890;201405;652;1967;527;1698;102;386;174;476;276;862
350900;201405;4676;15806;3920;14107;1110;4363;1155;3955;2265;8318
350910;201405;895;2780;841;2663;339;1110;304;954;643;2064
350920;201405;10100;30483;9310;29167;1807;6254;5992;18166;7799;24420
350925;201405;5380;16902;4795;15727;1406;5038;2120;6701;3526;11739
350930;201405;1578;4423;1330;4014;159;591;943;2734;1102;3325
350940;201405;2353;7923;2155;7593;475;1943;1295;4372;1770;6315
350945;201405;962;3222;854;2991;219;842;377;1269;596;2111
350950;201405;73122;236541;62304;214406;18189;68198;26072;87458;44261;155656
350960;201405;4708;16712;4193;15538;833;3573;2334;8321;3167;11894
350970;201405;4503;16385;4024;15191;1454;5916;1242;4506;2696;10422
350980;201405;705;2296;644;2193;316;1142;157;536;473;1678
350990;201405;1839;6473;1627;6067;554;2194;564;2074;1118;4268
350995;201405;835;3005;791;2920;228;943;398;1422;626;2365
351000;201405;3697;11323;3203;10383;509;1908;1855;5808;2364;7716
351010;201405;429;1309;313;1070;125;473;68;236;193;709
351015;201405;969;3253;840;3006;306;1217;290;983;596;2200
351020;201405;8004;26245;7126;24877;1871;7004;3712;13131;5583;20135
351030;201405;1485;5501;1380;5261;407;1787;523;1889;930;3676
351040;201405;3807;12284;3523;11777;795;3091;2085;6589;2880;9680
351050;201405;9847;31796;7995;28161;2688;10328;2770;9703;5458;20031
351060;201405;34800;110074;29411;99839;9469;34164;11008;37254;20477;71418
351070;201405;1887;5425;1384;4527;502;1801;263;759;765;2560
351080;201405;2845;8681;2256;7953;664;2574;1077;3722;1741;6296
351090;201405;379;1337;307;1184;110;486;64;235;174;721
351100;201405;1998;6478;1746;5977;707;2499;539;1865;1246;4364
351110;201405;9763;26458;6187;20191;1962;7024;1760;5499;3722;12523
351120;201405;622;1910;531;1700;74;275;270;778;344;1053
351130;201405;896;2529;467;1619;96;398;113;365;209;763
351140;201405;2045;7115;1864;6713;703;2729;597;2101;1300;4830
351150;201405;2246;7873;1835;6755;559;2260;447;1515;1006;3775
351160;201405;1566;5536;1414;5178;489;1995;499;1745;988;3740
351170;201405;1672;5556;1350;4797;356;1379;559;1849;915;3228
351190;201405;707;2313;578;1969;150;545;129;383;279;928
351200;201405;2354;7077;2009;6406;393;1435;924;2754;1317;4189
351210;201405;1133;3569;955;3215;291;1063;327;1036;618;2099
351220;201405;3597;12267;3191;11414;860;3327;1477;5243;2337;8570
351230;201405;1946;6568;1758;6195;546;2115;867;2978;1413;5093
351240;201405;1024;3345;743;2677;216;873;166;514;382;1387
351250;201405;903;2642;676;2181;144;520;328;1010;472;1530
351260;201405;1197;3607;1081;3361;297;1002;438;1306;735;2308
351270;201405;408;1475;377;1410;123;523;126;424;249;947
351280;201405;5438;16517;4012;13252;1080;3840;1274;3824;2354;7664
351290;201405;1126;3382;909;2943;303;1023;298;906;601;1929
351300;201405;10495;38709;9088;35410;2787;11713;3431;13306;6218;25019
351310;201405;3462;10950;2919;9939;729;2848;1408;4464;2137;7312
351320;201405;1027;3634;900;3331;318;1282;225;734;543;2016
351330;201405;284;837;254;779;111;346;62;187;173;533
351340;201405;6755;23734;6118;22421;1756;6793;3011;11069;4767;17862
351350;201405;8073;26697;7164;24753;2180;7937;2717;9067;4897;17004
351360;201405;4907;15161;4619;14660;1282;4406;2244;6979;3526;11385
351370;201405;2082;6822;1713;6032;551;2167;474;1524;1025;3691
351380;201405;37862;119607;35197;114237;9292;32891;17229;53816;26521;86707
351385;201405;256;817;250;807;87;287;104;330;191;617
351390;201405;1284;4346;1136;4038;417;1606;436;1464;853;3070
351400;201405;1246;4045;1183;3905;470;1657;370;1241;840;2898
351410;201405;3035;9314;2700;8723;624;2170;1432;4545;2056;6715
351420;201405;459;1364;334;1087;99;329;62;201;161;530
351430;201405;926;2963;849;2824;142;502;596;1993;738;2495
351440;201405;4787;14791;4134;13375;1570;5277;1119;3450;2689;8727
351450;201405;1836;5280;1626;5002;507;1604;836;2644;1343;4248
351460;201405;855;2713;729;2464;339;1232;221;711;560;1943
351470;201405;1116;3469;995;3232;392;1387;308;973;700;2360
351480;201405;2996;9908;2738;9470;655;2642;1390;4698;2045;7340
351490;201405;2044;6964;1834;6503;377;1557;1000;3395;1377;4952
351492;201405;308;1050;238;864;53;222;72;220;125;442
351495;201405;159;556;129;476;44;175;44;154;88;329
351500;201405;21134;68634;18782;63866;5952;21996;7730;25653;13682;47649
351510;201405;7801;25578;6764;23781;1720;6569;3483;12142;5203;18711
351512;201405;431;1302;370;1183;91;310;169;533;260;843
351515;201405;2126;7086;1667;6019;543;2139;453;1546;996;3685
351518;201405;1693;5885;1283;5148;393;1751;298;1124;691;2875
351519;201405;844;2727;718;2431;211;819;284;879;495;1698
351520;201405;825;2317;402;1446;81;333;58;184;139;517
351530;201405;474;1516;407;1345;86;304;138;414;224;718
351535;201405;2672;7002;2174;6297;249;832;1520;4341;1769;5173
351540;201405;2202;7111;1972;6676;925;3321;418;1388;1343;4709
351550;201405;4750;14338;3534;11869;947;3589;1133;3647;2080;7236
351560;201405;438;1442;384;1316;145;547;73;240;218;787
351565;201405;243;827;226;782;77;303;91;285;168;588
351570;201405;12962;42429;11327;39093;3340;12115;5336;18348;8676;30463
351580;201405;414;1158;306;934;56;173;104;302;160;475
351590;201405;526;1456;403;1197;123;389;92;257;215;646
351600;201405;1934;5614;1730;5250;394;1370;848;2389;1242;3759
351610;201405;649;1839;541;1651;112;401;281;807;393;1208
351620;201405;17016;56181;13174;47777;3483;14007;3477;11318;6960;25325
351630;201405;15401;52487;14236;50537;3708;13739;7959;28596;11667;42335
351640;201405;8611;27972;7177;25452;1736;6733;3752;13115;5488;19848
351650;201405;402;1214;249;837;78;274;34;109;112;383
351660;201405;868;2735;672;2269;158;587;199;602;357;1189
351670;201405;4322;13735;3653;12303;769;2992;1824;5822;2593;8814
351680;201405;661;2066;434;1485;108;405;73;215;181;620
351685;201405;462;1416;378;1266;104;363;154;523;258;886
351690;201405;1368;4097;1078;3439;444;1420;299;913;743;2333
351700;201405;1526;4612;1372;4310;470;1537;494;1504;964;3041
351710;201405;809;2564;682;2276;183;629;213;668;396;1297
351720;201405;1717;5493;1300;4400;323;1188;447;1450;770;2638
351730;201405;1142;3426;970;3188;417;1496;306;942;723;2438
351740;201405;4743;13697;4018;12176;1103;3554;1343;3817;2446;7371
351750;201405;1522;5059;1323;4645;452;1762;367;1190;819;2952
351760;201405;3824;12441;3385;11464;932;3410;1470;4802;2402;8212
351770;201405;2332;7626;2040;7088;647;2360;1001;3454;1648;5814
351780;201405;1638;4700;1104;3541;318;1114;227;657;545;1771
351790;201405;1182;3550;1009;3298;365;1261;421;1350;786;2611
351800;201405;385;878;305;758;37;110;191;444;228;554
351810;201405;1216;3732;1147;3644;282;1035;731;2227;1013;3262
351820;201405;1962;6251;1617;5632;569;2105;204;685;773;2790
351830;201405;4250;14001;3782;12950;957;3591;1805;5974;2762;9565
351840;201405;9112;31799;8191;29866;2881;11113;2788;10111;5669;21224
351850;201405;1404;4667;1159;4147;353;1432;310;967;663;2399
351860;201405;3700;12066;3386;11411;912;3430;1653;5303;2565;8733
351870;201405;35804;111894;32763;106514;7635;26549;19225;62461;26860;89010
351880;201405;104210;340967;91232;314058;29491;107704;28332;96779;57823;204483
351885;201405;667;2450;622;2346;184;759;283;1024;467;1783
351890;201405;820;2477;658;2134;204;719;166;503;370;1222
351900;201405;1444;4505;1262;4216;383;1368;490;1643;873;3011
351905;201405;441;1519;380;1405;99;437;192;644;291;1081
351907;201405;15484;49304;13548;45547;3065;11634;6997;22587;10062;34221
351910;201405;1195;3860;1111;3716;286;1092;423;1328;709;2420
351920;201405;1230;3556;1153;3435;268;890;685;2003;953;2893
351925;201405;1016;2997;944;2877;148;550;618;1755;766;2305
351930;201405;3213;11041;2984;10556;855;3497;1398;4522;2253;8019
351940;201405;1037;3223;969;3100;277;967;581;1790;858;2757
351950;201405;1428;4010;1041;3253;213;752;503;1501;716;2253
351960;201405;4332;14091;3394;12385;1022;3647;1579;6259;2601;9906
351970;201405;7085;26985;6438;25580;2394;9966;2211;8837;4605;18803
351980;201405;1014;3137;846;2820;207;767;342;1039;549;1806
351990;201405;1637;4742;1322;4109;395;1402;370;1002;765;2404
352000;201405;2512;8186;2298;7749;619;2260;1043;3378;1662;5638
352010;201405;2314;7950;2105;7419;769;2842;467;1646;1236;4488
352020;201405;1567;5082;1405;4757;447;1591;503;1691;950;3282
352030;201405;4633;14593;4182;13976;1009;3503;2368;8095;3377;11598
352040;201405;1899;6724;1640;6069;498;1964;403;1401;901;3365
352042;201405;2448;6990;1821;5664;439;1503;919;2785;1358;4288
352044;201405;1432;4896;1141;4138;284;1099;237;809;521;1908
352050;201405;7124;23984;5129;19320;1658;6906;985;3264;2643;10170
352060;201405;838;2519;737;2347;202;763;309;898;511;1661
352070;201405;751;2063;697;1976;281;838;250;749;531;1587
352080;201405;546;1695;462;1549;141;539;154;463;295;1002
352090;201405;1752;5732;1428;5033;368;1479;441;1395;809;2874
352100;201405;1828;6286;1636;5901;543;2198;624;2068;1167;4266
352110;201405;455;1730;407;1613;125;544;140;529;265;1073
352115;201405;390;1285;335;1166;91;358;164;534;255;892
352120;201405;950;2898;834;2730;170;608;480;1580;650;2188
352130;201405;1862;5371;1367;4453;384;1370;524;1554;908;2924
352140;201405;1544;4949;1175;4116;341;1279;494;1709;835;2988
352150;201405;663;2057;532;1792;162;553;227;751;389;1304
352160;201405;1258;3601;1162;3464;263;826;694;2096;957;2922
352170;201405;2556;7917;2324;7483;567;2030;1248;3792;1815;5822
352180;201405;3645;10582;3211;9778;861;2897;1447;4163;2308;7060
352190;201405;1128;3491;1032;3322;228;866;544;1639;772;2505
352200;201405;449;1567;377;1422;85;346;187;727;272;1073
352210;201405;15708;42853;12607;38262;2320;7375;7821;24306;10141;31681
352215;201405;582;1853;527;1776;75;299;305;1028;380;1327
352220;201405;15049;50607;13985;48423;4778;17561;5539;19159;10317;36720
352230;201405;13829;47907;12226;44830;3829;15263;4774;17281;8603;32544
352240;201405;9654;31054;8864;29652;2953;11085;3612;11444;6565;22529
352250;201405;22897;74737;20283;69385;5571;20838;8147;27552;13718;48390
352260;201405;5561;17337;3978;14009;1079;4212;1361;4424;2440;8636
352265;201405;959;3052;825;2838;127;514;506;1685;633;2199
352270;201405;2541;8734;2189;7927;875;3309;513;1799;1388;5108
352280;201405;2503;7857;2120;7205;601;2291;722;2350;1323;4641
352290;201405;1333;4364;1166;4000;307;1201;360;1112;667;2313
352300;201405;986;2979;825;2692;241;851;370;1184;611;2035
352310;201405;33708;113210;30329;107309;7780;29843;18011;62886;25791;92729
352320;201405;5751;17974;5010;16566;1548;5583;1768;5321;3316;10904
352330;201405;2223;7323;1941;6966;693;2651;702;2554;1395;5205
352340;201405;5926;20476;4891;17948;1689;6707;994;3346;2683;10053
352350;201405;1804;6684;1642;6317;477;1982;598;2226;1075;4208
352360;201405;1211;4029;1083;3768;290;1222;604;1940;894;3162
352370;201405;920;3159;839;2980;206;828;383;1319;589;2147
352380;201405;1042;3339;921;3132;336;1255;290;970;626;2225
352390;201405;13209;39339;9960;32935;2153;8285;4857;15067;7010;23352
352400;201405;3460;10491;2352;8266;652;2532;894;2986;1546;5518
352410;201405;3810;11287;2948;9809;954;3415;946;3033;1900;6448
352420;201405;1303;3764;1220;3617;445;1456;498;1464;943;2920
352430;201405;6416;20391;5688;19194;2210;8082;1997;6591;4207;14673
352440;201405;16264;51686;13476;46154;3743;13921;5360;17888;9103;31809
352450;201405;663;1961;453;1560;125;481;106;324;231;805
352460;201405;2293;7653;2017;7141;708;2822;690;2202;1398;5024
352470;201405;4928;14091;3016;10058;615;2247;1211;3951;1826;6198
352480;201405;5515;15714;4530;13903;1160;4120;1942;5521;3102;9641
352490;201405;757;2722;643;2455;171;726;139;511;310;1237
352500;201405;8988;29260;8467;28372;3960;14330;2710;8391;6670;22721
352510;201405;3492;12166;2902;10886;1083;4355;756;2796;1839;7151
352520;201405;2463;8784;2208;8185;572;2292;1189;4317;1761;6609
352530;201405;6614;21549;5006;18052;1567;6112;865;2894;2432;9006
352540;201405;478;1593;381;1374;84;330;121;440;205;770
352550;201405;1126;3834;877;3233;302;1211;196;668;498;1879
352560;201405;639;1923;489;1582;97;363;203;594;300;957
352570;201405;1574;5114;1135;4066;264;1097;290;934;554;2031
352580;201405;943;2863;813;2637;295;1084;339;1012;634;2096
352585;201405;245;832;193;714;60;248;43;142;103;390
352590;201405;13459;44030;12041;41249;2749;10515;6692;22200;9441;32715
352600;201405;1960;6382;1817;6071;629;2217;708;2307;1337;4524
352610;201405;3680;11806;3273;11138;1239;4593;1104;3583;2343;8176
352620;201405;5606;18060;5316;17665;1101;3905;3548;11798;4649;15703
352630;201405;862;2881;816;2768;257;929;382;1283;639;2212
352640;201405;3167;10198;2616;8975;574;2179;1172;3917;1746;6096
352650;201405;853;2561;641;2118;139;510;221;686;360;1196
352660;201405;1104;3877;899;3381;288;1166;262;977;550;2143
352670;201405;8243;27787;6881;24964;2600;9883;1674;6068;4274;15951
352680;201405;3451;12167;2702;10307;661;2805;711;2419;1372;5224
352690;201405;26281;78492;20284;66434;5198;18707;8694;27512;13892;46219
352700;201405;779;2327;624;2087;188;714;279;886;467;1600
352710;201405;5393;16155;4002;13311;1067;3930;1509;4774;2576;8704
352720;201405;8986;30452;8406;29222;2766;10107;3451;11944;6217;22051
352725;201405;419;1257;287;953;59;236;82;245;141;481
352730;201405;2681;9373;2358;8494;677;2695;735;2391;1412;5086
352740;201405;2304;6920;1965;6317;526;1984;929;2732;1455;4716
352750;201405;421;1297;311;1044;103;382;69;199;172;581
352760;201405;992;3479;914;3343;308;1224;459;1621;767;2845
352770;201405;946;2949;885;2838;278;952;327;1043;605;1995
352780;201405;631;2149;552;1965;152;611;174;546;326;1157
352790;201405;677;1980;528;1710;151;544;116;358;267;902
352800;201405;1171;4427;948;3797;313;1277;183;648;496;1925
352810;201405;1041;2799;770;2294;149;524;284;800;433;1324
352820;201405;602;1817;494;1638;208;718;104;350;312;1068
352830;201405;462;1335;341;1082;86;293;65;176;151;469
352840;201405;3694;12984;3254;12009;1002;3958;1099;4023;2101;7981
352850;201405;10127;33104;8899;30912;2724;9955;3408;11999;6132;21954
352860;201405;1063;3560;990;3400;407;1461;284;914;691;2375
352870;201405;1140;2900;886;2438;146;506;475;1188;621;1694
352880;201405;2393;7210;1871;6054;479;1676;488;1445;967;3121
352885;201405;316;1089;301;1056;92;351;128;425;220;776
352890;201405;825;2306;674;2005;159;526;272;736;431;1262
352900;201405;19554;60044;15076;50696;4031;14727;6135;19873;10166;34600
352910;201405;288;931;253;851;89;300;31;88;120;388
352920;201405;3419;10594;2926;9616;1026;3672;1042;3199;2068;6871
352930;201405;7218;23147;5771;19870;1810;6728;1107;3662;2917;10390
352940;201405;27148;92286;23482;83439;8625;32279;4674;16024;13299;48303
352950;201405;317;1006;228;811;62;266;65;197;127;463
352960;201405;597;1907;410;1446;82;322;72;236;154;558
352965;201405;379;1086;309;954;82;273;58;164;140;437
352970;201405;3401;9011;3025;8511;425;1275;2169;6181;2594;7456
352980;201405;1529;4599;1302;4238;400;1323;592;2033;992;3356
352990;201405;3631;12185;3356;11701;1106;4262;1229;4099;2335;8361
353000;201405;548;1552;403;1247;97;335;106;286;203;621
353010;201405;2882;8257;2182;6821;598;2089;781;2252;1379;4341
353020;201405;4501;12563;3203;9786;544;1874;1368;3849;1912;5723
353030;201405;3886;11631;3251;10358;1019;3556;866;2577;1885;6133
353040;201405;715;2068;621;1922;200;675;240;727;440;1402
353050;201405;5655;19764;4848;18050;1779;7117;1538;5490;3317;12607
353060;201405;34372;111965;32123;108393;5535;21915;21903;71092;27438;93007
353070;201405;8953;30874;7157;26675;2493;9819;1885;7042;4378;16861
353080;201405;5044;17307;4073;15072;1342;5362;1165;4050;2507;9412
353090;201405;602;2028;534;1885;100;422;266;859;366;1281
353100;201405;281;843;222;706;102;333;50;153;152;486
353110;201405;8002;25266;7207;23807;1752;6148;4035;13480;5787;19628
353120;201405;475;1616;402;1454;135;544;99;331;234;875
353130;201405;3042;9600;2702;8992;1043;3801;995;3138;2038;6939
353140;201405;2679;7622;2165;6584;677;2269;722;1982;1399;4251
353150;201405;1994;6347;1659;5714;606;2197;435;1538;1041;3735
353160;201405;672;1988;528;1685;165;537;103;309;268;846
353170;201405;524;1873;475;1779;181;758;187;673;368;1431
353180;201405;5706;18255;5028;16985;790;3106;3173;10398;3963;13504
353190;201405;3683;11891;3203;10781;778;2915;1511;4718;2289;7633
353200;201405;914;3229;809;2986;261;1078;318;1119;579;2197
353205;201405;549;1782;454;1566;99;345;166;575;265;920
353210;201405;1065;2862;867;2508;117;400;566;1599;683;1999
353215;201405;573;1805;495;1632;116;428;163;522;279;950
353220;201405;929;2881;831;2672;240;813;271;857;511;1670
353230;201405;969;3109;892;2979;242;908;288;884;530;1792
353240;201405;2256;7558;2051;7128;645;2490;884;2864;1529;5354
353250;201405;1263;3624;1066;3268;303;989;404;1188;707;2177
353260;201405;1174;3453;1038;3234;332;1115;426;1262;758;2377
353270;201405;682;2079;591;1902;178;622;180;533;358;1155
353280;201405;596;1973;522;1843;185;711;152;508;337;1219
353282;201405;1756;5884;1705;5804;310;1177;1148;3811;1458;4988
353284;201405;333;929;256;782;62;186;84;256;146;442
353286;201405;153;469;104;351;33;112;12;45;45;157
353290;201405;462;1642;411;1552;176;709;154;559;330;1268
353300;201405;1914;6149;1662;5586;563;2053;566;1724;1129;3777
353310;201405;353;1123;334;1074;155;521;95;285;250;806
353320;201405;560;1598;483;1473;115;399;240;693;355;1092
353325;201405;551;1936;468;1751;135;548;73;257;208;805
353330;201405;554;1655;414;1351;103;388;183;536;286;924
353340;201405;3243;10521;2790;9625;957;3528;1052;3559;2009;7087
353350;201405;3547;10850;3119;10083;1082;3734;1393;4384;2475;8118
353360;201405;460;1611;408;1484;114;480;221;757;335;1237
353370;201405;723;2372;657;2206;164;575;334;1114;498;1689
353380;201405;411;1360;365;1274;100;398;159;530;259;928
353390;201405;5534;15007;3965;12150;924;3177;1485;4140;2409;7317
353400;201405;629;1982;526;1764;136;490;155;446;291;936
353410;201405;693;2146;589;1979;176;665;300;980;476;1645
353420;201405;709;2125;544;1717;179;595;176;513;355;1108
353430;201405;2508;8792;1817;6781;524;2041;148;468;672;2509
353440;201405;61327;203177;54709;187343;17223;62103;18454;61724;35677;123827
353450;201405;470;1456;419;1366;127;463;160;504;287;967
353460;201405;3615;10196;3053;9210;543;1789;1672;5030;2215;6819
353470;201405;11525;36765;9106;31679;3004;11300;2243;7591;5247;18891
353475;201405;1758;5136;1303;4114;334;1162;369;1034;703;2196
353480;201405;1561;4699;1405;4409;323;1130;788;2383;1111;3513
353490;201405;1663;4793;1387;4234;409;1394;399;1092;808;2486
353500;201405;1242;3602;1137;3426;493;1579;404;1147;897;2726
353510;201405;1398;4541;1168;3935;352;1307;352;1033;704;2340
353520;201405;1265;3782;1034;3373;375;1322;326;1063;701;2385
353530;201405;2810;8496;2526;7979;654;2284;1158;3536;1812;5820
353540;201405;2081;6405;1896;6080;640;2154;793;2568;1433;4722
353550;201405;6862;19894;6082;18621;1134;4093;3490;10020;4624;14113
353560;201405;2204;7367;1846;6705;483;1960;694;2452;1177;4412
353570;201405;534;1714;435;1508;105;400;226;719;331;1119
353580;201405;2496;8215;2341;7935;711;2692;1289;4219;2000;6911
353590;201405;818;2380;687;2139;261;873;171;542;432;1415
353600;201405;1934;5585;1751;5260;416;1375;900;2679;1316;4054
353610;201405;603;2151;533;2006;150;661;173;606;323;1267
353620;201405;2382;8281;2142;7815;716;2812;750;2614;1466;5426
353625;201405;380;1059;272;868;108;384;71;202;179;586
353630;201405;1735;6001;1380;5103;363;1461;276;921;639;2382
353640;201405;1649;4813;1458;4407;379;1197;648;1978;1027;3175
353650;201405;6851;21049;4946;16762;1086;4001;1862;5947;2948;9948
353657;201405;345;1126;310;1049;66;266;118;376;184;642
353660;201405;1413;3664;1052;3088;452;1454;197;432;649;1886
353670;201405;4939;16434;4351;15161;1450;5542;1454;4754;2904;10296
353680;201405;686;2444;653;2386;319;1197;200;741;519;1938
353690;201405;540;1500;377;1223;100;371;139;417;239;788
353700;201405;2402;7737;2103;7091;524;1973;747;2380;1271;4353
353710;201405;3466;9386;1835;6547;549;2151;558;1987;1107;4138
353715;201405;489;1466;417;1329;93;327;187;579;280;906
353720;201405;2131;6721;1854;6302;368;1331;1074;3700;1442;5031
353730;201405;4516;14213;3651;12212;991;3585;1029;3163;2020;6748
353740;201405;2347;7204;1908;6273;680;2318;547;1738;1227;4056
353750;201405;783;2785;631;2390;189;791;176;666;365;1457
353760;201405;8360;26020;6887;23349;1938;6950;3129;10685;5067;17635
353770;201405;805;2546;537;1873;134;517;58;139;192;656
353780;201405;5971;21365;5418;20227;2511;9583;1502;5871;4013;15454
353790;201405;3156;11344;2824;10644;1051;4251;604;2389;1655;6640
353800;201405;14805;47990;11954;42410;3350;13055;4862;16737;8212;29792
353810;201405;1204;4022;1061;3687;324;1181;411;1427;735;2608
353820;201405;1259;4478;1211;4394;392;1630;537;1803;929;3433
353830;201405;799;2196;636;1893;135;439;265;777;400;1216
353850;201405;1882;6219;1765;6018;447;1656;871;2848;1318;4504
353860;201405;2491;8528;2087;7577;687;2685;637;2239;1324;4924
353870;201405;23835;75091;18163;63370;4402;17334;6192;19624;10594;36958
353880;201405;2169;7207;1978;6906;365;1482;1228;4175;1593;5657
353890;201405;2592;6774;1896;5626;490;1611;888;2508;1378;4119
353900;201405;1159;3658;869;3001;235;895;203;619;438;1514
353910;201405;2162;7670;2058;7392;684;2645;910;3261;1594;5906
353920;201405;2516;7536;1906;6257;457;1579;362;1072;819;2651
353930;201405;4110;14537;3463;13111;1275;5096;831;3124;2106;8220
353940;201405;1538;4973;1342;4562;343;1334;559;1765;902;3099
353950;201405;3685;12055;3386;11513;571;2249;2172;7193;2743;9442
353960;201405;623;2026;507;1766;128;503;153;462;281;965
353970;201405;541;1604;472;1513;49;201;343;1066;392;1267
353980;201405;14589;43605;12315;39780;3002;10451;6479;20628;9481;31079
353990;201405;525;1658;483;1556;145;518;195;568;340;1086
354000;201405;1967;5903;1375;4715;353;1337;152;454;505;1791
354010;201405;392;1226;354;1163;146;492;127;422;273;914
354020;201405;4895;15050;4433;14090;1313;4536;1968;5874;3281;10410
354025;201405;1121;3194;878;2762;235;793;224;689;459;1482
354030;201405;656;1761;465;1473;138;490;167;484;305;974
354040;201405;800;2197;626;1868;98;345;353;977;451;1322
354050;201405;982;3326;906;3163;340;1291;267;913;607;2204
354060;201405;4764;15533;3760;13321;1036;3986;1518;5175;2554;9161
354070;201405;3697;12470;3230;11384;1157;4357;846;2948;2003;7305
354075;201405;2267;8594;2171;8422;735;3074;968;3729;1703;6803
354080;201405;1964;6067;1530;5017;447;1521;452;1352;899;2873
354085;201405;313;857;279;789;31;117;202;523;233;640
354090;201405;1221;3712;1157;3611;149;525;880;2721;1029;3246
354100;201405;17019;58790;14738;54469;4035;15855;6762;24927;10797;40782
354105;201405;911;2913;775;2650;209;826;328;1011;537;1837
354110;201405;852;2461;696;2219;211;777;225;646;436;1423
354120;201405;2307;6552;1947;5900;546;1852;729;2064;1275;3916
354130;201405;5467;16688;4682;15130;1843;6343;1315;3990;3158;10333
354140;201405;21489;56746;13997;42343;2721;9335;5791;16271;8512;25606
354150;201405;4581;12881;3607;11120;1034;3485;1572;4676;2606;8161
354160;201405;4082;13581;3600;12536;1072;4017;1510;5094;2582;9111
354165;201405;418;1551;381;1455;149;613;98;380;247;993
354170;201405;1646;5370;1349;4651;308;1192;485;1493;793;2685
354180;201405;526;1605;512;1580;77;276;340;983;417;1259
354190;201405;1674;5654;1459;5158;511;1935;483;1647;994;3582
354200;201405;1184;3481;969;3070;208;763;397;1134;605;1897
354210;201405;861;3020;776;2828;188;815;321;1072;509;1887
354220;201405;3212;10134;2887;9495;953;3393;1202;3794;2155;7187
354230;201405;803;2678;759;2600;225;806;377;1297;602;2103
354240;201405;1380;4721;1128;4151;342;1364;293;1030;635;2394
354250;201405;554;1798;456;1631;207;829;132;436;339;1265
354260;201405;9329;28465;8468;27107;2677;9268;3602;11447;6279;20715
354270;201405;1154;4138;1074;3956;334;1365;426;1566;760;2931
354280;201405;907;2683;843;2570;174;596;487;1466;661;2062
354290;201405;1346;4798;1246;4576;394;1535;410;1494;804;3029
354300;201405;3258;11342;3157;11147;867;3250;1642;5758;2509;9008
354310;201405;796;2666;634;2270;186;725;187;678;373;1403
354320;201405;847;2581;733;2350;216;788;241;698;457;1486
354323;201405;375;1110;312;1008;101;351;105;310;206;661
354325;201405;1340;4616;1202;4307;326;1308;482;1607;808;2915
354330;201405;8164;25730;7332;24094;1959;6897;3792;12079;5751;18976
354340;201405;30453;100346;26208;92445;9785;37040;9468;32660;19253;69700
354350;201405;1194;3600;1123;3470;292;980;627;1868;919;2848
354360;201405;456;1501;372;1338;116;447;40;126;156;573
354370;201405;1161;3926;1019;3625;147;650;690;2359;837;3009
354380;201405;1330;4041;1117;3664;431;1553;220;640;651;2193
354390;201405;11871;38801;9044;32429;2436;9538;2538;8679;4974;18217
354400;201405;2186;7864;1916;7205;545;2184;609;2198;1154;4382
354410;201405;6523;20052;5446;18288;1279;4608;2868;9642;4147;14250
354420;201405;1692;5061;1412;4447;438;1452;514;1562;952;3014
354425;201405;3539;10288;3104;9491;1068;3436;1072;3357;2140;6793
354430;201405;1395;4634;1287;4458;352;1363;633;2098;985;3461
354440;201405;571;1719;456;1480;93;331;198;626;291;957
354450;201405;513;1504;342;1130;54;237;96;265;150;502
354460;201405;841;2525;738;2334;263;875;341;1055;604;1930
354470;201405;514;1475;398;1242;68;271;183;503;251;774
354480;201405;787;2381;698;2233;158;589;366;1066;524;1655
354490;201405;779;2676;624;2292;159;630;208;690;367;1320
354500;201405;2566;8777;2350;8380;904;3569;640;2254;1544;5823
354510;201405;735;2429;667;2287;177;654;337;1138;514;1792
354515;201405;365;1292;301;1137;72;315;98;339;170;654
354520;201405;6143;21744;4712;17785;1520;6390;1735;6254;3255;12644
354530;201405;2861;10393;2685;10045;743;3035;1458;5394;2201;8429
354540;201405;1401;4371;1232;4066;411;1441;499;1687;910;3128
354550;201405;591;1931;525;1779;107;367;224;725;331;1092
354560;201405;1520;4617;1174;3855;330;1115;397;1261;727;2376
354570;201405;679;2135;564;1858;192;677;128;403;320;1080
354580;201405;9349;27717;7607;24405;1637;5952;3571;10853;5208;16805
354600;201405;1746;6036;1559;5658;478;2010;685;2315;1163;4325
354610;201405;478;1361;340;1079;70;234;97;266;167;500
354620;201405;431;1509;356;1362;117;521;117;416;234;937
354625;201405;280;941;237;853;69;270;64;225;133;495
354630;201405;1943;6854;1764;6430;756;2827;561;1939;1317;4766
354640;201405;4195;14178;3589;12816;1112;4511;830;2705;1942;7216
354650;201405;1026;3158;926;2946;188;684;534;1647;722;2331
354660;201405;2036;6221;1626;5453;418;1529;727;2430;1145;3959
354670;201405;1643;5399;1323;4573;397;1500;349;1067;746;2567
354680;201405;5399;18260;4969;17328;1431;5348;1998;6752;3429;12100
354690;201405;876;2973;630;2359;131;520;187;640;318;1160
354700;201405;1212;3470;855;2705;157;596;361;987;518;1583
354710;201405;625;1871;540;1700;144;514;200;583;344;1097
354720;201405;198;578;164;509;66;203;42;132;108;335
354730;201405;6417;22722;5715;21280;1652;6711;2559;9231;4211;15942
354740;201405;264;815;197;695;55;199;43;154;98;353
354750;201405;2353;7624;2007;7129;691;2684;797;2774;1488;5458
354760;201405;2234;7525;1898;6746;642;2439;445;1498;1087;3937
354765;201405;310;829;203;635;48;178;32;94;80;272
354770;201405;2840;8430;2292;7529;1068;3782;430;1332;1498;5114
354780;201405;36924;117591;33854;110582;8377;30200;17209;53579;25586;83779
354790;201405;874;2886;769;2701;220;852;335;1088;555;1940
354800;201405;1903;5717;1728;5480;452;1553;1023;3250;1475;4803
354805;201405;932;2918;720;2441;130;487;138;434;268;921
354810;201405;707;2385;524;1930;174;709;95;317;269;1026
354820;201405;1086;3888;984;3684;294;1252;271;922;565;2174
354830;201405;447;1385;395;1287;138;501;146;437;284;938
354840;201405;825;2451;746;2314;235;776;310;945;545;1721
354850;201405;14932;48491;11443;41124;3095;12299;4178;14081;7273;26380
354860;201405;1291;4271;1178;4073;308;1265;546;1768;854;3033
354870;201405;43619;141849;40830;135969;12335;43769;19758;64519;32093;108288
354880;201405;4136;13072;3002;10495;886;3372;728;2274;1614;5646
354890;201405;15461;48079;13443;44048;3909;13883;4797;15162;8706;29045
354900;201405;623;1775;506;1603;175;582;197;625;372;1207
354910;201405;6570;20372;3906;14223;933;3760;458;1576;1391;5336
354920;201405;518;1553;402;1343;122;453;108;340;230;793
354925;201405;373;1082;224;772;47;186;36;103;83;289
354930;201405;259;800;238;747;87;292;75;233;162;525
354940;201405;2301;8248;1786;6805;679;2722;279;1002;958;3724
354950;201405;1499;5060;1373;4875;252;1027;854;2992;1106;4019
354960;201405;792;2545;691;2379;204;778;268;897;472;1675
354970;201405;4045;13679;3614;12794;798;3275;1944;6578;2742;9853
354980;201405;32776;82366;18759;57986;4229;14694;6436;18463;10665;33157
354990;201405;40210;132678;35869;123615;8346;31785;18847;63233;27193;95018
354995;201405;1992;6360;1874;6184;479;1663;1004;3344;1483;5007
355000;201405;1685;5722;1482;5345;522;2045;378;1331;900;3376
355010;201405;3690;11884;3143;10639;869;3258;1348;4478;2217;7736
355020;201405;3335;11997;2860;11069;1400;5690;795;3124;2195;8814
355030;201405;928500;2730569;848511;2572128;224163;735210;383087;1135956;607250;1871166
355040;201405;2994;9917;2700;9374;842;3222;1351;4524;2193;7746
355050;201405;1286;4119;1062;3654;358;1301;263;913;621;2214
355060;201405;5022;17508;4074;15330;1138;4764;994;3473;2132;8237
355070;201405;6449;20558;5798;19452;1340;5265;3172;10033;4512;15298
355080;201405;1394;4991;1082;4188;356;1509;156;514;512;2023
355090;201405;1122;4057;953;3652;230;979;401;1471;631;2450
355100;201405;29120;94285;25741;88489;9130;32956;9595;33560;18725;66516
355110;201405;1338;4692;1225;4446;426;1673;421;1492;847;3165
355120;201405;674;2183;584;2006;172;644;254;854;426;1498
355130;201405;577;1582;353;1089;96;336;124;325;220;661
355140;201405;1041;3825;995;3720;287;1182;474;1746;761;2928
355150;201405;3544;12033;3127;11230;1009;3801;1251;4383;2260;8184
355160;201405;1599;5501;1375;5113;577;2403;380;1270;957;3673
355170;201405;10029;28981;7192;23836;2443;8759;1929;6301;4372;15060
355180;201405;2922;9144;2523;8408;697;2675;1009;3170;1706;5845
355190;201405;1307;4658;1205;4427;513;1929;373;1328;886;3257
355200;201405;938;3482;889;3379;430;1713;225;837;655;2550
355210;201405;2835;9899;2604;9406;773;3133;1118;3763;1891;6896
355220;201405;30748;105534;28200;100274;11982;43957;8244;30258;20226;74215
355230;201405;1241;3658;788;2621;146;566;190;539;336;1105
355240;201405;22523;70068;17425;58648;4144;15619;6967;21829;11111;37448
355250;201405;25587;86984;23117;82092;7010;26489;10271;36119;17281;62608
355255;201405;899;2551;665;2068;135;457;208;614;343;1071
355260;201405;1637;4844;1479;4553;418;1454;583;1658;1001;3112
355270;201405;1685;5237;1606;5111;246;961;1139;3461;1385;4422
355280;201405;24005;73323;20890;67199;5142;18671;9508;29189;14650;47860
355290;201405;873;2864;811;2750;194;722;392;1277;586;1999
355300;201405;909;3024;714;2590;184;706;202;698;386;1404
355310;201405;1062;3323;945;3102;243;822;454;1550;697;2372
355320;201405;749;2427;665;2226;199;753;241;703;440;1456
355330;201405;1633;5911;1389;5428;524;2277;429;1558;953;3835
355340;201405;3158;8701;2933;8313;737;2306;1671;4561;2408;6867
355350;201405;1422;5039;1263;4693;426;1697;385;1398;811;3095
355360;201405;1245;4363;1153;4173;244;983;778;2807;1022;3790
355365;201405;316;1011;268;913;79;304;71;231;150;535
355370;201405;7376;19363;5386;16916;1861;6381;2131;6740;3992;13121
355380;201405;3702;11386;2885;9470;840;3014;635;1801;1475;4815
355385;201405;1002;3287;949;3192;413;1496;267;844;680;2340
355390;201405;1433;4059;1245;3697;346;1127;473;1352;819;2479
355395;201405;1796;5622;1389;4651;272;1044;551;1674;823;2718
355400;201405;9233;32198;8408;30443;2954;11646;3221;11251;6175;22897
355410;201405;13488;49783;12513;47626;4882;19693;3737;14454;8619;34147
355420;201405;833;3058;786;2938;299;1166;278;1060;577;2226
355430;201405;3755;11199;3256;10318;786;2738;1610;4967;2396;7705
355440;201405;921;3088;762;2671;230;861;214;663;444;1524
355450;201405;2658;8966;2231;8027;693;2756;727;2464;1420;5220
355460;201405;584;1667;443;1406;116;454;147;392;263;846
355465;201405;449;1398;383;1266;119;418;101;332;220;750
355470;201405;979;3053;796;2732;276;1051;282;913;558;1964
355475;201405;138;534;122;485;41;165;39;166;80;331
355480;201405;3295;12165;3111;11754;981;3946;1403;5203;2384;9149
355490;201405;853;2548;677;2168;191;655;163;522;354;1177
355495;201405;748;2525;699;2428;197;763;291;982;488;1745
355500;201405;8641;26256;6026;20401;1511;5672;1318;4106;2829;9778
355510;201405;2195;6126;1482;4710;361;1304;434;1281;795;2585
355520;201405;425;1086;267;785;64;216;77;188;141;404
355530;201405;223;553;100;315;10;33;30;106;40;139
355535;201405;695;2163;570;1911;165;647;163;464;328;1111
355540;201405;10390;33933;9869;33065;2861;10273;5004;16423;7865;26696
355550;201405;719;2289;675;2203;189;665;331;1064;520;1729
355560;201405;1437;4312;1075;3562;297;1087;236;644;533;1731
355570;201405;215;702;170;598;36;124;39;123;75;247
355580;201405;1296;3949;1121;3597;392;1367;436;1367;828;2734
355590;201405;261;741;232;681;54;182;115;328;169;510
355600;201405;1077;3505;903;3105;357;1330;215;716;572;2046
355610;201405;1464;4335;1254;4000;353;1250;558;1713;911;2963
355620;201405;4064;13242;3303;11502;809;3212;1349;4286;2158;7498
355630;201405;3437;10058;2167;7318;482;1818;700;2169;1182;3987
355635;201405;1008;3372;879;3137;161;644;563;1996;724;2640
355640;201405;3849;13015;3251;11578;1169;4331;648;2275;1817;6606
355645;201405;3461;12534;3263;12165;656;2691;2008;7461;2664;10152
355650;201405;6769;21697;5946;20071;1236;5020;3477;10951;4713;15971
355660;201405;1366;4463;1145;4023;384;1513;443;1463;827;2976
355670;201405;2355;7622;1639;5932;454;1885;547;1730;1001;3615
355680;201405;1790;6172;1450;5333;552;2106;310;1096;862;3202
355690;201405;371;1284;321;1176;218;852;25;61;243;913
355695;201405;345;1063;246;814;39;132;18;46;57;178
355700;201405;6593;23671;5989;22171;1824;7322;2588;9237;4412;16559
355710;201405;13011;33547;8196;24715;2674;8549;2211;6414;4885;14963
355715;201405;257;781;171;599;43;168;35;108;78;276
355720;201405;1502;4975;1245;4420;393;1542;410;1310;803;2852
355730;201405;786;2777;714;2621;297;1146;180;659;477;1805
410010;201405;1650;5319;1503;5003;438;1562;471;1540;909;3102
410020;201405;1271;4352;1181;4160;373;1389;441;1534;814;2923
410030;201405;1105;3837;940;3435;312;1193;192;704;504;1897
410040;201405;13168;44506;12085;42256;4352;16180;3669;12777;8021;28957
410045;201405;1123;3215;820;2623;242;821;280;854;522;1675
410050;201405;2929;8507;2022;6763;653;2378;543;1726;1196;4104
410060;201405;2032;6571;1838;6180;563;2109;688;2252;1251;4361
410070;201405;2202;6327;1804;5521;706;2298;403;1126;1109;3424
410080;201405;1496;4544;1248;4077;312;1093;617;1935;929;3028
410090;201405;1138;3662;1036;3447;355;1309;363;1140;718;2449
410100;201405;2624;7925;1910;6283;574;2195;419;1238;993;3433
410105;201405;519;1657;391;1355;94;368;49;129;143;497
410110;201405;2737;8461;2382;7765;614;2252;859;2705;1473;4957
410115;201405;582;1670;498;1489;124;411;172;483;296;894
410120;201405;2939;10180;2789;9957;1053;3906;1219;4505;2272;8411
410130;201405;1417;4777;1289;4475;402;1383;583;2051;985;3434
410140;201405;15976;44613;11407;36154;3269;11460;3991;12588;7260;24048
410150;201405;18200;46114;8857;26842;1890;6388;1786;4832;3676;11220
410160;201405;3411;10969;3124;10495;1035;3786;1154;3941;2189;7727
410165;201405;793;2388;653;2082;148;498;306;948;454;1446
410170;201405;1851;5761;1576;5157;585;2072;489;1553;1074;3625
410180;201405;8974;29130;7858;26686;2015;7796;3583;11372;5598;19168
410185;201405;661;1845;602;1741;146;460;366;1069;512;1529
410190;201405;2280;6881;1981;6196;668;2255;554;1635;1222;3890
410200;201405;3835;11109;2941;9249;865;3026;489;1399;1354;4425
410210;201405;2686;8326;2144;7123;547;2038;461;1334;1008;3372
410220;201405;658;1940;513;1640;117;408;185;556;302;964
410230;201405;1882;6143;1722;5866;662;2456;645;2148;1307;4604
410240;201405;5282;16676;4870;15801;1614;5625;1817;5811;3431;11436
410250;201405;2491;7171;1766;5649;561;2005;369;1052;930;3057
410260;201405;1741;5479;1541;5098;474;1658;586;1907;1060;3565
410270;201405;563;1684;482;1518;131;456;206;637;337;1093
410275;201405;948;2866;662;2238;112;404;347;1179;459;1583
410280;201405;2903;8793;2123;7098;527;2007;403;1269;930;3276
410290;201405;3342;10436;2938;9666;789;2793;1321;4350;2110;7143
410300;201405;632;1822;563;1679;92;339;293;780;385;1119
410302;201405;598;1720;480;1530;58;199;290;944;348;1143
410304;201405;1490;4899;1367;4640;427;1490;571;2029;998;3519
410305;201405;2225;5972;1916;5518;478;1454;1154;3383;1632;4837
410310;201405;2377;7976;2175;7580;668;2503;809;2854;1477;5357
410315;201405;630;1961;498;1683;118;420;168;523;286;943
410320;201405;1253;3734;830;2838;174;693;85;246;259;939
410322;201405;610;1832;447;1468;132;437;132;425;264;862
410330;201405;1520;4295;1289;3857;398;1280;432;1269;830;2549
410335;201405;1072;3193;912;2911;237;848;366;1114;603;1962
410337;201405;834;2264;708;2043;142;476;304;822;446;1298
410340;201405;596;1805;469;1474;97;349;143;377;240;726
410345;201405;1915;5834;1569;5086;530;1870;404;1210;934;3080
410347;201405;840;2404;611;1972;188;664;170;525;358;1189
410350;201405;842;2632;574;2059;166;706;106;329;272;1035
410360;201405;3549;10928;3171;10274;1026;3565;1074;3476;2100;7041
410370;201405;13186;39401;10053;32509;2747;10049;2990;8981;5737;19030
410380;201405;1421;4584;1300;4316;333;1185;621;2006;954;3191
410390;201405;2877;8507;2343;7527;889;3041;663;1994;1552;5035
410395;201405;916;3149;825;2944;220;906;394;1377;614;2283
410400;201405;5264;17265;4691;16134;1522;5851;1537;5123;3059;10974
410405;201405;998;2960;803;2568;210;765;315;957;525;1722
410410;201405;1357;4653;1295;4551;518;2018;352;1166;870;3184
410420;201405;9664;31968;8560;29452;2998;11158;2308;7485;5306;18643
410425;201405;3229;10514;2370;8488;595;2343;358;1234;953;3577
410430;201405;15935;44667;12213;37690;3493;11800;3866;11908;7359;23708
410440;201405;3616;11557;3315;10987;872;3098;1602;5306;2474;8404
410442;201405;2999;10452;2738;9839;939;3578;896;3204;1835;6782
410445;201405;2405;8088;2080;7500;620;2404;781;2953;1401;5357
410450;201405;2646;7688;2149;6755;739;2463;449;1314;1188;3777
410460;201405;2414;7350;2029;6551;557;1938;778;2385;1335;4323
410465;201405;2019;7374;1756;6745;615;2493;604;2176;1219;4669
410470;201405;1947;6320;1703;5746;531;1917;566;1906;1097;3823
410480;201405;30856;91391;24937;79633;9143;31696;6698;20711;15841;52407
410490;201405;11658;38334;9728;34060;3094;11805;3235;11199;6329;23004
410500;201405;1550;4968;1283;4369;495;1826;358;1217;853;3043
410510;201405;2477;6668;1818;5360;453;1451;757;2050;1210;3501
410520;201405;3262;11545;3101;11198;1189;4524;1149;4141;2338;8665
410530;201405;1697;4920;1433;4392;362;1277;608;1750;970;3027
410540;201405;3891;11432;2762;9172;738;2604;963;3156;1701;5760
410550;201405;6743;21168;5361;17984;1794;6609;929;2853;2723;9462
410560;201405;1299;4225;1039;3551;268;1012;268;744;536;1756
410570;201405;2965;9783;2711;9334;809;2860;1222;4514;2031;7374
410580;201405;25888;83025;22833;76548;7884;28747;7067;22620;14951;51367
410590;201405;1276;4065;835;2801;164;597;195;560;359;1157
410600;201405;1983;5985;1697;5413;460;1535;775;2477;1235;4012
410610;201405;834;2588;714;2365;180;647;310;992;490;1639
410620;201405;1764;6429;1581;5981;530;2115;389;1430;919;3545
410630;201405;2551;7716;2098;6763;603;2136;677;2051;1280;4187
410640;201405;5124;15149;4122;13236;1425;5166;977;2992;2402;8158
410645;201405;1297;4628;1243;4523;537;2079;407;1492;944;3571
410650;201405;2507;7788;2064;6865;740;2603;520;1662;1260;4265
410655;201405;936;2882;784;2575;226;807;252;818;478;1625
410657;201405;677;2058;551;1797;168;614;208;607;376;1221
410660;201405;3901;11490;3076;9665;1152;3824;715;2105;1867;5929
410670;201405;1003;2883;775;2436;220;752;212;630;432;1382
410680;201405;2462;8699;2087;7716;617;2298;743;2864;1360;5162
410685;201405;680;2076;631;1993;105;324;439;1402;544;1726
410690;201405;111266;327394;78784;259280;20300;74121;20109;60080;40409;134201
410700;201405;2387;7666;2230;7351;703;2534;935;2971;1638;5505
410710;201405;1111;3503;886;2968;283;1039;259;800;542;1839
410712;201405;801;2497;701;2295;303;1089;205;685;508;1774
410715;201405;1078;3438;931;3101;265;962;341;1094;606;2056
410720;201405;3138;9529;2375;7888;657;2442;751;2285;1408;4727
410725;201405;1092;3179;781;2543;178;616;194;545;372;1161
410730;201405;733;2242;668;2098;285;956;188;576;473;1532
410740;201405;975;2953;710;2399;166;650;316;1045;482;1695
410750;201405;1904;5718;1642;5172;529;1827;513;1517;1042;3344
410752;201405;264;787;215;686;56;214;94;271;150;485
410753;201405;467;1429;364;1201;80;310;144;444;224;754
410754;201405;980;3023;869;2845;92;337;603;2022;695;2359
410755;201405;766;2102;608;1840;106;380;334;949;440;1329
410760;201405;2521;8279;2407;8058;904;3149;947;3133;1851;6282
410765;201405;16118;48892;12162;40771;3154;11833;2102;6752;5256;18585
410770;201405;936;2680;766;2353;253;845;228;662;481;1507
410773;201405;1256;3870;1121;3636;281;1046;565;1718;846;2764
410775;201405;1847;5485;1762;5346;471;1383;1067;3384;1538;4767
410780;201405;522;1537;400;1315;123;415;158;570;281;985
410785;201405;931;3043;755;2522;267;931;263;876;530;1807
410790;201405;606;1888;507;1659;141;519;115;316;256;835
410800;201405;2550;7069;2101;6296;806;2649;709;2005;1515;4654
410810;201405;308;967;252;838;34;132;114;374;148;506
410820;201405;1086;3329;912;2910;271;914;229;722;500;1636
410830;201405;32006;96692;26578;86891;8313;29673;9428;30539;17741;60212
410832;201405;1180;3585;1073;3395;251;925;535;1574;786;2499
410840;201405;7705;23854;5927;19950;1960;7248;1150;3506;3110;10754
410845;201405;1581;4773;1384;4356;295;1029;732;2269;1027;3298
410850;201405;2837;8476;2541;8034;598;2172;1376;4334;1974;6506
410855;201405;736;2085;614;1831;180;574;229;676;409;1250
410860;201405;3898;11334;3339;10302;769;2484;1668;5283;2437;7767
410865;201405;1690;5891;1532;5577;387;1498;814;3049;1201;4547
410870;201405;1370;4273;1287;4136;660;2262;369;1143;1029;3405
410880;201405;4532;13647;3697;12079;995;3738;925;2671;1920;6409
410890;201405;1119;3479;855;2978;267;1004;113;325;380;1329
410895;201405;1057;3742;953;3503;348;1360;323;1147;671;2507
410900;201405;898;2568;705;2254;151;563;235;710;386;1273
410910;201405;353;1076;313;1006;67;230;162;506;229;736
410920;201405;859;2642;710;2377;214;796;235;734;449;1530
410930;201405;2126;6676;1860;6197;537;2092;738;2385;1275;4477
410940;201405;21364;72621;19104;68332;6081;23654;7951;28713;14032;52367
410950;201405;1909;6384;1740;6067;364;1322;1068;3785;1432;5107
410960;201405;6830;19469;4748;15546;1546;5500;1512;4936;3058;10436
410965;201405;1083;3445;970;3207;323;1120;390;1294;713;2414
410970;201405;5299;16190;4365;14282;1536;5604;1003;3287;2539;8891
410975;201405;1505;4451;1254;4022;230;869;628;2023;858;2892
410980;201405;5234;15487;3450;11701;852;3229;798;2565;1650;5794
410990;201405;1098;3372;816;2763;264;1002;220;650;484;1652
411000;201405;435;1347;296;1012;63;251;44;120;107;371
411005;201405;519;1546;365;1149;114;374;66;178;180;552
411007;201405;2046;6694;1867;6303;538;1917;826;2836;1364;4753
411010;201405;4021;13998;3728;13330;1401;5523;961;3190;2362;8713
411020;201405;2525;8162;2298;7757;781;2932;826;2791;1607;5723
411030;201405;868;2376;735;2129;235;745;221;603;456;1348
411040;201405;430;1383;348;1191;116;427;90;296;206;723
411050;201405;2150;7745;1934;7257;682;2785;349;1209;1031;3994
411060;201405;2111;6761;1840;6165;589;2123;326;1006;915;3129
411065;201405;401;1237;329;1090;69;235;124;391;193;626
411070;201405;4825;15589;3576;12730;1123;4426;531;1711;1654;6137
411080;201405;2042;6382;1844;5951;542;1945;592;1817;1134;3762
411090;201405;642;1644;504;1450;111;385;132;344;243;729
411095;201405;1633;4777;1280;4085;320;1135;353;1073;673;2208
411100;201405;1517;4428;1145;3702;277;1004;269;809;546;1813
411110;201405;953;2906;720;2371;224;775;133;385;357;1160
411120;201405;1766;5581;1544;5116;493;1764;514;1676;1007;3440
411125;201405;4751;15658;4619;15394;1529;5379;2219;7273;3748;12652
411130;201405;798;2445;662;2160;193;636;230;782;423;1418
411140;201405;2104;7637;1820;6914;675;2689;462;1827;1137;4516
411150;201405;6072;17298;4957;15067;1530;5032;1342;3771;2872;8803
411155;201405;1238;3657;1072;3328;362;1234;410;1195;772;2429
411160;201405;313;956;283;899;112;362;93;291;205;653
411170;201405;828;2835;745;2637;239;885;235;833;474;1718
411180;201405;6340;19602;5589;18179;1731;6138;1842;5962;3573;12100
411190;201405;1856;5528;1594;5042;486;1699;497;1512;983;3211
411200;201405;4397;13535;3686;12350;1206;4441;1463;4772;2669;9213
411210;201405;2668;7867;2181;6952;865;2956;412;1292;1277;4248
411220;201405;1198;3487;978;3077;247;908;424;1205;671;2113
411230;201405;1285;3702;834;2737;267;964;199;596;466;1560
411240;201405;1401;3504;851;2638;265;882;229;642;494;1524
411250;201405;3115;8785;2587;7816;781;2441;870;2662;1651;5103
411260;201405;288;815;205;674;59;227;83;253;142;480
411270;201405;2080;6695;1917;6391;606;2238;846;2752;1452;4990
411275;201405;1558;4733;1367;4288;411;1344;406;1213;817;2557
411280;201405;1758;5512;1418;4760;451;1691;235;710;686;2401
411290;201405;1038;2917;874;2592;252;770;314;979;566;1749
411295;201405;1097;3285;1016;3146;244;816;427;1309;671;2125
411300;201405;1130;2996;822;2384;85;279;375;1014;460;1293
411310;201405;861;2497;671;2167;134;501;292;930;426;1431
411320;201405;5764;17750;4654;15527;1373;4834;1251;4050;2624;8884
411325;201405;1572;5086;1419;4795;230;865;911;3075;1141;3940
411330;201405;3611;11901;3260;11253;1264;4729;1022;3470;2286;8199
411340;201405;1006;2978;669;2180;155;564;262;846;417;1410
411342;201405;900;2606;741;2257;219;743;211;566;430;1309
411345;201405;1076;3469;997;3317;304;1094;482;1601;786;2695
411350;201405;2893;8914;2074;7196;665;2540;294;928;959;3468
411360;201405;536;1372;338;983;49;193;145;342;194;535
411370;201405;45280;133000;34925;113053;7855;29805;12539;37287;20394;67092
411373;201405;1472;4687;1244;4225;356;1373;350;1140;706;2513
411375;201405;1100;3142;884;2709;241;786;314;895;555;1681
411380;201405;1291;3512;819;2515;157;514;252;750;409;1264
411390;201405;1847;5724;1642;5395;421;1538;861;2728;1282;4266
411400;201405;1777;5443;1413;4589;347;1271;449;1367;796;2638
411410;201405;2506;7931;2166;7136;724;2699;569;1604;1293;4303
411420;201405;4616;13586;3611;11371;1019;3591;781;2143;1800;5734
411430;201405;2924;9557;2527;8816;776;2940;1087;3713;1863;6653
411435;201405;584;1895;503;1691;128;469;195;634;323;1103
411440;201405;2560;8441;2333;7977;856;3085;731;2600;1587;5685
411450;201405;2121;6563;1945;6268;442;1496;1158;3749;1600;5245
411460;201405;4678;14790;3486;11889;1307;4738;734;2396;2041;7134
411470;201405;932;2908;674;2266;176;655;130;377;306;1032
411480;201405;4813;15004;3897;13179;1650;6032;863;2806;2513;8838
411490;201405;1675;5338;1529;5078;624;2340;413;1250;1037;3590
411500;201405;1591;4700;1173;3858;348;1274;296;934;644;2208
411510;201405;2479;7357;1979;6358;662;2347;453;1308;1115;3655
411520;201405;29001;83540;19783;64124;6507;23155;4366;13501;10873;36656
411530;201405;927;2694;637;2148;247;933;110;310;357;1243
411535;201405;462;1399;234;841;41;177;27;79;68;256
411540;201405;3129;8596;2510;7475;448;1384;1414;4296;1862;5680
411545;201405;1043;3678;966;3529;197;773;632;2334;829;3107
411550;201405;751;2120;608;1877;258;865;141;412;399;1277
411560;201405;2662;8170;2167;6980;641;2239;514;1519;1155;3758
411570;201405;6125;17211;4662;14708;1418;4976;1193;3916;2611;8892
411573;201405;1007;3085;951;2989;208;701;543;1740;751;2441
411575;201405;1483;4845;1293;4417;343;1251;506;1724;849;2975
411580;201405;3735;11233;2777;9246;793;2989;483;1361;1276;4350
411585;201405;493;1721;383;1404;106;416;71;239;177;655
411590;201405;590;1773;529;1650;152;527;172;518;324;1045
411600;201405;373;1149;310;1022;87;339;85;286;172;625
411605;201405;2360;6676;1765;5535;465;1606;721;2195;1186;3801
411610;201405;2303;6768;2143;6502;461;1515;1412;4229;1873;5744
411620;201405;2820;9315;2658;9040;851;3104;1176;4085;2027;7189
411630;201405;722;1928;438;1475;140;550;87;256;227;806
411640;201405;599;1862;504;1660;152;541;197;618;349;1159
411650;201405;187;622;164;576;45;178;56;180;101;358
411660;201405;834;2447;702;2191;185;615;306;964;491;1579
411670;201405;1704;5023;1519;4662;488;1666;566;1644;1054;3310
411680;201405;1741;5385;1531;5026;381;1211;905;3131;1286;4342
411690;201405;3695;11257;3132;10208;1024;3514;932;3102;1956;6616
411695;201405;831;2713;703;2448;151;549;347;1232;498;1781
411700;201405;1863;5503;1418;4672;376;1375;401;1236;777;2611
411705;201405;2274;7859;2001;7326;466;1727;1161;4377;1627;6104
411710;201405;2199;6818;1784;5899;543;1929;449;1355;992;3284
411720;201405;692;2107;538;1735;114;410;144;430;258;840
411721;201405;727;2208;616;1974;189;677;162;462;351;1139
411722;201405;692;2128;560;1846;142;533;161;487;303;1020
411725;201405;1352;4418;927;3357;234;936;220;797;454;1733
411727;201405;2321;6723;1893;5811;473;1576;832;2420;1305;3996
411729;201405;560;1557;435;1353;119;412;142;392;261;804
411730;201405;5687;16947;4882;15412;1838;6096;1650;5221;3488;11317
411740;201405;569;1668;446;1406;110;397;182;541;292;938
411745;201405;902;2856;758;2514;212;739;203;647;415;1386
411750;201405;4629;14594;3583;11984;1132;4190;682;2102;1814;6292
411760;201405;8868;26735;7993;25242;2921;9748;2668;8690;5589;18438
411770;201405;3916;13888;3470;12798;1384;5357;847;3173;2231;8530
411780;201405;3072;10108;2950;9965;410;1263;2192;7873;2602;9136
411790;201405;2531;7418;1916;6197;591;2208;620;1923;1211;4131
411800;201405;1260;3855;854;2872;173;657;152;408;325;1065
411810;201405;1581;4962;1394;4546;403;1503;430;1226;833;2729
411820;201405;16691;52986;14074;48111;5005;17480;4568;16452;9573;33932
411830;201405;430;1181;349;1062;98;286;151;495;249;781
411840;201405;8990;27290;7296;23954;2209;7926;2081;6596;4290;14522
411845;201405;541;1758;421;1473;113;422;88;314;201;736
411850;201405;5917;18255;4950;16248;1318;4682;1482;4810;2800;9492
411860;201405;903;2906;760;2599;218;798;224;725;442;1523
411870;201405;1043;3698;819;3076;153;603;215;788;368;1391
411880;201405;2492;7249;2131;6606;563;1959;901;2768;1464;4727
411885;201405;1465;4103;1196;3670;380;1290;405;1140;785;2430
411890;201405;1357;4230;988;3354;290;1064;208;628;498;1692
411900;201405;948;3096;719;2510;223;796;128;438;351;1234
411910;201405;1231;4268;1071;3899;336;1351;347;1191;683;2542
411915;201405;12103;34838;8099;26402;1986;7173;1984;5923;3970;13096
411920;201405;1055;3729;938;3427;274;1103;216;746;490;1849
411925;201405;622;1826;481;1563;142;485;156;495;298;980
411930;201405;6238;20863;5543;19424;1876;7028;1911;6714;3787;13742
411940;201405;3623;12331;3259;11541;1108;4128;940;3284;2048;7412
411950;201405;9966;32636;8660;30057;2513;9545;4021;13790;6534;23335
411960;201405;5409;16666;5078;16028;1341;4696;2453;7541;3794;12237
411965;201405;573;1746;443;1523;109;423;155;541;264;964
411970;201405;761;2212;613;1967;210;740;180;544;390;1284
411980;201405;2111;5915;1506;4923;279;964;680;2210;959;3174
411990;201405;29622;102669;26014;94877;9469;36843;7565;27919;17034;64762
411995;201405;3107;9920;2819;9323;1172;4140;781;2555;1953;6695
412000;201405;2071;5797;1670;5099;384;1348;728;2014;1112;3362
412010;201405;738;2498;633;2257;179;667;160;545;339;1212
412015;201405;668;2085;543;1807;108;388;286;943;394;1331
412020;201405;432;1281;328;1077;119;419;127;395;246;814
412030;201405;621;1995;418;1485;94;394;118;380;212;774
412033;201405;755;2352;571;1921;149;547;119;356;268;903
412035;201405;993;2891;788;2501;214;757;322;958;536;1715
412040;201405;750;2501;682;2321;256;898;218;733;474;1631
412050;201405;1619;4932;1265;4150;343;1262;271;847;614;2109
412060;201405;6867;24341;6294;23046;1961;7651;2528;9258;4489;16909
412065;201405;998;3095;845;2768;259;958;252;771;511;1729
412070;201405;1160;3324;1023;3027;219;707;417;1211;636;1918
412080;201405;1777;5597;1206;4277;323;1256;136;409;459;1665
412085;201405;314;900;174;593;47;182;49;149;96;331
412090;201405;4906;16233;4697;15844;1031;3682;2987;10215;4018;13897
412100;201405;2208;7058;1957;6612;634;2237;730;2460;1364;4697
412110;201405;1092;3215;788;2565;255;888;244;773;499;1661
412120;201405;2317;8017;2123;7551;582;2293;1004;3434;1586;5727
412125;201405;965;3022;866;2856;253;882;354;1190;607;2072
412130;201405;713;2097;533;1742;125;455;133;407;258;862
412135;201405;556;1612;417;1328;103;373;169;489;272;862
412140;201405;1852;5731;1574;5158;474;1667;467;1531;941;3198
412150;201405;2929;8757;2550;7978;426;1490;1492;4552;1918;6042
412160;201405;1220;3914;940;3219;275;1047;362;1216;637;2263
412170;201405;4505;15145;3872;13875;1332;5089;1446;5139;2778;10228
412175;201405;1454;5119;1316;4809;375;1487;546;2026;921;3513
412180;201405;1760;5658;1390;4987;525;2079;397;1364;922;3443
412190;201405;3102;9386;2544;8447;888;3128;712;2449;1600;5577
412200;201405;2325;7786;1684;6037;405;1596;550;1949;955;3545
412210;201405;755;2174;465;1536;115;426;84;253;199;679
412215;201405;3240;10711;2938;10145;470;1661;1940;6915;2410;8576
412217;201405;1199;3576;1131;3453;226;788;718;2079;944;2867
412220;201405;5802;19438;5564;18973;1780;6346;2966;10163;4746;16509
412230;201405;3037;10415;2674;9655;813;3261;873;3019;1686;6280
412240;201405;9304;24711;5459;17400;1279;4584;911;2618;2190;7202
412250;201405;2205;6806;1974;6320;716;2480;546;1616;1262;4096
412260;201405;1324;3995;910;3086;203;796;285;858;488;1654
412265;201405;1214;3886;1121;3702;285;1097;548;1768;833;2865
412270;201405;802;2666;627;2233;154;611;119;399;273;1010
412280;201405;696;2145;543;1838;252;916;137;430;389;1346
412290;201405;1265;3586;1053;3169;233;786;406;1160;639;1946
412300;201405;1807;5475;1509;4887;487;1768;403;1242;890;3010
412310;201405;1212;3482;1079;3302;204;531;723;2463;927;2994
412320;201405;712;1968;519;1631;137;488;181;557;318;1045
412330;201405;2023;5600;1570;4806;373;1231;742;2260;1115;3491
412340;201405;763;2435;534;1840;107;399;111;362;218;761
412350;201405;2575;8266;2145;7296;722;2618;447;1410;1169;4028
412360;201405;353;1130;289;967;58;215;87;246;145;461
412370;201405;1131;3589;898;3127;323;1190;274;942;597;2132
412380;201405;2032;6213;1756;5606;538;1792;520;1634;1058;3426
412382;201405;726;2100;537;1698;135;472;157;457;292;929
412385;201405;2508;8052;2310;7618;736;2552;853;2807;1589;5359
412390;201405;2453;7415;2254;7069;787;2652;886;2772;1673;5424
412395;201405;975;2760;793;2475;124;398;502;1591;626;1989
412400;201405;1191;3722;1062;3480;336;1147;430;1470;766;2617
412402;201405;2084;6500;1759;5789;568;2035;513;1532;1081;3567
412405;201405;4166;12260;2762;9201;790;2961;356;1075;1146;4036
412410;201405;6376;20884;5775;19655;2495;9260;1294;4335;3789;13595
412420;201405;546;1638;441;1423;145;510;137;375;282;885
412430;201405;470;1404;389;1240;109;379;164;476;273;855
412440;201405;4048;12266;3545;11378;738;2597;1492;5006;2230;7603
412450;201405;366;1176;288;968;61;227;50;127;111;354
412460;201405;997;2857;710;2318;181;697;170;522;351;1219
412470;201405;1828;6326;1644;5873;558;2081;604;2203;1162;4284
412480;201405;1296;3875;941;3093;241;870;179;490;420;1360
412490;201405;1292;3858;1145;3501;329;1065;335;998;664;2063
412500;201405;2064;6214;1768;5624;520;1867;481;1359;1001;3226
412510;201405;2779;9501;2465;8665;779;2943;914;3173;1693;6116
412520;201405;1851;5253;1414;4503;430;1468;496;1541;926;3009
412530;201405;803;2417;678;2136;212;686;198;614;410;1300
412535;201405;458;1401;319;1037;81;291;99;278;180;569
412540;201405;1233;3639;958;3047;186;677;357;1122;543;1799
412545;201405;924;2676;769;2348;155;540;286;782;441;1322
412550;201405;24854;76017;17406;59274;4915;18149;3609;11585;8524;29734
412555;201405;320;1004;237;791;59;214;43;117;102;331
412560;201405;4650;15332;3806;13571;1158;4617;911;2959;2069;7576
412570;201405;4479;13791;3459;11413;1026;3727;777;2470;1803;6197
412575;201405;1059;3354;882;2946;232;874;272;839;504;1713
412580;201405;1492;4138;1090;3421;279;925;351;1038;630;1963
412590;201405;511;1560;406;1361;139;500;120;417;259;917
412600;201405;1522;4878;1321;4468;437;1644;426;1347;863;2991
412610;201405;814;2628;658;2249;239;921;176;517;415;1438
412620;201405;1290;4306;1098;3892;388;1470;263;899;651;2369
412625;201405;13979;40234;11771;36061;4382;14331;2833;8615;7215;22946
412627;201405;1023;3210;726;2549;257;959;87;297;344;1256
412630;201405;3541;11406;3143;10546;906;3260;1025;3316;1931;6576
412635;201405;550;1685;398;1345;103;362;60;182;163;544
412640;201405;851;2593;597;1993;146;526;111;336;257;862
412650;201405;2307;6662;1913;5917;522;1801;675;1889;1197;3690
412660;201405;3095;9439;2587;8384;704;2561;665;2031;1369;4592
412665;201405;735;1990;466;1507;148;528;144;437;292;965
412667;201405;1483;4487;1199;3919;333;1220;327;995;660;2215
412670;201405;670;2121;475;1656;111;447;81;216;192;663
412680;201405;1532;5062;1262;4411;363;1364;352;1108;715;2472
412690;201405;707;2268;578;1978;222;822;112;369;334;1191
412700;201405;1879;6205;1651;5820;629;2449;602;2077;1231;4526
412710;201405;8846;28057;7490;25246;2227;8227;2029;6556;4256;14783
412720;201405;1680;5385;1187;4075;299;1093;149;427;448;1520
412730;201405;2856;8714;1999;6844;658;2421;280;853;938;3274
412740;201405;2169;7167;1923;6591;810;2896;319;1128;1129;4024
412750;201405;3429;11373;3148;10890;576;2318;2111;7109;2687;9427
412760;201405;2348;7906;2247;7727;704;2695;976;3231;1680;5926
412770;201405;12229;36165;8184;27205;1972;7289;1831;5615;3803;12904
412780;201405;1510;5016;1342;4623;418;1546;440;1451;858;2997
412785;201405;2536;7511;1881;6112;514;1836;852;2689;1366;4525
412788;201405;1380;4591;1286;4405;346;1377;521;1636;867;3013
412790;201405;1195;3765;996;3331;256;919;315;980;571;1899
412795;201405;1041;3122;901;2862;305;1033;297;911;602;1944
412796;201405;2648;8567;2459;8169;652;2414;1097;3490;1749;5904
412800;201405;3613;10872;2901;9444;840;2986;907;2815;1747;5801
412810;201405;10512;29913;6489;20901;1735;6084;1523;4496;3258;10580
412820;201405;6513;20112;4926;16922;1485;5566;1098;3826;2583;9392
412830;201405;405;1316;344;1188;100;401;87;253;187;654
412840;201405;2222;6432;1847;5686;539;1822;500;1513;1039;3335
412850;201405;2623;8003;2265;7474;435;1679;1171;3699;1606;5378
412853;201405;1632;4846;1455;4534;202;836;867;2493;1069;3329
412855;201405;1679;4917;1366;4277;436;1559;383;1057;819;2616
412860;201405;1323;4015;1129;3644;295;1081;504;1564;799;2645
412862;201405;852;2357;656;1963;179;584;255;718;434;1302
412863;201405;1229;4221;1182;4138;178;672;826;2872;1004;3544
412865;201405;669;2118;493;1679;105;388;193;669;298;1057
412870;201405;1038;3024;883;2779;303;1017;321;1019;624;2036
412880;201405;1587;4399;1354;4024;417;1351;352;1012;769;2363
420005;201405;523;1601;354;1205;78;294;146;469;224;763
420010;201405;3294;10329;2805;9526;435;1606;1953;6696;2388;8302
420020;201405;772;2584;472;1758;85;375;67;213;152;588
420030;201405;556;1605;326;1152;97;389;63;206;160;595
420040;201405;1000;3138;682;2502;224;915;159;515;383;1430
420050;201405;831;2651;670;2271;195;695;283;928;478;1623
420055;201405;321;1041;225;809;59;226;48;158;107;384
420060;201405;379;1351;292;1120;92;390;38;132;130;522
420070;201405;2047;6545;1720;5730;368;1331;709;2473;1077;3804
420075;201405;200;597;115;390;30;120;35;102;65;222
420080;201405;608;2032;524;1851;192;746;119;402;311;1148
420090;201405;691;2472;541;2116;158;637;106;411;264;1048
420100;201405;1500;4897;1385;4738;356;1242;838;2928;1194;4170
420110;201405;455;1577;413;1479;123;451;194;710;317;1161
420120;201405;339;1197;285;1080;106;444;65;230;171;674
420125;201405;368;1526;348;1480;151;687;106;414;257;1101
420127;201405;604;1887;275;1036;96;382;41;151;137;533
420130;201405;2728;9467;2412;8803;751;3008;905;3085;1656;6093
420140;201405;5217;15462;3674;12465;1058;4028;777;2487;1835;6515
420150;201405;800;2428;556;1863;169;616;164;498;333;1114
420160;201405;302;898;197;656;47;181;44;126;91;307
420165;201405;223;725;151;537;34;138;38;134;72;272
420170;201405;243;805;171;654;69;303;20;56;89;359
420180;201405;477;1533;302;1100;83;319;76;264;159;583
420190;201405;587;1876;374;1390;126;507;63;218;189;725
420195;201405;1439;4205;1156;3812;277;986;587;2003;864;2989
420200;201405;2942;9734;1946;7414;662;2772;353;1221;1015;3993
420205;201405;1080;3645;974;3452;294;1106;439;1561;733;2667
420207;201405;1385;4184;1002;3371;317;1199;300;920;617;2119
420208;201405;504;1529;348;1225;133;515;104;351;237;866
420209;201405;366;1188;230;839;49;182;63;233;112;415
420210;201405;1806;5986;1267;4884;392;1738;189;657;581;2395
420213;201405;884;3290;844;3203;180;711;565;2156;745;2867
420215;201405;524;1727;389;1365;121;455;81;268;202;723
420220;201405;428;1682;401;1620;173;744;101;370;274;1114
420230;201405;4551;14253;3581;12463;907;3540;1817;6207;2724;9747
420240;201405;13155;40098;8899;31586;2120;8949;3562;11531;5682;20480
420243;201405;590;1847;479;1607;121;463;164;534;285;997
420245;201405;1196;3803;857;3094;254;1058;191;597;445;1655
420250;201405;848;2743;793;2653;276;1005;345;1169;621;2174
420253;201405;666;1796;550;1630;134;388;270;891;404;1279
420257;201405;430;1343;328;1145;91;327;154;535;245;862
420260;201405;1376;4646;1236;4379;353;1360;580;2060;933;3420
420270;201405;577;1880;253;940;50;182;33;109;83;291
420280;201405;2449;6973;1616;5465;435;1742;571;1698;1006;3440
420285;201405;159;468;61;227;11;47;1;2;12;49
420287;201405;655;2034;571;1875;150;522;231;758;381;1280
420290;201405;6561;19740;4329;14564;1037;3840;1518;4789;2555;8629
420300;201405;5719;18016;3843;13967;1017;4190;809;2940;1826;7130
420310;201405;884;2707;846;2644;181;602;541;1658;722;2260
420315;201405;967;3217;778;2820;226;916;312;1115;538;2031
420320;201405;4994;15922;4205;14507;1233;4793;1779;5959;3012;10752
420325;201405;465;1510;450;1476;146;523;161;510;307;1033
420330;201405;1307;4627;1034;3862;371;1480;233;768;604;2248
420340;201405;1503;4751;1187;3988;296;1086;344;1102;640;2188
420350;201405;1626;5320;1409;4858;399;1473;633;2207;1032;3680
420360;201405;3815;12351;2890;10208;1095;4241;539;1744;1634;5985
420370;201405;2034;5862;1779;5464;216;689;1425;4358;1641;5047
420380;201405;5458;18620;4666;16741;1537;5930;1343;4803;2880;10733
420390;201405;2126;6435;1324;4714;399;1521;343;1166;742;2687
420395;201405;2071;6531;1592;5445;407;1541;354;1095;761;2636
420400;201405;1511;4569;1139;3840;353;1378;345;1081;698;2459
420410;201405;841;2368;601;1969;155;576;305;978;460;1554
420415;201405;519;1679;415;1411;128;462;145;483;273;945
420417;201405;808;2661;694;2396;150;557;337;1154;487;1711
420419;201405;466;1490;327;1217;144;585;86;319;230;904
420420;201405;15337;47701;12159;41113;3887;14263;4125;13817;8012;28080
420425;201405;1222;3446;766;2476;94;371;319;953;413;1324
420430;201405;4171;13255;2900;10228;906;3483;832;2898;1738;6381
420435;201405;237;783;169;614;63;255;44;149;107;404
420440;201405;1488;4390;916;3177;353;1329;168;523;521;1852
420445;201405;454;1322;352;1140;87;287;176;584;263;871
420450;201405;1296;3873;785;2809;199;809;153;469;352;1278
420455;201405;2290;7163;2056;6756;577;2154;937;2999;1514;5153
420460;201405;9982;31879;8159;28388;2404;9422;3097;10343;5501;19765
420470;201405;1241;3514;841;2742;254;930;249;778;503;1708
420475;201405;183;597;120;440;41;152;31;119;72;271
420480;201405;6129;18457;5100;16657;2090;7583;931;3004;3021;10587
420490;201405;841;2641;612;2209;195;745;159;547;354;1292
420500;201405;2133;6646;1768;5982;537;1941;885;3005;1422;4946
420510;201405;199;841;186;804;77;344;53;213;130;557
420515;201405;162;587;131;513;44;185;22;85;66;270
420517;201405;963;2996;885;2846;157;528;578;1875;735;2403
420519;201405;453;1284;336;1040;67;215;126;401;193;616
420520;201405;791;2287;635;2061;187;663;286;897;473;1560
420530;201405;1399;4882;1139;4225;377;1534;298;986;675;2520
420535;201405;250;776;172;602;55;219;33;97;88;316
420540;201405;18813;57616;14637;48877;5060;18525;4518;14359;9578;32884
420543;201405;496;1369;370;1156;46;164;227;743;273;907
420545;201405;1643;5388;1349;4721;387;1530;440;1447;827;2977
420550;201405;4903;16145;4110;14325;1216;4766;1350;4597;2566;9363
420555;201405;473;1559;398;1394;146;550;122;421;268;971
420560;201405;588;1757;487;1545;90;316;260;825;350;1141
420570;201405;2018;6758;1645;5844;490;1942;524;1769;1014;3711
420580;201405;1188;3989;1006;3658;295;1177;472;1736;767;2913
420590;201405;3379;10776;2497;8729;710;2715;538;1742;1248;4457
420600;201405;945;3310;860;3104;236;917;359;1326;595;2243
420610;201405;629;2076;448;1656;148;594;75;249;223;843
420620;201405;1216;3868;1082;3618;418;1489;292;953;710;2442
420630;201405;1136;3767;892;3129;259;984;284;880;543;1864
420640;201405;663;2156;328;1267;94;420;23;71;117;491
420650;201405;2133;6631;1232;4426;270;1118;230;680;500;1798
420660;201405;681;2041;555;1803;121;440;281;896;402;1336
420665;201405;825;2412;533;1790;111;420;172;505;283;925
420670;201405;1781;5730;1354;4769;362;1418;250;804;612;2222
420675;201405;245;792;179;631;47;191;77;255;124;446
420680;201405;513;1296;317;985;69;239;107;315;176;554
420690;201405;819;2893;598;2269;132;550;180;636;312;1186
420700;201405;4701;14108;3807;12278;1105;4009;1220;3801;2325;7810
420710;201405;802;2910;667;2629;269;1137;191;729;460;1866
420720;201405;1994;6209;1727;5843;466;1648;1017;3452;1483;5100
420730;201405;4727;14949;4138;13849;1463;5229;1605;5319;3068;10548
420740;201405;806;2653;771;2605;168;593;531;1797;699;2390
420750;201405;2489;8266;1805;6565;443;1850;563;1808;1006;3658
420757;201405;123;407;98;367;32;131;28;98;60;229
420760;201405;448;1472;332;1154;73;271;103;343;176;614
420765;201405;642;2191;427;1623;127;527;98;365;225;892
420768;201405;1305;4625;1089;4117;366;1444;409;1580;775;3024
420770;201405;898;2876;601;2191;202;786;163;561;365;1347
420775;201405;707;2289;493;1716;159;567;128;421;287;988
420780;201405;1726;5328;1173;3962;318;1155;329;1039;647;2194
420785;201405;325;1009;227;755;42;155;82;251;124;406
420790;201405;1382;5017;1135;4329;332;1412;456;1641;788;3053
420800;201405;946;2829;575;1968;176;671;135;421;311;1092
420810;201405;2654;9284;2144;8079;771;3226;589;2164;1360;5390
420820;201405;8297;28346;6791;25649;2369;9859;2394;9095;4763;18954
420830;201405;2816;9596;2449;8891;931;3654;882;3108;1813;6762
420840;201405;952;2880;573;2105;155;644;168;573;323;1217
420845;201405;1264;4312;1046;3864;395;1640;216;722;611;2362
420850;201405;2055;6823;1405;5430;513;2148;303;1169;816;3317
420860;201405;691;2041;470;1634;166;652;190;647;356;1299
420870;201405;1420;4154;1127;3733;437;1577;361;1152;798;2729
420880;201405;1482;5027;1228;4362;371;1380;247;834;618;2214
420890;201405;13044;31560;6132;19483;1263;4697;2301;6558;3564;11255
420895;201405;237;662;116;388;40;146;28;89;68;235
420900;201405;2382;6996;1597;5411;455;1670;426;1382;881;3052
420910;201405;24052;74490;16227;57635;4178;16910;4386;14650;8564;31560
420915;201405;674;2657;617;2505;189;769;281;1197;470;1966
420917;201405;426;1321;245;794;57;214;82;216;139;430
420920;201405;206;610;111;390;53;200;15;53;68;253
420930;201405;20461;63119;17616;58054;5558;19947;6533;21502;12091;41449
420940;201405;4503;13956;3900;12628;1166;4213;1212;3558;2378;7771
420945;201405;243;767;159;554;51;196;41;135;92;331
420950;201405;653;1914;319;1192;80;336;59;205;139;541
420960;201405;1480;4665;1277;4299;417;1587;470;1472;887;3059
420970;201405;2752;8714;2427;8191;626;2255;1308;4548;1934;6803
420980;201405;475;1545;392;1393;121;422;193;753;314;1175
420985;201405;600;1808;362;1293;115;450;105;354;220;804
420990;201405;938;2803;643;2274;174;677;186;614;360;1291
421000;201405;685;2465;490;1947;155;661;67;215;222;876
421003;201405;690;2003;299;1046;71;276;52;151;123;427
421005;201405;267;855;221;772;70;264;105;360;175;624
421010;201405;7025;21857;5416;18619;1779;6619;1679;5515;3458;12134
421020;201405;495;1602;376;1364;63;229;210;807;273;1036
421030;201405;1039;3855;964;3664;347;1396;324;1253;671;2649
421040;201405;956;2896;780;2590;249;899;302;934;551;1833
421050;201405;2038;5508;1203;4045;339;1300;364;1116;703;2416
421055;201405;285;927;189;681;56;218;49;150;105;368
421060;201405;568;2086;472;1816;130;543;125;461;255;1004
421070;201405;813;2584;545;1936;149;597;143;505;292;1102
421080;201405;694;2270;626;2122;190;680;295;991;485;1671
421085;201405;568;1567;332;1152;82;308;84;311;166;619
421090;201405;448;1305;325;1025;81;263;147;458;228;721
421100;201405;1064;3316;769;2658;226;843;186;558;412;1401
421105;201405;1490;4843;1292;4476;339;1273;538;1924;877;3197
421110;201405;1657;5492;1442;5123;535;2072;478;1592;1013;3664
421120;201405;1633;5439;1254;4471;304;1246;388;1256;692;2502
421125;201405;448;1378;342;1169;110;414;126;410;236;824
421130;201405;3441;11604;2877;10537;1072;4325;994;3678;2066;8003
421140;201405;434;1383;354;1212;97;370;141;451;238;821
421145;201405;585;1945;444;1562;85;343;193;646;278;989
421150;201405;562;1861;437;1621;118;469;189;700;307;1169
421160;201405;906;2825;630;2232;152;615;208;669;360;1284
421165;201405;331;1185;268;987;65;249;114;420;179;669
421170;201405;1875;6131;1604;5407;451;1600;812;2694;1263;4294
421175;201405;1437;4362;1143;3869;356;1396;412;1278;768;2674
421180;201405;559;1632;338;1143;98;375;125;376;223;751
421185;201405;490;1398;361;1146;73;218;184;607;257;825
421187;201405;329;1040;262;902;83;298;103;337;186;635
421189;201405;540;1654;487;1551;140;475;186;582;326;1057
421190;201405;10724;34404;7997;28642;2427;9272;2366;8429;4793;17701
421200;201405;1095;3707;959;3404;275;1072;348;1190;623;2262
421205;201405;249;797;187;657;46;193;46;135;92;328
421210;201405;2169;6793;1820;5918;622;2123;574;1827;1196;3950
421220;201405;2544;8757;2250;8124;799;3125;678;2435;1477;5560
421223;201405;792;2294;505;1792;143;540;239;839;382;1379
421225;201405;1230;3869;1030;3448;287;1031;423;1406;710;2437
421227;201405;974;3275;871;3115;230;818;511;1896;741;2714
421230;201405;752;2574;682;2403;196;747;252;846;448;1593
421240;201405;573;1929;374;1343;90;338;66;211;156;549
421250;201405;1975;6185;1382;5085;514;2056;376;1362;890;3418
421260;201405;320;972;166;638;51;197;36;131;87;328
421265;201405;318;1100;283;1003;64;242;78;278;142;520
421270;201405;716;1975;444;1508;156;585;99;368;255;953
421280;201405;1655;5304;1356;4841;487;1948;420;1514;907;3462
421290;201405;2084;5950;1334;4449;442;1592;320;962;762;2554
421300;201405;323;1026;281;939;109;411;109;338;218;749
421310;201405;527;1819;457;1628;159;572;121;421;280;993
421315;201405;384;1151;221;800;51;193;35;129;86;322
421320;201405;570;1968;398;1500;84;367;74;222;158;589
421330;201405;656;2310;574;2135;237;994;80;280;317;1274
421335;201405;578;1931;472;1716;129;513;103;380;232;893
421340;201405;1938;6212;1703;5789;462;1749;865;2921;1327;4670
421350;201405;1123;3860;942;3454;317;1300;287;1007;604;2307
421360;201405;3350;10152;2247;7953;545;2191;740;2464;1285;4655
421370;201405;1099;3936;955;3611;329;1366;281;1027;610;2393
421380;201405;1068;3128;876;2752;173;602;439;1371;612;1973
421390;201405;200;657;154;534;26;89;43;163;69;252
421400;201405;418;1590;339;1399;138;604;85;331;223;935
421410;201405;370;1168;301;1023;65;226;153;533;218;759
421415;201405;369;1219;211;814;68;282;62;223;130;505
421420;201405;1454;4562;1117;3739;265;951;257;790;522;1741
421430;201405;307;1027;242;896;81;341;49;176;130;517
421440;201405;860;2613;597;2105;174;667;225;754;399;1421
421450;201405;605;2065;441;1672;160;658;92;333;252;991
421460;201405;730;2323;483;1812;134;556;120;426;254;982
421470;201405;539;1996;461;1824;134;548;192;764;326;1312
421480;201405;3035;9580;2098;7669;694;2836;584;1960;1278;4796
421490;201405;329;1123;196;774;75;322;51;201;126;523
421500;201405;2749;9906;2445;9260;1020;4282;585;2153;1605;6435
421505;201405;409;1422;374;1332;117;439;148;519;265;958
421507;201405;666;2206;508;1826;122;458;197;704;319;1162
421510;201405;306;1159;280;1106;92;416;119;409;211;825
421520;201405;832;2242;545;1653;63;242;288;796;351;1038
421530;201405;524;1764;334;1317;92;410;113;429;205;839
421535;201405;728;2280;454;1679;91;349;232;850;323;1199
421540;201405;425;1266;367;1155;95;332;151;443;246;775
421545;201405;1246;4392;1031;3935;345;1472;229;835;574;2307
421550;201405;2274;7809;2055;7388;725;2881;674;2357;1399;5238
421555;201405;310;981;148;532;30;125;40;133;70;258
421560;201405;205;622;100;355;24;96;23;77;47;173
421565;201405;1105;3529;1008;3360;437;1552;347;1132;784;2684
421567;201405;954;3598;828;3259;398;1608;172;685;570;2293
421568;201405;506;1664;395;1417;114;424;126;449;240;873
421569;201405;208;690;126;486;31;133;29;107;60;240
421570;201405;1158;3898;825;3067;286;1172;211;749;497;1921
421575;201405;614;2104;549;1970;118;453;305;1103;423;1556
421580;201405;4302;14496;3486;12632;1327;5358;876;2905;2203;8263
421590;201405;264;848;214;741;47;173;102;333;149;506
421600;201405;573;1736;430;1429;128;467;108;339;236;806
421605;201405;698;2200;499;1790;134;550;134;455;268;1005
421610;201405;1868;4935;1476;4374;195;632;967;2869;1162;3501
421620;201405;5154;16109;3760;13114;1250;4701;1293;4550;2543;9251
421625;201405;410;1329;249;912;66;271;84;294;150;565
421630;201405;2817;8564;1789;6218;514;1943;396;1308;910;3251
421635;201405;338;1159;263;992;74;307;104;365;178;672
421640;201405;1127;3661;998;3444;207;720;631;2241;838;2961
421650;201405;2370;8057;2063;7342;853;3310;351;1178;1204;4488
421660;201405;9485;32305;7796;28924;2638;10765;2507;8894;5145;19659
421670;201405;1224;4031;923;3338;292;1150;275;997;567;2147
421680;201405;1517;5023;1338;4583;541;1953;273;903;814;2856
421690;201405;2095;7007;1647;5904;476;1844;296;1002;772;2846
421700;201405;728;2306;480;1746;154;619;147;464;301;1083
421710;201405;351;1262;275;1047;109;421;76;281;185;702
421715;201405;322;927;198;668;58;206;60;202;118;408
421720;201405;1879;5829;1409;4919;546;2163;428;1344;974;3507
421725;201405;131;469;126;458;40;159;58;209;98;368
421730;201405;629;1970;347;1281;90;363;77;230;167;593
421740;201405;749;2376;555;1912;168;677;144;407;312;1084
421750;201405;1486;4545;1159;3853;332;1198;447;1367;779;2565
421755;201405;472;1515;344;1187;110;419;98;304;208;723
421760;201405;552;1860;330;1240;90;379;134;487;224;866
421770;201405;3805;11716;3112;10287;1257;4312;877;2996;2134;7308
421775;201405;596;1774;390;1388;87;325;125;437;212;762
421780;201405;1787;6245;1428;5412;562;2301;417;1496;979;3797
421790;201405;1034;2973;655;2317;212;861;163;511;375;1372
421795;201405;410;1272;284;954;49;181;90;304;139;485
421800;201405;2755;9072;2176;7897;635;2559;766;2558;1401;5117
421810;201405;672;2201;504;1801;153;579;97;344;250;923
421820;201405;1217;3892;939;3319;223;937;299;962;522;1899
421825;201405;1409;4820;1301;4555;237;960;749;2532;986;3492
421830;201405;3198;11067;2999;10662;750;2766;1582;5835;2332;8601
421835;201405;190;607;150;537;51;216;68;220;119;436
421840;201405;522;1876;469;1741;168;683;180;640;348;1323
421850;201405;586;1728;431;1450;147;525;143;490;290;1015
421860;201405;398;1298;263;995;62;257;64;236;126;493
421870;201405;5301;15948;3858;12899;1205;4353;792;2572;1997;6925
421875;201405;419;1287;217;811;56;239;54;180;110;419
421880;201405;1130;3738;913;3213;280;1119;245;808;525;1927
421885;201405;363;1267;322;1173;82;292;136;503;218;795
421890;201405;1099;3814;954;3500;336;1354;301;1072;637;2426
421895;201405;441;1508;409;1446;111;394;224;821;335;1215
421900;201405;903;2965;753;2597;215;794;272;860;487;1654
421910;201405;552;1799;398;1429;110;448;115;369;225;817
421915;201405;628;1935;484;1600;109;386;166;511;275;897
421917;201405;601;1910;479;1685;157;648;179;578;336;1226
421920;201405;780;2459;633;2248;291;1105;214;723;505;1828
421930;201405;4120;11803;2868;9492;938;3446;527;1690;1465;5136
421935;201405;909;3215;727;2792;202;857;277;1036;479;1893
421940;201405;348;1260;245;974;82;359;59;209;141;568
421950;201405;4482;12934;2572;8890;799;2959;588;2052;1387;5011
421960;201405;265;866;214;747;57;217;62;208;119;425
421970;201405;2180;6728;1660;5555;610;2257;343;1001;953;3258
421985;201405;486;1357;286;956;55;211;94;318;149;529
422000;201405;420;1226;325;1049;65;237;172;570;237;807
430003;201405;919;2709;735;2389;214;769;238;761;452;1530
430005;201405;307;1042;269;958;56;218;151;513;207;731
430010;201405;2226;6450;1729;5493;541;1790;663;2150;1204;3940
430020;201405;1117;3033;987;2838;232;776;573;1568;805;2344
430030;201405;1538;4291;1350;3934;394;1238;578;1602;972;2840
430040;201405;13082;34358;11158;31324;3454;9955;4574;13044;8028;22999
430045;201405;756;2101;609;1809;113;377;352;1020;465;1397
430047;201405;224;630;162;503;36;107;80;248;116;355
430050;201405;1118;3140;748;2410;155;582;308;939;463;1521
430055;201405;295;872;197;633;42;152;99;312;141;464
430057;201405;80;215;36;124;7;29;10;22;17;51
430060;201405;15786;52043;14058;48933;4201;15268;6923;24641;11124;39909
430063;201405;1105;3324;901;2877;245;797;435;1438;680;2235
430064;201405;1726;5169;1450;4705;407;1345;667;2248;1074;3593
430066;201405;173;443;128;373;27;89;70;193;97;282
430070;201405;627;1952;426;1486;122;461;127;405;249;866
430080;201405;643;2107;515;1814;138;545;153;496;291;1041
430085;201405;704;2017;518;1683;167;614;213;658;380;1272
430087;201405;1013;3112;966;3024;101;346;769;2394;870;2740
430090;201405;806;2188;306;1012;40;154;72;238;112;392
430100;201405;1093;3456;839;2917;300;1149;200;582;500;1731
430105;201405;794;2579;634;2255;209;819;165;554;374;1373
430107;201405;265;897;209;729;45;172;81;269;126;441
430110;201405;2285;6753;2089;6419;699;2290;937;2855;1636;5145
430120;201405;1817;5614;1469;4862;319;1121;870;2846;1189;3967
430130;201405;4625;11934;4192;11331;733;2111;2630;7170;3363;9281
430140;201405;1235;4033;969;3391;303;1095;346;1187;649;2282
430150;201405;948;2577;651;2019;165;548;201;615;366;1163
430155;201405;517;1639;394;1355;91;303;184;648;275;951
430160;201405;18848;56019;17588;53927;3902;12912;10078;31687;13980;44599
430163;201405;1943;5923;1682;5433;383;1359;841;2755;1224;4114
430165;201405;310;1062;250;943;106;418;60;216;166;634
430170;201405;806;2368;391;1368;87;311;81;244;168;555
430175;201405;977;3128;788;2696;177;546;398;1464;575;2010
430180;201405;1151;3165;986;2890;245;793;476;1374;721;2167
430185;201405;775;1947;402;1217;60;199;137;373;197;572
430187;201405;748;2341;649;2145;191;722;234;741;425;1463
430190;201405;2358;7063;2079;6536;530;1904;1024;3203;1554;5107
430192;201405;196;615;103;331;18;63;35;107;53;170
430195;201405;269;827;79;296;13;49;14;43;27;92
430200;201405;1865;6022;1572;5419;503;1849;372;1281;875;3130
430205;201405;528;1565;418;1369;47;178;283;927;330;1105
430210;201405;6569;18950;3749;12776;1047;3849;769;2456;1816;6305
430215;201405;342;1014;261;845;60;206;117;364;177;570
430220;201405;691;1826;339;1130;69;254;60;192;129;446
430222;201405;324;1002;254;850;62;239;109;345;171;584
430223;201405;347;1047;308;985;67;214;204;662;271;876
430225;201405;60;176;36;117;7;19;8;22;15;41
430230;201405;2165;6874;2041;6744;319;923;1628;5584;1947;6507
430235;201405;276;931;222;791;69;267;61;206;130;473
430237;201405;430;1205;357;1072;50;186;235;673;285;859
430240;201405;1145;3439;905;2965;315;1158;288;864;603;2022
430245;201405;926;3071;741;2650;208;776;329;1204;537;1980
430250;201405;1620;4527;1467;4254;606;1801;496;1489;1102;3290
430258;201405;211;597;146;466;20;68;71;231;91;299
430260;201405;856;2437;576;1849;80;302;323;1038;403;1340
430265;201405;328;1050;274;917;81;262;43;133;124;395
430270;201405;3592;10268;3243;9668;802;2710;1689;4949;2491;7659
430280;201405;5432;15589;4689;14187;1349;4356;2100;6303;3449;10659
430290;201405;2514;6993;2394;6864;299;842;1988;5816;2287;6658
430300;201405;10158;31385;8671;28520;3124;10742;3556;12061;6680;22803
430310;201405;8839;28149;7882;26248;2580;9186;3389;11033;5969;20219
430320;201405;856;2569;603;2046;93;276;316;1128;409;1404
430330;201405;1016;2818;860;2521;262;813;353;959;615;1772
430340;201405;774;1980;448;1509;105;403;218;718;323;1121
430350;201405;6349;20403;5456;18422;1960;7002;1988;6589;3948;13591
430355;201405;246;663;158;501;32;119;41;111;73;230
430360;201405;1171;3130;1007;2829;185;579;575;1596;760;2175
430367;201405;350;978;236;767;40;134;72;228;112;362
430370;201405;643;1905;512;1637;181;618;139;409;320;1027
430380;201405;880;2286;492;1576;131;445;179;590;310;1035
430390;201405;4483;13360;3400;11008;894;3181;1039;3207;1933;6388
430400;201405;1354;3269;953;2684;271;854;454;1206;725;2060
430410;201405;710;1944;557;1693;97;330;289;880;386;1210
430420;201405;4698;13823;3817;11795;1142;3620;1574;4884;2716;8504
430430;201405;828;2301;537;1738;173;610;146;450;319;1060
430435;201405;2085;5718;1723;5065;383;1184;948;2803;1331;3987
430440;201405;4886;15283;4022;13523;891;3188;1900;6656;2791;9844
430450;201405;9167;26602;7428;23007;2759;8987;2331;7200;5090;16187
430460;201405;27196;83724;22441;74933;7154;25548;8286;27817;15440;53365
430461;201405;485;1357;170;551;37;134;42;130;79;264
430462;201405;356;1053;291;941;120;429;105;330;225;759
430463;201405;3988;13278;3566;12406;911;3453;1800;6265;2711;9718
430465;201405;666;1827;566;1657;125;414;370;1060;495;1474
430466;201405;4425;13172;4178;12726;1186;3896;2159;6568;3345;10464
430467;201405;602;1854;530;1736;134;481;266;854;400;1335
430468;201405;1500;4402;1308;4098;540;1854;362;1088;902;2942
430469;201405;178;496;56;207;8;33;14;54;22;87
430470;201405;7616;20537;5640;17218;1898;6277;1623;4881;3521;11158
430471;201405;920;3105;825;2896;292;1077;222;781;514;1858
430480;201405;915;2529;504;1654;90;333;114;327;204;660
430485;201405;247;777;138;504;29;97;49;191;78;288
430490;201405;539;1612;379;1303;117;411;133;476;250;887
430495;201405;430;1306;305;1034;70;261;87;289;157;550
430500;201405;1674;4712;1422;4275;431;1393;676;2026;1107;3419
430510;201405;27838;86928;21614;72060;7443;27160;6177;19732;13620;46892
430511;201405;480;1473;256;871;51;178;49;139;100;317
430512;201405;1357;3585;1202;3327;342;954;491;1416;833;2370
430513;201405;699;1973;498;1546;80;259;238;742;318;1001
430515;201405;616;1834;485;1551;101;328;214;706;315;1034
430517;201405;1439;4804;1276;4442;252;932;808;2794;1060;3726
430520;201405;1813;5366;1441;4573;479;1632;564;1725;1043;3357
430530;201405;946;2688;520;1681;111;417;140;399;251;816
430535;201405;2474;8046;2123;7266;590;2250;732;2441;1322;4691
430537;201405;631;1836;445;1523;47;147;344;1210;391;1357
430540;201405;766;1876;581;1631;141;438;333;910;474;1348
430543;201405;610;1612;549;1550;133;395;369;1055;502;1450
430544;201405;750;2493;640;2220;137;525;336;1126;473;1651
430545;201405;1440;4705;1259;4473;399;1386;691;2647;1090;4033
430550;201405;707;2123;495;1678;106;386;211;715;317;1101
430558;201405;122;369;83;282;39;151;11;25;50;176
430560;201405;397;1005;249;735;48;178;108;297;156;475
430570;201405;1230;3228;871;2560;209;712;446;1199;655;1911
430580;201405;1100;3182;769;2518;269;903;213;727;482;1630
430583;201405;154;426;54;179;11;42;5;14;16;56
430585;201405;366;995;243;733;78;265;104;283;182;548
430587;201405;298;933;255;842;106;368;78;254;184;622
430590;201405;1548;4411;1470;4287;349;1118;872;2519;1221;3637
430593;201405;37;145;35;137;12;56;11;34;23;90
430595;201405;229;655;102;370;36;150;13;37;49;187
430597;201405;395;1245;318;1065;60;225;131;419;191;644
430600;201405;2156;6002;1370;4253;316;1046;503;1521;819;2567
430605;201405;1368;4352;1116;3801;282;1052;471;1625;753;2677
430607;201405;713;1976;617;1808;123;391;371;1076;494;1467
430610;201405;8471;23046;6708;20210;1646;5448;3014;9122;4660;14570
430613;201405;254;635;135;398;32;98;45;116;77;214
430620;201405;992;3078;824;2682;240;861;334;1025;574;1886
430630;201405;469;1416;296;984;93;316;58;177;151;493
430632;201405;742;2097;482;1540;91;344;254;754;345;1098
430635;201405;704;1950;500;1552;120;390;241;743;361;1133
430637;201405;553;1592;504;1495;85;303;335;947;420;1250
430640;201405;1976;5672;1052;3503;247;872;213;594;460;1466
430642;201405;480;1290;328;1035;67;225;165;519;232;744
430645;201405;194;581;110;385;27;106;28;91;55;197
430650;201405;2129;7100;1860;6512;396;1410;1052;3820;1448;5230
430655;201405;312;944;275;863;71;241;107;286;178;527
430660;201405;6166;18396;4973;16183;1518;5415;2073;6718;3591;12133
430670;201405;501;1478;455;1387;40;113;348;1097;388;1210
430673;201405;788;1944;447;1368;124;385;185;567;309;952
430675;201405;202;623;127;442;30;122;50;164;80;286
430676;201405;4678;14315;4230;13562;1333;4551;1814;6019;3147;10570
430680;201405;1231;3680;916;2987;208;765;366;1105;574;1870
430690;201405;4579;13425;3824;11952;1221;3966;1484;4744;2705;8710
430692;201405;286;1001;216;848;33;130;128;517;161;647
430693;201405;1808;5142;1367;4160;308;1015;414;1225;722;2240
430695;201405;510;1491;424;1320;86;312;220;644;306;956
430697;201405;470;1350;364;1167;112;346;149;522;261;868
430700;201405;11117;29571;5680;18613;1191;4360;750;2257;1941;6617
430705;201405;414;1319;386;1270;132;462;164;546;296;1008
430710;201405;1890;4977;1499;4324;306;946;775;2325;1081;3271
430720;201405;929;2334;612;1862;177;574;245;780;422;1354
430730;201405;1939;5263;1523;4599;360;1042;837;2675;1197;3717
430740;201405;614;1802;393;1322;134;489;60;175;194;664
430745;201405;549;1604;365;1176;73;240;118;386;191;626
430750;201405;1824;5319;1594;4884;382;1283;825;2443;1207;3726
430755;201405;661;1878;475;1471;102;371;216;606;318;977
430760;201405;3707;9520;2934;8567;659;2078;1617;4904;2276;6982
430770;201405;7048;21333;5988;19488;1460;5225;3019;9710;4479;14935
430780;201405;2615;7499;1794;5821;495;1744;684;2120;1179;3864
430781;201405;664;2000;488;1632;139;489;173;568;312;1057
430783;201405;578;1522;452;1299;97;316;208;554;305;870
430786;201405;126;433;102;364;38;137;19;74;57;211
430790;201405;4006;11302;2722;8623;554;2053;1217;3603;1771;5656
430800;201405;833;2552;627;2051;174;600;209;651;383;1251
430805;201405;482;1403;360;1169;38;126;232;784;270;910
430807;201405;349;1071;282;921;78;308;94;270;172;578
430810;201405;703;1999;375;1275;80;304;71;220;151;524
430820;201405;1091;3536;832;2874;234;853;263;873;497;1726
430825;201405;464;1315;247;782;49;166;78;217;127;383
430830;201405;2736;8100;2542;7798;371;1137;1689;5498;2060;6635
430840;201405;1021;3201;928;3001;239;791;443;1480;682;2271
430843;201405;100;328;75;247;15;49;32;99;47;148
430845;201405;416;1249;344;1113;127;444;49;147;176;591
430850;201405;3406;10481;3042;9804;870;2971;1322;4270;2192;7241
430860;201405;765;2478;590;2075;190;779;153;481;343;1260
430865;201405;740;2043;680;1937;223;662;330;931;553;1593
430870;201405;663;1929;426;1443;139;480;122;403;261;883
430880;201405;1410;4161;1158;3651;461;1513;333;1093;794;2606
430885;201405;181;579;155;535;51;188;49;160;100;348
430890;201405;1697;4549;1310;3863;70;237;821;2388;891;2625
430900;201405;3357;9088;3109;8733;587;1694;2042;5843;2629;7537
430905;201405;1118;3364;798;2641;267;953;220;709;487;1662
430910;201405;1931;6194;1587;5505;587;2176;607;2046;1194;4222
430912;201405;597;1678;466;1462;78;281;260;794;338;1075
430915;201405;409;1442;304;1217;96;407;87;368;183;775
430920;201405;18565;59180;17103;56419;5250;18079;9678;31895;14928;49974
430925;201405;89;259;72;225;19;62;38;121;57;183
430930;201405;9647;30554;7940;27009;2384;8589;3160;11138;5544;19727
430940;201405;1184;3733;937;3215;242;924;291;962;533;1886
430950;201405;1633;4657;1262;3860;399;1294;385;1129;784;2423
430955;201405;115;380;87;302;30;114;24;75;54;189
430957;201405;326;1105;268;975;69;266;121;441;190;707
430960;201405;1828;5286;1590;4868;595;1930;553;1729;1148;3659
430965;201405;1424;4291;1233;3934;145;522;930;2954;1075;3476
430970;201405;544;1582;342;1138;88;320;102;338;190;658
430975;201405;655;2155;503;1777;90;346;272;952;362;1298
430980;201405;563;1385;348;1066;93;331;142;381;235;712
430990;201405;679;2206;519;1796;176;623;132;452;308;1075
430995;201405;737;2212;659;2060;221;722;269;830;490;1552
431000;201405;1767;4841;1021;3275;254;928;152;414;406;1342
431010;201405;2923;8740;2036;6908;553;2066;656;2090;1209;4156
431020;201405;14775;37248;10426;29283;2919;8408;3493;10171;6412;18579
431030;201405;405;1230;233;823;56;204;57;204;113;408
431033;201405;2878;8457;2636;8086;647;2049;1491;4785;2138;6834
431036;201405;231;664;103;349;23;82;30;91;53;173
431040;201405;1053;3089;886;2798;234;814;468;1448;702;2262
431041;201405;597;1675;534;1583;190;578;198;631;388;1209
431043;201405;416;1395;320;1173;153;612;105;349;258;961
431046;201405;121;367;89;289;26;85;33;106;59;191
431050;201405;1907;4868;1566;4321;367;1073;892;2456;1259;3529
431053;201405;644;2148;549;1949;183;703;191;686;374;1389
431055;201405;705;2006;652;1913;82;244;465;1381;547;1625
431057;201405;339;989;209;738;52;194;91;321;143;515
431060;201405;6373;18935;6031;18497;1525;4515;3775;12090;5300;16605
431065;201405;461;1398;432;1341;48;163;293;908;341;1071
431070;201405;774;2283;481;1616;110;389;124;375;234;764
431075;201405;290;887;196;681;36;138;62;217;98;355
431080;201405;715;2325;597;2076;175;647;124;415;299;1062
431085;201405;960;2569;776;2264;140;435;463;1343;603;1778
431087;201405;634;1831;562;1693;78;222;372;1134;450;1356
431090;201405;561;1460;317;991;110;361;67;194;177;555
431100;201405;4828;13566;4084;12241;1200;3770;1715;5276;2915;9046
431110;201405;1657;4477;1258;3669;309;972;631;1796;940;2768
431112;201405;668;2130;641;2086;218;706;312;1029;530;1735
431113;201405;678;2036;515;1664;155;506;157;517;312;1023
431115;201405;1543;4623;1398;4364;306;1013;847;2614;1153;3627
431120;201405;2814;9083;2472;8406;769;2871;1050;3466;1819;6337
431123;201405;540;1700;449;1519;127;460;226;779;353;1239
431125;201405;1441;4465;1109;3758;349;1198;420;1514;769;2712
431127;201405;125;354;67;220;8;25;10;38;18;63
431130;201405;4003;11659;3274;10391;922;3194;1407;4464;2329;7658
431140;201405;4089;10731;2355;7700;498;1894;652;1872;1150;3766
431142;201405;559;1707;508;1611;73;228;328;1070;401;1298
431150;201405;1366;4183;1114;3691;321;1116;421;1407;742;2523
431160;201405;990;2975;854;2687;172;547;431;1445;603;1992
431162;201405;464;1264;236;798;33;134;38;113;71;247
431164;201405;133;364;40;150;15;55;1;4;16;59
431170;201405;981;2888;761;2446;263;863;229;741;492;1604
431171;201405;905;2737;789;2492;294;977;195;583;489;1560
431173;201405;499;1514;462;1447;106;342;279;885;385;1227
431175;201405;1323;3698;1151;3441;371;1172;489;1465;860;2637
431177;201405;1003;3350;907;3130;300;1136;397;1357;697;2493
431179;201405;143;375;85;262;20;72;25;61;45;133
431180;201405;2767;8371;2208;7096;625;2161;700;2148;1325;4309
431190;201405;785;2198;470;1561;133;495;154;504;287;999
431198;201405;385;1283;337;1183;165;623;71;240;236;863
431200;201405;326;942;119;401;28;100;14;42;42;142
431205;201405;328;1090;235;824;56;202;94;315;150;517
431210;201405;800;2278;692;2062;177;538;377;1130;554;1668
431213;201405;318;1000;267;900;80;300;97;314;177;614
431215;201405;343;1017;178;601;35;116;22;62;57;178
431217;201405;247;749;193;628;63;222;54;182;117;404
431220;201405;1219;3167;880;2514;134;445;465;1264;599;1709
431225;201405;1411;4211;1225;3888;297;1002;667;2135;964;3137
431230;201405;964;2899;758;2473;122;430;420;1385;542;1815
431235;201405;76;183;36;110;9;30;12;35;21;65
431237;201405;461;1507;407;1430;115;464;192;652;307;1116
431238;201405;54;171;44;146;10;36;14;45;24;81
431240;201405;2837;8749;2429;8043;874;3132;753;2445;1627;5577
431242;201405;435;1419;412;1374;181;649;54;176;235;825
431244;201405;472;1159;341;961;78;265;159;412;237;677
431245;201405;1096;3052;955;2825;175;548;625;1854;800;2402
431247;201405;219;695;181;620;72;268;65;211;137;479
431250;201405;1934;6153;1728;5843;549;1996;738;2563;1287;4559
431260;201405;402;1178;281;936;79;303;72;217;151;520
431261;201405;227;810;195;737;46;191;59;228;105;419
431262;201405;366;1024;156;538;28;122;64;215;92;337
431265;201405;1388;3769;841;2598;204;729;260;682;464;1411
431267;201405;205;630;171;564;52;192;75;231;127;423
431270;201405;2645;7175;2101;6359;614;1973;968;2988;1582;4961
431275;201405;220;733;147;529;44;157;30;94;74;251
431280;201405;201;621;115;391;23;89;27;74;50;163
431290;201405;366;1197;287;989;82;327;69;224;151;551
431295;201405;225;722;133;455;26;99;34;97;60;196
431300;201405;226;691;96;370;30;121;9;34;39;155
431301;201405;254;831;179;636;49;181;41;131;90;312
431303;201405;752;2038;537;1610;130;461;197;553;327;1014
431306;201405;2175;6189;1713;5314;335;1246;610;1708;945;2954
431308;201405;57;198;53;187;33;115;16;59;49;174
431310;201405;770;2469;567;2010;119;459;221;800;340;1259
431320;201405;924;2719;585;2029;173;674;150;490;323;1164
431330;201405;2353;6074;1211;3883;366;1270;215;679;581;1949
431333;201405;396;1084;205;629;39;132;68;179;107;311
431335;201405;100;294;84;258;20;54;32;96;52;150
431337;201405;2684;8310;2098;7006;590;2049;586;1949;1176;3998
431339;201405;646;1872;500;1541;110;357;236;721;346;1078
431340;201405;28278;76456;20862;63660;5301;17850;7849;23428;13150;41278
431342;201405;648;1713;548;1542;158;467;295;809;453;1276
431344;201405;386;1079;299;925;31;101;187;590;218;691
431346;201405;333;888;197;584;59;175;58;172;117;347
431349;201405;647;1884;475;1478;99;312;162;499;261;811
431350;201405;4022;12224;3578;11419;704;2582;2065;6391;2769;8973
431360;201405;828;2248;631;1925;177;577;252;778;429;1355
431365;201405;1423;4385;1248;4094;471;1654;504;1670;975;3324
431370;201405;5664;16445;4774;14928;1416;4700;2024;6430;3440;11130
431380;201405;1140;3480;1074;3338;181;600;748;2291;929;2891
431390;201405;3787;10882;2628;8599;820;3000;793;2424;1613;5424
431395;201405;1631;4935;1466;4666;438;1479;611;1956;1049;3435
431400;201405;203;671;136;520;43;182;13;35;56;217
431402;201405;1251;3159;801;2339;160;488;393;1125;553;1613
431403;201405;328;985;250;843;86;315;63;218;149;533
431405;201405;4741;13652;3808;12230;908;3422;1825;5609;2733;9031
431406;201405;823;2612;646;2179;217;747;257;855;474;1602
431407;201405;649;1994;474;1584;153;526;119;372;272;898
431410;201405;17219;53721;13930;47182;5243;18921;3657;12963;8900;31884
431413;201405;211;520;103;320;12;41;45;133;57;174
431415;201405;949;2730;781;2412;195;656;363;1071;558;1727
431417;201405;699;1800;563;1594;100;291;306;897;406;1188
431420;201405;1639;4591;1448;4279;332;1019;812;2488;1144;3507
431430;201405;612;1698;454;1424;119;408;169;497;288;905
431440;201405;33372;98509;29891;92724;9625;30745;13829;44872;23454;75617
431442;201405;210;679;169;578;62;233;23;58;85;291
431445;201405;529;1460;353;1079;64;207;140;415;204;622
431446;201405;514;1522;378;1232;89;297;171;561;260;858
431447;201405;859;2459;616;1910;136;446;279;885;415;1331
431449;201405;949;2710;776;2411;127;436;421;1331;548;1767
431450;201405;2324;6178;2137;5886;496;1432;1363;3735;1859;5167
431455;201405;668;1743;418;1211;133;405;120;321;253;726
431460;201405;3727;10623;3222;9640;951;2933;1243;3803;2194;6736
431470;201405;1983;5914;1598;5050;435;1358;715;2372;1150;3730
431475;201405;163;483;60;237;14;59;5;23;19;82
431477;201405;660;1863;512;1580;99;339;284;846;383;1185
431478;201405;201;535;95;284;22;65;37;109;59;174
431480;201405;2850;8395;2272;7321;741;2612;775;2426;1516;5038
431490;201405;113876;324927;100537;304818;17715;60694;66793;199466;84508;260160
431500;201405;1197;3147;967;2715;285;791;366;1046;651;1837
431505;201405;401;1116;360;1053;37;101;292;870;329;971
431507;201405;464;1150;372;978;71;182;232;620;303;802
431510;201405;2255;6283;1878;5614;383;1248;975;2835;1358;4083
431513;201405;235;657;119;384;24;79;60;197;84;276
431514;201405;113;291;43;139;9;33;4;9;13;42
431515;201405;771;2322;562;1796;125;449;255;742;380;1191
431517;201405;94;310;87;293;40;144;24;71;64;215
431520;201405;495;1493;317;1051;72;262;81;260;153;522
431530;201405;4721;11610;3681;10401;1047;2953;1947;5847;2994;8800
431531;201405;296;855;208;677;55;189;82;273;137;462
431532;201405;570;1636;507;1503;170;539;188;553;358;1092
431535;201405;391;1165;280;879;68;236;79;225;147;461
431540;201405;2289;7379;2053;7038;303;961;1360;4991;1663;5952
431545;201405;163;469;64;229;8;32;12;51;20;83
431550;201405;2511;7626;2313;7263;557;1961;1150;3571;1707;5532
431555;201405;798;2119;702;1978;164;456;381;1090;545;1546
431560;201405;24737;77750;21145;70368;8405;28196;6968;24388;15373;52584
431570;201405;5779;16617;5224;15768;1588;4833;2875;8839;4463;13672
431575;201405;489;1321;351;1084;67;244;117;335;184;579
431580;201405;767;2441;621;2094;178;672;219;677;397;1349
431590;201405;1021;2875;709;2236;102;338;353;1110;455;1448
431595;201405;641;1825;526;1568;142;448;192;569;334;1017
431600;201405;2314;6947;1748;5753;497;1847;366;1044;863;2891
431610;201405;1747;4992;1293;4141;303;1019;637;2056;940;3075
431620;201405;411;1313;260;858;86;301;105;314;191;615
431630;201405;1472;4035;1117;3297;294;899;556;1664;850;2563
431640;201405;6236;18688;5680;17789;1441;4944;3167;9804;4608;14748
431642;201405;541;1601;465;1448;77;278;257;772;334;1050
431643;201405;225;605;192;545;30;101;116;307;146;408
431645;201405;1842;5606;1687;5331;389;1259;975;3159;1364;4418
431647;201405;182;522;129;395;43;136;31;78;74;214
431650;201405;255;813;180;652;38;159;43;134;81;293
431660;201405;1511;4609;1175;3875;377;1293;437;1390;814;2683
431670;201405;1425;3994;1147;3490;315;1063;514;1512;829;2575
431673;201405;242;718;156;529;44;160;41;135;85;295
431675;201405;328;1081;240;823;60;211;68;205;128;416
431680;201405;10846;30386;8374;26062;2539;8492;3066;9669;5605;18161
431690;201405;26489;76846;21751;69312;6786;23099;8888;28848;15674;51947
431695;201405;153;522;114;421;25;98;30;84;55;182
431697;201405;527;1501;470;1394;136;406;209;648;345;1054
431700;201405;1699;4821;1459;4359;288;942;785;2288;1073;3230
431710;201405;13411;39726;11141;35781;3366;11248;4453;14857;7819;26105
431720;201405;7387;21085;6135;18699;1404;4817;3152;9418;4556;14235
431725;201405;35;124;33;120;15;56;11;41;26;97
431730;201405;3911;12185;3220;10846;947;3503;1122;3858;2069;7361
431740;201405;6116;18142;5420;16816;2013;6725;1580;4722;3593;11447
431750;201405;10758;30931;9263;28487;1984;6600;4967;15610;6951;22210
431755;201405;276;729;81;282;19;73;13;37;32;110
431760;201405;4162;12721;3484;11406;990;3543;1111;3498;2101;7041
431770;201405;2399;6611;2031;6023;514;1587;1078;3185;1592;4772
431775;201405;257;733;201;629;81;265;54;151;135;416
431780;201405;2409;6508;1846;5455;519;1657;569;1600;1088;3257
431790;201405;1227;3898;1096;3665;279;992;581;1934;860;2926
431795;201405;497;1483;391;1235;82;280;195;620;277;900
431800;201405;9877;29464;8324;26553;2836;9785;2554;8002;5390;17787
431805;201405;311;756;89;301;14;57;18;58;32;115
431810;201405;3705;10397;3079;9101;673;2097;1488;4367;2161;6464
431820;201405;2915;9257;2582;8606;753;2709;1008;3310;1761;6019
431830;201405;11672;30622;9629;27465;3164;9675;3816;11022;6980;20697
431840;201405;3662;11005;3240;10197;981;3176;1490;4799;2471;7975
431842;201405;778;2021;447;1365;93;313;145;419;238;732
431843;201405;367;1076;332;1015;70;240;197;590;267;830
431844;201405;170;513;132;441;38;146;44;138;82;284
431845;201405;554;1690;506;1587;61;198;339;1080;400;1278
431846;201405;547;1643;470;1505;91;329;278;892;369;1221
431848;201405;203;560;110;373;23;92;23;73;46;165
431849;201405;397;989;120;374;28;92;34;91;62;183
431850;201405;5059;15055;4525;14032;1075;3619;2296;6986;3371;10605
431860;201405;988;2800;806;2501;171;599;434;1291;605;1890
431861;201405;100;308;62;214;14;45;7;20;21;65
431862;201405;504;1715;418;1524;154;615;110;375;264;990
431870;201405;26847;76609;22550;68894;6281;20967;9836;29373;16117;50340
431880;201405;4931;15699;4133;13865;1216;4443;1712;5588;2928;10031
431890;201405;6203;17562;5205;15773;1983;6283;1730;5402;3713;11685
431900;201405;993;3065;793;2674;232;881;313;953;545;1834
431910;201405;1000;2387;489;1423;106;347;195;518;301;865
431912;201405;625;1838;497;1576;160;489;175;585;335;1074
431915;201405;1422;3930;1077;3301;287;938;424;1316;711;2254
431920;201405;1559;4422;1432;4246;198;542;1108;3381;1306;3923
431930;201405;1366;3799;1058;3298;168;496;630;2099;798;2595
431935;201405;115;435;106;414;47;206;29;93;76;299
431936;201405;491;1421;442;1327;67;191;291;948;358;1139
431937;201405;355;970;209;652;58;197;41;113;99;310
431940;201405;2847;7896;1922;6070;527;1772;567;1771;1094;3543
431950;201405;1977;6353;1769;5970;505;1853;730;2368;1235;4221
431960;201405;3784;11309;3473;10704;1082;3521;1264;3922;2346;7443
431970;201405;526;1456;285;932;50;184;88;276;138;460
431971;201405;135;400;114;372;30;101;51;163;81;264
431973;201405;486;1721;430;1603;66;236;253;1019;319;1255
431975;201405;16;63;12;52;4;21;4;14;8;35
431980;201405;1584;4641;1403;4264;368;1260;580;1650;948;2910
431990;201405;8995;25248;7136;22240;1602;5707;3028;9012;4630;14719
432000;201405;11479;33941;9454;30326;2997;10100;4106;13237;7103;23337
432010;201405;2570;7681;2235;7040;522;1874;1097;3343;1619;5217
432020;201405;2345;6063;1973;5563;312;942;1328;3729;1640;4671
432023;201405;550;1605;418;1312;106;372;163;473;269;845
432026;201405;1238;3893;1038;3436;221;753;524;1751;745;2504
432030;201405;427;1275;360;1126;97;309;154;465;251;774
432032;201405;563;1504;387;1173;74;253;212;619;286;872
432035;201405;878;2825;794;2658;186;655;465;1545;651;2200
432040;201405;870;2403;562;1849;153;548;133;346;286;894
432045;201405;207;698;176;636;49;186;71;265;120;451
432050;201405;811;2374;729;2219;141;453;428;1330;569;1783
432055;201405;856;2669;733;2420;159;583;441;1407;600;1990
432057;201405;472;1247;374;1058;44;150;239;630;283;780
432060;201405;476;1352;210;731;58;228;52;165;110;393
432065;201405;249;727;192;621;48;169;89;267;137;436
432067;201405;1039;3374;777;2764;210;767;370;1317;580;2084
432070;201405;2693;7316;1992;5941;618;2057;669;1910;1287;3967
432080;201405;4391;12897;3849;11897;1197;3921;1639;4979;2836;8900
432085;201405;272;870;230;797;79;313;80;263;159;576
432090;201405;1820;5669;1554;5099;597;2118;499;1464;1096;3582
432100;201405;1273;3790;721;2501;191;690;133;396;324;1086
432110;201405;3162;9593;2549;8310;855;3074;507;1586;1362;4660
432120;201405;5529;16852;4786;15467;1768;6112;1572;5074;3340;11186
432130;201405;2466;7265;2147;6835;553;1916;1229;3948;1782;5864
432132;201405;429;1352;259;921;48;185;97;305;145;490
432135;201405;802;2433;760;2360;123;400;528;1639;651;2039
432140;201405;2977;8809;2428;7791;694;2281;977;3438;1671;5719
432143;201405;1426;4353;1236;4033;295;983;702;2363;997;3346
432145;201405;1153;3680;797;2837;271;1044;165;527;436;1571
432146;201405;282;895;204;702;73;267;55;181;128;448
432147;201405;847;2692;681;2326;198;689;278;973;476;1662
432149;201405;424;1268;299;966;96;327;100;310;196;637
432150;201405;3920;11508;3068;9860;994;3464;1014;3136;2008;6600
432160;201405;4762;15554;4281;14738;1497;5358;1745;6296;3242;11654
432162;201405;344;851;97;314;28;101;23;62;51;163
432163;201405;369;980;105;338;16;50;22;76;38;126
432166;201405;830;2493;680;2176;148;541;325;961;473;1502
432170;201405;880;2959;635;2403;146;595;140;502;286;1097
432180;201405;2924;7840;2100;6452;635;2091;645;1940;1280;4031
432183;201405;462;1501;389;1348;165;586;95;333;260;919
432185;201405;890;2580;603;1977;137;507;236;752;373;1259
432190;201405;3650;10228;2722;8149;761;2398;879;2483;1640;4881
432195;201405;1316;3783;1181;3572;205;671;750;2248;955;2919
432200;201405;3291;10246;2715;9217;772;2810;1269;4411;2041;7221
432210;201405;449;1336;388;1243;110;409;192;567;302;976
432215;201405;911;2866;813;2699;152;476;506;1780;658;2256
432218;201405;330;920;253;771;50;164;116;327;166;491
432220;201405;4060;10993;3384;9895;450;1559;2227;6397;2677;7956
432225;201405;67;223;56;202;27;101;13;47;40;148
432230;201405;1223;3453;894;2748;274;922;362;1009;636;1931
432232;201405;592;1753;468;1511;109;400;230;730;339;1130
432234;201405;551;1550;421;1226;104;309;181;502;285;811
432235;201405;76;237;46;164;15;66;7;23;22;89
432237;201405;511;1427;463;1352;35;140;367;1036;402;1176
432240;201405;16103;53546;14096;50838;3202;12697;8448;31153;11650;43850
432250;201405;5697;20070;5376;19402;2333;9073;1542;5642;3875;14715
432252;201405;488;1462;410;1308;129;437;185;600;314;1037
432253;201405;1313;4348;991;3508;330;1224;327;1173;657;2397
432254;201405;671;1841;212;699;49;179;30;89;79;268
432255;201405;220;553;123;400;41;145;37;115;78;260
432260;201405;7439;19213;5335;15696;1290;3998;2448;7299;3738;11297
432270;201405;2819;8753;2469;8141;723;2431;1178;3964;1901;6395
432280;201405;1327;3876;823;2773;191;724;197;587;388;1311
432285;201405;155;498;71;244;23;86;12;32;35;118
432290;201405;612;1878;416;1410;98;367;160;520;258;887
432300;201405;24373;75257;22277;71625;5740;19631;12160;39137;17900;58768
432310;201405;1012;3164;878;2916;194;721;466;1510;660;2231
432320;201405;284;803;182;593;53;174;62;204;115;378
432330;201405;263;754;107;379;19;67;13;40;32;107
432335;201405;208;611;92;324;28;106;10;31;38;137
432340;201405;311;815;160;497;40;127;48;144;88;271
432345;201405;781;2244;723;2152;166;580;396;1102;562;1682
432350;201405;478;1354;324;1060;89;308;85;261;174;569
432360;201405;48;156;37;133;13;51;13;42;26;93
432370;201405;492;1407;399;1222;38;115;270;847;308;962
432375;201405;897;2314;721;2022;129;375;431;1226;560;1601
432377;201405;82;281;41;135;10;39;13;30;23;69
432380;201405;890;3175;829;3043;339;1389;314;1080;653;2469
500020;201405;2087;6631;1583;5597;457;1819;530;1744;987;3563
500025;201405;1038;2639;670;1992;132;401;315;923;447;1324
500060;201405;6442;18992;5251;17117;731;2359;3592;12197;4323;14556
500070;201405;4154;12434;3547;11382;854;3084;1715;5429;2569;8513
500080;201405;1814;5394;1365;4578;465;1693;432;1500;897;3193
500085;201405;2161;5862;1630;5048;216;750;1005;3014;1221;3764
500090;201405;2469;7292;1901;6262;411;1409;976;3311;1387;4720
500100;201405;2573;7886;2394;7598;785;2822;1114;3375;1899;6197
500110;201405;8294;24603;6862;22436;1134;4026;4031;13843;5165;17869
500124;201405;1917;6247;1660;5812;287;972;1016;3832;1303;4804
500150;201405;1517;3971;1194;3463;287;932;598;1648;885;2580
500190;201405;5031;13446;3984;12148;915;2977;2217;7015;3132;9992
500200;201405;2652;6820;1965;5833;374;1258;1145;3314;1519;4572
500210;201405;4984;15021;4301;13957;1024;3479;2207;7365;3231;10844
500215;201405;1610;5083;1339;4552;287;1110;571;1835;858;2945
500220;201405;2814;8944;2321;8009;584;2170;901;3187;1485;5357
500230;201405;2666;7093;2085;6213;675;2159;830;2503;1505;4662
500240;201405;5008;15537;3763;13055;741;2791;1664;6076;2405;8867
500260;201405;2559;7003;2080;6224;409;1357;1045;2948;1454;4305
500270;201405;110716;292736;75653;232674;22152;74016;20231;62299;42383;136315
500280;201405;1390;4058;1185;3770;204;685;781;2549;985;3234
500290;201405;4030;10366;2645;8030;814;2839;827;2282;1641;5121
500295;201405;2547;7932;1862;6230;466;1771;531;1594;997;3365
500310;201405;841;2269;733;2108;171;540;369;1027;540;1567
500315;201405;3038;9703;2635;9119;539;1826;1674;6102;2213;7928
500320;201405;14023;47193;12344;44156;4004;15019;4900;18609;8904;33628
500325;201405;4323;11521;3288;9851;884;2920;1556;4531;2440;7451
500330;201405;5928;16551;4689;14242;1408;4573;1977;5956;3385;10529
500345;201405;2473;7292;2089;6656;532;1871;1056;3274;1588;5145
500348;201405;2556;7455;2287;7010;254;878;1691;5163;1945;6041
500350;201405;1240;3805;802;2808;145;539;241;860;386;1399
500370;201405;23964;75329;18961;65573;4984;19125;6880;23961;11864;43086
500375;201405;2799;7721;2067;6383;515;1706;898;2845;1413;4551
500380;201405;3000;8763;2550;7926;887;2905;836;2554;1723;5459
500390;201405;601;1309;400;1024;48;150;284;691;332;841
500400;201405;1359;4306;1087;3647;307;1151;324;995;631;2146
500410;201405;2159;6141;1760;5550;460;1586;842;2656;1302;4242
500430;201405;2735;8195;2231;7453;550;1980;1041;3606;1591;5586
500440;201405;1358;4006;1157;3679;273;972;615;1907;888;2879
500450;201405;2189;6875;1745;5974;466;1797;379;1174;845;2971
500460;201405;3685;11310;2986;10203;888;3292;1063;3631;1951;6923
500470;201405;3139;9411;2309;7579;692;2438;412;1237;1104;3675
500480;201405;2057;6633;1908;6410;198;668;1513;5234;1711;5902
500490;201405;1097;3140;914;2828;293;1002;323;1010;616;2012
500500;201405;3623;11286;2934;10253;1080;4240;974;3384;2054;7624
500510;201405;890;2420;610;1942;125;468;263;772;388;1240
500515;201405;1937;5242;1563;4734;256;720;1001;3270;1257;3990
500520;201405;2863;10044;2563;9624;541;2144;1582;6163;2123;8307
500525;201405;1210;3916;1034;3567;238;873;537;1945;775;2818
500540;201405;5424;15937;3513;12112;1098;4301;764;2449;1862;6750
500560;201405;4804;16053;4338;15370;854;3200;2931;10534;3785;13734
500568;201405;3986;10525;2994;9047;738;2323;1491;4581;2229;6904
500570;201405;7666;21498;5582;17816;1685;5769;2170;7001;3855;12770
500580;201405;3548;10457;2843;9208;441;1556;1836;5952;2277;7508
500600;201405;3182;8935;2391;7556;643;2243;979;3053;1622;5296
500620;201405;8045;22724;5962;19163;1320;4791;3063;9831;4383;14622
500625;201405;721;2167;483;1660;119;447;161;524;280;971
500627;201405;427;1227;322;1021;67;217;95;327;162;544
500630;201405;6248;17710;5038;15937;1718;5949;1672;5287;3390;11236
500635;201405;2441;9493;2113;8987;325;1316;1367;6306;1692;7622
500640;201405;1577;3969;1263;3518;147;466;907;2469;1054;2935
500660;201405;16745;50465;13699;45203;3581;13212;6116;20075;9697;33287
500690;201405;3060;8817;2506;8127;866;2866;1041;3637;1907;6503
500710;201405;3694;11414;3325;10803;845;2965;1752;5700;2597;8665
500720;201405;5883;16221;3924;12614;1159;4086;1180;3704;2339;7790
500730;201405;984;2879;781;2461;177;616;324;983;501;1599
500740;201405;3739;10575;2748;8759;619;2246;1241;3746;1860;5992
500750;201405;845;2502;770;2407;185;597;460;1487;645;2084
500755;201405;1284;3824;973;3215;250;916;355;1090;605;2006
500769;201405;4771;13043;3209;9877;728;2479;1006;2807;1734;5286
500770;201405;1749;5291;1377;4563;421;1478;486;1635;907;3113
500780;201405;1106;3482;968;3210;288;1054;432;1377;720;2431
500790;201405;8833;25270;7446;22834;1462;5247;4143;12152;5605;17399
500793;201405;2374;6950;1909;6173;338;1216;971;3045;1309;4261
500795;201405;2412;7269;2161;6902;283;773;1623;5520;1906;6293
500797;201405;941;2591;723;2237;161;538;332;1025;493;1563
500800;201405;2569;7394;2081;6687;721;2602;810;2631;1531;5233
500830;201405;16524;48806;12294;40147;3658;12876;3799;12155;7457;25031
500840;201405;1405;4120;1072;3460;213;744;499;1598;712;2342
510010;201405;1332;4165;1207;3942;390;1329;553;1852;943;3181
510020;201405;2947;8689;2124;7115;624;2201;623;2032;1247;4233
510025;201405;9297;28186;8070;26066;2397;8535;3512;11096;5909;19631
510030;201405;2147;5894;1811;5381;549;1701;828;2453;1377;4154
510035;201405;915;2718;764;2484;149;493;445;1512;594;2005
510040;201405;1717;4848;1371;4328;303;1076;711;2234;1014;3310
510050;201405;1868;5507;1391;4630;376;1373;541;1777;917;3150
510060;201405;1287;3854;1010;3318;275;962;351;1131;626;2093
510080;201405;1318;4098;1102;3724;336;1305;366;1140;702;2445
510100;201405;664;1814;451;1378;95;313;169;484;264;797
510120;201405;297;621;192;500;21;54;138;356;159;410
510125;201405;3132;8390;2470;7238;499;1780;1181;3260;1680;5040
510130;201405;2127;5943;1823;5462;536;1692;799;2438;1335;4130
510140;201405;2943;9704;2466;8953;930;3648;734;2600;1664;6248
510160;201405;1314;4449;1248;4368;90;355;1068;3744;1158;4099
510170;201405;6049;18872;5144;17194;1200;4465;2545;8283;3745;12748
510180;201405;11271;31203;8490;26667;2580;8542;3225;11021;5805;19563
510185;201405;1227;4019;1130;3870;202;658;793;2862;995;3520
510190;201405;1803;5982;1397;5300;352;1446;595;2362;947;3808
510250;201405;13787;44003;12003;41502;3706;13573;5812;20697;9518;34270
510260;201405;2569;9822;2337;9316;713;2989;1036;4348;1749;7337
510263;201405;4234;11949;3234;10249;969;3343;1128;3453;2097;6796
510267;201405;5367;15693;3926;12578;940;3278;1376;4261;2316;7539
510268;201405;874;2581;749;2399;204;710;391;1250;595;1960
510269;201405;826;2655;754;2548;225;781;360;1257;585;2038
510270;201405;2542;8017;2295;7604;412;1431;1378;4721;1790;6152
510279;201405;2068;6656;1892;6361;658;2462;706;2211;1364;4673
510285;201405;1496;4618;1262;4194;371;1330;460;1457;831;2787
510300;201405;3234;9908;2846;9360;364;1298;2134;7066;2498;8364
510305;201405;1633;5261;1348;4713;409;1545;423;1475;832;3020
510310;201405;1106;3215;875;2836;312;1108;290;907;602;2015
510320;201405;3638;10836;2839;9223;841;3187;606;1744;1447;4931
510325;201405;5456;17652;4774;16673;547;1820;3746;13552;4293;15372
510330;201405;2739;9141;2374;8462;627;2449;974;3552;1601;6001
510335;201405;4428;14232;3949;13585;642;2147;2853;10250;3495;12397
510336;201405;576;1791;490;1627;123;445;239;784;362;1229
510337;201405;2290;7701;1990;7114;794;2852;626;2455;1420;5307
510340;201405;63132;187063;50638;167901;20131;72470;11900;41700;32031;114170
510343;201405;1145;3451;1047;3333;114;350;860;2808;974;3158
510345;201405;1678;5025;1426;4575;371;1306;535;1619;906;2925
510350;201405;3512;10226;2894;9367;779;2724;1444;4757;2223;7481
510360;201405;1876;4998;1373;4371;252;877;917;2865;1169;3742
510370;201405;934;3396;838;3237;236;935;458;1835;694;2770
510380;201405;487;1582;385;1374;156;611;69;228;225;839
510385;201405;946;3551;764;3093;153;662;350;1518;503;2180
510390;201405;1177;3657;1085;3553;267;777;673;2395;940;3172
510395;201405;873;2245;660;1967;116;375;377;1184;493;1559
510410;201405;4170;13856;3925;13413;1101;3976;2038;7062;3139;11038
510420;201405;2317;6153;1786;5254;277;962;960;2806;1237;3768
510450;201405;586;1643;443;1437;125;458;174;547;299;1005
510452;201405;632;2081;461;1674;119;487;160;540;279;1027
510454;201405;841;2691;746;2554;147;529;467;1662;614;2191
510455;201405;1031;3161;794;2701;200;790;290;938;490;1728
510460;201405;2100;6001;1821;5614;320;1140;1210;3636;1530;4776
510480;201405;4306;11840;3250;9823;899;2898;1001;2937;1900;5835
510490;201405;1489;4928;1338;4704;304;1216;809;2784;1113;4000
510500;201405;1420;4379;1058;3689;281;1131;476;1605;757;2736
510510;201405;3084;10994;2739;10397;1023;4117;1049;4003;2072;8120
510515;201405;5802;18243;4734;15999;1248;4682;1397;4513;2645;9195
510517;201405;1805;5458;1591;5127;458;1425;905;3106;1363;4531
510520;201405;2221;5691;1699;4965;136;470;1228;3595;1364;4065
510523;201405;1088;3315;931;3052;211;739;542;1779;753;2518
510525;201405;7989;20760;5298;16518;1336;4501;2007;6201;3343;10702
510530;201405;565;1623;493;1517;84;298;283;869;367;1167
510550;201405;2730;9112;2365;8469;678;2497;1074;3968;1752;6465
510558;201405;2113;6187;1683;5549;499;1769;767;2509;1266;4278
510560;201405;1671;5490;1213;4661;422;1722;315;1245;737;2967
510562;201405;5257;16134;4578;14821;1540;5432;1626;5329;3166;10761
510590;201405;2836;8169;2273;7428;626;2174;1080;3624;1706;5798
510600;201405;1493;3875;1009;3091;187;644;465;1309;652;1953
510610;201405;2873;8492;2536;8036;240;865;2027;6421;2267;7286
510615;201405;2212;7184;1955;6755;632;2338;907;3136;1539;5474
510617;201405;570;1761;500;1653;70;235;374;1281;444;1516
510618;201405;1366;4048;996;3315;255;980;446;1459;701;2439
510619;201405;782;2189;513;1685;99;369;146;469;245;838
510620;201405;1235;3350;820;2715;260;977;204;621;464;1598
510621;201405;1060;3752;940;3490;289;1182;328;1159;617;2341
510622;201405;3698;11402;2503;8712;687;2604;429;1291;1116;3895
510623;201405;3774;10958;3144;9898;987;3271;1333;4177;2320;7448
510624;201405;1248;3880;979;3377;237;929;424;1369;661;2298
510625;201405;2323;6918;1891;6144;583;2108;519;1598;1102;3706
510626;201405;1324;4114;1047;3688;329;1267;518;1841;847;3108
510627;201405;714;2162;566;1893;189;691;182;620;371;1311
510628;201405;1577;4077;1206;3564;151;478;868;2575;1019;3053
510629;201405;1891;6234;1613;5623;542;2069;499;1645;1041;3714
510630;201405;2616;8814;2185;8034;681;2818;598;2197;1279;5015
510631;201405;406;1185;365;1121;65;197;247;762;312;959
510637;201405;2741;8304;2457;7803;701;2408;1234;3856;1935;6264
510642;201405;4840;15912;4152;14990;1278;4899;2028;7614;3306;12513
510645;201405;758;1913;597;1709;198;575;232;722;430;1297
510650;201405;6062;20671;5613;20121;1223;4572;3634;13608;4857;18180
510665;201405;1275;3546;885;2839;222;764;324;1005;546;1769
510670;201405;354;866;211;657;43;157;89;265;132;422
510675;201405;6520;21416;5492;19427;1861;7214;1541;5302;3402;12516
510677;201405;2552;6556;1912;5717;281;847;1379;4293;1660;5140
510680;201405;846;2631;704;2369;158;590;307;969;465;1559
510682;201405;2437;7664;1961;6796;537;2039;698;2424;1235;4463
510685;201405;976;2669;833;2487;110;373;609;1798;719;2171
510700;201405;4130;11266;3039;9591;692;2347;1695;5416;2387;7763
510704;201405;8390;23815;6973;21410;1792;6095;3495;10450;5287;16545
510706;201405;1819;5654;1410;4994;414;1503;679;2435;1093;3938
510710;201405;3696;10518;2868;8852;845;2856;961;2680;1806;5536
510715;201405;691;1802;473;1449;120;405;183;524;303;929
510718;201405;1756;5291;1532;5001;572;1894;703;2363;1275;4257
510719;201405;463;1062;283;829;39;153;129;343;168;496
510720;201405;1298;3072;969;2686;97;276;758;2141;855;2417
510724;201405;830;2564;700;2314;164;610;368;1163;532;1773
510726;201405;663;1798;545;1599;159;476;203;570;362;1046
510729;201405;731;1965;570;1722;148;490;257;777;405;1267
510730;201405;2368;7483;2101;6990;521;1972;1106;3510;1627;5482
510735;201405;1072;3730;904;3442;281;1111;434;1685;715;2796
510740;201405;1033;2652;835;2371;181;503;496;1455;677;1958
510757;201405;697;2425;624;2281;177;671;312;1146;489;1817
510760;201405;28987;82020;22898;71624;7849;26237;8092;25501;15941;51738
510770;201405;4521;12153;4088;11651;647;1775;2646;8498;3293;10273
510774;201405;394;1150;330;1047;74;282;177;533;251;815
510775;201405;847;2411;674;2136;256;882;257;803;513;1685
510776;201405;441;1248;366;1117;88;301;180;531;268;832
510777;201405;1530;4618;1177;4167;236;948;782;2749;1018;3697
510779;201405;646;1945;490;1660;95;352;209;734;304;1086
510780;201405;4005;11889;3442;11084;783;2635;1907;6391;2690;9026
510785;201405;1913;5737;1568;5154;521;1804;613;2043;1134;3847
510787;201405;2223;6861;1926;6378;658;2355;746;2393;1404;4748
510788;201405;382;1141;327;1064;151;469;111;388;262;857
510790;201405;15561;45929;10754;36747;3264;12738;1523;5089;4787;17827
510792;201405;5944;19277;4339;15942;1140;4802;889;3058;2029;7860
510794;201405;1373;4293;1098;3856;492;1845;261;837;753;2682
510795;201405;9581;30772;7475;26523;2454;9388;2007;7220;4461;16608
510800;201405;1865;5416;1584;5051;493;1754;752;2277;1245;4031
510805;201405;1948;5515;1621;5051;224;744;1195;3742;1419;4486
510810;201405;703;1727;551;1524;153;445;286;775;439;1220
510820;201405;869;2137;641;1796;157;514;265;678;422;1192
510830;201405;579;2006;517;1899;161;628;262;1018;423;1646
510835;201405;720;2238;553;1911;184;691;203;648;387;1339
510840;201405;51701;131170;41880;118784;10276;30479;22728;66835;33004;97314
510850;201405;1691;5015;1361;4494;568;2105;252;691;820;2796
510860;201405;2458;8347;2011;7367;735;2950;374;1302;1109;4252
510880;201405;840;2847;739;2668;249;953;309;1135;558;2088
510885;201405;578;1671;446;1478;84;318;211;703;295;1021
510890;201405;915;3089;784;2846;282;1157;217;692;499;1849
510895;201405;1160;3744;1025;3486;299;1163;428;1361;727;2524
520005;201405;1283;4211;1195;4077;374;1338;591;2048;965;3386
520010;201405;1900;6619;1686;6167;719;2902;372;1238;1091;4140
520013;201405;4019;11324;3066;9625;766;2513;1402;4458;2168;6971
520015;201405;578;1617;470;1454;117;386;205;649;322;1035
520017;201405;1261;3935;1094;3662;319;1135;453;1478;772;2613
520020;201405;428;1157;333;1005;91;281;174;556;265;837
520025;201405;23763;77181;23104;76385;2932;10131;18754;62399;21686;72530
520030;201405;4727;15367;4173;14465;1281;4726;1801;6384;3082;11110
520050;201405;345;1047;316;985;62;217;212;640;274;857
520055;201405;673;2069;579;1908;139;456;312;1062;451;1518
520060;201405;1670;5261;1469;4866;363;1313;605;2062;968;3375
520080;201405;1664;5172;1456;4859;372;1232;786;2746;1158;3978
520082;201405;675;2197;628;2116;142;454;388;1354;530;1808
520085;201405;1040;3277;912;2991;227;782;336;1102;563;1884
520090;201405;1006;2410;767;2091;155;369;430;1256;585;1625
520110;201405;41282;124632;32609;111586;13043;49088;8856;30951;21899;80039
520120;201405;262;695;156;506;39;144;38;128;77;272
520130;201405;3800;11235;3517;10806;699;2264;2255;6961;2954;9225
520140;201405;43641;146104;39173;137322;14388;54390;11264;39261;25652;93651
520145;201405;539;1400;398;1198;93;300;167;497;260;797
520150;201405;677;1823;560;1688;153;498;291;872;444;1370
520160;201405;897;2657;760;2447;256;873;295;962;551;1835
520170;201405;4195;10132;3379;9253;520;1472;2505;7048;3025;8520
520180;201405;1921;5821;1611;5300;431;1607;676;2162;1107;3769
520215;201405;1845;4824;1586;4461;260;752;1009;2897;1269;3649
520235;201405;833;2272;655;2017;198;658;288;869;486;1527
520250;201405;1112;3743;1028;3609;315;1172;520;1858;835;3030
520260;201405;772;2042;561;1653;91;316;277;776;368;1092
520280;201405;580;1704;532;1633;259;845;140;472;399;1317
520310;201405;1081;2718;856;2419;202;534;464;1450;666;1984
520320;201405;1642;5280;1360;4718;184;679;853;3036;1037;3715
520330;201405;2875;9049;2230;7896;708;2741;486;1631;1194;4372
520340;201405;1960;4996;1553;4516;199;512;1210;3665;1409;4177
520350;201405;3158;9487;2713;8617;896;3084;1226;3788;2122;6872
520355;201405;1134;4014;1101;3942;391;1479;489;1739;880;3218
520357;201405;892;2441;760;2247;81;265;537;1575;618;1840
520360;201405;613;1724;542;1608;125;375;267;815;392;1190
520380;201405;1219;3363;889;2772;186;640;433;1361;619;2001
520390;201405;1213;3237;855;2746;279;1034;334;988;613;2022
520393;201405;578;1530;517;1432;86;245;346;966;432;1211
520396;201405;713;2329;663;2244;103;394;456;1562;559;1956
520400;201405;1724;4949;1471;4605;275;929;933;2937;1208;3866
520410;201405;1561;4231;1242;3793;343;1132;632;1929;975;3061
520420;201405;347;970;261;812;50;177;114;328;164;505
520425;201405;1467;4104;1353;3912;419;1291;674;1920;1093;3211
520430;201405;2087;5599;1477;4464;339;1122;626;1841;965;2963
520440;201405;3421;9185;2555;7796;927;3088;730;2221;1657;5309
520450;201405;9833;28613;7533;24247;2188;7752;1430;4260;3618;12012
520455;201405;705;2130;582;1924;218;773;179;600;397;1373
520460;201405;885;2579;720;2294;186;662;314;960;500;1622
520465;201405;846;2321;735;2178;173;614;364;1017;537;1631
520470;201405;1752;5751;1599;5523;327;1122;1070;3861;1397;4983
520480;201405;1025;2992;847;2711;188;630;498;1613;686;2243
520485;201405;1212;4145;1125;3984;392;1457;560;2013;952;3470
520490;201405;4433;13793;3558;12444;1329;4978;1371;4848;2700;9826
520495;201405;1410;3843;1158;3536;91;271;991;3081;1082;3352
520500;201405;2065;5559;1844;5256;599;1790;836;2558;1435;4348
520505;201405;899;2573;780;2395;186;590;472;1485;658;2075
520510;201405;11406;32331;7792;26243;2509;9203;2047;6993;4556;16196
520520;201405;1069;3106;900;2877;328;1102;372;1213;700;2315
520530;201405;2390;7458;2048;6899;497;1641;1021;3802;1518;5443
520540;201405;3027;9276;2624;8580;810;2783;1122;3697;1932;6480
520545;201405;1330;4136;1143;3761;356;1251;359;1144;715;2395
520547;201405;832;2644;691;2399;270;1008;209;682;479;1690
520549;201405;8947;27529;7764;26052;2449;8618;3788;12908;6237;21526
520551;201405;3812;11645;3650;11450;1058;3467;2133;6895;3191;10362
520552;201405;727;2390;704;2359;127;467;481;1600;608;2067
520570;201405;582;1701;437;1466;181;637;115;393;296;1030
520580;201405;2016;5909;1686;5420;527;1873;670;2103;1197;3976
520590;201405;1537;4363;1275;3928;335;1076;485;1437;820;2513
520620;201405;7326;23800;6705;22875;1466;5386;4163;14329;5629;19715
520630;201405;653;1870;563;1758;138;426;321;1017;459;1443
520640;201405;2790;8195;2431;7624;782;2550;1056;3465;1838;6015
520650;201405;829;2395;713;2179;260;833;297;914;557;1747
520660;201405;400;1218;340;1122;112;392;107;350;219;742
520670;201405;819;2496;785;2443;64;170;687;2181;751;2351
520680;201405;627;1861;538;1736;181;634;218;698;399;1332
520690;201405;319;846;232;729;31;97;119;396;150;493
520710;201405;497;1268;329;945;15;46;199;565;214;611
520725;201405;1834;4824;1437;4246;343;1101;791;2335;1134;3436
520735;201405;696;2095;563;1858;190;666;186;599;376;1265
520740;201405;1721;5038;1450;4660;389;1328;710;2263;1099;3591
520750;201405;765;2012;575;1751;149;491;312;975;461;1466
520753;201405;1283;3706;1210;3598;162;431;909;2854;1071;3285
520760;201405;1163;3262;1020;3078;293;938;592;1796;885;2734
520780;201405;2075;5152;1741;4702;227;552;1324;3686;1551;4238
520790;201405;2590;7316;2286;6888;334;1038;1651;5082;1985;6120
520800;201405;17631;52340;15740;50087;3620;11209;9670;33177;13290;44386
520810;201405;970;2674;866;2545;142;419;646;1972;788;2391
520815;201405;468;1577;365;1367;180;757;39;144;219;901
520830;201405;1706;4366;1338;3981;54;129;1221;3718;1275;3847
520840;201405;1662;5667;1512;5373;522;1935;574;2109;1096;4044
520850;201405;805;2377;630;2117;188;669;273;903;461;1572
520860;201405;7129;20447;5341;18007;1465;5350;2550;8838;4015;14188
520870;201405;109981;303800;75617;242345;22401;78351;21171;66207;43572;144558
520880;201405;6816;19457;4846;16312;1431;5464;727;2300;2158;7764
520890;201405;3831;11289;3360;10526;762;2508;1797;5647;2559;8155
520910;201405;3454;10633;2711;9103;848;3086;690;2257;1538;5343
520915;201405;932;2697;705;2256;172;596;287;886;459;1482
520920;201405;3421;9133;2372;7449;630;2123;712;2302;1342;4425
520929;201405;452;1323;404;1266;119;378;215;680;334;1058
520940;201405;985;3003;883;2844;112;403;645;2049;757;2452
520945;201405;667;1673;574;1531;202;513;252;690;454;1203
520960;201405;896;2647;742;2402;140;477;422;1380;562;1857
520970;201405;3421;10121;2819;9043;692;2451;1127;3550;1819;6001
520980;201405;1010;2773;931;2669;260;819;569;1605;829;2424
520990;201405;3689;11580;3378;11013;714;2464;1842;6569;2556;9033
520993;201405;1187;3286;971;2916;137;455;614;1829;751;2284
520995;201405;2642;7298;2376;6944;364;1075;1728;5099;2092;6174
521000;201405;7929;24056;6794;22146;1680;6045;3292;10653;4972;16698
521010;201405;3965;12386;3405;11326;915;3245;1415;4768;2330;8013
521015;201405;686;1950;584;1785;120;373;330;1034;450;1407
521020;201405;4052;11951;3076;9868;1023;3541;646;1851;1669;5392
521030;201405;810;2174;705;2026;144;424;451;1325;595;1749
521040;201405;5509;16340;5051;15627;1768;5502;2588;8389;4356;13891
521056;201405;989;3057;843;2814;291;1018;356;1232;647;2250
521060;201405;1130;3206;995;2998;242;708;444;1359;686;2067
521080;201405;1233;3086;807;2373;174;599;285;690;459;1289
521090;201405;3247;9554;2767;8902;971;3307;1069;3540;2040;6847
521100;201405;1428;3742;1308;3607;247;658;917;2622;1164;3280
521120;201405;4774;13930;4370;13286;1170;3597;2412;7508;3582;11105
521130;201405;1118;3179;908;2797;198;695;483;1486;681;2181
521140;201405;939;3139;845;2933;288;1067;227;771;515;1838
521150;201405;12834;33767;8451;25252;2849;9278;2618;7709;5467;16987
521160;201405;750;1936;503;1434;88;280;276;740;364;1020
521170;201405;1351;3288;1137;3003;308;759;658;1782;966;2541
521180;201405;6563;22164;5975;21035;2190;8199;1830;6458;4020;14657
521190;201405;8856;26476;6620;22518;2234;8051;2222;7641;4456;15692
521200;201405;853;2268;790;2179;112;332;559;1535;671;1867
521205;201405;574;1721;464;1519;67;236;264;878;331;1114
521210;201405;900;2621;655;2133;257;935;228;664;485;1599
521220;201405;3823;10922;3210;10078;1059;3553;1333;4151;2392;7704
521225;201405;393;1011;314;911;48;146;211;629;259;775
521230;201405;1367;4340;1262;4118;453;1564;597;1895;1050;3459
521250;201405;26145;87803;24787;85731;9566;34942;10581;37377;20147;72319
521260;201405;824;2035;658;1746;115;384;379;938;494;1322
521270;201405;1828;5773;1676;5530;173;470;1304;4518;1477;4988
521280;201405;1852;5772;1572;5247;491;1749;623;2081;1114;3830
521290;201405;543;1576;401;1340;125;490;146;459;271;949
521295;201405;1138;3149;1042;3023;146;422;831;2441;977;2863
521300;201405;1837;5404;1702;5189;398;1191;1042;3301;1440;4492
521305;201405;853;2292;714;2098;157;436;443;1366;600;1802
521308;201405;5141;15312;4070;13451;842;3061;2197;7206;3039;10267
521310;201405;7469;23051;6020;20248;2047;7228;1616;5300;3663;12528
521340;201405;266;820;238;777;49;180;137;435;186;615
521350;201405;2193;5707;1812;5197;245;721;1213;3704;1458;4425
521370;201405;1024;3310;931;3138;327;1184;321;1029;648;2213
521375;201405;1393;4108;1208;3794;314;1080;620;1898;934;2978
521377;201405;1014;2940;970;2887;84;207;844;2579;928;2786
521380;201405;4744;13503;3503;11224;819;2835;720;2422;1539;5257
521385;201405;614;1729;549;1641;167;525;265;791;432;1316
521390;201405;1117;2952;830;2552;256;886;290;869;546;1755
521400;201405;2380;6501;2045;6112;338;1109;1510;4486;1848;5595
521405;201405;1364;3988;1136;3569;396;1350;467;1464;863;2814
521410;201405;778;2498;712;2385;281;925;303;1062;584;1987
521440;201405;1495;4157;1478;4138;120;300;1297;3729;1417;4029
521450;201405;5025;15383;4239;13945;1377;4811;1209;3910;2586;8721
521460;201405;7164;22377;6605;21516;1818;6376;3445;11177;5263;17553
521470;201405;733;2081;551;1729;158;559;102;303;260;862
521480;201405;515;1511;379;1263;119;402;120;397;239;799
521483;201405;3121;8366;2570;7413;758;2292;1063;3008;1821;5300
521486;201405;1681;4674;1512;4373;313;989;1019;2887;1332;3876
521487;201405;565;1575;442;1370;82;241;228;735;310;976
521490;201405;838;2439;674;2207;92;352;477;1572;569;1924
521500;201405;1340;4341;1156;3969;231;906;607;1947;838;2853
521520;201405;916;2184;820;2064;258;559;381;1072;639;1631
521523;201405;11408;42886;10742;41710;3569;14991;2738;11356;6307;26347
521525;201405;1128;2945;995;2768;149;453;687;1871;836;2324
521530;201405;2071;6199;1422;4877;541;1953;293;954;834;2907
521540;201405;992;2713;684;2165;186;693;205;597;391;1290
521550;201405;991;2542;888;2393;235;686;507;1337;742;2023
521560;201405;4975;15332;4014;14049;1628;6163;1241;4302;2869;10465
521565;201405;703;1844;601;1716;104;274;419;1235;523;1509
521570;201405;4739;13378;3400;10690;1083;3559;1133;3611;2216;7170
521580;201405;677;1669;496;1420;177;553;163;466;340;1019
521590;201405;752;2133;618;1909;228;727;130;428;358;1155
521600;201405;627;1640;451;1338;112;363;162;430;274;793
521630;201405;1793;4882;1506;4441;561;1888;282;681;843;2569
521640;201405;1953;5476;1637;4999;549;1879;572;1784;1121;3663
521645;201405;656;1991;549;1746;115;402;267;790;382;1192
521680;201405;1474;4717;1252;4241;670;2400;222;713;892;3113
521690;201405;597;1778;535;1661;131;476;261;751;392;1227
521710;201405;2302;7252;2021;6685;437;1541;1103;3642;1540;5183
521720;201405;2054;6136;1882;5896;555;1731;1101;3540;1656;5271
521730;201405;3913;13149;3605;12530;1572;5956;1029;3341;2601;9297
521740;201405;3673;10088;2921;9127;1278;4141;1116;3682;2394;7823
521760;201405;12392;42552;11594;41264;2076;8197;7673;27579;9749;35776
521770;201405;2778;8517;2370;7697;1035;3562;646;1991;1681;5553
521800;201405;8747;26042;7519;24184;2594;8828;3316;11004;5910;19832
521805;201405;988;2291;779;1976;216;488;427;1206;643;1694
521810;201405;814;2394;713;2229;175;604;374;1135;549;1739
521830;201405;5465;18546;5142;18051;1060;4013;3393;11903;4453;15916
521839;201405;687;2022;553;1758;138;489;207;617;345;1106
521850;201405;6999;19880;5963;18045;1427;4341;2970;9049;4397;13390
521860;201405;1764;5378;1536;4932;419;1463;568;1769;987;3232
521870;201405;559;1963;514;1844;169;662;143;481;312;1143
521878;201405;620;2011;498;1723;149;576;198;647;347;1223
521880;201405;26068;69329;17846;55764;6043;20011;5568;17802;11611;37813
521890;201405;3727;11606;3114;10405;1191;4286;822;2713;2013;6999
521900;201405;1671;4503;1369;4088;361;1163;564;1594;925;2757
521910;201405;1233;3440;1077;3259;272;864;614;1927;886;2791
521920;201405;404;1218;361;1150;127;429;154;473;281;902
521925;201405;640;1993;574;1860;122;438;254;764;376;1202
521930;201405;3969;12865;3588;12128;1263;4517;1099;3729;2362;8246
521935;201405;660;1994;626;1929;179;574;347;1052;526;1626
521940;201405;1131;3087;920;2726;320;993;340;1005;660;1998
521945;201405;682;2348;637;2289;128;420;449;1725;577;2145
521950;201405;552;1686;466;1540;128;453;202;682;330;1135
521960;201405;943;2772;802;2531;195;665;384;1187;579;1852
521970;201405;2498;7204;2279;6921;337;1013;1673;5226;2010;6239
521971;201405;1024;2808;795;2391;189;622;312;916;501;1538
521973;201405;885;2935;788;2734;235;867;257;868;492;1735
521975;201405;13700;39241;12912;38247;2395;7543;8662;25885;11057;33428
521980;201405;1801;5651;1717;5556;261;773;1354;4564;1615;5337
521990;201405;1095;3386;990;3211;165;593;638;2051;803;2644
522000;201405;2111;6218;1852;5881;384;1279;1128;3706;1512;4985
522005;201405;382;999;291;852;80;239;141;415;221;654
522010;201405;3101;9222;2622;8433;949;3230;741;2346;1690;5576
522015;201405;1025;3009;856;2756;229;790;421;1377;650;2167
522020;201405;4790;13185;4202;12425;913;2934;2662;7800;3575;10734
522026;201405;651;1865;465;1670;192;741;162;602;354;1343
522028;201405;538;1612;486;1532;112;368;303;950;415;1318
522040;201405;3136;8106;2358;7119;773;2421;1077;3325;1850;5746
522045;201405;13282;43788;11327;39759;3818;14754;2697;9201;6515;23955
522050;201405;1035;3048;841;2719;271;960;342;1051;613;2011
522060;201405;3035;9553;2554;8813;732;2720;1315;4495;2047;7215
522068;201405;1588;5147;1488;5035;128;345;1245;4448;1373;4793
522070;201405;846;2555;758;2416;105;404;512;1624;617;2028
522100;201405;808;2268;722;2137;263;873;337;929;600;1802
522108;201405;937;2793;830;2633;87;285;616;2006;703;2291
522119;201405;1316;4039;1096;3741;179;618;693;2446;872;3064
522130;201405;510;1464;441;1388;131;422;235;763;366;1185
522140;201405;17933;51280;15709;47921;4935;16143;6655;19976;11590;36119
522145;201405;953;2690;886;2582;427;1315;285;816;712;2131
522150;201405;1265;3350;1054;3058;394;1213;390;1177;784;2390
522155;201405;787;2315;706;2196;163;500;439;1420;602;1920
522157;201405;703;2062;612;1915;72;245;476;1495;548;1740
522160;201405;6104;17449;4397;14476;1704;6207;740;2319;2444;8526
522170;201405;3186;8912;2657;8136;802;2466;1108;3547;1910;6013
522180;201405;464;1329;345;1145;143;517;120;403;263;920
522185;201405;14887;46446;13585;44667;2915;10258;8209;27369;11124;37627
522190;201405;958;2521;786;2236;134;377;460;1341;594;1718
522200;201405;1576;5361;1462;5116;519;1950;472;1589;991;3539
522205;201405;1322;3860;1103;3491;299;997;524;1673;823;2670
522220;201405;1403;3907;1136;3571;266;878;585;2012;851;2890
522230;201405;1177;3557;1063;3371;161;568;727;2301;888;2869
530010;201405;255428;833691;230219;783906;72279;268751;83089;282846;155368;551597
110001;201404;4528;14884;3941;13933;1123;4126;2065;7402;3188;11528
110002;201404;13343;43003;11706;40134;3836;14214;4795;16480;8631;30694
110003;201404;987;3226;913;3094;268;968;307;1006;575;1974
110004;201404;9783;32082;8333;29047;2690;10229;2388;8327;5078;18556
110005;201404;2379;8015;2254;7764;869;3105;867;3011;1736;6116
110006;201404;3427;9245;2169;7497;707;2603;594;1923;1301;4526
110007;201404;1520;4842;1411;4684;333;1188;765;2720;1098;3908
110008;201404;2587;8882;2429;8651;549;1893;1646;6154;2195;8047
110009;201404;5419;15745;4225;13981;1173;4206;1826;5921;2999;10127
110010;201404;8498;24548;7505;23322;1646;4770;4560;15463;6206;20233
110011;201404;10961;33831;9090;30602;3383;12088;3126;10510;6509;22598
110012;201404;17177;53192;14889;48815;5073;17646;5189;16931;10262;34577
110013;201404;5340;16962;4430;15616;1413;5294;1880;6733;3293;12027
110014;201404;4403;13148;3731;12183;887;3067;2144;7101;3031;10168
110015;201404;5401;17223;4347;15316;1594;6053;1335;4691;2929;10744
110018;201404;5256;15489;4294;14234;1369;5091;1829;5782;3198;10873
110020;201404;57755;169352;48193;157380;11272;38132;27497;92823;38769;130955
110025;201404;4552;13349;3828;12067;689;2289;2593;8169;3282;10458
110026;201404;838;2438;712;2289;170;556;447;1481;617;2037
110028;201404;7775;23035;5871;19818;1753;6519;1436;4727;3189;11246
110029;201404;1712;5042;1375;4463;470;1581;552;1850;1022;3431
110030;201404;11532;33502;9528;30939;2563;8958;4951;16618;7514;25576
110032;201404;4244;13859;3796;12875;1125;3936;1499;5182;2624;9118
110033;201404;5559;17984;5185;17402;1728;5867;2314;8337;4042;14204
110034;201404;3929;10307;3293;9535;570;1625;2425;7122;2995;8747
110037;201404;2099;7140;1833;6644;507;1868;962;3539;1469;5407
110040;201404;3556;11644;3304;11199;1075;3945;1480;4958;2555;8903
110045;201404;5296;18166;4867;17656;1504;5835;2649;9573;4153;15408
110050;201404;1846;5920;1540;5514;540;1989;764;2789;1304;4778
110060;201404;1019;3524;907;3319;280;1095;429;1566;709;2661
110070;201404;2002;6872;1944;6739;336;1219;1352;4720;1688;5939
110080;201404;3561;11414;3401;11222;797;2434;2417;8331;3214;10765
110090;201404;958;2820;760;2502;239;894;308;919;547;1813
110092;201404;1736;5614;1584;5418;355;1230;903;3274;1258;4504
110094;201404;3304;10406;3029;10010;749;2633;1765;5981;2514;8614
110100;201404;2688;8566;2321;7947;740;2680;1091;3752;1831;6432
110110;201404;1813;5869;1692;5723;760;2621;683;2425;1443;5046
110120;201404;1695;5666;1391;4943;397;1457;460;1653;857;3110
110130;201404;2803;8030;2127;7041;590;2054;970;3250;1560;5304
110140;201404;2560;8829;2394;8553;536;1958;1491;5436;2027;7394
110143;201404;1579;5104;1237;4503;318;1200;634;2288;952;3488
110145;201404;1016;3094;894;2904;169;596;564;1843;733;2439
110146;201404;472;1504;430;1440;103;367;234;795;337;1162
110147;201404;905;2703;714;2390;197;721;252;758;449;1479
110148;201404;1377;4135;1075;3518;357;1277;327;1015;684;2292
110149;201404;3809;11163;2987;9915;781;2730;1720;5831;2501;8561
110150;201404;2894;8539;2393;7801;372;1337;1537;5045;1909;6382
110155;201404;946;3147;892;3020;296;1076;425;1404;721;2480
110160;201404;2219;7006;1830;6307;617;2186;819;2850;1436;5036
110170;201404;3227;9359;2509;8124;579;1991;1453;4738;2032;6729
110175;201404;1719;5475;1338;4984;151;601;947;3604;1098;4205
110180;201404;1709;5329;1456;4920;345;1202;853;2935;1198;4137
120001;201404;2913;10371;2816;10206;708;2775;1579;5786;2287;8561
120005;201404;1586;6300;1544;6221;175;681;1197;5019;1372;5700
120010;201404;4554;16155;4369;15835;959;3329;2833;10749;3792;14078
120013;201404;1892;7384;1845;7306;427;1708;1142;4756;1569;6464
120017;201404;2131;7638;2014;7419;565;2176;915;3715;1480;5891
120020;201404;14387;63309;14147;62772;2534;10773;10073;46882;12607;57655
120025;201404;2776;9650;2700;9531;655;2467;1570;5602;2225;8069
120030;201404;6136;24496;6061;24397;512;1941;5141;21194;5653;23135
120032;201404;1406;6748;1354;6621;196;1136;970;4758;1166;5894
120033;201404;3677;14044;3650;13994;226;892;3227;12555;3453;13447
120034;201404;1838;7412;1810;7368;93;419;1652;6742;1745;7161
120035;201404;2779;13413;2746;13335;273;1288;2252;11320;2525;12608
120038;201404;3228;11858;3109;11609;873;3355;1630;6285;2503;9640
120039;201404;1451;7914;1428;7861;183;1089;1129;6280;1312;7369
120040;201404;45883;166237;42271;158821;12728;50628;19437;74903;32165;125531
120042;201404;2813;12296;2697;12016;434;2045;1880;8545;2314;10590
120043;201404;859;4115;833;4060;65;314;700;3503;765;3817
120045;201404;4468;15552;4416;15472;1087;3823;2940;10586;4027;14409
120050;201404;8224;33926;7926;33275;1443;5840;5224;23343;6667;29183
120060;201404;7103;32703;6988;32486;765;3646;5655;26963;6420;30609
120070;201404;2831;10718;2776;10580;589;2174;1769;7067;2358;9241
120080;201404;3716;14064;3558;13802;640;2527;2507;10072;3147;12599
130002;201404;2835;12084;2679;11823;285;1298;2111;9484;2396;10782
130006;201404;1720;7465;1546;7142;226;1124;1077;5072;1303;6196
130008;201404;2027;8284;1940;8126;175;789;1550;6632;1725;7421
130010;201404;2710;9112;2358;8701;240;806;1946;7398;2186;8204
130014;201404;3485;11274;3015;10569;490;1844;1945;6928;2435;8772
130020;201404;2493;8848;2481;8834;36;130;2423;8644;2459;8774
130030;201404;7011;27610;6791;27318;572;1965;5810;24140;6382;26105
130040;201404;3525;11140;3293;10819;321;1171;2771;9090;3092;10261
130050;201404;5894;23727;5237;22692;737;3044;3659;17021;4396;20065
130060;201404;5913;26067;5576;25585;606;2731;4477;21093;5083;23824
130063;201404;3256;14611;3233;14568;351;1509;2703;12497;3054;14006
130068;201404;2998;12745;2785;12332;351;1699;1958;8769;2309;10468
130070;201404;6599;22158;6017;21404;753;2592;4612;16959;5365;19551
130080;201404;5077;22629;4902;22383;871;4107;3399;16048;4270;20155
130083;201404;2013;8051;1910;7890;329;1503;1307;5432;1636;6935
130090;201404;2489;9051;2376;8897;191;838;2017;7555;2208;8393
130100;201404;5452;20910;5248;20632;440;1903;4404;17498;4844;19401
130110;201404;6701;21681;6271;21165;749;2408;5009;17508;5758;19916
130115;201404;3793;13992;3633;13782;119;365;3429;13148;3548;13513
130120;201404;13468;51863;13140;51389;1305;4663;10955;44354;12260;49017
130130;201404;3411;14662;3313;14483;434;1915;2560;11471;2994;13386
130140;201404;5954;23766;5912;23712;166;495;5688;23092;5854;23587
130150;201404;3508;13159;3433;13059;216;1012;3012;11443;3228;12455
130160;201404;3899;16226;3825;16125;292;1088;3406;14621;3698;15709
130165;201404;2749;11445;2688;11338;444;1928;2059;8784;2503;10712
130170;201404;8864;32704;7806;31361;1444;5950;5323;22322;6767;28272
130180;201404;3357;10772;3283;10669;118;332;3034;9941;3152;10273
130185;201404;9513;33092;9008;32487;1436;4918;6790;25602;8226;30520
130190;201404;16905;59436;14943;56957;3157;11827;9383;38014;12540;49841
130195;201404;1805;7549;1749;7463;106;460;1527;6629;1633;7089
130200;201404;1962;7162;1827;6931;387;1516;1152;4467;1539;5983
130210;201404;1153;4601;1099;4506;160;649;828;3513;988;4162
130220;201404;2032;8374;1873;8084;351;1678;1090;4769;1441;6447
130230;201404;3333;15234;3158;14938;401;1960;2340;11543;2741;13503
130240;201404;8295;32160;7672;31240;495;2301;6488;26845;6983;29146
130250;201404;17511;64130;16926;63298;2855;10138;12319;48310;15174;58448
130255;201404;3981;14377;3781;14041;175;550;3377;12878;3552;13428
130260;201404;252479;823715;229108;786676;66680;236917;112144;398710;178824;635627
130270;201404;7288;30419;6582;29306;1126;4873;4594;21571;5720;26444
130280;201404;3213;12638;3144;12539;145;464;2827;11590;2972;12054
130290;201404;10637;38092;10472;37855;228;603;9909;36448;10137;37051
130300;201404;4429;17198;4158;16794;376;1701;3334;13600;3710;15301
130310;201404;4930;18712;4513;18191;580;2261;3469;14461;4049;16722
130320;201404;2860;9956;2624;9639;369;1405;1870;7060;2239;8465
130330;201404;3566;13175;3199;12676;244;1026;2668;10769;2912;11795
130340;201404;17321;67434;16789;66595;3504;12973;10877;46457;14381;59430
130350;201404;3236;13207;3107;13054;349;1436;2499;10813;2848;12249
130353;201404;5867;18326;5128;17325;1343;4550;2859;10349;4202;14899
130356;201404;4406;15916;4247;15677;519;1631;3385;13215;3904;14846
130360;201404;2923;8074;2610;7717;47;82;2458;7467;2505;7549
130370;201404;4953;19573;4260;18648;263;1410;3571;15755;3834;17165
130380;201404;6760;28696;6530;28338;494;2303;5515;24200;6009;26503
130390;201404;4611;20756;4337;20285;495;2357;3317;16000;3812;18357
130395;201404;2030;7419;1859;7101;281;1167;1187;4567;1468;5734
130400;201404;2133;7887;2064;7791;177;707;1767;6748;1944;7455
130406;201404;9668;36972;8643;35401;2168;8620;4888;21471;7056;30091
130410;201404;4088;15691;3770;15105;924;3847;2063;8616;2987;12463
130420;201404;9948;42531;9629;41909;3043;12986;5179;23944;8222;36930
130423;201404;3114;12262;2951;12040;271;1255;2449;10058;2720;11313
130426;201404;2044;8825;1968;8691;347;1532;1365;6301;1712;7833
130430;201404;3464;12493;3286;12245;421;1713;2361;8987;2782;10700
130440;201404;4007;14038;3719;13723;190;610;3352;12715;3542;13325
140002;201404;1500;4881;1406;4749;165;569;1012;3513;1177;4082
140005;201404;2585;7986;2426;7814;129;369;2199;7196;2328;7565
140010;201404;44520;145428;40363;138616;9795;36144;21854;76646;31649;112790
140015;201404;2850;9373;2733;9217;352;959;2159;7653;2511;8612
140017;201404;2952;9321;2795;9124;224;642;2356;7933;2580;8575
140020;201404;4341;14870;4058;14493;457;1498;3198;11883;3655;13381
140023;201404;2015;7036;1835;6745;266;1010;1267;4787;1533;5797
140028;201404;2151;6021;2094;5954;89;187;1924;5616;2013;5803
140030;201404;3565;11485;3420;11301;419;1075;2830;9828;3249;10903
140040;201404;1478;7145;1429;7004;131;719;1061;5318;1192;6037
140045;201404;2404;8792;2256;8582;386;1319;1557;6425;1943;7744
140047;201404;5373;15116;4923;14509;1586;4913;2125;6676;3711;11589
140050;201404;1518;4701;1405;4548;196;651;996;3292;1192;3943
140060;201404;1432;4544;1306;4364;307;1075;797;2747;1104;3822
140070;201404;1419;7015;1417;7012;57;233;1343;6725;1400;6958
150010;201404;33237;107071;31784;105134;2389;8369;26723;89611;29112;97980
150013;201404;1602;4968;1532;4886;173;570;1220;3925;1393;4495
150020;201404;11214;39055;10941;38656;1372;4845;8705;31438;10077;36283
150030;201404;6266;27555;6109;27293;696;2642;4986;23352;5682;25994
150034;201404;4441;12160;4210;11878;203;498;3878;11111;4081;11609
150040;201404;12441;42829;10950;40986;2548;8901;6912;28101;9460;37002
150050;201404;6010;23103;5870;22846;630;2623;4677;18421;5307;21044
150060;201404;15707;52060;14866;50792;3624;12198;9052;32272;12676;44470
150070;201404;5576;23375;5054;22783;495;2321;4214;19295;4709;21616
150080;201404;60520;166915;53947;158628;8196;22562;38335;116860;46531;139422
150085;201404;5072;18067;4845;17736;694;2208;3758;14476;4452;16684
150090;201404;9903;38691;9369;37954;1188;4621;7289;30432;8477;35053
150095;201404;5154;17880;4784;17314;511;1821;3778;14089;4289;15910
150100;201404;3536;13237;3315;12897;273;1293;2667;10300;2940;11593
150110;201404;3164;15233;3153;15205;198;828;2874;14093;3072;14921
150120;201404;5933;23427;5810;23197;1041;3980;4203;17238;5244;21218
150125;201404;800;2492;743;2405;175;597;445;1440;620;2037
150130;201404;20527;65107;19461;63567;1861;6012;15519;51766;17380;57778
150140;201404;150001;449686;144791;443253;18787;57480;115285;358263;134072;415743
150145;201404;4870;15454;4523;15018;697;2425;3287;11080;3984;13505
150150;201404;9747;32192;9179;31293;1996;7023;5784;20081;7780;27104
150157;201404;2915;9209;2640;8821;405;1412;1982;6682;2387;8094
150160;201404;2899;9730;2747;9508;728;2427;1606;5868;2334;8295
150170;201404;21882;81557;20781;80071;4515;17190;13989;55131;18504;72321
150172;201404;3043;10657;2756;10225;375;1420;2112;8001;2487;9421
150175;201404;2041;6383;1975;6306;163;452;1715;5645;1878;6097
150178;201404;10774;33698;9291;31947;686;2145;8063;28447;8749;30592
150180;201404;17688;72013;17155;71268;1675;7363;14123;59486;15798;66849
150190;201404;7198;23193;6771;22593;436;1007;5793;20227;6229;21234
150195;201404;4677;16502;4371;15974;464;1719;3493;12967;3957;14686
150200;201404;5069;16538;4917;16350;137;416;4573;15396;4710;15812
150210;201404;22453;86584;22083;86038;2460;8941;18195;72929;20655;81870
150215;201404;6007;19583;5482;18801;1452;5175;2866;10096;4318;15271
150220;201404;12623;40593;11533;38899;2852;9851;6157;21478;9009;31329
150230;201404;11044;38059;10023;36618;890;3935;8055;29252;8945;33187
150240;201404;33741;103968;30721;98921;9629;32259;12674;42291;22303;74550
150250;201404;4003;16251;3879;16066;680;2712;2795;12123;3475;14835
150260;201404;2012;8239;1931;8078;424;1858;1132;4884;1556;6742
150270;201404;9541;29225;7444;26612;1685;6418;4506;16453;6191;22871
150275;201404;5773;21313;5471;20818;890;3432;3871;15101;4761;18533
150276;201404;2101;6375;1954;6183;365;1226;1431;4535;1796;5761
150277;201404;4918;15664;4356;14978;580;2032;3284;11642;3864;13674
150280;201404;5858;25753;5690;25360;964;4195;4066;18748;5030;22943
150285;201404;2615;10620;2577;10538;313;1276;1981;8319;2294;9595
150290;201404;8883;27763;8652;27487;888;2490;7095;23531;7983;26021
150293;201404;8527;26565;7295;24697;2511;8827;2893;10434;5404;19261
150295;201404;6162;20342;5461;19469;1254;4512;3430;12894;4684;17406
150300;201404;1769;6299;1731;6251;125;426;1451;5412;1576;5838
150304;201404;4120;12974;3576;12235;550;1910;2520;8921;3070;10831
150307;201404;6528;22517;6082;21878;503;1692;4963;18396;5466;20088
150309;201404;6590;23611;6130;22987;1740;6543;3628;14302;5368;20845
150310;201404;4933;23199;4857;23081;581;2672;3902;19103;4483;21775
150320;201404;8643;22965;8278;22573;615;1536;7170;20042;7785;21578
150330;201404;13117;47978;12495;46988;1640;6124;9541;36900;11181;43024
150340;201404;2227;7582;2094;7388;404;1491;1374;4943;1778;6434
150345;201404;6321;22435;5926;21897;688;2566;4753;17987;5441;20553
150350;201404;7256;24442;6913;23955;1000;3357;5118;18164;6118;21521
150360;201404;21094;67467;18585;64267;3074;10922;12755;45693;15829;56615
150370;201404;10232;38265;9803;37686;1272;4502;7829;31363;9101;35865
150375;201404;2765;11805;2708;11728;318;1271;2227;10020;2545;11291
150380;201404;9467;29058;8546;27786;935;3222;6886;22556;7821;25778
150390;201404;8133;35182;7766;34447;1799;7617;4681;21986;6480;29603
150400;201404;5432;22594;5265;22246;706;2945;3846;16791;4552;19736
150405;201404;8317;25891;7554;24940;1610;4822;4967;17640;6577;22462
150410;201404;1711;6605;1674;6543;320;1322;1047;4190;1367;5512
150420;201404;34752;123923;31173;118052;8348;33470;15617;61785;23965;95255
150430;201404;6476;24274;6262;23896;803;3292;4761;18390;5564;21682
150440;201404;5336;18843;5202;18642;855;2969;3819;14070;4674;17039
150442;201404;21492;62734;19660;60300;3559;11120;12913;40962;16472;52082
150445;201404;5052;18094;4674;17538;729;2604;3474;13447;4203;16051
150450;201404;4255;20500;4111;20294;444;2181;3335;16901;3779;19082
150460;201404;6808;25040;5706;23866;458;2036;4915;21023;5373;23059
150470;201404;17155;53199;16618;52521;1250;3289;14672;47615;15922;50904
150475;201404;983;3354;894;3236;193;659;598;2305;791;2964
150480;201404;14038;48409;13493;47598;1089;3706;11220;40631;12309;44337
150490;201404;6465;25238;6345;25072;349;1359;5728;22903;6077;24262
150495;201404;4775;17600;4675;17442;266;979;4210;15845;4476;16824
150497;201404;3256;11493;2978;11016;929;3518;1536;5887;2465;9405
150500;201404;2906;8561;2793;8390;429;1229;2072;6331;2501;7560
150503;201404;3819;12203;3296;11536;1172;4285;1497;5480;2669;9765
150506;201404;12217;43681;11288;42379;2776;9558;7202;29129;9978;38687
150510;201404;9646;38330;9044;37264;1525;6294;6135;26445;7660;32739
150520;201404;6107;25311;6017;25181;434;1464;5394;23133;5828;24597
150530;201404;11550;41595;10585;40148;1450;4999;7831;30949;9281;35948
150540;201404;4589;14327;4191;13748;353;1185;3449;11369;3802;12554
150543;201404;5054;16127;4645;15551;1336;4587;2654;9083;3990;13670
150548;201404;8241;26954;7760;26336;555;1739;6790;23535;7345;25274
150549;201404;2210;7080;2104;6954;111;269;1906;6473;2017;6742
150550;201404;20933;67536;18776;63854;5758;20398;8252;28760;14010;49158
150553;201404;20977;77069;18627;71543;7268;29967;3459;13193;10727;43160
150555;201404;1732;5436;1519;5137;241;879;1068;3642;1309;4521
150560;201404;1977;6435;1902;6266;269;935;1366;4496;1635;5431
150563;201404;2853;9546;2663;9213;637;2371;1528;5278;2165;7649
150565;201404;3414;12266;3194;11940;265;1101;2500;9511;2765;10612
150570;201404;5336;20468;5254;20326;437;1628;4396;17466;4833;19094
150580;201404;9612;39803;9442;39590;840;3080;8106;35206;8946;38286
150590;201404;5439;22127;5296;21956;124;428;5039;21137;5163;21565
150600;201404;7681;30179;7495;29893;602;2194;6438;26403;7040;28597
150610;201404;2377;8302;2194;7921;265;1078;1522;5432;1787;6510
150611;201404;2620;9666;2506;9406;279;1110;1829;6930;2108;8040
150613;201404;11221;35286;9879;33416;3366;11748;4568;16282;7934;28030
150616;201404;3089;9114;2452;8298;587;2032;1365;4672;1952;6704
150618;201404;7305;25818;7026;25293;2281;8567;3371;12430;5652;20997
150619;201404;5202;18196;4904;17757;743;2886;3442;12591;4185;15477
150620;201404;6114;22463;5580;21775;856;3328;4168;16921;5024;20249
150630;201404;5370;17055;5171;16808;448;1456;4341;14376;4789;15832
150635;201404;4477;14846;4229;14380;817;2860;2589;9139;3406;11999
150640;201404;1474;4793;1461;4772;58;166;1358;4509;1416;4675
150650;201404;11948;37419;10905;35573;2984;10159;5380;17928;8364;28087
150655;201404;5304;17774;4890;17168;688;2523;3634;12934;4322;15457
150658;201404;4286;13829;3957;13351;410;1664;2947;10051;3357;11715
150660;201404;5657;18124;5184;17519;1432;4766;2909;10287;4341;15053
150670;201404;6175;18217;5390;17270;1733;5643;2831;9675;4564;15318
150680;201404;50910;200130;47810;194430;16757;68764;20697;90827;37454;159591
150690;201404;1813;6009;1687;5781;282;977;1074;3803;1356;4780
150700;201404;5808;18366;5435;17884;1187;3874;3498;11849;4685;15723
150710;201404;4270;13833;3863;13195;451;1382;2977;10472;3428;11854
150715;201404;4963;16373;4474;15668;636;2338;3354;11931;3990;14269
150720;201404;6488;26785;6149;26171;1074;4334;4251;19079;5325;23413
150730;201404;9092;31776;8574;31087;1153;4072;6841;25452;7994;29524
150740;201404;3643;11856;3346;11327;483;1762;2223;7629;2706;9391
150745;201404;5889;18753;5473;18193;1126;3975;3658;12241;4784;16216
150746;201404;1420;4651;1351;4527;201;733;889;3004;1090;3737
150747;201404;5017;16585;4593;16030;517;1697;3530;12952;4047;14649
150750;201404;2834;9801;2766;9717;122;281;2582;9269;2704;9550
150760;201404;11295;37196;10754;36470;2734;9244;6340;22384;9074;31628
150770;201404;5629;21466;5427;21138;898;3299;4044;16685;4942;19984
150775;201404;1116;3608;1011;3409;196;807;607;1950;803;2757
150780;201404;3004;10210;2977;10181;90;211;2813;9792;2903;10003
150790;201404;4960;16125;4638;15739;353;1006;3935;13892;4288;14898
150795;201404;15222;47450;13811;45412;2525;8051;9296;31949;11821;40000
150796;201404;2799;8723;2676;8571;441;1383;1971;6554;2412;7937
150797;201404;3726;12603;3563;12353;180;688;3129;10926;3309;11614
150800;201404;14080;47659;12903;46213;3236;11060;8142;31024;11378;42084
150803;201404;6827;24880;6521;24445;902;3457;4712;18228;5614;21685
150805;201404;2722;9588;2524;9289;365;1314;1816;6885;2181;8199
150808;201404;5847;20245;5058;18772;2159;8551;1025;3901;3184;12452
150810;201404;19396;61691;16465;58104;2662;8977;11513;42998;14175;51975
150812;201404;5308;16602;4905;16028;457;1904;3728;11809;4185;13713
150815;201404;8820;28552;7992;27536;1192;3954;6107;21796;7299;25750
150820;201404;10524;31191;9633;30220;654;1364;8506;27714;9160;29078
150830;201404;12387;48186;11669;46921;733;3153;9574;39715;10307;42868
150835;201404;2026;7493;1891;7182;545;2213;820;3121;1365;5334
150840;201404;7445;21797;5992;19832;1475;5488;3167;10218;4642;15706
160005;201404;699;2697;664;2629;118;540;402;1578;520;2118
160010;201404;1538;5252;1527;5240;152;396;1319;4711;1471;5107
160015;201404;1616;6062;1576;5990;247;882;1150;4614;1397;5496
160020;201404;2286;7651;2133;7442;324;1177;1494;5365;1818;6542
160021;201404;865;3731;844;3696;159;718;585;2641;744;3359
160023;201404;1040;4065;1024;4039;92;316;882;3573;974;3889
160025;201404;1254;3645;1218;3607;21;73;1177;3485;1198;3558
160027;201404;8064;25201;7598;24670;2606;8511;3822;13137;6428;21648
160030;201404;39964;148784;36921;142303;8966;34514;22113;88209;31079;122723
160040;201404;4176;16273;4096;16156;164;699;3781;14950;3945;15649
160050;201404;3411;12832;3088;12365;1121;4381;1462;6352;2583;10733
160053;201404;2563;10191;2508;10112;666;2730;1552;6447;2218;9177
160055;201404;758;2975;744;2957;143;629;523;2087;666;2716
160060;201404;17385;58983;16409;57890;4768;15931;9870;37097;14638;53028
160070;201404;2117;8855;2082;8789;191;795;1773;7630;1964;8425
160080;201404;2635;9885;2623;9863;116;385;2453;9347;2569;9732
170025;201404;561;1919;514;1844;180;679;220;826;400;1505
170030;201404;1193;3937;1081;3727;316;1131;452;1580;768;2711
170035;201404;1537;4677;1282;4196;439;1548;373;1236;812;2784
170040;201404;1845;6150;1624;5821;289;1221;1042;3718;1331;4939
170070;201404;2095;5739;1716;5260;534;1776;807;2493;1341;4269
170100;201404;2564;7260;2272;6757;342;1106;1647;4895;1989;6001
170105;201404;741;2420;623;2184;129;541;303;1011;432;1552
170110;201404;1208;3785;1058;3534;240;839;572;1920;812;2759
170130;201404;1423;4508;1254;4267;221;762;794;2822;1015;3584
170190;201404;1667;4825;1346;4346;593;1905;309;1156;902;3061
170200;201404;1555;4787;1210;4167;337;1287;367;1217;704;2504
170210;201404;29532;91361;25579;84573;8996;32094;8068;27520;17064;59614
170215;201404;1147;3656;1034;3486;134;474;772;2648;906;3122
170220;201404;6499;21715;5988;20885;977;3631;3902;13963;4879;17594
170230;201404;1521;5021;1324;4652;325;1314;613;2085;938;3399
170240;201404;2985;8537;2401;7758;341;1224;1586;5171;1927;6395
170255;201404;3639;11732;3078;10826;1044;3736;1200;4485;2244;8221
170270;201404;1061;2736;764;2331;122;408;484;1456;606;1864
170290;201404;2950;8980;2621;8584;194;541;2201;7549;2395;8090
170300;201404;2034;6502;1791;6093;300;1132;1167;4005;1467;5137
170305;201404;774;2429;640;2177;127;491;356;1201;483;1692
170307;201404;1098;3890;954;3619;226;908;448;1815;674;2723
170310;201404;1709;4735;1367;4188;360;1136;603;1959;963;3095
170320;201404;1063;3106;817;2668;216;740;367;1248;583;1988
170330;201404;856;2625;725;2462;131;470;475;1602;606;2072
170360;201404;463;1601;431;1545;104;393;157;545;261;938
170370;201404;1388;4146;1146;3775;217;809;564;1849;781;2658
170380;201404;2117;6714;1727;6125;391;1569;884;3086;1275;4655
170382;201404;554;1857;486;1752;120;483;273;955;393;1438
170384;201404;1565;6489;1479;6335;368;1637;873;3824;1241;5461
170386;201404;937;2814;801;2619;218;809;364;1194;582;2003
170388;201404;653;1976;567;1831;120;456;225;710;345;1166
170389;201404;920;3122;853;3017;128;544;577;1992;705;2536
170390;201404;1360;4019;1180;3791;177;608;857;2817;1034;3425
170410;201404;476;1578;445;1519;60;239;291;983;351;1222
170460;201404;522;1434;387;1203;102;345;130;404;232;749
170510;201404;766;2668;655;2491;121;518;341;1290;462;1808
170550;201404;5673;17684;4665;15870;1780;6568;1099;3782;2879;10350
170555;201404;1380;4065;1124;3673;300;1073;557;1815;857;2888
170560;201404;980;3363;810;3146;165;683;518;2082;683;2765
170600;201404;1326;3825;1172;3637;137;442;887;2817;1024;3259
170610;201404;1655;5051;1309;4500;179;677;778;2720;957;3397
170625;201404;442;1391;350;1207;81;282;90;326;171;608
170650;201404;1289;4129;1137;3866;294;1089;533;1842;827;2931
170700;201404;4021;13432;3392;12390;839;3384;1571;5964;2410;9348
170710;201404;1799;5366;1474;4817;209;755;947;3099;1156;3854
170720;201404;1851;5003;1598;4611;310;905;1068;3144;1378;4049
170730;201404;1122;3223;929;2936;297;1034;394;1244;691;2278
170740;201404;2235;7965;1983;7514;318;1310;1327;5067;1645;6377
170755;201404;894;2802;756;2511;191;710;266;824;457;1534
170765;201404;1592;4325;1289;3835;331;1079;536;1638;867;2717
170770;201404;1825;6318;1707;6100;368;1346;989;3667;1357;5013
170820;201404;4175;13423;3779;12798;1075;3836;1564;5440;2639;9276
170825;201404;783;2385;602;2029;142;532;225;732;367;1264
170830;201404;1380;4135;1244;3911;33;71;1107;3539;1140;3610
170900;201404;2899;10158;2770;9916;352;1255;2035;7563;2387;8818
170930;201404;4243;13013;3493;11915;1355;4896;1118;3805;2473;8701
170950;201404;13326;39110;10227;33837;3874;14402;2250;7113;6124;21515
170980;201404;533;1608;422;1431;94;351;249;837;343;1188
171050;201404;1324;4731;1253;4600;53;238;1104;4013;1157;4251
171070;201404;1706;5398;1579;5230;322;1109;974;3328;1296;4437
171090;201404;967;2816;820;2589;87;299;596;1880;683;2179
171110;201404;656;1932;528;1728;152;541;269;855;421;1396
171150;201404;852;2556;640;2165;126;464;349;1189;475;1653
171180;201404;639;2008;489;1701;136;509;174;642;310;1151
171190;201404;1891;6881;1637;6366;392;1614;774;3143;1166;4757
171195;201404;872;3138;788;2984;97;423;491;1905;588;2328
171200;201404;691;2250;570;2028;145;596;256;854;401;1450
171215;201404;477;1421;368;1229;66;242;156;537;222;779
171240;201404;795;2739;750;2664;87;274;570;2121;657;2395
171245;201404;668;2220;565;1980;121;466;231;799;352;1265
171250;201404;1177;3409;1026;3203;82;284;802;2493;884;2777
171270;201404;422;1726;395;1667;110;437;181;842;291;1279
171280;201404;907;2850;805;2677;189;618;398;1466;587;2084
171320;201404;4125;12626;3536;11739;1158;4039;1606;5360;2764;9399
171330;201404;2842;8621;2496;8113;644;2286;1324;4319;1968;6605
171360;201404;1518;4927;1300;4600;308;1127;707;2571;1015;3698
171370;201404;772;2171;692;2047;155;517;355;1027;510;1544
171380;201404;1316;4428;1134;4068;372;1369;443;1619;815;2988
171395;201404;902;2786;746;2500;145;549;364;1216;509;1765
171420;201404;2270;6965;1838;6193;475;1747;778;2632;1253;4379
171430;201404;1027;3246;905;3065;202;692;527;1811;729;2503
171488;201404;2462;7604;2258;7310;592;1916;1181;4031;1773;5947
171500;201404;888;2748;788;2558;127;373;448;1504;575;1877
171510;201404;937;3362;851;3227;162;651;520;2055;682;2706
171515;201404;622;1790;481;1578;112;378;223;740;335;1118
171525;201404;606;2033;512;1858;103;420;274;985;377;1405
171550;201404;343;1158;291;1052;112;461;36;126;148;587
171570;201404;1267;3927;1120;3685;236;790;703;2372;939;3162
171575;201404;1990;5755;1582;5007;387;1262;697;2314;1084;3576
171610;201404;6247;21446;5717;20442;1910;7275;1906;6807;3816;14082
171620;201404;2359;7341;2146;7020;164;598;1750;5774;1914;6372
171630;201404;896;2969;746;2706;194;767;287;1033;481;1800
171650;201404;2431;7631;2018;6895;559;2053;808;2713;1367;4766
171660;201404;2651;7322;2125;6398;434;1393;1142;3486;1576;4879
171665;201404;1444;4360;1215;3989;215;789;744;2506;959;3295
171670;201404;2379;6459;1920;5815;470;1554;1024;3009;1494;4563
171700;201404;1143;3812;1030;3617;168;654;625;2198;793;2852
171720;201404;717;2235;633;2081;216;738;267;896;483;1634
171750;201404;1300;4259;1147;3961;390;1413;385;1342;775;2755
171780;201404;1238;3433;902;2947;141;524;470;1545;611;2069
171790;201404;1739;5596;1433;5160;284;1027;850;3228;1134;4255
171800;201404;728;2321;663;2227;98;369;445;1512;543;1881
171820;201404;9964;30656;9094;29573;2125;7497;5190;17088;7315;24585
171830;201404;1620;5938;1495;5670;378;1529;670;2563;1048;4092
171840;201404;812;2365;718;2239;58;188;556;1748;614;1936
171845;201404;821;2233;647;1940;105;374;365;1055;470;1429
171850;201404;1017;3665;910;3438;105;465;591;2226;696;2691
171855;201404;1264;3999;1141;3798;113;475;854;2769;967;3244
171865;201404;499;1595;418;1474;114;448;193;659;307;1107
171870;201404;682;2203;570;2001;130;476;256;943;386;1419
171875;201404;1392;4430;1175;4103;175;688;819;2841;994;3529
171880;201404;981;3522;961;3488;121;464;712;2670;833;3134
171884;201404;921;2631;677;2266;156;568;237;828;393;1396
171886;201404;1514;5150;1338;4779;450;1720;437;1593;887;3313
171888;201404;685;2125;575;1920;96;330;341;1186;437;1516
171889;201404;489;1608;464;1552;105;343;264;917;369;1260
171890;201404;1135;3776;1027;3620;135;564;686;2419;821;2983
171900;201404;461;1847;440;1799;125;499;208;875;333;1374
172000;201404;662;2145;566;2002;101;417;319;1098;420;1515
172010;201404;1176;4101;1120;4007;114;464;863;3100;977;3564
172015;201404;357;1356;309;1282;58;231;176;782;234;1013
172020;201404;2385;7886;2149;7534;305;1162;1495;5333;1800;6495
172025;201404;753;2216;599;1937;104;360;310;1002;414;1362
172030;201404;1101;3754;993;3555;137;580;649;2320;786;2900
172049;201404;1130;3203;1042;3076;141;407;766;2336;907;2743
172065;201404;1267;3723;1067;3469;119;434;859;2797;978;3231
172080;201404;2611;8046;2208;7366;276;1088;1470;4808;1746;5896
172085;201404;518;1421;402;1211;87;284;117;346;204;630
172090;201404;3513;10522;2727;9446;569;2107;1595;5689;2164;7796
172093;201404;585;1868;457;1638;185;766;165;566;350;1332
172097;201404;711;2093;589;1893;159;574;212;662;371;1236
172100;201404;26763;91219;23500;84633;8050;31814;6077;21661;14127;53475
172110;201404;1703;6237;1573;6046;148;542;1229;4900;1377;5442
172120;201404;5607;16855;4647;15631;510;1802;3458;11902;3968;13704
172125;201404;329;1012;270;926;58;224;125;432;183;656
172130;201404;524;1518;459;1419;72;245;301;960;373;1205
172208;201404;2180;6794;2047;6578;427;1492;1126;3634;1553;5126
172210;201404;2349;7224;2182;6980;323;1138;1532;4809;1855;5947
210005;201404;21762;71281;19562;67801;6113;22531;9239;32454;15352;54985
210010;201404;1626;5810;1460;5578;160;604;1105;4383;1265;4987
210015;201404;3521;10973;3232;10545;298;653;2622;9111;2920;9764
210020;201404;7302;18355;6839;17792;487;1398;5527;14578;6014;15976
210030;201404;5877;19698;5573;19286;463;1887;4604;15874;5067;17761
210040;201404;1956;5646;1784;5440;209;655;1349;4166;1558;4821
210043;201404;6152;18478;5627;17770;529;1638;4462;14546;4991;16184
210047;201404;6701;26389;6261;25614;896;4015;4243;17560;5139;21575
210050;201404;2496;8906;2006;8196;487;1978;1015;4429;1502;6407
210055;201404;1717;5933;1600;5767;227;792;1160;4265;1387;5057
210060;201404;7892;29307;7129;28097;790;3460;5221;21052;6011;24512
210070;201404;6951;20808;6554;20305;315;1061;5750;17937;6065;18998
210080;201404;3740;12899;3672;12801;81;323;3447;12061;3528;12384
210083;201404;4091;14144;3921;13953;159;557;3616;13026;3775;13583
210087;201404;2607;8166;2460;7990;219;766;2075;6783;2294;7549
210090;201404;9942;32963;9558;32330;489;1855;8267;28088;8756;29943
210095;201404;6162;23484;6007;23235;713;2698;4772;18941;5485;21639
210100;201404;7584;22694;7153;22195;328;1197;6340;19670;6668;20867
210110;201404;3214;11126;3124;11009;204;771;2626;9445;2830;10216
210120;201404;25861;75072;22198;70613;2566;8501;16651;54189;19217;62690
210125;201404;3392;11146;3253;10993;267;813;2814;9738;3081;10551
210130;201404;3996;12178;3821;11944;433;1325;3020;9556;3453;10881
210135;201404;1661;4899;1478;4628;124;394;1206;3845;1330;4239
210140;201404;17721;56636;15015;53047;3437;12431;8945;33016;12382;45447
210150;201404;4648;11845;4252;11356;146;385;3878;10360;4024;10745
210160;201404;18545;60607;17376;58883;2616;8454;13044;45790;15660;54244
210170;201404;14044;52201;13836;51914;1031;3490;12070;46336;13101;49826
210173;201404;1794;7741;1744;7642;126;599;1507;6657;1633;7256
210177;201404;2945;9625;2789;9427;317;1226;2196;7358;2513;8584
210180;201404;1509;4704;1430;4588;91;325;1202;3850;1293;4175
210190;201404;5128;16577;4820;16050;374;1642;3638;11824;4012;13466
210193;201404;1444;4640;1335;4456;92;359;1072;3626;1164;3985
210197;201404;1930;6504;1795;6355;161;526;1492;5461;1653;5987
210200;201404;9249;31097;8530;30055;1275;4234;6125;22669;7400;26903
210203;201404;6270;21370;5922;20931;469;1531;5095;18362;5564;19893
210207;201404;3058;10254;2873;9922;423;1401;2027;7225;2450;8626
210210;201404;8858;30010;8510;29528;293;1085;7484;26528;7777;27613
210215;201404;1713;6816;1662;6727;186;841;1320;5369;1506;6210
210220;201404;6298;24339;6069;23959;516;2042;4886;19824;5402;21866
210230;201404;5376;18334;5004;17748;450;1653;4012;14417;4462;16070
210232;201404;11811;40954;10495;39316;2108;7928;6878;27517;8986;35445
210235;201404;3544;11019;3191;10580;266;899;2667;8964;2933;9863
210237;201404;2529;9241;2502;9206;49;122;2412;8992;2461;9114
210240;201404;2977;9515;2856;9334;263;745;2303;7749;2566;8494
210250;201404;5033;15953;4824;15690;145;527;4481;14653;4626;15180
210255;201404;2729;8933;2500;8548;554;2045;1492;5152;2046;7197
210260;201404;5215;16774;4772;16099;674;2231;3424;11842;4098;14073
210270;201404;5281;15194;4721;14432;143;515;4178;12863;4321;13378
210275;201404;3522;9036;3311;8810;131;279;3111;8387;3242;8666
210280;201404;5984;17564;5190;16559;370;1275;4284;13806;4654;15081
210290;201404;5808;18709;5356;18155;512;1673;4372;15190;4884;16863
210300;201404;37491;112311;31418;104589;3176;11305;24447;83635;27623;94940
210310;201404;2880;8345;2744;8143;128;382;2399;7155;2527;7537
210312;201404;2192;7107;2146;7034;121;480;1905;6230;2026;6710
210315;201404;2380;8529;2283;8389;141;591;1952;7222;2093;7813
210317;201404;4317;12945;4148;12727;312;919;3580;11184;3892;12103
210320;201404;19564;61978;18360;60537;1187;3875;15955;53669;17142;57544
210325;201404;3592;11489;3237;10958;340;1265;2513;8564;2853;9829
210330;201404;32782;87058;28148;82005;3881;9686;20675;65879;24556;75565
210340;201404;11976;37376;10989;36158;1487;4132;8079;28543;9566;32675
210350;201404;10448;32909;9705;31859;804;2720;7747;25972;8551;28692
210355;201404;3946;14323;3630;13921;138;385;3326;13156;3464;13541
210360;201404;16752;52014;15710;50506;1489;4947;12266;40210;13755;45157
210370;201404;8223;21841;7356;20915;365;841;6509;19041;6874;19882
210375;201404;3241;9990;2816;9477;488;1784;1994;6821;2482;8605
210380;201404;6311;18459;5691;17564;715;2000;4458;14230;5173;16230
210390;201404;2783;9909;2577;9567;126;569;2260;8419;2386;8988
210400;201404;4899;15724;4730;15518;341;1056;4101;13692;4442;14748
210405;201404;8787;24692;7210;22543;2253;7138;3153;10758;5406;17896
210407;201404;2096;7419;1871;7068;205;732;1399;5514;1604;6246
210408;201404;2159;8734;2064;8619;88;357;1871;8011;1959;8368
210409;201404;3945;14340;3753;14044;279;1081;3022;11607;3301;12688
210410;201404;3587;11595;3359;11313;360;1143;2779;9598;3139;10741
210420;201404;4223;14082;3947;13601;351;1213;3158;11102;3509;12315
210430;201404;2078;6637;2034;6583;152;527;1741;5675;1893;6202
210440;201404;4273;13479;4177;13331;213;687;3722;12006;3935;12693
210450;201404;2903;9252;2654;8874;233;844;2137;7148;2370;7992
210455;201404;4202;12658;3634;11805;748;2501;2254;7536;3002;10037
210460;201404;4059;13122;3810;12792;207;791;3262;11049;3469;11840
210462;201404;1790;6457;1723;6322;174;670;1309;4903;1483;5573
210465;201404;2697;8861;2545;8669;381;1105;1969;7045;2350;8150
210467;201404;6236;20827;5839;20334;488;1493;4865;17623;5353;19116
210470;201404;1983;5604;1596;5038;94;323;1255;4016;1349;4339
210480;201404;13810;46288;12274;44194;3885;13916;5950;23264;9835;37180
210490;201404;3458;10511;3222;10158;347;1162;2512;7944;2859;9106
210500;201404;6765;26657;6498;26191;724;2845;5044;21138;5768;23983
210510;201404;6916;23033;6665;22745;342;756;5846;20972;6188;21728
210515;201404;3458;11342;3360;11222;178;530;3041;10338;3219;10868
210520;201404;2736;8696;2560;8443;216;708;2091;7045;2307;7753
210530;201404;40492;134059;35069;125788;11254;43644;16509;60558;27763;104202
210535;201404;3193;11241;3098;11083;187;650;2684;9733;2871;10383
210540;201404;13046;45226;11641;42978;3080;11180;5831;23655;8911;34835
210542;201404;6449;18747;5651;17877;342;976;4944;16053;5286;17029
210545;201404;2236;7553;2135;7382;90;428;1842;6332;1932;6760
210547;201404;3790;13382;3553;13019;274;950;2882;10814;3156;11764
210550;201404;6386;18146;5564;17233;306;728;5021;15999;5327;16727
210560;201404;4174;13302;3762;12638;279;1073;3088;10354;3367;11427
210565;201404;1544;5343;1338;5034;134;634;990;3703;1124;4337
210570;201404;12748;36754;11629;35456;1038;2703;9617;30450;10655;33153
210580;201404;3136;9596;2788;9152;364;1004;2111;7451;2475;8455
210590;201404;4457;13748;4191;13430;311;957;3599;11765;3910;12722
210592;201404;2485;7980;2412;7866;104;395;2105;6849;2209;7244
210594;201404;2757;7959;2322;7374;154;457;1930;6296;2084;6753
210596;201404;2854;10673;2712;10417;327;1293;1991;7802;2318;9095
210598;201404;2007;6220;1880;6067;116;454;1666;5326;1782;5780
210600;201404;3338;9961;3087;9607;407;1272;2311;7244;2718;8516
210610;201404;2684;8616;2415;8289;242;902;1979;6809;2221;7711
210620;201404;1847;5730;1706;5549;64;175;1551;5114;1615;5289
210630;201404;3473;12849;3061;12050;555;2194;1839;7534;2394;9728
210632;201404;4810;16669;4424;16130;498;1820;3477;12901;3975;14721
210635;201404;1896;6773;1823;6663;108;373;1605;5977;1713;6350
210637;201404;2793;9585;2651;9385;131;469;2346;8413;2477;8882
210640;201404;4275;14430;4179;14323;23;70;4081;14081;4104;14151
210650;201404;6897;21082;6783;20944;167;484;6462;20099;6629;20583
210660;201404;7541;23517;7061;22770;280;781;6457;20981;6737;21762
210663;201404;2686;7882;2544;7698;149;521;2164;6581;2313;7102
210667;201404;1697;6196;1625;6085;84;392;1413;5313;1497;5705
210670;201404;4757;17724;4603;17463;447;1697;3554;13920;4001;15617
210675;201404;4846;13637;4587;13311;330;862;3926;11661;4256;12523
210680;201404;4569;12944;4090;12397;241;692;3512;10810;3753;11502
210690;201404;6863;23546;6588;23252;294;1013;5997;21435;6291;22448
210700;201404;2638;7468;2358;7145;251;513;1826;6163;2077;6676
210710;201404;4914;16084;4722;15780;200;700;4169;14013;4369;14713
210720;201404;2453;9114;2339;8948;149;659;2028;7738;2177;8397
210725;201404;1186;4410;1030;4125;135;588;631;2579;766;3167
210730;201404;1220;3823;1083;3670;115;341;872;3052;987;3393
210735;201404;3847;14199;3615;13787;672;2598;2434;9627;3106;12225
210740;201404;5109;14228;4773;13889;214;542;4411;13071;4625;13613
210745;201404;3723;11443;3514;11151;335;869;2852;9284;3187;10153
210750;201404;20244;56643;18521;54673;2347;6973;14559;43746;16906;50719
210760;201404;5966;16422;5657;16081;78;243;5470;15570;5548;15813
210770;201404;6257;17166;5327;16107;270;885;4705;14249;4975;15134
210780;201404;8654;29284;8065;28190;1141;4187;5600;19996;6741;24183
210790;201404;4828;14650;4170;13909;318;830;3539;12375;3857;13205
210800;201404;5046;14307;4616;13832;213;689;3925;12230;4138;12919
210805;201404;3730;15857;3634;15669;190;851;3118;13765;3308;14616
210810;201404;5676;17349;5128;16719;474;1103;4351;14923;4825;16026
210820;201404;9023;26065;8464;25300;1647;4965;5497;16935;7144;21900
210825;201404;5531;18686;5360;18469;252;869;4779;16719;5031;17588
210830;201404;8508;26496;8174;26123;354;992;7352;24029;7706;25021
210840;201404;3799;10589;3510;10181;329;795;2747;8152;3076;8947
210845;201404;5545;17708;5345;17484;290;793;4693;15893;4983;16686
210850;201404;6060;22425;5652;21712;924;3969;3874;14945;4798;18914
210860;201404;17295;53818;16218;52369;1385;4818;13109;42639;14494;47457
210870;201404;6513;21430;5924;20674;784;2618;4371;15757;5155;18375
210880;201404;4202;13717;4117;13599;227;743;3672;12281;3899;13024
210890;201404;5380;16314;5045;15894;503;1735;4071;12820;4574;14555
210900;201404;4765;15612;4365;14924;1523;5371;1863;6704;3386;12075
210905;201404;1831;5793;1728;5656;125;321;1449;4891;1574;5212
210910;201404;10615;33531;9958;32492;1939;6783;6384;21013;8323;27796
210920;201404;3412;11447;3320;11326;168;543;2957;10282;3125;10825
210923;201404;1528;5703;1463;5604;201;810;1027;4109;1228;4919
210927;201404;4716;15002;4593;14876;36;97;4519;14692;4555;14789
210930;201404;2670;9731;2562;9587;207;943;2136;7974;2343;8917
210940;201404;2912;11552;2864;11457;307;1132;2299;9429;2606;10561
210945;201404;5962;17624;5753;17410;199;253;5487;17032;5686;17285
210950;201404;5641;17718;4956;16702;665;2315;3514;12157;4179;14472
210955;201404;1931;6478;1750;6184;302;1150;1160;4187;1462;5337
210960;201404;9315;30925;8966;30416;2474;8151;5428;19492;7902;27643
210970;201404;1381;5009;1224;4773;173;767;862;3379;1035;4146
210975;201404;1740;6040;1658;5896;181;645;1262;4576;1443;5221
210980;201404;9078;22701;8863;22460;662;1417;7752;20103;8414;21520
210990;201404;16805;48742;13437;44727;2744;9736;8256;28259;11000;37995
211000;201404;16454;53286;14964;51427;1040;3661;12697;44584;13737;48245
211003;201404;5140;18109;4719;17472;598;2381;3356;12790;3954;15171
211010;201404;6722;22816;6563;22628;134;444;6162;21498;6296;21942
211020;201404;7499;23228;7358;22998;209;449;6937;21916;7146;22365
211023;201404;2445;8323;2374;8197;172;611;1970;6949;2142;7560
211027;201404;3058;11935;2946;11759;295;1109;2320;9677;2615;10786
211030;201404;4280;13119;3853;12634;851;2303;2710;9550;3561;11853
211040;201404;4166;16032;4054;15846;158;664;3556;14201;3714;14865
211050;201404;10245;27630;10090;27452;470;1220;9356;25604;9826;26824
211060;201404;5917;21509;5795;21287;717;2461;4559;17289;5276;19750
211065;201404;1716;5975;1589;5807;57;215;1472;5437;1529;5652
211070;201404;8691;29603;8204;28757;783;2763;6454;23109;7237;25872
211080;201404;1348;4214;1108;3880;86;423;893;3047;979;3470
211085;201404;2055;6910;1780;6528;321;1148;1210;4600;1531;5748
211090;201404;3578;11217;3372;10937;218;853;2843;9149;3061;10002
211100;201404;6827;18009;6660;17811;92;334;6333;16891;6425;17225
211102;201404;3130;11670;3015;11508;332;1200;2449;9639;2781;10839
211105;201404;2831;9034;2501;8581;205;757;2042;7022;2247;7779
211107;201404;4536;14129;4166;13635;227;740;3611;12090;3838;12830
211110;201404;6566;19790;5225;17894;933;3121;3331;12080;4264;15201
211120;201404;32263;90082;28322;85159;4348;12737;19824;62195;24172;74932
211125;201404;2204;7148;2010;6848;173;602;1634;5642;1807;6244
211130;201404;148833;440503;139985;429233;29938;91767;92310;291000;122248;382767
211140;201404;5644;18186;5347;17718;291;1027;4586;15249;4877;16276
211150;201404;9984;30346;9426;29645;723;2310;7968;25420;8691;27730
211153;201404;3192;9668;2931;9368;334;898;2380;7974;2714;8872
211157;201404;1255;4126;1082;3862;137;598;737;2726;874;3324
211160;201404;4233;14508;3659;13540;400;1728;2640;9734;3040;11462
211163;201404;1733;5729;1644;5608;61;211;1469;5134;1530;5345
211167;201404;1491;5097;1387;4931;50;202;1239;4426;1289;4628
211170;201404;6763;18109;6538;17832;154;493;6056;16466;6210;16959
211172;201404;2407;7103;2126;6683;173;667;1721;5284;1894;5951
211174;201404;2844;8464;2618;8179;125;509;2270;7022;2395;7531
211176;201404;5633;16485;4796;15517;625;1722;3645;12429;4270;14151
211178;201404;3218;10015;3154;9945;89;203;2995;9594;3084;9797
211180;201404;4475;15911;4200;15486;408;1622;3302;12385;3710;14007
211190;201404;2827;9554;2590;9215;129;559;2213;7937;2342;8496
211195;201404;1464;4646;1266;4405;117;396;1017;3646;1134;4042
211200;201404;2161;7552;1953;7273;282;987;1410;5570;1692;6557
211210;201404;6950;22110;6753;21824;482;1549;5767;18873;6249;20422
211220;201404;35884;107414;31590;101846;7320;24432;18982;63227;26302;87659
211223;201404;5964;17261;5544;16590;823;2521;3628;11405;4451;13926
211227;201404;1593;5948;1512;5823;141;644;1191;4586;1332;5230
211230;201404;9050;30767;8353;29572;1330;4808;5765;20935;7095;25743
211240;201404;8410;28366;8160;28070;360;1286;7483;25908;7843;27194
211245;201404;5271;15475;5203;15391;178;440;4857;14575;5035;15015
211250;201404;12055;44133;11468;43453;1475;4280;9244;37305;10719;41585
211260;201404;8261;26204;8135;26025;482;1482;7301;23619;7783;25101
211270;201404;10122;36154;9556;35402;644;2670;7916;29788;8560;32458
211280;201404;12314;36455;11809;35855;1338;3380;9720;30741;11058;34121
211285;201404;2013;7090;1744;6608;423;1703;831;3321;1254;5024
211290;201404;7759;25540;7572;25313;695;2024;6303;21694;6998;23718
211300;201404;8667;26719;7883;25592;591;2019;6501;21285;7092;23304
211400;201404;12321;36398;10628;34483;2554;8262;6054;21907;8608;30169
220005;201404;1702;5046;1626;4929;50;230;1415;4166;1465;4396
220010;201404;1748;4634;1329;4106;135;501;1028;3111;1163;3612
220020;201404;3760;11539;3561;11203;637;2164;2280;7132;2917;9296
220025;201404;2161;5401;1968;5102;50;152;1731;4444;1781;4596
220027;201404;1412;3864;1311;3735;107;246;1089;3195;1196;3441
220030;201404;3390;10154;3321;10041;301;979;2751;8345;3052;9324
220040;201404;8543;26672;8167;26058;1681;5567;4934;15904;6615;21471
220045;201404;1455;4709;1322;4487;135;503;944;3170;1079;3673
220050;201404;4853;14080;4275;13245;358;1340;3408;10382;3766;11722
220060;201404;2073;5448;1976;5333;97;270;1792;4842;1889;5112
220070;201404;2606;7705;2330;7307;224;705;1771;5623;1995;6328
220080;201404;831;2592;789;2523;95;386;555;1707;650;2093
220090;201404;1861;4916;1636;4599;134;451;1313;3594;1447;4045
220095;201404;680;1917;650;1864;28;87;599;1704;627;1791
220100;201404;1409;4279;1205;3944;133;436;884;2957;1017;3393
220105;201404;2251;7453;2092;7152;206;711;1494;5161;1700;5872
220110;201404;3589;10502;3170;9890;276;1037;2549;7810;2825;8847
220115;201404;2207;8127;2132;8007;320;1262;1632;6175;1952;7437
220117;201404;1429;3805;1182;3450;79;250;953;2764;1032;3014
220120;201404;12845;37124;11945;35994;374;1422;10872;32723;11246;34145
220130;201404;837;3024;740;2901;57;175;640;2593;697;2768
220140;201404;1633;4397;1504;4234;287;652;1151;3412;1438;4064
220150;201404;7292;23052;6992;22630;422;1639;5943;19164;6365;20803
220155;201404;1067;3375;908;3074;77;312;620;2054;697;2366
220157;201404;1055;2731;968;2604;44;116;820;2212;864;2328
220160;201404;2877;8632;2587;8135;190;740;1976;6159;2166;6899
220170;201404;1314;4242;1204;4052;102;392;943;3168;1045;3560
220173;201404;2107;6413;1742;5716;78;362;1399;4524;1477;4886
220177;201404;1743;5130;1712;5080;72;230;1572;4663;1644;4893
220180;201404;1172;3206;1040;3001;59;196;784;2212;843;2408
220190;201404;4707;15471;4145;14755;531;1906;3170;11480;3701;13386
220191;201404;1473;4980;1407;4864;265;875;965;3385;1230;4260
220192;201404;1772;5107;1428;4509;165;535;984;3113;1149;3648
220194;201404;1734;5093;1571;4812;186;634;1132;3370;1318;4004
220196;201404;2079;6267;1945;6039;216;761;1462;4528;1678;5289
220198;201404;1335;3721;1082;3388;23;79;1001;3166;1024;3245
220200;201404;4671;16199;4425;15818;754;2893;3022;10826;3776;13719
220202;201404;2080;6552;1891;6215;61;262;1655;5400;1716;5662
220205;201404;2972;7803;2618;7336;95;360;2281;6299;2376;6659
220207;201404;918;2845;800;2638;94;349;593;1945;687;2294
220208;201404;1698;5889;1561;5652;264;1122;1031;3685;1295;4807
220209;201404;1583;4985;1449;4756;86;337;1102;3627;1188;3964
220210;201404;1892;5022;1660;4721;95;329;1292;3679;1387;4008
220211;201404;1664;4997;1578;4883;103;466;1299;3959;1402;4425
220213;201404;1845;5370;1718;5137;103;362;1340;3936;1443;4298
220217;201404;1805;5950;1741;5870;69;209;1592;5442;1661;5651
220220;201404;11823;34096;10891;32623;1352;3962;7595;23383;8947;27345
220225;201404;1003;3098;926;2981;41;173;789;2502;830;2675
220230;201404;6122;16214;5122;14876;265;761;4460;13032;4725;13793
220240;201404;2701;8758;2572;8525;200;746;1992;6529;2192;7275
220245;201404;1450;3986;1345;3843;63;173;1172;3386;1235;3559
220250;201404;3379;9188;3045;8743;59;143;2817;8195;2876;8338
220253;201404;1872;5596;1629;5173;125;461;1188;3801;1313;4262
220255;201404;1787;5095;1583;4745;107;424;1279;3714;1386;4138
220260;201404;5256;16958;4735;15982;472;1749;3457;11698;3929;13447
220265;201404;1246;4546;1185;4438;110;516;855;3181;965;3697
220270;201404;6777;22506;6614;22216;420;1898;5569;18258;5989;20156
220271;201404;1561;4398;1471;4267;70;208;1266;3718;1336;3926
220272;201404;1793;5605;1664;5402;107;441;1296;4177;1403;4618
220273;201404;1317;3800;1152;3542;114;378;863;2633;977;3011
220275;201404;2105;5627;1805;5241;77;247;1562;4543;1639;4790
220277;201404;2614;7137;2218;6534;164;531;1712;5084;1876;5615
220280;201404;1792;4690;1566;4360;109;399;1236;3378;1345;3777
220285;201404;1692;4599;1517;4359;96;290;1257;3707;1353;3997
220290;201404;6641;21661;5631;20361;573;2207;4315;15827;4888;18034
220300;201404;1934;6354;1707;6049;101;461;1429;5047;1530;5508
220310;201404;2659;8612;2217;8081;87;275;1992;7503;2079;7778
220320;201404;3438;10178;2895;9268;438;1486;2014;6474;2452;7960
220323;201404;1426;5292;1304;5119;164;712;963;3800;1127;4512
220325;201404;1287;4077;1183;3872;154;545;779;2618;933;3163
220327;201404;1374;4408;1250;4201;72;347;996;3287;1068;3634
220330;201404;3782;10755;3584;10497;273;867;3009;8883;3282;9750
220335;201404;2133;6117;1926;5866;97;341;1643;5042;1740;5383
220340;201404;1863;5321;1638;4997;162;542;1243;3766;1405;4308
220342;201404;1213;4008;1164;3931;118;460;845;2993;963;3453
220345;201404;2923;7991;2511;7334;81;223;2172;6361;2253;6584
220350;201404;4503;12174;3981;11476;287;918;3138;9049;3425;9967
220360;201404;1488;4078;1178;3596;113;376;852;2598;965;2974
220370;201404;9230;26702;8433;25645;480;1388;7443;22788;7923;24176
220375;201404;1588;4948;1477;4799;83;314;1313;4250;1396;4564
220380;201404;1429;3893;1232;3617;86;276;957;2818;1043;3094
220385;201404;752;2021;661;1862;31;105;547;1498;578;1603
220390;201404;10323;32715;9472;31068;2518;8768;4093;13540;6611;22308
220400;201404;1461;3533;1305;3311;55;164;1119;2766;1174;2930
220410;201404;1392;4016;1189;3733;109;447;934;2851;1043;3298
220415;201404;892;2410;804;2293;92;255;592;1707;684;1962
220420;201404;2282;6668;2060;6224;159;461;1632;4962;1791;5423
220430;201404;2985;8717;2840;8523;363;1127;2147;6460;2510;7587
220435;201404;1690;4964;1559;4759;80;259;1286;3923;1366;4182
220440;201404;2821;8526;2349;7990;141;407;2069;7154;2210;7561
220450;201404;2742;8171;2376;7673;577;1970;1398;4526;1975;6496
220455;201404;1424;4392;1277;4191;51;174;1151;3819;1202;3993
220460;201404;1055;2917;1004;2845;73;209;854;2413;927;2622
220465;201404;2494;8243;2300;7951;571;2123;1346;4677;1917;6800
220470;201404;4107;12359;3725;11707;254;891;2859;8870;3113;9761
220480;201404;2378;7152;2181;6863;159;517;1747;5497;1906;6014
220490;201404;2445;7076;2300;6888;137;494;1952;5819;2089;6313
220500;201404;3458;9279;2906;8327;162;645;2345;6524;2507;7169
220510;201404;2952;8274;2224;7176;81;372;1740;5558;1821;5930
220515;201404;1988;4981;1759;4694;86;237;1477;3955;1563;4192
220520;201404;5120;14542;4800;14088;222;628;4199;12447;4421;13075
220525;201404;1476;4192;1371;4037;109;405;1105;3175;1214;3580
220527;201404;1460;4621;1351;4391;161;530;1014;3357;1175;3887
220530;201404;1219;3583;1121;3430;106;403;915;2717;1021;3120
220535;201404;908;2828;876;2781;87;334;686;2140;773;2474
220540;201404;3665;12244;3532;12036;282;1138;2869;9758;3151;10896
220545;201404;1450;4995;1394;4900;203;807;968;3354;1171;4161
220550;201404;9467;31029;8947;30121;1551;5570;5953;20085;7504;25655
220551;201404;1439;4926;1344;4766;130;545;1028;3609;1158;4154
220552;201404;1688;5332;1447;4910;128;590;1053;3435;1181;4025
220553;201404;1647;4906;1417;4578;87;312;1149;3706;1236;4018
220554;201404;932;2606;811;2438;114;345;576;1766;690;2111
220555;201404;2453;7236;2301;7047;100;340;1966;6109;2066;6449
220556;201404;1486;4726;1354;4473;104;427;1009;3302;1113;3729
220557;201404;1647;5462;1509;5206;214;815;971;3354;1185;4169
220558;201404;1052;3316;972;3170;102;391;731;2344;833;2735
220559;201404;1570;4476;1440;4279;75;250;1219;3622;1294;3872
220560;201404;1766;4397;1474;3999;89;245;1217;3286;1306;3531
220570;201404;7599;24321;7139;23677;1253;3934;5056;17376;6309;21310
220580;201404;6604;21660;6439;21465;406;1335;5739;19382;6145;20717
220585;201404;1968;7284;1900;7160;145;580;1570;5950;1715;6530
220590;201404;1448;4534;1310;4327;271;933;792;2660;1063;3593
220595;201404;2507;7278;2313;7019;86;302;2062;6270;2148;6572
220600;201404;1350;3389;1152;3151;228;514;742;2168;970;2682
220605;201404;2090;6222;1846;5841;108;351;1447;4594;1555;4945
220610;201404;2832;8798;2746;8676;170;668;2325;7274;2495;7942
220620;201404;7856;26875;7596;26491;416;1647;6602;23092;7018;24739
220630;201404;418;1285;358;1175;65;250;190;610;255;860
220635;201404;1894;6744;1769;6470;150;655;1153;4199;1303;4854
220640;201404;2835;8378;2703;8184;275;941;2082;6306;2357;7247
220650;201404;2512;7052;2252;6646;142;472;1809;5298;1951;5770
220660;201404;2549;8269;2064;7639;237;1016;1625;5967;1862;6983
220665;201404;1223;4219;1172;4139;52;228;1031;3617;1083;3845
220667;201404;1778;6023;1693;5907;89;344;1436;5018;1525;5362
220669;201404;1891;6240;1769;6015;268;1024;1199;4077;1467;5101
220670;201404;2173;6616;2035;6440;178;452;1723;5670;1901;6122
220672;201404;2344;6793;2260;6687;254;709;1862;5611;2116;6320
220675;201404;1384;4051;1296;3905;143;387;942;2896;1085;3283
220680;201404;2261;7449;2170;7317;219;709;1711;5909;1930;6618
220690;201404;1751;5000;1565;4694;128;458;1225;3631;1353;4089
220695;201404;894;2708;845;2627;75;259;644;1993;719;2252
220700;201404;9147;26706;8331;25497;773;2597;6386;19554;7159;22151
220710;201404;780;2372;679;2199;69;203;482;1598;551;1801
220720;201404;2161;5845;2046;5689;98;219;1803;5102;1901;5321
220730;201404;1392;3875;1214;3601;53;193;1016;2987;1069;3180
220735;201404;1062;2779;897;2499;67;216;669;1867;736;2083
220740;201404;1414;4539;1199;4242;228;785;833;3064;1061;3849
220750;201404;4028;11872;3796;11519;557;1497;2803;8854;3360;10351
220755;201404;1210;3547;1136;3428;73;222;942;2845;1015;3067
220760;201404;2677;9435;2499;9177;138;565;2151;7966;2289;8531
220770;201404;24126;82446;22351;79067;7657;28329;8619;31628;16276;59957
220775;201404;1234;3094;1204;3060;22;43;1170;2987;1192;3030
220777;201404;1708;4873;1599;4709;126;386;1275;3719;1401;4105
220779;201404;1193;3581;1158;3532;70;270;1022;3072;1092;3342
220780;201404;6293;16548;5682;15749;473;1264;4598;12935;5071;14199
220785;201404;1361;3661;1320;3577;65;176;1202;3245;1267;3421
220790;201404;9569;31232;9192;30534;986;3530;7119;23523;8105;27053
220793;201404;927;2656;854;2536;65;212;693;2052;758;2264
220795;201404;1550;4360;1502;4288;111;346;1267;3637;1378;3983
220800;201404;17432;49708;16177;47855;1905;6498;12070;35046;13975;41544
220810;201404;3394;10053;2947;9259;228;881;2297;7132;2525;8013
220820;201404;5660;15856;5184;15235;304;995;4418;13038;4722;14033
220830;201404;7767;22123;7392;21504;925;2686;5538;16326;6463;19012
220840;201404;15079;48671;13751;45978;3623;12379;6051;20965;9674;33344
220850;201404;2797;10066;2677;9885;322;1302;2098;7789;2420;9091
220855;201404;629;1964;562;1843;56;213;397;1292;453;1505
220860;201404;952;2658;885;2551;49;197;722;2035;771;2232
220865;201404;2684;7535;2186;6715;109;500;1749;5210;1858;5710
220870;201404;2456;8149;2166;7788;121;472;1895;6834;2016;7306
220880;201404;5454;14351;4993;13790;247;831;4377;12079;4624;12910
220885;201404;1350;4779;1191;4498;109;499;867;3267;976;3766
220887;201404;1400;3662;1220;3414;51;153;1080;3034;1131;3187
220890;201404;1640;5822;1464;5544;143;526;1163;4538;1306;5064
220900;201404;1942;5761;1733;5331;119;357;1383;4304;1502;4661
220910;201404;1735;5154;1546;4878;72;256;1341;4279;1413;4535
220915;201404;1053;3059;931;2849;51;221;729;2166;780;2387
220920;201404;1328;4946;1261;4856;127;556;924;3547;1051;4103
220930;201404;1493;4851;1328;4634;98;397;1081;3804;1179;4201
220935;201404;1048;3259;952;3061;64;281;692;2132;756;2413
220937;201404;1579;4371;1339;3948;68;240;1044;2994;1112;3234
220940;201404;1473;4527;1362;4291;104;398;1038;3244;1142;3642
220945;201404;494;1771;455;1662;55;245;310;1123;365;1368
220950;201404;1273;3271;932;2685;41;164;698;1952;739;2116
220955;201404;1633;4540;1386;4156;121;400;1061;3168;1182;3568
220960;201404;846;2364;737;2176;58;227;556;1602;614;1829
220965;201404;1697;5172;1607;5045;64;266;1392;4360;1456;4626
220970;201404;2161;5813;1591;4861;172;526;1064;3284;1236;3810
220975;201404;616;2224;613;2217;50;186;544;1969;594;2155
220980;201404;1506;4526;1346;4237;125;452;894;2898;1019;3350
220985;201404;1360;3948;1294;3850;128;442;961;2817;1089;3259
220987;201404;1502;4917;1408;4750;119;471;1050;3476;1169;3947
220990;201404;1820;5365;1599;4977;74;317;1234;3769;1308;4086
220995;201404;1246;3746;1012;3391;79;307;758;2567;837;2874
220997;201404;2119;6808;2022;6648;127;435;1803;5925;1930;6360
221000;201404;4510;14066;4199;13536;577;1984;2961;9563;3538;11547
221005;201404;1427;4581;1351;4439;457;1439;636;2195;1093;3634
221010;201404;1251;3382;1100;3184;55;173;936;2725;991;2898
221020;201404;1930;6035;1812;5818;123;547;1369;4297;1492;4844
221030;201404;1809;5069;1583;4746;88;369;1258;3699;1346;4068
221035;201404;1578;4312;1432;4131;91;255;1245;3646;1336;3901
221037;201404;640;1976;579;1871;36;159;461;1425;497;1584
221038;201404;644;1836;518;1628;43;156;346;1087;389;1243
221039;201404;943;2782;886;2695;69;231;746;2248;815;2479
221040;201404;5250;16205;4971;15750;413;1432;3865;12388;4278;13820
221050;201404;3783;11726;3500;11316;217;846;2951;9466;3168;10312
221060;201404;9269;25494;7912;23616;884;2767;5824;17454;6708;20221
221062;201404;1285;4554;1204;4418;33;113;1122;4140;1155;4253
221063;201404;1143;3704;1068;3566;343;1127;556;2004;899;3131
221065;201404;2754;8119;2578;7834;351;1006;1904;5871;2255;6877
221070;201404;4397;13518;3992;12892;259;1000;3149;10146;3408;11146
221080;201404;3508;9589;3164;9123;223;738;2569;7416;2792;8154
221090;201404;1349;3759;1188;3511;50;197;973;2824;1023;3021
221093;201404;1821;5464;1733;5291;399;1290;906;2700;1305;3990
221095;201404;1001;2692;861;2496;32;92;756;2200;788;2292
221097;201404;813;2354;727;2206;60;244;548;1640;608;1884
221100;201404;125585;386240;118984;375342;25760;89424;74712;230689;100472;320113
221110;201404;10143;33830;9715;33286;698;2745;8156;27921;8854;30666
221120;201404;4422;14784;4231;14441;1189;4074;2457;8682;3646;12756
221130;201404;4719;14158;4174;13066;1136;3718;2078;6458;3214;10176
221135;201404;1477;4729;1386;4591;175;678;1035;3379;1210;4057
221140;201404;1412;3602;1305;3461;147;337;1045;2838;1192;3175
221150;201404;1249;3249;1046;2899;31;135;828;2264;859;2399
221160;201404;910;2420;858;2339;63;187;648;1780;711;1967
221170;201404;1114;3632;1066;3526;70;279;869;2839;939;3118
230010;201404;3435;9404;2822;8344;190;658;2233;6589;2423;7247
230015;201404;2680;9550;2531;9225;430;1832;1686;5978;2116;7810
230020;201404;14402;48055;13926;47174;997;3681;11360;38723;12357;42404
230030;201404;12586;37492;11841;36322;949;3236;9441;28939;10390;32175
230040;201404;4562;13072;3900;11931;323;1135;2984;9041;3307;10176
230050;201404;2567;8930;2184;7939;382;1503;1044;3792;1426;5295
230060;201404;2023;6122;1805;5715;141;526;1341;4194;1482;4720
230070;201404;4718;13119;4193;12373;397;1259;3115;9399;3512;10658
230075;201404;8858;32800;8356;31753;852;4083;6255;23453;7107;27536
230080;201404;2340;6608;1990;6106;132;469;1599;4892;1731;5361
230090;201404;3509;10814;3151;10171;293;1159;2383;7569;2676;8728
230100;201404;17416;54310;16045;51709;4321;14802;7693;25096;12014;39898
230110;201404;14090;46697;13180;44777;2657;9803;7516;25472;10173;35275
230120;201404;8083;22537;7159;21262;821;2616;5247;15728;6068;18344
230125;201404;2940;8743;2470;7849;189;764;1822;5705;2011;6469
230130;201404;5656;19040;4824;17218;465;1989;3352;11802;3817;13791
230140;201404;3514;11543;3045;10676;458;1725;1921;6892;2379;8617
230150;201404;1763;5659;1551;5226;291;1150;950;3055;1241;4205
230160;201404;6399;19564;5634;18432;579;2106;4162;13689;4741;15795
230170;201404;6625;21220;5754;19588;509;2015;4122;13876;4631;15891
230180;201404;1955;5679;1726;5267;143;535;1198;3579;1341;4114
230185;201404;4205;14252;3911;13694;726;2565;2412;8799;3138;11364
230190;201404;12237;41247;11330;39447;2281;9021;6189;21296;8470;30317
230195;201404;5010;15855;4554;15116;340;1467;3505;11282;3845;12749
230200;201404;5750;16996;5172;15875;675;2158;3605;11102;4280;13260
230205;201404;4401;14090;3947;13318;361;1577;2830;9492;3191;11069
230210;201404;9305;27097;8200;25349;2425;7659;3867;12472;6292;20131
230220;201404;13707;40970;12636;39121;1951;6815;8373;25543;10324;32358
230230;201404;7493;24971;6748;23410;1126;4048;4041;14204;5167;18252
230240;201404;13485;39855;12252;37624;802;3041;9441;28446;10243;31487
230250;201404;10296;31904;10083;31596;552;2054;8475;26416;9027;28470
230260;201404;14897;51280;13878;49175;3074;11571;7335;26622;10409;38193
230270;201404;6827;21072;6079;19780;686;2431;4427;14477;5113;16908
230280;201404;20360;62085;18638;59107;2831;9230;12614;40388;15445;49618
230290;201404;5156;15996;4522;14722;656;2219;2944;9700;3600;11919
230300;201404;4800;15048;4611;14757;523;1947;3411;10794;3934;12741
230310;201404;4946;14972;4350;13973;368;1467;3196;10033;3564;11500
230320;201404;7427;24182;6959;23360;834;3194;5002;16817;5836;20011
230330;201404;4759;14369;4251;13382;403;1463;2991;9314;3394;10777
230340;201404;3426;12046;3221;11595;534;2132;1958;6914;2492;9046
230350;201404;18413;57261;16616;54146;2942;10470;10160;33442;13102;43912
230360;201404;3035;9123;2648;8414;333;1213;1862;5840;2195;7053
230365;201404;3007;8755;2659;8174;188;687;2045;6254;2233;6941
230370;201404;55656;186489;51651;179574;15773;57620;23675;84999;39448;142619
230380;201404;7143;20944;6137;19225;552;1943;4275;13400;4827;15343
230390;201404;3655;11724;3270;11097;390;1609;2251;7553;2641;9162
230393;201404;3396;11427;2925;10434;259;1289;2042;7023;2301;8312
230395;201404;4923;15811;4600;15179;708;2669;2973;9744;3681;12413
230400;201404;5177;16353;4539;15416;396;1697;3470;11542;3866;13239
230410;201404;15826;50738;14280;47843;2555;9173;8226;27682;10781;36855
230420;201404;24362;81875;22891;78866;5786;21742;10968;37588;16754;59330
230423;201404;4842;15929;4511;15307;522;1975;3093;10673;3615;12648
230425;201404;5501;18734;5071;17755;735;2810;3358;11701;4093;14511
230426;201404;2839;8013;2352;7111;155;633;1720;5048;1875;5681
230427;201404;1776;5479;1354;4549;125;459;892;2911;1017;3370
230428;201404;9184;30495;8967;30113;1805;6788;5569;18499;7374;25287
230430;201404;4630;15156;4381;14670;440;1787;3160;10398;3600;12185
230435;201404;5055;16779;4548;15873;1044;4031;2252;7963;3296;11994
230440;201404;359659;1129316;339313;1092579;88052;305653;161457;521363;249509;827016
230445;201404;4740;12981;4037;11966;353;1062;2986;9025;3339;10087
230450;201404;3716;12073;3199;11140;463;1858;2012;6985;2475;8843
230460;201404;1928;6479;1769;6170;198;828;1245;4308;1443;5136
230465;201404;4223;12837;3455;11423;326;1381;2275;7324;2601;8705
230470;201404;11355;41909;10939;41081;1465;5904;7748;29600;9213;35504
230480;201404;1481;4834;1294;4476;229;834;790;2759;1019;3593
230490;201404;2980;8793;2624;8137;471;1659;1342;4095;1813;5754
230495;201404;5738;19504;5219;18644;919;3886;2982;10646;3901;14532
230500;201404;10725;36812;10272;36037;895;3484;7801;27915;8696;31399
230510;201404;1529;5540;1281;4919;308;1256;504;2028;812;3284
230520;201404;5049;15497;4449;14441;520;1982;2975;9567;3495;11549
230523;201404;13829;46536;12718;44041;3698;14197;3525;12415;7223;26612
230526;201404;4202;13072;3713;12212;393;1529;2590;8514;2983;10043
230530;201404;5289;17815;4874;17249;1103;3967;3100;11158;4203;15125
230533;201404;4021;11528;3593;10714;245;807;2737;8069;2982;8876
230535;201404;5458;16457;4831;15329;518;1744;3478;11184;3996;12928
230540;201404;19054;55394;16969;52300;1139;4174;13813;42248;14952;46422
230550;201404;20145;61909;18438;58665;4332;15000;9440;29726;13772;44726
230560;201404;6565;19200;5901;18002;254;1027;4737;14278;4991;15305
230565;201404;3284;9686;2698;8506;280;979;1810;5668;2090;6647
230570;201404;3990;10990;3571;10458;224;818;2933;8484;3157;9302
230580;201404;10461;32525;9980;31844;630;2116;8613;27748;9243;29864
230590;201404;9474;30380;8602;28793;787;3264;6292;20661;7079;23925
230600;201404;3678;10498;2790;8640;204;706;1857;5682;2061;6388
230610;201404;6163;20506;5784;19905;832;3125;4065;14099;4897;17224
230620;201404;2079;5992;1740;5294;164;601;1092;3222;1256;3823
230625;201404;7707;25958;6957;24233;2053;7755;2142;7496;4195;15251
230630;201404;11280;37318;10363;35530;2628;8807;5042;18342;7670;27149
230640;201404;27039;90965;25468;88620;3807;14074;18063;63579;21870;77653
230650;201404;4971;16027;4574;15244;392;1652;3450;11261;3842;12913
230655;201404;8738;33387;8423;32867;728;2994;6976;27547;7704;30541
230660;201404;6395;20283;5655;18958;535;2180;4026;13551;4561;15731
230670;201404;6003;16549;4921;14699;256;949;3771;10939;4027;11888
230680;201404;2815;8340;2384;7549;373;1277;1413;4480;1786;5757
230690;201404;6363;21242;6225;20977;513;2189;4509;14889;5022;17078
230700;201404;9300;27453;8293;25665;874;3293;5644;16935;6518;20228
230710;201404;7692;25154;6877;23665;893;3113;4914;17323;5807;20436
230720;201404;1966;6228;1704;5724;228;842;1114;3768;1342;4610
230725;201404;3776;12869;3382;11905;694;2626;1763;6098;2457;8724
230730;201404;57003;176913;48700;163884;13444;49388;20810;71185;34254;120573
230740;201404;5476;17439;5144;16832;312;1339;4216;13584;4528;14923
230750;201404;9053;26456;7750;24335;685;2571;5791;18040;6476;20611
230760;201404;9954;30997;9590;30163;1247;4722;6764;20352;8011;25074
230763;201404;4210;13521;3972;13047;317;1440;3000;9488;3317;10928
230765;201404;41881;139249;39056;133492;12330;45443;13261;45828;25591;91271
230770;201404;23880;67565;22175;65127;2212;7235;16281;47693;18493;54928
230780;201404;6018;23964;5781;23393;1503;6097;2807;12196;4310;18293
230790;201404;2583;8887;2473;8697;298;1162;1865;6605;2163;7767
230800;201404;7915;28869;7303;27474;1768;7121;3338;12620;5106;19741
230810;201404;12545;41410;11981;40456;1407;4986;9044;30995;10451;35981
230820;201404;3480;11946;3094;11108;596;2398;1666;5971;2262;8369
230830;201404;7910;24262;7098;22773;742;2760;4915;15698;5657;18458
230835;201404;4168;11493;3564;10659;284;950;2753;8208;3037;9158
230837;201404;3159;10993;2761;10167;391;1659;1787;6564;2178;8223
230840;201404;9444;31605;8661;30207;1228;4709;5867;20769;7095;25478
230850;201404;11374;34883;10612;33894;1358;4886;7733;24604;9091;29490
230860;201404;5067;15450;4676;14711;396;1488;3513;10953;3909;12441
230870;201404;19061;53371;17191;50303;1601;5440;12784;37083;14385;42523
230880;201404;1930;6782;1799;6520;254;1059;1165;4181;1419;5240
230890;201404;4126;15071;3774;14336;553;2428;2362;8819;2915;11247
230900;201404;3008;10216;2654;9463;554;1970;1373;5046;1927;7016
230910;201404;2984;9171;2450;8148;253;1017;1706;5559;1959;6576
230920;201404;4709;13951;4347;13500;322;1083;3568;11256;3890;12339
230930;201404;7805;24153;7059;22764;915;3133;4788;15514;5703;18647
230940;201404;7703;22188;6836;20909;404;1248;5645;17460;6049;18708
230945;201404;5878;18068;5096;16950;577;2130;3548;11958;4125;14088
230950;201404;6969;19466;6008;18155;425;1417;4640;14090;5065;15507
230960;201404;12607;40935;11646;39067;2692;9855;5551;18684;8243;28539
230970;201404;13500;43740;12295;41362;2669;10216;5953;19564;8622;29780
230980;201404;2896;9584;2599;8964;897;3138;1011;3683;1908;6821
230990;201404;1623;5095;1336;4494;161;699;868;2828;1029;3527
231000;201404;2880;7876;2307;6787;269;927;1435;4079;1704;5006
231010;201404;3082;8913;2675;8268;283;1120;1968;5951;2251;7071
231020;201404;8055;27232;7616;26337;1433;5166;4609;16309;6042;21475
231025;201404;7877;25132;7125;23807;1245;4302;4436;15215;5681;19517
231030;201404;8074;26845;6907;24416;1352;5108;3870;13852;5222;18960
231040;201404;3001;10134;2730;9565;273;1149;1890;6510;2163;7659
231050;201404;12196;35855;10723;33184;1102;3767;7598;23502;8700;27269
231060;201404;2434;7863;2240;7514;190;862;1597;5195;1787;6057
231070;201404;9354;29980;8668;28628;1593;5701;5164;17151;6757;22852
231080;201404;4315;13670;3977;13072;269;1208;2956;9353;3225;10561
231085;201404;4783;15552;4642;15313;774;2659;3289;11086;4063;13745
231090;201404;4064;11660;3383;10304;195;732;2437;7296;2632;8028
231095;201404;2236;7577;1954;7016;238;914;1332;4861;1570;5775
231100;201404;3045;9620;2557;8633;231;871;1811;6032;2042;6903
231110;201404;3758;12708;3667;12550;391;1451;2658;9154;3049;10605
231120;201404;2427;8001;2261;7709;385;1362;1437;4965;1822;6327
231123;201404;2239;6171;1909;5621;147;426;1503;4449;1650;4875
231126;201404;6738;18865;5528;17124;390;1410;4151;12707;4541;14117
231130;201404;20300;64339;18667;61467;4696;16243;9522;32700;14218;48943
231135;201404;4672;13847;3954;12730;389;1493;2850;9010;3239;10503
231140;201404;15622;51579;14501;49303;1458;6664;10023;32729;11481;39393
231150;201404;5955;17643;5131;16091;1003;3522;2677;8140;3680;11662
231160;201404;5821;20113;5547;19586;1366;5096;3304;11675;4670;16771
231170;201404;4790;15560;4435;14842;485;1980;2965;9757;3450;11737
231180;201404;15159;46639;13931;44278;2633;9151;8285;26006;10918;35157
231190;201404;5083;14316;4255;13127;358;1258;3257;9949;3615;11207
231195;201404;4630;16002;4043;14848;386;1689;2963;10912;3349;12601
231200;201404;7684;27057;6832;25337;685;3179;4773;17404;5458;20583
231210;201404;5140;16058;4467;15114;316;1388;3424;11649;3740;13037
231220;201404;14225;41050;12188;37573;1206;4384;7919;24518;9125;28902
231230;201404;8718;31236;8185;30280;899;3895;6150;22696;7049;26591
231240;201404;11895;38589;10791;36556;1766;6658;6430;21992;8196;28650
231250;201404;2067;6073;1442;4554;306;985;549;1651;855;2636
231260;201404;4040;11590;3675;11078;507;1595;2438;7525;2945;9120
231270;201404;7731;21982;6900;20633;606;2402;4988;14514;5594;16916
231280;201404;1744;5832;1641;5625;165;600;1189;4118;1354;4718
231290;201404;33482;119416;30837;112918;7640;30846;12472;44475;20112;75321
231300;201404;4606;13673;3820;12064;339;1296;2678;8156;3017;9452
231310;201404;7582;22135;6457;19853;1304;4190;3317;10123;4621;14313
231320;201404;6982;21934;6192;20387;422;1693;4610;15116;5032;16809
231325;201404;2590;8011;2328;7547;190;695;1719;5603;1909;6298
231330;201404;14222;44672;12114;40640;2022;6909;7338;24931;9360;31840
231335;201404;5163;15093;4555;13986;314;1247;3582;10749;3896;11996
231340;201404;18067;59723;17006;58211;1487;4912;13619;47974;15106;52886
231350;201404;12351;42282;12111;41914;1482;4947;9565;33907;11047;38854
231355;201404;4286;14142;4129;13879;253;890;3486;11877;3739;12767
231360;201404;7306;24352;6745;23378;1783;6072;3705;13472;5488;19544
231370;201404;2409;6912;1948;6210;107;409;1463;4602;1570;5011
231375;201404;4134;14412;3937;14041;392;1788;3008;10498;3400;12286
231380;201404;5284;17411;4978;16983;839;2997;3284;11521;4123;14518
231390;201404;3464;11034;3275;10753;292;1161;2436;7909;2728;9070
231395;201404;4263;13889;3831;13194;784;2836;2259;7949;3043;10785
231400;201404;10495;31712;9618;30119;969;3549;6637;20834;7606;24383
231410;201404;13471;46831;12650;45599;1354;4917;9569;35310;10923;40227
240010;201404;2466;7811;2203;7210;537;1961;940;2941;1477;4902
240020;201404;11904;37723;10691;35441;2841;10151;4698;15793;7539;25944
240030;201404;2565;7667;2492;7551;222;862;1965;5807;2187;6669
240040;201404;811;2448;693;2222;52;252;492;1490;544;1742
240050;201404;3727;10274;3249;9467;212;751;2459;7064;2671;7815
240060;201404;1459;4407;1383;4280;125;473;1049;3150;1174;3623
240070;201404;2877;8389;2745;8144;482;1508;1723;5051;2205;6559
240080;201404;3163;8533;2810;8071;272;742;2173;6366;2445;7108
240090;201404;2253;6237;1923;5607;62;259;1523;4338;1585;4597
240100;201404;10356;30115;9645;28728;1261;4458;5911;17373;7172;21831
240110;201404;5242;16141;4686;15141;935;3432;2671;8267;3606;11699
240120;201404;3022;10120;2917;9930;580;2153;1761;6098;2341;8251
240130;201404;2822;7805;2441;7222;212;755;1858;5425;2070;6180
240140;201404;2211;6936;1977;6490;411;1509;1037;3359;1448;4868
240145;201404;6245;19770;5648;18703;1608;5977;2689;8832;4297;14809
240150;201404;1024;3158;846;2804;135;547;494;1571;629;2118
240160;201404;1470;4854;1337;4616;176;701;874;3033;1050;3734
240165;201404;933;3039;831;2829;116;415;522;1821;638;2236
240170;201404;2551;7789;2300;7313;599;2068;1006;3230;1605;5298
240180;201404;2997;9459;2810;9136;722;2489;1412;4768;2134;7257
240185;201404;1502;5040;1455;4955;185;653;1062;3687;1247;4340
240190;201404;897;2796;837;2676;60;255;627;1948;687;2203
240200;201404;14592;38007;12278;35198;2425;7065;7383;22235;9808;29300
240210;201404;2789;8029;2584;7754;237;820;2103;6259;2340;7079
240220;201404;7314;23903;6989;23444;403;1785;6022;19941;6425;21726
240230;201404;5570;15878;5122;15099;438;1505;3940;11470;4378;12975
240240;201404;1839;5803;1422;4696;375;1326;298;879;673;2205
240250;201404;2884;8400;2742;8196;212;774;2189;6441;2401;7215
240260;201404;15013;50662;14333;49549;2511;9812;9184;31755;11695;41567
240270;201404;2400;7934;2279;7717;259;896;1649;5706;1908;6602
240280;201404;1663;4772;1495;4476;129;468;1085;3208;1214;3676
240290;201404;1437;4527;1240;4166;110;525;798;2566;908;3091
240300;201404;2193;6200;1612;4927;417;1380;546;1600;963;2980
240310;201404;10516;30265;9616;28805;2198;7178;4906;14711;7104;21889
240320;201404;2064;6197;1706;5455;102;434;1208;3717;1310;4151
240325;201404;38533;107814;30722;94918;9598;32283;8920;28038;18518;60321
240330;201404;1564;4742;1328;4268;165;669;808;2484;973;3153
240340;201404;1691;5073;1492;4766;224;760;1012;3246;1236;4006
240350;201404;2160;6586;2027;6396;243;920;1597;4955;1840;5875
240360;201404;7475;22703;6572;21373;1113;3927;4121;13737;5234;17664
240370;201404;2046;5682;1797;5269;140;499;1321;3852;1461;4351
240375;201404;899;2400;805;2267;145;453;460;1256;605;1709
240380;201404;2713;8139;2241;7095;347;1146;1266;3978;1613;5124
240390;201404;939;2659;786;2363;75;286;545;1604;620;1890
240400;201404;1477;4005;1269;3691;138;470;909;2559;1047;3029
240410;201404;548;1787;501;1690;73;297;318;1053;391;1350
240420;201404;4938;18817;4750;18390;1462;5757;2242;9251;3704;15008
240430;201404;3555;10317;3297;9871;339;1155;2368;7030;2707;8185
240440;201404;2745;7404;2557;7074;667;1941;1322;3678;1989;5619
240450;201404;3955;11895;3587;11205;527;1994;2163;6608;2690;8602
240460;201404;2904;9358;2819;9223;293;1166;2196;7084;2489;8250
240470;201404;3654;11320;2968;9869;477;1718;1716;5644;2193;7362
240480;201404;440;1156;386;1042;37;93;241;644;278;737
240485;201404;2151;6591;1916;6152;406;1420;1045;3374;1451;4794
240490;201404;1691;4330;1476;4022;83;313;1152;3022;1235;3335
240500;201404;2131;6483;2038;6326;216;739;1534;4774;1750;5513
240510;201404;1810;5574;1691;5348;233;807;1234;3917;1467;4724
240520;201404;1458;4266;1286;4015;213;761;851;2585;1064;3346
240530;201404;2224;7106;1999;6747;265;957;1413;4779;1678;5736
240540;201404;1864;5717;1794;5597;173;622;1338;4149;1511;4771
240550;201404;814;2331;715;2164;55;196;546;1605;601;1801
240560;201404;3315;9712;3140;9451;348;1111;2472;7445;2820;8556
240570;201404;3130;9008;2584;7799;606;2081;1110;3042;1716;5123
240580;201404;8216;25645;7760;24872;1263;4357;5571;17761;6834;22118
240590;201404;852;2437;757;2269;52;203;549;1607;601;1810
240600;201404;1541;4624;1242;4007;177;644;686;2127;863;2771
240610;201404;5069;14324;4429;13149;593;1903;2717;7897;3310;9800
240615;201404;1066;3090;888;2750;158;494;493;1541;651;2035
240620;201404;1690;5567;1572;5356;223;841;1160;3950;1383;4791
240630;201404;2077;6437;1978;6270;192;593;1469;4858;1661;5451
240640;201404;936;2779;794;2548;96;418;518;1611;614;2029
240650;201404;3777;11831;3503;11430;308;1136;2766;9055;3074;10191
240660;201404;2524;8128;2416;7950;280;1008;1788;5951;2068;6959
240670;201404;2759;8329;2356;7514;335;1235;1314;4077;1649;5312
240680;201404;1519;4494;1240;3989;169;560;715;2338;884;2898
240690;201404;1101;3128;972;2919;103;371;691;2054;794;2425
240700;201404;2683;8113;2260;7315;132;582;1721;5409;1853;5991
240710;201404;18734;48174;16669;45523;3206;8857;10075;28530;13281;37387
240720;201404;5666;16544;5416;16162;1705;5608;2489;7223;4194;12831
240725;201404;1081;3264;835;2714;74;250;473;1510;547;1760
240730;201404;2292;7139;2048;6678;195;707;1429;4621;1624;5328
240740;201404;2281;6874;2053;6457;270;912;1316;4142;1586;5054
240750;201404;2272;8441;2098;8116;466;1955;1145;4512;1611;6467
240760;201404;1264;3779;1194;3685;108;309;937;3050;1045;3359
240770;201404;3571;10473;3263;10015;400;1374;2329;7161;2729;8535
240780;201404;6055;17096;4994;15426;890;2929;2832;8942;3722;11871
240790;201404;865;2692;704;2394;60;232;508;1735;568;1967
240800;201404;41322;120605;37664;114368;10656;34598;15157;46709;25813;81307
240810;201404;95614;288402;90202;278599;28601;92015;39986;125409;68587;217424
240820;201404;6966;20911;6047;19464;1175;4196;3098;10335;4273;14531
240830;201404;9466;29213;8962;28479;750;2561;7268;23435;8018;25996
240840;201404;1314;3689;1140;3401;119;426;686;2017;805;2443
240850;201404;1195;3695;942;3172;191;706;464;1490;655;2196
240860;201404;1331;3786;1146;3488;87;310;835;2490;922;2800
240870;201404;1174;3292;1005;2960;128;456;647;1794;775;2250
240880;201404;1197;4128;1134;4036;144;637;805;2822;949;3459
240890;201404;5514;15706;4838;14499;861;2893;2552;7548;3413;10441
240895;201404;2802;9618;2564;9196;382;1464;1720;6281;2102;7745
240910;201404;2707;8620;2492;8211;236;927;1846;6036;2082;6963
240920;201404;869;2840;795;2672;200;751;383;1242;583;1993
240930;201404;3693;9974;3342;9517;304;897;2614;7547;2918;8444
240933;201404;1513;4473;1352;4198;255;898;773;2395;1028;3293
240940;201404;6638;18876;5657;17157;1162;3731;2948;8941;4110;12672
240950;201404;1172;3705;1113;3610;104;442;787;2528;891;2970
240960;201404;788;2515;716;2370;81;325;512;1678;593;2003
240970;201404;2074;5861;1771;5343;164;588;1224;3661;1388;4249
240980;201404;3336;11065;3128;10672;688;2558;1837;6245;2525;8803
240990;201404;3086;9270;2905;8913;565;1963;1760;5257;2325;7220
241000;201404;1098;3114;966;2886;87;322;698;2052;785;2374
241010;201404;3018;10202;2741;9693;441;1790;1808;6251;2249;8041
241020;201404;2118;6050;1774;5393;178;623;1081;3158;1259;3781
241025;201404;1535;4803;1419;4581;125;524;998;3151;1123;3675
241030;201404;2563;8466;2331;8051;159;612;1825;6363;1984;6975
241040;201404;2180;7671;2016;7368;223;950;1454;5356;1677;6306
241050;201404;1346;4020;1225;3810;111;452;905;2721;1016;3173
241060;201404;1003;2907;919;2772;117;371;671;2028;788;2399
241070;201404;931;2695;817;2487;95;343;558;1643;653;1986
241080;201404;1184;3576;1045;3324;84;357;721;2213;805;2570
241090;201404;2144;6250;1854;5731;112;492;1514;4594;1626;5086
241100;201404;1214;3652;1064;3308;91;314;716;2198;807;2512
241105;201404;1168;3616;1108;3502;194;664;647;2111;841;2775
241110;201404;864;2760;732;2475;79;340;441;1459;520;1799
241120;201404;7969;24290;7281;23195;1497;4878;4667;15275;6164;20153
241140;201404;3486;9856;3109;9119;413;1270;2045;5925;2458;7195
241142;201404;708;2137;515;1714;145;551;136;407;281;958
241150;201404;5825;17634;5361;16834;917;3045;3453;10969;4370;14014
241160;201404;1138;3326;1072;3201;171;560;722;2147;893;2707
241170;201404;1373;4057;1260;3845;159;530;770;2450;929;2980
241180;201404;1025;2820;817;2440;113;384;464;1324;577;1708
241190;201404;1105;3109;946;2797;77;297;631;1752;708;2049
241200;201404;20972;63239;19475;60824;5319;17800;9496;30163;14815;47963
241210;201404;1535;4523;1298;4039;288;1011;605;1850;893;2861
241220;201404;8016;27206;7640;26479;1825;6725;4097;14547;5922;21272
241230;201404;3073;9261;2806;8877;207;771;2244;7064;2451;7835
241240;201404;1119;3297;861;2731;77;246;491;1625;568;1871
241250;201404;5563;17756;4839;16301;300;1511;3843;12573;4143;14084
241255;201404;1867;7160;1774;6953;483;1980;764;3145;1247;5125
241260;201404;5085;13814;4128;12324;339;1275;2923;8546;3262;9821
241270;201404;2073;6253;1823;5768;254;922;1041;3305;1295;4227
241280;201404;2162;6335;2014;6044;367;1174;1259;3827;1626;5001
241290;201404;3314;9239;2680;8225;498;1630;1522;4673;2020;6303
241300;201404;1441;4203;1290;3955;72;248;1009;3117;1081;3365
241310;201404;1559;4937;1485;4818;225;708;1023;3440;1248;4148
241320;201404;915;3095;851;2958;163;634;463;1623;626;2257
241330;201404;1539;4909;1448;4784;157;621;1158;3783;1315;4404
241335;201404;2653;8220;2512;7976;212;666;2065;6604;2277;7270
241340;201404;1968;6163;1769;5742;463;1657;814;2576;1277;4233
241350;201404;1954;6301;1837;6075;165;708;1384;4433;1549;5141
241355;201404;1279;3627;1138;3385;71;240;987;2908;1058;3148
241360;201404;2146;5976;1895;5501;138;475;1361;3797;1499;4272
241370;201404;1347;4199;1099;3670;198;724;551;1807;749;2531
241380;201404;725;2109;631;1919;99;356;338;1021;437;1377
241390;201404;2954;9917;2797;9621;623;2251;1669;5879;2292;8130
241400;201404;3702;11011;3456;10676;419;1507;2585;7954;3004;9461
241410;201404;2726;8103;2469;7754;458;1560;1645;5159;2103;6719
241415;201404;1595;4928;1484;4727;130;510;1090;3404;1220;3914
241420;201404;2238;7829;1969;7356;624;2579;623;2282;1247;4861
241430;201404;481;1480;422;1335;50;179;273;830;323;1009
241440;201404;6001;22124;5635;21489;1033;4155;3867;14922;4900;19077
241445;201404;1047;3238;989;3151;161;453;742;2506;903;2959
241450;201404;3282;9257;3023;8890;460;1515;2086;6070;2546;7585
241460;201404;3601;10596;3231;9878;291;1093;2305;6954;2596;8047
241470;201404;1341;3841;1167;3628;136;543;850;2564;986;3107
241475;201404;1239;3903;1092;3630;66;319;784;2535;850;2854
241480;201404;3259;10674;2983;10255;997;3544;1093;4114;2090;7658
241490;201404;635;1725;524;1554;56;228;356;990;412;1218
241500;201404;757;2380;711;2326;11;47;672;2205;683;2252
250010;201404;2726;8653;2405;8087;219;928;1762;5788;1981;6716
250020;201404;1684;4886;1305;4200;110;467;843;2608;953;3075
250030;201404;7996;23015;7270;22010;899;2803;5423;16764;6322;19567
250040;201404;4503;15288;4184;14671;825;3074;2526;8948;3351;12022
250050;201404;3654;11627;3442;11321;523;1926;2348;7825;2871;9751
250053;201404;1330;3951;1246;3838;191;642;815;2519;1006;3161
250057;201404;716;2744;698;2722;35;107;614;2514;649;2621
250060;201404;4990;15893;4802;15584;661;2456;3554;11334;4215;13790
250070;201404;3920;12346;3695;11956;287;1243;3002;9403;3289;10646
250073;201404;787;2418;705;2263;67;247;500;1596;567;1843
250077;201404;2285;6732;1920;6144;270;935;1088;3527;1358;4462
250080;201404;4769;14024;4611;13799;580;1844;3395;10198;3975;12042
250090;201404;2639;7947;2547;7799;132;510;2142;6430;2274;6940
250100;201404;3993;13539;3817;13222;462;1780;2863;9892;3325;11672
250110;201404;5754;17584;5509;17238;792;2795;4066;12608;4858;15403
250115;201404;552;1819;489;1674;47;218;289;927;336;1145
250120;201404;2244;6701;1939;6132;182;675;1411;4423;1593;5098
250130;201404;5742;17582;5421;17132;323;1170;4511;14393;4834;15563
250135;201404;1084;3351;996;3196;113;407;693;2241;806;2648
250140;201404;2122;6913;1959;6697;258;929;1432;4991;1690;5920
250150;201404;5092;17261;4688;16500;524;2152;3352;11667;3876;13819
250153;201404;1578;4219;1428;4001;130;459;1100;3057;1230;3516
250157;201404;1665;5817;1539;5547;350;1259;849;3158;1199;4417
250160;201404;3349;10500;3249;10336;216;812;2759;8823;2975;9635
250170;201404;1604;4744;1504;4585;317;1035;922;2861;1239;3896
250180;201404;16799;52777;16267;51871;2498;9290;11216;34761;13714;44051
250190;201404;4011;11988;3729;11503;622;2052;2406;7357;3028;9409
250200;201404;2218;6195;1773;5586;133;485;1450;4536;1583;5021
250205;201404;1004;3339;915;3167;85;399;588;2074;673;2473
250210;201404;1645;5408;1524;5229;190;805;1076;3614;1266;4419
250215;201404;1428;4918;1389;4843;210;848;870;3020;1080;3868
250220;201404;821;2337;681;2159;46;174;580;1817;626;1991
250230;201404;1728;4422;1415;3908;137;429;1091;2939;1228;3368
250240;201404;2672;8562;2368;8094;215;797;1781;6157;1996;6954
250250;201404;4591;13941;4213;13428;387;1315;3374;10864;3761;12179
250260;201404;1911;5863;1679;5474;127;516;1246;4030;1373;4546
250270;201404;1302;4141;1183;3988;156;542;867;2974;1023;3516
250280;201404;3808;11546;3521;11082;724;2344;2181;7148;2905;9492
250290;201404;2145;5723;1775;5243;57;216;1556;4590;1613;4806
250300;201404;5511;16418;5220;16053;621;2586;4109;12052;4730;14638
250310;201404;1166;3718;1058;3535;162;654;741;2422;903;3076
250320;201404;7950;25211;7570;24424;1155;4242;4969;15595;6124;19837
250330;201404;2592;8192;2269;7751;257;1020;1697;5744;1954;6764
250340;201404;1138;3322;1062;3206;49;178;902;2725;951;2903
250350;201404;4572;12532;4178;12046;171;601;3627;10560;3798;11161
250355;201404;2157;6593;1966;6304;113;493;1511;4743;1624;5236
250360;201404;2054;6182;1913;5984;101;372;1499;4718;1600;5090
250370;201404;13709;39028;11927;36889;1042;3357;9997;31187;11039;34544
250375;201404;1107;3508;1046;3405;67;272;871;2829;938;3101
250380;201404;1672;4793;1590;4690;103;363;1377;4039;1480;4402
250390;201404;1958;5276;1617;4710;217;678;1056;3085;1273;3763
250400;201404;69477;193884;61907;182818;15273;48466;32379;97068;47652;145534
250403;201404;1536;5099;1459;4992;203;783;1054;3555;1257;4338
250407;201404;1163;3386;1012;3127;66;236;790;2400;856;2636
250410;201404;681;2181;600;2035;67;288;450;1501;517;1789
250415;201404;1821;5790;1680;5518;103;425;1274;4104;1377;4529
250420;201404;1331;4165;1231;4009;105;422;1001;3181;1106;3603
250430;201404;6654;18734;6281;18189;519;1801;5063;14359;5582;16160
250435;201404;1649;5025;1481;4707;184;686;870;2827;1054;3513
250440;201404;4607;13751;4357;13411;289;992;3623;11163;3912;12155
250450;201404;2085;5960;1862;5664;106;377;1641;4983;1747;5360
250460;201404;6375;19498;5958;18927;778;2660;4409;14151;5187;16811
250470;201404;1616;4492;1469;4284;141;512;1055;2994;1196;3506
250480;201404;4033;12101;3642;11536;172;704;3129;9847;3301;10551
250485;201404;628;1658;533;1499;28;103;418;1132;446;1235
250490;201404;4195;13655;4098;13512;838;2962;2612;8685;3450;11647
250500;201404;1912;5890;1789;5680;362;1190;1053;3429;1415;4619
250510;201404;4969;14038;4401;13257;297;1087;3585;10761;3882;11848
250520;201404;1899;5909;1807;5749;348;1256;1028;3197;1376;4453
250523;201404;1801;5739;1713;5618;239;827;1254;4175;1493;5002
250527;201404;1490;4523;1403;4410;58;256;1254;3892;1312;4148
250530;201404;676;2091;594;1984;52;201;480;1609;532;1810
250535;201404;1313;4232;1250;4102;80;347;995;3193;1075;3540
250540;201404;2481;7379;2330;7212;83;267;2130;6655;2213;6922
250550;201404;908;3031;838;2920;73;309;631;2167;704;2476
250560;201404;1764;5706;1726;5651;142;524;1447;4738;1589;5262
250570;201404;2530;8379;2287;7906;198;818;1723;5898;1921;6716
250580;201404;1158;3215;955;2886;125;486;646;1863;771;2349
250590;201404;1057;3244;956;3110;80;340;738;2342;818;2682
250600;201404;7151;21004;6806;20498;528;1600;5598;17050;6126;18650
250610;201404;3484;10253;3244;9887;419;1399;2256;6863;2675;8262
250620;201404;868;2534;805;2409;139;446;510;1505;649;1951
250625;201404;2201;7239;2167;7193;82;220;2001;6740;2083;6960
250630;201404;10430;33872;9921;32977;2305;8255;5376;17898;7681;26153
250640;201404;3901;11622;3655;11333;290;1134;3040;9284;3330;10418
250650;201404;931;2764;877;2663;155;571;477;1467;632;2038
250660;201404;2160;5291;1660;4695;25;66;1571;4465;1596;4531
250670;201404;2746;9248;2612;9000;270;1138;1894;6485;2164;7623
250680;201404;5022;14411;4778;14067;262;927;4085;12025;4347;12952
250690;201404;6356;17077;6147;16796;636;1955;5135;13857;5771;15812
250700;201404;5370;16170;5014;15644;852;2895;3337;10314;4189;13209
250710;201404;4609;14748;4253;14285;697;2403;2894;10023;3591;12426
250720;201404;2555;7781;2441;7583;148;596;2010;6180;2158;6776
250730;201404;3685;11566;3536;11337;483;1746;2514;8002;2997;9748
250740;201404;2046;6093;1796;5663;214;746;1248;3897;1462;4643
250750;201404;103380;307920;97870;299462;18949;64003;61912;186732;80861;250735
250760;201404;2256;6747;2100;6510;194;755;1585;4844;1779;5599
250770;201404;3981;13728;3793;13469;817;3120;2253;8065;3070;11185
250780;201404;1905;5745;1656;5285;198;772;1069;3301;1267;4073
250790;201404;2483;8179;2353;7992;618;2072;1412;4977;2030;7049
250800;201404;2764;8076;2433;7513;159;564;1841;5562;2000;6126
250810;201404;1371;4072;1194;3813;119;480;938;2927;1057;3407
250820;201404;2035;6310;1987;6235;112;419;1656;5236;1768;5655
250830;201404;5964;19898;5668;19306;746;3025;3842;12844;4588;15869
250840;201404;1044;3355;912;3088;118;450;573;1942;691;2392
250850;201404;2448;7131;2183;6702;196;781;1413;4486;1609;5267
250855;201404;1096;3308;1039;3219;68;247;851;2594;919;2841
250860;201404;2919;9984;2704;9570;642;2484;1122;3919;1764;6403
250870;201404;1218;3498;1056;3239;76;291;758;2251;834;2542
250880;201404;1400;4146;1293;3993;195;647;877;2696;1072;3343
250890;201404;9460;30561;8825;29683;1548;6169;5725;18855;7273;25024
250900;201404;3086;10254;2756;9634;310;1095;1901;6778;2211;7873
250905;201404;2118;6693;2024;6567;362;1220;1410;4640;1772;5860
250910;201404;5464;16043;5110;15507;520;1739;3874;11775;4394;13514
250915;201404;1740;5215;1599;5008;151;477;1305;4159;1456;4636
250920;201404;3584;10265;3376;9975;466;1355;2360;7234;2826;8589
250930;201404;1976;6497;1895;6369;365;1436;1261;4136;1626;5572
250933;201404;1206;3897;1161;3823;131;488;839;2777;970;3265
250937;201404;872;2720;784;2542;112;450;470;1511;582;1961
250939;201404;1722;5394;1567;5142;219;770;1005;3288;1224;4058
250940;201404;4016;11861;3738;11430;257;916;2923;8989;3180;9905
250950;201404;1380;4303;1261;4151;76;261;1036;3474;1112;3735
250960;201404;1354;4254;1207;4058;74;277;1008;3440;1082;3717
250970;201404;9096;25016;8166;23703;1305;3897;5456;15949;6761;19846
250980;201404;2679;8218;2480;7869;255;1029;1695;5181;1950;6210
250990;201404;2142;7440;2012;7180;286;1194;1367;4802;1653;5996
251000;201404;2589;7401;2131;6745;130;492;1696;5342;1826;5834
251010;201404;2869;8352;2619;7986;205;737;2048;6277;2253;7014
251020;201404;1666;5118;1542;4963;160;563;1249;4064;1409;4627
251030;201404;1326;3751;1208;3555;124;427;766;2262;890;2689
251040;201404;1950;6241;1765;5956;183;854;1253;4062;1436;4916
251050;201404;1148;3424;1019;3197;157;534;558;1826;715;2360
251060;201404;1069;2603;866;2350;82;293;658;1698;740;1991
251065;201404;595;1780;522;1670;73;265;317;974;390;1239
251070;201404;601;1747;574;1705;55;214;443;1232;498;1446
251080;201404;21531;60556;20128;58216;5432;16683;10345;30235;15777;46918
251090;201404;3067;9772;2748;9188;287;1095;1956;6470;2243;7565
251100;201404;1010;3285;908;3105;132;525;593;1970;725;2495
251110;201404;2139;6220;1922;5858;219;741;1309;3995;1528;4736
251120;201404;5999;20685;5825;20379;792;3265;4450;15224;5242;18489
251130;201404;4009;10498;3599;10043;41;125;3465;9689;3506;9814
251140;201404;4442;13796;4153;13345;241;978;3207;10257;3448;11235
251150;201404;2831;9315;2614;9015;340;1374;1880;6542;2220;7916
251160;201404;1898;6326;1826;6229;93;368;1609;5513;1702;5881
251170;201404;1436;4497;1391;4440;138;528;1123;3524;1261;4052
251180;201404;2934;8841;2704;8543;624;2043;1537;4972;2161;7015
251190;201404;4369;12628;4243;12481;278;874;3746;11045;4024;11919
251200;201404;4243;13184;4045;12926;232;851;3512;11253;3744;12104
251203;201404;1338;4232;1252;4049;110;459;764;2568;874;3027
251207;201404;1240;3888;1078;3584;85;359;737;2387;822;2746
251210;201404;8204;23689;7211;22343;1041;3229;5156;16380;6197;19609
251220;201404;1306;3567;1144;3313;173;531;720;2160;893;2691
251230;201404;5228;15881;4626;15171;451;1683;3851;12597;4302;14280
251240;201404;3196;10583;3119;10464;337;1343;2446;8115;2783;9458
251250;201404;10573;31976;9876;30896;1592;5566;6807;20984;8399;26550
251260;201404;545;1680;486;1600;38;133;363;1199;401;1332
251270;201404;4254;13263;4034;12973;164;690;3611;11590;3775;12280
251272;201404;1394;4290;1310;4169;126;412;1018;3304;1144;3716
251274;201404;1014;3215;959;3106;125;507;561;1864;686;2371
251275;201404;1417;4049;1345;3939;146;546;984;2780;1130;3326
251276;201404;1509;4517;1431;4377;215;723;868;2739;1083;3462
251278;201404;642;2063;557;1864;86;327;321;1116;407;1443
251280;201404;2333;7472;2253;7333;285;1051;1649;5339;1934;6390
251290;201404;6138;17668;5853;17303;908;3110;4094;11781;5002;14891
251300;201404;764;2646;710;2567;56;254;508;1802;564;2056
251310;201404;3284;9683;3029;9315;218;842;2407;7321;2625;8163
251315;201404;1727;6131;1680;6041;310;1201;1011;3701;1321;4902
251320;201404;2170;6114;1801;5523;137;500;1284;4000;1421;4500
251330;201404;2069;5398;1718;4944;112;465;1446;4011;1558;4476
251335;201404;1004;3485;953;3390;110;472;680;2370;790;2842
251340;201404;3963;11079;3372;10183;331;1262;2334;6860;2665;8122
251350;201404;1640;5085;1497;4884;258;940;962;3140;1220;4080
251360;201404;1847;6069;1745;5951;122;503;1464;5023;1586;5526
251365;201404;900;2680;726;2313;57;226;470;1468;527;1694
251370;201404;22526;76160;22110;75494;4035;15579;15307;51183;19342;66762
251380;201404;1405;4372;1232;4073;95;411;954;3075;1049;3486
251385;201404;881;2463;803;2340;76;270;545;1545;621;1815
251390;201404;5806;20861;5487;20341;1067;4281;3580;13236;4647;17517
251392;201404;1076;3195;998;3066;112;363;715;2249;827;2612
251394;201404;622;1926;523;1733;33;134;366;1194;399;1328
251396;201404;877;2525;789;2373;98;320;564;1670;662;1990
251398;201404;1130;3303;945;2957;89;339;637;1968;726;2307
251400;201404;1369;3943;1256;3790;147;576;859;2487;1006;3063
251410;201404;1629;4270;1486;4034;163;505;1002;2766;1165;3271
251420;201404;2202;6401;1891;6055;187;693;1431;4541;1618;5234
251430;201404;1749;6222;1591;5966;119;537;1291;4845;1410;5382
251440;201404;1468;4454;1250;4035;166;615;863;2749;1029;3364
251445;201404;1605;4967;1529;4853;123;478;1270;3977;1393;4455
251450;201404;4857;15283;4341;14620;178;761;3732;12560;3910;13321
251455;201404;1222;3823;1085;3598;84;360;764;2528;848;2888
251460;201404;874;2707;842;2651;143;467;623;1978;766;2445
251465;201404;502;1586;460;1498;51;206;295;938;346;1144
251470;201404;1305;3779;1082;3367;127;480;614;1921;741;2401
251480;201404;1127;3092;1019;2910;61;235;813;2279;874;2514
251490;201404;2098;6212;1823;5839;304;1145;1141;3574;1445;4719
251500;201404;1768;5840;1719;5763;199;779;1312;4333;1511;5112
251510;201404;2631;8832;2451;8446;420;1556;1466;5101;1886;6657
251520;201404;1117;3087;1019;2934;161;496;539;1564;700;2060
251530;201404;12023;35384;11533;34675;791;3011;9765;28895;10556;31906
251540;201404;2867;9487;2650;9021;276;1159;1960;6627;2236;7786
251550;201404;4017;10053;3393;9273;174;603;2757;7335;2931;7938
251560;201404;749;2317;689;2217;109;447;403;1170;512;1617
251570;201404;1067;3149;916;2845;112;426;574;1806;686;2232
251580;201404;2204;6089;2032;5855;365;958;1434;4280;1799;5238
251590;201404;1711;5673;1688;5648;117;426;1451;4922;1568;5348
251593;201404;1031;3284;976;3200;146;547;618;1956;764;2503
251597;201404;1984;6166;1905;6043;186;727;1449;4496;1635;5223
251600;201404;7430;21985;7072;21394;972;2989;5075;15725;6047;18714
251610;201404;3685;11104;3410;10741;364;1233;2588;8248;2952;9481
251615;201404;1220;3529;1043;3219;104;374;660;2097;764;2471
251620;201404;17570;50071;15549;47509;2329;7564;10950;33922;13279;41486
251630;201404;5392;13733;4728;12916;408;1172;3675;10144;4083;11316
251640;201404;2706;7888;2212;6998;240;918;1538;4810;1778;5728
251650;201404;4405;12566;3971;12029;334;1121;3223;9922;3557;11043
251660;201404;3624;12202;3337;11749;271;1273;2641;9112;2912;10385
251670;201404;4067;12020;3663;11467;114;385;3257;10243;3371;10628
251675;201404;758;2539;719;2472;178;650;382;1292;560;1942
251680;201404;2898;8101;2367;7319;142;594;1932;5866;2074;6460
251690;201404;3507;10979;3264;10544;368;1339;2252;7177;2620;8516
251700;201404;2122;7026;2021;6889;215;838;1587;5394;1802;6232
251710;201404;951;2501;723;2101;95;349;370;1011;465;1360
251720;201404;1411;4387;1299;4198;116;472;992;3144;1108;3616
251740;201404;744;2118;606;1871;120;399;330;1032;450;1431
260005;201404;25131;62514;22257;58595;4936;13449;13126;34582;18062;48031
260010;201404;9682;26576;7805;24230;918;3028;5764;17937;6682;20965
260020;201404;5835;17310;5205;16362;626;1955;3709;12166;4335;14121
260030;201404;5446;16524;5048;15933;519;1813;3868;12180;4387;13993
260040;201404;10276;25005;8520;22995;626;1487;7010;19615;7636;21102
260050;201404;10949;35618;10195;34756;664;2437;8829;30467;9493;32904
260060;201404;4106;11466;3774;10944;345;1036;2927;8596;3272;9632
260070;201404;9557;29112;9129;28487;2242;7635;5358;16629;7600;24264
260080;201404;5478;15843;4887;14983;572;2012;3462;10477;4034;12489
260090;201404;5236;14638;4947;14237;1284;3546;3044;9156;4328;12702
260100;201404;3532;9473;3235;9077;238;870;2592;7311;2830;8181
260105;201404;4569;13805;4408;13496;874;2847;2757;8382;3631;11229
260110;201404;21870;64538;20214;62549;1582;4892;16990;53268;18572;58160
260120;201404;11582;35923;11005;34895;3083;10065;5350;17708;8433;27773
260130;201404;3129;9025;2974;8778;558;1500;1986;6100;2544;7600
260140;201404;13555;35049;11600;32644;1224;3950;8748;24889;9972;28839
260150;201404;3141;9218;2803;8726;236;889;2172;6807;2408;7696
260160;201404;6027;18372;5460;17707;503;1793;4407;14535;4910;16328
260170;201404;17744;48953;17041;48034;1516;4024;13935;39979;15451;44003
260180;201404;3511;10885;3217;10465;243;961;2594;8376;2837;9337
260190;201404;16208;39210;15315;38103;944;2543;13165;32775;14109;35318
260200;201404;11398;33060;10420;31604;1248;3988;7499;23556;8747;27544
260210;201404;11443;35678;10602;34481;783;2902;8643;28368;9426;31270
260220;201404;9059;28657;8854;28353;795;3212;7333;22951;8128;26163
260230;201404;9806;29119;9344;28481;659;2120;7633;23705;8292;25825
260240;201404;2963;9317;2628;8844;418;1491;1785;6060;2203;7551
260250;201404;2768;7492;2553;7223;191;540;2104;6023;2295;6563
260260;201404;11578;34096;11309;33751;988;3283;9265;28151;10253;31434
260270;201404;3570;10855;3353;10534;414;1552;2543;7842;2957;9394
260280;201404;12900;42979;11902;41416;802;3108;9854;34736;10656;37844
260290;201404;34203;104484;33081;102655;6017;21201;21827;66332;27844;87533
260300;201404;8373;25725;7434;24365;567;2287;5852;19165;6419;21452
260310;201404;5157;15523;4852;15050;1596;4676;2280;7685;3876;12361
260320;201404;6898;23380;6450;22727;547;2107;5132;18302;5679;20409
260330;201404;3152;9795;2923;9413;266;1061;1954;6503;2220;7564
260340;201404;1893;5636;1797;5499;122;442;1549;4698;1671;5140
260345;201404;26493;87227;25420;85087;7573;27691;11482;36904;19055;64595
260350;201404;4291;12416;4074;12066;383;1289;3176;9374;3559;10663
260360;201404;2409;7608;2312;7448;558;1918;1263;4135;1821;6053
260370;201404;6118;19022;5571;18052;736;2532;3905;12842;4641;15374
260380;201404;4988;16433;4640;15989;474;1604;3592;12649;4066;14253
260390;201404;4773;14954;4170;14009;502;1906;2951;9767;3453;11673
260392;201404;3518;11241;3326;10989;174;692;2913;9590;3087;10282
260400;201404;13846;41162;13343;40351;2597;8942;8753;25771;11350;34713
260410;201404;62984;187867;59814;182627;20310;63000;26545;83808;46855;146808
260415;201404;4081;13161;3577;12177;532;2183;2130;7123;2662;9306
260420;201404;12173;28668;11121;27549;734;2034;9370;23220;10104;25254
260430;201404;2724;9212;2500;8855;274;1122;1838;6413;2112;7535
260440;201404;3427;10611;3201;10165;567;1987;1867;5832;2434;7819
260450;201404;5157;15838;4912;15417;424;1501;3865;12153;4289;13654
260460;201404;5865;18214;5521;17697;934;3310;3504;11055;4438;14365
260470;201404;5110;14912;4820;14514;505;1632;3767;11548;4272;13180
260480;201404;3924;11601;3512;10972;653;2167;2248;6972;2901;9139
260490;201404;6087;15949;5365;14787;653;2183;3582;9826;4235;12009
260500;201404;6817;18987;6334;18306;738;2245;4613;13555;5351;15800
260510;201404;10488;27804;9777;26842;826;2400;7681;21761;8507;24161
260515;201404;4612;14525;3623;12436;397;1527;2185;7554;2582;9081
260520;201404;16077;43849;15612;43234;3823;10220;9667;27782;13490;38002
260530;201404;10303;30901;9061;29184;547;1675;7744;25469;8291;27144
260540;201404;5837;15232;5535;14900;695;1593;4357;12140;5052;13733
260545;201404;42;162;29;119;4;19;6;23;10;42
260550;201404;2849;9608;2546;9028;673;2655;1134;4003;1807;6658
260560;201404;6778;17532;6095;16558;334;916;5285;14389;5619;15305
260570;201404;6633;22883;6208;22131;1045;4147;4171;14953;5216;19100
260580;201404;3936;11009;3729;10693;332;1063;3062;8630;3394;9693
260590;201404;5992;15442;5779;15196;271;648;5241;13989;5512;14637
260600;201404;26023;81683;24758;79546;4638;16008;15623;50731;20261;66739
260610;201404;7104;21380;6776;20924;1239;4067;4628;14298;5867;18365
260620;201404;17471;54492;16853;53465;3442;12244;10412;32232;13854;44476
260630;201404;2327;6955;2013;6438;215;824;1457;4606;1672;5430
260640;201404;17579;48535;16694;47259;2399;7349;11852;33446;14251;40795
260650;201404;5610;17798;5298;17273;784;2575;3461;12087;4245;14662
260660;201404;8424;23723;7637;22713;618;1936;6276;18859;6894;20795
260670;201404;2442;6973;2063;6463;278;1012;1364;4282;1642;5294
260680;201404;23522;64778;22186;62545;5109;15454;11869;33013;16978;48467
260690;201404;3598;9994;3120;9242;211;784;2472;7236;2683;8020
260700;201404;5640;16781;5526;16662;89;193;5337;16300;5426;16493
260710;201404;1329;4096;1211;3924;140;557;897;2846;1037;3403
260720;201404;17406;57551;16593;56095;4643;16167;8419;29310;13062;45477
260730;201404;7366;24402;6631;23323;881;3252;4821;17208;5702;20460
260740;201404;1354;4170;1191;3880;173;628;718;2356;891;2984
260750;201404;6738;21757;6338;21208;602;1969;5219;17830;5821;19799
260760;201404;4792;13365;4508;12998;504;1556;3413;9891;3917;11447
260765;201404;8033;28463;7801;28135;1512;6278;4966;17800;6478;24078
260770;201404;4319;11286;3958;10811;244;846;3148;8416;3392;9262
260775;201404;5352;15628;5075;15208;622;2223;3576;10412;4198;12635
260780;201404;3979;13249;3853;13017;928;3534;2153;7173;3081;10707
260790;201404;120237;312600;115876;306347;26780;74627;68479;180786;95259;255413
260795;201404;3050;9849;2848;9530;472;1714;1856;6311;2328;8025
260800;201404;4753;13086;4429;12653;234;933;3802;10568;4036;11501
260805;201404;4128;12138;3718;11495;575;1929;2441;7550;3016;9479
260810;201404;7444;21669;7261;21432;473;1659;6297;18494;6770;20153
260820;201404;4595;13339;4310;12953;1324;4033;2241;6802;3565;10835
260825;201404;3059;9917;2881;9648;306;1023;2270;7713;2576;8736
260830;201404;3715;12136;3457;11671;1065;3416;1797;6458;2862;9874
260840;201404;4221;12445;3888;11963;281;1105;3225;9774;3506;10879
260845;201404;4242;12655;3962;12108;702;2281;2578;7905;3280;10186
260850;201404;4971;17091;4544;16182;1113;4557;2140;7370;3253;11927
260860;201404;3050;10017;2844;9676;328;1129;2056;7115;2384;8244
260870;201404;4167;11752;3805;11301;585;1646;2727;8364;3312;10010
260875;201404;7450;20045;6749;18951;1057;3078;4328;12522;5385;15600
260880;201404;9114;29106;8732;28563;979;3269;6910;22893;7889;26162
260890;201404;14980;43294;14312;42273;1661;5601;10479;30952;12140;36553
260900;201404;6131;19018;5273;17535;985;3495;3017;10145;4002;13640
260910;201404;3119;9527;2841;9106;301;1139;2179;6953;2480;8092
260915;201404;4569;15307;4428;15105;113;381;4088;14165;4201;14546
260920;201404;3506;10684;3335;10454;510;1763;2391;7649;2901;9412
260930;201404;4219;13399;3773;12755;542;1852;2651;9158;3193;11010
260940;201404;14716;41423;13645;39550;2581;8800;7780;21966;10361;30766
260950;201404;6125;19865;5841;19303;881;3717;3737;11562;4618;15279
260960;201404;67764;190637;64376;185204;13997;43062;36488;105663;50485;148725
260970;201404;5385;17531;5054;17036;643;2536;3604;12050;4247;14586
260980;201404;4058;12931;3864;12673;260;948;3234;10795;3494;11743
260990;201404;18257;57119;16941;55363;2378;7563;12265;41917;14643;49480
261000;201404;15649;44347;12822;39787;2840;9405;6597;20965;9437;30370
261010;201404;2809;7901;2636;7680;239;523;2204;6749;2443;7272
261020;201404;6201;18570;5728;17859;447;1687;4573;13884;5020;15571
261030;201404;3491;11550;3317;11257;329;1208;2600;8803;2929;10011
261040;201404;5417;17603;4708;16463;564;2265;3337;11609;3901;13874
261050;201404;8762;24979;8197;24096;1280;3921;5331;15647;6611;19568
261060;201404;11460;35682;11039;34974;1782;6294;7730;24120;9512;30414
261070;201404;50163;130617;45788;124547;10560;29989;25592;70499;36152;100488
261080;201404;5758;17697;5464;17220;469;1464;4486;14415;4955;15879
261090;201404;16461;46374;15429;44977;1721;5157;12025;35457;13746;40614
261100;201404;7336;23678;6831;22899;635;2559;5283;17607;5918;20166
261110;201404;67243;194470;61679;186440;15782;48977;32537;103903;48319;152880
261120;201404;3657;10049;3336;9643;148;440;2922;8543;3070;8983
261130;201404;7159;18667;6852;18321;278;764;6236;16671;6514;17435
261140;201404;3259;9305;3004;8897;597;1972;1797;5237;2394;7209
261150;201404;5659;16981;5103;16183;780;2781;3464;11077;4244;13858
261153;201404;1981;5755;1680;5334;109;427;1372;4360;1481;4787
261160;201404;225495;593496;215603;580113;49092;136483;124239;343192;173331;479675
261170;201404;6055;17081;5632;16470;918;2740;4019;11876;4937;14616
261180;201404;9602;27532;9284;27057;1191;3598;6939;20402;8130;24000
261190;201404;5475;17365;5225;17044;806;3480;3557;11000;4363;14480
261200;201404;3935;9790;3710;9488;615;1598;2564;6641;3179;8239
261210;201404;1968;5308;1898;5216;146;414;1627;4521;1773;4935
261220;201404;12768;42110;11279;38797;2192;8293;5964;20381;8156;28674
261230;201404;4085;12782;3855;12486;182;643;3416;11111;3598;11754
261240;201404;4954;14718;4711;14269;823;2446;3194;9864;4017;12310
261245;201404;3887;12287;3389;11452;249;1091;2474;8413;2723;9504
261247;201404;3551;11019;3076;10135;395;1381;2104;7002;2499;8383
261250;201404;19563;52967;18854;52028;3689;10347;13541;37648;17230;47995
261255;201404;4394;13504;3956;12788;323;1180;3065;10058;3388;11238
261260;201404;12222;35395;11246;34250;690;1928;9779;30375;10469;32303
261270;201404;3844;11191;3587;10795;514;1688;2467;7389;2981;9077
261280;201404;2754;8563;2519;8220;276;1018;1862;6070;2138;7088
261290;201404;3052;8765;2756;8389;240;826;2237;6878;2477;7704
261300;201404;10497;35346;9495;33609;1707;6837;5874;20615;7581;27452
261310;201404;8537;26042;8148;25395;1948;6393;4641;14459;6589;20852
261320;201404;5976;18839;5643;18205;657;2133;4181;13811;4838;15944
261330;201404;5502;16505;5331;16255;531;1712;4209;12904;4740;14616
261340;201404;4603;15117;4400;14799;652;2594;2815;9429;3467;12023
261350;201404;8027;27462;7625;26763;625;2685;5961;20724;6586;23409
261360;201404;9498;24718;8660;23587;1223;3409;5937;16504;7160;19913
261370;201404;21064;63078;19952;61411;4243;13786;12360;38279;16603;52065
261380;201404;4179;14565;3905;14096;640;2385;2601;9663;3241;12048
261390;201404;17180;53296;15771;50858;2742;9786;9461;30282;12203;40068
261400;201404;4898;17221;4494;16420;627;2602;2993;11013;3620;13615
261410;201404;8352;24745;7894;24027;1159;3643;5589;17361;6748;21004
261420;201404;8022;27144;7767;26761;2052;7785;4308;15016;6360;22801
261430;201404;3616;11290;3093;10594;408;1388;2236;7884;2644;9272
261440;201404;1669;5137;1560;4969;115;470;1252;3948;1367;4418
261450;201404;14251;41508;13880;41018;996;3098;12180;36035;13176;39133
261460;201404;8514;24697;7980;23952;852;2431;5862;19003;6714;21434
261470;201404;3959;10853;3638;10476;228;732;3102;8897;3330;9629
261480;201404;3495;12863;3274;12464;419;1720;2384;8959;2803;10679
261485;201404;4992;15580;4623;14944;1044;3688;2497;8085;3541;11773
261500;201404;5848;16315;5200;15432;704;1913;3885;12063;4589;13976
261510;201404;2046;6501;1925;6327;170;588;1506;4987;1676;5575
261520;201404;2617;8618;2326;8101;195;790;1646;5752;1841;6542
261530;201404;12487;40824;11149;38242;2514;9578;5140;17597;7654;27175
261540;201404;7390;24040;7139;23591;1560;5039;4634;15757;6194;20796
261550;201404;3487;10579;3348;10375;451;1771;2568;7659;3019;9430
261560;201404;6938;22737;6379;22006;1359;4657;4218;15041;5577;19698
261570;201404;3571;11167;3238;10641;493;1660;2169;7218;2662;8878
261580;201404;5893;18929;5281;17941;466;1763;4159;14398;4625;16161
261590;201404;2888;8085;2552;7631;337;1081;1775;5411;2112;6492
261600;201404;5174;14532;4459;13530;510;1651;3284;10069;3794;11720
261610;201404;2297;7008;2006;6587;143;589;1635;5269;1778;5858
261618;201404;2556;7380;2412;7186;278;881;1854;5509;2132;6390
261620;201404;4595;14237;4364;13883;489;1661;3145;10201;3634;11862
261630;201404;8135;24105;7210;22462;1365;4874;3917;11889;5282;16763
261640;201404;30532;80339;28208;77388;2434;6881;22792;63695;25226;70576
261650;201404;3839;12321;3608;11981;499;1846;2621;8748;3120;10594
270010;201404;4453;17120;4084;16367;532;2465;2739;11018;3271;13483
270020;201404;3953;12181;3700;11789;504;1849;2684;8417;3188;10266
270030;201404;45780;139193;43737;136050;11862;37798;23909;76192;35771;113990
270040;201404;10417;32459;9956;31932;1737;5085;7242;24237;8979;29322
270050;201404;4021;11871;3739;11493;439;1639;2799;8446;3238;10085
270060;201404;1678;5598;1600;5484;386;1461;930;3183;1316;4644
270070;201404;4179;13061;3913;12690;172;778;3375;10775;3547;11553
270080;201404;1321;4203;1190;3999;242;898;724;2397;966;3295
270090;201404;2074;6610;1999;6470;62;251;1803;5780;1865;6031
270100;201404;6460;20287;6195;19932;1388;4714;3925;12612;5313;17326
270110;201404;3457;9864;3191;9554;576;1783;2024;6512;2600;8295
270120;201404;3075;9060;2783;8664;153;573;2373;7434;2526;8007
270130;201404;5122;16166;4882;15882;615;1926;3807;12798;4422;14724
270135;201404;1740;5023;1664;4937;103;200;1495;4588;1598;4788
270140;201404;9560;24608;8515;23274;832;3263;6597;16859;7429;20122
270150;201404;2671;9271;2610;9192;221;898;2215;7774;2436;8672
270160;201404;5029;17036;4651;16561;324;1170;3898;14034;4222;15204
270170;201404;4056;13460;3755;13007;806;3164;1992;6825;2798;9989
270180;201404;2285;7641;2044;7326;176;804;1616;5747;1792;6551
270190;201404;1912;6349;1821;6213;152;593;1417;4868;1569;5461
270200;201404;2752;9290;2583;9027;265;1151;1996;6819;2261;7970
270210;201404;4328;14585;4193;14407;465;1891;3416;11648;3881;13539
270220;201404;1718;5435;1599;5202;296;1130;855;2838;1151;3968
270230;201404;11262;37079;9969;35011;1582;6621;6518;22496;8100;29117
270235;201404;6488;21634;6174;21106;366;1576;5217;17758;5583;19334
270240;201404;9784;29688;8694;28256;1611;5491;5663;18611;7274;24102
270250;201404;3523;9066;3212;8716;201;547;2863;7791;3064;8338
270255;201404;5125;15770;4272;14287;411;1755;2976;9762;3387;11517
270260;201404;6333;20607;6172;20324;882;3395;4485;14809;5367;18204
270270;201404;1214;3528;1123;3391;191;615;704;2079;895;2694
270280;201404;3725;11122;3509;10812;455;1676;2479;7455;2934;9131
270290;201404;8408;29777;8010;29064;909;3721;6110;22090;7019;25811
270300;201404;3314;11556;3149;11359;197;874;2743;9882;2940;10756
270310;201404;7264;22783;6594;21607;415;1884;5304;16987;5719;18871
270320;201404;6382;20937;6179;20588;1674;6351;3164;10528;4838;16879
270330;201404;4893;16236;4624;15874;458;1708;3690;12769;4148;14477
270340;201404;1791;5588;1627;5372;216;763;1193;4017;1409;4780
270350;201404;2096;5887;1946;5701;311;942;1272;3968;1583;4910
270360;201404;2089;6574;2045;6521;260;804;1638;5370;1898;6174
270370;201404;1723;5653;1599;5436;192;743;1057;3727;1249;4470
270375;201404;2890;9052;2743;8832;422;1675;1891;5827;2313;7502
270380;201404;6113;18782;5805;18347;630;2038;4399;14222;5029;16260
270390;201404;1449;4008;1307;3830;183;623;880;2499;1063;3122
270400;201404;5960;18606;5486;17894;528;2054;3922;12554;4450;14608
270410;201404;5057;15725;4825;15294;590;2038;3454;10876;4044;12914
270420;201404;5510;18191;5359;17977;280;1287;4512;14889;4792;16176
270430;201404;141870;416059;136161;408075;36718;113018;73454;226993;110172;340011
270440;201404;5038;15662;4771;15259;379;1406;3777;12161;4156;13567
270450;201404;6575;20745;6370;20479;625;2403;5048;16194;5673;18597
270460;201404;3656;10089;3300;9598;294;1043;2625;7469;2919;8512
270470;201404;10888;35635;10395;34784;1701;5792;6845;23629;8546;29421
270480;201404;3106;9957;2875;9544;352;1417;1869;5966;2221;7383
270490;201404;999;3227;944;3145;95;388;708;2321;803;2709
270500;201404;5423;18738;5239;18475;547;1967;4107;14911;4654;16878
270510;201404;6081;18860;5565;18139;943;3953;3912;12042;4855;15995
270520;201404;3758;12228;3540;11880;989;3592;1767;5995;2756;9587
270530;201404;1559;4607;1387;4383;225;723;922;3009;1147;3732
270540;201404;2067;7188;1911;6953;174;831;1501;5346;1675;6177
270550;201404;7077;21573;6301;20544;1121;3878;4047;13559;5168;17437
270560;201404;3031;9580;2871;9324;553;2088;1896;5978;2449;8066
270570;201404;4370;14358;4024;13828;496;2050;2733;9356;3229;11406
270580;201404;2056;6897;1977;6768;311;1155;1412;4886;1723;6041
270590;201404;1405;4789;1319;4639;93;422;1126;3918;1219;4340
270600;201404;2887;9757;2617;9354;208;1059;2003;6939;2211;7998
270610;201404;3268;10437;3042;10106;330;1172;2353;7816;2683;8988
270620;201404;1489;5047;1358;4851;147;689;1020;3539;1167;4228
270630;201404;18383;51589;17305;49930;2729;8019;12164;35696;14893;43715
270640;201404;5925;18531;5391;17871;453;1887;4378;14268;4831;16155
270642;201404;2501;8619;2343;8364;422;1725;1480;5290;1902;7015
270644;201404;2394;7074;2177;6833;225;640;1803;5789;2028;6429
270650;201404;4075;13089;3923;12879;882;3505;2225;7023;3107;10528
270660;201404;2461;6428;1993;5708;141;512;1399;3951;1540;4463
270670;201404;15795;43278;13832;40922;1819;5669;10095;30652;11914;36321
270680;201404;4175;12900;4045;12746;251;737;3580;11427;3831;12164
270690;201404;8887;25482;8299;24769;2860;8403;3737;12127;6597;20530
270700;201404;798;2509;760;2450;128;508;472;1470;600;1978
270710;201404;5712;19322;5482;19012;716;2560;4247;14937;4963;17497
270720;201404;3368;11578;3120;11151;270;1249;2465;8656;2735;9905
270730;201404;6669;20825;6362;20435;1258;3994;4413;14554;5671;18548
270740;201404;2399;7161;2260;6957;380;1293;1443;4422;1823;5715
270750;201404;4806;15693;4499;15221;553;1932;3374;11503;3927;13435
270760;201404;3578;10792;3248;10250;400;1347;2336;7413;2736;8760
270770;201404;18029;49289;15454;46132;3101;9811;9362;28651;12463;38462
270780;201404;1938;6331;1807;6131;269;974;1258;4329;1527;5303
270790;201404;1684;5366;1544;5141;406;1462;752;2511;1158;3973
270800;201404;11413;34569;10725;33663;1004;3481;8654;27213;9658;30694
270810;201404;3453;10680;2840;9564;396;1575;1725;5777;2121;7352
270820;201404;1897;6450;1744;6175;294;1167;1121;3949;1415;5116
270830;201404;5404;16740;4960;16166;1189;4392;2888;9410;4077;13802
270840;201404;7578;26037;6919;25199;482;2272;5736;20659;6218;22931
270850;201404;7632;25382;7471;25188;1509;6335;5020;15954;6529;22289
270860;201404;11638;35356;10920;34374;1723;6446;7798;23913;9521;30359
270870;201404;2308;6847;1881;5941;319;1066;1092;3464;1411;4530
270880;201404;7857;25798;7425;25157;591;2509;6066;20202;6657;22711
270890;201404;2666;8212;2481;7902;410;1554;1672;5190;2082;6744
270895;201404;3052;11384;2904;11189;283;1119;2353;9253;2636;10372
270900;201404;1939;5362;1596;4866;100;379;1214;3603;1314;3982
270910;201404;3226;11375;3163;11244;308;1401;2517;8694;2825;10095
270915;201404;10037;34468;9159;32870;1927;7870;5009;17798;6936;25668
270920;201404;6399;20212;6015;19675;303;1396;5231;16913;5534;18309
270930;201404;17213;47431;14344;43845;3131;10173;7969;25107;11100;35280
270940;201404;5842;20085;5667;19871;826;3249;4182;14673;5008;17922
280010;201404;717;2143;631;2005;70;283;404;1263;474;1546
280020;201404;5022;15133;4477;14141;947;3141;2622;8308;3569;11449
280030;201404;74152;198743;66427;187132;17093;50969;32741;93526;49834;144495
280040;201404;3199;10100;2885;9668;365;1279;2099;7231;2464;8510
280050;201404;4150;13424;3882;13018;1135;3896;1948;6816;3083;10712
280060;201404;4298;14590;4137;14320;925;3527;2422;8429;3347;11956
280067;201404;7635;21954;6515;20434;751;2590;4767;14946;5518;17536
280070;201404;1894;6596;1821;6487;356;1363;1214;4349;1570;5712
280100;201404;4075;12898;3665;12162;1027;3589;1687;5731;2714;9320
280110;201404;1427;4371;1315;4191;88;347;1065;3367;1153;3714
280120;201404;8002;25444;7450;24580;1305;4022;5026;17559;6331;21581
280130;201404;7885;22970;7425;22290;1314;4494;4856;14355;6170;18849
280140;201404;5538;15436;5020;14738;623;1879;3762;11189;4385;13068
280150;201404;3393;10660;3136;10196;490;1861;1965;6135;2455;7996
280160;201404;1542;4440;1410;4235;166;579;1003;2999;1169;3578
280170;201404;4689;14183;4287;13658;501;1536;3281;10840;3782;12376
280190;201404;1151;3339;1035;3157;106;419;730;2133;836;2552
280200;201404;1100;3490;1031;3374;172;699;696;2177;868;2876
280210;201404;12818;41016;12247;40180;2601;8963;7735;26035;10336;34998
280220;201404;1588;4900;1518;4806;108;427;1287;4038;1395;4465
280230;201404;3892;11528;3504;10876;703;2287;2023;6460;2726;8747
280240;201404;3511;10538;3214;10080;283;829;2502;7996;2785;8825
280250;201404;802;2154;712;2022;128;423;413;1076;541;1499
280260;201404;2082;5520;1904;5298;118;347;1635;4573;1753;4920
280270;201404;2243;7086;1979;6641;139;540;1527;5066;1666;5606
280280;201404;4095;13700;3825;13265;979;2951;1983;7825;2962;10776
280290;201404;16695;54588;15478;52495;2845;10418;10205;34928;13050;45346
280300;201404;10145;31021;9437;30220;872;2902;7718;25124;8590;28026
280310;201404;1447;4118;1280;3871;99;375;876;2546;975;2921
280320;201404;7865;26444;7309;25447;1490;5843;3737;12994;5227;18837
280330;201404;4692;13452;4403;13075;563;1875;3351;9900;3914;11775
280340;201404;3778;11531;3613;11308;341;1099;2863;9213;3204;10312
280350;201404;21764;64196;20377;62145;2931;9211;14289;44471;17220;53682
280360;201404;5920;18987;5611;18508;1211;4530;3313;10756;4524;15286
280370;201404;1957;5639;1791;5373;206;726;1297;3807;1503;4533
280380;201404;991;3092;925;3005;98;369;709;2282;807;2651
280390;201404;3266;9712;2885;9030;748;2202;1580;5086;2328;7288
280400;201404;4454;12931;4093;12443;959;2809;2458;7850;3417;10659
280410;201404;2430;7950;2169;7461;369;1470;1271;4257;1640;5727
280420;201404;4229;12331;3941;11890;262;830;3362;10232;3624;11062
280430;201404;2225;5956;2093;5789;160;524;1736;4799;1896;5323
280440;201404;5091;15030;4764;14632;506;1589;3860;12014;4366;13603
280445;201404;2456;7126;2270;6806;111;424;1859;5467;1970;5891
280450;201404;9094;24713;8444;23951;765;1867;7019;20626;7784;22493
280460;201404;7067;19363;6330;18341;1077;3316;4294;12687;5371;16003
280470;201404;1831;5524;1665;5274;189;621;1231;3931;1420;4552
280480;201404;30952;94418;29885;92866;5320;19133;19636;59575;24956;78708
280490;201404;3724;11583;3411;10973;444;1606;2403;7664;2847;9270
280500;201404;899;2410;848;2347;33;104;752;2063;785;2167
280510;201404;2756;8158;2388;7668;320;1187;1742;5609;2062;6796
280520;201404;1735;5012;1602;4836;212;577;1218;3840;1430;4417
280530;201404;2110;6541;2010;6407;260;909;1539;4987;1799;5896
280540;201404;9275;25322;8716;24573;331;1139;7782;21797;8113;22936
280550;201404;7200;19473;6403;18212;698;2301;4521;12782;5219;15083
280560;201404;7945;23586;7514;22892;590;1916;6056;18414;6646;20330
280570;201404;6825;19169;6198;18361;918;3124;4227;12427;5145;15551
280580;201404;5661;17411;4902;16142;964;3323;2999;10058;3963;13381
280590;201404;2412;7368;2217;7136;299;1214;1600;5083;1899;6297
280600;201404;4035;12521;3808;12125;401;1556;2738;8567;3139;10123
280610;201404;2346;6927;2221;6739;324;1124;1453;4354;1777;5478
280620;201404;5184;15950;4627;14897;785;2661;2944;9626;3729;12287
280630;201404;3812;12570;3660;12334;395;1228;2865;10063;3260;11291
280640;201404;2283;6548;2141;6385;122;277;1920;5859;2042;6136
280650;201404;1129;3541;1045;3381;187;672;668;2164;855;2836
280660;201404;2631;7769;2534;7616;324;1040;2037;6072;2361;7112
280670;201404;15906;42708;15121;41661;1936;5701;11182;30825;13118;36526
280680;201404;2837;7576;2440;7044;148;492;2066;5953;2214;6445
280690;201404;1005;2901;874;2709;124;424;562;1697;686;2121
280700;201404;1169;3456;1024;3239;90;288;744;2409;834;2697
280710;201404;10866;30045;10191;29231;757;2126;8638;24986;9395;27112
280720;201404;2469;6790;2223;6491;200;618;1709;5071;1909;5689
280730;201404;948;2875;910;2823;85;285;757;2367;842;2652
280740;201404;12851;35451;11241;33091;1830;5302;7462;22621;9292;27923
280750;201404;3571;11175;3305;10705;308;1249;2382;7612;2690;8861
280760;201404;5809;18079;5337;17463;760;2473;3883;13275;4643;15748
290010;201404;3040;6857;2235;5626;81;327;1770;4204;1851;4531
290020;201404;5006;15859;4577;15421;413;1230;3938;13596;4351;14826
290030;201404;3252;10481;3133;10295;468;1667;2296;7472;2764;9139
290035;201404;4632;12530;4167;11929;328;977;3425;9971;3753;10948
290040;201404;3792;11117;3479;10743;278;1077;2818;8555;3096;9632
290050;201404;2725;8960;2558;8706;263;1013;1923;6584;2186;7597
290060;201404;1318;3408;1107;3160;239;776;740;2037;979;2813
290070;201404;31277;82404;27189;77277;6107;17960;14137;42390;20244;60350
290080;201404;5937;18342;5269;17484;666;2289;3900;13306;4566;15595
290090;201404;2282;5091;1836;4623;246;623;1453;3722;1699;4345
290100;201404;10259;29645;9080;27693;1692;5201;5259;16781;6951;21982
290110;201404;5265;16029;5081;15721;959;3227;3288;10067;4247;13294
290115;201404;4904;14865;4362;14142;343;1217;3343;11029;3686;12246
290120;201404;6806;18815;6338;18232;458;1307;5409;15698;5867;17005
290130;201404;4542;12064;3956;11369;340;985;3232;9362;3572;10347
290135;201404;5221;13534;4581;12524;481;1575;3057;8253;3538;9828
290140;201404;3974;12876;3514;12286;332;1288;2864;10038;3196;11326
290150;201404;2111;6323;2026;6211;193;637;1686;5165;1879;5802
290160;201404;3493;9711;3414;9616;336;661;2939;8603;3275;9264
290170;201404;2852;9623;2628;9267;238;971;2133;7535;2371;8506
290180;201404;3071;8812;2707;8276;285;979;1965;6039;2250;7018
290190;201404;4169;13906;4034;13676;433;1560;3054;10457;3487;12017
290195;201404;2231;6261;1920;5798;145;499;1505;4575;1650;5074
290200;201404;3869;12502;3549;11941;416;1482;2627;8892;3043;10374
290205;201404;2930;9302;2698;8933;412;1618;1868;6017;2280;7635
290210;201404;15777;43788;14807;42629;2577;6274;10232;32057;12809;38331
290220;201404;2425;7419;2324;7265;314;1182;1642;4974;1956;6156
290225;201404;3068;8312;2878;8109;186;395;2533;7382;2719;7777
290230;201404;2343;7877;2305;7824;216;771;1899;6519;2115;7290
290240;201404;3876;10399;3500;9871;382;1197;2550;7101;2932;8298
290250;201404;3831;12255;3269;11377;307;1123;2456;8677;2763;9800
290260;201404;4746;14633;4395;14096;476;1631;3390;10903;3866;12534
290265;201404;3393;11065;3198;10716;313;1264;2416;8057;2729;9321
290270;201404;12118;44807;11450;43830;1547;6205;8429;32975;9976;39180
290280;201404;5179;17333;4916;16849;679;2490;3412;11960;4091;14450
290290;201404;9650;31422;8867;30154;1721;6089;5674;19734;7395;25823
290300;201404;4383;12663;3330;10750;306;998;2276;7592;2582;8590
290310;201404;1524;4684;1427;4542;251;905;932;2909;1183;3814
290320;201404;26882;83275;24017;79482;5434;19175;13767;46227;19201;65402
290323;201404;4098;11110;3391;10357;206;741;2891;8783;3097;9524
290327;201404;4027;13050;3753;12528;547;1945;2530;8466;3077;10411
290330;201404;1910;5091;1826;5000;270;840;1433;3868;1703;4708
290340;201404;5044;16113;4688;15648;1233;4269;2548;8679;3781;12948
290350;201404;4981;15234;4119;14073;600;2073;2766;9780;3366;11853
290360;201404;4214;13462;3777;12845;220;792;3203;11071;3423;11863
290370;201404;4542;13670;4230;13270;549;1723;3317;10587;3866;12310
290380;201404;5586;16506;4954;15609;416;1498;3960;12464;4376;13962
290390;201404;15172;49028;14424;47781;3106;10047;8647;30271;11753;40318
290395;201404;2784;9094;2528;8661;238;1025;1868;6380;2106;7405
290400;201404;3681;11403;3279;10849;511;1677;2320;7806;2831;9483
290405;201404;4494;14497;3935;13515;515;1861;2612;9218;3127;11079
290410;201404;6057;18192;5143;16848;582;2359;3648;11640;4230;13999
290420;201404;3365;9979;2810;9196;255;984;2190;7115;2445;8099
290430;201404;3540;11193;3191;10663;729;2506;1844;6335;2573;8841
290440;201404;3077;8164;2537;7466;203;689;2005;5977;2208;6666
290450;201404;3606;10608;3206;10036;578;1773;2012;6434;2590;8207
290460;201404;13434;41606;12563;40157;3748;12812;5351;16971;9099;29783
290470;201404;4810;13491;3808;12155;886;3219;1905;6140;2791;9359
290475;201404;5007;17768;4586;17031;518;2069;3330;12566;3848;14635
290480;201404;2618;6861;2330;6492;337;1042;1577;4445;1914;5487
290485;201404;4817;15609;4344;14908;454;2058;3362;11366;3816;13424
290490;201404;8122;22007;7858;21652;837;2524;6317;17350;7154;19874
290500;201404;4649;14933;4013;13753;809;2989;1921;6541;2730;9530
290510;201404;3476;10222;3068;9658;250;938;2417;7624;2667;8562
290515;201404;2858;9019;2707;8776;216;671;2117;7065;2333;7736
290520;201404;11773;36679;9642;32732;1102;4402;6016;20280;7118;24682
290530;201404;5292;15392;4549;14336;413;1335;3615;11496;4028;12831
290540;201404;3968;11532;3781;11294;493;1416;2882;8852;3375;10268
290550;201404;4424;11941;3915;11321;171;504;3498;10165;3669;10669
290560;201404;6152;18338;5472;17349;1138;3785;3205;10336;4343;14121
290570;201404;40502;118654;38128;115139;5276;16985;27383;82304;32659;99289
290580;201404;7340;25832;7039;25364;1655;5891;4360;16443;6015;22334
290590;201404;7542;24135;6355;22174;466;1864;4940;17205;5406;19069
290600;201404;18148;56662;17146;55126;2756;8936;11373;37878;14129;46814
290610;201404;2385;8374;2026;7662;196;906;1480;5517;1676;6423
290620;201404;7206;21585;6495;20564;535;1856;5286;16792;5821;18648
290630;201404;8231;22466;7273;21446;870;2598;5759;17182;6629;19780
290640;201404;2723;8096;2275;7340;242;860;1592;5132;1834;5992
290650;201404;11818;35347;11158;34358;3142;9762;6086;19424;9228;29186
290660;201404;3746;10520;3107;9608;201;726;2428;7520;2629;8246
290670;201404;6640;21018;6120;20216;988;3214;4374;15024;5362;18238
290680;201404;10396;31138;9663;30265;558;1904;8170;25817;8728;27721
290682;201404;4418;13229;3989;12640;202;800;3300;10373;3502;11173
290685;201404;3305;8558;2502;7430;318;1029;1499;4553;1817;5582
290687;201404;8261;22450;6584;20419;1267;4234;3872;12281;5139;16515
290689;201404;3152;9063;2675;8307;269;882;2051;6435;2320;7317
290690;201404;5475;16178;5037;15611;597;1994;3884;12117;4481;14111
290700;201404;2244;7141;2156;7015;230;815;1653;5406;1883;6221
290710;201404;7697;24845;7169;24006;427;1414;6168;20894;6595;22308
290720;201404;18798;55754;16817;53322;2195;6499;13090;42949;15285;49448
290730;201404;7368;20734;6729;19906;1329;3868;4294;13031;5623;16899
290740;201404;943;2860;808;2636;126;413;494;1659;620;2072
290750;201404;10185;29443;8863;27097;1597;5779;4859;13971;6456;19750
290755;201404;2433;6941;2050;6303;107;388;1598;4887;1705;5275
290760;201404;4490;13352;3698;12195;389;1266;2680;8953;3069;10219
290770;201404;2583;9118;2403;8879;147;647;1953;7274;2100;7921
290780;201404;8921;23535;7953;22208;1018;2494;5887;17119;6905;19613
290790;201404;4690;14185;4372;13732;471;1463;3340;10839;3811;12302
290800;201404;7391;16282;5655;14433;960;2264;4099;10955;5059;13219
290810;201404;4938;15945;4315;14980;318;1197;3263;11496;3581;12693
290820;201404;5483;15872;4933;15132;525;1825;3735;11452;4260;13277
290830;201404;4153;11996;3931;11638;313;1263;3084;8811;3397;10074
290840;201404;17734;50664;16260;48625;2748;8033;11002;34363;13750;42396
290850;201404;6746;20362;6616;20165;1335;4031;4614;14523;5949;18554
290860;201404;4834;17374;4600;17070;751;2811;3296;12619;4047;15430
290870;201404;4794;14513;4050;13506;470;1868;2924;9644;3394;11512
290880;201404;1404;3951;1164;3578;107;332;788;2468;895;2800
290890;201404;6429;18143;5969;17582;735;2205;4593;13641;5328;15846
290900;201404;2453;7259;1866;6293;288;1090;960;3211;1248;4301
290910;201404;4827;13585;4172;12632;286;939;3433;10456;3719;11395
290920;201404;4835;14473;4374;13843;340;950;3542;11480;3882;12430
290930;201404;7379;24121;6714;22948;846;3219;4670;15804;5516;19023
290940;201404;3568;11426;3344;11146;269;951;2810;9542;3079;10493
290950;201404;1569;4478;1432;4285;217;677;959;2897;1176;3574
290960;201404;6035;17350;5540;16704;387;1199;4487;13714;4874;14913
290970;201404;3714;12178;3416;11646;485;1681;2217;7789;2702;9470
290980;201404;10822;32555;9623;30219;2807;9202;3664;11522;6471;20724
290990;201404;9228;27954;8229;26324;900;3053;6147;19655;7047;22708
291000;201404;3240;9876;2988;9545;400;1338;2261;7364;2661;8702
291005;201404;13658;38656;12332;36748;2235;7117;7942;24055;10177;31172
291010;201404;3108;10161;2531;8865;338;1280;1546;5442;1884;6722
291020;201404;1397;3729;1083;3171;120;435;632;1769;752;2204
291030;201404;2165;6162;1737;5274;155;508;1111;3320;1266;3828
291040;201404;5611;17616;5185;17000;748;2633;3711;12250;4459;14883
291050;201404;8051;27014;7403;25802;1993;7489;3666;12768;5659;20257
291060;201404;6257;23219;5972;22868;887;3858;4250;16153;5137;20011
291070;201404;16115;48332;14821;46489;1897;5683;10778;34893;12675;40576
291072;201404;21890;68269;18972;62517;6234;22103;6514;22295;12748;44398
291075;201404;5294;15505;4813;14860;332;1008;3711;11856;4043;12864
291077;201404;1563;4582;1319;4208;138;524;887;2799;1025;3323
291080;201404;82674;256383;74592;241898;22406;76099;27583;88839;49989;164938
291085;201404;5748;15502;5029;14532;610;1825;3852;11239;4462;13064
291090;201404;1444;3720;1287;3514;131;495;1009;2631;1140;3126
291100;201404;2690;7207;2262;6758;122;489;1906;5646;2028;6135
291110;201404;5041;18223;4557;17475;736;3138;3020;11518;3756;14656
291120;201404;7609;20602;7163;19975;993;2894;5294;14847;6287;17741
291125;201404;1715;3754;1386;3408;144;369;1030;2616;1174;2985
291130;201404;3007;9305;2642;8697;244;953;1868;6105;2112;7058
291140;201404;4131;12542;3856;12057;572;1839;2631;8341;3203;10180
291150;201404;2006;5279;1913;5168;180;520;1451;3891;1631;4411
291160;201404;5592;17206;4946;16257;1212;4114;2749;9122;3961;13236
291165;201404;2438;7262;1990;6418;124;513;1413;4417;1537;4930
291170;201404;20875;54571;18113;51150;1265;4276;14354;40220;15619;44496
291180;201404;6537;17343;5328;15660;620;1988;3721;10907;4341;12895
291185;201404;3892;10678;3662;10368;305;941;3017;8481;3322;9422
291190;201404;7448;21151;6723;20273;864;2611;5031;15673;5895;18284
291200;201404;3099;9393;2597;8507;291;1073;1774;5812;2065;6885
291210;201404;7522;17962;6576;16894;557;1538;5221;13469;5778;15007
291220;201404;4201;13430;3971;13040;599;2216;2760;8949;3359;11165
291230;201404;4014;10562;3618;10100;150;413;3251;9170;3401;9583
291240;201404;4862;13307;4122;12019;283;852;3218;9312;3501;10164
291250;201404;3775;11397;3004;10107;326;1136;2040;6988;2366;8124
291260;201404;1177;3506;1105;3399;108;373;847;2594;955;2967
291270;201404;4443;14975;4184;14506;949;3533;2508;8741;3457;12274
291280;201404;2448;6376;1863;5628;488;1502;1005;3089;1493;4591
291290;201404;5976;16911;5400;16201;978;3014;3393;10496;4371;13510
291300;201404;4511;13398;3787;12191;475;1679;2513;8099;2988;9778
291310;201404;5433;15738;4798;14683;429;1381;3629;11119;4058;12500
291320;201404;6016;19634;5264;18206;1461;5590;2455;8336;3916;13926
291330;201404;1626;5080;1532;4931;198;737;976;3020;1174;3757
291340;201404;3931;11673;3166;10590;333;1294;2412;8027;2745;9321
291345;201404;3523;11609;3343;11410;244;848;2904;10085;3148;10933
291350;201404;6172;18359;5521;17367;563;1914;3810;12185;4373;14099
291360;201404;36013;105229;33715;101866;8556;26029;20108;62851;28664;88880
291370;201404;9147;26855;8760;26340;1034;3043;6614;20477;7648;23520
291380;201404;3847;11990;3399;11265;301;1022;2461;8399;2762;9421
291390;201404;10562;29605;9662;28543;1461;4191;7123;21440;8584;25631
291400;201404;17090;45175;13984;41043;2472;7353;8635;26459;11107;33812
291410;201404;3311;8689;2462;7460;199;825;1820;5340;2019;6165
291420;201404;2277;6037;2023;5734;102;276;1824;5216;1926;5492
291430;201404;3379;10016;2992;9509;242;971;2344;7348;2586;8319
291440;201404;6086;19477;5242;17962;583;2130;3927;13636;4510;15766
291450;201404;7533;23463;6955;22558;394;1308;5727;18949;6121;20257
291460;201404;13338;40893;11965;38872;2391;8330;7394;24214;9785;32544
291465;201404;8330;24214;7593;23369;845;2906;5985;18408;6830;21314
291470;201404;15706;44091;13981;41959;1341;4079;10700;33201;12041;37280
291480;201404;35737;97445;31941;92212;5433;17585;20235;58084;25668;75669
291490;201404;4315;14598;4231;14483;494;1700;3434;11927;3928;13627
291500;201404;4227;12369;3666;11575;270;980;2903;9125;3173;10105
291510;201404;3640;11262;3380;10917;154;541;3053;9933;3207;10474
291520;201404;4115;11154;3640;10514;543;1498;2429;7410;2972;8908
291530;201404;2119;6221;1811;5740;491;1683;856;2797;1347;4480
291535;201404;4370;12797;3947;12180;344;1112;2950;9457;3294;10569
291540;201404;2218;5417;1912;5097;184;444;1573;4321;1757;4765
291550;201404;5691;15436;5133;14674;1337;3864;2674;7822;4011;11686
291560;201404;17164;44446;13541;40350;1552;4820;10171;31058;11723;35878
291570;201404;2425;6530;2311;6390;182;471;2008;5646;2190;6117
291580;201404;5935;18321;5312;17370;753;2949;3522;11482;4275;14431
291590;201404;2020;6300;1817;5969;294;1048;1161;3949;1455;4997
291600;201404;5586;15624;4191;13636;1016;3687;1985;6298;3001;9985
291610;201404;5228;15547;5083;15353;411;1361;4246;12859;4657;14220
291620;201404;3092;7369;2567;6815;182;478;2023;5567;2205;6045
291630;201404;3209;8110;2821;7671;298;787;2290;6381;2588;7168
291640;201404;17867;49240;14925;45373;3895;12917;6239;19138;10134;32055
291650;201404;8136;24441;7513;23706;761;1958;6160;20327;6921;22285
291660;201404;2396;6369;2134;6001;263;881;1429;3843;1692;4724
291670;201404;2510;7051;2321;6758;349;1078;1323;4104;1672;5182
291680;201404;5008;14363;4527;13598;1121;3849;2079;6437;3200;10286
291685;201404;4471;11432;3911;10764;451;1224;2875;8262;3326;9486
291690;201404;4052;11173;3359;10085;329;991;2316;7044;2645;8035
291700;201404;9526;29915;8827;28786;1101;3704;6399;21292;7500;24996
291710;201404;6002;16122;5224;15117;1012;3125;3065;9285;4077;12410
291720;201404;3844;13521;3521;12849;418;1761;2534;9089;2952;10850
291730;201404;5924;19005;5553;18520;1155;3958;3613;12421;4768;16379
291733;201404;2642;7850;2255;7342;315;1063;1480;4886;1795;5949
291735;201404;2423;7075;2085;6561;135;515;1703;5313;1838;5828
291740;201404;4041;11829;3225;10578;331;1256;2257;7397;2588;8653
291750;201404;22255;58801;17694;51992;3981;12272;9169;27315;13150;39587
291760;201404;12323;39509;11394;37879;4157;15256;4412;14594;8569;29850
291770;201404;8089;23608;7329;22319;1262;4147;4680;14128;5942;18275
291780;201404;4336;13503;4105;13073;538;1717;3008;9646;3546;11363
291790;201404;2486;7876;2352;7694;135;543;1995;6484;2130;7027
291800;201404;31709;92915;28808;88786;6207;20043;17089;54021;23296;74064
291810;201404;10869;31207;9344;29379;687;2396;7497;23811;8184;26207
291820;201404;3621;10989;3270;10473;373;1198;2397;7817;2770;9015
291830;201404;4431;12064;4154;11666;546;1640;3098;8713;3644;10353
291835;201404;6181;19414;5139;17698;1294;4761;2922;10067;4216;14828
291840;201404;49524;136661;42397;128997;5659;16981;32023;100414;37682;117395
291845;201404;2994;8737;2697;8400;267;800;2284;7233;2551;8033
291850;201404;4834;13630;4080;12581;456;1382;3015;9565;3471;10947
291855;201404;1711;4533;1482;4238;207;704;1062;2942;1269;3646
291860;201404;2064;6194;1785;5656;180;612;1148;3651;1328;4263
291870;201404;1388;3783;1095;3265;114;437;695;2034;809;2471
291875;201404;2905;9283;2617;8833;240;997;1832;6049;2072;7046
291880;201404;4654;14961;4453;14636;353;1199;3670;12151;4023;13350
291890;201404;1427;3607;1211;3346;277;807;707;2008;984;2815
291900;201404;1332;3817;1143;3521;118;412;858;2617;976;3029
291905;201404;2977;7916;2493;7146;217;733;1749;5051;1966;5784
291910;201404;2638;7245;2296;6824;174;638;1860;5473;2034;6111
291915;201404;6720;20972;6005;19585;519;1819;4850;16027;5369;17846
291920;201404;32671;96742;30316;93289;6492;20636;17700;56132;24192;76768
291930;201404;2575;7701;2337;7339;255;909;1708;5367;1963;6276
291940;201404;3608;10357;2730;8801;415;1499;1500;4690;1915;6189
291950;201404;9321;31630;8489;30273;2023;7270;4486;16557;6509;23827
291955;201404;8411;27243;8100;26765;2030;6754;4648;15925;6678;22679
291960;201404;3410;10141;2916;9443;342;1057;2047;6987;2389;8044
291970;201404;4413;13306;3931;12693;635;2209;2627;8565;3262;10774
291980;201404;11524;33501;8842;29634;1066;3692;6130;21010;7196;24702
291990;201404;2183;7091;2012;6824;203;729;1483;5150;1686;5879
291992;201404;2833;8826;2767;8693;522;1721;1896;5924;2418;7645
291995;201404;2149;6368;1923;6042;246;813;1410;4490;1656;5303
292000;201404;2375;7114;2157;6799;430;1527;1345;4191;1775;5718
292010;201404;6390;16531;4933;14386;523;1544;3691;10846;4214;12390
292020;201404;4495;15303;4174;14787;724;2745;2807;10115;3531;12860
292030;201404;2248;7048;1996;6692;245;920;1285;4342;1530;5262
292040;201404;4651;13061;4131;12518;364;1029;3427;10806;3791;11835
292045;201404;2623;9206;2596;9162;91;307;2447;8668;2538;8975
292050;201404;6424;20188;5680;18717;555;2280;3867;12499;4422;14779
292060;201404;10985;31155;10543;30566;1089;3170;8506;24782;9595;27952
292070;201404;4407;14141;4297;14003;423;1213;3633;12081;4056;13294
292080;201404;3701;9814;3214;9189;295;886;2573;7438;2868;8324
292090;201404;4309;11560;3717;10885;344;1149;3001;8825;3345;9974
292100;201404;11090;31012;9621;29148;2727;8647;4782;15092;7509;23739
292105;201404;3215;9877;2797;9285;203;818;2222;7343;2425;8161
292110;201404;7103;18881;5464;16463;1262;3934;2983;9267;4245;13201
292120;201404;8605;24440;7694;22827;1559;4794;4056;12679;5615;17473
292130;201404;3203;8636;2877;8187;622;1686;1825;5385;2447;7071
292140;201404;5513;14332;4796;13378;651;1787;3257;9470;3908;11257
292145;201404;2718;8375;2480;8007;217;688;1852;6266;2069;6954
292150;201404;13641;41823;12678;40287;898;3315;9917;31867;10815;35182
292160;201404;2762;7973;2389;7476;173;514;1986;6373;2159;6887
292170;201404;8875;26543;7627;24396;1155;4031;4708;15320;5863;19351
292180;201404;3548;10321;2882;9276;438;1424;1798;5936;2236;7360
292190;201404;3256;9319;2855;8753;583;1900;1788;5547;2371;7447
292200;201404;5832;19794;5270;18641;1598;6103;2036;7202;3634;13305
292205;201404;3991;12506;3669;12074;263;1014;2935;9654;3198;10668
292210;201404;6719;19286;5839;18113;523;1709;4556;14480;5079;16189
292220;201404;1921;5483;1822;5340;422;1158;1078;3226;1500;4384
292225;201404;3070;9677;2838;9337;172;611;2320;7713;2492;8324
292230;201404;6254;19036;5991;18625;662;2507;4491;13552;5153;16059
292240;201404;4476;14290;4151;13568;669;2378;2539;8199;3208;10577
292250;201404;5270;16391;4954;15809;1098;3661;2552;8216;3650;11877
292260;201404;3143;9746;2999;9531;317;1067;2356;7494;2673;8561
292265;201404;3074;10117;2785;9598;222;932;2009;6858;2231;7790
292270;201404;3981;10906;3250;10046;247;999;2635;8070;2882;9069
292273;201404;2813;6880;2172;6076;301;822;1526;4480;1827;5302
292275;201404;1901;4982;1782;4817;215;674;1335;3565;1550;4239
292280;201404;2091;6229;1905;6027;219;557;1434;4897;1653;5454
292285;201404;2639;7470;2348;7053;228;794;1798;5468;2026;6262
292290;201404;7425;22458;6267;20948;460;1765;4913;16689;5373;18454
292300;201404;8569;26460;7545;25319;2210;7557;4226;14694;6436;22251
292303;201404;2833;8961;2649;8710;111;426;2281;7514;2392;7940
292305;201404;3177;8698;3026;8502;107;331;2715;7661;2822;7992
292310;201404;5955;17887;5432;17164;253;878;4563;14466;4816;15344
292320;201404;6129;18649;5459;17487;593;2210;4084;12997;4677;15207
292330;201404;2014;5774;1897;5615;227;757;1444;4216;1671;4973
292335;201404;5345;14085;4792;13365;518;1489;3814;10711;4332;12200
292340;201404;6624;19123;5738;17740;628;2022;4052;12666;4680;14688
292350;201404;2174;6651;2010;6444;255;927;1522;4879;1777;5806
292360;201404;4964;14512;4784;14002;177;535;4189;12543;4366;13078
292370;201404;8811;26492;8001;25287;1124;3441;5482;18172;6606;21613
292380;201404;7487;21862;6991;21082;614;1684;5660;17384;6274;19068
292390;201404;3775;8581;3344;8117;116;215;3118;7671;3234;7886
292400;201404;22244;66335;21285;64798;3215;10402;14740;45707;17955;56109
292405;201404;4394;11842;3831;11150;273;809;3162;9313;3435;10122
292410;201404;1932;5245;1841;5142;150;439;1591;4438;1741;4877
292420;201404;3825;12321;3689;12164;170;479;3362;11333;3532;11812
292430;201404;5533;16973;4445;15444;263;1090;3435;11899;3698;12989
292440;201404;8591;28447;8006;27593;297;1173;6976;24405;7273;25578
292450;201404;4443;13249;3659;12004;350;1228;2634;8781;2984;10009
292460;201404;5681;17143;5034;15988;999;3296;3022;9723;4021;13019
292465;201404;2401;7365;2077;6844;243;948;1468;4843;1711;5791
292467;201404;2151;7098;2042;6915;420;1539;1289;4417;1709;5956
292470;201404;3209;8637;2679;7782;229;795;1998;5724;2227;6519
292480;201404;6122;16847;5279;15682;348;1195;4366;12994;4714;14189
292490;201404;2327;6504;1962;5965;171;632;1486;4446;1657;5078
292500;201404;6623;20066;5794;18647;587;2191;4172;13541;4759;15732
292510;201404;13295;38436;11818;36357;1257;4211;8951;27961;10208;32172
292520;201404;5920;18126;5439;17329;1617;5255;2536;8267;4153;13522
292525;201404;5553;14632;4854;13810;397;1187;3891;11226;4288;12413
292530;201404;25837;77751;23633;75009;5642;18628;13416;44181;19058;62809
292540;201404;2878;8462;2611;8085;393;1438;1862;5682;2255;7120
292550;201404;6469;21201;5812;20251;915;3373;3993;14272;4908;17645
292560;201404;4195;11628;3603;10854;305;1123;2892;8561;3197;9684
292570;201404;4071;12140;3919;11980;126;392;3450;10903;3576;11295
292575;201404;5999;20813;5861;20561;1038;3792;4145;14584;5183;18376
292580;201404;7180;21352;6668;20716;563;1779;5485;17263;6048;19042
292590;201404;7271;23184;6950;22661;921;3009;5058;16714;5979;19723
292593;201404;3289;8672;2790;7942;274;760;2119;6045;2393;6805
292595;201404;6046;16968;5288;15986;522;1676;3973;12152;4495;13828
292600;201404;10654;30275;9983;29431;1223;2924;7866;24237;9089;27161
292610;201404;4384;12851;3614;11565;479;1610;2304;7533;2783;9143
292620;201404;5900;18045;5193;17213;308;1108;4578;15305;4886;16413
292630;201404;9984;25416;8670;23478;862;2439;6451;17776;7313;20215
292640;201404;8270;26925;7359;25708;645;2392;5619;20125;6264;22517
292650;201404;4995;13614;4802;13392;511;1065;3854;11530;4365;12595
292660;201404;11159;34146;10630;33372;1436;4651;7820;25078;9256;29729
292665;201404;2851;8377;2785;8284;82;218;2602;7836;2684;8054
292670;201404;3920;11201;3049;9729;314;1106;1963;6310;2277;7416
292680;201404;3668;11158;3451;10840;380;1159;2734;8666;3114;9825
292690;201404;3368;9226;2464;7835;319;1128;1597;5175;1916;6303
292700;201404;9331;28409;8134;26678;1196;3693;5691;19589;6887;23282
292710;201404;1953;6459;1861;6323;92;335;1650;5631;1742;5966
292720;201404;9570;24939;8478;23711;757;2188;7023;19868;7780;22056
292730;201404;3408;10600;3305;10430;540;1672;2272;7373;2812;9045
292740;201404;354767;1004342;338037;980115;81616;251112;196235;569361;277851;820473
292750;201404;5956;16510;5387;15751;376;1110;4352;12943;4728;14053
292760;201404;4286;13750;3973;13206;578;2104;2558;8599;3136;10703
292770;201404;6127;18859;5748;18264;1346;4371;3392;11159;4738;15530
292780;201404;1888;4602;1492;4110;198;695;1052;2819;1250;3514
292790;201404;3399;9121;3255;8964;257;604;2731;7852;2988;8456
292800;201404;9519;28923;8924;27972;914;3136;6832;21413;7746;24549
292805;201404;3192;9425;2934;9055;591;2031;1881;5795;2472;7826
292810;201404;10100;30732;8561;28697;1232;4344;6158;21125;7390;25469
292820;201404;7484;21594;5523;18809;417;1599;4376;14977;4793;16576
292830;201404;1889;5651;1711;5405;121;484;1383;4324;1504;4808
292840;201404;7318;24187;6853;23543;453;1748;5860;20148;6313;21896
292850;201404;3259;8650;2709;7839;320;963;1907;5491;2227;6454
292860;201404;15328;41970;14705;41185;2025;5719;11137;31548;13162;37267
292870;201404;19601;54829;17431;51468;3229;10532;10103;29401;13332;39933
292880;201404;11972;35834;10839;34076;1974;6316;6638;21112;8612;27428
292890;201404;5623;19492;5092;18488;1026;3914;2846;10614;3872;14528
292895;201404;2769;7008;2249;6219;300;852;1602;4403;1902;5255
292900;201404;3068;9647;2908;9391;413;1622;1945;6032;2358;7654
292905;201404;4288;12563;3641;11746;304;882;2998;10002;3302;10884
292910;201404;5132;16020;4749;15310;864;2989;2917;9331;3781;12320
292920;201404;8704;26100;8291;25454;927;3125;6264;18754;7191;21879
292925;201404;5133;16133;4577;15357;415;1472;3527;11923;3942;13395
292930;201404;6525;21238;6231;20695;810;3304;4472;14462;5282;17766
292935;201404;2143;6160;1812;5801;122;324;1530;5103;1652;5427
292937;201404;3332;8567;2836;7946;313;1006;2170;5996;2483;7002
292940;201404;3121;8698;2477;7804;297;958;1644;5370;1941;6328
292950;201404;8241;25254;7879;24644;995;3710;5648;17176;6643;20886
292960;201404;4793;13303;4317;12628;493;1595;3024;8742;3517;10337
292970;201404;4292;13350;3940;12887;187;773;3296;10763;3483;11536
292975;201404;3410;9414;3289;9234;380;1086;2666;7556;3046;8642
292980;201404;3615;10064;2960;9264;385;1437;2051;6395;2436;7832
292990;201404;12309;35542;11213;33875;747;2352;9426;28586;10173;30938
293000;201404;2969;7846;2437;7178;124;431;2104;6185;2228;6616
293010;201404;18951;53984;16642;50353;3174;10611;9961;30070;13135;40681
293015;201404;7808;25692;6378;23581;1068;4285;4004;14677;5072;18962
293020;201404;9461;31548;8859;30703;619;2413;7247;25397;7866;27810
293030;201404;5589;16468;4575;14966;445;1594;3154;10670;3599;12264
293040;201404;3704;11984;3545;11772;242;857;3063;10216;3305;11073
293050;201404;20227;57595;18039;54796;2961;9258;11745;36764;14706;46022
293060;201404;4348;11207;3678;10150;400;1211;2485;6799;2885;8010
293070;201404;20515;62945;19035;60408;5408;17862;9322;30218;14730;48080
293075;201404;3468;11141;3146;10745;292;1050;2549;8789;2841;9839
293076;201404;3738;10603;3486;10244;294;840;2872;8615;3166;9455
293077;201404;5075;15836;4409;14979;882;3197;2611;9005;3493;12202
293080;201404;4908;15472;4516;14838;321;1359;3539;11387;3860;12746
293090;201404;3589;11313;2964;10431;316;1107;2234;8019;2550;9126
293100;201404;5758;17696;4962;16306;569;1960;3566;11921;4135;13881
293105;201404;3890;13075;3447;12218;583;2119;2218;8051;2801;10170
293110;201404;1963;5951;1833;5743;118;449;1494;4651;1612;5100
293120;201404;4064;13634;3780;13231;356;1251;2985;10641;3341;11892
293130;201404;3945;11407;3230;10597;183;684;2820;9389;3003;10073
293135;201404;28964;75388;22609;66920;4193;14718;11436;33464;15629;48182
293140;201404;2110;6317;2039;6215;201;760;1549;4594;1750;5354
293150;201404;5865;19347;5288;18245;1124;3939;2948;10598;4072;14537
293160;201404;3532;9657;3329;9414;500;1114;2504;7516;3004;8630
293170;201404;3436;10585;3215;10253;484;1675;2244;7259;2728;8934
293180;201404;5374;15239;4480;13863;359;1323;3466;10572;3825;11895
293190;201404;13868;42537;13172;41474;572;2578;11309;34854;11881;37432
293200;201404;6398;18866;5696;17871;271;1000;4869;15234;5140;16234
293210;201404;4858;14748;4518;14182;522;1752;3241;10290;3763;12042
293220;201404;5247;15978;4739;15172;1225;4159;2343;7640;3568;11799
293230;201404;3946;12468;3658;12073;452;1682;2780;9140;3232;10822
293240;201404;4550;12007;3603;10646;200;592;2780;8205;2980;8797
293245;201404;4459;12986;4086;12384;520;1610;2851;8955;3371;10565
293250;201404;5995;17020;5512;16312;787;2483;3835;11348;4622;13831
293260;201404;4758;14377;4002;13307;357;1297;2949;9986;3306;11283
293270;201404;5871;16156;5578;15839;590;1532;4693;13660;5283;15192
293280;201404;5683;16144;4962;15199;425;1255;3803;12054;4228;13309
293290;201404;16553;55779;15699;54060;3707;13251;8446;29791;12153;43042
293300;201404;6473;16378;5575;15372;459;1214;4492;12552;4951;13766
293305;201404;4768;12095;4206;11322;284;846;3438;9243;3722;10089
293310;201404;2748;7134;2265;6342;248;780;1530;4236;1778;5016
293315;201404;4947;12664;4508;12006;743;1957;2780;7826;3523;9783
293317;201404;2580;7616;2332;7165;294;916;1519;4715;1813;5631
293320;201404;8169;26901;7985;26664;945;3431;6430;21448;7375;24879
293325;201404;1942;5679;1620;5182;291;1008;1015;3266;1306;4274
293330;201404;55337;176167;50042;167325;11428;41515;26257;89033;37685;130548
293340;201404;2734;7845;2180;6897;306;1106;1475;4565;1781;5671
293345;201404;3533;10698;3001;9937;377;1218;2094;7245;2471;8463
293350;201404;6779;18950;6499;18622;445;1173;5708;16693;6153;17866
293360;201404;13829;42294;12631;40724;780;2493;10655;35131;11435;37624
310010;201404;1244;3405;905;2865;240;916;360;1029;600;1945
310020;201404;3854;12307;3230;10940;1080;3960;552;1676;1632;5636
310030;201404;2501;8353;2220;7814;710;2641;960;3375;1670;6016
310040;201404;1005;2775;856;2573;103;372;613;1801;716;2173
310050;201404;1950;6817;1740;6308;352;1531;850;2994;1202;4525
310060;201404;3207;10988;2951;10627;385;1456;2193;8045;2578;9501
310070;201404;313;906;237;765;35;148;118;342;153;490
310080;201404;776;2422;632;2140;174;678;199;620;373;1298
310090;201404;4881;14663;4235;13557;740;2676;2506;7992;3246;10668
310100;201404;3345;10371;2810;9479;312;1261;2039;6810;2351;8071
310110;201404;5908;16874;5012;15542;1096;3934;2664;8141;3760;12075
310120;201404;588;1950;559;1893;223;890;208;581;431;1471
310130;201404;465;1472;426;1411;105;403;206;639;311;1042
310140;201404;267;924;233;861;69;297;52;162;121;459
310150;201404;4908;15388;4482;14621;995;3655;2262;7328;3257;10983
310160;201404;7270;23800;6359;22153;1931;7449;2295;7838;4226;15287
310163;201404;815;2752;714;2547;201;808;261;891;462;1699
310170;201404;9846;28415;9107;27301;1713;5485;5651;17517;7364;23002
310180;201404;1871;5490;1530;5016;404;1527;693;2172;1097;3699
310190;201404;2558;8663;2326;8275;663;2622;346;1264;1009;3886
310200;201404;1931;6565;1627;5941;477;1905;503;1802;980;3707
310205;201404;997;3127;884;2910;188;630;495;1673;683;2303
310210;201404;2503;8003;2321;7719;374;1394;1607;5316;1981;6710
310220;201404;1276;3676;1030;3357;226;803;558;1795;784;2598
310230;201404;2946;9750;2555;8868;753;3029;935;2949;1688;5978
310240;201404;1035;3666;884;3378;151;660;450;1790;601;2450
310250;201404;974;3393;951;3359;200;816;576;1944;776;2760
310260;201404;3227;10549;2744;9519;738;2889;990;3329;1728;6218
310270;201404;2395;7259;2154;6899;253;909;1604;5187;1857;6096
310280;201404;2157;6310;1945;5968;641;2307;777;2195;1418;4502
310285;201404;2227;7857;2096;7666;266;983;1539;5773;1805;6756
310290;201404;1339;4232;1251;4099;380;1436;559;1627;939;3063
310300;201404;1910;6575;1813;6380;516;1996;960;3334;1476;5330
310310;201404;398;1108;292;885;53;180;137;405;190;585
310320;201404;392;1329;340;1211;81;332;145;498;226;830
310330;201404;502;1292;378;1079;40;153;207;525;247;678
310340;201404;8420;26880;7471;25296;1528;5463;4139;14431;5667;19894
310350;201404;15012;44096;12002;38706;4174;14631;3018;9768;7192;24399
310360;201404;465;1474;452;1451;79;304;301;912;380;1216
310370;201404;1459;5193;1408;5096;444;1696;679;2461;1123;4157
310375;201404;1297;3597;939;2935;150;525;438;1338;588;1863
310380;201404;400;1142;323;1032;134;477;120;344;254;821
310390;201404;495;1790;424;1626;113;475;66;208;179;683
310400;201404;10334;31381;8353;27811;2716;9953;2228;7375;4944;17328
310410;201404;1042;3378;680;2793;239;1056;115;455;354;1511
310420;201404;5759;16907;3498;11647;817;3075;547;1587;1364;4662
310430;201404;1654;5695;1383;5142;451;1789;340;1245;791;3034
310440;201404;621;1823;543;1701;152;539;197;577;349;1116
310445;201404;1203;4129;1038;3849;155;639;668;2520;823;3159
310450;201404;4560;13423;3804;12308;763;2645;2271;7535;3034;10180
310460;201404;1596;5215;1396;4859;467;1778;308;1125;775;2903
310470;201404;3736;9781;3194;9111;330;1107;2486;7102;2816;8209
310480;201404;1088;3428;938;3141;225;887;365;1101;590;1988
310490;201404;3324;11366;2926;10598;950;3801;1024;3648;1974;7449
310500;201404;1510;5287;1402;5076;438;1722;530;1894;968;3616
310510;201404;2525;8418;2212;7698;787;2991;447;1472;1234;4463
310520;201404;1366;3789;1143;3417;81;239;767;2309;848;2548
310530;201404;864;2803;567;2038;116;467;95;330;211;797
310540;201404;3743;12458;3474;12053;1190;4381;1280;4525;2470;8906
310550;201404;1195;3694;1015;3386;302;1188;382;1165;684;2353
310560;201404;16318;51732;14210;47623;4681;17467;4544;14391;9225;31858
310570;201404;1274;3988;1193;3881;169;618;864;2798;1033;3416
310590;201404;4113;12267;3312;10744;625;2326;1252;3860;1877;6186
310600;201404;1640;5567;1549;5372;521;2029;507;1631;1028;3660
310610;201404;558;1923;514;1829;149;626;170;543;319;1169
310620;201404;189397;606768;157323;541865;42655;163861;57461;188750;100116;352611
310630;201404;4190;13846;3979;13453;875;3391;2461;8040;3336;11431
310640;201404;1460;4559;1202;4105;400;1483;325;1039;725;2522
310650;201404;2925;9415;2401;8522;528;2049;1205;4381;1733;6430
310660;201404;1332;4124;1166;3888;193;733;810;2650;1003;3383
310665;201404;1193;3767;1102;3637;207;734;720;2427;927;3161
310670;201404;56195;178998;52126;169970;16144;55813;21064;67501;37208;123314
310680;201404;804;2406;740;2299;178;602;363;1104;541;1706
310690;201404;1270;4337;1050;3879;299;1260;254;887;553;2147
310700;201404;525;1469;448;1356;130;442;217;619;347;1061
310710;201404;7326;24046;5894;21685;1503;6268;1850;6607;3353;12875
310720;201404;857;2675;782;2537;245;922;330;974;575;1896
310730;201404;9528;30566;8805;29442;2108;7632;4946;16606;7054;24238
310740;201404;5136;17691;4436;16170;1542;6080;935;3211;2477;9291
310750;201404;1628;4271;1344;3890;253;769;846;2465;1099;3234
310760;201404;640;2010;552;1856;131;474;233;780;364;1254
310770;201404;751;2795;739;2774;297;1253;284;1000;581;2253
310780;201404;3654;10606;3289;9976;657;2041;1881;5714;2538;7755
310790;201404;1810;5846;1658;5598;481;1715;788;2724;1269;4439
310800;201404;3105;10227;2533;9065;988;3856;347;1181;1335;5037
310810;201404;1528;4323;1399;4111;357;1168;644;1782;1001;2950
310820;201404;1502;4314;1103;3616;317;1145;325;1013;642;2158
310825;201404;2419;8331;1974;7552;139;740;1471;5554;1610;6294
310830;201404;1444;4954;1226;4487;433;1694;330;1124;763;2818
310840;201404;2308;7688;2012;7091;747;2917;508;1652;1255;4569
310850;201404;1553;4738;1336;4450;227;846;922;3061;1149;3907
310855;201404;3136;10320;2850;9857;724;2637;1551;5525;2275;8162
310860;201404;7661;24494;6885;23174;1303;4557;3825;13359;5128;17916
310870;201404;1038;3004;878;2734;201;686;399;1227;600;1913
310880;201404;1261;3935;962;3377;199;793;437;1518;636;2311
310890;201404;2787;8951;2223;7886;660;2646;545;1789;1205;4435
310900;201404;4387;14907;3838;13813;1160;4642;1460;5054;2620;9696
310910;201404;2078;6055;1459;4887;424;1613;329;1023;753;2636
310920;201404;1903;5915;1528;5370;410;1650;708;2457;1118;4107
310925;201404;959;3222;877;3083;324;1268;259;905;583;2173
310930;201404;5360;16000;4369;14452;914;3239;2381;8128;3295;11367
310940;201404;6268;18713;5433;17468;1109;3860;2926;9480;4035;13340
310945;201404;1311;3768;1070;3433;235;868;578;1775;813;2643
310950;201404;2017;6775;1627;5924;538;2196;453;1513;991;3709
310960;201404;465;1618;417;1525;150;601;135;496;285;1097
310970;201404;1475;5262;1154;4391;423;1755;121;399;544;2154
310980;201404;485;1294;336;1008;59;213;143;375;202;588
310990;201404;1179;4116;1022;3779;239;1000;342;1178;581;2178
311000;201404;4334;15256;3880;14274;1198;4955;1272;4419;2470;9374
311010;201404;966;3142;862;2956;273;999;386;1299;659;2298
311020;201404;884;2823;762;2618;170;667;307;983;477;1650
311030;201404;1894;5747;1480;4895;487;1791;460;1342;947;3133
311040;201404;500;1712;434;1533;112;415;100;338;212;753
311050;201404;2632;8572;2255;7834;729;2774;801;2764;1530;5538
311060;201404;2411;7657;1977;6705;540;1977;455;1484;995;3461
311070;201404;1733;6200;1538;5800;440;1893;475;1743;915;3636
311080;201404;1209;3300;1088;3109;154;515;706;2024;860;2539
311090;201404;1695;6509;1498;6075;505;2338;258;954;763;3292
311100;201404;2378;8357;2109;7798;951;3705;453;1664;1404;5369
311110;201404;4097;9954;2941;8334;596;1885;1444;4019;2040;5904
311115;201404;1101;3431;964;3225;131;553;598;2020;729;2573
311120;201404;7633;22029;6093;19216;1567;5582;1578;4594;3145;10176
311130;201404;2381;7386;1923;6774;586;2385;777;2615;1363;5000
311140;201404;1301;3806;1133;3600;188;712;778;2412;966;3124
311150;201404;2438;8177;2256;7873;611;2236;1053;3739;1664;5975
311160;201404;4933;16851;4199;15589;1542;6137;1229;4474;2771;10611
311170;201404;753;2375;602;2081;54;211;331;1202;385;1413
311180;201404;1626;4571;1191;3714;354;1230;245;673;599;1903
311190;201404;1108;3376;943;3045;255;962;355;1050;610;2012
311200;201404;2549;7963;2217;7278;853;3064;490;1435;1343;4499
311205;201404;1195;3934;1062;3676;273;1079;378;1343;651;2422
311210;201404;952;3138;882;3027;175;602;606;2148;781;2750
311220;201404;927;3002;745;2587;207;760;234;799;441;1559
311230;201404;9035;27809;7657;25421;1688;6101;3616;12385;5304;18486
311240;201404;1354;4202;1135;3843;366;1369;338;1114;704;2483
311250;201404;1333;4491;1220;4320;403;1570;337;1035;740;2605
311260;201404;2957;8161;2254;6929;735;2490;584;1697;1319;4187
311265;201404;1326;3581;1028;3165;160;600;666;2033;826;2633
311270;201404;3424;11415;3088;10964;621;2609;1919;6637;2540;9246
311280;201404;1436;4051;1080;3369;278;959;319;959;597;1918
311290;201404;2323;7662;2154;7308;434;1444;1193;4215;1627;5659
311300;201404;5047;16879;4582;16130;752;3010;2901;10298;3653;13308
311310;201404;494;1770;479;1745;117;496;187;639;304;1135
311320;201404;4131;14047;3635;12922;945;3805;1188;3968;2133;7773
311330;201404;5532;17117;4768;15892;1734;6216;1410;4680;3144;10896
311340;201404;12298;40223;11270;38286;3907;14370;3251;10911;7158;25281
311350;201404;2332;6991;2005;6407;444;1690;881;2668;1325;4358
311360;201404;1347;3835;1083;3488;469;1601;279;934;748;2535
311370;201404;4556;13752;4068;12917;986;3872;1664;4924;2650;8796
311380;201404;480;1604;407;1467;121;485;110;365;231;850
311390;201404;1978;7426;1891;7267;832;3557;563;2049;1395;5606
311400;201404;1712;5783;1586;5559;466;1844;665;2141;1131;3985
311410;201404;2024;7422;1897;7235;655;2676;895;3444;1550;6120
311420;201404;2372;8311;2045;7497;734;2882;422;1367;1156;4249
311430;201404;3954;12614;3047;10616;716;2752;564;1913;1280;4665
311440;201404;2352;8172;1945;7477;737;3173;442;1660;1179;4833
311450;201404;1864;6613;1581;5917;442;1822;371;1289;813;3111
311455;201404;1602;4385;1382;4062;304;1022;734;2067;1038;3089
311460;201404;635;2113;510;1855;120;555;130;439;250;994
311470;201404;615;1973;494;1709;132;553;143;444;275;997
311480;201404;813;2304;773;2241;270;812;302;822;572;1634
311490;201404;320;1269;310;1237;117;496;98;376;215;872
311500;201404;520;1576;431;1413;155;561;146;458;301;1019
311510;201404;3164;9953;2638;8964;1025;3928;659;2080;1684;6008
311520;201404;695;2406;655;2321;244;933;228;789;472;1722
311530;201404;11418;30593;7928;24504;2138;7896;2162;6269;4300;14165
311535;201404;731;2258;537;1866;135;539;100;332;235;871
311540;201404;707;2577;677;2531;250;956;302;1119;552;2075
311545;201404;2215;7029;2097;6861;346;1268;1423;4643;1769;5911
311547;201404;1667;4700;1420;4323;138;454;954;2933;1092;3387
311550;201404;3388;11146;2964;10259;909;3489;900;3016;1809;6505
311560;201404;280;762;251;726;57;187;136;373;193;560
311570;201404;2037;5238;1704;4834;126;377;1386;3995;1512;4372
311580;201404;2368;5306;1992;4851;606;1448;1084;2735;1690;4183
311590;201404;387;1257;340;1195;92;393;92;316;184;709
311600;201404;1345;4108;1175;3891;256;870;654;2268;910;3138
311610;201404;3454;12083;3210;11697;1089;3968;1325;5238;2414;9206
311615;201404;2711;8968;2370;8371;326;1309;1594;5621;1920;6930
311620;201404;460;1499;416;1439;114;457;204;669;318;1126
311630;201404;1462;4397;1251;4015;352;1131;585;1913;937;3044
311640;201404;896;2821;749;2582;144;535;489;1691;633;2226
311650;201404;2445;7066;2054;6451;301;1088;1183;3764;1484;4852
311660;201404;2592;9288;2310;8610;677;2808;419;1353;1096;4161
311670;201404;1428;4478;1250;4150;466;1710;465;1489;931;3199
311680;201404;2283;7250;1948;6759;512;1891;1014;3596;1526;5487
311690;201404;537;1512;455;1413;86;295;297;913;383;1208
311700;201404;2149;6323;1921;5982;195;796;1453;4403;1648;5199
311710;201404;1745;5462;1387;4812;577;2205;361;1198;938;3403
311720;201404;407;1405;377;1346;73;291;231;803;304;1094
311730;201404;5244;14032;3438;10886;1063;3741;1157;3377;2220;7118
311740;201404;1006;2901;880;2753;395;1246;359;1186;754;2432
311750;201404;3879;13303;3593;12867;640;2542;2211;7988;2851;10530
311760;201404;800;2779;750;2674;243;1010;264;801;507;1811
311770;201404;2584;8237;2127;7415;578;2280;641;2141;1219;4421
311780;201404;1057;4030;925;3695;322;1449;169;634;491;2083
311783;201404;2055;6781;1852;6409;207;887;1206;4287;1413;5174
311787;201404;642;2259;477;1765;95;384;94;291;189;675
311790;201404;1293;4223;1080;3797;295;1118;254;855;549;1973
311800;201404;3899;13496;2901;10401;686;2642;232;676;918;3318
311810;201404;1044;3550;1001;3470;47;224;846;2893;893;3117
311820;201404;827;2756;710;2481;236;949;312;990;548;1939
311830;201404;10509;38152;9650;35997;3949;15482;2016;7457;5965;22939
311840;201404;3479;10475;3006;9763;989;3557;1175;3703;2164;7260
311850;201404;320;972;278;903;77;262;126;408;203;670
311860;201404;49665;156780;43595;145119;11652;42574;18076;58272;29728;100846
311870;201404;2386;7199;1923;6325;476;1819;613;1839;1089;3658
311880;201404;7136;21523;6478;20733;1003;3226;4489;15031;5492;18257
311890;201404;1617;5139;1372;4619;402;1506;496;1593;898;3099
311900;201404;799;2510;727;2411;154;529;438;1524;592;2053
311910;201404;4726;14077;3894;12929;1158;4186;1534;5105;2692;9291
311920;201404;2075;6853;1802;6446;216;880;1223;4334;1439;5214
311930;201404;4826;14544;4321;13719;1691;5822;1179;3715;2870;9537
311940;201404;11885;37012;10153;33402;3144;11417;2270;7014;5414;18431
311950;201404;2300;6896;1972;6475;124;400;1613;5376;1737;5776
311960;201404;392;1364;362;1299;119;470;135;446;254;916
311970;201404;474;1714;410;1569;125;530;67;236;192;766
311980;201404;749;2134;574;1855;137;468;231;762;368;1230
311990;201404;518;1583;461;1496;191;674;139;407;330;1081
311995;201404;1124;3517;799;2698;178;671;184;517;362;1188
312000;201404;698;2191;656;2128;112;413;369;1182;481;1595
312010;201404;1044;3406;955;3219;198;719;424;1438;622;2157
312015;201404;1592;4961;1379;4592;221;866;786;2646;1007;3512
312020;201404;930;3053;832;2914;216;850;437;1510;653;2360
312030;201404;1813;5476;1635;5249;219;783;1236;3935;1455;4718
312040;201404;690;2648;593;2353;164;725;112;416;276;1141
312050;201404;1479;5157;1296;4769;399;1631;255;877;654;2508
312060;201404;754;2320;670;2203;317;1109;171;501;488;1610
312070;201404;972;3054;655;2348;183;708;218;762;401;1470
312080;201404;2611;7421;2049;6537;464;1787;924;2675;1388;4462
312083;201404;943;2736;791;2515;118;436;465;1455;583;1891
312087;201404;2337;7196;2097;6864;373;1286;1403;4691;1776;5977
312090;201404;9868;32390;9085;31043;2924;10920;3512;11567;6436;22487
312100;201404;1364;4670;1205;4405;258;1073;645;2402;903;3475
312110;201404;1191;4283;1069;4015;383;1583;199;661;582;2244
312120;201404;918;3232;831;3035;261;1075;210;673;471;1748
312125;201404;1239;4080;1110;3801;311;1149;480;1649;791;2798
312130;201404;828;2564;677;2236;166;638;242;751;408;1389
312140;201404;1154;3648;976;3231;221;801;351;1054;572;1855
312150;201404;572;1654;486;1464;51;177;314;921;365;1098
312160;201404;8123;28058;7474;26732;2430;9503;2479;8903;4909;18406
312170;201404;1025;3094;930;2901;129;434;568;1795;697;2229
312180;201404;1612;5041;1482;4821;445;1535;550;1761;995;3296
312190;201404;672;2242;530;1959;214;885;94;312;308;1197
312200;201404;4772;14585;4175;13581;587;1996;2745;9029;3332;11025
312210;201404;1162;3276;940;2947;260;922;397;1172;657;2094
312220;201404;1914;6371;1736;6166;267;1011;1257;4637;1524;5648
312230;201404;18119;61071;15422;55632;7128;27479;2606;9604;9734;37083
312235;201404;1760;5095;1476;4657;182;709;961;3015;1143;3724
312240;201404;1126;3880;966;3540;287;1115;321;1169;608;2284
312245;201404;2385;7073;2081;6667;181;525;1658;5438;1839;5963
312247;201404;917;2746;712;2419;212;807;326;1121;538;1928
312250;201404;1149;3414;1005;3166;235;836;444;1356;679;2192
312260;201404;937;3014;787;2800;119;527;534;1874;653;2401
312270;201404;801;2581;698;2375;162;674;244;701;406;1375
312280;201404;472;1641;435;1553;183;695;48;163;231;858
312290;201404;814;2859;768;2792;298;1204;174;622;472;1826
312300;201404;1122;3783;950;3381;284;1074;116;356;400;1430
312310;201404;956;3681;873;3471;272;1167;327;1261;599;2428
312320;201404;2435;7030;1974;6101;553;1923;481;1235;1034;3158
312330;201404;1156;3553;1033;3369;289;1080;511;1657;800;2737
312340;201404;309;836;290;808;48;171;211;552;259;723
312350;201404;385;1011;357;976;51;167;281;730;332;897
312352;201404;1669;5502;1544;5327;538;1900;786;2803;1324;4703
312360;201404;3704;12720;3276;11839;1052;4091;817;2908;1869;6999
312370;201404;1671;5511;1551;5305;563;2128;508;1650;1071;3778
312380;201404;2001;5945;1835;5684;248;832;1280;4073;1528;4905
312385;201404;1237;3932;1141;3750;169;684;757;2375;926;3059
312390;201404;2034;6907;1741;6259;520;1977;311;1054;831;3031
312400;201404;3417;11416;3071;10739;1094;3977;1074;3908;2168;7885
312410;201404;10697;36220;9680;34184;2902;11216;3255;11164;6157;22380
312420;201404;4056;13096;3865;12872;819;2770;2461;8498;3280;11268
312430;201404;8529;25640;7598;24251;1433;4833;4746;15654;6179;20487
312440;201404;632;2071;565;1942;166;631;238;811;404;1442
312450;201404;1165;4276;1073;4080;482;1881;346;1310;828;3191
312460;201404;397;1228;357;1183;92;350;178;562;270;912
312470;201404;764;2203;535;1742;128;492;119;370;247;862
312480;201404;1296;4017;1123;3815;396;1432;467;1556;863;2988
312490;201404;2340;6171;1851;5498;299;1046;1014;2875;1313;3921
312500;201404;612;2167;581;2113;153;665;291;1013;444;1678
312510;201404;2365;7980;1964;7079;517;2102;642;2089;1159;4191
312520;201404;402;1381;356;1284;120;466;107;390;227;856
312530;201404;576;1929;551;1876;107;444;309;990;416;1434
312540;201404;1464;4729;1182;4170;291;1133;590;2023;881;3156
312550;201404;633;2068;572;1940;63;252;369;1222;432;1474
312560;201404;2176;5855;1906;5503;229;783;1410;4083;1639;4866
312570;201404;2718;8397;2405;7824;746;2625;702;2170;1448;4795
312580;201404;532;1804;435;1608;104;454;168;581;272;1035
312590;201404;1850;6282;1637;5808;488;1975;514;1627;1002;3602
312595;201404;2033;6944;1816;6414;550;2107;739;2521;1289;4628
312600;201404;812;2963;747;2820;214;913;308;1088;522;2001
312610;201404;8567;27247;7415;24987;2687;9808;2058;6675;4745;16483
312620;201404;2086;6068;1603;5437;101;367;1306;4574;1407;4941
312630;201404;511;1747;473;1674;134;543;198;664;332;1207
312640;201404;594;1981;495;1772;120;492;194;643;314;1135
312650;201404;2349;7064;1738;5919;185;757;924;3114;1109;3871
312660;201404;1266;3532;1091;3311;156;568;718;2126;874;2694
312670;201404;5964;18757;5514;18058;1437;5417;2654;8442;4091;13859
312675;201404;1469;4669;1272;4278;242;869;680;2319;922;3188
312680;201404;1721;5314;1542;5025;249;943;910;3003;1159;3946
312690;201404;2418;6717;2003;6133;393;1405;1080;3151;1473;4556
312695;201404;906;3264;852;3181;163;620;551;2132;714;2752
312700;201404;2190;6491;1705;5557;310;1153;854;2737;1164;3890
312705;201404;1411;4204;1239;3960;180;593;843;2700;1023;3293
312707;201404;1773;5523;1475;5020;254;1017;782;2604;1036;3621
312710;201404;8027;23107;6084;19702;2279;8221;1315;3911;3594;12132
312720;201404;760;2625;694;2500;191;767;279;951;470;1718
312730;201404;1899;4779;1427;4258;207;727;856;2547;1063;3274
312733;201404;1756;4781;1359;4041;118;443;959;2733;1077;3176
312735;201404;899;2717;801;2573;278;949;370;1183;648;2132
312737;201404;1045;2582;740;2167;254;789;270;833;524;1622
312738;201404;515;1689;419;1507;138;583;147;481;285;1064
312740;201404;502;1453;345;1248;122;485;87;313;209;798
312750;201404;1299;4777;1245;4664;335;1426;562;2054;897;3480
312760;201404;2429;7935;1939;6966;576;2310;426;1533;1002;3843
312770;201404;45202;126367;35629;111806;10451;35853;11017;34219;21468;70072
312780;201404;2812;10094;2526;9596;549;2290;1372;5337;1921;7627
312790;201404;372;1005;236;764;72;255;58;170;130;425
312800;201404;5235;17989;4582;16646;1458;5727;1351;4982;2809;10709
312810;201404;2218;6923;1648;5883;555;2191;325;1071;880;3262
312820;201404;2145;6450;1977;6169;257;956;1239;3739;1496;4695
312825;201404;1535;4230;1352;4009;143;461;1054;3118;1197;3579
312830;201404;2766;9048;2044;7553;551;2255;344;1261;895;3516
312840;201404;1173;3942;1002;3613;189;798;423;1454;612;2252
312850;201404;703;2314;604;2108;162;656;194;657;356;1313
312860;201404;1310;3868;1022;3424;349;1346;300;888;649;2234
312870;201404;5662;18191;4456;15898;1235;4979;1186;4011;2421;8990
312880;201404;1230;3753;1039;3425;221;829;503;1610;724;2439
312890;201404;1634;5081;1270;4367;424;1641;406;1338;830;2979
312900;201404;1455;4747;1351;4601;359;1288;776;2670;1135;3958
312910;201404;1502;3507;1176;3066;315;985;506;1200;821;2185
312920;201404;1041;3414;918;3239;305;1208;363;1222;668;2430
312930;201404;2223;6689;1982;6347;458;1552;995;3251;1453;4803
312940;201404;938;3174;847;3003;239;1007;261;853;500;1860
312950;201404;3515;10140;2885;9196;1014;3545;1081;3390;2095;6935
312960;201404;1931;5964;1748;5722;224;738;1295;4352;1519;5090
312965;201404;1799;5840;1548;5387;348;1315;825;2934;1173;4249
312970;201404;1146;4003;1032;3840;407;1712;176;614;583;2326
312980;201404;21052;74715;20291;72853;7931;30571;6783;23524;14714;54095
312990;201404;391;1207;298;1040;105;408;84;287;189;695
313000;201404;518;1752;449;1621;135;610;155;473;290;1083
313005;201404;2635;8643;2354;8179;390;1512;1429;4972;1819;6484
313010;201404;4096;13920;3696;13244;1135;4463;1416;4826;2551;9289
313020;201404;1047;3628;952;3409;304;1233;275;862;579;2095
313030;201404;1583;4526;1284;4123;366;1350;633;1916;999;3266
313040;201404;971;3457;829;3056;213;857;217;762;430;1619
313050;201404;1901;6309;1599;5858;523;2115;539;1899;1062;4014
313055;201404;1509;5091;1401;4933;144;523;1032;3735;1176;4258
313060;201404;973;3408;889;3214;379;1435;135;473;514;1908
313065;201404;1925;6479;1769;6232;290;1165;1244;4348;1534;5513
313070;201404;1271;3799;1034;3352;266;1006;474;1438;740;2444
313080;201404;475;1513;391;1348;119;470;109;313;228;783
313090;201404;5372;16330;4936;15592;824;2860;3223;10273;4047;13133
313100;201404;1156;3753;1079;3638;177;665;752;2508;929;3173
313110;201404;1707;5109;1359;4449;316;1184;484;1457;800;2641
313115;201404;2881;10223;2759;9974;884;3551;1198;4127;2082;7678
313120;201404;3837;11189;3344;10478;1119;3763;1554;4864;2673;8627
313130;201404;26916;86469;24258;80792;7241;26503;8090;25446;15331;51949
313140;201404;723;1913;537;1623;41;147;349;1043;390;1190
313150;201404;1664;5254;1506;4971;660;2269;376;1274;1036;3543
313160;201404;1179;3602;1058;3402;215;824;620;1896;835;2720
313170;201404;9751;36272;9062;34560;3471;13846;1795;6870;5266;20716
313180;201404;2729;7247;2080;6396;642;2233;679;1979;1321;4212
313190;201404;3546;13115;3190;12068;872;3572;1062;3907;1934;7479
313200;201404;1511;4811;1361;4581;220;883;842;2847;1062;3730
313210;201404;4618;14779;3970;13907;958;3882;2078;7068;3036;10950
313220;201404;1300;3994;977;3283;246;948;249;732;495;1680
313230;201404;2535;9074;2383;8842;424;1679;1483;5698;1907;7377
313240;201404;8242;28240;7121;26136;2065;8307;2719;9990;4784;18297
313250;201404;7729;24421;7034;23273;1309;4484;4132;14052;5441;18536
313260;201404;624;1964;522;1767;130;499;136;427;266;926
313270;201404;5660;16854;5087;16001;787;2628;3449;10994;4236;13622
313280;201404;545;1799;429;1509;86;348;104;331;190;679
313290;201404;1050;3812;875;3454;286;1211;205;758;491;1969
313300;201404;1955;6819;1698;6154;526;2054;318;1045;844;3099
313310;201404;1084;3862;996;3677;258;1081;182;611;440;1692
313320;201404;2433;7467;2039;6793;455;1614;829;2780;1284;4394
313330;201404;3884;12885;3457;12081;732;2961;1687;5801;2419;8762
313340;201404;2196;5439;1734;4788;381;1133;944;2542;1325;3675
313350;201404;3385;10707;2648;9041;666;2420;509;1569;1175;3989
313360;201404;1202;3709;935;3204;302;1214;383;1187;685;2401
313370;201404;1489;5241;1414;5027;284;1178;634;2076;918;3254
313375;201404;2088;5659;1419;4655;377;1490;491;1539;868;3029
313380;201404;6817;23597;5987;21772;2329;9154;1557;5324;3886;14478
313390;201404;917;3384;887;3337;140;604;577;2144;717;2748
313400;201404;3743;11047;3480;10723;455;1508;2622;8229;3077;9737
313410;201404;1382;3977;1181;3706;266;947;671;2085;937;3032
313420;201404;19694;49341;12955;37329;3050;10001;2958;8159;6008;18160
313430;201404;1321;4350;1191;4116;361;1392;411;1342;772;2734
313440;201404;6602;16082;4978;14180;771;2408;3375;9615;4146;12023
313450;201404;741;2233;598;1931;142;560;202;585;344;1145
313460;201404;2592;9304;2346;8867;810;3359;667;2403;1477;5762
313470;201404;3468;9769;3292;9563;380;998;2693;8062;3073;9060
313480;201404;1144;3397;886;2940;165;629;373;1185;538;1814
313490;201404;1596;5302;1190;4601;474;1853;269;1047;743;2900
313500;201404;450;1451;429;1414;93;353;253;803;346;1156
313505;201404;8952;26799;8408;26156;551;1332;7426;23947;7977;25279
313507;201404;1324;3968;1203;3785;238;889;689;2157;927;3046
313510;201404;15926;47929;14386;46009;2487;8277;9932;32558;12419;40835
313520;201404;16402;49815;13988;45762;2146;8147;8742;28384;10888;36531
313530;201404;554;1938;493;1813;77;330;190;647;267;977
313535;201404;2557;7755;2298;7327;405;1351;1409;4581;1814;5932
313540;201404;1142;3649;909;3064;266;943;218;671;484;1614
313545;201404;1403;5179;1247;4893;242;1159;737;2760;979;3919
313550;201404;1969;6773;1879;6583;523;1980;904;3049;1427;5029
313560;201404;2310;5772;2032;5452;260;691;1530;4276;1790;4967
313570;201404;817;3020;719;2829;284;1217;227;833;511;2050
313580;201404;6241;17930;5411;16807;784;2607;3834;12044;4618;14651
313590;201404;1090;3273;885;3030;425;1546;298;1003;723;2549
313600;201404;3931;12136;3493;11437;637;2316;2043;6784;2680;9100
313610;201404;1159;3668;1012;3383;280;1035;408;1328;688;2363
313620;201404;7486;25354;7086;24507;2419;8945;2246;7616;4665;16561
313630;201404;8900;27723;7608;25694;2334;8674;2514;8879;4848;17553
313640;201404;866;2756;747;2589;277;1036;275;954;552;1990
313650;201404;2313;7637;2060;7236;294;1073;1468;5276;1762;6349
313652;201404;1027;3730;946;3569;179;727;558;2133;737;2860
313655;201404;1007;3357;840;3077;194;803;477;1704;671;2507
313657;201404;1185;3962;1078;3783;155;706;707;2274;862;2980
313660;201404;911;3167;845;3050;237;985;389;1330;626;2315
313665;201404;3108;10416;2899;9968;709;2754;1370;4552;2079;7306
313670;201404;48685;141044;34196;116400;10020;37867;10026;32937;20046;70804
313680;201404;1111;3379;984;3186;121;405;705;2314;826;2719
313690;201404;970;3511;875;3318;252;988;334;1304;586;2292
313695;201404;1500;4950;1293;4614;173;733;890;3161;1063;3894
313700;201404;3970;13279;3391;12503;564;2187;2319;8699;2883;10886
313710;201404;1423;4030;1204;3709;374;1272;541;1609;915;2881
313720;201404;5429;18461;4734;16978;1299;5177;1364;4392;2663;9569
313730;201404;1306;3603;1035;3274;148;517;664;2119;812;2636
313740;201404;2105;7701;1758;6801;591;2575;231;834;822;3409
313750;201404;2984;9288;2630;8610;834;2980;690;2087;1524;5067
313753;201404;1888;5769;1577;5226;488;1743;568;1906;1056;3649
313760;201404;4352;14617;3757;13393;1186;4660;1052;3576;2238;8236
313770;201404;3691;12555;3513;12149;1225;4496;979;3335;2204;7831
313780;201404;3972;11473;3241;10396;849;3136;1454;4518;2303;7654
313790;201404;558;1955;541;1930;121;449;296;1077;417;1526
313800;201404;1270;3667;1135;3453;187;666;693;2084;880;2750
313810;201404;1540;4726;1481;4642;209;660;1077;3470;1286;4130
313820;201404;13179;39251;11144;35620;3072;10960;4111;13095;7183;24055
313830;201404;451;1552;388;1421;125;521;114;404;239;925
313835;201404;1076;3582;1027;3506;240;892;537;1821;777;2713
313840;201404;7652;23366;6501;21422;1913;7025;2034;6397;3947;13422
313850;201404;1286;3642;1160;3421;277;963;585;1605;862;2568
313860;201404;2714;8555;2290;7647;652;2422;488;1470;1140;3892
313862;201404;1138;3100;822;2578;228;762;242;761;470;1523
313865;201404;2258;7270;2104;7002;333;1253;1424;4698;1757;5951
313867;201404;1081;3796;926;3475;331;1310;292;1114;623;2424
313868;201404;1570;5595;1400;5234;174;763;927;3466;1101;4229
313870;201404;922;2927;828;2789;239;935;317;988;556;1923
313880;201404;2273;7378;2086;7128;484;1963;1029;3238;1513;5201
313890;201404;2013;5590;1722;5220;305;932;1102;3419;1407;4351
313900;201404;4825;17762;4508;17037;1675;7059;1191;4407;2866;11466
313910;201404;774;2664;668;2438;276;1098;108;349;384;1447
313920;201404;3716;12099;3401;11566;601;2092;2051;7278;2652;9370
313925;201404;2139;5748;1557;4662;134;459;1015;3030;1149;3489
313930;201404;5378;17862;4545;16407;817;3211;2545;9443;3362;12654
313940;201404;7557;26482;6602;24908;2284;9364;2429;9402;4713;18766
313950;201404;4900;14427;4120;13150;1273;4652;1382;4165;2655;8817
313960;201404;6166;16828;5089;15350;1681;5710;1269;3749;2950;9459
313970;201404;1512;4471;1267;4195;248;906;791;2642;1039;3548
313980;201404;1224;4122;1065;3834;332;1352;308;1073;640;2425
313990;201404;2015;7686;1801;7192;654;2818;411;1496;1065;4314
314000;201404;8267;28573;7695;27460;2203;8826;3823;13270;6026;22096
314010;201404;1113;3287;942;3073;179;692;521;1632;700;2324
314015;201404;1613;6100;1491;5826;528;2172;432;1703;960;3875
314020;201404;514;1666;424;1454;129;489;109;342;238;831
314030;201404;846;2762;678;2376;120;466;232;790;352;1256
314040;201404;642;1919;560;1774;192;645;255;783;447;1428
314050;201404;1918;6373;1623;5764;499;1974;450;1471;949;3445
314053;201404;1496;5022;1409;4915;257;881;948;3444;1205;4325
314055;201404;2263;6838;2010;6485;207;688;1490;4920;1697;5608
314060;201404;1108;3615;961;3347;128;527;602;2073;730;2600
314070;201404;3621;11706;2890;10190;828;3210;706;2341;1534;5551
314080;201404;1917;5999;1386;4842;268;1036;323;1024;591;2060
314085;201404;1890;6655;1652;6323;553;2336;573;2202;1126;4538
314090;201404;3569;12294;3227;11624;1043;4110;1121;4076;2164;8186
314100;201404;3553;9703;3115;9080;381;1133;2357;7008;2738;8141
314110;201404;4464;14924;3961;13885;1003;4021;1425;4593;2428;8614
314120;201404;1073;2655;597;1894;180;658;151;447;331;1105
314130;201404;696;2039;413;1384;77;277;82;272;159;549
314140;201404;5106;16162;4550;15100;1033;3762;2118;7050;3151;10812
314150;201404;1780;4781;1397;4174;272;915;648;1893;920;2808
314160;201404;2462;6664;1997;6050;162;537;1622;4998;1784;5535
314170;201404;1089;3429;937;3104;175;685;471;1477;646;2162
314180;201404;6586;21064;5843;19951;1660;6232;2463;8545;4123;14777
314190;201404;823;2636;737;2495;242;943;261;831;503;1774
314200;201404;3092;10110;2793;9571;431;1680;1838;6215;2269;7895
314210;201404;2025;6359;1818;5974;392;1423;949;2996;1341;4419
314220;201404;1756;5816;1484;5239;498;1952;321;981;819;2933
314225;201404;1185;3732;1071;3573;75;211;940;3212;1015;3423
314230;201404;711;2508;662;2414;204;815;217;744;421;1559
314240;201404;1145;3682;1021;3486;247;842;613;2169;860;3011
314250;201404;523;1616;417;1398;131;490;139;432;270;922
314260;201404;1309;4791;1245;4650;412;1628;445;1665;857;3293
314270;201404;2723;9535;2568;9265;319;1311;1745;6331;2064;7642
314280;201404;3297;9569;2426;7927;742;2799;625;1762;1367;4561
314290;201404;5472;15513;4686;14247;864;2846;3031;9197;3895;12043
314300;201404;1990;6761;1840;6410;632;2351;634;2131;1266;4482
314310;201404;6667;21585;5904;20021;2267;8222;1502;4894;3769;13116
314315;201404;983;3781;920;3658;148;673;536;2159;684;2832
314320;201404;3545;10721;2848;9765;980;3694;1069;3590;2049;7284
314330;201404;54781;178598;51589;173095;16180;59433;22283;73518;38463;132951
314340;201404;2573;7354;1460;4997;370;1394;136;311;506;1705
314345;201404;1365;4617;1210;4376;390;1463;569;2111;959;3574
314350;201404;1421;4230;1163;3806;467;1664;290;948;757;2612
314360;201404;723;2323;518;1889;142;602;121;414;263;1016
314370;201404;568;2019;530;1965;170;693;247;896;417;1589
314380;201404;1155;3588;884;3105;340;1273;215;774;555;2047
314390;201404;15833;48230;12911;42648;4083;14649;3412;10758;7495;25407
314400;201404;5505;15850;4537;14514;1409;4554;2373;7944;3782;12498
314410;201404;2733;8957;2380;8217;761;2944;772;2495;1533;5439
314420;201404;787;2307;644;2110;95;383;477;1543;572;1926
314430;201404;8238;24819;7441;23377;2491;8607;2217;7059;4708;15666
314435;201404;1247;4113;1127;3889;157;666;714;2393;871;3059
314437;201404;1211;3180;1071;2978;100;274;820;2307;920;2581
314440;201404;760;2130;539;1828;198;747;113;353;311;1100
314450;201404;1797;5368;1546;5004;522;1961;655;1955;1177;3916
314460;201404;4686;16410;4151;15191;1357;5442;753;2712;2110;8154
314465;201404;2419;7813;2231;7478;219;902;1647;5409;1866;6311
314467;201404;1131;3250;975;2986;175;524;596;1887;771;2411
314470;201404;2427;8042;1941;6906;549;2285;439;1277;988;3562
314480;201404;7372;25728;5513;20649;1277;5140;523;1752;1800;6892
314490;201404;1000;3026;823;2674;229;864;341;1049;570;1913
314500;201404;2844;8256;2378;7368;712;2482;801;2474;1513;4956
314505;201404;1796;5627;1703;5464;377;1344;977;3133;1354;4477
314510;201404;2007;5728;1438;4869;518;1927;338;1083;856;3010
314520;201404;3801;14712;3195;13122;1086;4886;537;1995;1623;6881
314530;201404;7257;25733;6707;24870;1282;4924;3864;14937;5146;19861
314535;201404;2841;8132;2470;7635;353;1185;1668;5217;2021;6402
314537;201404;1447;4397;1221;3988;258;997;569;1861;827;2858
314540;201404;466;1460;412;1339;128;481;121;354;249;835
314545;201404;1372;4438;1227;4213;261;973;652;2248;913;3221
314550;201404;607;1785;474;1602;121;488;132;408;253;896
314560;201404;5359;19278;4735;17652;1243;5098;1160;4170;2403;9268
314570;201404;375;1182;335;1098;100;354;151;473;251;827
314580;201404;472;1666;401;1513;147;628;87;303;234;931
314585;201404;775;2657;595;2270;162;682;158;589;320;1271
314587;201404;1751;5672;1578;5358;300;1055;820;2818;1120;3873
314590;201404;4299;15108;3229;12164;743;3034;394;1340;1137;4374
314600;201404;2138;7444;1791;6825;678;2875;340;1197;1018;4072
314610;201404;8485;30533;7995;29382;2537;10126;2586;9128;5123;19254
314620;201404;1786;5352;1614;5135;232;740;1177;3869;1409;4609
314625;201404;1574;5250;1538;5205;200;743;1175;4020;1375;4763
314630;201404;5196;15563;4569;14561;656;2301;3022;9802;3678;12103
314640;201404;839;2433;718;2216;245;817;178;504;423;1321
314650;201404;1340;4033;1059;3518;266;1019;410;1234;676;2253
314655;201404;1698;5094;1325;4409;270;946;644;2153;914;3099
314660;201404;213;602;171;517;25;88;95;271;120;359
314670;201404;1506;4240;1233;3758;226;754;687;2077;913;2831
314675;201404;1907;5907;1715;5581;215;801;1091;3576;1306;4377
314690;201404;2744;8857;2371;8178;698;2766;636;2013;1334;4779
314700;201404;10394;39439;9295;36993;4093;17206;1891;7746;5984;24952
314710;201404;8572;27807;6138;22315;1433;5888;765;2510;2198;8398
314720;201404;2699;9137;2277;8279;672;2717;880;3141;1552;5858
314730;201404;2548;7959;2137;7362;756;2915;624;2041;1380;4956
314740;201404;3114;10546;2832;10015;881;3394;1017;3430;1898;6824
314750;201404;337;1123;306;1052;63;265;140;458;203;723
314760;201404;1731;6069;1278;4869;282;1269;264;812;546;2081
314770;201404;1205;3866;765;2654;93;389;105;273;198;662
314780;201404;321;896;244;791;90;336;93;285;183;621
314790;201404;13711;42451;10636;37055;4037;16089;2486;8021;6523;24110
314795;201404;1527;4724;1361;4452;155;679;1012;3153;1167;3832
314800;201404;17360;53745;14483;47929;5722;19937;2668;8972;8390;28909
314810;201404;13123;40067;10402;35132;3324;12609;2360;7861;5684;20470
314820;201404;1125;3154;789;2653;271;1006;242;740;513;1746
314830;201404;1708;5903;1516;5521;546;2189;532;1953;1078;4142
314840;201404;1124;3990;900;3656;183;869;526;2132;709;3001
314850;201404;2284;6638;1921;6012;367;1345;1038;3203;1405;4548
314860;201404;3312;11488;3052;11063;607;2442;1811;6579;2418;9021
314870;201404;5781;18845;5190;18038;837;3322;3557;12492;4394;15814
314875;201404;1734;5939;1693;5878;335;1132;1257;4456;1592;5588
314880;201404;826;2448;737;2306;69;228;522;1638;591;1866
314890;201404;612;1928;464;1633;144;571;108;318;252;889
314900;201404;428;1366;348;1224;108;404;149;513;257;917
314910;201404;1761;6206;1553;5842;603;2487;359;1272;962;3759
314915;201404;2534;8070;2248;7653;233;917;1728;5833;1961;6750
314920;201404;651;1906;494;1674;97;373;221;701;318;1074
314930;201404;5242;18109;4656;16834;1496;5916;1005;3555;2501;9471
314940;201404;416;1246;394;1205;100;316;192;577;292;893
314950;201404;385;1348;330;1232;93;386;63;217;156;603
314960;201404;826;2719;671;2395;197;766;159;530;356;1296
314970;201404;886;3202;808;3031;313;1297;178;622;491;1919
314980;201404;2272;7036;2057;6688;802;2794;275;835;1077;3629
314990;201404;3190;10406;2607;9114;930;3561;426;1323;1356;4884
314995;201404;1587;5005;1445;4806;237;944;958;3104;1195;4048
315000;201404;1065;3190;891;2934;170;677;531;1693;701;2370
315010;201404;501;1631;415;1449;134;541;133;407;267;948
315015;201404;1935;6063;1775;5870;327;1144;1217;4173;1544;5317
315020;201404;757;2460;640;2215;156;607;242;765;398;1372
315030;201404;1017;3144;876;2874;339;1208;166;527;505;1735
315040;201404;953;2975;879;2846;189;637;516;1656;705;2293
315050;201404;1648;4962;1380;4518;469;1704;438;1364;907;3068
315053;201404;1157;3468;1009;3231;257;996;398;1202;655;2198
315057;201404;1928;6607;1576;6065;243;953;973;3890;1216;4843
315060;201404;969;3299;805;2896;239;948;188;696;427;1644
315070;201404;687;2122;639;2051;172;613;340;1039;512;1652
315080;201404;3493;12177;3167;11493;852;3350;1384;5039;2236;8389
315090;201404;758;2776;676;2600;188;776;231;928;419;1704
315100;201404;1189;4136;969;3649;278;1169;225;786;503;1955
315110;201404;1682;5217;1481;4861;431;1533;598;1944;1029;3477
315120;201404;13872;34007;10128;29186;1950;6160;5189;15806;7139;21966
315130;201404;1829;6130;1656;5777;563;2141;380;1265;943;3406
315140;201404;2544;8650;2146;7774;592;2465;641;2046;1233;4511
315150;201404;4819;13528;3674;11500;900;3251;1316;3951;2216;7202
315160;201404;1354;3916;1225;3739;253;868;692;2069;945;2937
315170;201404;1415;4294;1235;4041;276;985;680;2338;956;3323
315180;201404;14128;44462;11007;37839;3050;11857;2509;8194;5559;20051
315190;201404;2411;6500;1977;5870;621;1955;839;2515;1460;4470
315200;201404;4552;15556;3824;13925;1159;4637;983;3436;2142;8073
315210;201404;8915;27656;7583;25049;2609;9390;2303;7418;4912;16808
315213;201404;1146;3720;1100;3655;105;326;908;3105;1013;3431
315217;201404;2744;9349;2314;8610;383;1604;1291;4839;1674;6443
315220;201404;10268;30734;9153;29209;1923;6287;5494;18105;7417;24392
315230;201404;2524;6861;2314;6613;144;357;2022;5899;2166;6256
315240;201404;3328;10843;3046;10352;635;2383;1748;5921;2383;8304
315250;201404;9415;30812;7332;26870;2476;10162;2142;7752;4618;17914
315260;201404;1087;3636;918;3246;339;1318;143;429;482;1747
315270;201404;882;3184;769;2942;249;1019;165;605;414;1624
315280;201404;4002;12403;3202;10593;1104;3882;710;2185;1814;6067
315290;201404;1277;3707;996;3256;356;1279;166;537;522;1816
315300;201404;543;1561;423;1412;216;770;120;370;336;1140
315310;201404;1233;4165;1121;3976;160;643;733;2557;893;3200
315320;201404;869;2901;738;2715;224;898;322;1214;546;2112
315330;201404;789;2824;585;2319;221;981;73;252;294;1233
315340;201404;4246;12506;3649;11571;1037;3612;1569;5019;2606;8631
315350;201404;1879;5380;1521;4878;232;738;1048;3484;1280;4222
315360;201404;1712;5851;1410;5043;328;1247;445;1508;773;2755
315370;201404;618;1891;546;1783;133;495;288;919;421;1414
315380;201404;289;1036;259;952;81;325;43;139;124;464
315390;201404;1963;7063;1725;6504;599;2447;377;1381;976;3828
315400;201404;4684;14613;4174;13615;1055;3754;1994;6493;3049;10247
315410;201404;1791;5036;1517;4602;314;1179;841;2415;1155;3594
315415;201404;1189;4031;1094;3881;447;1604;428;1587;875;3191
315420;201404;1528;4860;1158;4146;354;1335;174;592;528;1927
315430;201404;4068;11260;3104;9623;790;2806;911;2681;1701;5487
315440;201404;984;3059;880;2896;182;692;463;1503;645;2195
315445;201404;2201;6334;1859;5875;291;1069;1234;3867;1525;4936
315450;201404;2518;8117;2359;7878;505;1689;1455;5041;1960;6730
315460;201404;39466;133877;35480;125368;11979;45859;8361;28584;20340;74443
315470;201404;560;1765;501;1665;86;304;308;1012;394;1316
315480;201404;1439;4588;1010;3605;201;828;200;665;401;1493
315490;201404;3284;9471;2837;8837;540;2004;1568;4720;2108;6724
315500;201404;458;1479;316;1120;60;254;114;330;174;584
315510;201404;1510;4389;1306;4059;123;430;922;2868;1045;3298
315520;201404;1171;3665;980;3411;161;646;584;1960;745;2606
315530;201404;504;1794;474;1740;229;882;139;483;368;1365
315540;201404;1280;3948;1030;3538;221;935;353;1181;574;2116
315550;201404;1732;5156;1479;4829;509;1857;558;1793;1067;3650
315560;201404;7231;24126;6661;23364;971;3765;4469;15763;5440;19528
315570;201404;2401;7623;2256;7408;504;1882;1257;4040;1761;5922
315580;201404;2735;8583;2254;7671;627;2524;797;2509;1424;5033
315590;201404;895;2643;820;2536;136;496;522;1565;658;2061
315600;201404;2631;9415;2204;8706;380;1611;1268;5223;1648;6834
315610;201404;1027;3095;870;2761;202;775;302;792;504;1567
315620;201404;342;1221;334;1205;95;348;160;599;255;947
315630;201404;1004;3269;870;3048;241;896;214;734;455;1630
315640;201404;764;2406;665;2211;223;858;200;591;423;1449
315645;201404;873;2836;762;2568;305;1141;163;507;468;1648
315650;201404;1907;5659;1713;5385;162;664;1270;3876;1432;4540
315660;201404;2682;7406;2414;7020;443;1388;1465;4243;1908;5631
315670;201404;11950;43036;11009;41122;4015;16124;3244;11840;7259;27964
315680;201404;2889;10244;2398;9296;903;3639;539;2197;1442;5836
315690;201404;3355;10728;2750;9621;952;3710;713;2476;1665;6186
315700;201404;7435;23948;6471;21985;1407;5487;2958;9573;4365;15060
315710;201404;1841;5516;1500;4978;223;869;875;2877;1098;3746
315720;201404;3040;9952;2782;9464;762;2859;1201;3878;1963;6737
315725;201404;1652;5144;1344;4740;463;1671;602;2181;1065;3852
315727;201404;661;2109;593;1969;140;497;279;914;419;1411
315730;201404;1001;3135;913;2967;192;679;498;1623;690;2302
315733;201404;1173;3828;1086;3654;471;1682;315;1033;786;2715
315737;201404;1385;4243;1128;3789;109;424;725;2467;834;2891
315740;201404;1045;3395;917;3156;246;981;408;1293;654;2274
315750;201404;1154;3613;1039;3453;105;439;763;2471;868;2910
315760;201404;956;2707;925;2666;24;66;853;2463;877;2529
315765;201404;1498;4649;1397;4488;159;549;1050;3414;1209;3963
315770;201404;1690;5526;1546;5225;457;1675;522;1711;979;3386
315780;201404;23798;79619;22173;76115;7368;27149;6317;21692;13685;48841
315790;201404;3259;11338;2954;10686;326;1172;1951;7289;2277;8461
315800;201404;1552;6110;1305;5386;404;1839;241;942;645;2781
315810;201404;1516;4380;1296;4031;227;762;800;2420;1027;3182
315820;201404;3075;10167;2634;9499;745;2818;1246;4618;1991;7436
315830;201404;1485;5088;1373;4855;333;1360;407;1339;740;2699
315840;201404;756;2075;586;1762;111;385;188;511;299;896
315850;201404;1349;4837;1306;4752;377;1447;519;1847;896;3294
315860;201404;438;1629;371;1485;116;530;77;302;193;832
315870;201404;480;1456;408;1343;120;445;134;399;254;844
315880;201404;1110;3082;931;2856;267;951;419;1250;686;2201
315890;201404;1698;5825;1539;5583;498;1888;727;2725;1225;4613
315895;201404;5194;16504;4841;15838;1375;4991;2089;6632;3464;11623
315900;201404;789;2552;741;2469;178;720;404;1226;582;1946
315910;201404;621;2218;578;2134;227;875;242;869;469;1744
315920;201404;1485;4437;1076;3580;299;1114;297;897;596;2011
315930;201404;1132;3214;930;2851;292;977;285;840;577;1817
315935;201404;1182;4038;1100;3858;327;1269;331;1113;658;2382
315940;201404;646;2120;589;2013;183;714;236;774;419;1488
315950;201404;1260;3942;1179;3781;344;1132;642;2101;986;3233
315960;201404;2797;9537;2178;8286;1025;4445;120;394;1145;4839
315970;201404;805;2298;657;2084;82;261;473;1556;555;1817
315980;201404;4121;10547;2894;8409;778;2566;839;2084;1617;4650
315990;201404;4403;13298;3897;12521;927;3528;1989;6231;2916;9759
316000;201404;592;1964;528;1862;236;916;134;443;370;1359
316010;201404;453;1671;406;1560;107;475;112;375;219;850
316020;201404;1197;3825;964;3419;179;729;522;1842;701;2571
316030;201404;3695;10598;2705;9016;380;1395;1412;4855;1792;6250
316040;201404;3537;11298;2551;9030;412;1665;287;764;699;2429
316045;201404;2126;6928;1975;6671;282;898;1367;4902;1649;5800
316050;201404;380;1244;332;1173;78;313;171;584;249;897
316060;201404;785;2413;648;2215;123;527;366;1187;489;1714
316070;201404;6118;20637;5678;19749;1835;7021;2289;7577;4124;14598
316080;201404;749;2819;679;2625;159;692;134;504;293;1196
316090;201404;628;1871;478;1552;112;421;123;356;235;777
316095;201404;1316;4409;1198;4187;343;1249;668;2382;1011;3631
316100;201404;2729;9313;2162;7857;574;2357;403;1339;977;3696
316105;201404;965;2748;731;2361;172;605;319;1060;491;1665
316110;201404;12504;44354;11395;42294;1597;6643;7737;29425;9334;36068
316120;201404;1304;4517;1199;4268;385;1438;418;1459;803;2897
316130;201404;1297;3121;971;2674;196;633;534;1448;730;2081
316140;201404;1095;3272;851;2879;136;517;499;1708;635;2225
316150;201404;1364;4225;1300;4127;354;1300;673;2046;1027;3346
316160;201404;1256;3798;994;3277;141;541;536;1747;677;2288
316165;201404;981;2735;825;2491;164;578;451;1335;615;1913
316170;201404;1401;4108;1061;3503;227;870;424;1299;651;2169
316180;201404;1269;4116;1010;3574;289;1191;262;842;551;2033
316190;201404;2716;8488;1470;5224;290;1095;246;758;536;1853
316200;201404;3865;12687;3023;10999;822;3492;844;2900;1666;6392
316210;201404;5095;16853;4706;16030;2094;7613;929;3162;3023;10775
316220;201404;670;2096;466;1695;110;475;57;219;167;694
316225;201404;1094;3246;977;3092;141;530;651;2003;792;2533
316230;201404;464;1402;384;1260;77;282;189;645;266;927
316240;201404;6470;20478;5676;19441;706;2486;4243;14753;4949;17239
316245;201404;3127;11131;2957;10849;288;1330;2234;8145;2522;9475
316250;201404;9287;29622;8193;27399;3207;11601;2128;6670;5335;18271
316255;201404;2401;7672;2135;7358;382;1261;1456;5168;1838;6429
316257;201404;1414;4024;1108;3480;277;1002;387;1138;664;2140
316260;201404;1867;5414;1419;4762;307;1161;740;2504;1047;3665
316265;201404;1201;3514;1050;3216;108;383;736;2216;844;2599
316270;201404;5210;16896;4854;16164;1376;4965;2036;6847;3412;11812
316280;201404;3350;11255;3028;10603;603;2386;1622;5667;2225;8053
316290;201404;3228;10775;2945;10232;759;3012;1255;4123;2014;7135
316292;201404;3839;12976;3548;12413;1088;4239;1421;4699;2509;8938
316294;201404;804;2678;534;2014;121;541;74;254;195;795
316295;201404;1998;7162;1881;6924;458;1959;972;3342;1430;5301
316300;201404;977;3072;853;2852;91;324;569;1954;660;2278
316310;201404;705;2245;551;1926;128;499;187;641;315;1140
316320;201404;574;1955;514;1869;131;543;138;478;269;1021
316330;201404;991;3058;820;2716;141;465;459;1563;600;2028
316340;201404;1159;3820;1021;3541;313;1238;286;888;599;2126
316350;201404;1487;4866;1356;4642;290;1023;703;2561;993;3584
316360;201404;782;2075;622;1858;82;264;457;1369;539;1633
316370;201404;5097;17026;4555;15943;1585;5972;972;3448;2557;9420
316380;201404;1487;4239;1238;3868;128;454;868;2727;996;3181
316390;201404;934;2860;785;2594;270;980;305;1019;575;1999
316400;201404;1484;5054;1322;4763;356;1389;512;1865;868;3254
316410;201404;1228;4129;1148;4000;275;1069;627;2149;902;3218
316420;201404;2015;6864;1871;6668;280;1125;1185;4265;1465;5390
316430;201404;972;2984;805;2696;248;919;282;896;530;1815
316440;201404;653;2206;573;2100;248;1035;188;651;436;1686
316443;201404;696;2149;591;1942;148;543;224;705;372;1248
316447;201404;1355;4528;1296;4424;163;624;1035;3511;1198;4135
316450;201404;2246;7848;2002;7361;452;1741;1141;4307;1593;6048
316460;201404;893;2894;838;2804;234;888;446;1405;680;2293
316470;201404;8247;27440;6581;23679;2103;8650;1842;6212;3945;14862
316480;201404;253;882;228;837;65;254;70;246;135;500
316490;201404;376;1218;359;1179;116;407;142;451;258;858
316500;201404;1069;3936;753;2967;164;709;42;157;206;866
316510;201404;975;3561;874;3338;348;1388;207;771;555;2159
316520;201404;1227;3871;1027;3566;262;1063;368;1145;630;2208
316530;201404;1161;3803;971;3402;254;1085;359;1054;613;2139
316540;201404;1022;3383;920;3213;257;1065;307;958;564;2023
316550;201404;1275;4377;1177;4222;264;1050;707;2544;971;3594
316553;201404;2286;8492;1945;7672;655;2758;407;1557;1062;4315
316555;201404;2826;10011;2506;9646;238;931;1990;7833;2228;8764
316556;201404;595;1711;495;1522;46;182;338;983;384;1165
316557;201404;731;2715;706;2674;324;1307;208;765;532;2072
316560;201404;370;1273;312;1139;82;353;75;242;157;595
316570;201404;1450;4642;1272;4266;245;893;649;2170;894;3063
316580;201404;294;858;232;741;66;240;70;205;136;445
316590;201404;1436;4205;1158;3716;221;841;628;1930;849;2771
316600;201404;1193;3952;1086;3734;175;648;642;2182;817;2830
316610;201404;609;2277;570;2205;140;617;316;1201;456;1818
316620;201404;2215;7139;1956;6618;513;1942;873;2871;1386;4813
316630;201404;1546;5212;1366;4836;601;2246;351;1244;952;3490
316640;201404;259;855;226;782;58;238;86;270;144;508
316650;201404;959;3737;868;3583;204;889;453;1975;657;2864
316660;201404;137;425;119;390;25;99;55;166;80;265
316670;201404;1881;5622;1535;4944;578;2121;321;881;899;3002
316680;201404;2027;6053;1769;5650;234;780;1330;4325;1564;5105
316690;201404;1175;4043;1066;3851;388;1596;343;1186;731;2782
316695;201404;1263;3953;1130;3718;107;351;749;2577;856;2928
316700;201404;350;1193;327;1135;80;322;152;489;232;811
316710;201404;3466;13308;3050;12392;1066;4561;869;3740;1935;8301
316720;201404;20258;69528;17620;63656;6347;24284;4243;15142;10590;39426
316730;201404;439;1400;388;1301;100;383;188;573;288;956
316740;201404;769;2665;697;2518;268;1062;184;617;452;1679
316750;201404;426;1510;390;1431;107;450;119;395;226;845
316760;201404;3632;12373;3105;11775;1864;7224;759;3016;2623;10240
316770;201404;1502;4500;1344;4289;229;813;878;2884;1107;3697
316780;201404;721;2523;673;2428;261;1018;170;574;431;1592
316790;201404;858;2566;644;2190;184;719;224;731;408;1450
316800;201404;5906;19904;5390;18943;1182;4850;2669;8919;3851;13769
316805;201404;898;2438;851;2376;170;470;598;1720;768;2190
316810;201404;591;1850;514;1687;138;510;224;709;362;1219
316820;201404;397;1150;275;945;101;380;52;169;153;549
316830;201404;628;2242;607;2207;220;851;223;784;443;1635
316840;201404;2968;9115;2580;8395;739;2748;980;2980;1719;5728
316850;201404;2186;6983;2006;6655;479;1766;1029;3387;1508;5153
316860;201404;24133;75973;22018;72035;6265;22880;9293;29971;15558;52851
316870;201404;7207;24402;6339;22288;2274;8668;1215;4120;3489;12788
316880;201404;898;3078;870;3034;351;1360;258;835;609;2195
316890;201404;1457;3809;1161;3402;490;1601;412;1141;902;2742
316900;201404;2769;8851;2432;8170;755;2852;749;2270;1504;5122
316905;201404;472;1661;427;1557;178;700;121;413;299;1113
316910;201404;736;2547;594;2236;154;611;185;715;339;1326
316920;201404;1578;4838;1280;4369;216;818;645;2183;861;3001
316930;201404;9757;33965;8355;30853;2458;10162;1731;5908;4189;16070
316935;201404;4821;14710;3527;12285;1248;4821;651;2159;1899;6980
316940;201404;7063;24164;6018;21916;1567;6271;1569;5529;3136;11800
316950;201404;1533;4609;1352;4367;217;819;881;2800;1098;3619
316960;201404;5461;14311;4603;13204;1041;3298;2552;7293;3593;10591
316970;201404;3593;11901;3419;11596;1326;5056;917;2869;2243;7925
316980;201404;1110;3299;804;2772;364;1370;178;615;542;1985
316990;201404;10102;34229;9188;32174;3774;14354;1177;3875;4951;18229
317000;201404;2735;9653;2646;9546;289;858;2059;8189;2348;9047
317005;201404;2503;8173;2356;7976;404;1393;1657;5711;2061;7104
317010;201404;31759;85537;20946;67495;5971;21550;4918;16430;10889;37980
317020;201404;51704;153155;34807;117819;8849;33151;7930;25055;16779;58206
317030;201404;887;2540;749;2331;117;449;422;1301;539;1750
317040;201404;13140;40645;11706;37954;4272;14616;4151;13606;8423;28222
317043;201404;860;2500;730;2325;174;589;410;1323;584;1912
317047;201404;1162;3202;914;2775;167;576;416;1252;583;1828
317050;201404;1864;6727;1632;6172;471;1920;545;1976;1016;3896
317052;201404;2456;8013;2199;7621;274;1047;1608;5635;1882;6682
317057;201404;1797;5278;1407;4607;228;910;711;2265;939;3175
317060;201404;394;1189;306;995;82;301;101;297;183;598
317065;201404;1229;4134;1117;3949;144;589;836;2933;980;3522
317070;201404;9628;32486;7696;28111;2357;9506;1625;5925;3982;15431
317075;201404;1281;4033;1102;3700;382;1406;341;1093;723;2499
317080;201404;7179;20864;6558;19827;2085;6850;2320;6980;4405;13830
317090;201404;4915;16912;4610;16375;828;2990;2946;10762;3774;13752
317100;201404;3340;9946;2892;9186;1005;3556;1088;3241;2093;6797
317103;201404;2011;7074;1706;6435;354;1660;744;2700;1098;4360
317107;201404;1355;4268;1176;3903;263;1010;596;1877;859;2887
317110;201404;751;2082;531;1652;152;570;193;540;345;1110
317115;201404;1100;3574;966;3275;141;503;611;2081;752;2584
317120;201404;13552;46535;11693;42117;3913;15057;4000;14160;7913;29217
317130;201404;9018;29195;8186;27670;2252;8617;3410;11198;5662;19815
317140;201404;668;2326;628;2249;85;337;398;1426;483;1763
317150;201404;1058;2930;896;2742;113;414;647;1963;760;2377
317160;201404;3835;10431;2918;9267;409;1541;1908;5954;2317;7495
317170;201404;2029;6011;1826;5662;240;887;1085;3210;1325;4097
317180;201404;1837;6316;1478;5491;423;1733;424;1502;847;3235
317190;201404;1323;3979;1159;3754;129;451;876;2848;1005;3299
317200;201404;4667;15709;4269;14856;1461;5551;1134;3794;2595;9345
317210;201404;1080;3438;927;3191;278;1084;399;1361;677;2445
317220;201404;357;1295;348;1285;129;479;172;657;301;1136
320010;201404;5942;18869;5302;17427;940;3390;2623;8562;3563;11952
320013;201404;2076;6151;1485;5061;212;762;799;2806;1011;3568
320016;201404;3553;10008;3011;9228;537;1656;1975;6194;2512;7850
320020;201404;4255;13949;3923;13224;1313;4715;1387;4627;2700;9342
320030;201404;1475;4905;1315;4546;399;1490;536;1785;935;3275
320035;201404;1829;5674;1660;5393;553;1994;605;1862;1158;3856
320040;201404;3182;10897;2698;9743;701;2758;761;2635;1462;5393
320050;201404;1940;5417;1673;4895;306;1007;941;2683;1247;3690
320060;201404;11494;36624;9055;30922;2290;8630;3080;9987;5370;18617
320070;201404;1846;6264;1619;5718;496;1869;395;1281;891;3150
320080;201404;5665;16873;4594;14729;1438;4967;1400;4409;2838;9376
320090;201404;9197;26567;7224;22692;2072;6988;2959;8969;5031;15957
320100;201404;3276;9998;2728;8897;655;2307;1234;3958;1889;6265
320110;201404;1548;4788;1419;4533;384;1310;470;1475;854;2785
320115;201404;1821;6737;1741;6556;864;3370;559;2133;1423;5503
320120;201404;17950;61050;15685;56541;5658;21858;4135;14966;9793;36824
320130;201404;41354;139281;38543;133296;11440;42997;16700;56212;28140;99209
320140;201404;4103;13483;2964;10653;719;2885;299;995;1018;3880
320150;201404;18348;52834;13931;44356;4286;14755;2325;7237;6611;21992
320160;201404;5313;16581;4639;15463;1279;4829;1891;5801;3170;10630
320170;201404;1988;6594;1782;6145;578;2087;564;1992;1142;4079
320180;201404;925;3075;832;2932;310;1147;305;1079;615;2226
320190;201404;4434;16136;4012;14982;1399;5460;1052;3861;2451;9321
320200;201404;1149;3816;1029;3562;310;1165;422;1471;732;2636
320210;201404;6092;16881;5297;15527;1293;4327;2624;7365;3917;11692
320220;201404;2910;8990;2315;7936;695;2606;809;2794;1504;5400
320225;201404;1508;5385;1319;4890;467;1855;263;1001;730;2856
320230;201404;4305;14579;4028;14039;1435;5419;1324;4703;2759;10122
320240;201404;9715;30124;7827;26414;2335;8488;2003;6849;4338;15337
320245;201404;4187;14454;3916;13791;1275;4762;1368;4729;2643;9491
320250;201404;1814;5709;1362;4656;340;1293;275;835;615;2128
320255;201404;2048;6909;1780;6439;753;2933;555;2043;1308;4976
320260;201404;1147;3620;906;2976;225;826;309;867;534;1693
320265;201404;2541;7910;2165;7457;284;1010;1568;5578;1852;6588
320270;201404;2723;8452;2135;7279;551;2048;907;3050;1458;5098
320280;201404;7274;22348;6690;21333;1514;5290;3454;10818;4968;16108
320290;201404;1634;5558;1396;4926;506;1861;315;1034;821;2895
320300;201404;4296;14744;4012;14090;1263;4703;1314;4611;2577;9314
320305;201404;4790;15899;4389;14984;1114;4210;1975;6535;3089;10745
320310;201404;2035;6236;1821;5840;482;1680;766;2372;1248;4052
320313;201404;2396;7303;1727;5745;462;1788;286;835;748;2623
320316;201404;2241;7109;2119;6826;618;2103;911;2908;1529;5011
320320;201404;19127;62646;16649;57800;5172;20014;6098;20462;11270;40476
320330;201404;3007;9256;2627;8610;581;1894;1454;4965;2035;6859
320332;201404;5056;17356;4593;16492;1572;5982;1718;6332;3290;12314
320334;201404;1518;5341;1253;4698;431;1803;233;783;664;2586
320335;201404;2268;6899;1648;5499;545;2023;305;949;850;2972
320340;201404;5820;16738;4725;14833;1166;4054;2110;6520;3276;10574
320350;201404;5660;14820;4190;12301;861;2834;1918;5536;2779;8370
320360;201404;1776;4811;1366;4046;258;868;635;1751;893;2619
320370;201404;3509;11707;3056;10805;955;3502;1129;4025;2084;7527
320380;201404;2820;8741;2529;8186;564;1969;1333;4226;1897;6195
320390;201404;8344;25632;6973;22868;2109;7692;2236;7014;4345;14706
320400;201404;4186;12184;3512;11193;850;3064;1800;5532;2650;8596
320405;201404;4155;12505;3821;12060;1188;4182;1988;6078;3176;10260
320410;201404;6274;15667;4600;13738;844;2622;2944;8895;3788;11517
320420;201404;1665;5054;1181;4239;385;1535;179;594;564;2129
320425;201404;2475;6383;2028;5723;324;1084;1190;3324;1514;4408
320430;201404;2396;7151;2169;6693;443;1499;1062;3216;1505;4715
320435;201404;2554;8705;2194;7933;1017;3851;657;2438;1674;6289
320440;201404;1449;4899;1302;4487;399;1493;384;1232;783;2725
320450;201404;2546;8268;2184;7487;639;2422;894;2964;1533;5386
320455;201404;4782;17027;3795;14486;1155;4648;748;2792;1903;7440
320460;201404;3115;10300;2535;9026;773;2969;818;2785;1591;5754
320465;201404;1662;5347;1322;4520;278;1032;508;1678;786;2710
320470;201404;4585;14326;3342;11564;1023;3903;470;1457;1493;5360
320480;201404;1983;6102;1668;5484;420;1586;699;2176;1119;3762
320490;201404;17938;57689;15243;52322;5203;19238;4617;16185;9820;35423
320495;201404;1458;4644;1169;3976;449;1660;270;899;719;2559
320500;201404;46997;148531;41070;137144;13177;47672;16532;53983;29709;101655
320501;201404;3665;12193;3392;11727;1209;4703;1373;4539;2582;9242
320503;201404;2352;8562;2055;7802;690;2824;527;1796;1217;4620
320506;201404;3309;10615;2356;8172;711;2674;243;759;954;3433
320510;201404;8673;27921;7673;25921;2587;9396;2766;9168;5353;18564
320515;201404;2148;6207;1911;5757;548;1785;639;1873;1187;3658
320517;201404;2268;7533;1903;6731;709;2701;399;1322;1108;4023
320520;201404;33453;108959;28881;99916;9401;36005;11361;38880;20762;74885
320530;201404;28270;89608;24533;82062;6561;25019;10219;32306;16780;57325
330010;201404;17265;55121;16091;52715;3340;12418;9429;29743;12769;42161
330015;201404;1985;5601;1724;5104;450;1497;616;1754;1066;3251
330020;201404;16823;51203;15441;48954;3762;12893;8278;26069;12040;38962
330022;201404;1677;5445;1503;5106;309;1200;781;2536;1090;3736
330023;201404;3460;11392;3259;10966;876;3252;1267;4060;2143;7312
330025;201404;3413;10500;3121;10065;820;2885;1780;5620;2600;8505
330030;201404;7669;26940;7097;25736;2045;8178;2975;10259;5020;18437
330040;201404;14569;42331;12433;38882;3486;11692;5835;17904;9321;29596
330045;201404;67180;195882;61600;187312;9729;31838;41045;124216;50774;156054
330050;201404;2968;9568;2655;8940;959;3600;667;2046;1626;5646
330060;201404;5644;17441;5086;16620;1194;4380;2917;9555;4111;13935
330070;201404;25761;80832;23654;76988;6647;23258;10142;32933;16789;56191
330080;201404;9490;27438;9052;26837;1867;5442;5973;18333;7840;23775
330090;201404;3280;9234;3069;8861;874;2763;1417;3979;2291;6742
330093;201404;2003;5970;1728;5482;428;1453;622;1913;1050;3366
330095;201404;1208;4224;1128;4040;404;1604;178;555;582;2159
330100;201404;55370;185648;51664;179179;12101;46836;25950;90283;38051;137119
330110;201404;2690;8619;2476;8227;774;2777;797;2649;1571;5426
330115;201404;2484;7564;2305;7255;736;2559;946;2843;1682;5402
330120;201404;2551;7526;2337;7231;729;2430;990;2974;1719;5404
330130;201404;4032;13449;3668;12732;1217;4561;1346;4624;2563;9185
330140;201404;3438;10624;3144;10220;864;3099;1438;4684;2302;7783
330150;201404;2603;7865;2034;6674;541;1969;442;1384;983;3353
330160;201404;1411;4941;1310;4726;477;1877;422;1459;899;3336
330170;201404;104268;320667;97984;310852;15315;52284;67814;215220;83129;267504
330180;201404;1779;5545;1620;5234;247;1025;1000;2982;1247;4007
330185;201404;8066;25811;7511;24848;2014;7063;3915;13265;5929;20328
330187;201404;4409;12771;3922;11956;840;2900;2239;6750;3079;9650
330190;201404;28525;86836;27226;84703;6941;22993;15588;47839;22529;70832
330200;201404;13926;44351;12570;41772;3044;10447;6427;21764;9471;32211
330205;201404;2606;7171;2324;6686;538;1785;1115;3054;1653;4839
330210;201404;4705;12333;3348;9826;982;3147;716;2054;1698;5201
330220;201404;11567;36926;10728;35162;3487;12383;3218;9978;6705;22361
330225;201404;4113;13102;3887;12756;558;2177;2733;8953;3291;11130
330227;201404;17810;51212;16115;48871;4064;13147;8760;26137;12824;39284
330230;201404;1523;4553;1397;4322;426;1485;529;1506;955;2991
330240;201404;20618;64714;18445;60737;6965;25115;3149;10069;10114;35184
330245;201404;1265;4058;1050;3609;318;1188;206;709;524;1897
330250;201404;37811;111973;35444;108075;10582;32863;17436;54331;28018;87194
330260;201404;3946;12570;3665;11961;910;3277;1603;4997;2513;8274
330270;201404;14425;42595;12201;39033;3642;12466;4330;14001;7972;26467
330280;201404;2040;6481;1751;5895;400;1510;787;2483;1187;3993
330285;201404;19085;56933;17574;54769;3859;12829;10610;33200;14469;46029
330290;201404;3640;10306;3243;9756;676;2330;1856;5320;2532;7650
330300;201404;4171;13690;3930;13251;927;3387;2030;6875;2957;10262
330310;201404;2805;8241;2559;7831;635;2036;1243;3761;1878;5797
330320;201404;12441;37639;11688;36477;1934;6560;8076;25145;10010;31705
330330;201404;32158;93251;29642;89268;7349;23991;17126;50758;24475;74749
330340;201404;14854;46348;12252;41150;3806;13776;3437;11383;7243;25159
330350;201404;93312;300559;90685;296760;16867;55957;63249;210513;80116;266470
330360;201404;5585;17811;5465;17626;772;2731;4082;13117;4854;15848
330370;201404;3858;14412;3660;13921;1431;5675;1160;4436;2591;10111
330380;201404;4521;14867;3990;13873;1051;3974;1852;6360;2903;10334
330385;201404;4111;14388;3821;13799;1301;5015;1364;4897;2665;9912
330390;201404;24304;82539;22360;78657;5530;21769;11043;37817;16573;59586
330395;201404;3364;10150;3140;9769;540;1873;1895;5860;2435;7733
330400;201404;2594;8766;2375;8353;530;2154;1151;3715;1681;5869
330410;201404;3114;10001;2697;9151;633;2281;1301;4424;1934;6705
330411;201404;2545;8162;2300;7676;476;1838;1173;3680;1649;5518
330412;201404;1400;4872;1127;4338;274;1203;388;1426;662;2629
330414;201404;26058;74719;22452;69873;4606;15186;13638;42671;18244;57857
330415;201404;3702;11730;3295;10988;830;3090;1414;4676;2244;7766
330420;201404;8476;26951;6336;22606;1838;7200;1060;3709;2898;10909
330430;201404;8275;24734;7460;23312;1763;6195;3615;10999;5378;17194
330440;201404;2127;7175;1793;6473;591;2421;382;1238;973;3659
330450;201404;1640;5754;1553;5571;484;1965;615;2128;1099;4093
330452;201404;10521;32873;8812;29477;2464;9185;3471;11068;5935;20253
330455;201404;479850;1417249;412876;1307552;112850;383333;198395;624666;311245;1007999
330460;201404;1408;4776;1320;4611;361;1457;603;2059;964;3516
330470;201404;4560;15000;4229;14330;1453;5349;1342;4409;2795;9758
330475;201404;8366;26726;7560;25379;2095;7720;3564;11917;5659;19637
330480;201404;6512;19918;6157;19281;1765;6001;2577;7987;4342;13988
330490;201404;101904;288011;94866;277751;13204;40776;70912;208385;84116;249161
330500;201404;6953;21389;6545;20579;1429;4865;3436;11034;4865;15899
330510;201404;42955;139338;40436;135166;13841;47227;18617;63767;32458;110994
330513;201404;1610;4879;1475;4615;582;1912;476;1474;1058;3386
330515;201404;3095;9899;2840;9421;970;3426;983;3199;1953;6625
330520;201404;13468;40642;12416;38927;3242;10752;6413;20158;9655;30910
330530;201404;1574;4725;1451;4505;383;1321;681;2048;1064;3369
330540;201404;3362;10284;2935;9609;885;3127;1116;3571;2001;6698
330550;201404;9139;30378;8093;28407;3309;12392;1829;6479;5138;18871
330555;201404;10502;32332;9486;30787;1962;6596;5797;19178;7759;25774
330560;201404;4238;13104;3974;12665;866;3183;2130;6577;2996;9760
330570;201404;3710;10787;3182;9890;873;2869;1529;4790;2402;7659
330575;201404;5590;16875;5105;16015;1220;4122;2831;8620;4051;12742
330580;201404;17229;56055;15201;51944;5101;18282;5221;18202;10322;36484
330590;201404;1979;6016;1850;5787;540;1774;899;2832;1439;4606
330600;201404;10025;30075;8494;27573;1339;5209;5023;15578;6362;20787
330610;201404;9092;29701;8411;28433;2160;8159;3967;13185;6127;21344
330615;201404;1659;5973;1532;5618;675;2588;396;1505;1071;4093
330620;201404;4081;14410;3773;13786;1337;5244;1009;3804;2346;9048
330630;201404;21692;71301;19491;66803;5327;20390;8999;29381;14326;49771
350010;201404;3013;9476;2368;8123;711;2597;428;1393;1139;3990
350020;201404;618;1762;480;1507;122;439;179;523;301;962
350030;201404;4775;15407;4003;13669;1405;5305;1059;3429;2464;8734
350040;201404;600;2185;525;2020;167;710;103;347;270;1057
350050;201404;1421;4686;1200;4279;331;1359;377;1223;708;2582
350055;201404;630;2107;608;2070;176;657;298;975;474;1632
350060;201404;86;298;79;285;22;97;29;93;51;190
350070;201404;2727;9199;2236;8023;508;2022;396;1238;904;3260
350075;201404;542;1916;478;1805;158;650;125;440;283;1090
350080;201404;613;1805;477;1519;125;467;174;534;299;1001
350090;201404;587;1692;446;1453;119;414;120;358;239;772
350100;201404;2005;6913;1679;6135;543;2123;464;1618;1007;3741
350110;201404;478;1480;383;1263;103;380;124;370;227;750
350115;201404;1373;4503;1218;4117;266;1049;555;1704;821;2753
350120;201404;542;1466;297;948;63;229;70;210;133;439
350130;201404;3747;11589;3409;10923;869;3090;1460;4327;2329;7417
350140;201404;700;2219;633;2087;162;611;258;797;420;1408
350150;201404;437;1512;402;1431;154;582;97;341;251;923
350160;201404;6145;19588;4732;16472;1442;5522;1647;5261;3089;10783
350170;201404;2307;8261;2075;7670;728;2811;450;1581;1178;4392
350180;201404;1461;3839;1223;3437;312;927;515;1407;827;2334
350190;201404;3304;11323;2876;10457;832;3522;1287;4185;2119;7707
350200;201404;419;1438;381;1372;125;517;131;448;256;965
350210;201404;7660;21702;6146;19062;2319;7787;1886;5539;4205;13326
350220;201404;3160;10266;2901;9770;998;3791;799;2419;1797;6210
350230;201404;761;2596;702;2498;231;905;231;813;462;1718
350240;201404;597;1828;519;1703;119;465;281;877;400;1342
350250;201404;2778;10367;2686;10183;1119;4527;844;3146;1963;7673
350260;201404;1080;2919;899;2589;214;640;373;1100;587;1740
350270;201404;5357;16630;4744;15361;972;3406;2216;7110;3188;10516
350275;201404;2050;6860;1842;6539;555;2193;698;2294;1253;4487
350280;201404;23341;61785;15456;47385;3885;12775;3224;9971;7109;22746
350290;201404;1819;6364;1622;5900;490;1845;459;1722;949;3567
350300;201404;507;1613;472;1539;144;507;166;556;310;1063
350310;201404;945;3183;877;3019;187;750;375;1220;562;1970
350315;201404;570;1817;471;1609;78;349;149;480;227;829
350320;201404;12182;40523;11260;38413;3527;12858;1904;6319;5431;19177
350330;201404;9641;28688;8445;26194;2126;7256;3989;11600;6115;18856
350335;201404;567;1682;525;1595;128;398;213;711;341;1109
350340;201404;1066;3409;854;3019;233;913;238;804;471;1717
350350;201404;765;2447;676;2297;183;713;219;728;402;1441
350360;201404;856;3077;754;2832;240;944;243;920;483;1864
350370;201404;707;2219;544;1833;107;413;109;320;216;733
350380;201404;3849;12624;3246;11661;1337;5179;710;2399;2047;7578
350390;201404;8765;28586;7810;26820;2217;8157;3477;11595;5694;19752
350395;201404;329;1038;248;869;72;274;51;175;123;449
350400;201404;8454;25022;7022;22439;2037;7141;2505;7629;4542;14770
350410;201404;7750;28846;6905;26838;2438;10270;1499;5589;3937;15859
350420;201404;1025;3287;836;2917;395;1463;73;242;468;1705
350430;201404;873;2774;756;2565;208;840;359;1165;567;2005
350440;201404;1455;4688;1372;4530;469;1661;638;2025;1107;3686
350450;201404;7933;24477;6441;21474;1956;7022;1669;5326;3625;12348
350460;201404;1574;4685;1160;3797;325;1183;323;936;648;2119
350470;201404;241;701;205;640;52;184;93;270;145;454
350480;201404;791;2474;542;1872;89;354;84;240;173;594
350490;201404;2151;6313;1842;5891;529;1931;822;2459;1351;4390
350500;201404;617;1839;535;1713;141;507;211;635;352;1142
350510;201404;1113;3600;946;3213;290;1114;320;962;610;2076
350520;201404;1306;5137;1181;4872;444;1918;290;1173;734;3091
350530;201404;2597;7898;2155;6927;791;2765;535;1556;1326;4321
350535;201404;1499;4480;1451;4415;78;273;1245;3781;1323;4054
350540;201404;2072;5998;1755;5435;495;1673;652;2022;1147;3695
350550;201404;11042;32785;8979;29225;2476;9095;3366;10260;5842;19355
350560;201404;3504;11883;3185;11217;645;2428;1588;5673;2233;8101
350570;201404;21597;75198;19856;71173;6407;24535;6916;23806;13323;48341
350580;201404;2101;6959;1728;6088;505;1969;253;762;758;2731
350590;201404;4251;13828;3296;11744;1005;3954;1070;3459;2075;7413
350600;201404;39925;102774;28110;83974;5799;18868;13308;38498;19107;57366
350610;201404;9285;27547;7504;24495;2022;7400;3242;10093;5264;17493
350620;201404;482;1482;404;1360;94;361;166;529;260;890
350630;201404;1707;5353;1355;4643;393;1524;195;591;588;2115
350635;201404;5140;16813;4182;14915;1271;4795;1497;5360;2768;10155
350640;201404;682;2213;553;1863;156;571;154;482;310;1053
350650;201404;4790;15493;3316;11947;1160;4619;306;1055;1466;5674
350660;201404;3769;12047;3303;11231;898;3281;1555;5228;2453;8509
350670;201404;1894;5940;1776;5730;369;1325;1099;3401;1468;4726
350680;201404;1241;3898;1001;3402;289;1175;393;1268;682;2443
350690;201404;1080;3682;934;3352;280;1113;228;739;508;1852
350700;201404;2786;9710;2443;8933;977;3953;842;2740;1819;6693
350710;201404;2229;7103;2042;6806;337;1286;1352;4438;1689;5724
350715;201404;1127;3479;1005;3246;277;1007;360;1064;637;2071
350720;201404;139;430;129;411;48;173;42;110;90;283
350730;201404;437;1679;412;1606;124;537;119;427;243;964
350740;201404;2434;7469;2187;6921;567;1963;878;2771;1445;4734
350745;201404;351;1142;288;992;68;282;118;350;186;632
350750;201404;10088;31285;7865;26790;2143;8019;1972;6287;4115;14306
350760;201404;12406;40026;11300;37991;3623;13641;4788;15178;8411;28819
350770;201404;927;2756;669;2243;144;553;244;791;388;1344
350775;201404;641;1908;586;1817;132;476;261;799;393;1275
350780;201404;2150;6592;1625;5478;441;1668;210;649;651;2317
350790;201404;2165;7143;1741;6221;529;2017;331;1048;860;3065
350800;201404;3141;10790;2996;10545;653;2565;1780;6148;2433;8713
350810;201404;2624;7759;2315;7211;773;2642;673;2082;1446;4724
350820;201404;574;1591;425;1275;93;325;161;428;254;753
350830;201404;896;2881;652;2274;120;472;134;386;254;858
350840;201404;2336;8495;1961;7523;620;2625;355;1156;975;3781
350850;201404;6754;23172;5641;20512;1946;7497;1213;4181;3159;11678
350860;201404;3422;11181;3280;10958;517;1989;2382;7868;2899;9857
350870;201404;2493;8542;2226;8127;757;2987;1086;3976;1843;6963
350880;201404;1714;5872;1472;5328;434;1688;289;1041;723;2729
350890;201404;646;1957;529;1709;95;346;171;462;266;808
350900;201404;4654;15737;3918;14100;1077;4238;1035;3467;2112;7705
350910;201404;892;2785;838;2666;362;1200;259;803;621;2003
350920;201404;10023;30311;9252;29026;1836;6362;5711;17244;7547;23606
350925;201404;5366;16899;4800;15765;1449;5217;1941;6123;3390;11340
350930;201404;1584;4447;1335;4037;156;579;930;2690;1086;3269
350940;201404;2341;7905;2147;7587;462;1898;1264;4271;1726;6169
350945;201404;959;3218;852;2989;215;829;351;1178;566;2007
350950;201404;72816;235909;62107;214035;18270;68785;23888;79753;42158;148538
350960;201404;4678;16641;4169;15478;821;3521;2226;7887;3047;11408
350970;201404;4480;16338;4011;15171;1459;5914;1111;4013;2570;9927
350980;201404;703;2294;642;2190;297;1096;129;433;426;1529
350990;201404;1829;6466;1622;6069;577;2337;494;1802;1071;4139
350995;201404;826;2999;783;2916;213;903;380;1346;593;2249
351000;201404;3660;11241;3177;10326;526;1973;1785;5578;2311;7551
351010;201404;426;1304;312;1068;119;448;63;216;182;664
351015;201404;968;3252;840;3008;306;1237;247;813;553;2050
351020;201404;7983;26293;7127;24982;1906;7173;3552;12614;5458;19787
351030;201404;1465;5442;1363;5208;387;1696;465;1684;852;3380
351040;201404;3788;12233;3510;11740;827;3226;1989;6227;2816;9453
351050;201404;9774;31607;7952;28028;2716;10441;2471;8625;5187;19066
351060;201404;34499;109302;29207;99296;9542;34492;9806;33224;19348;67716
351070;201404;1870;5406;1381;4526;468;1677;246;716;714;2393
351080;201404;2846;8700;2256;7970;652;2541;1010;3472;1662;6013
351090;201404;384;1356;311;1201;111;491;51;177;162;668
351100;201404;1957;6385;1730;5935;692;2462;467;1616;1159;4078
351110;201404;9675;26306;6177;20166;1850;6658;1600;4899;3450;11557
351120;201404;612;1885;522;1678;72;277;249;713;321;990
351130;201404;889;2504;463;1600;90;363;103;320;193;683
351140;201404;2033;7083;1856;6690;696;2735;542;1876;1238;4611
351150;201404;2236;7855;1831;6756;492;1992;408;1367;900;3359
351160;201404;1552;5492;1406;5152;482;1961;447;1554;929;3515
351170;201404;1664;5544;1344;4790;364;1388;503;1658;867;3046
351190;201404;703;2299;578;1968;123;438;120;350;243;788
351200;201404;2298;6972;1976;6362;363;1329;901;2681;1264;4010
351210;201404;1133;3585;960;3241;287;1061;292;911;579;1972
351220;201404;3578;12252;3179;11420;869;3406;1346;4765;2215;8171
351230;201404;1937;6555;1756;6195;539;2111;817;2795;1356;4906
351240;201404;1022;3345;745;2686;202;792;151;470;353;1262
351250;201404;901;2637;674;2176;144;513;314;966;458;1479
351260;201404;1201;3624;1087;3385;290;989;411;1217;701;2206
351270;201404;409;1479;377;1413;113;485;120;401;233;886
351280;201404;5419;16469;3995;13206;1050;3722;1159;3438;2209;7160
351290;201404;1106;3348;909;2950;279;941;280;846;559;1787
351300;201404;10332;38269;9003;35143;2648;11251;3151;12173;5799;23424
351310;201404;3444;10915;2908;9920;714;2825;1340;4199;2054;7024
351320;201404;1019;3614;897;3326;287;1155;212;689;499;1844
351330;201404;283;835;255;783;108;332;60;178;168;510
351340;201404;6739;23690;6107;22391;1809;6988;2818;10349;4627;17337
351350;201404;8012;26547;7132;24673;2161;7905;2475;8210;4636;16115
351360;201404;4889;15132;4608;14647;1288;4626;2093;6440;3381;11066
351370;201404;2056;6749;1689;5963;555;2175;417;1327;972;3502
351380;201404;37842;119690;35244;114470;9409;33458;16221;50360;25630;83818
351385;201404;253;808;247;798;92;306;83;263;175;569
351390;201404;1280;4343;1136;4041;439;1685;362;1191;801;2876
351400;201404;1246;4047;1185;3911;425;1501;374;1251;799;2752
351410;201404;3018;9288;2687;8702;607;2119;1346;4289;1953;6408
351420;201404;458;1362;333;1085;73;259;57;175;130;434
351430;201404;921;2948;844;2809;151;545;565;1877;716;2422
351440;201404;4769;14756;4138;13396;1528;5170;986;2982;2514;8152
351450;201404;1833;5277;1626;5004;504;1581;807;2576;1311;4157
351460;201404;853;2713;728;2469;344;1243;204;661;548;1904
351470;201404;1110;3453;994;3230;397;1426;277;858;674;2284
351480;201404;2981;9887;2722;9445;657;2718;1295;4330;1952;7048
351490;201404;2041;6962;1833;6507;361;1498;970;3279;1331;4777
351492;201404;309;1056;241;876;52;224;72;215;124;439
351495;201404;161;562;132;485;41;159;40;137;81;296
351500;201404;21012;68374;18728;63788;5983;22135;7052;23340;13035;45475
351510;201404;7763;25527;6745;23768;1744;6661;3292;11490;5036;18151
351512;201404;429;1301;371;1189;80;269;163;523;243;792
351515;201404;2114;7060;1671;6026;505;1965;426;1450;931;3415
351518;201404;1670;5821;1272;5112;361;1581;257;965;618;2546
351519;201404;837;2712;718;2432;198;769;270;828;468;1597
351520;201404;823;2316;400;1444;63;266;50;161;113;427
351530;201404;471;1508;407;1345;86;306;122;358;208;664
351535;201404;2662;7000;2172;6303;264;889;1465;4177;1729;5066
351540;201404;2186;7072;1961;6651;924;3347;354;1140;1278;4487
351550;201404;4739;14302;3528;11842;904;3402;1048;3334;1952;6736
351560;201404;438;1446;385;1323;135;512;67;221;202;733
351565;201404;240;817;223;772;72;293;83;254;155;547
351570;201404;12904;42324;11285;39024;3418;12293;4853;16798;8271;29091
351580;201404;403;1131;303;919;59;176;93;262;152;438
351590;201404;512;1423;399;1189;132;420;75;202;207;622
351600;201404;1938;5630;1734;5266;386;1363;813;2252;1199;3615
351610;201404;641;1817;537;1638;108;391;266;756;374;1147
351620;201404;17035;56393;13237;48084;3256;13103;3225;10384;6481;23487
351630;201404;15253;52198;14112;50308;4047;15013;7210;26049;11257;41062
351640;201404;8537;27760;7123;25298;1790;6932;3486;12163;5276;19095
351650;201404;398;1209;254;852;65;234;36;112;101;346
351660;201404;862;2703;668;2246;154;580;183;542;337;1122
351670;201404;4316;13735;3658;12332;737;2853;1788;5703;2525;8556
351680;201404;653;2038;434;1480;91;339;71;207;162;546
351685;201404;455;1392;372;1245;118;406;127;438;245;844
351690;201404;1366;4104;1079;3456;452;1467;258;772;710;2239
351700;201404;1508;4568;1363;4289;470;1536;422;1289;892;2825
351710;201404;806;2556;679;2268;164;554;191;596;355;1150
351720;201404;1723;5523;1306;4430;284;1077;424;1364;708;2441
351730;201404;1130;3408;965;3178;406;1477;258;788;664;2265
351740;201404;4723;13666;4029;12222;1072;3500;1241;3509;2313;7009
351750;201404;1509;5027;1319;4628;411;1591;323;1026;734;2617
351760;201404;3808;12423;3377;11464;921;3388;1370;4448;2291;7836
351770;201404;2319;7606;2025;7064;705;2541;888;3096;1593;5637
351780;201404;1636;4706;1105;3552;289;1022;213;615;502;1637
351790;201404;1173;3537;1001;3287;359;1246;398;1278;757;2524
351800;201404;384;877;306;757;38;112;185;429;223;541
351810;201404;1207;3724;1138;3635;298;1102;688;2086;986;3188
351820;201404;1975;6289;1631;5667;572;2096;162;528;734;2624
351830;201404;4171;13819;3780;12969;928;3522;1691;5572;2619;9094
351840;201404;9084;31709;8172;29798;2780;10751;2472;8957;5252;19708
351850;201404;1372;4597;1141;4111;312;1260;265;829;577;2089
351860;201404;3688;12042;3390;11435;909;3421;1586;5048;2495;8469
351870;201404;35725;111788;32776;106602;7971;28037;18241;59017;26212;87054
351880;201404;109632;359438;96470;332695;30330;111204;27799;95074;58129;206278
351885;201404;668;2454;625;2353;173;688;264;961;437;1649
351890;201404;820;2481;657;2134;210;726;141;422;351;1148
351900;201404;1443;4508;1265;4223;402;1436;438;1467;840;2903
351905;201404;437;1508;377;1395;96;415;185;621;281;1036
351907;201404;15311;48923;13448;45324;3035;11547;6555;21078;9590;32625
351910;201404;1184;3832;1100;3687;261;984;390;1228;651;2212
351920;201404;1221;3545;1149;3433;279;952;656;1896;935;2848
351925;201404;1014;2981;941;2861;136;516;607;1701;743;2217
351930;201404;3193;11014;2966;10537;818;3325;1318;4255;2136;7580
351940;201404;1031;3204;965;3084;271;961;558;1706;829;2667
351950;201404;1425;4013;1046;3271;216;741;468;1393;684;2134
351960;201404;4337;14009;3412;12328;1077;3809;1433;5662;2510;9471
351970;201404;7073;26938;6429;25542;2329;9782;1965;7753;4294;17535
351980;201404;1000;3096;834;2782;180;702;328;977;508;1679
351990;201404;1627;4720;1323;4113;357;1288;350;922;707;2210
352000;201404;2502;8162;2294;7737;580;2119;984;3166;1564;5285
352010;201404;2297;7935;2099;7424;738;2761;421;1476;1159;4237
352020;201404;1545;5041;1397;4743;444;1587;444;1489;888;3076
352030;201404;4587;14528;4164;13955;1006;3573;2260;7738;3266;11311
352040;201404;1881;6675;1630;6041;456;1790;369;1277;825;3067
352042;201404;2398;6897;1795;5622;452;1577;856;2589;1308;4166
352044;201404;1446;4942;1154;4179;260;1011;233;775;493;1786
352050;201404;7956;27205;5923;22458;1825;7551;989;3271;2814;10822
352060;201404;831;2502;733;2341;206;775;285;816;491;1591
352070;201404;748;2059;694;1972;293;900;207;618;500;1518
352080;201404;543;1687;461;1546;123;473;150;446;273;919
352090;201404;1739;5693;1421;5009;335;1327;428;1356;763;2683
352100;201404;1812;6252;1625;5879;541;2179;548;1784;1089;3963
352110;201404;452;1719;404;1603;118;517;126;470;244;987
352115;201404;385;1265;330;1148;98;372;151;496;249;868
352120;201404;987;2954;865;2780;180;629;474;1542;654;2171
352130;201404;1849;5331;1372;4463;356;1260;493;1444;849;2704
352140;201404;1526;4914;1171;4111;329;1227;462;1603;791;2830
352150;201404;648;2007;521;1751;168;591;200;641;368;1232
352160;201404;1257;3604;1161;3467;255;821;656;1973;911;2794
352170;201404;2533;7900;2316;7492;587;2081;1163;3564;1750;5645
352180;201404;3640;10589;3209;9786;861;2879;1353;3897;2214;6776
352190;201404;1116;3477;1022;3311;213;826;519;1562;732;2388
352200;201404;433;1516;363;1376;75;316;169;659;244;975
352210;201404;15619;42662;12546;38116;2427;7793;7455;23227;9882;31020
352215;201404;579;1846;526;1770;81;311;292;989;373;1300
352220;201404;15043;50656;13994;48499;4766;17594;5005;17270;9771;34864
352230;201404;13773;47755;12193;44730;3793;15251;4431;15910;8224;31161
352240;201404;9598;30941;8823;29561;2975;11246;3313;10362;6288;21608
352250;201404;22830;74541;20262;69317;5364;20132;7702;26008;13066;46140
352260;201404;5501;17193;3955;13960;1044;4100;1243;4003;2287;8103
352265;201404;952;3045;820;2832;136;547;495;1660;631;2207
352270;201404;2547;8750;2205;7975;839;3209;472;1622;1311;4831
352280;201404;2490;7842;2116;7215;590;2265;681;2212;1271;4477
352290;201404;1323;4339;1160;3986;284;1110;323;974;607;2084
352300;201404;979;2958;819;2672;237;831;336;1078;573;1909
352310;201404;33262;112228;30045;106623;8293;31550;16791;58708;25084;90258
352320;201404;5742;17993;5010;16609;1521;5527;1623;4810;3144;10337
352330;201404;2224;7345;1944;6991;679;2629;644;2317;1323;4946
352340;201404;5886;20403;4877;17928;1630;6425;877;2935;2507;9360
352350;201404;1789;6642;1630;6287;453;1920;549;2015;1002;3935
352360;201404;1211;4033;1083;3772;297;1244;578;1848;875;3092
352370;201404;917;3146;836;2968;193;779;376;1302;569;2081
352380;201404;1036;3335;915;3128;349;1327;245;798;594;2125
352390;201404;12879;38585;9849;32651;2141;8160;4584;14213;6725;22373
352400;201404;3427;10402;2327;8206;655;2539;832;2773;1487;5312
352410;201404;3805;11299;2949;9837;955;3419;863;2751;1818;6170
352420;201404;1301;3770;1218;3623;451;1508;439;1277;890;2785
352430;201404;6386;20319;5668;19135;2206;8136;1774;5765;3980;13901
352440;201404;16135;51381;13408;45982;3617;13419;4952;16494;8569;29913
352450;201404;656;1950;452;1556;113;431;96;286;209;717
352460;201404;2747;9302;2481;8795;873;3454;789;2544;1662;5998
352470;201404;4929;14085;3047;10131;588;2149;1210;3916;1798;6065
352480;201404;5472;15654;4523;13911;1181;4198;1826;5148;3007;9346
352490;201404;756;2729;644;2464;153;662;122;439;275;1101
352500;201404;8949;29196;8440;28334;3964;14302;2310;7066;6274;21368
352510;201404;3478;12133;2892;10861;1006;4089;671;2444;1677;6533
352520;201404;2454;8769;2207;8203;582;2333;1151;4194;1733;6527
352530;201404;6565;21450;5004;18054;1428;5597;795;2600;2223;8197
352540;201404;492;1639;395;1420;94;371;114;401;208;772
352550;201404;1123;3815;890;3275;282;1137;188;639;470;1776
352560;201404;596;1820;465;1527;88;340;194;568;282;908
352570;201404;1604;5199;1160;4146;244;1004;283;900;527;1904
352580;201404;945;2875;819;2659;286;1063;329;979;615;2042
352585;201404;235;791;185;677;43;180;39;124;82;304
352590;201404;13883;45551;12478;42803;2970;11355;6500;21505;9470;32860
352600;201404;1947;6349;1806;6040;618;2167;638;2077;1256;4244
352610;201404;3649;11773;3264;11144;1232;4622;985;3173;2217;7795
352620;201404;5581;18025;5295;17635;1255;4400;3304;11069;4559;15469
352630;201404;858;2873;811;2756;239;897;361;1195;600;2092
352640;201404;3148;10156;2602;8951;559;2135;1094;3651;1653;5786
352650;201404;856;2583;645;2145;141;503;210;663;351;1166
352660;201404;1099;3865;898;3379;276;1108;245;911;521;2019
352670;201404;7938;27186;6890;25087;2603;9943;1493;5405;4096;15348
352680;201404;3365;11991;2681;10262;634;2679;665;2245;1299;4924
352690;201404;26038;78072;20299;66620;5144;18522;8135;25670;13279;44192
352700;201404;775;2316;620;2077;187;722;261;826;448;1548
352710;201404;5340;16031;3968;13241;1060;3944;1388;4381;2448;8325
352720;201404;8976;30470;8403;29256;2805;10355;3093;10687;5898;21042
352725;201404;417;1257;286;954;51;204;79;240;130;444
352730;201404;2674;9375;2353;8505;611;2428;682;2189;1293;4617
352740;201404;2296;6907;1968;6319;524;1994;874;2521;1398;4515
352750;201404;421;1297;313;1052;92;341;67;195;159;536
352760;201404;988;3464;913;3330;315;1265;442;1541;757;2806
352770;201404;940;2946;888;2848;249;877;320;1021;569;1898
352780;201404;625;2138;548;1957;151;601;166;526;317;1127
352790;201404;666;1976;533;1736;149;536;103;319;252;855
352800;201404;1166;4413;945;3786;270;1106;161;563;431;1669
352810;201404;1042;2801;772;2295;140;479;275;768;415;1247
352820;201404;602;1816;495;1638;203;715;90;299;293;1014
352830;201404;440;1297;334;1070;84;270;53;146;137;416
352840;201404;3646;12872;3224;11938;980;3886;1011;3700;1991;7586
352850;201404;10046;32948;8837;30796;2585;9620;3124;10975;5709;20595
352860;201404;1054;3551;982;3393;396;1444;244;774;640;2218
352870;201404;1133;2894;888;2445;131;468;470;1162;601;1630
352880;201404;2375;7183;1865;6049;445;1571;458;1348;903;2919
352885;201404;314;1084;299;1051;87;341;121;401;208;742
352890;201404;827;2310;676;2009;128;435;258;694;386;1129
352900;201404;19421;59738;15000;50523;3958;14550;5683;18314;9641;32864
352910;201404;288;931;252;849;75;262;28;78;103;340
352920;201404;3417;10597;2928;9629;988;3601;952;2866;1940;6467
352930;201404;7177;23055;5751;19845;1597;5936;1034;3408;2631;9344
352940;201404;27219;92810;23629;84149;8166;30667;4085;13949;12251;44616
352950;201404;318;1015;229;820;56;241;61;189;117;430
352960;201404;584;1881;407;1439;76;296;64;209;140;505
352965;201404;376;1078;306;946;77;257;44;131;121;388
352970;201404;3387;8984;3015;8492;410;1259;2131;6087;2541;7346
352980;201404;1515;4545;1289;4186;423;1430;510;1736;933;3166
352990;201404;3604;12153;3342;11701;1137;4362;1085;3629;2222;7991
353000;201404;544;1549;403;1253;86;298;101;271;187;569
353010;201404;2845;8186;2154;6765;580;2067;737;2115;1317;4182
353020;201404;4464;12486;3185;9750;532;1832;1299;3619;1831;5451
353030;201404;3859;11562;3234;10308;978;3435;770;2270;1748;5705
353040;201404;704;2036;610;1890;208;702;216;646;424;1348
353050;201404;5611;19651;4819;17969;1752;7036;1378;4843;3130;11879
353060;201404;34187;111631;31984;108158;5574;22432;21176;68423;26750;90855
353070;201404;8930;30835;7153;26682;2433;9565;1642;6131;4075;15696
353080;201404;4965;17157;4062;15065;1302;5228;1051;3605;2353;8833
353090;201404;601;2022;533;1879;89;382;260;826;349;1208
353100;201404;283;848;225;714;97;321;44;129;141;450
353110;201404;7979;25231;7189;23781;1776;6278;3815;12744;5591;19022
353120;201404;472;1607;402;1454;129;525;87;277;216;802
353130;201404;3041;9614;2704;9012;1045;3807;893;2784;1938;6591
353140;201404;2658;7580;2156;6574;641;2150;662;1807;1303;3957
353150;201404;1979;6320;1654;5701;605;2197;373;1325;978;3522
353160;201404;655;1948;525;1681;146;495;98;288;244;783
353170;201404;524;1877;477;1790;185;781;175;620;360;1401
353180;201404;5650;18089;4988;16846;796;3134;3061;9981;3857;13115
353190;201404;3672;11868;3196;10762;761;2852;1430;4439;2191;7291
353200;201404;900;3193;807;2982;259;1087;291;1004;550;2091
353205;201404;540;1750;444;1531;104;361;144;504;248;865
353210;201404;1062;2861;871;2522;118;413;548;1548;666;1961
353215;201404;571;1805;496;1644;106;392;160;521;266;913
353220;201404;928;2886;841;2712;224;785;270;844;494;1629
353230;201404;969;3112;892;2982;217;825;273;834;490;1659
353240;201404;2234;7500;2034;7083;648;2514;812;2606;1460;5120
353250;201404;1260;3620;1065;3268;294;967;377;1093;671;2060
353260;201404;1170;3449;1036;3233;328;1099;398;1170;726;2269
353270;201404;678;2068;588;1893;178;620;157;469;335;1089
353280;201404;581;1930;507;1800;167;641;130;435;297;1076
353282;201404;1758;5898;1707;5818;311;1195;1116;3700;1427;4895
353284;201404;343;989;265;839;68;216;74;236;142;452
353286;201404;153;469;103;349;27;90;11;41;38;131
353290;201404;462;1641;412;1552;168;668;140;510;308;1178
353300;201404;1903;6148;1657;5594;566;2036;499;1518;1065;3554
353310;201404;353;1123;334;1074;141;481;86;255;227;736
353320;201404;552;1579;478;1457;115;414;228;650;343;1064
353325;201404;540;1908;457;1725;116;486;63;224;179;710
353330;201404;552;1657;415;1358;98;364;173;507;271;871
353340;201404;3235;10534;2798;9661;938;3498;961;3218;1899;6716
353350;201404;3528;10822;3115;10083;1059;3703;1321;4123;2380;7826
353360;201404;448;1574;397;1449;102;431;207;704;309;1135
353370;201404;726;2382;662;2220;167;592;314;1047;481;1639
353380;201404;409;1355;366;1276;97;378;154;517;251;895
353390;201404;5562;15089;4000;12247;887;3010;1421;3947;2308;6957
353400;201404;628;1989;526;1772;124;459;145;412;269;871
353410;201404;691;2137;588;1972;177;658;282;915;459;1573
353420;201404;707;2118;542;1710;165;566;157;448;322;1014
353430;201404;2487;8736;1811;6756;438;1690;121;373;559;2063
353440;201404;61132;202706;54744;187515;16844;60715;16742;55676;33586;116391
353450;201404;463;1426;412;1337;108;413;147;450;255;863
353460;201404;3605;10188;3051;9214;618;2028;1560;4672;2178;6700
353470;201404;11497;36728;9094;31682;2762;10521;1997;6698;4759;17219
353475;201404;1752;5113;1300;4101;304;1043;349;970;653;2013
353480;201404;1556;4696;1404;4418;322;1159;753;2252;1075;3411
353490;201404;1651;4767;1385;4223;369;1264;366;993;735;2257
353500;201404;1231;3570;1130;3398;473;1507;375;1065;848;2572
353510;201404;1396;4546;1169;3942;335;1258;331;958;666;2216
353520;201404;1170;3646;998;3328;379;1359;268;890;647;2249
353530;201404;2794;8477;2519;7973;637;2254;1108;3363;1745;5617
353540;201404;2059;6359;1880;6053;654;2187;713;2335;1367;4522
353550;201404;6831;19841;6066;18595;1144;4095;3343;9565;4487;13660
353560;201404;2200;7363;1849;6721;456;1878;653;2283;1109;4161
353570;201404;525;1691;430;1494;93;364;222;704;315;1068
353580;201404;2483;8207;2329;7929;749;2864;1211;3934;1960;6798
353590;201404;808;2352;684;2127;256;869;164;521;420;1390
353600;201404;1927;5583;1749;5269;398;1347;854;2553;1252;3900
353610;201404;604;2153;534;2006;145;630;160;554;305;1184
353620;201404;2374;8281;2135;7817;688;2750;670;2301;1358;5051
353625;201404;378;1056;270;865;96;349;66;182;162;531
353630;201404;1726;5972;1381;5111;324;1331;248;806;572;2137
353640;201404;1640;4786;1457;4403;363;1177;601;1822;964;2999
353650;201404;6831;20991;4926;16708;1067;3920;1734;5517;2801;9437
353657;201404;339;1115;310;1053;65;267;112;352;177;619
353660;201404;1410;3665;1053;3099;446;1453;162;325;608;1778
353670;201404;4918;16374;4345;15147;1416;5426;1308;4230;2724;9656
353680;201404;682;2431;649;2373;310;1194;177;630;487;1824
353690;201404;539;1501;376;1224;102;383;133;392;235;775
353700;201404;2377;7706;2094;7083;492;1856;688;2181;1180;4037
353710;201404;3448;9343;1827;6527;535;2124;506;1781;1041;3905
353715;201404;486;1465;416;1334;84;309;184;571;268;880
353720;201404;2119;6704;1847;6291;381;1367;1022;3567;1403;4934
353730;201404;4500;14182;3652;12229;886;3215;950;2911;1836;6126
353740;201404;2333;7159;1896;6232;624;2154;488;1532;1112;3686
353750;201404;757;2697;620;2355;174;716;161;612;335;1328
353760;201404;8254;25847;6818;23245;1975;7187;2854;9765;4829;16952
353770;201404;798;2523;531;1852;108;419;52;113;160;532
353780;201404;5949;21308;5402;20187;2500;9611;1269;4949;3769;14560
353790;201404;3149;11330;2823;10647;991;4106;517;1992;1508;6098
353800;201404;14737;47893;11942;42443;3356;13152;4554;15584;7910;28736
353810;201404;1201;4015;1063;3693;329;1208;391;1360;720;2568
353820;201404;1263;4487;1215;4405;405;1702;496;1624;901;3326
353830;201404;801;2203;638;1899;129;429;255;744;384;1173
353850;201404;1877;6222;1761;6024;444;1642;818;2676;1262;4318
353860;201404;2476;8487;2079;7560;674;2639;582;2034;1256;4673
353870;201404;23721;74791;18132;63322;4166;16257;5865;18515;10031;34772
353880;201404;2177;7244;1986;6943;347;1449;1210;4095;1557;5544
353890;201404;2496;6565;1871;5556;503;1677;812;2270;1315;3947
353900;201404;1158;3659;868;2999;208;792;191;576;399;1368
353910;201404;2160;7675;2055;7396;672;2579;822;2973;1494;5552
353920;201404;2524;7562;1923;6313;436;1511;332;982;768;2493
353930;201404;4084;14473;3446;13070;1191;4802;726;2686;1917;7488
353940;201404;1530;4953;1337;4544;319;1247;530;1649;849;2896
353950;201404;3675;12075;3387;11553;556;2196;2156;7160;2712;9356
353960;201404;619;2009;503;1748;116;446;138;412;254;858
353970;201404;534;1584;468;1500;55;224;332;1031;387;1255
353980;201404;14520;43444;12291;39743;3043;10635;6123;19479;9166;30114
353990;201404;523;1658;482;1557;146;526;173;493;319;1019
354000;201404;1958;5889;1374;4718;297;1145;131;376;428;1521
354010;201404;391;1226;353;1163;150;508;109;360;259;868
354020;201404;4863;14978;4411;14039;1390;4766;1781;5303;3171;10069
354025;201404;1069;3127;871;2766;233;811;207;631;440;1442
354030;201404;655;1759;466;1477;139;488;152;443;291;931
354040;201404;797;2187;628;1870;94;334;349;956;443;1290
354050;201404;975;3305;900;3145;332;1278;237;792;569;2070
354060;201404;4702;15407;3764;13376;1022;3912;1460;4995;2482;8907
354070;201404;3686;12452;3226;11385;1151;4374;732;2524;1883;6898
354075;201404;2261;8605;2165;8434;760;3217;897;3426;1657;6643
354080;201404;1947;6042;1536;5043;403;1381;431;1280;834;2661
354085;201404;310;864;277;801;33;133;196;514;229;647
354090;201404;1197;3639;1136;3543;154;539;841;2589;995;3128
354100;201404;16993;58716;14735;54477;4066;16067;6237;22946;10303;39013
354105;201404;888;2859;752;2595;178;711;297;911;475;1622
354110;201404;851;2462;696;2221;196;718;211;600;407;1318
354120;201404;2291;6524;1937;5881;535;1815;658;1859;1193;3674
354130;201404;5400;16535;4651;15054;1791;6182;1209;3647;3000;9829
354140;201404;21142;56120;13933;42240;2661;9177;5503;15402;8164;24579
354150;201404;4550;12814;3600;11109;1018;3488;1461;4304;2479;7792
354160;201404;4065;13529;3590;12501;1053;3953;1403;4698;2456;8651
354165;201404;414;1544;380;1457;137;570;88;340;225;910
354170;201404;1642;5378;1353;4677;289;1135;461;1407;750;2542
354180;201404;525;1602;511;1577;63;233;340;979;403;1212
354190;201404;1675;5656;1461;5164;518;1947;434;1477;952;3424
354200;201404;1177;3461;965;3057;207;763;368;1023;575;1786
354210;201404;855;3014;773;2825;175;766;301;1002;476;1768
354220;201404;3189;10098;2889;9518;953;3354;1109;3506;2062;6860
354230;201404;802;2678;758;2600;234;848;345;1181;579;2029
354240;201404;1372;4689;1127;4135;324;1304;256;874;580;2178
354250;201404;552;1795;454;1625;196;785;122;401;318;1186
354260;201404;9629;29392;8776;28038;2737;9617;3406;10792;6143;20409
354270;201404;1150;4135;1074;3963;318;1315;411;1511;729;2826
354280;201404;904;2677;843;2571;164;571;467;1406;631;1977
354290;201404;1335;4791;1235;4569;386;1522;352;1293;738;2815
354300;201404;3223;11310;3128;11126;855;3187;1535;5444;2390;8631
354310;201404;798;2669;633;2266;170;669;166;595;336;1264
354320;201404;846;2574;731;2342;213;781;226;648;439;1429
354323;201404;372;1103;310;1002;99;348;99;289;198;637
354325;201404;1333;4611;1199;4315;312;1269;448;1479;760;2748
354330;201404;8122;25656;7316;24077;1996;7109;3604;11419;5600;18528
354340;201404;30327;100111;26147;92375;9884;37495;8621;29536;18505;67031
354350;201404;1190;3599;1120;3470;321;1052;559;1668;880;2720
354360;201404;455;1502;372;1340;91;358;35;109;126;467
354370;201404;1163;3937;1024;3641;152;673;686;2351;838;3024
354380;201404;1331;4043;1118;3666;409;1493;186;522;595;2015
354390;201404;11775;38608;9011;32377;2283;9006;2305;7829;4588;16835
354400;201404;2167;7802;1901;7155;480;1981;560;1986;1040;3967
354410;201404;6491;20002;5428;18273;1336;4916;2663;8875;3999;13791
354420;201404;1681;5033;1404;4423;421;1414;463;1391;884;2805
354425;201404;3539;10317;3109;9533;1054;3460;936;2916;1990;6376
354430;201404;1386;4607;1280;4436;344;1335;602;1987;946;3322
354440;201404;569;1719;454;1480;87;312;192;604;279;916
354450;201404;494;1452;335;1097;53;228;92;251;145;479
354460;201404;829;2494;731;2315;262;876;306;957;568;1833
354470;201404;477;1403;393;1229;71;285;177;484;248;769
354480;201404;789;2388;702;2244;142;530;354;1015;496;1545
354490;201404;774;2658;619;2273;143;564;197;644;340;1208
354500;201404;2567;8781;2351;8384;842;3310;594;2085;1436;5395
354510;201404;729;2418;661;2276;175;661;315;1063;490;1724
354515;201404;361;1275;298;1123;71;306;89;300;160;606
354520;201404;5990;21264;4667;17643;1458;6165;1585;5672;3043;11837
354530;201404;2848;10354;2676;10019;803;3274;1338;4934;2141;8208
354540;201404;1392;4340;1225;4040;411;1438;441;1491;852;2929
354550;201404;587;1923;523;1773;108;382;206;657;314;1039
354560;201404;1477;4550;1165;3846;314;1050;359;1155;673;2205
354570;201404;665;2095;551;1820;189;683;106;325;295;1008
354580;201404;9314;27661;7603;24415;1622;5829;3426;10413;5048;16242
354600;201404;1740;6044;1559;5685;493;2088;631;2104;1124;4192
354610;201404;482;1369;343;1086;64;221;92;248;156;469
354620;201404;434;1518;359;1371;104;470;113;396;217;866
354625;201404;280;941;237;853;65;273;59;197;124;470
354630;201404;1931;6822;1757;6411;752;2740;510;1770;1262;4510
354640;201404;4180;14154;3584;12826;1022;4129;743;2411;1765;6540
354650;201404;1017;3120;922;2921;188;695;511;1552;699;2247
354660;201404;2028;6213;1618;5445;427;1586;682;2273;1109;3859
354670;201404;1636;5375;1320;4562;371;1416;317;938;688;2354
354680;201404;5380;18217;4955;17298;1423;5276;1820;6118;3243;11394
354690;201404;875;2978;627;2357;119;469;171;583;290;1052
354700;201404;1194;3427;841;2661;148;548;345;945;493;1493
354710;201404;626;1880;541;1709;137;517;181;508;318;1025
354720;201404;194;566;159;494;57;179;36;113;93;292
354730;201404;6579;23394;5884;21973;1719;6941;2441;8781;4160;15722
354740;201404;234;783;198;701;49;179;40;142;89;321
354750;201404;2322;7517;1984;7049;677;2620;731;2547;1408;5167
354760;201404;2217;7472;1885;6705;602;2266;401;1357;1003;3623
354765;201404;307;817;201;625;39;151;33;96;72;247
354770;201404;2845;8443;2297;7541;993;3549;377;1137;1370;4686
354780;201404;36529;117158;33800;111000;8489;30792;16179;50421;24668;81213
354790;201404;877;2899;772;2714;215;827;311;1005;526;1832
354800;201404;1874;5658;1708;5431;466;1628;953;3036;1419;4664
354805;201404;919;2888;710;2416;105;408;130;407;235;815
354810;201404;703;2363;532;1967;168;684;86;279;254;963
354820;201404;1075;3863;975;3663;295;1262;231;767;526;2029
354830;201404;446;1385;394;1287;125;474;137;404;262;878
354840;201404;808;2432;741;2306;227;754;274;833;501;1587
354850;201404;14675;48017;11352;40944;2989;11972;3820;12775;6809;24747
354860;201404;1290;4271;1178;4075;293;1232;538;1731;831;2963
354870;201404;43355;141201;40706;135673;12776;45437;18111;58855;30887;104292
354880;201404;4127;13069;3009;10533;826;3159;665;2035;1491;5194
354890;201404;15350;47841;13386;43933;3742;13363;4417;13894;8159;27257
354900;201404;620;1764;505;1596;169;591;181;557;350;1148
354910;201404;6517;20321;3890;14179;855;3432;421;1455;1276;4887
354920;201404;508;1527;397;1327;115;414;92;287;207;701
354925;201404;373;1085;225;776;44;170;33;93;77;263
354930;201404;258;800;237;747;74;260;60;180;134;440
354940;201404;2314;8288;1799;6844;692;2757;251;889;943;3646
354950;201404;1494;5044;1369;4861;241;996;841;2930;1082;3926
354960;201404;790;2546;692;2383;205;796;248;821;453;1617
354970;201404;4019;13606;3590;12725;788;3201;1834;6180;2622;9381
354980;201404;32708;82193;18738;57906;4082;14177;6117;17464;10199;31641
354990;201404;39538;131120;35427;122579;8166;31340;17720;59396;25886;90736
354995;201404;1989;6349;1871;6171;486;1686;944;3134;1430;4820
355000;201404;1672;5687;1469;5310;501;1937;330;1168;831;3105
355010;201404;3687;11890;3142;10646;847;3161;1294;4287;2141;7448
355020;201404;3307;11936;2850;11048;1390;5717;687;2664;2077;8381
355030;201404;917099;2703666;840921;2553640;221414;731107;351404;1040034;572818;1771141
355040;201404;2978;9889;2684;9346;902;3477;1220;4039;2122;7516
355050;201404;1290;4130;1069;3673;336;1237;240;812;576;2049
355060;201404;5011;17479;4075;15338;1077;4568;908;3095;1985;7663
355070;201404;6406;20466;5764;19377;1341;5228;3005;9510;4346;14738
355080;201404;1381;4977;1084;4199;300;1285;139;451;439;1736
355090;201404;1110;4040;946;3650;227;970;377;1372;604;2342
355100;201404;29091;94459;25773;88769;9023;32973;8517;29802;17540;62775
355110;201404;1330;4682;1220;4440;408;1608;380;1345;788;2953
355120;201404;669;2165;580;1989;183;679;227;752;410;1431
355130;201404;563;1553;352;1086;89;306;122;321;211;627
355140;201404;1031;3789;987;3688;298;1226;432;1581;730;2807
355150;201404;3541;12035;3126;11236;990;3710;1160;4043;2150;7753
355160;201404;1584;5470;1363;5087;548;2300;349;1137;897;3437
355170;201404;9979;28875;7166;23796;2387;8593;1732;5628;4119;14221
355180;201404;2908;9133;2524;8426;696;2684;940;2933;1636;5617
355190;201404;1307;4656;1206;4427;522;1958;327;1163;849;3121
355200;201404;932;3463;886;3368;420;1682;200;747;620;2429
355210;201404;2810;9836;2587;9369;773;3150;1006;3353;1779;6503
355220;201404;30446;104813;27997;99815;12008;44413;7023;25767;19031;70180
355230;201404;1236;3653;788;2634;140;548;182;504;322;1052
355240;201404;22334;69715;17413;58701;4119;15407;6579;20494;10698;35901
355250;201404;25555;86955;23131;82165;6985;26523;9608;33679;16593;60202
355255;201404;894;2541;664;2069;120;400;193;568;313;968
355260;201404;1624;4812;1466;4521;403;1389;534;1512;937;2901
355270;201404;1675;5215;1596;5089;232;931;1127;3409;1359;4340
355280;201404;23820;72920;20801;66990;5080;18448;8918;27215;13998;45663
355290;201404;875;2864;813;2750;180;665;380;1224;560;1889
355300;201404;920;3045;718;2595;170;638;194;658;364;1296
355310;201404;1057;3308;943;3095;237;816;428;1455;665;2271
355320;201404;749;2430;666;2234;183;686;223;634;406;1320
355330;201404;1603;5856;1381;5421;492;2141;389;1399;881;3540
355340;201404;3153;8698;2931;8315;787;2486;1536;4133;2323;6619
355350;201404;1412;5016;1259;4684;416;1677;333;1211;749;2888
355360;201404;1237;4334;1147;4150;273;1110;729;2610;1002;3720
355365;201404;315;1010;267;912;72;278;65;209;137;487
355370;201404;7308;19244;5362;16863;1915;6626;1909;6007;3824;12633
355380;201404;3697;11377;2884;9469;776;2785;576;1605;1352;4390
355385;201404;1001;3292;950;3197;390;1444;228;712;618;2156
355390;201404;1426;4044;1240;3687;341;1098;428;1231;769;2329
355395;201404;1771;5566;1385;4637;261;998;531;1585;792;2583
355400;201404;9137;32000;8332;30275;2948;11710;2939;10158;5887;21868
355410;201404;13365;49491;12444;47459;4844;19723;3215;12355;8059;32078
355420;201404;835;3078;789;2960;312;1235;239;895;551;2130
355430;201404;3717;11120;3236;10262;793;2783;1505;4614;2298;7397
355440;201404;907;3040;758;2662;203;732;189;582;392;1314
355450;201404;2637;8899;2220;7998;649;2607;664;2232;1313;4839
355460;201404;580;1663;443;1409;120;465;129;334;249;799
355465;201404;451;1403;385;1271;118;417;96;311;214;728
355470;201404;981;3069;799;2751;272;1045;260;829;532;1874
355475;201404;138;535;122;486;31;129;37;161;68;290
355480;201404;3273;12111;3095;11714;984;3993;1301;4801;2285;8794
355490;201404;851;2556;676;2178;178;626;154;503;332;1129
355495;201404;743;2511;696;2419;188;735;268;881;456;1616
355500;201404;8572;26156;6048;20515;1393;5230;1193;3646;2586;8876
355510;201404;2178;6101;1477;4704;311;1148;418;1212;729;2360
355520;201404;413;1064;265;780;56;194;74;179;130;373
355530;201404;216;537;102;323;13;43;24;89;37;132
355535;201404;698;2169;572;1917;159;637;149;401;308;1038
355540;201404;10359;33865;9843;33007;2839;10299;4670;15284;7509;25583
355550;201404;718;2285;674;2199;194;707;305;968;499;1675
355560;201404;1433;4290;1082;3581;264;987;216;575;480;1562
355570;201404;196;664;170;598;36;120;35;111;71;231
355580;201404;1283;3913;1110;3565;387;1406;399;1214;786;2620
355590;201404;260;744;231;684;50;186;112;314;162;500
355600;201404;1077;3514;902;3110;353;1330;189;619;542;1949
355610;201404;1452;4305;1246;3979;374;1305;484;1487;858;2792
355620;201404;4018;13128;3277;11437;765;3033;1272;4015;2037;7048
355630;201404;3336;9832;2127;7226;452;1743;654;2001;1106;3744
355635;201404;998;3362;874;3134;180;717;519;1841;699;2558
355640;201404;3840;12989;3247;11567;1113;4166;564;1939;1677;6105
355645;201404;3437;12545;3259;12202;670;2773;1940;7198;2610;9971
355650;201404;6711;21598;5909;20010;1258;5118;3339;10494;4597;15612
355660;201404;1357;4449;1139;4014;352;1400;403;1318;755;2718
355670;201404;2325;7520;1613;5842;406;1683;512;1607;918;3290
355680;201404;1787;6176;1452;5349;536;2099;275;949;811;3048
355690;201404;353;1232;316;1157;208;808;26;62;234;870
355695;201404;341;1052;247;817;30;101;19;49;49;150
355700;201404;6564;23590;5989;22172;1813;7285;2368;8396;4181;15681
355710;201404;12930;33405;8171;24687;2574;8359;1953;5581;4527;13940
355715;201404;255;773;169;591;41;157;31;94;72;251
355720;201404;1499;4973;1247;4430;402;1569;371;1170;773;2739
355730;201404;781;2763;711;2612;284;1107;147;540;431;1647
410010;201404;1640;5291;1494;4976;412;1495;424;1389;836;2884
410020;201404;1264;4334;1178;4150;373;1374;404;1412;777;2786
410030;201404;1102;3826;942;3435;283;1105;167;611;450;1716
410040;201404;13135;44434;12075;42237;4166;15654;3291;11316;7457;26970
410045;201404;1119;3200;816;2612;247;844;241;721;488;1565
410050;201404;3083;9009;2162;7249;695;2541;518;1643;1213;4184
410060;201404;2022;6544;1830;6160;537;2001;640;2091;1177;4092
410070;201404;2188;6300;1794;5493;653;2163;344;939;997;3102
410080;201404;1490;4523;1250;4071;300;1052;605;1883;905;2935
410090;201404;1136;3663;1035;3449;351;1272;330;1037;681;2309
410100;201404;2664;8054;1958;6429;577;2202;394;1138;971;3340
410105;201404;517;1652;394;1360;79;307;53;137;132;444
410110;201404;2688;8390;2371;7738;588;2183;808;2519;1396;4702
410115;201404;579;1663;496;1484;100;344;163;452;263;796
410120;201404;2938;10189;2789;9969;1102;4159;1077;3951;2179;8110
410130;201404;1410;4757;1284;4463;409;1403;539;1910;948;3313
410140;201404;15826;44351;11329;35999;3272;11532;3634;11409;6906;22941
410150;201404;18131;45955;8861;26858;1779;6063;1686;4528;3465;10591
410160;201404;3383;10925;3106;10471;1007;3759;1064;3618;2071;7377
410165;201404;788;2381;653;2085;140;474;288;891;428;1365
410170;201404;1830;5711;1563;5124;603;2145;431;1356;1034;3501
410180;201404;8896;28938;7799;26537;1997;7723;3389;10687;5386;18410
410185;201404;661;1845;602;1741;170;528;334;975;504;1503
410190;201404;2267;6867;1987;6236;619;2100;501;1462;1120;3562
410200;201404;3958;11510;3085;9689;833;2897;488;1397;1321;4294
410210;201404;2660;8248;2121;7052;490;1848;423;1208;913;3056
410220;201404;654;1925;514;1634;99;350;182;544;281;894
410230;201404;1878;6140;1723;5871;659;2480;569;1860;1228;4340
410240;201404;5244;16603;4846;15757;1592;5619;1658;5272;3250;10891
410250;201404;2537;7315;1863;5944;588;2096;357;987;945;3083
410260;201404;1727;5446;1531;5071;448;1587;539;1753;987;3340
410270;201404;556;1668;475;1502;127;450;193;601;320;1051
410275;201404;946;2857;661;2229;115;422;334;1127;449;1549
410280;201404;2903;8805;2124;7117;454;1757;381;1195;835;2952
410290;201404;3318;10399;2928;9650;781;2769;1226;4046;2007;6815
410300;201404;624;1803;563;1676;92;322;289;772;381;1094
410302;201404;596;1714;481;1528;58;192;282;920;340;1112
410304;201404;1478;4877;1357;4623;420;1502;521;1838;941;3340
410305;201404;2220;5979;1912;5527;517;1610;1066;3117;1583;4727
410310;201404;2357;7935;2161;7550;644;2419;732;2597;1376;5016
410315;201404;626;1944;494;1666;114;405;153;469;267;874
410320;201404;1259;3749;836;2856;164;649;72;206;236;855
410322;201404;603;1817;445;1463;117;395;122;389;239;784
410330;201404;1511;4281;1283;3847;360;1196;395;1136;755;2332
410335;201404;1067;3184;911;2908;245;888;330;976;575;1864
410337;201404;826;2259;701;2036;143;488;281;752;424;1240
410340;201404;593;1790;470;1473;86;308;139;362;225;670
410345;201404;1888;5777;1553;5049;487;1743;360;1073;847;2816
410347;201404;834;2403;615;1986;160;569;155;475;315;1044
410350;201404;880;2800;620;2232;148;637;103;318;251;955
410360;201404;3489;10807;3141;10217;1004;3569;916;2957;1920;6526
410370;201404;13113;39215;10025;32438;2578;9520;2781;8237;5359;17757
410380;201404;1415;4562;1302;4318;318;1144;595;1913;913;3057
410390;201404;2862;8478;2334;7510;862;2994;592;1744;1454;4738
410395;201404;911;3147;823;2949;218;902;371;1299;589;2201
410400;201404;5227;17168;4672;16077;1456;5619;1380;4548;2836;10167
410405;201404;1000;2970;806;2579;218;818;284;835;502;1653
410410;201404;1347;4640;1287;4540;489;1919;304;1015;793;2934
410420;201404;9641;31943;8567;29499;2890;10828;2065;6563;4955;17391
410425;201404;3217;10489;2369;8499;514;2057;324;1114;838;3171
410430;201404;15812;44401;12150;37564;3409;11719;3517;10733;6926;22452
410440;201404;3600;11538;3315;11004;913;3323;1482;4879;2395;8202
410442;201404;2986;10458;2736;9865;926;3509;809;2905;1735;6414
410445;201404;2392;8052;2069;7466;628;2479;722;2721;1350;5200
410450;201404;2632;7636;2139;6712;678;2279;390;1126;1068;3405
410460;201404;2408;7343;2027;6553;547;1918;709;2161;1256;4079
410465;201404;1941;7204;1749;6723;598;2409;545;1960;1143;4369
410470;201404;1944;6313;1709;5767;501;1780;531;1780;1032;3560
410480;201404;30664;90956;24961;79724;9046;31542;6070;18491;15116;50033
410490;201404;11612;38260;9724;34082;3090;11865;2912;9988;6002;21853
410500;201404;1526;4926;1274;4355;491;1842;306;1039;797;2881
410510;201404;2460;6648;1810;5354;461;1482;712;1932;1173;3414
410520;201404;3248;11514;3089;11172;1194;4582;1011;3645;2205;8227
410530;201404;1690;4910;1426;4381;367;1314;555;1581;922;2895
410540;201404;3886;11444;2774;9229;707;2550;898;2934;1605;5484
410550;201404;6701;21060;5336;17920;1619;6033;805;2401;2424;8434
410560;201404;1291;4216;1041;3561;245;910;254;699;499;1609
410570;201404;2934;9718;2701;9314;817;2931;1116;4132;1933;7063
410580;201404;25779;82873;22787;76527;7558;27838;6381;20181;13939;48019
410590;201404;1283;4137;869;2943;153;565;192;547;345;1112
410600;201404;1970;5962;1693;5409;480;1627;697;2228;1177;3855
410610;201404;836;2591;715;2367;191;678;290;915;481;1593
410620;201404;1735;6372;1570;5948;508;2040;357;1302;865;3342
410630;201404;2530;7648;2108;6780;568;2013;660;1988;1228;4001
410640;201404;5070;15044;4108;13206;1345;4900;880;2665;2225;7565
410645;201404;1289;4604;1235;4499;532;2102;344;1252;876;3354
410650;201404;2500;7785;2070;6894;705;2497;475;1488;1180;3985
410655;201404;933;2877;783;2576;229;827;223;715;452;1542
410657;201404;672;2054;556;1813;152;579;200;571;352;1150
410660;201404;3859;11370;3068;9644;1072;3617;620;1791;1692;5408
410670;201404;1001;2894;773;2445;195;685;193;577;388;1262
410680;201404;2448;8671;2080;7705;581;2192;676;2624;1257;4816
410685;201404;675;2065;628;1987;109;333;419;1343;528;1676
410690;201404;110282;324989;78416;258381;18823;68876;18620;55014;37443;123890
410700;201404;2373;7640;2218;7330;712;2581;860;2714;1572;5295
410710;201404;1104;3496;888;2981;250;932;239;729;489;1661
410712;201404;793;2481;701;2298;329;1177;164;553;493;1730
410715;201404;1070;3423;924;3089;238;880;316;1017;554;1897
410720;201404;4368;13617;3549;11840;1037;3729;940;2936;1977;6665
410725;201404;1088;3175;783;2556;165;581;181;488;346;1069
410730;201404;731;2245;669;2105;296;995;164;501;460;1496
410740;201404;970;2956;708;2408;161;636;297;984;458;1620
410750;201404;1897;5711;1647;5188;519;1812;467;1341;986;3153
410752;201404;262;786;216;693;45;171;94;272;139;443
410753;201404;469;1443;368;1218;71;275;145;450;216;725
410754;201404;958;2976;853;2807;96;351;584;1970;680;2321
410755;201404;760;2089;607;1841;104;366;317;909;421;1275
410760;201404;2514;8263;2405;8053;916;3268;815;2649;1731;5917
410765;201404;15996;48659;12138;40749;2813;10553;1916;6191;4729;16744
410770;201404;917;2646;755;2332;254;863;197;549;451;1412
410773;201404;1253;3865;1119;3633;283;1045;527;1592;810;2637
410775;201404;1848;5527;1769;5398;519;1541;1025;3279;1544;4820
410780;201404;539;1603;416;1378;131;453;146;533;277;986
410785;201404;926;3036;752;2521;261;902;247;829;508;1731
410790;201404;604;1887;505;1658;131;503;100;262;231;765
410800;201404;2517;7031;2080;6277;805;2713;635;1766;1440;4479
410810;201404;331;1038;270;896;35;134;112;364;147;498
410820;201404;1084;3326;914;2922;255;882;209;652;464;1534
410830;201404;31804;96347;26464;86714;8139;29236;8749;28241;16888;57477
410832;201404;1173;3576;1072;3395;241;907;517;1504;758;2411
410840;201404;7559;23572;5897;19878;1886;6933;978;2919;2864;9852
410845;201404;1585;4798;1396;4404;283;1012;732;2293;1015;3305
410850;201404;2820;8443;2530;8009;591;2161;1312;4123;1903;6284
410855;201404;733;2088;614;1841;167;554;209;619;376;1173
410860;201404;3865;11247;3321;10252;801;2617;1550;4919;2351;7536
410865;201404;1683;5881;1526;5570;405;1592;743;2777;1148;4369
410870;201404;1373;4278;1289;4140;672;2373;288;826;960;3199
410880;201404;4523;13624;3693;12067;916;3485;858;2425;1774;5910
410890;201404;1115;3469;853;2971;242;925;98;273;340;1198
410895;201404;1051;3734;950;3501;343;1346;300;1055;643;2401
410900;201404;887;2535;698;2230;133;487;218;657;351;1144
410910;201404;343;1047;305;980;57;199;152;476;209;675
410920;201404;850;2631;706;2377;211;783;204;632;415;1415
410930;201404;2120;6678;1866;6223;546;2135;674;2157;1220;4292
410940;201404;21226;72326;19016;68143;6238;24423;7270;26075;13508;50498
410950;201404;1915;6394;1749;6084;369;1355;1020;3601;1389;4956
410960;201404;6776;19363;4729;15504;1534;5554;1360;4394;2894;9948
410965;201404;1073;3430;964;3199;317;1133;354;1168;671;2301
410970;201404;5266;16135;4355;14276;1448;5357;920;2986;2368;8343
410975;201404;1485;4421;1242;4001;226;860;604;1941;830;2801
410980;201404;5205;15410;3447;11686;812;3067;746;2401;1558;5468
410990;201404;1087;3364;821;2786;247;930;204;603;451;1533
411000;201404;428;1328;291;1000;59;235;38;105;97;340
411005;201404;516;1539;364;1146;93;295;57;150;150;445
411007;201404;2036;6659;1865;6290;538;1929;788;2714;1326;4643
411010;201404;4011;13976;3721;13314;1399;5541;834;2721;2233;8262
411020;201404;2646;8543;2417;8137;842;3193;747;2501;1589;5694
411030;201404;864;2368;737;2134;219;702;200;529;419;1231
411040;201404;417;1354;346;1188;108;400;81;260;189;660
411050;201404;2135;7740;1932;7277;652;2669;336;1166;988;3835
411060;201404;2110;6771;1840;6176;507;1868;290;862;797;2730
411065;201404;400;1239;329;1096;58;202;111;345;169;547
411070;201404;4707;15306;3522;12585;1050;4169;451;1406;1501;5575
411080;201404;2030;6368;1839;5954;500;1822;556;1706;1056;3528
411090;201404;627;1612;496;1434;90;321;119;311;209;632
411095;201404;1621;4752;1272;4063;301;1083;321;965;622;2048
411100;201404;1509;4419;1148;3714;248;905;253;757;501;1662
411110;201404;946;2887;716;2364;198;699;111;304;309;1003
411120;201404;1747;5541;1534;5094;483;1745;453;1456;936;3201
411125;201404;4742;15649;4612;15392;1668;5827;1990;6529;3658;12356
411130;201404;791;2435;659;2159;189;652;205;690;394;1342
411140;201404;2091;7631;1818;6923;675;2709;380;1516;1055;4225
411150;201404;6058;17279;4963;15104;1419;4688;1195;3280;2614;7968
411155;201404;1201;3597;1075;3333;363;1247;362;1035;725;2282
411160;201404;312;955;283;899;108;363;83;248;191;611
411170;201404;822;2813;741;2613;219;828;217;754;436;1582
411180;201404;6316;19553;5576;18151;1610;5785;1694;5429;3304;11214
411190;201404;1845;5510;1585;5029;454;1598;455;1369;909;2967
411200;201404;4166;13098;3593;12139;1206;4464;1316;4294;2522;8758
411210;201404;2709;7973;2228;7073;842;2890;321;969;1163;3859
411220;201404;1199;3498;981;3089;252;924;399;1128;651;2052
411230;201404;1274;3689;835;2750;248;921;168;487;416;1408
411240;201404;1399;3497;850;2637;249;846;211;584;460;1430
411250;201404;3110;8782;2589;7827;775;2455;785;2377;1560;4832
411260;201404;268;776;206;674;52;193;80;240;132;433
411270;201404;2069;6664;1910;6369;604;2247;781;2522;1385;4769
411275;201404;1548;4716;1365;4292;391;1275;353;1047;744;2322
411280;201404;1756;5510;1416;4758;386;1481;220;653;606;2134
411290;201404;1040;2935;877;2612;222;705;301;941;523;1646
411295;201404;1087;3258;1009;3125;224;779;406;1222;630;2001
411300;201404;1332;3500;946;2765;84;279;377;1010;461;1289
411310;201404;861;2493;677;2182;141;537;287;892;428;1429
411320;201404;5665;17604;4661;15553;1273;4428;1142;3688;2415;8116
411325;201404;1560;5077;1408;4785;227;892;884;2986;1111;3878
411330;201404;3593;11871;3255;11254;1245;4663;942;3200;2187;7863
411340;201404;1000;2966;675;2197;151;567;251;805;402;1372
411342;201404;900;2606;741;2257;202;675;196;528;398;1203
411345;201404;1074;3476;996;3326;295;1089;459;1517;754;2606
411350;201404;2741;8632;2068;7236;653;2496;260;807;913;3303
411360;201404;533;1367;336;980;44;169;139;330;183;499
411370;201404;44983;132277;34730;112550;7446;28330;11929;35291;19375;63621
411373;201404;1443;4621;1230;4189;330;1290;308;998;638;2288
411375;201404;1081;3108;884;2707;237;776;283;806;520;1582
411380;201404;1291;3516;823;2532;141;489;233;682;374;1171
411390;201404;1835;5701;1635;5384;404;1511;845;2662;1249;4173
411400;201404;1765;5419;1411;4589;330;1214;433;1322;763;2536
411410;201404;2480;7869;2170;7142;701;2630;541;1500;1242;4130
411420;201404;4576;13460;3602;11347;955;3388;691;1844;1646;5232
411430;201404;2907;9539;2520;8813;763;2863;1013;3450;1776;6313
411435;201404;580;1881;502;1684;127;463;177;575;304;1038
411440;201404;2548;8428;2326;7975;836;3056;656;2333;1492;5389
411450;201404;2107;6523;1932;6231;455;1586;1067;3433;1522;5019
411460;201404;4555;14529;3498;11956;1244;4545;633;2029;1877;6574
411470;201404;931;2914;682;2288;165;614;122;349;287;963
411480;201404;4744;14805;3866;13077;1636;5988;762;2423;2398;8411
411490;201404;1671;5330;1528;5081;625;2380;369;1082;994;3462
411500;201404;1566;4648;1160;3829;325;1186;253;804;578;1990
411510;201404;2469;7352;1974;6362;606;2164;395;1119;1001;3283
411520;201404;28777;83049;19757;64123;6126;22028;3901;11882;10027;33910
411530;201404;926;2684;636;2134;240;913;102;267;342;1180
411535;201404;460;1397;241;866;41;177;26;76;67;253
411540;201404;3106;8567;2498;7467;440;1364;1379;4230;1819;5594
411545;201404;1034;3665;959;3518;218;870;586;2163;804;3033
411550;201404;749;2115;607;1875;254;856;131;380;385;1236
411560;201404;2638;8126;2162;6978;591;2086;462;1357;1053;3443
411570;201404;6073;17101;4634;14642;1322;4723;1079;3513;2401;8236
411573;201404;1002;3091;951;3001;221;754;501;1600;722;2354
411575;201404;1464;4796;1282;4393;339;1245;459;1553;798;2798
411580;201404;3711;11174;2772;9232;606;2375;459;1301;1065;3676
411585;201404;487;1709;382;1405;85;342;66;223;151;565
411590;201404;577;1748;518;1628;122;437;161;482;283;919
411600;201404;370;1141;307;1013;66;267;79;264;145;531
411605;201404;2349;6652;1758;5515;459;1596;672;2026;1131;3622
411610;201404;2292;6749;2138;6489;521;1709;1329;3970;1850;5679
411620;201404;2797;9267;2639;8997;850;3158;1056;3663;1906;6821
411630;201404;729;1963;445;1508;120;475;80;235;200;710
411640;201404;596;1856;501;1652;139;508;183;566;322;1074
411650;201404;191;628;168;582;36;146;56;175;92;321
411660;201404;830;2436;700;2186;183;599;284;903;467;1502
411670;201404;1700;5022;1523;4679;481;1676;524;1489;1005;3165
411680;201404;1736;5371;1527;5014;383;1264;830;2898;1213;4162
411690;201404;3668;11210;3120;10189;1068;3708;776;2566;1844;6274
411695;201404;827;2695;699;2433;140;500;334;1188;474;1688
411700;201404;1852;5505;1426;4699;366;1365;370;1118;736;2483
411705;201404;2266;7860;2000;7334;487;1838;1108;4188;1595;6026
411710;201404;2181;6791;1779;5897;500;1803;396;1170;896;2973
411720;201404;686;2092;534;1726;109;394;131;391;240;785
411721;201404;724;2211;613;1979;180;635;145;419;325;1054
411722;201404;690;2138;562;1864;138;525;155;466;293;991
411725;201404;1329;4373;927;3371;230;924;208;766;438;1690
411727;201404;2314;6730;1893;5829;486;1629;756;2200;1242;3829
411729;201404;555;1540;434;1344;97;325;148;413;245;738
411730;201404;5649;16911;4852;15388;1799;6060;1499;4736;3298;10796
411740;201404;561;1660;447;1420;111;414;175;515;286;929
411745;201404;895;2845;754;2509;195;694;178;558;373;1252
411750;201404;4496;14264;3533;11839;1046;3884;606;1852;1652;5736
411760;201404;8840;26774;7987;25325;2831;9635;2398;7836;5229;17471
411770;201404;3903;13883;3470;12829;1336;5160;727;2731;2063;7891
411780;201404;3024;10074;2932;9961;400;1326;2128;7654;2528;8980
411790;201404;2468;7300;1905;6159;584;2169;592;1818;1176;3987
411800;201404;1249;3819;845;2839;142;530;132;336;274;866
411810;201404;1570;4942;1384;4528;380;1423;400;1122;780;2545
411820;201404;16567;52651;13993;47880;4862;17258;4058;14627;8920;31885
411830;201404;431;1191;353;1082;98;285;144;484;242;769
411840;201404;8881;27058;7262;23859;2142;7761;1911;6017;4053;13778
411845;201404;536;1747;422;1481;113;433;72;249;185;682
411850;201404;5842;18094;4908;16151;1269;4543;1349;4374;2618;8917
411860;201404;903;2903;762;2600;203;731;201;639;404;1370
411870;201404;1036;3680;817;3072;136;550;204;728;340;1278
411880;201404;2480;7213;2132;6594;524;1853;887;2700;1411;4553
411885;201404;1457;4090;1192;3666;361;1256;372;1021;733;2277
411890;201404;1350;4220;992;3371;253;963;189;553;442;1516
411900;201404;937;3063;715;2496;219;785;106;357;325;1142
411910;201404;1227;4260;1070;3898;322;1275;322;1112;644;2387
411915;201404;11901;34412;8058;26281;1863;6781;1812;5287;3675;12068
411920;201404;1047;3714;932;3418;245;995;196;669;441;1664
411925;201404;618;1815;480;1562;146;503;143;453;289;956
411930;201404;6193;20751;5512;19342;1897;7145;1669;5869;3566;13014
411940;201404;3610;12297;3254;11523;1043;3879;835;2899;1878;6778
411950;201404;9873;32419;8606;29922;2565;9752;3711;12652;6276;22404
411960;201404;5463;16890;5143;16273;1388;4892;2317;7087;3705;11979
411965;201404;551;1718;435;1509;102;403;133;466;235;869
411970;201404;763;2218;614;1971;205;726;158;469;363;1195
411980;201404;2109;5918;1509;4943;233;830;695;2259;928;3089
411990;201404;29329;101974;25822;94432;9258;36284;6645;24468;15903;60752
411995;201404;3085;9877;2811;9308;1140;4098;687;2200;1827;6298
412000;201404;2053;5766;1666;5093;369;1308;693;1903;1062;3211
412010;201404;714;2454;635;2261;176;661;148;492;324;1153
412015;201404;662;2075;544;1823;107;398;277;914;384;1312
412020;201404;427;1273;326;1076;115;413;117;362;232;775
412030;201404;618;1982;420;1489;87;367;114;362;201;729
412033;201404;756;2359;574;1930;140;523;109;314;249;837
412035;201404;986;2870;787;2499;199;733;301;881;500;1614
412040;201404;750;2504;683;2327;252;896;195;646;447;1542
412050;201404;1609;4909;1267;4164;317;1166;256;800;573;1966
412060;201404;6812;24280;6286;23057;1988;7788;2346;8552;4334;16340
412065;201404;991;3076;841;2757;240;887;237;716;477;1603
412070;201404;1146;3289;1017;3009;203;658;397;1147;600;1805
412080;201404;1856;5887;1295;4603;322;1266;126;370;448;1636
412085;201404;309;890;175;597;47;175;43;137;90;312
412090;201404;4867;16158;4666;15788;1043;3835;2856;9755;3899;13590
412100;201404;2212;7071;1960;6627;642;2311;654;2182;1296;4493
412110;201404;1079;3190;785;2560;246;852;219;693;465;1545
412120;201404;2324;8051;2139;7608;575;2265;967;3280;1542;5545
412125;201404;964;3020;864;2853;248;896;323;1066;571;1962
412130;201404;716;2101;535;1743;107;399;120;363;227;762
412135;201404;553;1613;420;1339;87;307;168;483;255;790
412140;201404;1834;5687;1568;5145;449;1582;419;1378;868;2960
412150;201404;2911;8757;2539;7991;422;1482;1431;4384;1853;5866
412160;201404;1215;3899;933;3197;270;1051;328;1087;598;2138
412170;201404;4465;15060;3850;13824;1347;5156;1293;4580;2640;9736
412175;201404;1437;5078;1309;4793;380;1527;488;1797;868;3324
412180;201404;1751;5640;1385;4978;529;2114;359;1205;888;3319
412190;201404;3070;9348;2537;8452;912;3234;611;2115;1523;5349
412200;201404;2294;7753;1676;6056;393;1530;504;1795;897;3325
412210;201404;753;2170;469;1546;98;377;86;253;184;630
412215;201404;3217;10667;2917;10107;501;1764;1844;6628;2345;8392
412217;201404;1184;3536;1125;3429;222;775;692;1995;914;2770
412220;201404;5780;19384;5543;18921;1951;7055;2650;9033;4601;16088
412230;201404;3004;10336;2659;9611;773;3061;793;2726;1566;5787
412240;201404;9233;24573;5434;17349;1125;4052;802;2234;1927;6286
412250;201404;2197;6793;1975;6333;699;2438;463;1357;1162;3795
412260;201404;1313;3962;902;3064;192;751;265;787;457;1538
412265;201404;1209;3870;1116;3686;275;1093;514;1639;789;2732
412270;201404;778;2627;623;2235;134;537;102;344;236;881
412280;201404;690;2139;546;1856;212;768;169;540;381;1308
412290;201404;1256;3578;1048;3165;219;740;377;1071;596;1811
412300;201404;1798;5432;1501;4847;472;1722;368;1113;840;2835
412310;201404;1209;3479;1077;3301;209;568;700;2387;909;2955
412320;201404;706;1956;520;1632;151;552;162;488;313;1040
412330;201404;2018;5584;1566;4790;368;1238;710;2139;1078;3377
412340;201404;752;2396;528;1815;104;391;103;333;207;724
412350;201404;2555;8208;2133;7257;647;2380;398;1238;1045;3618
412360;201404;346;1113;289;968;60;222;79;217;139;439
412370;201404;1132;3593;899;3133;305;1115;245;841;550;1956
412380;201404;2024;6193;1749;5589;492;1663;470;1464;962;3127
412382;201404;724;2102;538;1709;140;503;139;396;279;899
412385;201404;2485;8034;2301;7635;696;2452;804;2711;1500;5163
412390;201404;2460;7449;2261;7103;799;2739;787;2427;1586;5166
412395;201404;974;2754;794;2473;123;403;495;1567;618;1970
412400;201404;1189;3714;1061;3473;329;1140;401;1359;730;2499
412402;201404;2076;6496;1759;5802;516;1855;473;1405;989;3260
412405;201404;4132;12170;2752;9163;667;2559;305;887;972;3446
412410;201404;6342;20848;5758;19647;2440;9150;1080;3579;3520;12729
412420;201404;544;1636;439;1419;126;456;124;329;250;785
412430;201404;463;1396;385;1237;112;407;153;440;265;847
412440;201404;4030;12244;3547;11397;687;2462;1455;4887;2142;7349
412450;201404;390;1255;315;1060;70;263;55;140;125;403
412460;201404;996;2854;710;2316;163;618;159;490;322;1108
412470;201404;1812;6328;1645;5909;554;2132;547;1965;1101;4097
412480;201404;1291;3865;939;3091;211;780;165;439;376;1219
412490;201404;1287;3844;1143;3497;294;949;294;861;588;1810
412500;201404;2058;6197;1763;5610;480;1716;432;1192;912;2908
412510;201404;2769;9492;2460;8663;776;2964;838;2867;1614;5831
412520;201404;1823;5200;1411;4501;405;1389;453;1421;858;2810
412530;201404;805;2424;681;2147;204;687;174;524;378;1211
412535;201404;428;1313;314;1020;81;285;90;248;171;533
412540;201404;1220;3618;952;3040;168;619;346;1090;514;1709
412545;201404;920;2660;767;2334;137;463;272;742;409;1205
412550;201404;24494;74982;17214;58625;4547;16817;3191;10098;7738;26915
412555;201404;314;995;235;791;46;165;44;122;90;287
412560;201404;4503;15056;3784;13539;1126;4499;829;2637;1955;7136
412570;201404;4457;13761;3443;11389;942;3463;706;2219;1648;5682
412575;201404;1057;3353;883;2951;214;792;252;779;466;1571
412580;201404;1488;4137;1094;3440;247;827;334;989;581;1816
412590;201404;508;1559;405;1361;147;523;100;348;247;871
412600;201404;1505;4842;1311;4446;427;1616;395;1232;822;2848
412610;201404;800;2592;652;2240;216;834;161;474;377;1308
412620;201404;1287;4293;1096;3881;393;1517;219;722;612;2239
412625;201404;13909;40041;11727;35929;4196;13877;2388;7185;6584;21062
412627;201404;1013;3193;726;2550;222;834;74;250;296;1084
412630;201404;3531;11406;3148;10582;867;3143;928;3012;1795;6155
412635;201404;550;1687;399;1348;92;320;56;172;148;492
412640;201404;876;2687;624;2092;137;510;114;342;251;852
412650;201404;2300;6644;1909;5905;497;1700;644;1775;1141;3475
412660;201404;3086;9421;2588;8398;650;2407;611;1832;1261;4239
412665;201404;731;1984;462;1497;135;489;128;382;263;871
412667;201404;1475;4468;1196;3913;312;1146;310;933;622;2079
412670;201404;665;2108;470;1642;109;450;74;195;183;645
412680;201404;1512;4992;1250;4359;342;1272;318;990;660;2262
412690;201404;698;2235;569;1945;201;750;90;294;291;1044
412700;201404;1866;6177;1642;5798;604;2388;571;1940;1175;4328
412710;201404;8840;28018;7486;25213;2093;7713;1823;5844;3916;13557
412720;201404;1676;5371;1191;4087;255;939;139;385;394;1324
412730;201404;2835;8656;1993;6830;589;2171;243;730;832;2901
412740;201404;2160;7156;1921;6594;732;2681;266;940;998;3621
412750;201404;3414;11341;3140;10860;569;2287;2041;6852;2610;9139
412760;201404;2329;7864;2229;7686;662;2537;900;2964;1562;5501
412770;201404;12150;36000;8162;27171;1798;6680;1641;4940;3439;11620
412780;201404;1510;5021;1343;4628;394;1446;404;1321;798;2767
412785;201404;2526;7490;1873;6090;581;2077;733;2300;1314;4377
412788;201404;1374;4606;1289;4441;334;1343;500;1561;834;2904
412790;201404;1190;3760;993;3331;214;780;298;920;512;1700
412795;201404;1041;3127;903;2872;298;1020;263;805;561;1825
412796;201404;2629;8513;2451;8148;644;2385;1056;3348;1700;5733
412800;201404;3590;10820;2893;9435;765;2747;832;2549;1597;5296
412810;201404;10386;29645;6483;20892;1649;5787;1389;4028;3038;9815
412820;201404;6459;19989;4890;16845;1404;5287;959;3327;2363;8614
412830;201404;403;1310;342;1182;92;375;81;232;173;607
412840;201404;2219;6426;1845;5681;512;1772;457;1354;969;3126
412850;201404;2559;7892;2255;7447;432;1639;1109;3517;1541;5156
412853;201404;1629;4848;1455;4543;198;807;845;2421;1043;3228
412855;201404;1675;4920;1374;4320;431;1581;348;937;779;2518
412860;201404;1318;4018;1128;3657;286;1059;472;1462;758;2521
412862;201404;833;2322;653;1960;173;579;226;633;399;1212
412863;201404;1227;4223;1179;4137;176;659;806;2820;982;3479
412865;201404;666;2105;493;1671;107;401;175;605;282;1006
412870;201404;1036;3024;885;2785;318;1081;278;871;596;1952
412880;201404;1589;4405;1357;4032;384;1254;316;894;700;2148
420005;201404;514;1583;349;1196;75;287;140;448;215;735
420010;201404;3265;10269;2798;9506;447;1633;1905;6549;2352;8182
420020;201404;762;2568;476;1771;77;326;61;191;138;517
420030;201404;545;1586;322;1144;87;345;54;173;141;518
420040;201404;999;3140;682;2507;217;889;136;425;353;1314
420050;201404;827;2641;666;2264;203;720;246;815;449;1535
420055;201404;322;1045;226;813;54;208;45;145;99;353
420060;201404;379;1352;292;1121;77;325;34;116;111;441
420070;201404;2035;6531;1710;5713;343;1266;681;2368;1024;3634
420075;201404;202;603;117;396;30;119;31;84;61;203
420080;201404;592;2005;523;1856;186;723;96;330;282;1053
420090;201404;691;2471;541;2115;133;543;98;380;231;923
420100;201404;1496;4897;1383;4740;382;1340;795;2784;1177;4124
420110;201404;455;1578;413;1480;125;461;179;654;304;1115
420120;201404;337;1192;283;1075;111;454;51;180;162;634
420125;201404;367;1521;348;1477;133;604;100;389;233;993
420127;201404;600;1879;277;1041;90;360;35;128;125;488
420130;201404;2729;9478;2425;8838;724;2940;853;2858;1577;5798
420140;201404;5161;15345;3661;12450;997;3829;707;2211;1704;6040
420150;201404;797;2421;552;1851;159;581;142;420;301;1001
420160;201404;297;879;193;640;46;180;36;93;82;273
420165;201404;212;702;151;538;27;106;34;122;61;228
420170;201404;241;801;169;650;63;284;19;52;82;336
420180;201404;473;1516;298;1081;77;292;68;230;145;522
420190;201404;582;1865;378;1408;117;467;57;197;174;664
420195;201404;1434;4211;1154;3823;292;1044;542;1860;834;2904
420200;201404;2932;9710;1945;7416;607;2605;306;1010;913;3615
420205;201404;1079;3650;976;3460;306;1174;394;1378;700;2552
420207;201404;1369;4145;994;3352;316;1196;262;789;578;1985
420208;201404;496;1503;342;1201;133;511;92;310;225;821
420209;201404;364;1181;228;832;43;163;55;204;98;367
420210;201404;1785;5930;1251;4837;349;1576;172;586;521;2162
420213;201404;881;3288;841;3201;183;735;541;2064;724;2799
420215;201404;518;1710;387;1356;113;425;66;215;179;640
420220;201404;428;1682;401;1620;168;728;84;295;252;1023
420230;201404;4490;14137;3565;12428;913;3595;1710;5799;2623;9394
420240;201404;12871;39670;8862;31542;1979;8401;3399;10844;5378;19245
420243;201404;589;1845;478;1605;124;485;147;475;271;960
420245;201404;1187;3780;860;3093;226;948;174;533;400;1481
420250;201404;851;2762;796;2672;305;1132;300;1008;605;2140
420253;201404;666;1794;550;1629;130;397;250;827;380;1224
420257;201404;429;1342;329;1148;93;326;143;499;236;825
420260;201404;1363;4618;1229;4361;357;1402;542;1897;899;3299
420270;201404;564;1848;253;941;34;131;30;97;64;228
420280;201404;2412;6893;1606;5438;419;1664;522;1538;941;3202
420285;201404;155;457;62;231;9;38;1;2;10;40
420287;201404;653;2029;569;1870;142;509;224;732;366;1241
420290;201404;6472;19527;4270;14416;1008;3752;1384;4338;2392;8090
420300;201404;5622;17771;3791;13818;937;3859;706;2569;1643;6428
420310;201404;880;2690;842;2627;189;631;513;1557;702;2188
420315;201404;962;3212;775;2819;211;848;289;1048;500;1896
420320;201404;4942;15797;4163;14395;1255;4912;1609;5331;2864;10243
420325;201404;463;1509;450;1478;154;573;135;416;289;989
420330;201404;1298;4598;1029;3847;343;1395;196;616;539;2011
420340;201404;1501;4747;1195;4012;283;1041;315;1001;598;2042
420350;201404;1612;5274;1399;4828;408;1513;577;1990;985;3503
420360;201404;3787;12301;2884;10207;1007;3913;469;1493;1476;5406
420370;201404;2024;5821;1787;5483;240;749;1408;4315;1648;5064
420380;201404;5455;18637;4668;16765;1465;5692;1196;4230;2661;9922
420390;201404;2120;6412;1320;4695;417;1621;272;868;689;2489
420395;201404;2063;6522;1591;5449;381;1467;318;951;699;2418
420400;201404;1510;4573;1142;3854;340;1329;325;1015;665;2344
420410;201404;833;2355;600;1969;161;600;279;894;440;1494
420415;201404;518;1676;415;1412;127;462;132;441;259;903
420417;201404;804;2654;692;2399;152;547;314;1099;466;1646
420419;201404;441;1450;332;1246;156;637;77;284;233;921
420420;201404;15250;47462;12086;40897;3919;14453;3625;12002;7544;26455
420425;201404;1220;3447;769;2484;96;386;311;904;407;1290
420430;201404;4150;13202;2881;10177;854;3332;756;2571;1610;5903
420435;201404;226;763;165;606;66;273;30;100;96;373
420440;201404;1488;4393;925;3200;333;1263;149;455;482;1718
420445;201404;455;1324;353;1142;92;314;161;525;253;839
420450;201404;1292;3870;785;2812;183;753;142;419;325;1172
420455;201404;2279;7142;2049;6741;601;2292;857;2705;1458;4997
420460;201404;9917;31722;8128;28306;2350;9226;2895;9551;5245;18777
420470;201404;1234;3499;838;2736;247;901;225;698;472;1599
420475;201404;182;597;119;437;43;161;25;96;68;257
420480;201404;6093;18386;5098;16662;2044;7490;780;2429;2824;9919
420490;201404;823;2633;622;2239;182;700;151;506;333;1206
420500;201404;2132;6651;1771;5998;528;1952;848;2874;1376;4826
420510;201404;198;835;185;798;70;310;45;175;115;485
420515;201404;162;589;131;515;41;174;21;80;62;254
420517;201404;961;2991;883;2842;146;496;564;1838;710;2334
420519;201404;450;1273;335;1034;64;205;116;364;180;569
420520;201404;782;2272;628;2048;176;629;264;829;440;1458
420530;201404;1392;4869;1139;4230;372;1520;258;831;630;2351
420535;201404;250;779;172;605;51;197;27;81;78;278
420540;201404;18929;58278;14806;49649;5091;18979;4177;13166;9268;32145
420543;201404;497;1370;371;1157;51;175;218;715;269;890
420545;201404;1630;5362;1344;4712;388;1541;389;1261;777;2802
420550;201404;4870;16076;4101;14299;1201;4770;1245;4187;2446;8957
420555;201404;473;1558;398;1393;144;547;108;369;252;916
420560;201404;588;1758;487;1545;96;347;240;757;336;1104
420570;201404;2005;6716;1640;5826;483;1947;477;1586;960;3533
420580;201404;1162;3944;990;3630;296;1186;442;1647;738;2833
420590;201404;3358;10710;2484;8685;631;2429;493;1576;1124;4005
420600;201404;909;3210;833;3029;222;884;338;1242;560;2126
420610;201404;630;2080;449;1660;136;549;71;235;207;784
420620;201404;1211;3854;1079;3610;399;1449;246;789;645;2238
420630;201404;1131;3745;888;3112;258;1001;253;753;511;1754
420640;201404;662;2177;334;1313;83;384;31;120;114;504
420650;201404;2134;6645;1242;4470;236;961;209;606;445;1567
420660;201404;682;2054;559;1823;120;433;275;878;395;1311
420665;201404;820;2396;531;1780;99;371;166;488;265;859
420670;201404;1756;5677;1340;4745;316;1256;219;694;535;1950
420675;201404;245;796;180;636;45;177;74;245;119;422
420680;201404;517;1315;324;1010;62;228;108;317;170;545
420690;201404;812;2864;595;2248;133;548;167;578;300;1126
420700;201404;4949;14962;4032;13079;1148;4176;1152;3561;2300;7737
420710;201404;795;2886;662;2607;249;1056;162;608;411;1664
420720;201404;1991;6212;1724;5845;502;1792;936;3177;1438;4969
420730;201404;4718;14931;4135;13843;1503;5396;1421;4662;2924;10058
420740;201404;782;2609;762;2580;177;648;500;1670;677;2318
420750;201404;2490;8282;1814;6600;401;1674;538;1708;939;3382
420757;201404;119;406;99;373;26;110;29;101;55;211
420760;201404;447;1473;335;1165;75;284;96;317;171;601
420765;201404;644;2200;429;1630;128;530;82;302;210;832
420768;201404;1296;4610;1088;4117;371;1456;357;1399;728;2855
420770;201404;884;2847;599;2182;177;704;148;501;325;1205
420775;201404;706;2293;500;1745;145;520;123;410;268;930
420780;201404;1723;5309;1183;3976;315;1133;320;1002;635;2135
420785;201404;324;1014;228;766;34;133;83;253;117;386
420790;201404;1377;5012;1137;4344;328;1346;423;1549;751;2895
420800;201404;940;2816;582;1983;168;644;123;372;291;1016
420810;201404;2637;9246;2132;8046;719;3054;526;1890;1245;4944
420820;201404;8205;28158;6752;25566;2371;9989;2156;8085;4527;18074
420830;201404;2814;9594;2447;8888;922;3643;822;2875;1744;6518
420840;201404;924;2818;573;2107;156;650;152;517;308;1167
420845;201404;1252;4285;1041;3851;362;1498;184;600;546;2098
420850;201404;2031;6766;1407;5437;476;2016;258;984;734;3000
420860;201404;686;2029;468;1627;185;732;158;525;343;1257
420870;201404;1411;4148;1126;3739;445;1643;312;964;757;2607
420880;201404;1482;5027;1233;4376;316;1167;230;783;546;1950
420890;201404;12954;31304;6116;19399;1186;4438;2217;6246;3403;10684
420895;201404;237;662;116;388;40;144;27;87;67;231
420900;201404;2372;6988;1591;5414;435;1622;372;1197;807;2819
420910;201404;23843;73987;16128;57348;3926;15970;4076;13417;8002;29387
420915;201404;669;2636;614;2490;180;745;259;1099;439;1844
420917;201404;424;1313;243;786;54;208;77;197;131;405
420920;201404;206;608;112;391;50;190;12;37;62;227
420930;201404;20433;63115;17640;58147;5614;20292;5811;18958;11425;39250
420940;201404;4485;13918;3893;12612;1116;4073;1131;3275;2247;7348
420945;201404;242;765;159;555;41;160;40;130;81;290
420950;201404;574;1762;314;1177;74;314;54;187;128;501
420960;201404;1481;4667;1277;4300;421;1593;409;1248;830;2841
420970;201404;2747;8737;2429;8229;692;2559;1203;4159;1895;6718
420980;201404;475;1543;392;1391;128;458;174;674;302;1132
420985;201404;597;1798;361;1291;102;409;98;331;200;740
420990;201404;929;2790;644;2278;160;620;174;577;334;1197
421000;201404;687;2472;494;1960;145;629;56;169;201;798
421003;201404;690;2006;300;1052;60;230;46;135;106;365
421005;201404;267;859;221;776;66;257;101;344;167;601
421010;201404;6991;21843;5433;18704;1773;6618;1517;4915;3290;11533
421020;201404;542;1789;429;1562;87;322;217;844;304;1166
421030;201404;1040;3865;965;3674;347;1406;292;1127;639;2533
421040;201404;947;2880;782;2601;253;915;280;869;533;1784
421050;201404;2007;5444;1205;4053;311;1190;352;1081;663;2271
421055;201404;284;932;191;694;49;190;46;142;95;332
421060;201404;556;2063;461;1794;126;531;105;378;231;909
421070;201404;806;2570;540;1923;134;537;140;502;274;1039
421080;201404;689;2261;623;2116;197;726;257;848;454;1574
421085;201404;554;1540;323;1128;82;316;69;256;151;572
421090;201404;439;1296;326;1036;80;264;138;432;218;696
421100;201404;1062;3311;768;2654;205;773;176;505;381;1278
421105;201404;1469;4794;1275;4433;321;1196;501;1804;822;3000
421110;201404;1644;5459;1432;5099;507;1994;429;1419;936;3413
421120;201404;1631;5431;1255;4473;286;1192;362;1152;648;2344
421125;201404;429;1351;339;1161;108;403;118;379;226;782
421130;201404;3442;11633;2880;10567;1051;4255;916;3357;1967;7612
421140;201404;435;1388;355;1217;104;390;127;407;231;797
421145;201404;584;1938;444;1558;79;317;189;633;268;950
421150;201404;560;1852;435;1612;114;462;176;643;290;1105
421160;201404;890;2778;616;2192;130;519;190;613;320;1132
421165;201404;328;1182;265;984;59;234;106;402;165;636
421170;201404;1872;6134;1602;5410;486;1747;742;2451;1228;4198
421175;201404;1416;4317;1135;3843;354;1389;374;1143;728;2532
421180;201404;555;1632;338;1151;97;369;118;359;215;728
421185;201404;486;1393;362;1154;67;207;180;601;247;808
421187;201404;327;1031;260;893;74;262;97;316;171;578
421189;201404;534;1649;483;1549;135;471;174;547;309;1018
421190;201404;10544;34041;7971;28614;2392;9208;2119;7516;4511;16724
421200;201404;1094;3712;960;3412;278;1076;317;1081;595;2157
421205;201404;247;796;185;656;43;177;41;118;84;295
421210;201404;2141;6730;1817;5922;581;2022;524;1663;1105;3685
421220;201404;2523;8713;2249;8133;751;2967;630;2252;1381;5219
421223;201404;789;2277;501;1776;144;536;229;808;373;1344
421225;201404;1218;3849;1024;3440;296;1077;372;1228;668;2305
421227;201404;974;3280;873;3123;239;856;489;1814;728;2670
421230;201404;748;2568;679;2398;194;752;226;743;420;1495
421240;201404;570;1928;381;1374;91;355;53;160;144;515
421250;201404;1959;6149;1373;5068;490;1984;340;1225;830;3209
421260;201404;304;923;167;642;41;153;34;125;75;278
421265;201404;306;1055;269;952;56;207;59;218;115;425
421270;201404;707;1962;444;1513;152;562;81;301;233;863
421280;201404;1660;5325;1361;4862;460;1873;391;1390;851;3263
421290;201404;2078;5935;1333;4448;416;1471;281;852;697;2323
421300;201404;325;1030;284;945;116;433;98;303;214;736
421310;201404;519;1803;454;1628;150;546;107;379;257;925
421315;201404;383;1153;220;802;48;184;25;88;73;272
421320;201404;555;1909;390;1457;69;284;68;194;137;478
421330;201404;656;2320;574;2145;226;956;68;235;294;1191
421335;201404;576;1922;469;1705;128;515;91;326;219;841
421340;201404;1918;6186;1691;5776;493;1868;786;2637;1279;4505
421350;201404;1109;3830;932;3438;303;1246;242;839;545;2085
421360;201404;3338;10139;2246;7958;528;2147;684;2233;1212;4380
421370;201404;1097;3943;952;3617;317;1335;245;893;562;2228
421380;201404;1052;3103;878;2763;162;559;423;1316;585;1875
421390;201404;201;662;155;540;22;81;42;153;64;234
421400;201404;410;1576;338;1400;131;568;76;289;207;857
421410;201404;369;1166;300;1021;71;249;133;471;204;720
421415;201404;354;1157;208;803;66;272;54;193;120;465
421420;201404;1445;4564;1117;3755;252;900;230;709;482;1609
421430;201404;303;1013;239;884;80;346;44;148;124;494
421440;201404;851;2586;590;2079;171;648;210;697;381;1345
421450;201404;609;2082;451;1701;155;638;86;304;241;942
421460;201404;718;2306;482;1816;117;494;110;379;227;873
421470;201404;532;1982;458;1818;134;566;178;694;312;1260
421480;201404;2964;9426;2081;7627;657;2751;539;1761;1196;4512
421490;201404;315;1093;195;776;78;337;40;152;118;489
421500;201404;2740;9894;2436;9249;996;4205;495;1784;1491;5989
421505;201404;409;1423;374;1333;128;470;123;440;251;910
421507;201404;647;2161;502;1812;118;446;185;661;303;1107
421510;201404;307;1160;280;1106;89;410;112;376;201;786
421520;201404;833;2251;550;1670;54;204;294;810;348;1014
421530;201404;516;1743;332;1311;96;445;105;389;201;834
421535;201404;718;2256;450;1666;103;408;204;742;307;1150
421540;201404;425;1265;367;1154;94;320;138;406;232;726
421545;201404;1240;4381;1030;3940;320;1371;208;752;528;2123
421550;201404;2262;7772;2046;7359;741;2900;585;2038;1326;4938
421555;201404;306;972;146;525;32;125;34;115;66;240
421560;201404;201;612;99;352;21;83;22;73;43;156
421565;201404;1101;3526;1007;3364;444;1590;307;988;751;2578
421567;201404;953;3596;828;3260;392;1590;155;603;547;2193
421568;201404;492;1644;389;1416;110;414;121;443;231;857
421569;201404;206;682;124;478;24;105;28;104;52;209
421570;201404;1126;3829;818;3051;281;1138;192;686;473;1824
421575;201404;613;2101;548;1967;115;434;289;1050;404;1484
421580;201404;4293;14473;3485;12630;1302;5260;767;2471;2069;7731
421590;201404;262;842;212;735;47;173;96;315;143;488
421600;201404;568;1728;429;1432;123;454;101;323;224;777
421605;201404;695;2199;500;1798;123;512;123;408;246;920
421610;201404;1867;4924;1477;4366;205;651;928;2749;1133;3400
421620;201404;5058;15830;3731;13024;1290;4886;1137;3964;2427;8850
421625;201404;400;1313;248;913;67;276;74;257;141;533
421630;201404;2784;8495;1785;6219;473;1789;366;1196;839;2985
421635;201404;317;1088;260;985;74;302;95;331;169;633
421640;201404;1122;3660;999;3454;216;758;602;2143;818;2901
421650;201404;2367;8065;2066;7363;790;3089;312;1021;1102;4110
421660;201404;9378;32030;7734;28777;2598;10691;2214;7744;4812;18435
421670;201404;1205;3986;918;3323;259;1024;258;935;517;1959
421680;201404;1510;5008;1337;4588;517;1911;228;715;745;2626
421690;201404;2095;7016;1647;5913;446;1711;263;881;709;2592
421700;201404;720;2282;483;1757;161;648;127;381;288;1029
421710;201404;348;1257;274;1046;107;414;70;258;177;672
421715;201404;320;925;198;672;54;195;56;189;110;384
421720;201404;1861;5794;1400;4903;551;2178;375;1158;926;3336
421725;201404;131;469;126;458;38;148;53;188;91;336
421730;201404;629;1967;349;1287;82;334;80;239;162;573
421740;201404;746;2374;554;1916;160;655;127;346;287;1001
421750;201404;1484;4539;1159;3852;332;1210;410;1237;742;2447
421755;201404;472;1515;344;1187;102;394;96;296;198;690
421760;201404;537;1808;326;1224;88;363;128;461;216;824
421770;201404;3773;11643;3103;10272;1268;4395;732;2481;2000;6876
421775;201404;587;1759;391;1388;85;316;118;418;203;734
421780;201404;1789;6265;1435;5442;560;2298;377;1333;937;3631
421790;201404;1035;2979;657;2324;194;793;154;476;348;1269
421795;201404;410;1273;285;956;43;151;87;291;130;442
421800;201404;2707;8966;2148;7838;594;2415;697;2315;1291;4730
421810;201404;670;2197;504;1800;139;545;82;276;221;821
421820;201404;1157;3777;935;3301;215;920;283;886;498;1806
421825;201404;1396;4810;1288;4544;233;924;700;2387;933;3311
421830;201404;3177;11006;2978;10601;777;2890;1463;5388;2240;8278
421835;201404;187;600;147;530;53;224;59;185;112;409
421840;201404;517;1863;464;1728;182;743;155;543;337;1286
421850;201404;586;1726;435;1458;149;528;125;428;274;956
421860;201404;387;1277;264;1005;61;252;60;226;121;478
421870;201404;5291;15937;3853;12902;1151;4154;676;2191;1827;6345
421875;201404;418;1282;216;806;54;226;49;162;103;388
421880;201404;1124;3739;909;3215;267;1077;222;715;489;1792
421885;201404;365;1275;324;1181;85;319;127;462;212;781
421890;201404;1094;3799;950;3489;319;1285;271;961;590;2246
421895;201404;438;1502;408;1443;116;423;203;740;319;1163
421900;201404;903;2968;753;2600;208;775;256;800;464;1575
421910;201404;544;1780;395;1419;102;411;99;313;201;724
421915;201404;627;1940;489;1621;105;380;157;478;262;858
421917;201404;596;1887;475;1663;150;624;166;527;316;1151
421920;201404;782;2467;635;2254;300;1151;180;590;480;1741
421930;201404;4101;11752;2860;9473;858;3171;455;1458;1313;4629
421935;201404;903;3210;728;2803;207;872;244;911;451;1783
421940;201404;347;1268;244;982;85;374;50;174;135;548
421950;201404;4442;12840;2570;8892;769;2846;508;1762;1277;4608
421960;201404;265;870;214;751;56;215;57;193;113;408
421970;201404;2155;6687;1656;5554;577;2125;316;917;893;3042
421985;201404;476;1344;286;961;42;175;89;305;131;480
422000;201404;327;955;261;836;53;195;136;436;189;631
430003;201404;923;2711;737;2387;204;731;220;693;424;1424
430005;201404;303;1034;267;952;62;240;140;473;202;713
430010;201404;2204;6403;1719;5464;564;1891;589;1911;1153;3802
430020;201404;1119;3043;989;2848;236;782;541;1473;777;2255
430030;201404;1537;4294;1350;3939;387;1199;532;1480;919;2679
430040;201404;13073;34323;11188;31375;3530;10360;4245;12046;7775;22406
430045;201404;753;2098;607;1810;111;366;345;1007;456;1373
430047;201404;212;610;160;503;37;120;74;230;111;350
430050;201404;1113;3138;747;2418;155;594;296;897;451;1491
430055;201404;293;868;198;634;42;149;92;290;134;439
430057;201404;80;214;37;127;7;29;11;25;18;54
430060;201404;15587;51602;13949;48641;4329;15786;6376;22746;10705;38532
430063;201404;1103;3328;901;2885;257;867;393;1290;650;2157
430064;201404;1721;5155;1447;4694;416;1379;623;2098;1039;3477
430066;201404;173;446;129;377;32;108;66;178;98;286
430070;201404;596;1899;428;1497;110;416;117;369;227;785
430080;201404;629;2083;506;1800;130;518;133;432;263;950
430085;201404;696;1996;513;1669;156;563;193;604;349;1167
430087;201404;1011;3105;964;3017;104;348;758;2356;862;2704
430090;201404;800;2178;307;1015;42;152;70;233;112;385
430100;201404;1067;3378;834;2903;281;1078;188;542;469;1620
430105;201404;787;2567;635;2259;206;803;145;493;351;1296
430107;201404;264;893;208;725;46;173;73;238;119;411
430110;201404;2280;6745;2090;6422;699;2315;869;2631;1568;4946
430120;201404;1805;5593;1463;4851;316;1111;838;2741;1154;3852
430130;201404;4617;11915;4195;11331;751;2159;2562;6986;3313;9145
430140;201404;1230;4016;965;3381;303;1096;313;1075;616;2171
430150;201404;950;2582;653;2025;148;502;191;581;339;1083
430155;201404;512;1632;392;1355;105;358;157;551;262;909
430160;201404;18826;55991;17579;53916;3920;13320;9644;30125;13564;43445
430163;201404;1927;5889;1669;5403;396;1451;770;2503;1166;3954
430165;201404;297;1041;249;941;109;429;46;165;155;594
430170;201404;803;2361;401;1404;83;307;78;232;161;539
430175;201404;969;3109;790;2707;172;532;391;1450;563;1982
430180;201404;1145;3159;981;2885;246;801;438;1273;684;2074
430185;201404;773;1942;403;1214;59;192;126;329;185;521
430187;201404;749;2352;652;2160;195;751;221;691;416;1442
430190;201404;2314;6941;2064;6502;514;1879;979;3052;1493;4931
430192;201404;196;616;103;332;15;52;34;103;49;155
430195;201404;259;802;80;299;13;50;12;33;25;83
430200;201404;1848;6008;1579;5472;506;1900;320;1088;826;2988
430205;201404;524;1570;419;1383;50;198;277;906;327;1104
430210;201404;6552;18901;3754;12790;970;3556;682;2155;1652;5711
430215;201404;341;1013;261;847;60;210;111;347;171;557
430220;201404;681;1803;340;1134;64;244;56;174;120;418
430222;201404;323;1001;253;849;64;246;98;307;162;553
430223;201404;343;1042;307;987;61;201;198;649;259;850
430225;201404;60;176;36;117;6;14;7;20;13;34
430230;201404;2168;6891;2044;6761;336;1031;1565;5369;1901;6400
430235;201404;277;936;223;796;66;258;57;192;123;450
430237;201404;422;1187;353;1066;51;185;225;651;276;836
430240;201404;1139;3435;898;2955;309;1148;250;735;559;1883
430245;201404;876;2955;729;2615;210;792;296;1087;506;1879
430250;201404;1618;4528;1472;4268;590;1811;446;1310;1036;3121
430258;201404;210;596;146;466;20;64;68;221;88;285
430260;201404;855;2434;575;1846;68;250;324;1044;392;1294
430265;201404;326;1047;270;910;78;271;29;75;107;346
430270;201404;3571;10228;3229;9645;828;2815;1586;4636;2414;7451
430280;201404;5405;15572;4672;14192;1400;4582;1911;5714;3311;10296
430290;201404;2504;6983;2384;6854;319;927;1935;5665;2254;6592
430300;201404;10142;31386;8669;28542;3326;11553;3113;10519;6439;22072
430310;201404;8784;28035;7852;26187;2576;9292;3073;9941;5649;19233
430320;201404;833;2531;603;2049;82;249;307;1107;389;1356
430330;201404;1007;2804;859;2523;257;807;323;862;580;1669
430340;201404;770;1980;453;1527;104;393;214;708;318;1101
430350;201404;6327;20399;5452;18462;2109;7513;1741;5788;3850;13301
430355;201404;245;666;160;509;30;110;39;106;69;216
430360;201404;1169;3118;1011;2833;175;554;562;1551;737;2105
430367;201404;351;982;239;773;37;136;72;217;109;353
430370;201404;638;1889;510;1629;161;560;132;378;293;938
430380;201404;875;2282;488;1572;135;454;163;543;298;997
430390;201404;4449;13294;3398;11015;833;2948;961;2944;1794;5892
430400;201404;1353;3278;954;2698;268;871;439;1157;707;2028
430410;201404;707;1940;555;1690;96;331;280;847;376;1178
430420;201404;4679;13793;3819;11825;1179;3756;1435;4449;2614;8205
430430;201404;825;2292;536;1734;165;581;134;408;299;989
430435;201404;2056;5667;1716;5044;389;1195;900;2672;1289;3867
430440;201404;4830;15133;3990;13432;800;2961;1797;6286;2597;9247
430450;201404;9164;26620;7450;23072;2746;9052;2117;6471;4863;15523
430460;201404;26853;82889;22207;74316;7094;25520;7409;24777;14503;50297
430461;201404;484;1360;173;561;39;134;37;115;76;249
430462;201404;343;1027;291;939;114;404;100;312;214;716
430463;201404;3978;13258;3557;12388;943;3600;1672;5819;2615;9419
430465;201404;658;1823;561;1656;121;405;356;1035;477;1440
430466;201404;4409;13152;4167;12715;1239;4109;1982;6012;3221;10121
430467;201404;604;1854;532;1736;130;467;261;827;391;1294
430468;201404;1494;4410;1305;4111;537;1861;287;864;824;2725
430469;201404;175;480;55;201;7;26;14;54;21;80
430470;201404;7547;20375;5634;17185;1834;6078;1494;4483;3328;10561
430471;201404;919;3115;826;2912;291;1082;191;669;482;1751
430480;201404;875;2458;498;1641;80;293;105;303;185;596
430485;201404;245;772;138;504;24;84;48;189;72;273
430490;201404;540;1608;381;1303;111;399;128;445;239;844
430495;201404;431;1307;304;1029;71;267;75;244;146;511
430500;201404;1669;4703;1423;4279;421;1402;638;1881;1059;3283
430510;201404;27730;86775;21560;72009;7279;26697;5616;17707;12895;44404
430511;201404;476;1462;253;864;59;192;37;113;96;305
430512;201404;1357;3594;1203;3337;338;987;443;1276;781;2263
430513;201404;698;1971;497;1546;77;245;230;721;307;966
430515;201404;619;1849;493;1580;101;344;204;670;305;1014
430517;201404;1438;4804;1275;4441;257;966;773;2655;1030;3621
430520;201404;1806;5351;1437;4561;471;1608;510;1550;981;3158
430530;201404;918;2608;521;1680;102;385;135;383;237;768
430535;201404;2460;8025;2116;7254;550;2096;673;2249;1223;4345
430537;201404;632;1840;448;1532;50;161;340;1194;390;1355
430540;201404;764;1873;580;1630;134;417;317;859;451;1276
430543;201404;607;1609;546;1547;132;410;346;993;478;1403
430544;201404;733;2462;637;2213;151;571;311;1040;462;1611
430545;201404;1435;4682;1255;4453;468;1595;583;2295;1051;3890
430550;201404;631;1984;497;1681;118;445;191;632;309;1077
430558;201404;122;369;83;282;34;133;11;25;45;158
430560;201404;397;1017;251;752;49;189;105;292;154;481
430570;201404;1223;3212;876;2578;212;728;421;1121;633;1849
430580;201404;1086;3151;762;2501;263;912;192;648;455;1560
430583;201404;149;412;53;178;11;44;4;10;15;54
430585;201404;366;999;244;740;81;276;96;265;177;541
430587;201404;299;938;257;850;108;374;69;227;177;601
430590;201404;1543;4417;1468;4299;362;1179;820;2364;1182;3543
430593;201404;37;145;35;137;13;58;9;28;22;86
430595;201404;174;541;106;387;34;131;12;33;46;164
430597;201404;392;1238;317;1064;56;215;127;408;183;623
430600;201404;2141;5983;1371;4269;308;1015;472;1434;780;2449
430605;201404;1360;4329;1113;3788;279;1044;437;1511;716;2555
430607;201404;708;1967;617;1807;129;420;354;1014;483;1434
430610;201404;8438;22971;6701;20182;1667;5552;2828;8539;4495;14091
430613;201404;253;640;135;407;33;101;37;94;70;195
430620;201404;988;3076;823;2686;229;834;306;925;535;1759
430630;201404;472;1425;299;993;84;282;57;173;141;455
430632;201404;741;2093;490;1567;90;340;249;733;339;1073
430635;201404;701;1943;499;1550;110;348;224;692;334;1040
430637;201404;549;1581;500;1484;89;323;317;885;406;1208
430640;201404;1958;5656;1062;3547;223;793;201;551;424;1344
430642;201404;484;1299;334;1049;66;234;161;502;227;736
430645;201404;190;576;111;388;23;92;27;87;50;179
430650;201404;2100;7076;1849;6510;401;1454;1011;3681;1412;5135
430655;201404;311;945;276;866;66;233;98;255;164;488
430660;201404;6135;18365;4962;16183;1525;5457;1913;6178;3438;11635
430670;201404;500;1478;454;1387;44;133;339;1070;383;1203
430673;201404;788;1942;447;1366;130;402;164;498;294;900
430675;201404;197;614;128;443;26;106;49;159;75;265
430676;201404;4661;14289;4226;13555;1317;4575;1699;5601;3016;10176
430680;201404;1217;3647;908;2967;198;726;340;1031;538;1757
430690;201404;4567;13413;3830;11977;1204;3937;1384;4459;2588;8396
430692;201404;283;989;214;837;32;124;126;509;158;633
430693;201404;1783;5106;1376;4184;308;1015;378;1110;686;2125
430695;201404;510;1489;425;1320;97;346;202;581;299;927
430697;201404;465;1347;364;1173;114;362;135;476;249;838
430700;201404;11093;29550;5743;18805;1071;3930;689;2040;1760;5970
430705;201404;414;1318;386;1269;135;482;146;477;281;959
430710;201404;1883;4966;1499;4328;314;1000;732;2180;1046;3180
430720;201404;922;2326;611;1866;175;576;229;735;404;1311
430730;201404;1913;5234;1521;4600;351;1069;796;2545;1147;3614
430740;201404;614;1806;393;1326;117;422;54;153;171;575
430745;201404;544;1593;379;1223;74;245;119;382;193;627
430750;201404;1821;5308;1591;4873;383;1301;783;2293;1166;3594
430755;201404;665;1892;479;1484;111;406;203;550;314;956
430760;201404;3707;9532;2936;8587;645;2081;1566;4760;2211;6841
430770;201404;7006;21225;5952;19394;1443;5199;2810;9011;4253;14210
430780;201404;2587;7445;1788;5825;485;1712;641;1974;1126;3686
430781;201404;662;2001;494;1656;139;493;169;549;308;1042
430783;201404;577;1520;452;1298;85;270;200;532;285;802
430786;201404;126;436;102;367;35;133;14;48;49;181
430790;201404;3951;11160;2700;8563;558;2065;1150;3393;1708;5458
430800;201404;827;2538;621;2038;162;559;202;632;364;1191
430805;201404;481;1400;363;1177;44;157;223;741;267;898
430807;201404;343;1060;278;913;64;250;89;262;153;512
430810;201404;691;1964;369;1261;63;250;66;205;129;455
430820;201404;1124;3657;873;3017;240;883;249;814;489;1697
430825;201404;463;1315;249;789;44;149;75;212;119;361
430830;201404;2735;8100;2542;7800;386;1217;1640;5333;2026;6550
430840;201404;1010;3183;921;2989;237;765;407;1388;644;2153
430843;201404;100;328;75;247;15;48;30;93;45;141
430845;201404;413;1241;344;1111;122;423;49;149;171;572
430850;201404;3391;10465;3029;9791;925;3178;1182;3816;2107;6994
430860;201404;750;2444;581;2049;182;766;137;416;319;1182
430865;201404;737;2043;677;1937;226;668;304;870;530;1538
430870;201404;655;1910;429;1457;139;484;122;398;261;882
430880;201404;1405;4162;1155;3656;454;1552;276;892;730;2444
430885;201404;181;579;155;535;50;190;47;151;97;341
430890;201404;1650;4483;1315;3876;69;237;825;2412;894;2649
430900;201404;3354;9087;3125;8773;599;1756;2022;5744;2621;7500
430905;201404;1108;3341;798;2640;266;964;188;582;454;1546
430910;201404;1870;6079;1582;5479;582;2162;563;1870;1145;4032
430912;201404;598;1681;468;1466;77;269;253;774;330;1043
430915;201404;406;1438;302;1214;88;378;76;323;164;701
430920;201404;18385;58765;16956;56073;5777;19938;8787;28940;14564;48878
430925;201404;91;268;74;234;22;79;36;111;58;190
430930;201404;9594;30432;7921;26970;2413;8722;2883;10180;5296;18902
430940;201404;1144;3624;929;3201;223;872;273;890;496;1762
430950;201404;1624;4638;1261;3855;370;1197;348;1028;718;2225
430955;201404;108;358;85;298;27;103;22;69;49;172
430957;201404;326;1104;269;976;67;255;114;416;181;671
430960;201404;1807;5261;1568;4841;593;1954;474;1486;1067;3440
430965;201404;1415;4297;1223;3937;166;614;880;2796;1046;3410
430970;201404;545;1586;344;1146;81;296;94;305;175;601
430975;201404;649;2142;502;1775;90;345;261;915;351;1260
430980;201404;564;1395;350;1077;96;340;128;335;224;675
430990;201404;670;2190;517;1793;170;613;115;387;285;1000
430995;201404;737;2209;659;2057;234;742;233;731;467;1473
431000;201404;1749;4799;1018;3272;229;847;135;357;364;1204
431010;201404;2879;8656;2020;6873;523;1966;610;1926;1133;3892
431020;201404;14709;37159;10424;29307;2859;8453;3161;9163;6020;17616
431030;201404;405;1240;240;843;59;219;53;190;112;409
431033;201404;2887;8510;2650;8152;655;2148;1408;4523;2063;6671
431036;201404;223;642;102;344;20;72;29;87;49;159
431040;201404;1052;3090;885;2799;238;827;443;1369;681;2196
431041;201404;594;1671;535;1584;194;612;180;562;374;1174
431043;201404;415;1383;322;1169;156;619;98;313;254;932
431046;201404;120;367;88;289;23;80;31;99;54;179
431050;201404;1876;4808;1568;4320;369;1096;860;2353;1229;3449
431053;201404;638;2133;546;1939;176;690;172;592;348;1282
431055;201404;706;2008;653;1915;82;254;456;1348;538;1602
431057;201404;338;983;208;732;57;216;81;280;138;496
431060;201404;6348;18866;6015;18449;1566;4608;3647;11767;5213;16375
431065;201404;460;1401;436;1360;53;181;288;897;341;1078
431070;201404;772;2277;481;1616;107;367;111;334;218;701
431075;201404;290;884;194;674;34;130;61;217;95;347
431080;201404;712;2314;593;2060;164;612;110;358;274;970
431085;201404;954;2557;771;2253;139;429;442;1288;581;1717
431087;201404;631;1823;561;1690;83;237;357;1092;440;1329
431090;201404;555;1445;314;981;101;328;59;170;160;498
431100;201404;4816;13559;4078;12244;1169;3722;1588;4913;2757;8635
431110;201404;1647;4472;1254;3671;318;1018;592;1681;910;2699
431112;201404;665;2110;638;2066;228;740;285;948;513;1688
431113;201404;672;2023;511;1654;167;548;129;423;296;971
431115;201404;1519;4589;1385;4346;320;1076;786;2430;1106;3506
431120;201404;2758;8992;2470;8412;758;2865;988;3246;1746;6111
431123;201404;536;1698;450;1525;118;412;216;756;334;1168
431125;201404;1424;4436;1114;3773;345;1208;393;1417;738;2625
431127;201404;124;351;66;217;9;32;8;28;17;60
431130;201404;3978;11641;3285;10442;947;3303;1313;4177;2260;7480
431140;201404;4061;10701;2385;7807;484;1859;628;1785;1112;3644
431142;201404;555;1701;508;1611;71;248;312;1010;383;1258
431150;201404;1357;4162;1105;3666;307;1046;381;1290;688;2336
431160;201404;981;2959;846;2672;169;535;414;1398;583;1933
431162;201404;455;1243;238;803;36;143;33;94;69;237
431164;201404;131;363;40;151;14;48;1;4;15;52
431170;201404;973;2879;764;2452;236;793;208;659;444;1452
431171;201404;899;2728;789;2498;264;882;171;503;435;1385
431173;201404;493;1498;457;1434;107;345;267;852;374;1197
431175;201404;1325;3705;1155;3450;399;1271;445;1317;844;2588
431177;201404;996;3336;900;3116;307;1164;360;1229;667;2393
431179;201404;140;366;83;256;20;71;23;57;43;128
431180;201404;2755;8336;2202;7078;592;2076;637;1910;1229;3986
431190;201404;779;2179;468;1552;134;495;140;456;274;951
431198;201404;381;1270;333;1170;151;582;66;215;217;797
431200;201404;322;939;126;428;23;83;14;46;37;129
431205;201404;321;1069;236;827;56;208;88;288;144;496
431210;201404;798;2273;690;2057;182;552;353;1059;535;1611
431213;201404;318;1002;267;901;74;275;91;292;165;567
431215;201404;344;1025;179;607;28;96;21;56;49;152
431217;201404;248;760;195;641;65;229;47;163;112;392
431220;201404;1216;3165;893;2548;122;416;462;1250;584;1666
431225;201404;1399;4195;1223;3893;288;991;650;2079;938;3070
431230;201404;954;2884;750;2463;115;430;402;1329;517;1759
431235;201404;76;183;36;110;12;41;9;24;21;65
431237;201404;456;1498;402;1421;124;503;175;590;299;1093
431238;201404;54;174;45;151;9;35;14;45;23;80
431240;201404;2792;8644;2389;7946;853;3030;676;2221;1529;5251
431242;201404;431;1407;408;1362;160;601;37;111;197;712
431244;201404;470;1153;341;959;73;249;154;393;227;642
431245;201404;1078;3013;940;2789;175;551;605;1792;780;2343
431247;201404;222;704;184;629;73;264;61;200;134;464
431250;201404;1911;6131;1715;5831;566;2099;640;2231;1206;4330
431260;201404;401;1178;281;938;69;260;64;192;133;452
431261;201404;224;802;192;729;43;184;54;205;97;389
431262;201404;363;1024;160;554;25;122;62;203;87;325
431265;201404;1378;3756;837;2594;195;682;238;618;433;1300
431267;201404;205;630;171;564;49;174;69;212;118;386
431270;201404;2465;6984;2122;6455;664;2176;1005;3082;1669;5258
431275;201404;220;731;147;527;41;134;26;83;67;217
431280;201404;200;621;117;402;22;85;26;71;48;156
431290;201404;359;1181;282;976;78;312;63;199;141;511
431295;201404;223;719;132;453;25;100;29;83;54;183
431300;201404;223;683;96;370;32;131;7;24;39;155
431301;201404;249;820;180;640;40;152;39;124;79;276
431303;201404;748;2032;537;1612;138;480;187;525;325;1005
431306;201404;2174;6185;1720;5328;320;1170;585;1620;905;2790
431308;201404;58;203;54;192;39;143;11;36;50;179
431310;201404;771;2474;568;2015;106;406;210;763;316;1169
431320;201404;918;2702;584;2024;175;679;130;411;305;1090
431330;201404;2312;5998;1204;3873;359;1263;183;565;542;1828
431333;201404;384;1051;205;629;39;130;64;170;103;300
431335;201404;101;298;85;262;19;59;28;76;47;135
431337;201404;2684;8327;2114;7060;590;2049;529;1750;1119;3799
431339;201404;638;1854;498;1533;110;364;222;677;332;1041
431340;201404;28166;76249;20877;63728;5169;17548;7386;21952;12555;39500
431342;201404;648;1717;548;1546;155;460;280;761;435;1221
431344;201404;374;1062;298;926;25;79;185;587;210;666
431346;201404;306;832;193;572;55;169;52;152;107;321
431349;201404;635;1853;473;1469;103;320;147;454;250;774
431350;201404;4015;12209;3581;11424;675;2479;2029;6262;2704;8741
431360;201404;819;2232;625;1914;175;572;228;699;403;1271
431365;201404;1383;4285;1211;3999;470;1697;424;1382;894;3079
431370;201404;5635;16410;4770;14943;1391;4703;1904;6044;3295;10747
431380;201404;1141;3475;1077;3339;186;622;732;2226;918;2848
431390;201404;3767;10861;2636;8643;828;3011;711;2174;1539;5185
431395;201404;1625;4921;1462;4655;405;1377;561;1801;966;3178
431400;201404;201;665;134;516;37;156;12;29;49;185
431402;201404;1231;3153;805;2368;152;482;381;1076;533;1558
431403;201404;328;983;250;841;85;319;52;172;137;491
431405;201404;4693;13541;3771;12138;877;3282;1753;5400;2630;8682
431406;201404;815;2592;641;2165;212;740;233;770;445;1510
431407;201404;644;1990;478;1601;158;555;103;315;261;870
431410;201404;17113;53523;13914;47179;5300;19340;3149;11087;8449;30427
431413;201404;211;530;103;330;10;35;45;143;55;178
431415;201404;949;2737;782;2420;193;648;354;1051;547;1699
431417;201404;696;1802;560;1595;96;295;296;869;392;1164
431420;201404;1630;4577;1446;4276;364;1149;757;2295;1121;3444
431430;201404;605;1682;457;1431;112;388;160;460;272;848
431440;201404;33307;98471;29890;92795;10138;33009;12511;40462;22649;73471
431442;201404;210;679;169;578;54;204;19;45;73;249
431445;201404;510;1425;350;1068;58;182;132;387;190;569
431446;201404;511;1514;379;1233;99;340;155;497;254;837
431447;201404;860;2459;618;1915;109;364;281;889;390;1253
431449;201404;936;2685;767;2397;131;444;389;1243;520;1687
431450;201404;2313;6155;2128;5866;549;1596;1262;3451;1811;5047
431455;201404;657;1718;417;1208;121;369;116;305;237;674
431460;201404;3717;10607;3220;9638;930;2906;1143;3490;2073;6396
431470;201404;2168;6435;1793;5596;494;1536;743;2457;1237;3993
431475;201404;158;471;60;238;11;48;5;23;16;71
431477;201404;640;1845;514;1594;106;362;275;826;381;1188
431478;201404;200;532;95;284;19;57;36;106;55;163
431480;201404;2817;8343;2248;7282;744;2622;672;2110;1416;4732
431490;201404;112707;322654;99670;303022;17826;62127;64033;190611;81859;252738
431500;201404;1196;3148;967;2717;279;791;332;942;611;1733
431505;201404;378;1073;352;1035;33;89;284;849;317;938
431507;201404;461;1139;371;971;82;210;219;584;301;794
431510;201404;2255;6286;1882;5623;382;1230;939;2723;1321;3953
431513;201404;226;637;117;381;29;98;54;177;83;275
431514;201404;113;290;43;138;8;29;3;6;11;35
431515;201404;770;2333;565;1815;132;471;241;698;373;1169
431517;201404;94;310;87;293;39;140;22;67;61;207
431520;201404;495;1498;316;1053;57;213;78;256;135;469
431530;201404;4717;11640;3692;10453;1098;3192;1846;5560;2944;8752
431531;201404;296;856;208;678;51;185;79;262;130;447
431532;201404;569;1630;507;1500;181;584;153;440;334;1024
431535;201404;392;1167;281;881;63;218;75;213;138;431
431540;201404;2279;7363;2048;7029;298;966;1325;4887;1623;5853
431545;201404;148;439;65;232;5;20;13;53;18;73
431550;201404;2498;7612;2302;7250;537;1921;1102;3401;1639;5322
431555;201404;790;2102;699;1969;173;494;353;1005;526;1499
431560;201404;24583;77475;21145;70404;8694;29577;6117;21401;14811;50978
431570;201404;5780;16682;5243;15867;1663;5148;2731;8403;4394;13551
431575;201404;492;1336;356;1103;54;199;121;352;175;551
431580;201404;747;2377;617;2070;160;611;213;644;373;1255
431590;201404;1020;2881;714;2261;100;333;354;1120;454;1453
431595;201404;644;1835;528;1577;132;422;176;528;308;950
431600;201404;2301;6925;1754;5771;458;1703;348;970;806;2673
431610;201404;1727;4936;1282;4104;317;1094;586;1863;903;2957
431620;201404;408;1300;258;850;91;326;91;265;182;591
431630;201404;1465;4029;1118;3307;284;877;533;1598;817;2475
431640;201404;6206;18648;5661;17772;1545;5370;2922;8981;4467;14351
431642;201404;528;1587;464;1455;73;276;251;753;324;1029
431643;201404;227;611;194;551;43;144;104;265;147;409
431645;201404;1837;5593;1683;5319;397;1274;922;3000;1319;4274
431647;201404;179;512;128;393;41;127;25;60;66;187
431650;201404;252;802;180;650;40;162;38;110;78;272
431660;201404;1509;4604;1177;3884;389;1333;394;1246;783;2579
431670;201404;1414;3977;1148;3490;312;1068;470;1359;782;2427
431673;201404;242;718;156;529;42;151;37;121;79;272
431675;201404;319;1069;237;817;57;204;62;184;119;388
431680;201404;10766;30211;8324;25942;2565;8574;2724;8596;5289;17170
431690;201404;26307;76534;21660;69152;6823;23423;7952;25760;14775;49183
431695;201404;152;518;113;417;24;89;27;75;51;164
431697;201404;528;1506;471;1399;129;383;199;619;328;1002
431700;201404;1692;4806;1454;4350;290;943;745;2176;1035;3119
431710;201404;13353;39641;11114;35743;3351;11368;4078;13657;7429;25025
431720;201404;7342;20986;6117;18668;1397;4839;3024;9010;4421;13849
431725;201404;35;124;33;120;20;77;5;18;25;95
431730;201404;3890;12133;3215;10828;973;3658;1062;3602;2035;7260
431740;201404;6074;18121;5429;16865;1967;6604;1469;4343;3436;10947
431750;201404;10738;30911;9251;28482;2003;6645;4736;14914;6739;21559
431755;201404;277;732;83;290;17;66;13;37;30;103
431760;201404;4140;12700;3478;11424;982;3482;1008;3200;1990;6682
431770;201404;2394;6609;2036;6037;536;1686;992;2906;1528;4592
431775;201404;257;736;200;628;81;261;47;130;128;391
431780;201404;2392;6476;1836;5440;503;1617;512;1425;1015;3042
431790;201404;1216;3872;1088;3648;276;994;556;1847;832;2841
431795;201404;491;1472;391;1237;78;265;184;579;262;844
431800;201404;9835;29426;8321;26582;2782;9749;2306;7172;5088;16921
431805;201404;309;752;87;293;13;55;18;58;31;113
431810;201404;3713;10428;3093;9139;690;2208;1406;4120;2096;6328
431820;201404;2890;9211;2574;8596;752;2752;922;3010;1674;5762
431830;201404;11520;30411;9572;27390;3313;10347;3361;9599;6674;19946
431840;201404;3645;10994;3228;10196;1009;3312;1362;4388;2371;7700
431842;201404;762;1984;442;1355;93;305;132;386;225;691
431843;201404;362;1067;328;1007;75;254;181;542;256;796
431844;201404;169;510;131;438;36;140;40;125;76;265
431845;201404;552;1684;505;1583;64;199;331;1059;395;1258
431846;201404;546;1646;470;1509;86;313;268;862;354;1175
431848;201404;203;560;110;373;20;83;22;69;42;152
431849;201404;379;948;122;381;25;86;33;87;58;173
431850;201404;5051;15033;4536;14052;1094;3700;2203;6685;3297;10385
431860;201404;982;2794;804;2503;191;668;397;1177;588;1845
431861;201404;99;307;62;214;12;40;7;20;19;60
431862;201404;499;1706;421;1541;153;612;100;342;253;954
431870;201404;26843;76666;22578;69024;6265;21115;9130;27010;15395;48125
431880;201404;4880;15588;4105;13808;1232;4565;1570;5075;2802;9640
431890;201404;6143;17520;5220;15863;1986;6415;1516;4701;3502;11116
431900;201404;997;3072;799;2687;230;881;308;926;538;1807
431910;201404;948;2298;486;1416;103;338;182;486;285;824
431912;201404;624;1839;499;1582;161;483;159;535;320;1018
431915;201404;1422;3931;1077;3302;300;973;369;1149;669;2122
431920;201404;1565;4454;1442;4286;202;572;1083;3313;1285;3885
431930;201404;1365;3791;1056;3290;160;486;614;2049;774;2535
431935;201404;113;430;104;409;41;176;24;74;65;250
431936;201404;486;1415;441;1331;79;242;275;894;354;1136
431937;201404;354;968;208;650;44;152;41;116;85;268
431940;201404;2842;7903;1931;6111;520;1746;503;1567;1023;3313
431950;201404;1971;6330;1767;5955;500;1822;665;2148;1165;3970
431960;201404;3765;11284;3457;10689;1055;3479;1154;3586;2209;7065
431970;201404;527;1463;286;939;43;163;83;259;126;422
431971;201404;135;406;114;378;31;104;48;157;79;261
431973;201404;482;1720;427;1605;71;271;244;986;315;1257
431975;201404;16;63;12;52;2;12;4;14;6;26
431980;201404;1582;4635;1404;4264;368;1306;532;1471;900;2777
431990;201404;8963;25224;7146;22289;1474;5314;2925;8702;4399;14016
432000;201404;11406;33769;9399;30190;3098;10443;3689;11904;6787;22347
432010;201404;2561;7672;2234;7047;523;1889;1045;3174;1568;5063
432020;201404;2330;6062;1972;5583;318;968;1273;3577;1591;4545
432023;201404;541;1597;417;1316;104;372;158;466;262;838
432026;201404;1239;3907;1044;3464;228;773;500;1677;728;2450
432030;201404;424;1271;357;1122;103;339;132;392;235;731
432032;201404;560;1498;384;1167;75;262;204;591;279;853
432035;201404;865;2807;791;2653;197;702;439;1458;636;2160
432040;201404;787;2318;559;1849;131;465;124;319;255;784
432045;201404;206;700;177;640;52;198;66;246;118;444
432050;201404;805;2355;726;2205;145;470;405;1257;550;1727
432055;201404;855;2668;732;2419;161;593;425;1351;586;1944
432057;201404;470;1250;377;1070;37;134;242;634;279;768
432060;201404;474;1349;211;734;56;215;46;143;102;358
432065;201404;250;733;193;627;44;166;85;249;129;415
432067;201404;1018;3353;776;2766;202;753;348;1231;550;1984
432070;201404;2646;7212;1984;5910;632;2138;606;1685;1238;3823
432080;201404;4365;12843;3842;11883;1239;4081;1461;4436;2700;8517
432085;201404;265;846;226;777;81;322;65;204;146;526
432090;201404;1809;5648;1545;5082;593;2105;441;1279;1034;3384
432100;201404;1251;3757;718;2499;173;630;124;369;297;999
432110;201404;3146;9560;2548;8322;818;2965;451;1407;1269;4372
432120;201404;5487;16759;4749;15385;1777;6171;1358;4376;3135;10547
432130;201404;2451;7233;2133;6804;584;2029;1156;3724;1740;5753
432132;201404;426;1338;264;935;45;160;94;298;139;458
432135;201404;800;2427;760;2357;138;447;498;1550;636;1997
432140;201404;2967;8788;2425;7787;682;2312;899;3159;1581;5471
432143;201404;1410;4327;1225;4015;304;1024;654;2211;958;3235
432145;201404;1142;3642;788;2806;250;971;148;458;398;1429
432146;201404;281;894;204;702;69;247;49;164;118;411
432147;201404;845;2689;682;2332;197;698;263;923;460;1621
432149;201404;424;1268;304;978;91;308;94;293;185;601
432150;201404;3901;11485;3056;9846;981;3459;902;2777;1883;6236
432160;201404;4700;15393;4227;14593;1465;5366;1575;5670;3040;11036
432162;201404;344;852;98;318;23;84;22;58;45;142
432163;201404;367;977;105;337;19;61;19;65;38;126
432166;201404;827;2487;680;2178;139;519;315;925;454;1444
432170;201404;876;2954;640;2419;138;563;125;444;263;1007
432180;201404;2908;7800;2095;6436;588;1966;599;1768;1187;3734
432183;201404;410;1382;379;1315;165;601;78;263;243;864
432185;201404;887;2572;603;1973;118;429;227;724;345;1153
432190;201404;3615;10152;2700;8105;723;2301;795;2242;1518;4543
432195;201404;1312;3776;1178;3562;213;697;723;2165;936;2862
432200;201404;3251;10144;2690;9155;819;2997;1127;3935;1946;6932
432210;201404;446;1330;387;1241;107;398;183;539;290;937
432215;201404;909;2865;812;2699;161;508;484;1703;645;2211
432218;201404;318;896;243;747;41;133;107;306;148;439
432220;201404;4042;10966;3374;9877;448;1545;2172;6231;2620;7776
432225;201404;67;227;56;206;29;110;12;45;41;155
432230;201404;1213;3422;894;2742;273;926;341;930;614;1856
432232;201404;584;1734;461;1497;111;402;220;703;331;1105
432234;201404;551;1550;421;1226;97;289;173;481;270;770
432235;201404;76;237;46;164;14;63;7;23;21;86
432237;201404;510;1428;462;1353;39;150;358;1008;397;1158
432240;201404;16011;53408;14026;50724;3312;13246;8116;29913;11428;43159
432250;201404;5674;20008;5365;19366;2337;9169;1364;4949;3701;14118
432252;201404;485;1454;408;1301;130;441;175;568;305;1009
432253;201404;1296;4315;987;3506;323;1202;294;1053;617;2255
432254;201404;619;1691;213;702;40;143;30;88;70;231
432255;201404;217;546;120;393;36;127;35;110;71;237
432260;201404;7355;19063;5308;15648;1367;4239;2270;6777;3637;11016
432270;201404;2798;8721;2464;8142;733;2504;1108;3729;1841;6233
432280;201404;1311;3841;826;2784;166;620;199;582;365;1202
432285;201404;145;465;70;237;20;74;13;34;33;108
432290;201404;606;1860;415;1401;93;349;149;468;242;817
432300;201404;24190;74870;22167;71369;5983;20548;11242;36116;17225;56664
432310;201404;1011;3155;876;2905;197;733;436;1402;633;2135
432320;201404;284;804;182;594;51;166;57;193;108;359
432330;201404;245;723;106;375;14;44;11;35;25;79
432335;201404;207;609;91;322;24;92;8;23;32;115
432340;201404;313;823;163;507;41;136;44;130;85;266
432345;201404;781;2241;723;2149;160;574;381;1044;541;1618
432350;201404;471;1340;325;1062;80;273;80;245;160;518
432360;201404;48;156;37;133;15;56;10;32;25;88
432370;201404;490;1405;398;1224;36;103;267;848;303;951
432375;201404;894;2304;720;2018;134;394;419;1193;553;1587
432377;201404;82;282;41;136;6;19;13;31;19;50
432380;201404;884;3169;823;3037;358;1466;260;885;618;2351
500020;201404;2227;7194;1737;6173;496;1955;523;1720;1019;3675
500025;201404;1034;2633;671;1995;131;407;296;861;427;1268
500060;201404;6407;18895;5245;17084;739;2400;3518;11969;4257;14369
500070;201404;4118;12391;3524;11364;813;2994;1619;5118;2432;8112
500080;201404;1814;5421;1368;4610;461;1700;380;1330;841;3030
500085;201404;2159;5873;1630;5063;210;717;971;2921;1181;3638
500090;201404;2390;7154;1870;6204;417;1440;925;3168;1342;4608
500100;201404;2580;7925;2402;7638;810;2932;1047;3157;1857;6089
500110;201404;8243;24512;6837;22381;1132;4129;3903;13376;5035;17505
500124;201404;1909;6227;1653;5793;289;969;956;3646;1245;4615
500150;201404;1409;3783;1151;3373;293;977;543;1501;836;2478
500190;201404;5009;13430;3980;12162;918;3079;2086;6598;3004;9677
500200;201404;2635;6795;1953;5815;385;1340;1071;3078;1456;4418
500210;201404;4959;15002;4292;13959;1044;3635;2041;6828;3085;10463
500215;201404;1597;5069;1334;4554;286;1128;538;1717;824;2845
500220;201404;2805;8941;2315;8013;569;2149;834;2953;1403;5102
500230;201404;2637;7051;2075;6205;693;2302;758;2236;1451;4538
500240;201404;4968;15458;3742;13007;715;2786;1587;5752;2302;8538
500260;201404;2533;6971;2072;6217;420;1394;994;2801;1414;4195
500270;201404;109598;290537;75274;231821;21256;71596;18187;55972;39443;127568
500280;201404;1369;4013;1172;3737;213;711;728;2388;941;3099
500290;201404;4010;10358;2638;8037;778;2748;761;2054;1539;4802
500295;201404;2521;7867;1857;6212;421;1637;497;1450;918;3087
500310;201404;842;2258;734;2099;175;559;355;971;530;1530
500315;201404;2986;9553;2590;8978;565;1908;1541;5672;2106;7580
500320;201404;13883;46894;12253;43937;4095;15642;4324;16422;8419;32064
500325;201404;4288;11440;3271;9799;910;3019;1427;4113;2337;7132
500330;201404;5844;16384;4642;14120;1469;4835;1730;5163;3199;9998
500345;201404;2477;7305;2093;6669;522;1858;1008;3103;1530;4961
500348;201404;2541;7437;2281;7013;274;960;1653;5053;1927;6013
500350;201404;1239;3818;805;2830;135;500;226;807;361;1307
500370;201404;23739;74749;18890;65336;4856;18785;6482;22426;11338;41211
500375;201404;2781;7672;2052;6339;483;1601;842;2671;1325;4272
500380;201404;2975;8713;2542;7901;840;2819;741;2218;1581;5037
500390;201404;604;1324;403;1039;55;172;275;673;330;845
500400;201404;1342;4281;1086;3664;320;1199;291;884;611;2083
500410;201404;2155;6136;1759;5546;462;1604;766;2427;1228;4031
500430;201404;2717;8181;2227;7459;568;2059;949;3303;1517;5362
500440;201404;1353;3986;1153;3662;281;1020;590;1804;871;2824
500450;201404;2183;6885;1749;6005;445;1738;344;1048;789;2786
500460;201404;3671;11307;2987;10227;843;3175;1015;3457;1858;6632
500470;201404;3111;9377;2323;7636;628;2261;378;1138;1006;3399
500480;201404;2023;6576;1876;6355;196;676;1467;5117;1663;5793
500490;201404;1083;3112;910;2819;289;1011;285;886;574;1897
500500;201404;3597;11203;2915;10188;1080;4300;874;2999;1954;7299
500510;201404;880;2401;607;1934;126;477;242;695;368;1172
500515;201404;1934;5241;1561;4734;272;799;954;3119;1226;3918
500520;201404;2851;10034;2549;9610;592;2383;1482;5791;2074;8174
500525;201404;1205;3905;1033;3569;233;878;511;1852;744;2730
500540;201404;5358;15827;3504;12108;1040;4088;696;2212;1736;6300
500560;201404;4778;16017;4317;15341;902;3384;2788;10068;3690;13452
500568;201404;3953;10471;2985;9034;706;2295;1414;4341;2120;6636
500570;201404;7607;21339;5553;17729;1680;5778;1958;6281;3638;12059
500580;201404;3540;10471;2838;9224;466;1649;1751;5710;2217;7359
500600;201404;3166;8945;2393;7600;651;2285;878;2747;1529;5032
500620;201404;7928;22379;5887;18899;1304;4768;2889;9211;4193;13979
500625;201404;689;2090;467;1613;105;410;148;479;253;889
500627;201404;415;1195;315;999;65;225;76;258;141;483
500630;201404;6233;17684;5030;15926;1684;5939;1495;4680;3179;10619
500635;201404;2415;9476;2116;9017;302;1237;1343;6228;1645;7465
500640;201404;1533;3904;1228;3462;151;493;843;2314;994;2807
500660;201404;16494;49969;13553;44873;3228;12129;5844;19145;9072;31274
500690;201404;3053;8808;2503;8124;852;2899;973;3376;1825;6275
500710;201404;3628;11267;3284;10707;829;2904;1660;5412;2489;8316
500720;201404;5820;16096;3910;12581;1104;3942;1066;3327;2170;7269
500730;201404;975;2847;773;2430;172;607;291;867;463;1474
500740;201404;3728;10559;2749;8778;596;2193;1189;3568;1785;5761
500750;201404;838;2491;763;2396;187;631;427;1379;614;2010
500755;201404;1277;3819;974;3238;241;887;332;1011;573;1898
500769;201404;4750;12945;3207;9839;692;2354;950;2619;1642;4973
500770;201404;1731;5239;1371;4534;390;1413;442;1471;832;2884
500780;201404;1109;3483;971;3211;285;1038;407;1286;692;2324
500790;201404;8804;25205;7432;22800;1478;5334;3944;11487;5422;16821
500793;201404;2367;6946;1901;6170;333;1206;902;2820;1235;4026
500795;201404;2381;7182;2147;6847;285;777;1572;5374;1857;6151
500797;201404;933;2593;720;2246;150;511;312;976;462;1487
500800;201404;2536;7373;2083;6717;719;2624;766;2476;1485;5100
500830;201404;16301;48337;12177;39879;3448;12366;3418;10822;6866;23188
500840;201404;1404;4116;1076;3470;213;741;464;1479;677;2220
510010;201404;1296;4112;1200;3928;421;1434;479;1635;900;3069
510020;201404;2913;8615;2117;7084;608;2144;550;1771;1158;3915
510025;201404;9173;28004;8037;26052;2445;8846;3177;9947;5622;18793
510030;201404;2129;5856;1808;5368;582;1826;750;2204;1332;4030
510035;201404;900;2705;763;2489;160;535;413;1406;573;1941
510040;201404;1715;4846;1370;4327;294;1053;685;2139;979;3192
510050;201404;1861;5496;1388;4623;383;1432;495;1609;878;3041
510060;201404;1281;3845;1009;3321;261;929;331;1066;592;1995
510080;201404;1317;4109;1102;3740;323;1283;331;988;654;2271
510100;201404;661;1816;449;1384;90;301;154;448;244;749
510120;201404;295;619;191;499;19;44;142;374;161;418
510125;201404;3098;8342;2453;7219;487;1748;1114;3063;1601;4811
510130;201404;2118;5931;1814;5448;574;1816;708;2167;1282;3983
510140;201404;2931;9697;2459;8957;916;3577;661;2360;1577;5937
510160;201404;1302;4418;1240;4344;92;366;1071;3754;1163;4120
510170;201404;6010;18763;5112;17104;1226;4591;2339;7606;3565;12197
510180;201404;11118;30877;8426;26506;2673;8955;2872;9864;5545;18819
510185;201404;1217;3999;1127;3860;234;772;738;2682;972;3454
510190;201404;1728;5850;1384;5263;342;1444;564;2225;906;3669
510250;201404;13701;43889;11937;41423;3790;14073;5351;19052;9141;33125
510260;201404;2560;9779;2335;9288;702;3000;971;4064;1673;7064
510263;201404;4204;11881;3216;10208;919;3194;1045;3182;1964;6376
510267;201404;5330;15605;3909;12539;924;3282;1276;3915;2200;7197
510268;201404;863;2552;743;2380;193;682;370;1190;563;1872
510269;201404;827;2674;756;2568;225;798;335;1171;560;1969
510270;201404;2510;7939;2269;7537;378;1289;1349;4663;1727;5952
510279;201404;2058;6644;1887;6359;668;2536;632;1941;1300;4477
510285;201404;1491;4617;1261;4199;361;1315;424;1347;785;2662
510300;201404;3213;9860;2832;9320;382;1413;2075;6845;2457;8258
510305;201404;1627;5246;1345;4705;361;1386;400;1406;761;2792
510310;201404;1109;3232;877;2850;305;1094;256;804;561;1898
510320;201404;3620;10792;2839;9219;807;3071;546;1517;1353;4588
510325;201404;5454;17680;4780;16716;653;2266;3588;13004;4241;15270
510330;201404;2716;9108;2366;8459;627;2484;900;3285;1527;5769
510335;201404;4408;14170;3936;13531;688;2372;2759;9900;3447;12272
510336;201404;559;1729;481;1590;112;405;218;711;330;1116
510337;201404;2276;7683;1992;7130;820;3025;525;2075;1345;5100
510340;201404;62555;186045;50351;167386;19880;72703;10330;35959;30210;108662
510343;201404;1138;3437;1043;3323;125;376;833;2741;958;3117
510345;201404;1671;5012;1424;4572;363;1278;467;1402;830;2680
510350;201404;3491;10202;2884;9361;829;2916;1295;4284;2124;7200
510360;201404;1856;4953;1363;4338;276;961;853;2653;1129;3614
510370;201404;911;3340;817;3181;226;910;419;1702;645;2612
510380;201404;480;1565;384;1372;134;529;61;197;195;726
510385;201404;927;3513;763;3085;136;606;338;1463;474;2069
510390;201404;1168;3639;1078;3537;289;854;616;2227;905;3081
510395;201404;869;2258;663;1992;122;398;366;1172;488;1570
510410;201404;4128;13742;3885;13299;1110;4078;1883;6502;2993;10580
510420;201404;2305;6127;1773;5228;280;971;928;2714;1208;3685
510450;201404;589;1667;451;1471;134;492;151;479;285;971
510452;201404;630;2067;460;1662;121;502;148;482;269;984
510454;201404;824;2632;731;2500;157;565;424;1513;581;2078
510455;201404;1017;3141;789;2708;192;783;275;888;467;1671
510460;201404;2073;5958;1807;5585;344;1228;1151;3443;1495;4671
510480;201404;4283;11802;3255;9849;812;2641;965;2822;1777;5463
510490;201404;1483;4917;1334;4693;333;1299;750;2579;1083;3878
510500;201404;1411;4351;1056;3679;285;1140;457;1523;742;2663
510510;201404;3079;10979;2735;10386;1070;4318;907;3450;1977;7768
510515;201404;5734;18072;4702;15909;1153;4364;1294;4174;2447;8538
510517;201404;1787;5426;1576;5103;482;1542;856;2941;1338;4483
510520;201404;2200;5688;1695;4985;135;478;1225;3584;1360;4062
510523;201404;1083;3312;927;3051;242;856;494;1615;736;2471
510525;201404;7963;20651;5284;16445;1276;4317;1866;5724;3142;10041
510530;201404;561;1617;491;1516;82;300;279;860;361;1160
510550;201404;2721;9094;2363;8463;670;2521;985;3634;1655;6155
510558;201404;2093;6149;1668;5515;503;1817;680;2225;1183;4042
510560;201404;1654;5463;1204;4647;411;1684;269;1080;680;2764
510562;201404;5208;16057;4561;14790;1567;5588;1448;4717;3015;10305
510590;201404;2818;8166;2263;7442;660;2391;954;3187;1614;5578
510600;201404;1486;3860;1016;3108;176;599;459;1315;635;1914
510610;201404;2802;8381;2515;7994;283;1037;1947;6154;2230;7191
510615;201404;2162;7097;1933;6707;661;2480;807;2763;1468;5243
510617;201404;562;1745;493;1640;73;258;359;1222;432;1480
510618;201404;1351;4032;991;3314;244;932;440;1441;684;2373
510619;201404;781;2186;514;1690;98;359;143;471;241;830
510620;201404;1228;3343;820;2725;273;1043;177;533;450;1576
510621;201404;1053;3724;934;3464;272;1105;307;1086;579;2191
510622;201404;3657;11298;2471;8614;581;2277;385;1123;966;3400
510623;201404;3737;10874;3124;9847;1010;3390;1171;3653;2181;7043
510624;201404;1235;3858;976;3372;221;878;410;1326;631;2204
510625;201404;2319;6911;1890;6141;544;1999;470;1422;1014;3421
510626;201404;1298;4091;1045;3696;343;1338;473;1674;816;3012
510627;201404;712;2161;564;1892;200;737;161;542;361;1279
510628;201404;1579;4084;1210;3575;174;585;819;2409;993;2994
510629;201404;1878;6208;1605;5606;522;2024;430;1404;952;3428
510630;201404;2613;8817;2201;8082;684;2852;528;1942;1212;4794
510631;201404;401;1173;360;1109;78;242;226;696;304;938
510637;201404;2717;8255;2441;7765;737;2590;1109;3427;1846;6017
510642;201404;4777;15734;4100;14829;1336;5142;1843;6942;3179;12084
510645;201404;739;1875;588;1687;219;648;184;578;403;1226
510650;201404;6041;20612;5602;20074;1363;5167;3364;12638;4727;17805
510665;201404;1248;3469;872;2809;217;778;303;940;520;1718
510670;201404;348;862;212;660;42;157;87;254;129;411
510675;201404;6431;21223;5451;19325;1803;7063;1396;4789;3199;11852
510677;201404;2558;6587;1919;5751;282;882;1329;4149;1611;5031
510680;201404;803;2531;688;2330;142;522;295;939;437;1461
510682;201404;2432;7666;1961;6805;498;1886;677;2374;1175;4260
510685;201404;972;2659;829;2480;103;364;592;1758;695;2122
510700;201404;4127;11284;3042;9620;684;2351;1621;5164;2305;7515
510704;201404;8235;23515;6872;21200;1776;6177;3257;9701;5033;15878
510706;201404;1761;5538;1392;4938;417;1550;613;2184;1030;3734
510710;201404;3670;10471;2862;8848;815;2838;888;2438;1703;5276
510715;201404;705;1852;486;1496;117;397;175;502;292;899
510718;201404;1735;5261;1528;4989;549;1848;687;2309;1236;4157
510719;201404;459;1052;278;817;34;138;125;335;159;473
510720;201404;1280;3055;953;2670;88;266;733;2084;821;2350
510724;201404;825;2547;695;2298;168;606;336;1062;504;1668
510726;201404;665;1805;547;1606;156;477;180;499;336;976
510729;201404;719;1940;567;1713;159;522;228;687;387;1209
510730;201404;2321;7343;2072;6895;539;2058;1036;3261;1575;5319
510735;201404;1063;3709;900;3434;311;1272;375;1436;686;2708
510740;201404;1007;2607;823;2348;192;535;467;1384;659;1919
510757;201404;687;2392;618;2257;184;709;283;1030;467;1739
510760;201404;28786;81715;22830;71555;8057;27215;7164;22413;15221;49628
510770;201404;4496;12109;4065;11608;636;1829;2556;8234;3192;10063
510774;201404;390;1146;326;1043;81;304;159;475;240;779
510775;201404;850;2413;677;2138;239;865;230;718;469;1583
510776;201404;442;1258;368;1128;84;291;173;516;257;807
510777;201404;1483;4543;1164;4145;253;1028;723;2539;976;3567
510779;201404;645;1953;492;1674;81;292;191;675;272;967
510780;201404;3971;11823;3422;11041;786;2714;1807;6047;2593;8761
510785;201404;1912;5770;1579;5215;543;1902;540;1822;1083;3724
510787;201404;2221;6871;1931;6398;626;2255;683;2200;1309;4455
510788;201404;360;1126;328;1076;165;540;91;301;256;841
510790;201404;15348;45384;10679;36512;2920;11568;1335;4355;4255;15923
510792;201404;6215;20332;4623;17027;1122;4794;838;2837;1960;7631
510794;201404;1371;4285;1095;3853;486;1803;220;700;706;2503
510795;201404;9469;30550;7414;26404;2335;9021;1781;6395;4116;15416
510800;201404;1836;5339;1556;4977;453;1613;703;2126;1156;3739
510805;201404;1912;5425;1593;4972;234;805;1132;3530;1366;4335
510810;201404;696;1710;547;1509;164;476;259;704;423;1180
510820;201404;836;2092;649;1814;158;526;245;609;403;1135
510830;201404;571;1981;513;1882;169;672;238;918;407;1590
510835;201404;716;2234;556;1924;193;733;190;600;383;1333
510840;201404;51212;130189;41557;118043;10603;32104;20988;61719;31591;93823
510850;201404;1689;5022;1368;4519;564;2096;214;559;778;2655
510860;201404;2465;8388;2028;7427;701;2812;326;1122;1027;3934
510880;201404;830;2822;730;2644;252;956;270;992;522;1948
510885;201404;577;1664;444;1469;92;356;198;652;290;1008
510890;201404;897;3058;780;2842;262;1078;192;608;454;1686
510895;201404;1150;3717;1025;3487;297;1131;397;1265;694;2396
520005;201404;1280;4203;1194;4073;379;1357;543;1886;922;3243
520010;201404;1890;6588;1680;6144;724;2977;291;915;1015;3892
520013;201404;4000;11274;3054;9596;750;2500;1319;4178;2069;6678
520015;201404;580;1615;473;1454;133;424;182;577;315;1001
520017;201404;1247;3891;1084;3624;310;1115;421;1369;731;2484
520020;201404;427;1153;332;1001;92;291;163;517;255;808
520025;201404;23572;76752;22933;75977;3395;11878;17893;59546;21288;71424
520030;201404;4688;15295;4149;14419;1332;4997;1590;5617;2922;10614
520050;201404;340;1031;314;977;65;229;203;607;268;836
520055;201404;668;2052;574;1891;150;490;287;977;437;1467
520060;201404;1671;5270;1477;4890;332;1236;575;1953;907;3189
520080;201404;1665;5215;1460;4905;382;1315;735;2564;1117;3879
520082;201404;672;2194;625;2113;155;508;354;1258;509;1766
520085;201404;1034;3265;903;2966;210;746;324;1063;534;1809
520090;201404;958;2353;766;2092;146;384;403;1182;549;1566
520110;201404;40910;123887;32367;111024;12959;49139;7703;26773;20662;75912
520120;201404;262;693;156;504;39;155;34;107;73;262
520130;201404;3748;11128;3469;10705;704;2347;2110;6517;2814;8864
520140;201404;43367;145567;39043;137079;13971;53265;10264;35543;24235;88808
520145;201404;540;1398;399;1197;99;327;152;434;251;761
520150;201404;679;1833;562;1698;154;503;269;808;423;1311
520160;201404;891;2640;755;2431;257;880;262;853;519;1733
520170;201404;4133;10047;3338;9191;569;1700;2357;6628;2926;8328
520180;201404;1903;5799;1607;5300;448;1655;612;1941;1060;3596
520215;201404;1807;4758;1565;4415;275;827;947;2698;1222;3525
520235;201404;832;2275;652;2015;203;688;261;778;464;1466
520250;201404;1100;3736;1028;3615;348;1303;463;1657;811;2960
520260;201404;772;2044;560;1651;93;312;261;737;354;1049
520280;201404;579;1703;531;1632;252;850;116;391;368;1241
520310;201404;1051;2656;833;2370;213;639;414;1280;627;1919
520320;201404;1611;5208;1335;4664;194;725;800;2872;994;3597
520330;201404;2865;9031;2224;7881;665;2561;431;1431;1096;3992
520340;201404;1943;4971;1548;4504;245;661;1155;3496;1400;4157
520350;201404;3135;9451;2704;8605;964;3297;1085;3347;2049;6644
520355;201404;1128;3987;1093;3910;448;1684;404;1430;852;3114
520357;201404;894;2454;764;2265;66;217;530;1560;596;1777
520360;201404;616;1742;547;1628;131;385;254;783;385;1168
520380;201404;1187;3272;876;2721;176;611;426;1340;602;1951
520390;201404;1210;3237;857;2753;275;1016;321;939;596;1955
520393;201404;574;1521;516;1426;92;268;330;918;422;1186
520396;201404;704;2301;655;2218;104;398;436;1494;540;1892
520400;201404;1725;4952;1472;4608;275;941;903;2855;1178;3796
520410;201404;1549;4196;1233;3762;358;1198;575;1728;933;2926
520420;201404;345;961;263;816;50;182;109;307;159;489
520425;201404;1443;4062;1345;3885;435;1346;622;1765;1057;3111
520430;201404;2046;5504;1464;4438;307;1058;590;1725;897;2783
520440;201404;3347;9031;2519;7701;893;3015;619;1879;1512;4894
520450;201404;9742;28466;7527;24265;2026;7291;1289;3793;3315;11084
520455;201404;702;2119;579;1913;223;794;149;500;372;1294
520460;201404;884;2580;719;2295;179;648;294;897;473;1545
520465;201404;836;2309;733;2175;170;626;341;926;511;1552
520470;201404;1756;5764;1604;5540;393;1373;976;3524;1369;4897
520480;201404;1019;2969;844;2697;193;652;468;1519;661;2171
520485;201404;1204;4123;1118;3965;414;1565;492;1755;906;3320
520490;201404;4396;13725;3534;12395;1449;5496;1157;4076;2606;9572
520495;201404;1402;3837;1154;3535;90;274;969;3029;1059;3303
520500;201404;2057;5543;1841;5250;633;1939;738;2257;1371;4196
520505;201404;897;2572;778;2394;214;691;433;1355;647;2046
520510;201404;11393;32315;7777;26221;2367;8842;1831;6164;4198;15006
520520;201404;1056;3084;888;2855;331;1134;329;1077;660;2211
520530;201404;2385;7456;2049;6908;485;1657;972;3644;1457;5301
520540;201404;3025;9284;2627;8597;855;2967;997;3257;1852;6224
520545;201404;1321;4110;1138;3744;325;1130;321;1018;646;2148
520547;201404;825;2624;685;2380;247;940;184;594;431;1534
520549;201404;8833;27302;7702;25892;2405;8548;3573;12151;5978;20699
520551;201404;3801;11633;3643;11442;1167;3885;1937;6281;3104;10166
520552;201404;723;2376;701;2346;126;459;457;1521;583;1980
520570;201404;579;1703;438;1469;192;688;79;260;271;948
520580;201404;2008;5903;1681;5420;543;1953;576;1773;1119;3726
520590;201404;1534;4359;1274;3930;340;1098;455;1336;795;2434
520620;201404;7269;23650;6655;22735;1531;5642;3885;13377;5416;19019
520630;201404;642;1842;555;1737;163;508;285;907;448;1415
520640;201404;2766;8136;2419;7587;802;2662;943;3101;1745;5763
520650;201404;826;2387;713;2177;272;873;262;799;534;1672
520660;201404;399;1219;339;1123;107;385;98;324;205;709
520670;201404;815;2484;783;2434;73;189;672;2138;745;2327
520680;201404;620;1849;533;1727;179;633;194;622;373;1255
520690;201404;319;845;232;728;34;110;112;370;146;480
520710;201404;487;1235;325;926;12;39;201;562;213;601
520725;201404;1838;4836;1438;4253;347;1144;729;2127;1076;3271
520735;201404;689;2083;561;1855;187;674;162;510;349;1184
520740;201404;1707;5001;1441;4632;393;1338;678;2170;1071;3508
520750;201404;767;2017;580;1759;155;516;301;932;456;1448
520753;201404;1263;3658;1197;3563;193;542;850;2660;1043;3202
520760;201404;1139;3205;1004;3031;320;1049;530;1590;850;2639
520780;201404;2075;5149;1743;4702;217;560;1309;3636;1526;4196
520790;201404;2544;7245;2268;6858;384;1232;1562;4806;1946;6038
520800;201404;17564;52260;15692;50029;3665;11498;9217;31793;12882;43291
520810;201404;966;2668;864;2541;155;476;614;1877;769;2353
520815;201404;437;1490;348;1313;166;705;33;111;199;816
520830;201404;1702;4362;1334;3977;59;156;1206;3681;1265;3837
520840;201404;1664;5675;1514;5381;523;1976;506;1842;1029;3818
520850;201404;779;2331;615;2088;183;644;240;806;423;1450
520860;201404;7114;20427;5336;17997;1528;5575;2379;8241;3907;13816
520870;201404;125238;354590;90927;293313;29268;102839;24286;77176;53554;180015
520880;201404;7248;20956;5269;17810;1502;5734;743;2320;2245;8054
520890;201404;3796;11216;3340;10482;770;2586;1691;5300;2461;7886
520910;201404;3447;10660;2726;9173;827;3096;619;1999;1446;5095
520915;201404;929;2688;702;2247;168;571;270;826;438;1397
520920;201404;3367;9030;2342;7374;614;2102;639;2067;1253;4169
520929;201404;451;1324;404;1269;132;426;195;613;327;1039
520940;201404;978;3004;879;2848;123;460;623;1981;746;2441
520945;201404;666;1669;573;1527;195;512;237;637;432;1149
520960;201404;894;2647;741;2407;130;463;406;1320;536;1783
520970;201404;3416;10106;2816;9031;662;2384;1058;3295;1720;5679
520980;201404;1013;2788;935;2686;263;846;563;1579;826;2425
520990;201404;3677;11562;3370;11001;689;2496;1747;6251;2436;8747
520993;201404;1167;3261;961;2903;141;465;578;1729;719;2194
520995;201404;2625;7272;2361;6917;386;1180;1660;4886;2046;6066
521000;201404;7897;24001;6768;22111;1624;5897;3186;10314;4810;16211
521010;201404;3946;12333;3392;11288;888;3209;1330;4445;2218;7654
521015;201404;682;1948;582;1786;140;433;291;911;431;1344
521020;201404;4463;13265;3490;11211;1159;4026;659;1871;1818;5897
521030;201404;808;2179;707;2037;152;458;443;1294;595;1752
521040;201404;5492;16332;5042;15633;2038;6430;2209;7197;4247;13627
521056;201404;989;3060;841;2812;299;1054;324;1127;623;2181
521060;201404;1130;3209;997;3003;240;724;412;1253;652;1977
521080;201404;1221;3067;801;2363;163;570;262;635;425;1205
521090;201404;3244;9545;2764;8893;1012;3489;911;3007;1923;6496
521100;201404;1428;3741;1310;3608;274;729;871;2496;1145;3225
521120;201404;4761;13922;4361;13283;1150;3521;2209;6908;3359;10429
521130;201404;1112;3171;905;2798;214;767;445;1369;659;2136
521140;201404;923;3102;838;2912;285;1052;201;680;486;1732
521150;201404;13147;34739;8812;26326;2818;9394;2753;8014;5571;17408
521160;201404;742;1922;499;1425;91;289;269;722;360;1011
521170;201404;1343;3273;1130;2989;369;952;569;1513;938;2465
521180;201404;6488;22086;5945;20997;2096;7981;1639;5736;3735;13717
521190;201404;8781;26338;6594;22492;2235;8089;1953;6728;4188;14817
521200;201404;849;2270;789;2185;121;370;548;1504;669;1874
521205;201404;567;1723;462;1531;73;261;251;847;324;1108
521210;201404;897;2619;654;2134;234;884;224;640;458;1524
521220;201404;3815;10923;3209;10083;1098;3740;1186;3657;2284;7397
521225;201404;393;1009;314;909;52;155;202;606;254;761
521230;201404;1358;4311;1255;4096;497;1730;512;1597;1009;3327
521250;201404;25904;87291;24625;85318;9725;36392;9596;33572;19321;69964
521260;201404;826;2044;660;1755;115;390;373;922;488;1312
521270;201404;1806;5730;1664;5503;170;485;1268;4431;1438;4916
521280;201404;1840;5744;1571;5253;504;1827;562;1863;1066;3690
521290;201404;542;1573;400;1337;124;494;139;430;263;924
521295;201404;1126;3134;1039;3018;149;454;807;2356;956;2810
521300;201404;1837;5393;1703;5179;384;1190;984;3104;1368;4294
521305;201404;848;2269;717;2090;187;551;404;1215;591;1766
521308;201404;5112;15280;4072;13495;867;3185;2079;6793;2946;9978
521310;201404;7380;22839;5981;20148;2049;7306;1378;4452;3427;11758
521340;201404;260;811;233;766;55;205;118;370;173;575
521350;201404;2190;5701;1810;5190;249;769;1164;3540;1413;4309
521370;201404;1020;3302;929;3133;346;1247;270;857;616;2104
521375;201404;1382;4067;1201;3763;326;1130;571;1723;897;2853
521377;201404;1009;2938;964;2884;86;237;822;2517;908;2754
521380;201404;4722;13458;3365;10872;779;2659;675;2241;1454;4900
521385;201404;609;1723;545;1636;170;545;241;718;411;1263
521390;201404;1109;2930;827;2538;244;855;263;789;507;1644
521400;201404;2363;6448;2029;6059;332;1108;1463;4325;1795;5433
521405;201404;1334;3914;1123;3526;396;1376;402;1240;798;2616
521410;201404;781;2507;716;2395;306;1015;264;928;570;1943
521440;201404;1489;4156;1473;4139;139;355;1264;3650;1403;4005
521450;201404;5003;15338;4227;13924;1332;4673;1061;3386;2393;8059
521460;201404;7120;22344;6573;21497;1950;6959;3092;10018;5042;16977
521470;201404;725;2054;544;1703;142;494;77;220;219;714
521480;201404;517;1518;381;1270;116;389;102;338;218;727
521483;201404;3067;8266;2561;7398;710;2193;1008;2852;1718;5045
521486;201404;1651;4621;1489;4325;360;1158;918;2575;1278;3733
521487;201404;555;1566;442;1374;102;315;198;633;300;948
521490;201404;836;2441;673;2212;105;396;454;1505;559;1901
521500;201404;1327;4328;1156;3977;226;883;603;1931;829;2814
521520;201404;914;2176;815;2049;235;557;344;971;579;1528
521523;201404;11363;42756;10710;41603;3593;15322;2466;10087;6059;25409
521525;201404;1126;2933;993;2756;138;432;667;1799;805;2231
521530;201404;2059;6175;1429;4894;536;1929;241;780;777;2709
521540;201404;979;2711;690;2185;177;660;205;584;382;1244
521550;201404;990;2534;890;2389;260;751;461;1206;721;1957
521560;201404;4966;15291;4006;14011;1627;6208;1080;3657;2707;9865
521565;201404;696;1837;596;1712;112;319;396;1165;508;1484
521570;201404;4714;13343;3390;10673;1099;3696;976;3068;2075;6764
521580;201404;674;1659;495;1413;174;549;141;387;315;936
521590;201404;750;2129;621;1914;226;752;112;363;338;1115
521600;201404;629;1650;453;1345;115;367;148;389;263;756
521630;201404;1797;4902;1511;4460;531;1827;261;606;792;2433
521640;201404;1897;5379;1611;4946;504;1806;476;1478;980;3284
521645;201404;657;1996;549;1741;121;423;237;682;358;1105
521680;201404;1473;4715;1254;4245;678;2439;192;607;870;3046
521690;201404;595;1775;534;1660;121;446;248;713;369;1159
521710;201404;2292;7224;2019;6675;428;1503;1084;3576;1512;5079
521720;201404;2043;6122;1873;5884;531;1736;1031;3325;1562;5061
521730;201404;3884;13076;3591;12496;1560;5942;885;2805;2445;8747
521740;201404;3608;9988;2896;9079;1317;4320;989;3258;2306;7578
521760;201404;12397;42639;11609;41369;2175;8634;7439;26713;9614;35347
521770;201404;2769;8497;2364;7680;1029;3594;534;1608;1563;5202
521800;201404;8742;26086;7542;24295;2766;9490;3118;10361;5884;19851
521805;201404;985;2280;776;1965;222;524;397;1121;619;1645
521810;201404;811;2389;711;2225;174;604;355;1077;529;1681
521830;201404;5453;18499;5136;18012;1094;4185;3266;11415;4360;15600
521839;201404;686;2020;554;1760;138;485;191;563;329;1048
521850;201404;6936;19753;5936;17996;1457;4493;2786;8476;4243;12969
521860;201404;1755;5354;1527;4907;421;1482;521;1609;942;3091
521870;201404;555;1953;514;1848;160;626;133;439;293;1065
521878;201404;598;1954;489;1692;143;559;179;572;322;1131
521880;201404;25798;68752;17730;55465;5948;20055;4933;15609;10881;35664
521890;201404;3678;11556;3116;10423;1167;4201;716;2357;1883;6558
521900;201404;1670;4498;1371;4087;356;1168;529;1472;885;2640
521910;201404;1224;3424;1073;3249;273;925;575;1783;848;2708
521920;201404;403;1217;360;1149;138;468;127;389;265;857
521925;201404;641;2005;574;1871;133;484;233;705;366;1189
521930;201404;3957;12857;3589;12139;1293;4624;988;3361;2281;7985
521935;201404;660;1994;626;1929;195;630;317;951;512;1581
521940;201404;1127;3073;916;2712;330;1035;297;884;627;1919
521945;201404;679;2345;632;2281;148;493;417;1622;565;2115
521950;201404;546;1673;462;1529;143;506;182;609;325;1115
521960;201404;943;2781;803;2542;188;642;362;1114;550;1756
521970;201404;2491;7206;2277;6927;358;1094;1613;5057;1971;6151
521971;201404;1014;2790;795;2403;184;627;299;869;483;1496
521973;201404;883;2945;792;2762;218;814;249;841;467;1655
521975;201404;13604;39081;12831;38103;2539;8207;8093;24195;10632;32402
521980;201404;1779;5619;1702;5534;277;888;1299;4386;1576;5274
521990;201404;1062;3335;977;3192;165;595;609;1969;774;2564
522000;201404;2114;6246;1858;5914;380;1312;1080;3547;1460;4859
522005;201404;377;992;288;850;77;241;130;379;207;620
522010;201404;3056;9137;2598;8381;918;3191;682;2130;1600;5321
522015;201404;1017;2992;851;2742;238;842;387;1249;625;2091
522020;201404;4605;12863;4088;12208;958;3139;2436;7165;3394;10304
522026;201404;651;1865;465;1670;207;804;132;490;339;1294
522028;201404;538;1616;486;1536;127;434;281;871;408;1305
522040;201404;3121;8088;2344;7100;793;2533;968;2995;1761;5528
522045;201404;12839;42555;11015;38805;3700;14345;2343;7983;6043;22328
522050;201404;1031;3054;844;2739;276;993;318;970;594;1963
522060;201404;3034;9550;2555;8814;816;3027;1199;4075;2015;7102
522068;201404;1552;5085;1456;4977;155;469;1179;4255;1334;4724
522070;201404;841;2550;754;2412;113;440;492;1556;605;1996
522100;201404;806;2260;720;2129;277;929;302;811;579;1740
522108;201404;938;2793;831;2633;87;284;604;1978;691;2262
522119;201404;1309;4030;1092;3737;161;566;670;2391;831;2957
522130;201404;508;1461;439;1385;139;467;214;691;353;1158
522140;201404;17828;51052;15645;47772;4969;16467;6099;18174;11068;34641
522145;201404;955;2693;887;2583;438;1359;239;677;677;2036
522150;201404;1262;3344;1053;3056;387;1204;364;1099;751;2303
522155;201404;783;2315;704;2199;163;530;402;1318;565;1848
522157;201404;691;2043;608;1906;69;247;468;1462;537;1709
522160;201404;6150;17614;4467;14699;1701;6235;670;2069;2371;8304
522170;201404;3168;8878;2665;8156;814;2548;1018;3270;1832;5818
522180;201404;465;1339;348;1158;150;547;111;371;261;918
522185;201404;14739;46127;13528;44479;3072;10909;7837;26046;10909;36955
522190;201404;957;2525;786;2241;135;395;439;1278;574;1673
522200;201404;1578;5367;1464;5122;496;1892;424;1413;920;3305
522205;201404;1316;3850;1100;3486;318;1067;475;1512;793;2579
522220;201404;1394;3896;1129;3562;270;940;538;1838;808;2778
522230;201404;1141;3500;1044;3344;177;652;678;2150;855;2802
530010;201404;254754;832589;229938;783511;70395;265457;75531;255035;145926;520492
110001;201403;4491;14788;3904;13840;1114;4102;2050;7375;3164;11477
110002;201403;13257;42828;11671;40054;3842;14249;4805;16542;8647;30791
110003;201403;985;3226;915;3103;272;975;321;1063;593;2038
110004;201403;9651;31794;8294;28955;2687;10246;2457;8571;5144;18817
110005;201403;2372;8013;2256;7786;873;3132;878;3048;1751;6180
110006;201403;3429;9258;2169;7507;718;2659;598;1933;1316;4592
110007;201403;1523;4871;1415;4714;329;1177;778;2764;1107;3941
110008;201403;2589;8920;2431;8689;562;1933;1633;6139;2195;8072
110009;201403;5394;15681;4225;13970;1172;4204;1851;5994;3023;10198
110010;201403;8478;24469;7491;23244;1621;4678;4581;15511;6202;20189
110011;201403;10910;33740;9055;30545;3399;12155;3107;10476;6506;22631
110012;201403;17095;52967;14823;48618;5088;17757;5186;16893;10274;34650
110013;201403;5242;16781;4394;15550;1411;5290;1916;6899;3327;12189
110014;201403;4368;13101;3709;12163;880;3051;2148;7133;3028;10184
110015;201403;5301;17047;4315;15277;1631;6208;1341;4748;2972;10956
110018;201403;5221;15420;4278;14194;1362;5068;1847;5864;3209;10932
110020;201403;57046;168115;47938;156801;11237;38101;27627;93368;38864;131469
110025;201403;4526;13319;3810;12048;670;2245;2600;8211;3270;10456
110026;201403;838;2446;711;2296;169;556;448;1490;617;2046
110028;201403;7563;22606;5763;19588;1752;6547;1476;4886;3228;11433
110029;201403;1710;5063;1377;4488;476;1608;551;1850;1027;3458
110030;201403;11425;33268;9454;30750;2548;8917;4907;16516;7455;25433
110032;201403;4206;13793;3769;12828;1113;3904;1519;5268;2632;9172
110033;201403;5525;17898;5160;17332;1744;5949;2294;8270;4038;14219
110034;201403;3911;10299;3279;9532;556;1574;2445;7230;3001;8804
110037;201403;2074;7090;1821;6617;500;1847;963;3560;1463;5407
110040;201403;3546;11651;3305;11225;1093;4019;1467;4921;2560;8940
110045;201403;5269;18139;4848;17637;1493;5783;2673;9710;4166;15493
110050;201403;1850;5949;1545;5544;546;2019;767;2803;1313;4822
110060;201403;1008;3512;897;3313;276;1081;429;1588;705;2669
110070;201403;1981;6820;1929;6699;337;1228;1346;4704;1683;5932
110080;201403;3467;11205;3328;11033;763;2367;2384;8214;3147;10581
110090;201403;948;2805;754;2492;241;903;297;891;538;1794
110092;201403;1713;5554;1562;5361;368;1287;876;3182;1244;4469
110094;201403;3264;10335;2995;9950;745;2633;1751;5961;2496;8594
110100;201403;2685;8579;2327;7980;730;2631;1116;3846;1846;6477
110110;201403;1799;5842;1684;5706;756;2605;694;2473;1450;5078
110120;201403;1672;5612;1391;4943;382;1404;496;1781;878;3185
110130;201403;2795;8037;2125;7060;586;2058;982;3291;1568;5349
110140;201403;2537;8763;2372;8492;531;1934;1505;5499;2036;7433
110143;201403;1582;5122;1241;4524;305;1153;656;2373;961;3526
110145;201403;1013;3097;894;2910;171;603;565;1848;736;2451
110146;201403;466;1494;425;1431;106;380;231;788;337;1168
110147;201403;903;2711;712;2398;196;723;251;759;447;1482
110148;201403;1364;4112;1068;3507;353;1270;333;1040;686;2310
110149;201403;3793;11134;2977;9896;766;2689;1746;5911;2512;8600
110150;201403;2885;8533;2384;7794;383;1379;1521;5005;1904;6384
110155;201403;948;3174;895;3049;299;1093;427;1418;726;2511
110160;201403;2211;7003;1830;6325;612;2178;829;2889;1441;5067
110170;201403;3215;9348;2511;8147;564;1940;1491;4886;2055;6826
110175;201403;1690;5420;1317;4938;135;537;956;3656;1091;4193
110180;201403;1704;5327;1455;4922;345;1202;858;2952;1203;4154
120001;201403;2903;10392;2810;10231;718;2804;1560;5779;2278;8583
120005;201403;1565;6249;1523;6170;179;700;1174;4946;1353;5646
120010;201403;4535;16097;4354;15783;971;3362;2807;10667;3778;14029
120013;201403;1870;7302;1826;7230;417;1674;1135;4727;1552;6401
120017;201403;2127;7629;2010;7409;565;2187;918;3718;1483;5905
120020;201403;14334;63115;14099;62586;2566;10843;10033;46760;12599;57603
120025;201403;2746;9558;2674;9446;652;2460;1548;5522;2200;7982
120030;201403;6084;24367;6019;24280;518;1974;5099;21055;5617;23029
120032;201403;1401;6740;1349;6615;193;1125;967;4757;1160;5882
120033;201403;3656;13979;3628;13926;229;908;3202;12469;3431;13377
120034;201403;1828;7355;1804;7317;86;381;1664;6775;1750;7156
120035;201403;2743;13322;2710;13244;265;1262;2232;11280;2497;12542
120038;201403;3208;11788;3094;11547;875;3365;1614;6212;2489;9577
120039;201403;1441;7911;1418;7858;182;1077;1119;6281;1301;7358
120040;201403;45568;165431;42065;158236;12757;50784;19399;74870;32156;125654
120042;201403;2797;12231;2688;11969;444;2085;1862;8461;2306;10546
120043;201403;853;4098;826;4037;67;326;691;3466;758;3792
120045;201403;4454;15552;4402;15472;1107;3895;2903;10518;4010;14413
120050;201403;8190;33858;7915;33270;1464;5914;5215;23346;6679;29260
120060;201403;6989;32403;6875;32187;798;3827;5523;26523;6321;30350
120070;201403;2825;10705;2771;10569;606;2215;1749;7020;2355;9235
120080;201403;3719;14088;3562;13828;638;2523;2512;10098;3150;12621
130002;201403;2831;12068;2678;11811;285;1289;2110;9480;2395;10769
130006;201403;1710;7400;1543;7089;210;1065;1096;5106;1306;6171
130008;201403;2010;8238;1929;8087;176;796;1544;6604;1720;7400
130010;201403;2718;9132;2364;8719;241;808;1951;7414;2192;8222
130014;201403;3481;11260;3016;10564;496;1870;1949;6935;2445;8805
130020;201403;2473;8771;2461;8755;42;153;2397;8542;2439;8695
130030;201403;6936;27494;6731;27217;574;1995;5782;24094;6356;26089
130040;201403;3492;11101;3294;10830;313;1142;2799;9194;3112;10336
130050;201403;5857;23666;5202;22634;752;3107;3613;16894;4365;20001
130060;201403;5905;25936;5569;25458;611;2730;4479;21010;5090;23740
130063;201403;3238;14509;3215;14466;362;1544;2685;12399;3047;13943
130068;201403;2994;12715;2786;12314;349;1698;1982;8844;2331;10542
130070;201403;6546;22120;5988;21396;742;2591;4614;17015;5356;19606
130080;201403;5052;22535;4890;22306;869;4074;3418;16113;4287;20187
130083;201403;1962;7917;1867;7772;326;1498;1274;5331;1600;6829
130090;201403;2466;9017;2357;8871;190;841;2004;7535;2194;8376
130100;201403;5409;20842;5209;20568;456;1980;4362;17403;4818;19383
130110;201403;6674;21607;6249;21096;785;2534;4954;17327;5739;19861
130115;201403;3695;13738;3536;13530;125;378;3326;12881;3451;13259
130120;201403;13309;51512;13001;51068;1268;4572;10902;44273;12170;48845
130130;201403;3390;14602;3296;14434;453;1998;2532;11369;2985;13367
130140;201403;5857;23510;5817;23458;155;470;5607;22870;5762;23340
130150;201403;3498;13114;3424;13019;218;1024;3003;11395;3221;12419
130160;201403;3898;16206;3824;16105;271;1000;3436;14714;3707;15714
130165;201403;2717;11360;2679;11294;456;1968;2044;8728;2500;10696
130170;201403;8754;32476;7719;31156;1447;5996;5224;22019;6671;28015
130180;201403;3353;10743;3283;10647;119;343;3046;9953;3165;10296
130185;201403;9083;32498;8766;32091;1429;5008;6608;25179;8037;30187
130190;201403;16548;58578;14661;56206;3141;11774;9210;37584;12351;49358
130195;201403;1786;7478;1731;7395;102;451;1515;6577;1617;7028
130200;201403;1965;7195;1830;6964;358;1425;1188;4600;1546;6025
130210;201403;1142;4569;1088;4474;160;644;817;3487;977;4131
130220;201403;2029;8377;1872;8091;359;1726;1084;4750;1443;6476
130230;201403;3312;15145;3149;14873;402;1972;2334;11476;2736;13448
130240;201403;8246;32102;7634;31197;499;2330;6467;26847;6966;29177
130250;201403;17381;63826;16830;63045;2880;10247;12216;48020;15096;58267
130255;201403;3976;14455;3778;14123;178;549;3367;12946;3545;13495
130260;201403;250405;817776;227657;781919;65802;233367;112995;402372;178797;635739
130270;201403;7276;30441;6584;29354;1136;4919;4588;21574;5724;26493
130280;201403;3193;12589;3124;12490;144;465;2812;11551;2956;12016
130290;201403;10643;38375;10477;38136;232;632;9894;36643;10126;37275
130300;201403;4371;17105;4128;16755;364;1635;3333;13681;3697;15316
130310;201403;4848;18529;4437;18018;617;2418;3352;14112;3969;16530
130320;201403;2828;9844;2598;9534;380;1448;1843;6943;2223;8391
130330;201403;3528;13089;3170;12602;243;1021;2654;10754;2897;11775
130340;201403;17035;66682;16532;65878;3373;12567;10821;46353;14194;58920
130350;201403;3206;13091;3077;12938;352;1426;2470;10721;2822;12147
130353;201403;5766;18147;5051;17178;1337;4574;2806;10208;4143;14782
130356;201403;4350;15759;4197;15531;529;1669;3324;13016;3853;14685
130360;201403;2876;7999;2585;7665;51;92;2427;7403;2478;7495
130370;201403;4933;19538;4239;18613;266;1439;3557;15722;3823;17161
130380;201403;6753;28642;6526;28289;481;2264;5539;24244;6020;26508
130390;201403;4443;20185;4175;19727;495;2371;3193;15589;3688;17960
130395;201403;2013;7435;1855;7152;296;1258;1185;4604;1481;5862
130400;201403;2137;7855;2069;7760;159;642;1800;6821;1959;7463
130406;201403;9577;36686;8573;35133;2126;8501;4860;21363;6986;29864
130410;201403;4088;15682;3772;15100;924;3823;2071;8657;2995;12480
130420;201403;9953;42604;9638;41990;3034;13004;5203;24049;8237;37053
130423;201403;3106;12182;2948;11972;259;1212;2475;10103;2734;11315
130426;201403;2024;8742;1948;8609;339;1501;1361;6273;1700;7774
130430;201403;3446;12474;3273;12234;408;1670;2358;9000;2766;10670
130440;201403;3832;13838;3547;13526;196;644;3175;12483;3371;13127
140002;201403;1445;4783;1355;4651;168;579;958;3413;1126;3992
140005;201403;2593;8022;2433;7849;128;373;2206;7225;2334;7598
140010;201403;44437;145600;40377;138953;9675;35688;22216;78213;31891;113901
140015;201403;2809;9352;2713;9221;262;610;2294;8207;2556;8817
140017;201403;2875;9135;2732;8958;216;634;2319;7815;2535;8449
140020;201403;4327;14822;4045;14445;468;1574;3168;11734;3636;13308
140023;201403;1978;6947;1803;6662;273;1044;1221;4656;1494;5700
140028;201403;2128;5990;2071;5923;95;204;1895;5570;1990;5774
140030;201403;3509;11370;3367;11190;413;1053;2796;9774;3209;10827
140040;201403;1471;7127;1423;6988;131;724;1054;5294;1185;6018
140045;201403;2379;8689;2238;8495;353;1206;1619;6607;1972;7813
140047;201403;5286;14944;4863;14370;1567;4856;2081;6570;3648;11426
140050;201403;1496;4637;1388;4492;191;636;1011;3341;1202;3977
140060;201403;1418;4513;1298;4340;317;1102;778;2692;1095;3794
140070;201403;1412;6968;1410;6963;58;235;1337;6681;1395;6916
150010;201403;32927;106642;31552;104813;2344;8238;26650;89734;28994;97972
150013;201403;1586;4966;1530;4903;173;578;1221;3937;1394;4515
150020;201403;10921;38379;10664;38006;1393;4964;8398;30625;9791;35589
150030;201403;6266;27557;6112;27301;681;2581;5011;23451;5692;26032
150034;201403;4423;12149;4196;11874;191;469;3889;11165;4080;11634
150040;201403;12325;42752;10881;40961;2528;8846;6905;28243;9433;37089
150050;201403;5993;23096;5862;22855;654;2757;4665;18376;5319;21133
150060;201403;15355;50991;14559;49807;3625;12207;8793;31439;12418;43646
150070;201403;5495;23176;4994;22606;510;2379;4143;19069;4653;21448
150080;201403;59866;165612;53557;157709;8015;22059;38446;117248;46461;139307
150085;201403;5055;18034;4832;17714;716;2300;3730;14393;4446;16693
150090;201403;9873;38597;9342;37865;1217;4691;7257;30370;8474;35061
150095;201403;5142;17908;4780;17353;514;1851;3775;14116;4289;15967
150100;201403;3508;13152;3287;12814;268;1267;2657;10281;2925;11548
150110;201403;3140;15118;3129;15090;196;807;2860;14029;3056;14836
150120;201403;5872;23292;5754;23072;1040;4027;4173;17176;5213;21203
150125;201403;795;2481;739;2396;177;610;438;1414;615;2024
150130;201403;20220;64545;19237;63136;1846;6039;15426;51677;17272;57716
150140;201403;148490;446452;143394;440172;18620;57217;114206;355798;132826;413015
150145;201403;4859;15430;4513;14995;704;2446;3277;11058;3981;13504
150150;201403;9585;31750;9037;30890;1981;6990;5689;19790;7670;26780
150157;201403;2895;9175;2628;8802;402;1399;1983;6706;2385;8105
150160;201403;2838;9642;2710;9456;718;2411;1595;5860;2313;8271
150170;201403;21827;81395;20755;79976;4448;16938;14130;55645;18578;72583
150172;201403;3021;10575;2739;10150;366;1389;2121;8020;2487;9409
150175;201403;2039;6385;1973;6308;161;455;1715;5644;1876;6099
150178;201403;10713;33642;9287;31967;616;1872;8193;28946;8809;30818
150180;201403;17514;71499;16998;70783;1659;7264;14055;59392;15714;66656
150190;201403;7171;23146;6759;22571;438;1011;5813;20311;6251;21322
150195;201403;4622;16411;4322;15894;472;1745;3433;12835;3905;14580
150200;201403;4997;16417;4851;16239;139;429;4516;15293;4655;15722
150210;201403;22302;86089;21961;85590;2413;8836;18228;72836;20641;81672
150215;201403;5933;19292;5425;18539;1407;4959;2935;10330;4342;15289
150220;201403;12555;40521;11500;38878;2866;9913;6139;21477;9005;31390
150230;201403;11027;38114;10018;36691;877;3887;8115;29551;8992;33438
150240;201403;33424;103426;30560;98625;9508;31962;12980;43379;22488;75341
150250;201403;3942;16019;3819;15837;708;2808;2712;11814;3420;14622
150260;201403;2010;8233;1930;8078;427;1877;1133;4888;1560;6765
150270;201403;9521;29198;7440;26608;1698;6476;4513;16493;6211;22969
150275;201403;5736;21232;5443;20748;891;3452;3853;15053;4744;18505
150276;201403;2088;6355;1943;6167;360;1205;1422;4530;1782;5735
150277;201403;4907;15719;4353;15048;572;2012;3333;11877;3905;13889
150280;201403;5823;25653;5667;25292;952;4155;4079;18797;5031;22952
150285;201403;2619;10626;2584;10548;287;1155;2047;8567;2334;9722
150290;201403;8730;27486;8509;27220;891;2522;6974;23251;7865;25773
150293;201403;8448;26523;7251;24689;2501;8864;2949;10661;5450;19525
150295;201403;5776;19774;5137;18961;1171;4463;3280;12509;4451;16972
150300;201403;1776;6331;1738;6283;125;426;1458;5444;1583;5870
150304;201403;4099;12941;3562;12213;538;1874;2532;8974;3070;10848
150307;201403;6520;22628;6086;22013;514;1755;5004;18667;5518;20422
150309;201403;6438;23124;5996;22518;1693;6368;3570;14069;5263;20437
150310;201403;4925;23172;4851;23059;577;2646;3906;19133;4483;21779
150320;201403;8584;23022;8228;22639;607;1534;7131;20108;7738;21642
150330;201403;13048;47946;12445;46983;1609;6060;9552;37060;11161;43120
150340;201403;2190;7497;2066;7317;400;1483;1357;4896;1757;6379
150345;201403;6327;22525;5936;21993;692;2586;4765;18079;5457;20665
150350;201403;7227;24427;6893;23952;1003;3404;5103;18150;6106;21554
150360;201403;20871;66955;18406;63827;3038;10821;12706;45620;15744;56441
150370;201403;10191;38280;9786;37733;1235;4377;7866;31568;9101;35945
150375;201403;2734;11697;2679;11624;240;853;2285;10373;2525;11226
150380;201403;9426;29313;8557;28113;939;3278;6929;22933;7868;26211
150390;201403;8099;35060;7737;34332;1835;7735;4652;21890;6487;29625
150400;201403;5397;22610;5238;22276;708;2961;3837;16862;4545;19823
150405;201403;8226;25759;7488;24837;1608;4876;4938;17568;6546;22444
150410;201403;1703;6595;1670;6539;322;1332;1046;4197;1368;5529
150420;201403;34704;123957;31169;118166;8342;33479;15694;62123;24036;95602
150430;201403;6446;24243;6243;23886;803;3312;4767;18440;5570;21752
150440;201403;5323;18817;5202;18638;846;2947;3832;14103;4678;17050
150442;201403;21336;62374;19559;60033;3506;10956;12952;41101;16458;52057
150445;201403;5039;18117;4669;17582;722;2575;3489;13565;4211;16140
150450;201403;4256;20413;4114;20214;431;2128;3393;17047;3824;19175
150460;201403;6790;24999;5689;23825;461;2060;4901;20991;5362;23051
150470;201403;17044;52886;16510;52214;1297;3414;14492;47132;15789;50546
150475;201403;892;3026;805;2910;199;669;502;1962;701;2631
150480;201403;13992;48294;13478;47535;1056;3536;11291;40913;12347;44449
150490;201403;6402;25061;6288;24908;355;1398;5673;22730;6028;24128
150495;201403;4726;17474;4627;17312;277;1032;4154;15661;4431;16693
150497;201403;3248;11456;2977;10997;907;3406;1573;6048;2480;9454
150500;201403;2893;8552;2785;8391;422;1225;2074;6345;2496;7570
150503;201403;3788;12136;3266;11472;1182;4349;1456;5342;2638;9691
150506;201403;12234;43792;11304;42492;2794;9603;7221;29258;10015;38861
150510;201403;9600;38183;9017;37169;1517;6266;6165;26572;7682;32838
150520;201403;6069;25231;5981;25104;463;1565;5323;22934;5786;24499
150530;201403;11414;41347;10485;39961;1450;5036;7757;30799;9207;35835
150540;201403;4573;14311;4180;13739;357;1211;3445;11369;3802;12580
150543;201403;4989;15967;4596;15414;1386;4765;2577;8855;3963;13620
150548;201403;8151;26722;7684;26123;576;1813;6692;23242;7268;25055
150549;201403;2209;7084;2108;6963;112;273;1907;6474;2019;6747
150550;201403;20834;67374;18726;63771;5745;20364;8317;29036;14062;49400
150553;201403;20913;77123;18671;71825;7346;30373;3408;13000;10754;43373
150555;201403;1715;5419;1503;5121;236;867;1057;3633;1293;4500
150560;201403;1980;6447;1910;6290;262;913;1386;4557;1648;5470
150563;201403;2824;9499;2650;9195;622;2316;1541;5346;2163;7662
150565;201403;3396;12277;3193;11980;261;1074;2557;9778;2818;10852
150570;201403;5260;20342;5179;20198;432;1627;4344;17406;4776;19033
150580;201403;9431;39020;9268;38814;829;3048;7975;34568;8804;37616
150590;201403;5392;21976;5255;21814;121;465;5000;20952;5121;21417
150600;201403;7586;29906;7416;29636;600;2201;6368;26155;6968;28356
150610;201403;2360;8261;2181;7887;267;1097;1506;5370;1773;6467
150611;201403;2619;9689;2506;9430;288;1147;1822;6925;2110;8072
150613;201403;11134;35190;9838;33374;3349;11697;4543;16256;7892;27953
150616;201403;3064;8998;2436;8206;568;1924;1442;4964;2010;6888
150618;201403;7311;25953;7038;25442;2313;8754;3365;12425;5678;21179
150619;201403;5168;18164;4880;17740;742;2863;3448;12696;4190;15559
150620;201403;6048;22299;5518;21619;846;3310;4119;16785;4965;20095
150630;201403;5309;16943;5110;16696;455;1483;4272;14231;4727;15714
150635;201403;4457;14799;4213;14338;818;2858;2582;9141;3400;11999
150640;201403;1444;4718;1431;4697;51;143;1337;4461;1388;4604
150650;201403;11873;37357;10876;35601;2960;10113;5459;18250;8419;28363
150655;201403;5298;17767;4886;17164;694;2538;3629;12929;4323;15467
150658;201403;4254;13776;3935;13315;401;1621;2955;10119;3356;11740
150660;201403;5646;18145;5183;17558;1419;4731;2940;10433;4359;15164
150670;201403;6116;18112;5353;17196;1750;5691;2797;9595;4547;15286
150680;201403;50468;199426;47500;193972;16676;68564;20737;91334;37413;159898
150690;201403;1785;5960;1666;5745;269;948;1075;3826;1344;4774
150700;201403;5758;18315;5415;17874;1167;3827;3549;12057;4716;15884
150710;201403;4214;13685;3819;13063;440;1341;2979;10513;3419;11854
150715;201403;4913;16267;4439;15592;645;2363;3337;11899;3982;14262
150720;201403;6435;26705;6112;26118;1059;4293;4254;19153;5313;23446
150730;201403;9027;31636;8523;30963;1146;4052;6831;25459;7977;29511
150740;201403;3627;11807;3340;11301;486;1760;2231;7685;2717;9445
150745;201403;5882;18765;5475;18223;1067;3781;3750;12567;4817;16348
150746;201403;1394;4611;1333;4503;200;744;887;3034;1087;3778
150747;201403;5004;16596;4596;16064;492;1630;3576;13104;4068;14734
150750;201403;2762;9640;2707;9577;112;246;2550;9229;2662;9475
150760;201403;11289;37253;10767;36545;2761;9322;6336;22422;9097;31744
150770;201403;5582;21333;5390;21027;878;3205;4025;16664;4903;19869
150775;201403;1120;3624;1015;3425;202;826;604;1947;806;2773
150780;201403;3002;10232;2975;10203;90;214;2813;9817;2903;10031
150790;201403;4870;15939;4600;15607;345;975;3909;13800;4254;14775
150795;201403;15065;47181;13701;45212;2453;7826;9384;32343;11837;40169
150796;201403;2781;8686;2671;8549;437;1356;1979;6599;2416;7955
150797;201403;3719;12627;3566;12399;181;696;3134;10974;3315;11670
150800;201403;14032;47510;12871;46082;3222;11030;8130;30969;11352;41999
150803;201403;6781;24793;6487;24377;898;3483;4720;18263;5618;21746
150805;201403;2713;9582;2525;9306;373;1345;1811;6883;2184;8228
150808;201403;5815;20177;5043;18749;2182;8650;1050;4023;3232;12673
150810;201403;19257;61492;16365;57966;2671;9088;11469;42931;14140;52019
150812;201403;5288;16582;4892;16023;466;1945;3734;11871;4200;13816
150815;201403;8783;28457;7966;27452;1205;3998;6082;21703;7287;25701
150820;201403;10507;31341;9626;30380;651;1376;8538;27975;9189;29351
150830;201403;12344;48163;11750;47174;762;3244;9613;39879;10375;43123
150835;201403;2000;7435;1866;7126;542;2201;814;3120;1356;5321
150840;201403;7356;21642;5953;19739;1473;5486;3151;10198;4624;15684
160005;201403;689;2664;655;2597;117;533;392;1546;509;2079
160010;201403;1537;5248;1526;5236;153;398;1317;4705;1470;5103
160015;201403;1559;5922;1526;5862;253;909;1100;4473;1353;5382
160020;201403;2273;7671;2122;7466;314;1157;1501;5432;1815;6589
160021;201403;821;3582;801;3549;150;708;546;2486;696;3194
160023;201403;989;3903;973;3877;86;309;844;3436;930;3745
160025;201403;1253;3630;1219;3594;20;68;1178;3475;1198;3543
160027;201403;8034;25225;7574;24702;2596;8554;3842;13225;6438;21779
160030;201403;39622;147894;36730;141700;8826;33977;22279;88933;31105;122910
160040;201403;4087;15977;4010;15864;178;763;3672;14563;3850;15326
160050;201403;3404;12812;3084;12349;1112;4324;1468;6404;2580;10728
160053;201403;2487;9935;2433;9860;650;2680;1501;6268;2151;8948
160055;201403;758;2982;744;2964;143;629;523;2094;666;2723
160060;201403;17381;58954;16408;57865;4817;16116;9820;36911;14637;53027
160070;201403;2054;8753;2029;8704;204;856;1724;7539;1928;8395
160080;201403;2607;9825;2595;9803;121;406;2419;9263;2540;9669
170025;201403;561;1927;514;1852;183;690;221;833;404;1523
170030;201403;1197;3962;1087;3757;312;1134;465;1630;777;2764
170035;201403;1537;4683;1285;4208;445;1571;374;1239;819;2810
170040;201403;1816;6084;1612;5783;291;1224;1026;3669;1317;4893
170070;201403;2086;5712;1713;5250;520;1733;821;2540;1341;4273
170100;201403;2541;7173;2250;6668;347;1125;1626;4801;1973;5926
170105;201403;736;2433;627;2222;128;567;329;1124;457;1691
170110;201403;1208;3783;1058;3531;241;833;579;1953;820;2786
170130;201403;1407;4483;1248;4256;215;752;810;2879;1025;3631
170190;201403;1666;4838;1354;4379;607;1965;318;1180;925;3145
170200;201403;1511;4681;1187;4097;326;1246;371;1240;697;2486
170210;201403;29008;90375;25235;83873;9027;32438;7829;26783;16856;59221
170215;201403;1157;3705;1047;3541;134;481;787;2699;921;3180
170220;201403;6469;21619;5973;20823;957;3553;3944;14109;4901;17662
170230;201403;1508;5012;1313;4647;333;1348;607;2089;940;3437
170240;201403;2989;8554;2415;7800;339;1228;1615;5256;1954;6484
170255;201403;3639;11733;3086;10846;1048;3738;1216;4553;2264;8291
170270;201403;1058;2729;762;2327;118;391;485;1467;603;1858
170290;201403;2946;9002;2616;8604;198;572;2191;7534;2389;8106
170300;201403;2027;6496;1788;6097;298;1129;1164;3999;1462;5128
170305;201403;749;2345;622;2114;128;486;352;1191;480;1677
170307;201403;1094;3881;952;3617;230;921;445;1814;675;2735
170310;201403;1705;4710;1366;4172;361;1140;597;1931;958;3071
170320;201403;1019;3016;814;2661;221;751;370;1256;591;2007
170330;201403;853;2622;722;2459;132;476;470;1592;602;2068
170360;201403;451;1583;428;1546;102;383;168;592;270;975
170370;201403;1378;4135;1144;3774;202;770;607;1985;809;2755
170380;201403;2116;6726;1728;6144;397;1601;884;3095;1281;4696
170382;201403;553;1858;485;1752;110;448;280;980;390;1428
170384;201403;1548;6447;1467;6302;372;1641;870;3833;1242;5474
170386;201403;933;2817;796;2620;213;789;358;1187;571;1976
170388;201403;652;1977;566;1832;117;453;224;709;341;1162
170389;201403;915;3125;852;3029;105;464;618;2143;723;2607
170390;201403;1356;4010;1176;3784;179;624;848;2790;1027;3414
170410;201403;475;1573;448;1522;63;245;298;1008;361;1253
170460;201403;525;1444;391;1215;105;355;131;407;236;762
170510;201403;766;2675;656;2500;123;526;341;1298;464;1824
170550;201403;5558;17467;4607;15755;1764;6514;1162;4044;2926;10558
170555;201403;1369;4042;1118;3658;297;1065;564;1842;861;2907
170560;201403;974;3354;817;3169;166;678;527;2119;693;2797
170600;201403;1309;3788;1166;3617;98;334;936;2964;1034;3298
170610;201403;1647;5036;1309;4498;184;700;774;2702;958;3402
170625;201403;442;1387;352;1206;88;309;91;324;179;633
170650;201403;1280;4115;1133;3859;296;1105;529;1824;825;2929
170700;201403;3992;13367;3370;12339;841;3406;1573;5975;2414;9381
170710;201403;1765;5276;1446;4743;199;756;943;3069;1142;3825
170720;201403;1832;4957;1583;4571;293;855;1069;3151;1362;4006
170730;201403;1123;3246;931;2959;301;1056;395;1252;696;2308
170740;201403;2222;7974;1974;7537;318;1316;1320;5083;1638;6399
170755;201403;891;2811;760;2534;189;700;272;854;461;1554
170765;201403;1590;4323;1286;3832;335;1102;536;1631;871;2733
170770;201403;1822;6321;1706;6105;375;1374;986;3659;1361;5033
170820;201403;4169;13399;3777;12789;1093;3906;1545;5369;2638;9275
170825;201403;778;2373;599;2027;145;539;231;758;376;1297
170830;201403;1352;4080;1254;3926;33;74;1162;3680;1195;3754
170900;201403;2860;10100;2743;9881;343;1247;2031;7579;2374;8826
170930;201403;4231;12993;3485;11910;1356;4896;1118;3807;2474;8703
170950;201403;13009;38412;10108;33539;3898;14532;2233;7028;6131;21560
170980;201403;529;1597;425;1433;97;366;250;831;347;1197
171050;201403;1313;4703;1246;4579;56;250;1103;4019;1159;4269
171070;201403;1702;5435;1575;5268;332;1157;967;3340;1299;4497
171090;201403;954;2780;809;2555;104;354;574;1818;678;2172
171110;201403;654;1936;534;1751;159;564;276;878;435;1442
171150;201403;849;2556;641;2172;126;463;351;1204;477;1667
171180;201403;639;2012;496;1726;136;511;173;639;309;1150
171190;201403;1894;6897;1643;6388;393;1615;781;3170;1174;4785
171195;201403;869;3150;790;3007;104;439;499;1962;603;2401
171200;201403;691;2253;573;2036;144;592;265;888;409;1480
171215;201403;474;1421;369;1236;65;236;157;547;222;783
171240;201403;793;2740;748;2665;86;271;570;2128;656;2399
171245;201403;668;2215;567;1984;118;449;238;824;356;1273
171250;201403;1170;3373;1026;3183;71;236;827;2579;898;2815
171270;201403;419;1733;393;1678;106;431;183;855;289;1286
171280;201403;910;2863;809;2691;191;618;406;1497;597;2115
171320;201403;4106;12603;3526;11728;1158;4045;1599;5342;2757;9387
171330;201403;2829;8573;2495;8081;644;2266;1328;4320;1972;6586
171360;201403;1514;4925;1297;4599;309;1128;702;2567;1011;3695
171370;201403;762;2152;684;2032;152;519;358;1033;510;1552
171380;201403;1316;4441;1137;4085;368;1336;465;1725;833;3061
171395;201403;898;2784;748;2510;148;565;369;1231;517;1796
171420;201403;2275;6992;1846;6227;478;1759;788;2670;1266;4429
171430;201403;1033;3274;915;3102;201;702;541;1853;742;2555
171488;201403;2453;7592;2254;7304;585;1898;1186;4055;1771;5953
171500;201403;889;2754;792;2569;128;381;445;1494;573;1875
171510;201403;925;3319;841;3189;161;642;517;2048;678;2690
171515;201403;625;1812;485;1603;109;363;231;782;340;1145
171525;201403;608;2041;514;1866;105;432;274;979;379;1411
171550;201403;343;1157;291;1051;113;469;37;130;150;599
171570;201403;1254;3932;1111;3698;239;817;687;2345;926;3162
171575;201403;1979;5750;1581;5023;392;1277;692;2310;1084;3587
171610;201403;6197;21319;5673;20324;1911;7289;1900;6818;3811;14107
171620;201403;2346;7338;2139;7027;174;640;1742;5769;1916;6409
171630;201403;896;2974;746;2711;183;732;292;1056;475;1788
171650;201403;2426;7632;2020;6910;559;2055;820;2762;1379;4817
171660;201403;2616;7284;2102;6382;441;1426;1121;3463;1562;4889
171665;201403;1435;4347;1211;3985;218;799;735;2487;953;3286
171670;201403;2372;6435;1925;5832;468;1548;1039;3062;1507;4610
171700;201403;1136;3795;1024;3601;170;655;623;2206;793;2861
171720;201403;712;2248;630;2098;220;768;263;887;483;1655
171750;201403;1287;4237;1144;3965;393;1438;385;1344;778;2782
171780;201403;1228;3440;908;2983;155;582;503;1655;658;2237
171790;201403;1736;5603;1431;5168;290;1067;850;3220;1140;4287
171800;201403;723;2325;661;2233;98;370;446;1519;544;1889
171820;201403;9811;30392;8989;29366;2158;7653;5086;16823;7244;24476
171830;201403;1623;5963;1499;5698;375;1524;679;2601;1054;4125
171840;201403;806;2362;719;2245;60;194;553;1743;613;1937
171845;201403;820;2223;645;1929;100;353;369;1069;469;1422
171850;201403;1013;3657;906;3430;107;472;585;2210;692;2682
171855;201403;1252;3989;1136;3798;115;485;856;2788;971;3273
171865;201403;492;1590;415;1475;110;436;194;669;304;1105
171870;201403;677;2191;565;1988;129;475;255;944;384;1419
171875;201403;1388;4418;1173;4093;171;675;826;2866;997;3541
171880;201403;984;3537;965;3504;122;469;716;2685;838;3154
171884;201403;908;2606;670;2252;161;592;244;847;405;1439
171886;201403;1502;5137;1340;4796;454;1729;436;1600;890;3329
171888;201403;678;2093;573;1897;99;340;337;1161;436;1501
171889;201403;488;1603;464;1551;102;331;265;923;367;1254
171890;201403;1129;3769;1023;3613;137;579;685;2409;822;2988
171900;201403;452;1814;431;1766;120;482;210;891;330;1373
172000;201403;662;2148;567;2009;100;416;326;1123;426;1539
172010;201403;1175;4087;1120;3995;115;468;869;3110;984;3578
172015;201403;354;1351;308;1280;60;242;177;789;237;1031
172020;201403;2342;7782;2119;7454;298;1138;1495;5341;1793;6479
172025;201403;755;2218;603;1943;104;360;314;1008;418;1368
172030;201403;1096;3745;991;3553;141;601;640;2285;781;2886
172049;201403;1126;3201;1049;3093;141;404;774;2358;915;2762
172065;201403;1252;3697;1054;3446;124;456;840;2742;964;3198
172080;201403;2643;8136;2243;7461;287;1114;1490;4862;1777;5976
172085;201403;512;1406;397;1198;86;285;124;371;210;656
172090;201403;3501;10513;2721;9442;563;2097;1617;5775;2180;7872
172093;201403;586;1874;458;1644;186;761;170;591;356;1352
172097;201403;707;2089;588;1893;161;572;207;659;368;1231
172100;201403;26445;90547;23381;84348;8052;31873;6111;21862;14163;53735
172110;201403;1695;6207;1565;6016;148;541;1227;4890;1375;5431
172120;201403;5597;16781;4641;15572;502;1774;3474;11921;3976;13695
172125;201403;327;1013;269;928;56;213;127;448;183;661
172130;201403;527;1531;461;1430;73;253;303;967;376;1220
172208;201403;2175;6794;2042;6578;430;1499;1117;3625;1547;5124
172210;201403;2303;7054;2150;6837;280;989;1595;5001;1875;5990
210005;201403;21682;71114;19508;67672;6179;22817;9232;32461;15411;55278
210010;201403;1618;5789;1457;5568;165;616;1101;4372;1266;4988
210015;201403;3511;10976;3229;10562;281;602;2654;9247;2935;9849
210020;201403;7264;18317;6817;17780;488;1412;5512;14583;6000;15995
210030;201403;5868;19697;5573;19296;452;1860;4630;15967;5082;17827
210040;201403;1952;5655;1780;5448;213;676;1338;4149;1551;4825
210043;201403;6075;18356;5614;17718;529;1642;4457;14512;4986;16154
210047;201403;6697;26365;6260;25594;909;4076;4235;17505;5144;21581
210050;201403;2488;8884;2000;8184;484;1968;1015;4427;1499;6395
210055;201403;1701;5877;1588;5722;220;766;1177;4329;1397;5095
210060;201403;7899;29346;7145;28159;796;3492;5247;21140;6043;24632
210070;201403;6866;20637;6487;20159;320;1076;5700;17847;6020;18923
210080;201403;3737;13027;3669;12929;83;330;3442;12183;3525;12513
210083;201403;4016;13988;3854;13803;169;599;3543;12837;3712;13436
210087;201403;2580;8103;2435;7932;219;755;2053;6743;2272;7498
210090;201403;9879;32825;9511;32224;486;1852;8237;28042;8723;29894
210095;201403;6143;23500;5993;23258;729;2762;4768;18987;5497;21749
210100;201403;7562;22651;7143;22167;327;1204;6346;19683;6673;20887
210110;201403;3203;11105;3115;10993;201;760;2624;9453;2825;10213
210120;201403;25650;75041;21996;70592;2468;8314;16606;54467;19074;62781
210125;201403;3379;11161;3243;11012;257;797;2819;9788;3076;10585
210130;201403;3914;12021;3748;11799;427;1312;2960;9438;3387;10750
210135;201403;1661;4901;1478;4630;124;392;1209;3860;1333;4252
210140;201403;17312;55913;14762;52570;3432;12452;8898;33147;12330;45599
210150;201403;4630;11836;4241;11357;148;399;3870;10361;4018;10760
210160;201403;18456;60508;17298;58802;2645;8548;12950;45646;15595;54194
210170;201403;13965;52089;13764;51809;1014;3448;12029;46316;13043;49764
210173;201403;1788;7724;1739;7626;131;621;1505;6647;1636;7268
210177;201403;2925;9603;2773;9413;321;1235;2181;7346;2502;8581
210180;201403;1489;4668;1412;4555;92;322;1188;3835;1280;4157
210190;201403;5110;16536;4812;16030;372;1644;3646;11852;4018;13496
210193;201403;1444;4654;1341;4481;93;357;1080;3661;1173;4018
210197;201403;1831;6404;1722;6285;125;483;1479;5476;1604;5959
210200;201403;9189;31120;8508;30131;1274;4255;6125;22759;7399;27014
210203;201403;6247;21310;5900;20872;479;1554;5071;18305;5550;19859
210207;201403;3030;10223;2858;9921;420;1401;2041;7310;2461;8711
210210;201403;8834;30006;8492;29533;300;1115;7460;26507;7760;27622
210215;201403;1714;6821;1663;6732;185;835;1322;5379;1507;6214
210220;201403;6255;24310;6046;23965;519;2077;4875;19840;5394;21917
210230;201403;5359;18291;4990;17707;446;1646;4001;14377;4447;16023
210232;201403;11690;40886;10453;39332;2097;7928;6885;27598;8982;35526
210235;201403;3505;10950;3170;10536;262;899;2647;8898;2909;9797
210237;201403;2529;9242;2502;9207;49;122;2412;8993;2461;9115
210240;201403;2979;9532;2860;9353;266;762;2307;7762;2573;8524
210250;201403;5024;15881;4817;15621;148;543;4470;14568;4618;15111
210255;201403;2727;8962;2507;8585;567;2107;1513;5228;2080;7335
210260;201403;5209;16762;4794;16144;687;2273;3451;11921;4138;14194
210270;201403;5266;15135;4718;14395;155;539;4172;12838;4327;13377
210275;201403;3506;9023;3296;8798;134;288;3095;8370;3229;8658
210280;201403;5973;17570;5188;16580;366;1270;4314;13923;4680;15193
210290;201403;5808;18704;5364;18160;518;1710;4390;15218;4908;16928
210300;201403;37296;112260;31369;104699;3209;11488;24423;83693;27632;95181
210310;201403;2871;8334;2738;8135;127;379;2399;7161;2526;7540
210312;201403;2181;7087;2141;7025;125;492;1897;6212;2022;6704
210315;201403;2360;8484;2267;8348;140;580;1942;7210;2082;7790
210317;201403;4335;12979;4168;12763;310;921;3582;11156;3892;12077
210320;201403;19540;61914;18355;60495;1193;3894;15985;53741;17178;57635
210325;201403;3584;11488;3235;10965;339;1267;2515;8580;2854;9847
210330;201403;32529;86871;27952;81875;3852;9728;20563;65726;24415;75454
210340;201403;11957;37413;10982;36219;1438;4047;8195;28945;9633;32992
210350;201403;10400;32903;9678;31890;797;2732;7788;26161;8585;28893
210355;201403;3960;14325;3646;13931;141;394;3339;13160;3480;13554
210360;201403;16687;51894;15675;50438;1489;4929;12276;40279;13765;45208
210370;201403;8169;21753;7333;20857;382;886;6480;18954;6862;19840
210375;201403;3248;10018;2822;9504;484;1768;2010;6888;2494;8656
210380;201403;6295;18455;5678;17563;696;1947;4461;14258;5157;16205
210390;201403;2772;9887;2573;9558;124;563;2265;8437;2389;9000
210400;201403;4877;15692;4710;15488;348;1081;4079;13643;4427;14724
210405;201403;8755;24622;7190;22493;2235;7086;3171;10821;5406;17907
210407;201403;2094;7414;1880;7084;202;716;1419;5581;1621;6297
210408;201403;2159;8745;2065;8631;89;364;1876;8031;1965;8395
210409;201403;3932;14292;3743;13999;281;1085;3017;11589;3298;12674
210410;201403;3579;11597;3354;11318;360;1145;2772;9595;3132;10740
210420;201403;4205;14059;3934;13584;352;1223;3158;11125;3510;12348
210430;201403;2054;6601;2011;6548;158;544;1716;5627;1874;6171
210440;201403;4246;13408;4153;13264;210;680;3704;11953;3914;12633
210450;201403;2892;9238;2650;8870;233;846;2137;7152;2370;7998
210455;201403;4178;12647;3616;11802;758;2553;2227;7485;2985;10038
210460;201403;4053;13115;3813;12800;212;817;3262;11045;3474;11862
210462;201403;1784;6446;1719;6317;178;689;1305;4896;1483;5585
210465;201403;2708;8910;2557;8719;381;1113;1983;7095;2364;8208
210467;201403;6214;20857;5822;20371;480;1486;4856;17664;5336;19150
210470;201403;1937;5537;1576;5012;93;329;1250;4021;1343;4350
210480;201403;13689;46048;12177;43985;3878;13971;5888;23063;9766;37034
210490;201403;3442;10483;3208;10137;345;1159;2511;7960;2856;9119
210500;201403;6739;26594;6476;26135;727;2856;5027;21098;5754;23954
210510;201403;6890;22991;6658;22724;344;760;5878;21075;6222;21835
210515;201403;3467;11368;3376;11257;184;549;3056;10367;3240;10916
210520;201403;2727;8667;2556;8421;214;707;2097;7048;2311;7755
210530;201403;39956;133364;34833;125544;11289;43899;16715;61456;28004;105355
210535;201403;3138;11114;3064;10979;169;608;2684;9733;2853;10341
210540;201403;12807;44735;11453;42566;2974;10940;5821;23655;8795;34595
210542;201403;6439;18748;5648;17885;333;952;4958;16112;5291;17064
210545;201403;2237;7570;2136;7398;89;419;1845;6360;1934;6779
210547;201403;3748;13283;3517;12930;262;942;2872;10778;3134;11720
210550;201403;6372;18160;5557;17254;304;732;5016;16014;5320;16746
210560;201403;4098;13167;3714;12547;270;1046;3054;10301;3324;11347
210565;201403;1542;5341;1339;5038;134;631;990;3708;1124;4339
210570;201403;12684;36650;11584;35375;1034;2703;9634;30554;10668;33257
210580;201403;3122;9580;2776;9140;362;1000;2107;7448;2469;8448
210590;201403;4459;13795;4197;13481;306;956;3612;11822;3918;12778
210592;201403;2481;7972;2411;7864;104;395;2106;6856;2210;7251
210594;201403;2751;7973;2329;7417;160;478;1958;6403;2118;6881
210596;201403;2828;10658;2699;10426;339;1342;1983;7809;2322;9151
210598;201403;2003;6214;1878;6064;117;462;1665;5318;1782;5780
210600;201403;3318;9888;3078;9554;399;1239;2322;7257;2721;8496
210610;201403;2663;8560;2396;8236;252;926;1955;6753;2207;7679
210620;201403;1824;5661;1690;5488;61;162;1538;5070;1599;5232
210630;201403;3467;12859;3055;12060;554;2190;1834;7542;2388;9732
210632;201403;4818;16724;4435;16189;503;1827;3492;12991;3995;14818
210635;201403;1875;6753;1810;6658;104;362;1607;6025;1711;6387
210637;201403;2754;9485;2638;9323;134;487;2351;8427;2485;8914
210640;201403;4267;14375;4176;14273;26;84;4078;14021;4104;14105
210650;201403;6828;20924;6716;20788;174;501;6384;19914;6558;20415
210660;201403;7510;23468;7042;22740;286;797;6431;20928;6717;21725
210663;201403;2690;7891;2549;7708;150;526;2167;6583;2317;7109
210667;201403;1685;6187;1615;6081;87;404;1401;5295;1488;5699
210670;201403;4740;17717;4597;17472;456;1750;3566;13972;4022;15722
210675;201403;4837;13597;4585;13280;324;858;3936;11658;4260;12516
210680;201403;4540;12925;4071;12389;238;686;3503;10833;3741;11519
210690;201403;6832;23517;6561;23226;296;1029;5967;21390;6263;22419
210700;201403;2607;7364;2329;7043;228;448;1847;6169;2075;6617
210710;201403;4907;16072;4721;15780;199;702;4174;14033;4373;14735
210720;201403;2432;9061;2323;8904;154;664;2010;7705;2164;8369
210725;201403;1184;4417;1029;4137;130;575;639;2618;769;3193
210730;201403;1215;3812;1077;3658;116;347;868;3042;984;3389
210735;201403;3821;14139;3601;13756;672;2600;2420;9583;3092;12183
210740;201403;5040;14037;4708;13702;209;501;4347;12912;4556;13413
210745;201403;3696;11429;3494;11148;338;907;2845;9295;3183;10202
210750;201403;20176;56578;18497;54661;2337;6952;14594;43888;16931;50840
210760;201403;5915;16362;5641;16066;78;245;5465;15585;5543;15830
210770;201403;6225;17114;5309;16070;267;876;4693;14241;4960;15117
210780;201403;8646;29328;8068;28255;1153;4265;5623;20100;6776;24365
210790;201403;4815;14637;4169;13914;313;817;3551;12413;3864;13230
210800;201403;5005;14259;4583;13793;219;709;3894;12180;4113;12889
210805;201403;3724;15846;3630;15664;191;852;3121;13780;3312;14632
210810;201403;5650;17313;5104;16685;492;1153;4311;14842;4803;15995
210820;201403;8963;25931;8432;25206;1604;4811;5541;17100;7145;21911
210825;201403;5528;18692;5361;18482;255;875;4788;16758;5043;17633
210830;201403;8469;26535;8150;26181;361;1018;7334;24106;7695;25124
210840;201403;3774;10557;3497;10168;337;814;2735;8127;3072;8941
210845;201403;5508;17656;5310;17434;295;809;4657;15839;4952;16648
210850;201403;6024;22425;5648;21762;967;4170;3855;14905;4822;19075
210860;201403;17253;53859;16214;52466;1386;4821;13159;42872;14545;47693
210870;201403;6449;21273;5864;20522;794;2670;4311;15561;5105;18231
210880;201403;4128;13545;4048;13435;223;746;3619;12148;3842;12894
210890;201403;5362;16304;5031;15888;498;1741;4057;12796;4555;14537
210900;201403;4729;15549;4341;14882;1516;5352;1876;6773;3392;12125
210905;201403;1823;5798;1733;5678;123;309;1470;4969;1593;5278
210910;201403;10564;33498;9939;32526;1932;6784;6412;21167;8344;27951
210920;201403;3426;11480;3337;11365;163;523;2987;10371;3150;10894
210923;201403;1525;5710;1463;5614;199;802;1037;4153;1236;4955
210927;201403;4685;14952;4570;14834;36;97;4498;14656;4534;14753
210930;201403;2666;9740;2564;9604;210;956;2138;7987;2348;8943
210940;201403;2902;11561;2857;11471;311;1142;2303;9496;2614;10638
210945;201403;5949;17592;5742;17380;195;248;5482;17010;5677;17258
210950;201403;5622;17737;4947;16739;680;2377;3495;12146;4175;14523
210955;201403;1928;6475;1748;6184;301;1154;1161;4186;1462;5340
210960;201403;9267;30832;8932;30337;2425;7994;5466;19629;7891;27623
210970;201403;1378;5038;1226;4813;174;764;877;3482;1051;4246
210975;201403;1714;6032;1634;5888;169;628;1265;4627;1434;5255
210980;201403;9001;22592;8786;22351;662;1423;7667;19978;8329;21401
210990;201403;16578;48188;13308;44311;2670;9499;8288;28309;10958;37808
211000;201403;16262;53027;14860;51265;1039;3661;12634;44470;13673;48131
211003;201403;5125;18032;4709;17403;607;2401;3342;12713;3949;15114
211010;201403;6707;22790;6552;22606;134;450;6151;21473;6285;21923
211020;201403;7485;23155;7378;22994;196;390;7018;22145;7214;22535
211023;201403;2431;8305;2362;8182;171;613;1964;6948;2135;7561
211027;201403;3055;11937;2943;11761;289;1086;2332;9729;2621;10815
211030;201403;4251;13101;3835;12627;839;2295;2709;9556;3548;11851
211040;201403;4135;15980;4024;15797;158;671;3529;14156;3687;14827
211050;201403;10172;27606;10019;27429;457;1201;9314;25637;9771;26838
211060;201403;5824;21306;5710;21095;707;2431;4493;17155;5200;19586
211065;201403;1710;5949;1582;5780;61;234;1462;5393;1523;5627
211070;201403;8694;29598;8223;28783;798;2826;6486;23171;7284;25997
211080;201403;1336;4195;1099;3869;88;437;891;3051;979;3488
211085;201403;2046;6897;1773;6521;319;1147;1214;4624;1533;5771
211090;201403;3556;11209;3357;10937;220;859;2827;9147;3047;10006
211100;201403;6812;17993;6648;17800;94;341;6315;16860;6409;17201
211102;201403;3117;11649;3013;11501;338;1219;2445;9620;2783;10839
211105;201403;2825;9001;2500;8558;203;754;2053;7042;2256;7796
211107;201403;4518;14106;4158;13625;228;740;3624;12119;3852;12859
211110;201403;6538;19761;5210;17888;930;3117;3325;12101;4255;15218
211120;201403;32157;89806;28214;84870;4259;12486;19855;62284;24114;74770
211125;201403;2198;7127;2003;6826;181;618;1620;5608;1801;6226
211130;201403;147673;438316;139026;427300;29672;91148;92043;290820;121715;381968
211140;201403;5647;18230;5363;17786;291;1028;4608;15341;4899;16369
211150;201403;9948;30349;9411;29681;727;2316;7978;25533;8705;27849
211153;201403;3202;9700;2942;9401;334;887;2392;8018;2726;8905
211157;201403;1248;4139;1076;3877;139;606;737;2743;876;3349
211160;201403;4218;14527;3658;13595;393;1686;2689;10007;3082;11693
211163;201403;1714;5684;1634;5576;59;205;1467;5114;1526;5319
211167;201403;1475;5073;1375;4913;54;217;1224;4398;1278;4615
211170;201403;6752;18153;6545;17902;151;507;6090;16599;6241;17106
211172;201403;2385;7072;2108;6656;175;675;1700;5247;1875;5922
211174;201403;2844;8481;2620;8200;126;512;2272;7040;2398;7552
211176;201403;5630;16512;4803;15563;590;1612;3722;12696;4312;14308
211178;201403;3143;10011;3078;9939;73;186;2944;9617;3017;9803
211180;201403;4450;15874;4176;15450;421;1693;3266;12287;3687;13980
211190;201403;2811;9525;2573;9183;134;577;2193;7887;2327;8464
211195;201403;1464;4644;1265;4402;117;399;1022;3664;1139;4063
211200;201403;2164;7572;1959;7298;289;1008;1411;5585;1700;6593
211210;201403;6837;22129;6661;21871;506;1638;5653;18826;6159;20464
211220;201403;35641;107018;31436;101572;7306;24427;18902;63110;26208;87537
211223;201403;5947;17228;5538;16577;768;2373;3720;11668;4488;14041
211227;201403;1580;5916;1503;5796;145;664;1181;4551;1326;5215
211230;201403;9027;30757;8346;29587;1336;4837;5767;20962;7103;25799
211240;201403;8400;28361;8167;28092;357;1266;7496;25961;7853;27227
211245;201403;5192;15340;5125;15257;181;452;4775;14426;4956;14878
211250;201403;12005;44267;11432;43603;1473;4314;9226;37452;10699;41766
211260;201403;8276;26178;8161;26014;477;1449;7350;23697;7827;25146
211270;201403;10085;36098;9550;35392;651;2697;7922;29796;8573;32493
211280;201403;12284;36343;11805;35781;1346;3386;9731;30726;11077;34112
211285;201403;2020;7132;1756;6660;432;1736;834;3340;1266;5076
211290;201403;7744;25489;7565;25274;669;1954;6379;21898;7048;23852
211300;201403;8667;26759;7884;25630;613;2102;6467;21200;7080;23302
211400;201403;12239;36269;10599;34410;2545;8276;6056;21874;8601;30150
220005;201403;1703;5061;1633;4953;52;239;1431;4221;1483;4460
220010;201403;1740;4632;1321;4104;131;487;1017;3091;1148;3578
220020;201403;3721;11488;3535;11171;621;2115;2300;7224;2921;9339
220025;201403;2152;5380;1963;5086;52;161;1728;4436;1780;4597
220027;201403;1406;3867;1308;3745;107;246;1095;3228;1202;3474
220030;201403;3372;10138;3306;10030;309;1001;2728;8317;3037;9318
220040;201403;8505;26583;8138;25982;1648;5494;4953;15958;6601;21452
220045;201403;1446;4694;1316;4480;139;525;938;3158;1077;3683
220050;201403;4845;14052;4271;13226;362;1364;3413;10388;3775;11752
220060;201403;2064;5424;1967;5309;104;285;1776;4803;1880;5088
220070;201403;2581;7669;2308;7275;212;674;1780;5686;1992;6360
220080;201403;830;2584;788;2515;97;390;552;1694;649;2084
220090;201403;1841;4906;1631;4609;134;455;1303;3585;1437;4040
220095;201403;670;1898;641;1850;28;85;591;1693;619;1778
220100;201403;1409;4277;1210;3949;139;450;894;2989;1033;3439
220105;201403;2249;7448;2091;7149;211;743;1500;5168;1711;5911
220110;201403;3590;10488;3172;9877;276;1029;2559;7834;2835;8863
220115;201403;2175;8052;2100;7932;325;1276;1597;6099;1922;7375
220117;201403;1428;3803;1182;3449;79;250;953;2763;1032;3013
220120;201403;12785;37038;11904;35946;379;1445;10820;32627;11199;34072
220130;201403;827;2991;731;2869;57;170;632;2569;689;2739
220140;201403;1614;4360;1493;4208;289;654;1140;3390;1429;4044
220150;201403;7282;23030;6983;22612;433;1679;5915;19076;6348;20755
220155;201403;1056;3370;900;3078;82;349;618;2059;700;2408
220157;201403;1053;2728;968;2604;44;116;824;2221;868;2337
220160;201403;2876;8631;2587;8135;190;741;1976;6155;2166;6896
220170;201403;1309;4240;1205;4062;106;406;952;3221;1058;3627
220173;201403;2107;6423;1741;5724;80;372;1397;4527;1477;4899
220177;201403;1728;5108;1699;5060;73;229;1558;4644;1631;4873
220180;201403;1165;3195;1040;3001;60;201;787;2222;847;2423
220190;201403;4690;15445;4132;14739;529;1913;3158;11450;3687;13363
220191;201403;1468;4967;1404;4856;262;864;966;3390;1228;4254
220192;201403;1760;5074;1420;4485;165;525;988;3142;1153;3667
220194;201403;1733;5087;1573;4812;188;640;1136;3379;1324;4019
220196;201403;2069;6233;1940;6016;215;757;1464;4525;1679;5282
220198;201403;1328;3702;1080;3374;22;74;1005;3170;1027;3244
220200;201403;4672;16219;4430;15846;742;2882;3043;10886;3785;13768
220202;201403;2072;6543;1886;6208;61;256;1652;5407;1713;5663
220205;201403;2940;7759;2602;7309;97;374;2262;6254;2359;6628
220207;201403;920;2846;805;2646;98;365;596;1947;694;2312
220208;201403;1685;5863;1551;5635;269;1147;1019;3655;1288;4802
220209;201403;1579;4988;1453;4774;95;377;1111;3663;1206;4040
220210;201403;1877;4998;1649;4703;95;328;1285;3674;1380;4002
220211;201403;1658;4997;1572;4883;104;469;1296;3967;1400;4436
220213;201403;1836;5356;1718;5139;108;379;1349;3972;1457;4351
220217;201403;1800;5932;1737;5853;75;226;1583;5413;1658;5639
220220;201403;11777;34027;10863;32586;1355;3988;7636;23560;8991;27548
220225;201403;1000;3099;924;2983;42;181;791;2515;833;2696
220230;201403;6093;16219;5095;14883;263;788;4438;13028;4701;13816
220240;201403;2702;8747;2576;8519;203;757;2012;6590;2215;7347
220245;201403;1445;3984;1349;3856;61;158;1185;3431;1246;3589
220250;201403;3375;9179;3047;8745;59;143;2827;8216;2886;8359
220253;201403;1866;5586;1626;5166;125;462;1191;3812;1316;4274
220255;201403;1780;5080;1577;4731;109;430;1275;3709;1384;4139
220260;201403;5239;16949;4730;16001;477;1795;3466;11733;3943;13528
220265;201403;1243;4538;1185;4440;110;515;861;3211;971;3726
220270;201403;6749;22461;6587;22174;424;1915;5557;18251;5981;20166
220271;201403;1551;4400;1472;4284;75;216;1273;3756;1348;3972
220272;201403;1789;5611;1663;5412;109;450;1303;4212;1412;4662
220273;201403;1313;3796;1150;3546;115;384;860;2631;975;3015
220275;201403;2102;5617;1808;5241;78;251;1570;4557;1648;4808
220277;201403;2597;7122;2211;6537;169;548;1703;5071;1872;5619
220280;201403;1789;4673;1565;4347;107;395;1243;3393;1350;3788
220285;201403;1684;4593;1512;4356;97;295;1252;3704;1349;3999
220290;201403;6622;21623;5624;20348;565;2184;4336;15917;4901;18101
220300;201403;1929;6318;1705;6017;98;442;1437;5063;1535;5505
220310;201403;2633;8548;2192;8019;89;280;1971;7444;2060;7724
220320;201403;3421;10184;2881;9280;447;1516;1999;6480;2446;7996
220323;201403;1434;5333;1312;5158;191;831;950;3749;1141;4580
220325;201403;1284;4060;1184;3869;158;561;781;2623;939;3184
220327;201403;1372;4402;1250;4197;72;347;996;3283;1068;3630
220330;201403;3773;10754;3579;10502;283;906;2997;8858;3280;9764
220335;201403;2125;6122;1921;5874;100;362;1633;5023;1733;5385
220340;201403;1858;5314;1638;4999;160;537;1253;3796;1413;4333
220342;201403;1213;4007;1164;3931;118;467;849;2999;967;3466
220345;201403;2910;7981;2503;7332;81;223;2171;6379;2252;6602
220350;201403;4489;12156;3973;11469;294;943;3133;9052;3427;9995
220360;201403;1488;4074;1179;3593;108;355;854;2603;962;2958
220370;201403;9181;26626;8406;25607;473;1369;7436;22828;7909;24197
220375;201403;1580;4934;1468;4784;84;318;1304;4231;1388;4549
220380;201403;1428;3899;1235;3632;87;280;962;2840;1049;3120
220385;201403;737;2002;655;1858;32;112;540;1487;572;1599
220390;201403;10316;32737;9471;31103;2505;8740;4134;13704;6639;22444
220400;201403;1461;3528;1313;3319;60;184;1130;2784;1190;2968
220410;201403;1388;4006;1189;3733;109;449;936;2856;1045;3305
220415;201403;889;2406;802;2290;90;249;595;1718;685;1967
220420;201403;2274;6656;2063;6232;160;466;1642;4986;1802;5452
220430;201403;2979;8724;2834;8530;372;1157;2132;6438;2504;7595
220435;201403;1672;4937;1552;4747;80;260;1290;3938;1370;4198
220440;201403;2821;8507;2351;7976;141;399;2080;7188;2221;7587
220450;201403;2737;8171;2374;7677;588;2010;1394;4520;1982;6530
220455;201403;1430;4387;1284;4187;51;175;1157;3816;1208;3991
220460;201403;1052;2914;1002;2843;72;204;855;2418;927;2622
220465;201403;2488;8216;2299;7936;562;2101;1358;4700;1920;6801
220470;201403;4085;12342;3712;11700;252;889;2857;8888;3109;9777
220480;201403;2370;7157;2181;6881;166;549;1783;5642;1949;6191
220490;201403;2426;7062;2296;6891;137;495;1953;5825;2090;6320
220500;201403;3436;9238;2903;8326;163;645;2347;6542;2510;7187
220510;201403;2947;8291;2230;7215;86;394;1756;5637;1842;6031
220515;201403;1989;4987;1760;4700;89;243;1476;3957;1565;4200
220520;201403;5103;14508;4795;14076;219;623;4208;12484;4427;13107
220525;201403;1473;4192;1370;4042;110;408;1102;3172;1212;3580
220527;201403;1459;4628;1358;4414;156;502;1027;3415;1183;3917
220530;201403;1214;3571;1120;3426;108;412;912;2709;1020;3121
220535;201403;895;2805;863;2758;84;328;678;2127;762;2455
220540;201403;3652;12236;3519;12028;289;1164;2851;9729;3140;10893
220545;201403;1445;4992;1389;4897;205;816;963;3349;1168;4165
220550;201403;9402;30963;8909;30090;1578;5696;5918;20033;7496;25729
220551;201403;1442;4939;1349;4783;132;555;1032;3621;1164;4176
220552;201403;1686;5333;1450;4926;128;592;1057;3452;1185;4044
220553;201403;1642;4896;1416;4577;87;313;1154;3728;1241;4041
220554;201403;934;2609;814;2445;116;353;578;1774;694;2127
220555;201403;2445;7235;2294;7047;100;340;1958;6106;2058;6446
220556;201403;1486;4733;1357;4485;105;429;1011;3312;1116;3741
220557;201403;1640;5445;1510;5200;215;821;972;3351;1187;4172
220558;201403;1033;3273;961;3142;108;414;721;2312;829;2726
220559;201403;1563;4470;1437;4280;75;251;1223;3642;1298;3893
220560;201403;1767;4413;1478;4019;85;234;1226;3321;1311;3555
220570;201403;7581;24293;7131;23666;1222;3824;5104;17559;6326;21383
220580;201403;6614;21689;6448;21493;406;1336;5747;19407;6153;20743
220585;201403;1954;7265;1889;7148;143;582;1571;5971;1714;6553
220590;201403;1440;4526;1305;4322;270;926;787;2657;1057;3583
220595;201403;2500;7269;2309;7014;88;308;2056;6262;2144;6570
220600;201403;1341;3379;1148;3146;225;506;744;2183;969;2689
220605;201403;2087;6217;1847;5843;112;363;1446;4592;1558;4955
220610;201403;2833;8806;2747;8684;171;673;2325;7279;2496;7952
220620;201403;7834;26886;7584;26519;417;1660;6600;23133;7017;24793
220630;201403;417;1281;359;1177;69;262;187;603;256;865
220635;201403;1892;6749;1766;6472;151;648;1154;4213;1305;4861
220640;201403;2818;8357;2689;8169;280;957;2061;6260;2341;7217
220650;201403;2498;7047;2248;6659;144;478;1798;5289;1942;5767
220660;201403;2535;8354;2066;7751;226;977;1671;6229;1897;7206
220665;201403;1228;4238;1177;4158;53;233;1035;3630;1088;3863
220667;201403;1771;6003;1687;5889;86;338;1440;5030;1526;5368
220669;201403;1889;6239;1768;6015;269;1035;1199;4070;1468;5105
220670;201403;2170;6626;2039;6460;177;461;1728;5681;1905;6142
220672;201403;2313;6730;2232;6628;242;695;1846;5568;2088;6263
220675;201403;1378;4033;1292;3891;147;403;938;2883;1085;3286
220680;201403;2257;7441;2167;7308;218;707;1709;5905;1927;6612
220690;201403;1739;4972;1557;4675;130;470;1218;3611;1348;4081
220695;201403;888;2700;840;2621;76;263;638;1981;714;2244
220700;201403;9117;26675;8321;25498;786;2636;6381;19584;7167;22220
220710;201403;776;2347;675;2170;68;195;480;1579;548;1774
220720;201403;2155;5840;2042;5687;99;217;1814;5151;1913;5368
220730;201403;1385;3854;1213;3593;54;198;1016;2976;1070;3174
220735;201403;1059;2779;897;2506;69;223;667;1866;736;2089
220740;201403;1407;4538;1197;4247;259;870;789;2955;1048;3825
220750;201403;4019;11859;3789;11509;561;1509;2797;8851;3358;10360
220755;201403;1207;3554;1134;3437;70;209;946;2876;1016;3085
220760;201403;2674;9450;2498;9194;135;552;2157;8012;2292;8564
220770;201403;23846;82061;22303;79209;7713;28651;8778;32250;16491;60901
220775;201403;1225;3065;1196;3033;20;35;1167;2977;1187;3012
220777;201403;1705;4893;1598;4735;129;393;1282;3772;1411;4165
220779;201403;1185;3582;1150;3533;69;266;1015;3077;1084;3343
220780;201403;6291;16568;5691;15786;474;1263;4637;13081;5111;14344
220785;201403;1357;3657;1316;3573;65;176;1199;3243;1264;3419
220790;201403;9524;31182;9168;30524;985;3536;7128;23630;8113;27166
220793;201403;921;2650;853;2538;67;220;690;2046;757;2266
220795;201403;1547;4363;1499;4291;110;345;1265;3638;1375;3983
220800;201403;17336;49603;16136;47824;1891;6477;12097;35216;13988;41693
220810;201403;3377;10009;2934;9219;238;910;2280;7089;2518;7999
220820;201403;5648;15862;5177;15249;308;996;4414;13073;4722;14069
220830;201403;7753;22114;7381;21501;924;2683;5538;16358;6462;19041
220840;201403;15017;48626;13755;46070;3611;12399;6090;21133;9701;33532
220850;201403;2749;10013;2637;9840;330;1340;2042;7668;2372;9008
220855;201403;628;1960;560;1835;56;214;395;1284;451;1498
220860;201403;952;2675;889;2575;50;201;726;2058;776;2259
220865;201403;2675;7537;2182;6726;110;497;1744;5227;1854;5724
220870;201403;2443;8114;2156;7757;125;496;1881;6780;2006;7276
220880;201403;5429;14334;4979;13789;245;822;4366;12090;4611;12912
220885;201403;1346;4769;1190;4493;114;527;868;3269;982;3796
220887;201403;1358;3639;1190;3408;48;145;1059;3057;1107;3202
220890;201403;1630;5822;1462;5558;143;531;1164;4563;1307;5094
220900;201403;1931;5757;1727;5337;118;353;1379;4315;1497;4668
220910;201403;1732;5156;1546;4883;72;260;1343;4286;1415;4546
220915;201403;1050;3051;930;2845;51;224;729;2161;780;2385
220920;201403;1328;4933;1263;4846;124;552;954;3651;1078;4203
220930;201403;1486;4841;1320;4623;101;409;1073;3789;1174;4198
220935;201403;1049;3273;954;3077;64;282;698;2162;762;2444
220937;201403;1563;4357;1339;3969;69;246;1052;3045;1121;3291
220940;201403;1469;4516;1360;4284;102;391;1039;3252;1141;3643
220945;201403;493;1774;456;1667;55;245;312;1133;367;1378
220950;201403;1272;3264;933;2683;41;163;698;1949;739;2112
220955;201403;1634;4549;1392;4174;125;416;1067;3186;1192;3602
220960;201403;840;2356;733;2171;58;227;555;1603;613;1830
220965;201403;1695;5174;1606;5047;67;276;1391;4360;1458;4636
220970;201403;2159;5810;1589;4858;174;531;1060;3276;1234;3807
220975;201403;594;2170;591;2163;51;193;522;1912;573;2105
220980;201403;1500;4521;1342;4233;126;456;898;2922;1024;3378
220985;201403;1362;3954;1297;3858;127;443;966;2831;1093;3274
220987;201403;1500;4929;1407;4765;119;479;1059;3513;1178;3992
220990;201403;1815;5359;1596;4974;74;319;1237;3787;1311;4106
220995;201403;1246;3754;1017;3407;82;317;763;2592;845;2909
220997;201403;2118;6810;2021;6650;128;440;1802;5926;1930;6366
221000;201403;4503;14040;4201;13525;581;2000;2970;9578;3551;11578
221005;201403;1424;4577;1348;4435;447;1416;654;2258;1101;3674
221010;201403;1247;3384;1096;3186;57;180;934;2731;991;2911
221020;201403;1930;6038;1814;5824;124;551;1374;4312;1498;4863
221030;201403;1808;5073;1585;4757;87;366;1266;3730;1353;4096
221035;201403;1569;4288;1425;4109;88;250;1242;3630;1330;3880
221037;201403;638;1974;579;1872;37;162;462;1429;499;1591
221038;201403;644;1843;521;1641;47;169;347;1092;394;1261
221039;201403;938;2788;885;2708;69;228;748;2273;817;2501
221040;201403;5232;16177;4961;15732;416;1438;3873;12441;4289;13879
221050;201403;3773;11720;3495;11314;221;866;2947;9467;3168;10333
221060;201403;9276;25478;7956;23678;896;2786;5931;17774;6827;20560
221062;201403;1284;4551;1204;4419;34;112;1124;4151;1158;4263
221063;201403;1143;3709;1067;3570;347;1139;554;2001;901;3140
221065;201403;2743;8122;2571;7844;317;962;1939;5958;2256;6920
221070;201403;4401;13542;4000;12925;260;1003;3156;10175;3416;11178
221080;201403;3497;9573;3158;9112;223;733;2570;7430;2793;8163
221090;201403;1340;3738;1183;3498;50;196;971;2822;1021;3018
221093;201403;1820;5456;1734;5288;388;1257;923;2747;1311;4004
221095;201403;981;2672;850;2490;35;104;763;2260;798;2364
221097;201403;811;2348;726;2201;61;249;546;1633;607;1882
221100;201403;125030;385409;118573;374744;25731;89530;74662;230934;100393;320464
221110;201403;10110;33778;9695;33253;717;2830;8142;27890;8859;30720
221120;201403;4416;14771;4225;14428;1205;4111;2436;8635;3641;12746
221130;201403;4699;14136;4170;13078;1079;3527;2153;6724;3232;10251
221135;201403;1472;4714;1382;4577;177;685;1022;3334;1199;4019
221140;201403;1411;3609;1304;3467;146;334;1043;2840;1189;3174
221150;201403;1246;3243;1049;2899;30;127;834;2279;864;2406
221160;201403;911;2430;860;2350;62;186;651;1792;713;1978
221170;201403;1109;3628;1063;3528;72;289;866;2843;938;3132
230010;201403;3429;9384;2819;8330;189;667;2233;6580;2422;7247
230015;201403;2674;9545;2527;9224;433;1841;1689;6012;2122;7853
230020;201403;14337;47996;13865;47124;1031;3822;11266;38526;12297;42348
230030;201403;12524;37418;11789;36265;965;3300;9401;28905;10366;32205
230040;201403;4554;13064;3900;11937;327;1148;2987;9062;3314;10210
230050;201403;2555;8902;2200;7989;393;1565;1090;3975;1483;5540
230060;201403;2010;6104;1794;5698;144;531;1330;4195;1474;4726
230070;201403;4691;13080;4176;12352;395;1257;3120;9436;3515;10693
230075;201403;8771;32673;8291;31663;877;4193;6180;23320;7057;27513
230080;201403;2345;6649;2002;6161;130;461;1621;4978;1751;5439
230090;201403;3487;10757;3131;10118;298;1170;2358;7489;2656;8659
230100;201403;17382;54288;16028;51728;4363;14976;7652;25010;12015;39986
230110;201403;14025;46647;13149;44796;2612;9703;7586;25771;10198;35474
230120;201403;8030;22482;7124;21237;826;2682;5229;15694;6055;18376
230125;201403;2933;8735;2467;7849;197;795;1814;5689;2011;6484
230130;201403;5616;18997;4801;17220;463;1971;3358;11896;3821;13867
230140;201403;3502;11542;3042;10696;460;1735;1924;6920;2384;8655
230150;201403;1758;5637;1549;5212;292;1151;946;3038;1238;4189
230160;201403;6365;19554;5619;18448;596;2174;4132;13638;4728;15812
230170;201403;6566;21111;5706;19506;509;2029;4083;13811;4592;15840
230180;201403;1952;5679;1725;5270;148;553;1196;3581;1344;4134
230185;201403;4186;14251;3899;13704;721;2554;2403;8805;3124;11359
230190;201403;12225;41260;11321;39467;2265;8972;6244;21570;8509;30542
230195;201403;4986;15804;4535;15079;348;1500;3503;11293;3851;12793
230200;201403;5731;16976;5162;15873;682;2179;3593;11094;4275;13273
230205;201403;4393;14107;3946;13349;377;1634;2826;9508;3203;11142
230210;201403;9240;26977;8166;25275;2413;7619;3848;12438;6261;20057
230220;201403;13649;40989;12645;39274;1971;6884;8412;25770;10383;32654
230230;201403;7396;24822;6676;23311;1142;4133;3974;14068;5116;18201
230240;201403;13420;39820;12223;37649;826;3145;9398;28426;10224;31571
230250;201403;10263;31833;10050;31526;559;2105;8453;26368;9012;28473
230260;201403;14887;51341;13885;49279;3128;11801;7321;26614;10449;38415
230270;201403;6781;20975;6045;19704;679;2436;4444;14553;5123;16989
230280;201403;20218;61814;18571;59003;2847;9353;12614;40448;15461;49801
230290;201403;5133;15979;4509;14732;652;2205;2948;9766;3600;11971
230300;201403;4752;14992;4569;14710;529;1969;3373;10754;3902;12723
230310;201403;4919;14972;4373;14072;392;1576;3243;10228;3635;11804
230320;201403;7404;24172;6943;23361;843;3237;5006;16863;5849;20100
230330;201403;4711;14275;4213;13305;412;1512;2949;9204;3361;10716
230340;201403;3402;12009;3204;11578;543;2189;1938;6859;2481;9048
230350;201403;18329;57136;16545;54050;2978;10662;10133;33448;13111;44110
230360;201403;3021;9121;2650;8444;336;1227;1874;5904;2210;7131
230365;201403;2975;8743;2633;8175;199;739;2007;6195;2206;6934
230370;201403;55232;185803;51378;179217;15630;57241;23937;86236;39567;143477
230380;201403;7125;20916;6133;19236;572;2039;4287;13443;4859;15482
230390;201403;3658;11753;3274;11126;399;1639;2251;7560;2650;9199
230393;201403;3396;11454;2931;10473;266;1328;2048;7054;2314;8382
230395;201403;4897;15793;4580;15172;699;2664;2974;9753;3673;12417
230400;201403;5152;16331;4528;15421;422;1792;3449;11519;3871;13311
230410;201403;15780;50701;14270;47885;2541;9174;8289;27919;10830;37093
230420;201403;24252;81688;22834;78786;5785;21808;11011;37800;16796;59608
230423;201403;4820;15879;4492;15261;528;1998;3085;10679;3613;12677
230425;201403;5467;18689;5053;17747;743;2855;3352;11707;4095;14562
230426;201403;2832;8011;2348;7117;156;632;1734;5124;1890;5756
230427;201403;1766;5454;1345;4526;125;468;885;2890;1010;3358
230428;201403;9166;30504;8952;30124;1816;6850;5580;18569;7396;25419
230430;201403;4624;15156;4377;14674;437;1776;3168;10443;3605;12219
230435;201403;4984;16653;4495;15786;1047;4063;2227;7949;3274;12012
230440;201403;358281;1127442;338589;1091952;87957;305907;161753;523029;249710;828936
230445;201403;4737;12997;4049;12004;360;1076;3005;9101;3365;10177
230450;201403;3688;12023;3183;11114;468;1880;2000;6978;2468;8858
230460;201403;1927;6485;1773;6191;196;815;1265;4384;1461;5199
230465;201403;4212;12841;3450;11439;325;1376;2261;7307;2586;8683
230470;201403;11340;41910;10944;41121;1490;6024;7791;29782;9281;35806
230480;201403;1478;4820;1296;4472;232;835;792;2763;1024;3598
230490;201403;2977;8796;2626;8152;471;1674;1346;4104;1817;5778
230495;201403;5707;19454;5194;18604;939;3986;2995;10725;3934;14711
230500;201403;10704;36752;10263;36002;895;3467;7803;27951;8698;31418
230510;201403;1526;5554;1292;4969;321;1325;506;2037;827;3362
230520;201403;5026;15453;4431;14407;515;1964;2975;9592;3490;11556
230523;201403;13779;46474;12716;44122;3739;14416;3526;12407;7265;26823
230526;201403;4164;13018;3682;12174;409;1591;2550;8432;2959;10023
230530;201403;5237;17720;4838;17178;1080;3893;3090;11164;4170;15057
230533;201403;4001;11510;3594;10735;248;814;2730;8074;2978;8888
230535;201403;5440;16427;4819;15308;521;1763;3473;11172;3994;12935
230540;201403;18986;55270;16923;52209;1163;4239;13754;42137;14917;46376
230550;201403;20150;61968;18459;58759;4356;15078;9450;29791;13806;44869
230560;201403;6555;19173;5902;17987;256;1035;4759;14316;5015;15351
230565;201403;3274;9673;2696;8512;282;989;1828;5727;2110;6716
230570;201403;3974;10952;3562;10429;228;829;2928;8472;3156;9301
230580;201403;10435;32519;9969;31861;626;2107;8614;27793;9240;29900
230590;201403;9485;30480;8633;28925;794;3308;6317;20767;7111;24075
230600;201403;3673;10510;2798;8678;204;714;1876;5744;2080;6458
230610;201403;6103;20441;5731;19853;839;3146;4038;14136;4877;17282
230620;201403;2073;5979;1739;5291;163;600;1106;3267;1269;3867
230625;201403;7666;25855;6935;24171;2022;7662;2184;7639;4206;15301
230630;201403;11282;37371;10369;35590;2633;8843;5064;18428;7697;27271
230640;201403;26827;90705;25321;88466;3856;14303;17919;63350;21775;77653
230650;201403;4969;16075;4578;15301;398;1691;3459;11323;3857;13014
230655;201403;8690;33270;8381;32763;733;3003;6952;27506;7685;30509
230660;201403;6372;20250;5642;18939;547;2236;4018;13554;4565;15790
230670;201403;5987;16544;4923;14727;258;954;3774;10985;4032;11939
230680;201403;2795;8317;2385;7579;390;1354;1417;4508;1807;5862
230690;201403;6372;21299;6234;21036;515;2215;4505;14888;5020;17103
230700;201403;9269;27445;8270;25672;879;3339;5623;16925;6502;20264
230710;201403;7695;25147;6883;23664;897;3099;4927;17385;5824;20484
230720;201403;1957;6186;1694;5680;233;862;1102;3710;1335;4572
230725;201403;3772;12885;3392;11965;691;2622;1799;6243;2490;8865
230730;201403;56887;176641;48725;163918;13453;49396;21164;72386;34617;121782
230740;201403;5403;17336;5094;16770;322;1373;4160;13501;4482;14874
230750;201403;9015;26437;7724;24336;690;2602;5769;18032;6459;20634
230760;201403;10257;32021;9925;31266;1450;5443;6904;20817;8354;26260
230763;201403;4208;13535;3973;13064;324;1470;3006;9522;3330;10992
230765;201403;41761;139141;39040;133626;12387;45718;13388;46395;25775;92113
230770;201403;23791;67413;22110;65012;2134;7090;16402;48022;18536;55112
230780;201403;5975;23938;5739;23363;1467;6014;2835;12342;4302;18356
230790;201403;2570;8857;2463;8672;300;1176;1863;6599;2163;7775
230800;201403;7895;28903;7300;27548;1764;7127;3376;12850;5140;19977
230810;201403;12498;41350;11948;40418;1422;5056;9010;30931;10432;35987
230820;201403;3453;11889;3074;11065;597;2409;1649;5937;2246;8346
230830;201403;7893;24240;7099;22792;732;2744;4949;15809;5681;18553
230835;201403;4152;11459;3566;10658;291;974;2755;8210;3046;9184
230837;201403;3152;10998;2760;10198;393;1651;1782;6606;2175;8257
230840;201403;9390;31549;8615;30162;1284;4897;5755;20504;7039;25401
230850;201403;11342;34840;10588;33863;1367;4911;7715;24593;9082;29504
230860;201403;5067;15468;4676;14728;403;1517;3500;10922;3903;12439
230870;201403;18990;53319;17144;50290;1645;5590;12729;37019;14374;42609
230880;201403;1928;6773;1802;6523;261;1090;1166;4178;1427;5268
230890;201403;4102;15018;3760;14311;528;2331;2408;9023;2936;11354
230900;201403;2999;10198;2650;9456;551;1976;1391;5096;1942;7072
230910;201403;2976;9165;2449;8157;254;1021;1700;5548;1954;6569
230920;201403;4711;13965;4353;13522;324;1093;3570;11260;3894;12353
230930;201403;7785;24133;7046;22759;911;3154;4815;15612;5726;18766
230940;201403;7692;22176;6832;20904;398;1234;5667;17536;6065;18770
230945;201403;5834;17989;5078;16921;581;2122;3581;12105;4162;14227
230950;201403;6932;19400;5980;18107;420;1408;4614;14026;5034;15434
230960;201403;12505;40770;11574;38958;2697;9938;5520;18624;8217;28562
230970;201403;13414;43607;12253;41322;2632;10155;6029;19841;8661;29996
230980;201403;2861;9532;2595;8972;879;3057;1033;3796;1912;6853
230990;201403;1633;5122;1342;4517;161;693;873;2853;1034;3546
231000;201403;2877;7883;2306;6796;268;927;1445;4113;1713;5040
231010;201403;3024;8835;2646;8232;292;1150;1935;5901;2227;7051
231020;201403;8019;27139;7592;26274;1451;5261;4632;16399;6083;21660
231025;201403;7827;25046;7092;23760;1223;4255;4439;15255;5662;19510
231030;201403;8033;26821;6897;24460;1359;5155;3871;13883;5230;19038
231040;201403;2996;10132;2725;9562;276;1155;1888;6528;2164;7683
231050;201403;12128;35823;10709;33259;1121;3845;7578;23574;8699;27419
231060;201403;2425;7837;2232;7489;193;875;1594;5190;1787;6065
231070;201403;9325;29945;8671;28664;1587;5699;5210;17320;6797;23019
231080;201403;4303;13642;3968;13049;274;1227;2943;9317;3217;10544
231085;201403;4767;15528;4628;15293;768;2640;3289;11105;4057;13745
231090;201403;4107;11761;3447;10445;209;777;2495;7429;2704;8206
231095;201403;2231;7564;1952;7013;241;932;1328;4843;1569;5775
231100;201403;3036;9615;2556;8649;227;852;1819;6077;2046;6929
231110;201403;3748;12696;3658;12540;399;1469;2650;9158;3049;10627
231120;201403;2426;8026;2262;7738;385;1370;1442;4995;1827;6365
231123;201403;2234;6157;1905;5608;145;420;1502;4444;1647;4864
231126;201403;6712;18830;5517;17120;405;1459;4155;12759;4560;14218
231130;201403;20162;64086;18570;61282;4699;16300;9462;32582;14161;48882
231135;201403;4667;13835;3957;12734;388;1489;2864;9067;3252;10556
231140;201403;15453;51288;14421;49190;1492;6859;10012;32762;11504;39621
231150;201403;5934;17638;5113;16097;1011;3564;2676;8187;3687;11751
231160;201403;5787;20017;5520;19507;1389;5173;3259;11541;4648;16714
231170;201403;4776;15566;4437;14891;482;1979;2997;9906;3479;11885
231180;201403;15075;46486;13872;44191;2651;9236;8273;26015;10924;35251
231190;201403;5081;14333;4255;13148;364;1286;3263;9981;3627;11267
231195;201403;4633;16053;4052;14914;388;1699;2987;11039;3375;12738
231200;201403;7647;27009;6801;25297;691;3208;4761;17443;5452;20651
231210;201403;5108;16033;4445;15111;317;1387;3400;11631;3717;13018
231220;201403;14165;41026;12144;37583;1223;4465;7866;24474;9089;28939
231230;201403;8680;31219;8159;30280;917;3974;6139;22735;7056;26709
231240;201403;11800;38419;10731;36453;1711;6504;6522;22346;8233;28850
231250;201403;2068;6079;1443;4557;307;989;548;1650;855;2639
231260;201403;4020;11556;3661;11054;510;1640;2440;7525;2950;9165
231270;201403;7691;21939;6878;20619;626;2474;4961;14481;5587;16955
231280;201403;1742;5833;1643;5635;164;601;1197;4147;1361;4748
231290;201403;33306;119210;30710;112789;7647;30925;12464;44658;20111;75583
231300;201403;4586;13652;3813;12071;347;1330;2671;8149;3018;9479
231310;201403;7551;22090;6449;19860;1330;4293;3308;10099;4638;14392
231320;201403;6976;21955;6201;20442;427;1716;4633;15212;5060;16928
231325;201403;2574;8017;2318;7563;198;725;1715;5624;1913;6349
231330;201403;14172;44597;12078;40592;2027;6943;7337;24993;9364;31936
231335;201403;5146;15066;4546;13970;312;1243;3593;10800;3905;12043
231340;201403;18012;59613;16965;58125;1502;4976;13599;47942;15101;52918
231350;201403;12290;42237;12056;41877;1490;4985;9519;33900;11009;38885
231355;201403;4278;14114;4132;13869;245;845;3526;12011;3771;12856
231360;201403;7268;24261;6725;23322;1799;6119;3693;13445;5492;19564
231370;201403;2403;6905;1946;6212;109;418;1460;4597;1569;5015
231375;201403;4129;14394;3935;14028;402;1827;3007;10486;3409;12313
231380;201403;5282;17433;4980;17014;844;3055;3313;11603;4157;14658
231390;201403;3452;11014;3268;10741;291;1153;2443;7946;2734;9099
231395;201403;4263;13886;3839;13208;783;2834;2296;8083;3079;10917
231400;201403;10473;31709;9611;30149;976;3567;6686;21042;7662;24609
231410;201403;13419;46753;12642;45590;1397;5056;9556;35319;10953;40375
240010;201403;2460;7814;2207;7236;540;1987;947;2973;1487;4960
240020;201403;11880;37691;10690;35445;2856;10205;4707;15863;7563;26068
240030;201403;2544;7636;2472;7521;222;867;1951;5784;2173;6651
240040;201403;804;2429;688;2208;53;257;487;1477;540;1734
240050;201403;3705;10244;3239;9454;215;763;2450;7050;2665;7813
240060;201403;1447;4382;1378;4265;127;476;1046;3139;1173;3615
240070;201403;2867;8370;2735;8125;478;1502;1722;5060;2200;6562
240080;201403;3159;8530;2816;8081;273;744;2202;6442;2475;7186
240090;201403;2246;6224;1920;5602;62;259;1520;4334;1582;4593
240100;201403;10317;30070;9627;28724;1266;4488;5922;17433;7188;21921
240110;201403;5230;16113;4675;15116;940;3464;2668;8248;3608;11712
240120;201403;3016;10120;2918;9940;591;2188;1771;6148;2362;8336
240130;201403;2805;7778;2435;7211;214;764;1855;5418;2069;6182
240140;201403;2205;6924;1976;6490;410;1525;1042;3374;1452;4899
240145;201403;6235;19739;5643;18681;1608;5975;2719;8939;4327;14914
240150;201403;1022;3166;847;2817;135;550;494;1578;629;2128
240160;201403;1461;4844;1332;4619;155;616;913;3199;1068;3815
240165;201403;930;3027;829;2820;116;419;525;1827;641;2246
240170;201403;2550;7800;2305;7339;598;2065;1044;3370;1642;5435
240180;201403;2996;9465;2811;9145;724;2497;1421;4798;2145;7295
240185;201403;1501;5040;1461;4968;187;661;1066;3688;1253;4349
240190;201403;966;2969;903;2845;88;341;643;1983;731;2324
240200;201403;14553;37970;12263;35189;2424;7099;7400;22291;9824;29390
240210;201403;2774;8001;2578;7739;242;840;2097;6241;2339;7081
240220;201403;7309;23873;6998;23434;383;1684;6095;20188;6478;21872
240230;201403;5528;15833;5092;15078;444;1531;3916;11453;4360;12984
240240;201403;1817;5759;1409;4673;382;1364;290;859;672;2223
240250;201403;2881;8390;2739;8186;212;775;2186;6430;2398;7205
240260;201403;14969;50584;14300;49486;2519;9882;9184;31768;11703;41650
240270;201403;2385;7927;2268;7717;261;898;1643;5720;1904;6618
240280;201403;1648;4752;1487;4463;130;476;1073;3177;1203;3653
240290;201403;1433;4527;1237;4169;114;544;793;2561;907;3105
240300;201403;2166;6143;1642;5023;414;1386;578;1712;992;3098
240310;201403;10482;30218;9602;28790;2196;7184;4906;14708;7102;21892
240320;201403;2053;6180;1701;5454;103;450;1202;3708;1305;4158
240325;201403;38163;107091;30557;94546;9509;32028;9100;28694;18609;60722
240330;201403;1551;4724;1322;4268;164;671;807;2489;971;3160
240340;201403;1659;5017;1466;4720;235;807;984;3178;1219;3985
240350;201403;2144;6561;2019;6379;244;929;1585;4920;1829;5849
240360;201403;7445;22634;6554;21325;1086;3818;4180;13970;5266;17788
240370;201403;2036;5654;1797;5261;136;494;1324;3851;1460;4345
240375;201403;898;2413;806;2282;144;457;461;1270;605;1727
240380;201403;2695;8117;2253;7151;341;1135;1279;4025;1620;5160
240390;201403;922;2635;769;2338;77;288;522;1563;599;1851
240400;201403;1465;3975;1268;3690;145;499;910;2560;1055;3059
240410;201403;546;1788;500;1692;74;299;319;1064;393;1363
240420;201403;4934;18796;4748;18372;1458;5732;2249;9269;3707;15001
240430;201403;3536;10299;3282;9856;343;1171;2354;7009;2697;8180
240440;201403;2723;7361;2547;7051;670;1944;1319;3671;1989;5615
240450;201403;3894;11770;3551;11130;529;2012;2151;6620;2680;8632
240460;201403;2886;9348;2802;9214;296;1182;2182;7082;2478;8264
240470;201403;3670;11329;2988;9895;480;1734;1748;5736;2228;7470
240480;201403;420;1103;380;1023;38;91;238;639;276;730
240485;201403;2147;6574;1914;6139;405;1421;1047;3365;1452;4786
240490;201403;1679;4331;1468;4030;84;317;1145;3025;1229;3342
240500;201403;2118;6463;2028;6314;216;753;1529;4764;1745;5517
240510;201403;1790;5568;1675;5347;237;832;1202;3860;1439;4692
240520;201403;1449;4257;1279;4008;212;763;843;2576;1055;3339
240530;201403;2221;7103;1997;6744;268;972;1406;4751;1674;5723
240540;201403;1861;5693;1791;5573;174;620;1333;4123;1507;4743
240550;201403;792;2288;710;2153;54;195;541;1595;595;1790
240560;201403;3302;9702;3132;9447;343;1099;2472;7459;2815;8558
240570;201403;3119;8987;2578;7786;602;2071;1116;3063;1718;5134
240580;201403;8191;25636;7746;24885;1280;4421;5548;17726;6828;22147
240590;201403;849;2434;758;2279;54;213;549;1609;603;1822
240600;201403;1538;4621;1243;4011;179;658;690;2136;869;2794
240610;201403;5028;14241;4435;13179;558;1820;2849;8303;3407;10123
240615;201403;1063;3077;887;2744;153;485;496;1549;649;2034
240620;201403;1677;5534;1566;5334;228;860;1147;3903;1375;4763
240630;201403;2069;6406;1972;6241;193;592;1463;4831;1656;5423
240640;201403;925;2759;787;2541;98;428;514;1601;612;2029
240650;201403;3769;11815;3498;11418;307;1140;2771;9074;3078;10214
240660;201403;2519;8117;2413;7943;279;974;1799;6028;2078;7002
240670;201403;2759;8353;2369;7568;345;1268;1334;4150;1679;5418
240680;201403;1516;4496;1242;3996;170;572;722;2359;892;2931
240690;201403;1098;3136;971;2927;103;370;691;2065;794;2435
240700;201403;2681;8118;2261;7323;132;583;1723;5416;1855;5999
240710;201403;18679;48034;16633;45411;3190;8822;10081;28514;13271;37336
240720;201403;5645;16508;5406;16141;1591;5179;2656;7858;4247;13037
240725;201403;1077;3254;832;2706;78;264;469;1501;547;1765
240730;201403;2285;7137;2058;6706;200;723;1434;4629;1634;5352
240740;201403;2281;6896;2061;6493;268;906;1342;4249;1610;5155
240750;201403;2259;8417;2086;8093;467;1962;1138;4500;1605;6462
240760;201403;1221;3718;1158;3629;105;302;927;3030;1032;3332
240770;201403;3555;10452;3258;10007;406;1394;2311;7111;2717;8505
240780;201403;6026;17069;4980;15420;889;2949;2818;8923;3707;11872
240790;201403;863;2697;702;2397;56;213;512;1761;568;1974
240800;201403;41168;120344;37585;114224;10667;34720;15242;47008;25909;81728
240810;201403;94809;287019;89536;277454;28692;92737;39666;124822;68358;217559
240820;201403;6951;20880;6045;19459;1163;4156;3140;10481;4303;14637
240830;201403;9434;29129;8937;28404;767;2601;7240;23354;8007;25955
240840;201403;1310;3688;1140;3407;117;422;697;2055;814;2477
240850;201403;1175;3663;931;3158;192;721;456;1471;648;2192
240860;201403;1327;3780;1143;3485;89;316;829;2481;918;2797
240870;201403;1174;3292;1012;2977;123;439;660;1836;783;2275
240880;201403;1189;4104;1129;4018;144;640;799;2795;943;3435
240890;201403;5508;15689;4842;14504;856;2881;2590;7671;3446;10552
240895;201403;2795;9619;2559;9204;385;1479;1725;6312;2110;7791
240910;201403;2673;8561;2475;8184;239;941;1838;6029;2077;6970
240920;201403;864;2823;792;2659;200;750;386;1256;586;2006
240930;201403;3655;9928;3320;9489;310;930;2605;7538;2915;8468
240933;201403;1501;4454;1339;4179;270;952;746;2325;1016;3277
240940;201403;6626;18875;5652;17169;1167;3759;2944;8945;4111;12704
240950;201403;1163;3695;1104;3600;102;434;778;2518;880;2952
240960;201403;783;2508;714;2368;77;322;514;1681;591;2003
240970;201403;2064;5872;1767;5366;168;605;1218;3667;1386;4272
240980;201403;3322;11046;3119;10660;703;2634;1828;6223;2531;8857
240990;201403;3076;9254;2898;8903;573;1986;1761;5283;2334;7269
241000;201403;1093;3110;962;2884;94;349;689;2032;783;2381
241010;201403;3011;10178;2737;9677;449;1827;1803;6229;2252;8056
241020;201403;2111;6037;1775;5401;185;664;1069;3107;1254;3771
241025;201403;1533;4804;1425;4602;129;548;1005;3174;1134;3722
241030;201403;2562;8484;2337;8081;160;613;1836;6419;1996;7032
241040;201403;2165;7637;2003;7340;227;964;1443;5330;1670;6294
241050;201403;1337;3998;1218;3792;112;456;899;2703;1011;3159
241060;201403;1000;2909;917;2775;117;371;678;2062;795;2433
241070;201403;921;2681;806;2470;94;350;552;1634;646;1984
241080;201403;1179;3566;1050;3338;85;360;722;2219;807;2579
241090;201403;2193;6372;1902;5856;131;551;1523;4629;1654;5180
241100;201403;1214;3662;1072;3337;97;339;729;2236;826;2575
241105;201403;1152;3569;1098;3471;198;679;646;2109;844;2788
241110;201403;863;2765;735;2488;82;354;443;1463;525;1817
241120;201403;7978;24304;7293;23218;1494;4882;4693;15329;6187;20211
241140;201403;3460;9821;3090;9092;414;1277;2027;5891;2441;7168
241142;201403;700;2115;508;1696;147;561;132;394;279;955
241150;201403;5814;17624;5357;16838;917;3048;3462;11016;4379;14064
241160;201403;1123;3300;1060;3179;170;561;713;2134;883;2695
241170;201403;1371;4049;1261;3841;162;540;770;2446;932;2986
241180;201403;1020;2814;817;2442;110;371;468;1337;578;1708
241190;201403;1088;3072;933;2767;79;307;623;1733;702;2040
241200;201403;20848;63019;19394;60676;5296;17761;9492;30233;14788;47994
241210;201403;1527;4505;1295;4041;287;1008;604;1857;891;2865
241220;201403;7972;27123;7622;26457;1827;6737;4123;14667;5950;21404
241230;201403;3061;9250;2793;8864;210;788;2230;7049;2440;7837
241240;201403;1115;3288;859;2726;76;244;490;1622;566;1866
241250;201403;5524;17689;4827;16290;308;1531;3827;12562;4135;14093
241255;201403;1867;7168;1777;6967;485;1985;771;3172;1256;5157
241260;201403;5061;13778;4110;12297;341;1287;2888;8466;3229;9753
241270;201403;2069;6246;1819;5760;257;933;1035;3292;1292;4225
241280;201403;2155;6325;2011;6040;385;1211;1240;3795;1625;5006
241290;201403;3305;9215;2674;8206;487;1596;1532;4709;2019;6305
241300;201403;1422;4173;1283;3950;78;275;1003;3112;1081;3387
241310;201403;1550;4920;1478;4804;228;724;1023;3444;1251;4168
241320;201403;911;3081;850;2951;169;653;457;1602;626;2255
241330;201403;1542;4914;1451;4789;157;620;1161;3788;1318;4408
241335;201403;2627;8181;2494;7950;212;666;2053;6600;2265;7266
241340;201403;1965;6165;1770;5753;462;1660;822;2604;1284;4264
241350;201403;1949;6299;1836;6079;164;698;1384;4451;1548;5149
241355;201403;1278;3615;1138;3375;72;243;985;2892;1057;3135
241360;201403;2127;5953;1884;5487;139;487;1351;3780;1490;4267
241370;201403;1348;4210;1104;3688;197;718;561;1843;758;2561
241380;201403;723;2103;631;1916;99;357;337;1013;436;1370
241390;201403;2939;9919;2787;9630;638;2309;1647;5840;2285;8149
241400;201403;3724;11083;3485;10758;430;1547;2613;8047;3043;9594
241410;201403;2715;8091;2464;7753;456;1555;1647;5167;2103;6722
241415;201403;1590;4920;1480;4721;131;507;1086;3403;1217;3910
241420;201403;2223;7796;1960;7338;607;2512;664;2458;1271;4970
241430;201403;479;1465;421;1327;51;182;273;830;324;1012
241440;201403;5987;22099;5629;21481;1013;4084;3900;15052;4913;19136
241445;201403;1046;3251;988;3166;163;466;739;2506;902;2972
241450;201403;3269;9232;3018;8878;461;1519;2093;6093;2554;7612
241460;201403;3584;10574;3217;9862;287;1081;2301;6965;2588;8046
241470;201403;1341;3840;1167;3627;137;546;852;2571;989;3117
241475;201403;1235;3899;1091;3631;68;324;781;2532;849;2856
241480;201403;3252;10661;2977;10244;991;3532;1101;4151;2092;7683
241490;201403;634;1724;523;1553;56;228;356;992;412;1220
241500;201403;760;2400;717;2349;11;47;678;2228;689;2275
250010;201403;2695;8602;2388;8069;221;934;1741;5756;1962;6690
250020;201403;1686;4885;1311;4207;113;475;851;2622;964;3097
250030;201403;7954;22955;7238;21970;918;2855;5374;16691;6292;19546
250040;201403;4507;15329;4195;14725;820;3081;2557;9059;3377;12140
250050;201403;3620;11563;3408;11257;534;1970;2295;7697;2829;9667
250053;201403;1324;3958;1251;3857;192;647;821;2534;1013;3181
250057;201403;720;2721;702;2699;38;117;616;2483;654;2600
250060;201403;4945;15820;4766;15524;648;2418;3537;11318;4185;13736
250070;201403;3971;12516;3736;12109;315;1348;3004;9437;3319;10785
250073;201403;785;2408;703;2254;70;258;495;1579;565;1837
250077;201403;2266;6693;1915;6130;272;945;1082;3510;1354;4455
250080;201403;4748;13977;4593;13755;583;1861;3373;10129;3956;11990
250090;201403;2645;7967;2559;7831;139;524;2149;6455;2288;6979
250100;201403;3986;13550;3816;13247;466;1797;2863;9913;3329;11710
250110;201403;5743;17591;5502;17251;800;2821;4054;12613;4854;15434
250115;201403;554;1834;493;1695;53;251;295;954;348;1205
250120;201403;2246;6722;1944;6158;182;677;1416;4444;1598;5121
250130;201403;5719;17551;5403;17108;311;1115;4501;14410;4812;15525
250135;201403;1088;3357;1000;3203;117;419;693;2240;810;2659
250140;201403;2112;6879;1949;6662;261;936;1427;4967;1688;5903
250150;201403;5079;17261;4684;16521;539;2217;3346;11682;3885;13899
250153;201403;1576;4211;1428;3997;132;465;1102;3061;1234;3526
250157;201403;1625;5731;1503;5474;353;1268;815;3099;1168;4367
250160;201403;3337;10496;3237;10332;217;811;2748;8823;2965;9634
250170;201403;1591;4722;1494;4567;319;1042;916;2850;1235;3892
250180;201403;16723;52717;16206;51833;2544;9485;11132;34614;13676;44099
250190;201403;3985;11950;3709;11477;622;2070;2387;7317;3009;9387
250200;201403;2223;6208;1781;5605;138;497;1456;4552;1594;5049
250205;201403;1006;3355;922;3194;86;405;589;2080;675;2485
250210;201403;1638;5398;1518;5219;190;808;1067;3590;1257;4398
250215;201403;1422;4916;1383;4841;210;852;865;3014;1075;3866
250220;201403;823;2335;684;2158;47;174;584;1824;631;1998
250230;201403;1723;4416;1414;3907;141;442;1090;2935;1231;3377
250240;201403;2669;8559;2367;8095;220;818;1769;6116;1989;6934
250250;201403;4576;13938;4200;13427;392;1344;3362;10845;3754;12189
250260;201403;1912;5884;1683;5500;128;510;1257;4093;1385;4603
250270;201403;1289;4133;1179;3988;164;565;862;2966;1026;3531
250280;201403;3802;11538;3518;11079;731;2369;2177;7144;2908;9513
250290;201403;2143;5724;1775;5246;58;220;1555;4589;1613;4809
250300;201403;5490;16350;5202;15991;620;2565;4086;11993;4706;14558
250310;201403;1161;3715;1053;3532;164;664;735;2411;899;3075
250320;201403;7942;25253;7573;24489;1171;4323;4988;15696;6159;20019
250330;201403;2582;8182;2263;7747;260;1023;1689;5739;1949;6762
250340;201403;1137;3301;1063;3188;52;190;899;2690;951;2880
250350;201403;4553;12473;4162;11990;174;608;3607;10497;3781;11105
250355;201403;2153;6563;1963;6276;113;487;1510;4731;1623;5218
250360;201403;2056;6187;1916;5990;107;390;1498;4716;1605;5106
250370;201403;13684;38984;11937;36891;934;2980;10171;31741;11105;34721
250375;201403;1100;3490;1040;3389;65;262;868;2827;933;3089
250380;201403;1665;4767;1583;4664;102;356;1371;4021;1473;4377
250390;201403;1951;5268;1615;4712;212;672;1059;3103;1271;3775
250400;201403;68666;192464;61459;182001;15102;47972;32582;98099;47684;146071
250403;201403;1507;5063;1455;4986;209;796;1065;3609;1274;4405
250407;201403;1164;3390;1013;3131;66;236;791;2404;857;2640
250410;201403;682;2180;601;2034;67;288;451;1500;518;1788
250415;201403;1827;5807;1690;5543;104;434;1286;4131;1390;4565
250420;201403;1324;4154;1232;4008;103;417;1013;3219;1116;3636
250430;201403;6615;18670;6263;18155;516;1792;5061;14372;5577;16164
250435;201403;1644;5015;1478;4701;186;701;880;2858;1066;3559
250440;201403;4591;13747;4355;13429;278;990;3653;11262;3931;12252
250450;201403;2081;5956;1858;5659;104;375;1639;4980;1743;5355
250460;201403;6347;19436;5933;18869;787;2700;4389;14107;5176;16807
250470;201403;1612;4480;1470;4280;142;508;1067;3039;1209;3547
250480;201403;4011;12050;3629;11504;167;677;3142;9909;3309;10586
250485;201403;622;1666;527;1507;26;100;416;1144;442;1244
250490;201403;4184;13575;4087;13433;812;2873;2654;8799;3466;11672
250500;201403;1912;5906;1792;5702;355;1185;1066;3464;1421;4649
250510;201403;4970;14028;4404;13254;306;1115;3577;10727;3883;11842
250520;201403;1898;5904;1807;5745;350;1260;1029;3197;1379;4457
250523;201403;1801;5750;1714;5630;239;822;1261;4212;1500;5034
250527;201403;1478;4499;1391;4386;58;257;1243;3871;1301;4128
250530;201403;674;2087;593;1981;51;199;480;1608;531;1807
250535;201403;1307;4226;1246;4100;83;357;994;3202;1077;3559
250540;201403;2485;7366;2334;7199;85;277;2131;6632;2216;6909
250550;201403;911;3041;841;2930;73;309;634;2177;707;2486
250560;201403;1756;5700;1719;5646;142;534;1441;4726;1583;5260
250570;201403;2516;8336;2281;7882;202;831;1708;5845;1910;6676
250580;201403;1139;3188;937;2859;131;510;626;1826;757;2336
250590;201403;1056;3255;956;3122;82;350;737;2354;819;2704
250600;201403;7538;21894;7189;21385;649;1925;5794;17464;6443;19389
250610;201403;3438;10219;3211;9879;418;1415;2256;6928;2674;8343
250620;201403;868;2535;807;2415;140;449;511;1514;651;1963
250625;201403;2184;7179;2150;7133;82;222;1983;6676;2065;6898
250630;201403;10387;33787;9887;32909;2310;8269;5336;17816;7646;26085
250640;201403;3889;11587;3646;11302;292;1146;3033;9250;3325;10396
250650;201403;917;2738;870;2649;165;613;452;1396;617;2009
250660;201403;2169;5286;1670;4691;26;67;1578;4456;1604;4523
250670;201403;2728;9218;2593;8967;276;1164;1868;6430;2144;7594
250680;201403;5019;14414;4775;14070;268;953;4073;11990;4341;12943
250690;201403;6336;17052;6130;16777;639;1963;5113;13820;5752;15783
250700;201403;5344;16136;5001;15628;820;2808;3389;10488;4209;13296
250710;201403;4596;14741;4239;14273;680;2342;2909;10110;3589;12452
250720;201403;2540;7775;2428;7584;153;620;1987;6137;2140;6757
250730;201403;3674;11550;3529;11326;484;1754;2505;7984;2989;9738
250740;201403;2042;6103;1794;5677;219;762;1244;3901;1463;4663
250750;201403;102962;307360;97641;299272;19060;64594;61840;186825;80900;251419
250760;201403;2251;6745;2095;6508;206;788;1560;4782;1766;5570
250770;201403;3945;13656;3761;13403;822;3147;2233;8015;3055;11162
250780;201403;1899;5736;1654;5285;196;768;1082;3356;1278;4124
250790;201403;2476;8162;2348;7979;623;2107;1406;4943;2029;7050
250800;201403;2735;8036;2412;7488;167;604;1816;5507;1983;6111
250810;201403;1370;4067;1193;3809;119;480;936;2922;1055;3402
250820;201403;2029;6317;1980;6240;113;419;1648;5240;1761;5659
250830;201403;5936;19834;5664;19294;751;3054;3837;12820;4588;15874
250840;201403;1044;3350;912;3083;120;461;573;1936;693;2397
250850;201403;2445;7127;2182;6701;199;796;1411;4479;1610;5275
250855;201403;1097;3303;1040;3215;67;240;855;2603;922;2843
250860;201403;2896;9953;2688;9547;643;2514;1169;4143;1812;6657
250870;201403;1214;3494;1052;3237;78;300;755;2247;833;2547
250880;201403;1399;4126;1295;3981;157;518;937;2884;1094;3402
250890;201403;9388;30488;8759;29619;1540;6176;5680;18828;7220;25004
250900;201403;3080;10268;2756;9659;315;1130;1907;6814;2222;7944
250905;201403;2116;6690;2022;6564;358;1212;1416;4652;1774;5864
250910;201403;5443;16003;5095;15475;527;1765;3854;11729;4381;13494
250915;201403;1738;5212;1597;5005;151;480;1301;4146;1452;4626
250920;201403;3576;10230;3372;9947;461;1340;2363;7230;2824;8570
250930;201403;1964;6458;1884;6331;362;1425;1251;4109;1613;5534
250933;201403;1195;3877;1151;3806;136;512;823;2732;959;3244
250937;201403;874;2727;786;2549;112;450;469;1509;581;1959
250939;201403;1708;5371;1554;5120;225;796;992;3260;1217;4056
250940;201403;4001;11832;3730;11409;258;923;2922;8991;3180;9914
250950;201403;1385;4309;1264;4154;77;270;1041;3478;1118;3748
250960;201403;1354;4270;1209;4077;73;273;1013;3469;1086;3742
250970;201403;9032;24904;8126;23634;1319;3964;5416;15875;6735;19839
250980;201403;2674;8233;2476;7885;264;1069;1701;5223;1965;6292
250990;201403;2126;7438;2005;7192;290;1221;1363;4798;1653;6019
251000;201403;2578;7387;2123;6737;130;491;1687;5329;1817;5820
251010;201403;2866;8343;2620;7982;215;771;2039;6239;2254;7010
251020;201403;1658;5106;1539;4958;159;559;1246;4065;1405;4624
251030;201403;1322;3753;1206;3559;125;439;766;2262;891;2701
251040;201403;1945;6225;1760;5940;178;829;1257;4084;1435;4913
251050;201403;1139;3405;1012;3185;158;536;551;1811;709;2347
251060;201403;1056;2592;856;2343;84;302;644;1676;728;1978
251065;201403;589;1772;518;1664;75;275;312;962;387;1237
251070;201403;599;1736;572;1694;56;223;443;1232;499;1455
251080;201403;21445;60338;20071;58050;5416;16665;10435;30492;15851;47157
251090;201403;3060;9760;2743;9181;290;1110;1951;6458;2241;7568
251100;201403;1009;3297;908;3118;133;530;590;1969;723;2499
251110;201403;2134;6222;1918;5865;220;746;1311;4017;1531;4763
251120;201403;5992;20637;5822;20340;811;3333;4457;15261;5268;18594
251130;201403;3994;10459;3585;10005;42;128;3453;9656;3495;9784
251140;201403;4422;13765;4137;13320;247;994;3195;10249;3442;11243
251150;201403;2830;9332;2617;9039;341;1382;1891;6596;2232;7978
251160;201403;1894;6314;1823;6219;95;379;1605;5497;1700;5876
251170;201403;1436;4493;1392;4438;137;517;1126;3532;1263;4049
251180;201403;2928;8838;2700;8546;626;2060;1541;4995;2167;7055
251190;201403;4337;12596;4216;12454;277;876;3721;11020;3998;11896
251200;201403;4248;13190;4048;12929;238;877;3512;11241;3750;12118
251203;201403;1339;4242;1253;4059;112;470;763;2569;875;3039
251207;201403;1241;3895;1080;3596;87;371;746;2422;833;2793
251210;201403;8165;23614;7188;22285;1049;3250;5120;16277;6169;19527
251220;201403;1304;3565;1144;3314;176;540;716;2148;892;2688
251230;201403;5215;15857;4613;15147;451;1683;3841;12577;4292;14260
251240;201403;3178;10537;3102;10421;334;1338;2433;8079;2767;9417
251250;201403;10531;31945;9848;30880;1643;5720;6737;20828;8380;26548
251260;201403;543;1678;491;1611;41;146;368;1209;409;1355
251270;201403;4230;13177;4014;12904;161;683;3597;11530;3758;12213
251272;201403;1390;4263;1307;4145;123;401;1020;3302;1143;3703
251274;201403;1007;3207;957;3109;128;521;555;1852;683;2373
251275;201403;1412;4029;1341;3920;139;527;988;2783;1127;3310
251276;201403;1509;4515;1431;4375;217;730;866;2733;1083;3463
251278;201403;628;2032;550;1846;85;320;318;1113;403;1433
251280;201403;2322;7457;2243;7319;291;1073;1635;5312;1926;6385
251290;201403;6100;17626;5818;17267;905;3103;4062;11748;4967;14851
251300;201403;762;2643;708;2564;65;301;505;1792;570;2093
251310;201403;3258;9644;3004;9277;220;848;2394;7328;2614;8176
251315;201403;1715;6115;1670;6030;314;1229;1001;3672;1315;4901
251320;201403;2160;6106;1801;5531;137;503;1288;4017;1425;4520
251330;201403;2063;5395;1715;4944;115;478;1442;4003;1557;4481
251335;201403;1000;3473;952;3386;111;474;678;2369;789;2843
251340;201403;3942;11080;3367;10203;335;1277;2347;6937;2682;8214
251350;201403;1633;5070;1491;4873;255;925;959;3146;1214;4071
251360;201403;1845;6063;1746;5950;122;501;1467;5029;1589;5530
251365;201403;900;2677;729;2316;60;239;472;1469;532;1708
251370;201403;22369;75890;21960;75233;4084;15766;15122;50787;19206;66553
251380;201403;1402;4364;1233;4071;95;410;953;3067;1048;3477
251385;201403;874;2456;801;2341;76;276;544;1543;620;1819
251390;201403;5800;20858;5487;20345;1057;4239;3609;13344;4666;17583
251392;201403;1074;3194;997;3067;114;371;712;2240;826;2611
251394;201403;620;1926;523;1735;35;142;365;1200;400;1342
251396;201403;873;2513;790;2371;90;301;579;1710;669;2011
251398;201403;1133;3308;948;2962;86;328;642;1980;728;2308
251400;201403;1366;3935;1256;3785;151;595;863;2491;1014;3086
251410;201403;1617;4274;1473;4035;166;521;989;2754;1155;3275
251420;201403;2197;6387;1887;6042;188;699;1425;4520;1613;5219
251430;201403;1730;6203;1574;5949;121;545;1276;4831;1397;5376
251440;201403;1465;4446;1250;4032;167;618;866;2754;1033;3372
251445;201403;1581;4958;1509;4851;124;489;1252;3969;1376;4458
251450;201403;4856;15301;4352;14655;171;715;3766;12698;3937;13413
251455;201403;1215;3812;1079;3588;84;367;759;2515;843;2882
251460;201403;875;2717;843;2661;146;470;621;1986;767;2456
251465;201403;501;1582;459;1494;51;206;295;939;346;1145
251470;201403;1305;3782;1084;3368;131;495;612;1913;743;2408
251480;201403;1126;3085;1019;2904;61;235;816;2283;877;2518
251490;201403;2099;6222;1827;5853;308;1165;1149;3595;1457;4760
251500;201403;1760;5847;1714;5774;205;798;1303;4337;1508;5135
251510;201403;2618;8806;2442;8427;426;1583;1458;5087;1884;6670
251520;201403;1100;3060;1008;2918;159;497;537;1565;696;2062
251530;201403;11990;35369;11515;34679;805;3072;9747;28878;10552;31950
251540;201403;2855;9463;2647;9017;276;1166;1956;6617;2232;7783
251550;201403;4014;10042;3394;9268;176;610;2758;7328;2934;7938
251560;201403;751;2325;692;2227;111;459;409;1190;520;1649
251570;201403;1066;3157;918;2861;113;430;576;1821;689;2251
251580;201403;2202;6085;2035;5856;347;931;1457;4322;1804;5253
251590;201403;1705;5667;1683;5643;115;411;1452;4943;1567;5354
251593;201403;1029;3282;975;3199;147;550;618;1962;765;2512
251597;201403;1965;6120;1887;5999;190;747;1438;4460;1628;5207
251600;201403;7399;21958;7054;21393;964;2976;5089;15827;6053;18803
251610;201403;3678;11108;3410;10756;367;1247;2585;8248;2952;9495
251615;201403;1216;3527;1042;3219;109;393;654;2075;763;2468
251620;201403;17517;50022;15530;47503;2348;7646;10938;33922;13286;41568
251630;201403;5386;13740;4728;12932;404;1164;3686;10181;4090;11345
251640;201403;2699;7901;2218;7035;245;936;1536;4816;1781;5752
251650;201403;4389;12545;3961;12013;336;1132;3212;9900;3548;11032
251660;201403;3612;12174;3328;11729;269;1263;2651;9147;2920;10410
251670;201403;4049;11920;3647;11370;131;445;3209;10039;3340;10484
251675;201403;757;2547;720;2484;175;652;385;1301;560;1953
251680;201403;2893;8103;2364;7323;142;603;1932;5869;2074;6472
251690;201403;3480;10928;3237;10491;386;1401;2210;7081;2596;8482
251700;201403;2112;7000;2011;6863;216;845;1574;5355;1790;6200
251710;201403;950;2496;722;2095;100;363;369;1008;469;1371
251720;201403;1408;4383;1300;4203;115;473;994;3149;1109;3622
251740;201403;742;2111;604;1863;118;393;330;1032;448;1425
260005;201403;25056;62360;22226;58540;4947;13502;13160;34737;18107;48239
260010;201403;9648;26515;7789;24195;886;2943;5821;18127;6707;21070
260020;201403;5826;17309;5203;16372;629;1968;3723;12215;4352;14183
260030;201403;5425;16477;5032;15898;530;1858;3858;12175;4388;14033
260040;201403;10251;24963;8503;22978;619;1475;7026;19676;7645;21151
260050;201403;10916;35652;10177;34811;668;2441;8827;30565;9495;33006
260060;201403;4095;11434;3768;10918;340;1027;2934;8604;3274;9631
260070;201403;9501;29083;9076;28463;2290;7808;5326;16675;7616;24483
260080;201403;5509;15986;4911;15124;571;2043;3460;10523;4031;12566
260090;201403;5237;14579;4953;14186;1163;3162;3168;9502;4331;12664
260100;201403;3526;9465;3237;9077;243;896;2587;7285;2830;8181
260105;201403;4539;13716;4386;13429;900;2943;2726;8280;3626;11223
260110;201403;21769;64481;20144;62528;1591;4929;16929;53252;18520;58181
260120;201403;11683;36273;11179;35378;3154;10298;5468;18078;8622;28376
260130;201403;3128;9053;2978;8812;571;1538;1985;6132;2556;7670
260140;201403;13507;35035;11562;32643;1246;4016;8710;24873;9956;28889
260150;201403;3138;9225;2802;8737;237;894;2171;6813;2408;7707
260160;201403;6015;18356;5460;17705;499;1763;4422;14598;4921;16361
260170;201403;17676;48833;16983;47929;1523;4059;13873;39851;15396;43910
260180;201403;3489;10839;3206;10433;243;971;2588;8347;2831;9318
260190;201403;16155;39153;15275;38066;957;2581;13111;32700;14068;35281
260200;201403;11345;33002;10373;31557;1246;3993;7439;23457;8685;27450
260210;201403;11386;35654;10566;34487;777;2880;8664;28562;9441;31442
260220;201403;9042;28692;8844;28400;786;3187;7370;23163;8156;26350
260230;201403;9749;29059;9307;28452;670;2163;7612;23707;8282;25870
260240;201403;2947;9309;2618;8842;408;1466;1791;6104;2199;7570
260250;201403;2771;7506;2558;7240;189;526;2130;6123;2319;6649
260260;201403;11531;34020;11274;33691;963;3201;9282;28252;10245;31453
260270;201403;3556;10857;3351;10554;413;1553;2576;7980;2989;9533
260280;201403;12824;42871;11843;41324;821;3189;9793;34612;10614;37801
260290;201403;33921;103788;32868;102087;5991;21149;21797;66291;27788;87440
260300;201403;8340;25686;7425;24357;604;2416;5845;19178;6449;21594
260310;201403;5146;15526;4844;15059;1583;4645;2296;7749;3879;12394
260320;201403;6861;23339;6421;22701;555;2132;5113;18309;5668;20441
260330;201403;3140;9804;2913;9423;272;1091;1935;6470;2207;7561
260340;201403;1894;5641;1801;5512;122;447;1553;4703;1675;5150
260345;201403;26284;86936;25285;84940;7571;27782;11492;37123;19063;64905
260350;201403;4264;12358;4051;12014;391;1313;3146;9309;3537;10622
260360;201403;2396;7581;2299;7421;561;1938;1249;4107;1810;6045
260370;201403;6075;18948;5543;18004;750;2554;3871;12810;4621;15364
260380;201403;4978;16415;4634;15980;452;1538;3632;12786;4084;14324
260390;201403;4751;14950;4161;14035;501;1923;2958;9829;3459;11752
260392;201403;3508;11200;3320;10951;174;693;2918;9588;3092;10281
260400;201403;13777;41038;13285;40249;2633;9036;8672;25622;11305;34658
260410;201403;62760;187551;59686;182478;20246;62865;26725;84595;46971;147460
260415;201403;4057;13171;3564;12213;544;2224;2123;7187;2667;9411
260420;201403;12137;28608;11114;27520;744;2065;9355;23161;10099;25226
260430;201403;2726;9233;2508;8888;266;1082;1879;6595;2145;7677
260440;201403;3408;10573;3189;10143;562;1997;1881;5875;2443;7872
260450;201403;5112;15794;4869;15375;433;1542;3812;12065;4245;13607
260460;201403;5854;18201;5524;17708;940;3330;3527;11158;4467;14488
260470;201403;5102;14927;4813;14530;512;1652;3753;11548;4265;13200
260480;201403;3876;11485;3482;10887;641;2151;2266;7041;2907;9192
260490;201403;6070;15956;5355;14813;681;2265;3557;9809;4238;12074
260500;201403;6798;18974;6321;18301;739;2278;4618;13594;5357;15872
260510;201403;10425;27706;9745;26790;830;2432;7642;21665;8472;24097
260515;201403;4596;14498;3620;12437;399;1540;2174;7522;2573;9062
260520;201403;15995;43677;15550;43091;3757;9998;9748;28084;13505;38082
260530;201403;10315;30941;9078;29234;535;1639;7794;25639;8329;27278
260540;201403;5814;15240;5536;14937;694;1610;4361;12178;5055;13788
260545;201403;42;162;29;119;4;19;6;23;10;42
260550;201403;2841;9606;2539;9027;680;2701;1142;4047;1822;6748
260560;201403;6774;17559;6103;16601;330;900;5299;14454;5629;15354
260570;201403;6632;22892;6210;22148;1053;4182;4176;14967;5229;19149
260580;201403;3931;11009;3731;10709;335;1076;3068;8665;3403;9741
260590;201403;5963;15446;5756;15206;278;669;5209;13980;5487;14649
260600;201403;25885;81518;24652;79430;4750;16407;15431;50332;20181;66739
260610;201403;7090;21372;6765;20921;1261;4141;4636;14371;5897;18512
260620;201403;17412;54448;16812;53446;3412;12161;10435;32408;13847;44569
260630;201403;2310;6939;2000;6432;221;844;1445;4609;1666;5453
260640;201403;17555;48508;16692;47262;2409;7392;11884;33561;14293;40953
260650;201403;5586;17818;5298;17331;786;2588;3471;12170;4257;14758
260660;201403;8371;23683;7587;22676;627;1974;6221;18790;6848;20764
260670;201403;2432;6956;2055;6450;284;1024;1354;4274;1638;5298
260680;201403;23475;64594;22195;62483;5106;15461;12074;33583;17180;49044
260690;201403;3576;9978;3116;9251;226;836;2461;7214;2687;8050
260700;201403;5592;16677;5481;16562;89;199;5292;16191;5381;16390
260710;201403;1322;4083;1206;3913;141;557;891;2835;1032;3392
260720;201403;17425;57652;16614;56204;4654;16196;8438;29407;13092;45603
260730;201403;7357;24446;6631;23386;886;3274;4850;17378;5736;20652
260740;201403;1350;4161;1191;3877;168;606;729;2401;897;3007
260750;201403;6729;21799;6336;21262;594;1985;5233;17904;5827;19889
260760;201403;4763;13389;4485;13029;525;1640;3366;9829;3891;11469
260765;201403;8005;28464;7780;28143;1528;6358;4938;17769;6466;24127
260770;201403;4315;11305;3958;10835;243;860;3164;8477;3407;9337
260775;201403;5344;15612;5067;15192;620;2222;3576;10411;4196;12633
260780;201403;3973;13242;3848;13014;932;3515;2143;7190;3075;10705
260790;201403;119717;311725;115448;305604;26727;74621;68403;180875;95130;255496
260795;201403;3047;9866;2852;9556;482;1743;1865;6365;2347;8108
260800;201403;4751;13100;4430;12672;244;976;3799;10577;4043;11553
260805;201403;4127;12140;3727;11519;585;1954;2472;7660;3057;9614
260810;201403;7437;21650;7255;21414;473;1665;6293;18472;6766;20137
260820;201403;4585;13359;4308;12983;1339;4104;2241;6844;3580;10948
260825;201403;3063;9931;2890;9673;305;1030;2289;7771;2594;8801
260830;201403;3700;12125;3451;11678;1059;3409;1820;6534;2879;9943
260840;201403;4214;12441;3889;11975;283;1092;3246;9876;3529;10968
260845;201403;4208;12598;3932;12060;700;2296;2550;7832;3250;10128
260850;201403;4956;17111;4537;16211;1122;4607;2143;7417;3265;12024
260860;201403;3025;9964;2822;9626;334;1159;2032;7049;2366;8208
260870;201403;4166;11769;3806;11321;583;1640;2729;8384;3312;10024
260875;201403;7437;20008;6748;18935;1052;3059;4355;12595;5407;15654
260880;201403;9054;29015;8674;28474;1022;3417;6821;22699;7843;26116
260890;201403;14964;43264;14319;42290;1662;5611;10537;31126;12199;36737
260900;201403;6113;19041;5285;17620;1010;3566;3066;10372;4076;13938
260910;201403;3105;9534;2830;9115;308;1158;2164;6970;2472;8128
260915;201403;4563;15303;4430;15116;111;366;4106;14234;4217;14600
260920;201403;3504;10692;3335;10464;519;1798;2383;7624;2902;9422
260930;201403;4178;13334;3749;12725;535;1821;2646;9200;3181;11021
260940;201403;14546;41124;13500;39292;2583;8819;7680;21773;10263;30592
260950;201403;6131;19888;5856;19342;874;3691;3784;11718;4658;15409
260960;201403;67654;190545;64327;185221;13995;43128;36584;106034;50579;149162
260970;201403;5372;17596;5049;17111;657;2602;3599;12122;4256;14724
260980;201403;4041;12901;3851;12651;262;966;3216;10744;3478;11710
260990;201403;18180;57017;16873;55275;2409;7695;12165;41694;14574;49389
261000;201403;15530;44232;12784;39812;2826;9395;6624;21119;9450;30514
261010;201403;2808;7914;2636;7694;240;540;2201;6743;2441;7283
261020;201403;6210;18622;5738;17913;454;1720;4583;13932;5037;15652
261030;201403;3472;11570;3305;11287;332;1240;2598;8841;2930;10081
261040;201403;5400;17597;4702;16474;579;2338;3340;11638;3919;13976
261050;201403;8738;24989;8195;24139;1290;3965;5317;15649;6607;19614
261060;201403;11384;35593;10980;34917;1823;6442;7657;24012;9480;30454
261070;201403;49486;129366;45248;123524;10567;30109;25222;69768;35789;99877
261080;201403;5750;17721;5461;17251;462;1446;4490;14462;4952;15908
261090;201403;16379;46281;15369;44901;1701;5147;11993;35408;13694;40555
261100;201403;7318;23630;6821;22866;625;2523;5296;17646;5921;20169
261110;201403;67069;194191;61585;186290;15743;48962;32681;104477;48424;153439
261120;201403;3651;10051;3338;9657;151;453;2924;8553;3075;9006
261130;201403;7141;18649;6841;18310;280;768;6221;16650;6501;17418
261140;201403;3250;9293;3000;8895;609;2017;1794;5240;2403;7257
261150;201403;5590;16884;5047;16113;742;2655;3489;11262;4231;13917
261153;201403;1983;5762;1683;5341;108;421;1378;4381;1486;4802
261160;201403;224726;592280;215057;579240;48510;134896;125078;345964;173588;480860
261170;201403;6036;17080;5629;16495;926;2787;4042;11968;4968;14755
261180;201403;9552;27436;9253;26997;1207;3656;6957;20501;8164;24157
261190;201403;5450;17328;5204;17012;814;3529;3564;11036;4378;14565
261200;201403;3929;9792;3711;9499;616;1608;2569;6655;3185;8263
261210;201403;1957;5295;1887;5202;157;430;1605;4492;1762;4922
261220;201403;12690;41963;11233;38723;2182;8282;5969;20436;8151;28718
261230;201403;4081;12785;3856;12504;181;644;3443;11198;3624;11842
261240;201403;4928;14709;4688;14262;836;2493;3170;9839;4006;12332
261245;201403;3879;12254;3383;11424;256;1120;2464;8365;2720;9485
261247;201403;3527;10995;3064;10135;405;1426;2094;6997;2499;8423
261250;201403;19485;52861;18792;51947;3602;10175;13581;37769;17183;47944
261255;201403;4389;13502;3953;12792;321;1177;3061;10055;3382;11232
261260;201403;12214;35393;11261;34281;688;1917;9825;30505;10513;32422
261270;201403;3830;11177;3582;10795;514;1698;2471;7408;2985;9106
261280;201403;2753;8564;2520;8225;279;1037;1863;6066;2142;7103
261290;201403;3033;8764;2738;8387;241;838;2219;6873;2460;7711
261300;201403;10397;35251;9430;33568;1697;6835;5854;20681;7551;27516
261310;201403;8500;26014;8120;25383;1923;6354;4681;14640;6604;20994
261320;201403;5960;18809;5633;18184;668;2170;4160;13753;4828;15923
261330;201403;5498;16535;5340;16303;521;1687;4247;13038;4768;14725
261340;201403;4582;15087;4389;14790;671;2660;2816;9462;3487;12122
261350;201403;8005;27454;7608;26762;643;2780;5954;20738;6597;23518
261360;201403;9467;24683;8648;23583;1233;3458;5935;16524;7168;19982
261370;201403;20979;62993;19900;61392;4133;13529;12545;38907;16678;52436
261380;201403;4170;14558;3902;14106;636;2355;2607;9721;3243;12076
261390;201403;17159;53298;15772;50898;2773;9931;9462;30301;12235;40232
261400;201403;4875;17181;4480;16401;627;2602;2990;11045;3617;13647
261410;201403;8260;24609;7832;23944;1132;3583;5557;17335;6689;20918
261420;201403;7990;27048;7738;26670;2035;7713;4328;15102;6363;22815
261430;201403;3607;11269;3087;10578;414;1426;2233;7881;2647;9307
261440;201403;1661;5118;1555;4955;119;481;1248;3940;1367;4421
261450;201403;14195;41598;13828;41111;1039;3284;12086;35950;13125;39234
261460;201403;8513;24741;7982;24003;845;2413;5870;19071;6715;21484
261470;201403;3952;10845;3635;10476;230;742;3104;8916;3334;9658
261480;201403;3483;12837;3264;12439;424;1756;2385;8968;2809;10724
261485;201403;4953;15481;4593;14863;1031;3617;2506;8170;3537;11787
261500;201403;5897;16483;5271;15639;749;2027;3902;12149;4651;14176
261510;201403;2033;6490;1914;6318;169;586;1497;4982;1666;5568
261520;201403;2603;8590;2314;8077;197;797;1631;5714;1828;6511
261530;201403;12468;40807;11141;38256;2520;9650;5191;17765;7711;27415
261540;201403;7372;24018;7129;23586;1579;5082;4631;15799;6210;20881
261550;201403;3477;10580;3341;10383;455;1783;2556;7651;3011;9434
261560;201403;6917;22683;6369;21979;1374;4684;4250;15195;5624;19879
261570;201403;3551;11136;3220;10616;486;1644;2175;7275;2661;8919
261580;201403;5896;18962;5284;17974;468;1772;4175;14473;4643;16245
261590;201403;2881;8081;2549;7629;343;1098;1771;5402;2114;6500
261600;201403;5137;14494;4427;13488;519;1694;3256;10023;3775;11717
261610;201403;2305;7082;2021;6673;152;611;1651;5372;1803;5983
261618;201403;2561;7403;2423;7219;286;920;1860;5512;2146;6432
261620;201403;4586;14212;4362;13873;472;1596;3172;10304;3644;11900
261630;201403;8124;24127;7213;22515;1369;4921;3968;12071;5337;16992
261640;201403;32440;85377;30076;82376;2779;7874;24123;67206;26902;75080
261650;201403;3836;12344;3610;12013;508;1886;2635;8807;3143;10693
270010;201403;4456;17138;4090;16392;522;2407;2759;11095;3281;13502
270020;201403;3932;12186;3686;11803;529;1976;2661;8361;3190;10337
270030;201403;45454;138607;43496;135604;11865;37947;23918;76461;35783;114408
270040;201403;10401;32446;9960;31949;1716;5024;7304;24437;9020;29461
270050;201403;4006;11816;3723;11440;438;1638;2784;8414;3222;10052
270060;201403;1677;5614;1600;5501;389;1467;927;3192;1316;4659
270070;201403;4166;13048;3918;12699;169;762;3403;10884;3572;11646
270080;201403;1306;4180;1176;3975;249;928;707;2353;956;3281
270090;201403;2069;6607;1996;6470;58;232;1815;5837;1873;6069
270100;201403;6458;20326;6196;19977;1397;4769;3939;12680;5336;17449
270110;201403;3438;9857;3177;9554;583;1819;2014;6501;2597;8320
270120;201403;3059;9034;2769;8640;152;573;2357;7399;2509;7972
270130;201403;5104;16144;4866;15862;619;1942;3783;12745;4402;14687
270135;201403;1731;5020;1655;4934;102;202;1487;4582;1589;4784
270140;201403;9488;24602;8460;23286;856;3368;6549;16875;7405;20243
270150;201403;2636;9212;2577;9135;228;936;2175;7673;2403;8609
270160;201403;4977;16960;4611;16497;326;1185;3859;13961;4185;15146
270170;201403;4042;13435;3743;12985;807;3170;1984;6817;2791;9987
270180;201403;2262;7596;2032;7302;178;815;1612;5740;1790;6555
270190;201403;1897;6351;1812;6223;154;603;1416;4905;1570;5508
270200;201403;2744;9302;2586;9057;252;1110;2020;6923;2272;8033
270210;201403;4260;14536;4139;14371;477;1948;3358;11576;3835;13524
270220;201403;1714;5435;1598;5206;294;1126;869;2895;1163;4021
270230;201403;11214;37064;9949;35055;1572;6589;6564;22759;8136;29348
270235;201403;6488;21682;6183;21173;369;1611;5244;17884;5613;19495
270240;201403;9750;29647;8696;28259;1615;5528;5696;18682;7311;24210
270250;201403;3503;9057;3198;8714;200;539;2851;7797;3051;8336
270255;201403;5106;15767;4262;14300;419;1804;2970;9768;3389;11572
270260;201403;6316;20561;6155;20278;883;3413;4469;14753;5352;18166
270270;201403;1197;3480;1108;3345;189;610;696;2048;885;2658
270280;201403;3707;11139;3506;10851;454;1690;2474;7471;2928;9161
270290;201403;8376;29758;7990;29072;902;3717;6116;22168;7018;25885
270300;201403;3302;11551;3139;11360;194;866;2750;9936;2944;10802
270310;201403;7223;22734;6563;21579;424;1929;5266;16923;5690;18852
270320;201403;6357;20943;6155;20594;1698;6468;3116;10414;4814;16882
270330;201403;4872;16244;4609;15890;429;1609;3722;12951;4151;14560
270340;201403;1780;5571;1617;5358;214;754;1187;4022;1401;4776
270350;201403;2096;5910;1947;5723;317;956;1264;3966;1581;4922
270360;201403;2089;6575;2045;6522;267;836;1633;5348;1900;6184
270370;201403;1720;5674;1597;5459;190;739;1074;3811;1264;4550
270375;201403;2892;9082;2759;8888;412;1657;1968;6086;2380;7743
270380;201403;6092;18769;5793;18348;634;2064;4388;14214;5022;16278
270390;201403;1444;4026;1305;3852;184;627;882;2529;1066;3156
270400;201403;5958;18648;5516;18006;545;2112;4017;12927;4562;15039
270410;201403;5029;15673;4802;15252;601;2079;3440;10878;4041;12957
270420;201403;5487;18127;5339;17920;285;1317;4512;14896;4797;16213
270430;201403;141703;416005;136150;408263;36685;113002;74130;229107;110815;342109
270440;201403;5020;15681;4769;15302;390;1448;3778;12212;4168;13660
270450;201403;6528;20665;6330;20410;634;2440;5011;16130;5645;18570
270460;201403;3610;10056;3258;9568;293;1063;2589;7432;2882;8495
270470;201403;10862;35565;10387;34746;1682;5715;6805;23492;8487;29207
270480;201403;3101;9973;2873;9568;354;1430;1872;6001;2226;7431
270490;201403;992;3215;938;3134;98;405;698;2291;796;2696
270500;201403;5356;18642;5180;18387;535;1967;4084;14902;4619;16869
270510;201403;6074;18888;5564;18174;945;3967;3919;12096;4864;16063
270520;201403;3739;12192;3531;11856;1003;3627;1761;6005;2764;9632
270530;201403;1547;4583;1378;4362;224;727;921;3006;1145;3733
270540;201403;2040;7162;1889;6935;174;858;1483;5315;1657;6173
270550;201403;7088;21618;6319;20598;1130;3908;4084;13653;5214;17561
270560;201403;3010;9564;2860;9326;559;2113;1900;6027;2459;8140
270570;201403;4343;14360;4007;13846;497;2069;2725;9392;3222;11461
270580;201403;2016;6818;1942;6695;318;1185;1367;4770;1685;5955
270590;201403;1394;4782;1311;4638;94;424;1114;3902;1208;4326
270600;201403;2843;9676;2601;9329;217;1076;2008;6998;2225;8074
270610;201403;3263;10434;3041;10109;336;1203;2348;7792;2684;8995
270620;201403;1487;5054;1355;4857;147;688;1019;3558;1166;4246
270630;201403;18374;51582;17336;49993;2733;8010;12245;35933;14978;43943
270640;201403;5896;18494;5373;17852;454;1901;4366;14259;4820;16160
270642;201403;2503;8633;2344;8376;427;1750;1477;5286;1904;7036
270644;201403;2345;6991;2152;6775;235;661;1768;5710;2003;6371
270650;201403;4058;13045;3910;12840;878;3486;2209;6992;3087;10478
270660;201403;2463;6448;1999;5729;143;525;1420;3997;1563;4522
270670;201403;15680;43173;13776;40887;1816;5733;10082;30655;11898;36388
270680;201403;4161;12887;4033;12737;248;737;3590;11481;3838;12218
270690;201403;8832;25381;8257;24688;2854;8406;3722;12122;6576;20528
270700;201403;802;2526;765;2468;129;515;476;1481;605;1996
270710;201403;5620;19139;5397;18840;712;2542;4177;14806;4889;17348
270720;201403;3330;11555;3100;11160;288;1343;2450;8678;2738;10021
270730;201403;6651;20823;6348;20440;1246;3997;4410;14546;5656;18543
270740;201403;2395;7183;2258;6981;383;1306;1444;4449;1827;5755
270750;201403;4783;15655;4489;15207;580;2052;3375;11549;3955;13601
270760;201403;3572;10805;3249;10276;415;1403;2317;7371;2732;8774
270770;201403;18018;49299;15462;46170;3083;9798;9444;28873;12527;38671
270780;201403;1933;6334;1804;6136;276;1003;1253;4319;1529;5322
270790;201403;1652;5292;1514;5069;409;1493;721;2418;1130;3911
270800;201403;11354;34543;10697;33682;993;3462;8655;27287;9648;30749
270810;201403;3430;10639;2836;9545;397;1566;1719;5765;2116;7331
270820;201403;1893;6459;1743;6192;298;1197;1120;3949;1418;5146
270830;201403;5380;16697;4939;16127;1187;4409;2866;9345;4053;13754
270840;201403;7500;25974;6876;25171;485;2323;5697;20612;6182;22935
270850;201403;7619;25363;7459;25171;1514;6362;5029;16005;6543;22367
270860;201403;11604;35326;10890;34354;1745;6544;7754;23817;9499;30361
270870;201403;2299;6817;1875;5922;314;1055;1096;3467;1410;4522
270880;201403;7866;25885;7457;25298;543;2340;6222;20792;6765;23132
270890;201403;2663;8245;2480;7938;414;1577;1662;5187;2076;6764
270895;201403;3048;11401;2901;11209;284;1134;2353;9276;2637;10410
270900;201403;1926;5343;1588;4851;102;391;1217;3617;1319;4008
270910;201403;3206;11336;3148;11217;308;1402;2524;8746;2832;10148
270915;201403;9980;34450;9120;32883;1939;7952;4985;17825;6924;25777
270920;201403;6359;20180;5982;19652;305;1422;5195;16865;5500;18287
270930;201403;17179;47365;14321;43797;3133;10203;7953;25074;11086;35277
270940;201403;5831;20040;5663;19833;853;3300;4163;14614;5016;17914
280010;201403;717;2141;633;2005;70;287;404;1257;474;1544
280020;201403;4990;15101;4464;14142;941;3142;2623;8331;3564;11473
280030;201403;73495;197494;66061;186372;16948;50678;33001;94478;49949;145156
280040;201403;3197;10108;2885;9678;365;1271;2124;7327;2489;8598
280050;201403;4130;13414;3871;13021;1115;3819;2012;7083;3127;10902
280060;201403;4270;14566;4121;14317;947;3616;2419;8460;3366;12076
280067;201403;7627;21950;6514;20439;758;2626;4775;14965;5533;17591
280070;201403;1868;6566;1797;6461;344;1323;1200;4360;1544;5683
280100;201403;4058;12884;3665;12174;1031;3599;1688;5737;2719;9336
280110;201403;1417;4342;1306;4160;97;386;1043;3285;1140;3671
280120;201403;7953;25389;7417;24547;1300;4020;5011;17543;6311;21563
280130;201403;7832;22897;7381;22228;1316;4518;4829;14306;6145;18824
280140;201403;5505;15372;4996;14691;624;1872;3762;11221;4386;13093
280150;201403;3361;10600;3107;10140;492;1870;1938;6075;2430;7945
280160;201403;1542;4449;1410;4243;173;605;999;2991;1172;3596
280170;201403;4633;14148;4248;13655;512;1628;3251;10808;3763;12436
280190;201403;1145;3330;1031;3152;107;427;727;2127;834;2554
280200;201403;1100;3491;1037;3387;173;703;713;2232;886;2935
280210;201403;12729;40862;12191;40069;2607;8990;7705;25976;10312;34966
280220;201403;1583;4889;1518;4806;100;396;1306;4108;1406;4504
280230;201403;3873;11474;3491;10832;717;2354;2018;6439;2735;8793
280240;201403;3509;10545;3217;10095;284;841;2513;8031;2797;8872
280250;201403;792;2142;709;2020;124;414;415;1097;539;1511
280260;201403;2067;5502;1891;5282;120;355;1620;4549;1740;4904
280270;201403;2236;7092;1977;6659;147;564;1522;5070;1669;5634
280280;201403;4075;13683;3809;13252;973;2936;1997;7891;2970;10827
280290;201403;16637;54545;15446;52497;2863;10507;10259;35206;13122;45713
280300;201403;10120;30993;9429;30213;869;2899;7756;25249;8625;28148
280310;201403;1443;4117;1282;3877;106;405;897;2619;1003;3024
280320;201403;7830;26397;7288;25428;1481;5821;3765;13127;5246;18948
280330;201403;4627;13333;4350;12975;551;1860;3316;9846;3867;11706
280340;201403;3743;11578;3600;11386;341;1121;2895;9429;3236;10550
280350;201403;21548;63895;20231;61949;2987;9484;14149;44200;17136;53684
280360;201403;5885;18924;5577;18444;1219;4550;3309;10794;4528;15344
280370;201403;1948;5630;1786;5369;206;729;1292;3799;1498;4528
280380;201403;985;3080;920;2993;99;386;702;2245;801;2631
280390;201403;3249;9686;2883;9031;757;2229;1574;5076;2331;7305
280400;201403;4436;12907;4079;12425;939;2758;2481;7931;3420;10689
280410;201403;2413;7920;2162;7453;368;1477;1274;4267;1642;5744
280420;201403;4210;12309;3926;11877;257;814;3358;10246;3615;11060
280430;201403;2209;5955;2084;5799;166;551;1728;4791;1894;5342
280440;201403;5075;15025;4752;14631;497;1576;3860;12035;4357;13611
280445;201403;2449;7102;2269;6795;113;425;1865;5484;1978;5909
280450;201403;9029;24596;8398;23860;770;1883;6974;20544;7744;22427
280460;201403;6983;19249;6269;18269;1089;3339;4234;12614;5323;15953
280470;201403;1824;5514;1661;5267;185;612;1235;3942;1420;4554
280480;201403;30885;94405;29841;92882;5338;19259;19647;59714;24985;78973
280490;201403;3708;11554;3403;10961;448;1630;2407;7698;2855;9328
280500;201403;889;2397;842;2339;33;104;746;2057;779;2161
280510;201403;2746;8129;2382;7646;320;1200;1741;5599;2061;6799
280520;201403;1728;4990;1598;4820;216;583;1211;3822;1427;4405
280530;201403;2102;6552;2003;6419;261;902;1530;5003;1791;5905
280540;201403;9189;25224;8655;24505;333;1146;7730;21753;8063;22899
280550;201403;7156;19453;6404;18269;690;2301;4562;12914;5252;15215
280560;201403;7917;23536;7504;22870;574;1904;6077;18470;6651;20374
280570;201403;6734;19049;6150;18301;922;3175;4209;12390;5131;15565
280580;201403;5643;17368;4900;16139;945;3269;3032;10161;3977;13430
280590;201403;2392;7342;2197;7107;298;1194;1601;5121;1899;6315
280600;201403;4028;12508;3803;12114;401;1551;2737;8571;3138;10122
280610;201403;2346;6938;2222;6753;327;1120;1450;4369;1777;5489
280620;201403;5159;15928;4619;14902;794;2685;2926;9598;3720;12283
280630;201403;3804;12613;3665;12399;380;1151;2919;10322;3299;11473
280640;201403;2267;6512;2127;6351;126;289;1900;5810;2026;6099
280650;201403;1118;3518;1038;3364;184;664;664;2158;848;2822
280660;201403;2622;7764;2525;7608;315;1029;2041;6093;2356;7122
280670;201403;15859;42584;15105;41594;1906;5610;11294;31129;13200;36739
280680;201403;2802;7532;2431;7051;158;521;2051;5941;2209;6462
280690;201403;996;2890;871;2705;125;433;562;1698;687;2131
280700;201403;1156;3442;1017;3236;89;286;742;2414;831;2700
280710;201403;10702;29797;10050;29008;699;2017;8577;24925;9276;26942
280720;201403;2469;6806;2227;6513;199;612;1723;5118;1922;5730
280730;201403;944;2869;907;2818;86;288;754;2361;840;2649
280740;201403;12775;35377;11202;33072;1810;5270;7482;22749;9292;28019
280750;201403;3554;11135;3296;10679;312;1269;2377;7583;2689;8852
280760;201403;5773;18016;5315;17419;757;2464;3874;13266;4631;15730
290010;201403;3028;6838;2227;5614;86;351;1762;4188;1848;4539
290020;201403;4993;15858;4566;15422;400;1199;3948;13661;4348;14860
290030;201403;3238;10466;3124;10287;479;1719;2278;7422;2757;9141
290035;201403;4610;12532;4153;11943;330;990;3421;9989;3751;10979
290040;201403;3783;11104;3479;10739;281;1093;2827;8576;3108;9669
290050;201403;2725;8979;2563;8736;264;1016;1931;6620;2195;7636
290060;201403;1315;3406;1105;3159;243;789;732;2017;975;2806
290070;201403;31196;82300;27152;77247;6090;17981;14237;42768;20327;60749
290080;201403;5940;18370;5279;17528;662;2281;3923;13384;4585;15665
290090;201403;2275;5088;1832;4623;255;658;1442;3695;1697;4353
290100;201403;10226;29590;9048;27635;1742;5366;5172;16545;6914;21911
290110;201403;5257;16047;5078;15749;964;3248;3291;10116;4255;13364
290115;201403;4880;14827;4345;14116;336;1188;3331;11027;3667;12215
290120;201403;6768;18767;6310;18200;461;1330;5401;15707;5862;17037
290130;201403;4545;12063;3967;11378;344;996;3243;9373;3587;10369
290135;201403;5207;13531;4575;12531;484;1604;3055;8260;3539;9864
290140;201403;3922;12794;3477;12228;347;1352;2810;9907;3157;11259
290150;201403;2112;6330;2031;6222;195;641;1691;5175;1886;5816
290160;201403;3482;9733;3404;9639;338;672;2927;8617;3265;9289
290170;201403;2840;9603;2614;9244;240;989;2113;7480;2353;8469
290180;201403;3058;8791;2700;8266;289;1000;1959;6025;2248;7025
290190;201403;4149;13877;4016;13651;431;1569;3039;10424;3470;11993
290195;201403;2220;6255;1921;5812;152;523;1524;4649;1676;5172
290200;201403;3850;12485;3534;11931;436;1561;2600;8820;3036;10381
290205;201403;2920;9303;2696;8951;413;1613;1867;6058;2280;7671
290210;201403;15742;43777;14825;42695;2525;6106;10415;32645;12940;38751
290220;201403;2415;7407;2315;7256;320;1208;1626;4935;1946;6143
290225;201403;3057;8337;2872;8139;185;407;2526;7397;2711;7804
290230;201403;2344;7887;2306;7837;218;785;1901;6527;2119;7312
290240;201403;3870;10406;3501;9890;399;1239;2544;7121;2943;8360
290250;201403;3804;12194;3247;11322;314;1165;2434;8608;2748;9773
290260;201403;4719;14631;4383;14111;475;1641;3398;10969;3873;12610
290265;201403;3370;11007;3183;10671;316;1267;2411;8054;2727;9321
290270;201403;12022;44689;11380;43762;1524;6165;8460;33217;9984;39382
290280;201403;5153;17294;4902;16825;693;2542;3378;11869;4071;14411
290290;201403;9605;31336;8839;30095;1716;6103;5654;19671;7370;25774
290300;201403;4391;12644;3358;10779;311;1012;2308;7660;2619;8672
290310;201403;1515;4666;1420;4528;252;917;935;2926;1187;3843
290320;201403;26695;83018;23922;79333;5403;19112;13783;46405;19186;65517
290323;201403;4077;11092;3376;10346;208;751;2873;8759;3081;9510
290327;201403;4007;13025;3738;12512;538;1910;2537;8529;3075;10439
290330;201403;1906;5114;1824;5025;270;845;1433;3892;1703;4737
290340;201403;5013;16065;4660;15604;1250;4372;2542;8681;3792;13053
290350;201403;4976;15246;4118;14092;588;2036;2784;9862;3372;11898
290360;201403;4181;13424;3766;12840;220;807;3206;11099;3426;11906
290370;201403;4544;13716;4234;13319;550;1732;3315;10605;3865;12337
290380;201403;5580;16558;4957;15676;409;1522;3981;12527;4390;14049
290390;201403;15081;48983;14380;47819;3100;10085;8660;30427;11760;40512
290395;201403;2783;9107;2530;8681;246;1060;1874;6413;2120;7473
290400;201403;3646;11368;3262;10836;542;1777;2264;7669;2806;9446
290405;201403;4462;14395;3916;13440;519;1873;2603;9189;3122;11062
290410;201403;6029;18163;5138;16860;585;2388;3658;11689;4243;14077
290420;201403;3358;9979;2812;9211;253;978;2198;7148;2451;8126
290430;201403;3528;11176;3181;10649;737;2531;1833;6325;2570;8856
290440;201403;3054;8130;2535;7464;206;691;2012;6011;2218;6702
290450;201403;3566;10569;3199;10038;594;1815;2015;6489;2609;8304
290460;201403;13311;41442;12506;40100;3775;12918;5403;17183;9178;30101
290470;201403;4788;13481;3805;12189;903;3302;1927;6234;2830;9536
290475;201403;5009;17786;4588;17048;518;2071;3349;12655;3867;14726
290480;201403;2608;6855;2322;6487;329;1018;1583;4467;1912;5485
290485;201403;4793;15570;4331;14886;462;2085;3346;11331;3808;13416
290490;201403;8029;21910;7776;21571;849;2587;6244;17265;7093;19852
290500;201403;4628;14901;3999;13738;796;2950;1931;6595;2727;9545
290510;201403;3466;10215;3062;9655;253;951;2409;7614;2662;8565
290515;201403;2836;8988;2698;8762;189;579;2146;7170;2335;7749
290520;201403;11726;36605;9620;32703;1112;4456;6037;20399;7149;24855
290530;201403;5279;15384;4543;14341;417;1360;3615;11508;4032;12868
290540;201403;3950;11487;3763;11249;498;1437;2858;8780;3356;10217
290550;201403;4415;11907;3902;11281;179;531;3472;10091;3651;10622
290560;201403;6133;18327;5465;17361;1147;3853;3245;10487;4392;14340
290570;201403;40401;118539;38039;115038;5286;17091;27382;82418;32668;99509
290580;201403;7327;25908;7035;25461;1597;5699;4421;16769;6018;22468
290590;201403;7504;24168;6328;22224;464;1888;4968;17425;5432;19313
290600;201403;18100;56621;17134;55131;2724;8852;11441;38108;14165;46960
290610;201403;2368;8336;2014;7635;197;910;1469;5501;1666;6411
290620;201403;7209;21618;6506;20612;542;1888;5303;16847;5845;18735
290630;201403;8198;22454;7253;21449;860;2578;5753;17218;6613;19796
290640;201403;2718;8095;2276;7349;249;886;1587;5115;1836;6001
290650;201403;11815;35395;11158;34409;3154;9816;6065;19407;9219;29223
290660;201403;3727;10506;3098;9612;199;714;2451;7643;2650;8357
290670;201403;6582;20907;6072;20122;969;3131;4397;15176;5366;18307
290680;201403;10357;31086;9642;30232;572;1968;8165;25800;8737;27768
290682;201403;4402;13234;3981;12655;206;820;3299;10402;3505;11222
290685;201403;3276;8527;2493;7428;318;1035;1503;4582;1821;5617
290687;201403;8245;22433;6585;20437;1230;4091;3969;12603;5199;16694
290689;201403;3154;9051;2680;8299;272;887;2048;6407;2320;7294
290690;201403;5461;16195;5031;15635;600;2021;3881;12130;4481;14151
290700;201403;2242;7139;2155;7016;229;807;1660;5440;1889;6247
290710;201403;7690;24900;7169;24072;423;1409;6174;20961;6597;22370
290720;201403;18647;55487;16694;53088;2201;6536;12990;42740;15191;49276
290730;201403;7368;20746;6734;19935;1334;3897;4305;13079;5639;16976
290740;201403;937;2845;803;2623;136;447;488;1649;624;2096
290750;201403;10127;29293;8826;27009;1592;5768;4848;13957;6440;19725
290755;201403;2424;6940;2050;6321;113;426;1607;4916;1720;5342
290760;201403;4487;13366;3703;12232;389;1280;2699;9034;3088;10314
290770;201403;2572;9101;2398;8869;149;654;1949;7260;2098;7914
290780;201403;8896;23547;7944;22247;1024;2521;5874;17137;6898;19658
290790;201403;4664;14147;4353;13701;481;1492;3318;10794;3799;12286
290800;201403;7334;16204;5608;14365;990;2341;4031;10826;5021;13167
290810;201403;4921;15917;4309;14971;317;1197;3266;11517;3583;12714
290820;201403;5461;15850;4915;15113;527;1843;3712;11401;4239;13244
290830;201403;4103;11983;3898;11642;316;1286;3056;8811;3372;10097
290840;201403;17682;50549;16237;48555;2692;7861;11092;34634;13784;42495
290850;201403;6726;20333;6596;20136;1343;4072;4584;14437;5927;18509
290860;201403;4797;17339;4571;17046;746;2816;3274;12587;4020;15403
290870;201403;4787;14488;4045;13485;475;1892;2921;9615;3396;11507
290880;201403;1398;3949;1161;3583;110;342;778;2454;888;2796
290890;201403;6230;17888;5929;17494;733;2209;4557;13543;5290;15752
290900;201403;2449;7243;1864;6280;289;1095;956;3192;1245;4287
290910;201403;4823;13611;4182;12688;288;947;3439;10498;3727;11445
290920;201403;4810;14409;4365;13809;349;973;3544;11480;3893;12453
290930;201403;7369;24134;6724;22993;865;3282;4675;15853;5540;19135
290940;201403;3533;11379;3318;11111;275;980;2792;9522;3067;10502
290950;201403;1567;4480;1434;4294;217;679;970;2935;1187;3614
290960;201403;6011;17375;5522;16737;389;1217;4486;13783;4875;15000
290970;201403;3679;12135;3394;11628;480;1688;2216;7798;2696;9486
290980;201403;10775;32477;9596;30182;2811;9232;3692;11629;6503;20861
290990;201403;9207;27945;8231;26362;907;3076;6178;19813;7085;22889
291000;201403;3182;9760;2935;9436;408;1361;2207;7251;2615;8612
291005;201403;13512;38420;12244;36600;2244;7162;7897;23977;10141;31139
291010;201403;3090;10138;2526;8874;355;1359;1523;5363;1878;6722
291020;201403;1390;3734;1082;3187;127;477;628;1762;755;2239
291030;201403;2153;6147;1737;5281;162;537;1110;3320;1272;3857
291040;201403;5582;17586;5169;16985;765;2687;3690;12219;4455;14906
291050;201403;8046;27029;7404;25829;1985;7460;3702;12930;5687;20390
291060;201403;6252;23248;5971;22906;869;3809;4313;16422;5182;20231
291070;201403;16029;48127;14788;46354;1911;5737;10789;34907;12700;40644
291072;201403;21493;67392;18730;61970;6264;22301;6350;21874;12614;44175
291075;201403;5201;15405;4746;14795;322;1006;3689;11838;4011;12844
291077;201403;1545;4553;1317;4198;138;524;890;2798;1028;3322
291080;201403;81960;254579;74241;240934;22206;75529;28141;90785;50347;166314
291085;201403;5716;15460;5007;14505;606;1828;3838;11212;4444;13040
291090;201403;1440;3736;1285;3534;131;508;1004;2624;1135;3132
291100;201403;2686;7227;2266;6788;127;511;1918;5695;2045;6206
291110;201403;5011;18173;4552;17453;752;3180;3037;11613;3789;14793
291120;201403;7581;20576;7142;19960;999;2927;5291;14867;6290;17794
291125;201403;1663;3710;1355;3385;145;378;1004;2594;1149;2972
291130;201403;3002;9296;2642;8696;244;950;1870;6120;2114;7070
291140;201403;4115;12540;3856;12086;559;1824;2647;8393;3206;10217
291150;201403;2004;5279;1913;5170;180;521;1456;3905;1636;4426
291160;201403;5584;17193;4944;16253;1208;4114;2770;9195;3978;13309
291165;201403;2427;7279;1998;6477;138;587;1432;4506;1570;5093
291170;201403;20804;54419;18066;51037;1280;4344;14362;40281;15642;44625
291180;201403;6507;17326;5319;15686;620;2011;3721;10937;4341;12948
291185;201403;3883;10658;3666;10374;309;968;3023;8479;3332;9447
291190;201403;7433;21165;6718;20305;871;2617;5023;15716;5894;18333
291200;201403;3088;9378;2605;8531;299;1125;1781;5818;2080;6943
291210;201403;7478;17888;6559;16860;566;1570;5203;13431;5769;15001
291220;201403;4195;13422;3975;13048;605;2247;2765;8958;3370;11205
291230;201403;3996;10535;3602;10075;157;431;3226;9119;3383;9550
291240;201403;4848;13343;4118;12073;286;880;3217;9359;3503;10239
291250;201403;3766;11410;3003;10137;319;1112;2065;7105;2384;8217
291260;201403;1166;3501;1102;3405;109;376;845;2598;954;2974
291270;201403;4433;15054;4194;14623;809;3113;2703;9424;3512;12537
291280;201403;2435;6329;1861;5617;485;1466;1038;3238;1523;4704
291290;201403;5975;16961;5405;16257;976;3020;3406;10553;4382;13573
291300;201403;4498;13415;3779;12220;488;1727;2495;8097;2983;9824
291310;201403;5394;15693;4777;14670;436;1414;3609;11098;4045;12512
291320;201403;5963;19537;5238;18159;1469;5637;2437;8294;3906;13931
291330;201403;1622;5071;1528;4922;197;734;977;3027;1174;3761
291340;201403;3903;11652;3139;10571;347;1354;2370;7938;2717;9292
291345;201403;3494;11558;3317;11368;252;910;2882;10009;3134;10919
291350;201403;6137;18322;5486;17333;594;2018;3738;12050;4332;14068
291360;201403;36029;105416;33761;102099;8518;25916;20311;63583;28829;89499
291370;201403;9125;26862;8747;26358;1049;3098;6617;20537;7666;23635
291380;201403;3845;12010;3405;11294;313;1051;2449;8385;2762;9436
291390;201403;10548;29644;9658;28595;1455;4189;7133;21535;8588;25724
291400;201403;17022;45079;13939;40981;2407;7208;8708;26697;11115;33905
291410;201403;3292;8645;2447;7421;198;820;1806;5301;2004;6121
291420;201403;2276;6047;2029;5751;101;267;1838;5262;1939;5529
291430;201403;3368;10008;2985;9507;247;978;2331;7340;2578;8318
291440;201403;6033;19401;5194;17891;590;2161;3883;13576;4473;15737
291450;201403;7476;23370;6929;22501;398;1324;5720;18964;6118;20288
291460;201403;13264;40801;11928;38859;2372;8266;7445;24477;9817;32743
291465;201403;8258;24103;7537;23277;857;2951;5920;18275;6777;21226
291470;201403;15606;43985;13935;41932;1327;4076;10729;33313;12056;37389
291480;201403;35654;97381;31918;92233;5508;17819;20209;58060;25717;75879
291490;201403;4292;14622;4211;14510;502;1723;3411;11942;3913;13665
291500;201403;4220;12366;3666;11584;267;961;2907;9165;3174;10126
291510;201403;3621;11227;3368;10889;157;557;3038;9886;3195;10443
291520;201403;4098;11160;3642;10553;556;1544;2440;7469;2996;9013
291530;201403;2111;6228;1810;5755;496;1710;854;2800;1350;4510
291535;201403;4358;12817;3939;12207;344;1110;2938;9464;3282;10574
291540;201403;2208;5410;1905;5093;185;447;1567;4319;1752;4766
291550;201403;5672;15414;5127;14669;1330;3868;2677;7834;4007;11702
291560;201403;17066;44385;13495;40342;1572;4884;10115;31011;11687;35895
291570;201403;2377;6428;2267;6289;187;477;1951;5521;2138;5998
291580;201403;5920;18296;5308;17368;767;2998;3504;11423;4271;14421
291590;201403;2021;6323;1820;5995;306;1102;1151;3913;1457;5015
291600;201403;5568;15652;4180;13683;1034;3749;1982;6358;3016;10107
291610;201403;5217;15484;5070;15287;418;1388;4227;12753;4645;14141
291620;201403;3077;7343;2557;6794;180;464;2027;5593;2207;6057
291630;201403;3211;8145;2834;7724;297;785;2321;6487;2618;7272
291640;201403;17810;49175;14906;45371;3906;12968;6279;19289;10185;32257
291650;201403;8059;24358;7458;23659;741;1950;6155;20352;6896;22302
291660;201403;2390;6370;2132;6013;259;873;1435;3884;1694;4757
291670;201403;2511;7065;2326;6777;351;1085;1324;4110;1675;5195
291680;201403;4998;14361;4523;13606;1129;3880;2078;6442;3207;10322
291685;201403;4430;11372;3894;10739;439;1191;2886;8324;3325;9515
291690;201403;4046;11174;3357;10093;337;1024;2303;7012;2640;8036
291700;201403;9494;29854;8804;28742;1095;3702;6382;21264;7477;24966
291710;201403;5955;16082;5201;15108;1043;3267;3012;9137;4055;12404
291720;201403;3837;13528;3521;12869;406;1714;2574;9268;2980;10982
291730;201403;5872;18958;5520;18499;1200;4143;3549;12258;4749;16401
291733;201403;2640;7858;2259;7361;314;1066;1492;4935;1806;6001
291735;201403;2399;7015;2070;6518;129;495;1703;5312;1832;5807
291740;201403;4023;11794;3214;10549;329;1249;2239;7354;2568;8603
291750;201403;22124;58644;17633;51966;3977;12277;9172;27443;13149;39720
291760;201403;12229;39365;11353;37821;4088;14969;4570;15238;8658;30207
291770;201403;8067;23568;7332;22327;1268;4167;4687;14166;5955;18333
291780;201403;4322;13523;4097;13104;550;1761;2986;9628;3536;11389
291790;201403;2460;7858;2330;7686;139;563;1969;6452;2108;7015
291800;201403;31698;93000;28824;88908;6213;20076;17107;54119;23320;74195
291810;201403;10797;31179;9306;29398;676;2396;7473;23861;8149;26257
291820;201403;3610;10986;3269;10492;376;1216;2402;7849;2778;9065
291830;201403;4386;11982;4118;11595;542;1649;3076;8654;3618;10303
291835;201403;6135;19344;5119;17674;1271;4720;2959;10197;4230;14917
291840;201403;47957;134897;41540;128041;5416;16650;31905;100759;37321;117409
291845;201403;2996;8760;2701;8427;270;810;2284;7241;2554;8051
291850;201403;4839;13652;4088;12608;457;1382;3027;9599;3484;10981
291855;201403;1685;4512;1453;4211;220;746;1032;2915;1252;3661
291860;201403;2040;6153;1779;5652;176;598;1153;3676;1329;4274
291870;201403;1379;3767;1091;3255;114;435;699;2047;813;2482
291875;201403;2884;9259;2603;8815;246;1018;1815;6018;2061;7036
291880;201403;4627;14858;4442;14570;351;1184;3683;12177;4034;13361
291890;201403;1422;3602;1205;3334;257;746;730;2070;987;2816
291900;201403;1333;3833;1148;3546;120;420;863;2642;983;3062
291905;201403;2966;7904;2504;7165;218;732;1780;5146;1998;5878
291910;201403;2600;7198;2290;6810;175;641;1860;5472;2035;6113
291915;201403;6686;20941;5983;19573;528;1846;4836;16036;5364;17882
291920;201403;32665;96687;30345;93305;6440;20449;17887;56691;24327;77140
291930;201403;2558;7670;2326;7320;260;925;1711;5382;1971;6307
291940;201403;3596;10354;2736;8835;411;1494;1521;4769;1932;6263
291950;201403;9295;31614;8472;30282;2065;7450;4456;16489;6521;23939
291955;201403;8221;26813;7959;26416;1981;6655;4654;15964;6635;22619
291960;201403;3397;10124;2917;9449;347;1071;2049;6998;2396;8069
291970;201403;4412;13319;3927;12703;635;2194;2630;8614;3265;10808
291980;201403;11499;33458;8839;29635;1107;3851;6144;21108;7251;24959
291990;201403;2168;7072;1999;6808;209;750;1459;5093;1668;5843
291992;201403;2800;8756;2741;8641;513;1700;1883;5894;2396;7594
291995;201403;2132;6333;1908;6011;242;804;1403;4483;1645;5287
292000;201403;2352;7067;2140;6757;440;1561;1324;4121;1764;5682
292010;201403;6339;16469;4905;14349;515;1539;3682;10848;4197;12387
292020;201403;4466;15266;4144;14748;676;2604;2825;10199;3501;12803
292030;201403;2235;7035;1990;6686;251;947;1285;4343;1536;5290
292040;201403;4623;13020;4123;12498;365;1048;3424;10792;3789;11840
292045;201403;2557;9073;2531;9030;90;308;2381;8529;2471;8837
292050;201403;6399;20170;5663;18714;563;2319;3872;12562;4435;14881
292060;201403;10937;31074;10505;30499;1078;3150;8509;24844;9587;27994
292070;201403;4377;14123;4270;13989;401;1150;3681;12311;4082;13461
292080;201403;3697;9830;3218;9215;296;893;2577;7458;2873;8351
292090;201403;4297;11565;3712;10901;350;1179;3000;8834;3350;10013
292100;201403;11071;31019;9625;29209;2731;8658;4860;15375;7591;24033
292105;201403;3209;9866;2796;9283;204;825;2222;7346;2426;8171
292110;201403;7088;18870;5463;16486;1248;3906;3027;9438;4275;13344
292120;201403;8579;24433;7694;22868;1533;4729;4107;12857;5640;17586
292130;201403;3209;8646;2887;8201;625;1691;1840;5413;2465;7104
292140;201403;5504;14325;4793;13380;646;1782;3261;9482;3907;11264
292145;201403;2711;8361;2478;8004;217;689;1850;6264;2067;6953
292150;201403;13622;41837;12676;40337;900;3323;9917;31923;10817;35246
292160;201403;2748;7966;2380;7480;187;563;1960;6330;2147;6893
292170;201403;8827;26541;7599;24428;1148;4051;4712;15416;5860;19467
292180;201403;3530;10295;2885;9290;444;1463;1800;5938;2244;7401
292190;201403;3254;9323;2858;8765;581;1911;1798;5570;2379;7481
292200;201403;5783;19697;5235;18572;1604;6134;2024;7186;3628;13320
292205;201403;3980;12497;3663;12072;274;1055;2930;9657;3204;10712
292210;201403;6667;19298;5836;18182;527;1741;4575;14586;5102;16327
292220;201403;1921;5522;1825;5386;426;1186;1096;3299;1522;4485
292225;201403;3047;9635;2824;9313;174;628;2317;7710;2491;8338
292230;201403;6234;18975;5971;18567;664;2503;4482;13543;5146;16046
292240;201403;4461;14282;4141;13572;662;2366;2531;8194;3193;10560
292250;201403;5248;16324;4935;15749;1101;3684;2548;8202;3649;11886
292260;201403;3124;9725;2980;9511;316;1074;2339;7463;2655;8537
292265;201403;3073;10141;2792;9638;229;957;2014;6894;2243;7851
292270;201403;3937;10871;3213;10018;252;1009;2583;8005;2835;9014
292273;201403;2809;6877;2174;6086;308;848;1529;4484;1837;5332
292275;201403;1890;4956;1772;4793;217;678;1330;3557;1547;4235
292280;201403;2066;6198;1888;6004;216;556;1429;4881;1645;5437
292285;201403;2625;7441;2339;7036;232;808;1787;5443;2019;6251
292290;201403;7404;22485;6257;20992;450;1725;4926;16816;5376;18541
292300;201403;8534;26426;7520;25292;2261;7740;4168;14548;6429;22288
292303;201403;2808;8961;2637;8726;115;441;2276;7553;2391;7994
292305;201403;3175;8703;3026;8510;108;332;2715;7670;2823;8002
292310;201403;5913;17828;5397;17117;259;909;4535;14426;4794;15335
292320;201403;6054;18533;5419;17438;595;2230;4066;12983;4661;15213
292330;201403;2009;5770;1894;5615;233;769;1439;4218;1672;4987
292335;201403;5334;14087;4803;13398;485;1388;3871;10884;4356;12272
292340;201403;6593;19150;5748;17842;614;2004;4102;12855;4716;14859
292350;201403;2164;6624;2005;6427;261;946;1510;4836;1771;5782
292360;201403;4943;14499;4766;13992;177;533;4174;12533;4351;13066
292370;201403;8632;26264;7847;25094;1099;3458;5376;18027;6475;21485
292380;201403;7446;21811;6973;21069;610;1682;5661;17418;6271;19100
292390;201403;3759;8581;3332;8121;115;218;3108;7675;3223;7893
292400;201403;22138;66076;21216;64606;3199;10410;14716;45639;17915;56049
292405;201403;4368;11836;3814;11159;272;813;3169;9390;3441;10203
292410;201403;1917;5207;1830;5108;153;442;1586;4428;1739;4870
292420;201403;3806;12313;3671;12157;169;473;3345;11332;3514;11805
292430;201403;5535;17011;4448;15481;263;1092;3436;11922;3699;13014
292440;201403;8572;28384;7990;27535;301;1189;6957;24329;7258;25518
292450;201403;4429;13242;3658;12022;349;1253;2640;8806;2989;10059
292460;201403;5662;17129;5022;15986;998;3296;3034;9789;4032;13085
292465;201403;2367;7327;2057;6822;246;962;1454;4833;1700;5795
292467;201403;2159;7130;2052;6949;424;1551;1292;4432;1716;5983
292470;201403;3213;8667;2689;7828;233;811;2006;5761;2239;6572
292480;201403;6073;16807;5238;15653;364;1248;4307;12906;4671;14154
292490;201403;2309;6477;1951;5946;172;637;1473;4417;1645;5054
292500;201403;6611;20084;5772;18636;577;2190;4170;13550;4747;15740
292510;201403;13243;38364;11798;36342;1248;4202;8975;28053;10223;32255
292520;201403;5867;18064;5427;17329;1626;5293;2536;8280;4162;13573
292525;201403;5538;14617;4849;13807;405;1215;3878;11199;4283;12414
292530;201403;25597;77308;23478;74718;5504;18262;13606;44844;19110;63106
292540;201403;2868;8455;2603;8078;398;1468;1844;5632;2242;7100
292550;201403;6380;21001;5750;20085;936;3446;3920;14047;4856;17493
292560;201403;4202;11662;3611;10890;304;1112;2903;8615;3207;9727
292570;201403;4056;12115;3906;11957;125;389;3438;10876;3563;11265
292575;201403;5972;20738;5835;20488;1043;3812;4113;14484;5156;18296
292580;201403;7173;21342;6665;20710;560;1748;5491;17299;6051;19047
292590;201403;7230;23185;6920;22684;952;3154;5010;16647;5962;19801
292593;201403;3288;8679;2793;7954;274;775;2123;6052;2397;6827
292595;201403;5991;16878;5265;15936;537;1739;3942;12058;4479;13797
292600;201403;10592;30202;9976;29426;1235;2944;7920;24460;9155;27404
292610;201403;4368;12803;3614;11541;487;1636;2321;7573;2808;9209
292620;201403;5870;18205;5181;17402;314;1150;4616;15604;4930;16754
292630;201403;9950;25381;8679;23514;832;2344;6486;17901;7318;20245
292640;201403;8239;26899;7337;25698;656;2426;5622;20209;6278;22635
292650;201403;4959;13572;4767;13352;513;1080;3812;11473;4325;12553
292660;201403;11095;34053;10586;33302;1458;4724;7776;25000;9234;29724
292665;201403;2862;8452;2798;8363;81;214;2616;7919;2697;8133
292670;201403;3898;11171;3045;9734;327;1162;1958;6309;2285;7471
292680;201403;3635;11100;3437;10814;364;1135;2752;8710;3116;9845
292690;201403;3338;9200;2456;7848;318;1132;1605;5219;1923;6351
292700;201403;9291;28415;8116;26716;1195;3709;5708;19727;6903;23436
292710;201403;1950;6450;1859;6315;94;355;1652;5633;1746;5988
292720;201403;9536;24922;8462;23712;767;2231;7014;19876;7781;22107
292730;201403;3391;10566;3288;10398;550;1715;2244;7305;2794;9020
292740;201403;352469;1001177;336157;977529;81355;250968;195496;569261;276851;820229
292750;201403;5935;16487;5370;15731;385;1145;4345;12951;4730;14096
292760;201403;4258;13722;3950;13188;577;2106;2548;8606;3125;10712
292770;201403;6091;18823;5721;18239;1349;4418;3376;11136;4725;15554
292780;201403;1877;4588;1489;4111;197;689;1052;2833;1249;3522
292790;201403;3387;9126;3244;8970;264;622;2710;7830;2974;8452
292800;201403;9477;28900;8898;27975;925;3184;6800;21380;7725;24564
292805;201403;3175;9424;2921;9060;588;2018;1867;5795;2455;7813
292810;201403;10026;30672;8526;28685;1232;4352;6155;21207;7387;25559
292820;201403;7444;21528;5505;18785;433;1650;4380;15036;4813;16686
292830;201403;1883;5648;1707;5404;121;487;1381;4327;1502;4814
292840;201403;7267;24124;6808;23489;457;1767;5810;20070;6267;21837
292850;201403;3244;8632;2702;7835;328;988;1889;5451;2217;6439
292860;201403;15240;41869;14634;41104;2041;5787;11083;31512;13124;37299
292870;201403;19429;54531;17316;51255;3279;10738;10018;29210;13297;39948
292880;201403;11908;35733;10792;34000;2008;6416;6589;21057;8597;27473
292890;201403;5575;19396;5061;18421;1027;3940;2838;10611;3865;14551
292895;201403;2755;6990;2247;6218;295;838;1605;4413;1900;5251
292900;201403;3051;9599;2894;9347;418;1631;1931;6004;2349;7635
292905;201403;4251;12506;3623;11715;307;893;3014;10088;3321;10981
292910;201403;5107;15986;4734;15297;858;2972;2930;9416;3788;12388
292920;201403;8628;25918;8233;25297;927;3112;6222;18679;7149;21791
292925;201403;5123;16149;4573;15384;412;1475;3542;12005;3954;13480
292930;201403;6496;21184;6203;20642;817;3357;4451;14407;5268;17764
292935;201403;2144;6166;1815;5808;127;330;1537;5134;1664;5464
292937;201403;3331;8572;2839;7957;313;1006;2174;6008;2487;7014
292940;201403;3103;8682;2473;7814;303;977;1642;5397;1945;6374
292950;201403;8239;25261;7884;24669;1014;3771;5660;17232;6674;21003
292960;201403;4571;13028;4251;12554;484;1604;2996;8724;3480;10328
292970;201403;4261;13319;3927;12887;184;754;3298;10816;3482;11570
292975;201403;3368;9359;3260;9196;376;1090;2647;7519;3023;8609
292980;201403;3578;10089;2939;9317;393;1510;2025;6382;2418;7892
292990;201403;12238;35464;11178;33848;736;2342;9436;28701;10172;31043
293000;201403;2958;7864;2433;7205;125;437;2103;6219;2228;6656
293010;201403;18881;53891;16623;50347;3211;10751;9976;30171;13187;40922
293015;201403;7753;25599;6346;23544;1063;4273;4007;14752;5070;19025
293020;201403;9403;31465;8814;30641;634;2466;7193;25302;7827;27768
293030;201403;5556;16428;4560;14957;453;1627;3138;10636;3591;12263
293040;201403;3695;11939;3546;11773;238;847;3070;10245;3308;11092
293050;201403;19977;57151;17843;54409;2941;9211;11674;36759;14615;45970
293060;201403;4334;11188;3669;10142;403;1220;2476;6790;2879;8010
293070;201403;20387;62675;18942;60209;5388;17841;9318;30273;14706;48114
293075;201403;3471;11143;3153;10755;292;1057;2563;8820;2855;9877
293076;201403;3729;10601;3483;10253;296;849;2873;8620;3169;9469
293077;201403;5071;15833;4409;14987;888;3219;2625;9062;3513;12281
293080;201403;4907;15506;4522;14885;326;1390;3564;11513;3890;12903
293090;201403;3586;11316;2962;10436;315;1106;2234;8025;2549;9131
293100;201403;5717;17626;4929;16251;586;2028;3533;11855;4119;13883
293105;201403;3886;13073;3451;12232;582;2110;2224;8071;2806;10181
293110;201403;1949;5919;1825;5721;116;440;1500;4679;1616;5119
293120;201403;4060;13685;3779;13289;359;1282;2990;10699;3349;11981
293130;201403;3930;11446;3216;10637;185;706;2807;9422;2992;10128
293135;201403;28554;74719;22381;66528;4162;14654;11433;33599;15595;48253
293140;201403;2102;6320;2031;6218;201;759;1551;4629;1752;5388
293150;201403;5859;19326;5293;18248;1119;3907;2965;10668;4084;14575
293160;201403;3485;9608;3301;9385;505;1127;2482;7501;2987;8628
293170;201403;3413;10568;3208;10261;464;1591;2287;7463;2751;9054
293180;201403;5347;15196;4466;13844;364;1342;3464;10583;3828;11925
293190;201403;13829;42441;13150;41400;568;2538;11309;34860;11877;37398
293200;201403;6358;18784;5672;17805;277;1013;4872;15252;5149;16265
293210;201403;4774;14582;4444;14029;528;1770;3171;10145;3699;11915
293220;201403;5215;15916;4719;15142;1228;4191;2344;7678;3572;11869
293230;201403;3923;12434;3637;12040;450;1698;2769;9125;3219;10823
293240;201403;4546;11988;3614;10679;189;556;2815;8312;3004;8868
293245;201403;4431;12958;4066;12366;520;1610;2834;8953;3354;10563
293250;201403;5989;17072;5506;16365;800;2543;3819;11344;4619;13887
293260;201403;4736;14355;3986;13293;368;1354;2954;10033;3322;11387
293270;201403;5855;16151;5562;15833;593;1554;4671;13624;5264;15178
293280;201403;5694;16215;4983;15285;433;1263;3823;12160;4256;13423
293290;201403;16466;55680;15657;54039;3684;13217;8463;29922;12147;43139
293300;201403;6425;16344;5550;15364;467;1253;4455;12501;4922;13754
293305;201403;4732;12040;4190;11294;287;856;3435;9246;3722;10102
293310;201403;2736;7106;2256;6318;250;793;1523;4211;1773;5004
293315;201403;4938;12663;4505;12010;748;1975;2783;7845;3531;9820
293317;201403;2561;7595;2330;7176;301;943;1515;4705;1816;5648
293320;201403;8158;26854;7976;26619;947;3445;6422;21398;7369;24843
293325;201403;1934;5651;1611;5150;299;1028;1003;3239;1302;4267
293330;201403;55125;175800;49898;167108;11396;41508;26400;89685;37796;131193
293340;201403;2729;7853;2182;6917;309;1120;1474;4578;1783;5698
293345;201403;3481;10609;2964;9871;370;1209;2074;7186;2444;8395
293350;201403;6761;18898;6487;18576;457;1220;5688;16604;6145;17824
293360;201403;13810;42254;12632;40707;784;2505;10671;35183;11455;37688
310010;201403;1241;3396;904;2862;235;896;365;1048;600;1944
310020;201403;3853;12305;3235;10957;1083;3969;554;1691;1637;5660
310030;201403;2492;8344;2214;7810;718;2658;948;3353;1666;6011
310040;201403;991;2754;848;2560;103;376;603;1779;706;2155
310050;201403;1943;6810;1736;6308;359;1555;833;2944;1192;4499
310060;201403;3143;10913;2940;10623;367;1397;2232;8210;2599;9607
310070;201403;310;897;234;756;35;148;115;333;150;481
310080;201403;777;2422;633;2143;175;683;200;624;375;1307
310090;201403;4872;14648;4229;13549;757;2736;2488;7952;3245;10688
310100;201403;3323;10333;2803;9472;321;1289;2035;6819;2356;8108
310110;201403;5892;16857;5007;15548;1108;3984;2652;8099;3760;12083
310120;201403;589;1957;561;1901;228;909;206;573;434;1482
310130;201403;463;1464;424;1405;103;395;206;643;309;1038
310140;201403;267;924;233;861;69;297;52;162;121;459
310150;201403;4887;15387;4464;14623;992;3685;2242;7287;3234;10972
310160;201403;7200;23616;6295;21984;1922;7450;2277;7800;4199;15250
310163;201403;803;2710;709;2522;197;792;259;881;456;1673
310170;201403;9792;28364;9059;27253;1758;5671;5559;17274;7317;22945
310180;201403;1857;5460;1516;4984;401;1513;690;2173;1091;3686
310190;201403;2546;8626;2315;8234;679;2692;349;1273;1028;3965
310200;201403;1919;6539;1618;5922;475;1902;498;1789;973;3691
310205;201403;986;3113;879;2906;190;636;489;1660;679;2296
310210;201403;2476;7943;2298;7667;380;1416;1579;5242;1959;6658
310220;201403;1268;3665;1027;3356;221;787;568;1832;789;2619
310230;201403;2928;9732;2546;8871;745;3015;945;2999;1690;6014
310240;201403;1028;3649;881;3365;152;665;451;1792;603;2457
310250;201403;973;3396;951;3363;196;804;581;1966;777;2770
310260;201403;3193;10459;2728;9472;743;2926;999;3370;1742;6296
310270;201403;2367;7207;2135;6861;254;923;1576;5101;1830;6024
310280;201403;2145;6289;1939;5956;657;2349;755;2147;1412;4496
310285;201403;2214;7838;2095;7664;259;924;1551;5853;1810;6777
310290;201403;1336;4230;1249;4097;385;1467;556;1611;941;3078
310300;201403;1906;6563;1809;6368;509;1970;958;3330;1467;5300
310310;201403;401;1126;295;903;55;189;138;414;193;603
310320;201403;382;1318;335;1206;86;360;141;483;227;843
310330;201403;500;1292;377;1082;40;153;209;534;249;687
310340;201403;8365;26804;7462;25302;1537;5511;4197;14656;5734;20167
310350;201403;14627;43642;11921;38699;4228;14908;2995;9765;7223;24673
310360;201403;453;1451;441;1430;84;321;290;887;374;1208
310370;201403;1451;5174;1400;5077;449;1721;664;2410;1113;4131
310375;201403;1293;3580;947;2949;153;541;447;1356;600;1897
310380;201403;399;1145;323;1037;136;484;119;347;255;831
310390;201403;490;1776;420;1615;120;511;66;214;186;725
310400;201403;10264;31227;8314;27722;2734;10045;2204;7280;4938;17325
310410;201403;1035;3361;678;2791;241;1073;114;453;355;1526
310420;201403;5725;16824;3473;11578;823;3105;533;1555;1356;4660
310430;201403;1640;5666;1375;5119;453;1805;341;1251;794;3056
310440;201403;620;1831;545;1715;156;560;196;575;352;1135
310445;201403;1187;4095;1027;3824;160;662;652;2471;812;3133
310450;201403;4514;13342;3775;12255;787;2704;2223;7435;3010;10139
310460;201403;1582;5175;1390;4830;471;1789;305;1114;776;2903
310470;201403;3739;9809;3197;9138;330;1110;2489;7126;2819;8236
310480;201403;1049;3317;910;3053;227;892;356;1084;583;1976
310490;201403;3307;11327;2911;10563;960;3838;1014;3648;1974;7486
310500;201403;1504;5272;1398;5070;441;1750;533;1898;974;3648
310510;201403;2517;8423;2212;7723;787;2998;452;1496;1239;4494
310520;201403;1346;3772;1141;3424;85;254;756;2283;841;2537
310530;201403;859;2795;576;2073;121;487;96;334;217;821
310540;201403;3668;12278;3415;11902;1192;4426;1256;4462;2448;8888
310550;201403;1190;3688;1012;3385;311;1223;381;1164;692;2387
310560;201403;16222;51525;14166;47526;4673;17461;4573;14541;9246;32002
310570;201403;1265;3979;1187;3875;168;625;863;2796;1031;3421
310590;201403;4166;12511;3373;11003;653;2444;1252;3885;1905;6329
310600;201403;1638;5574;1547;5379;516;2016;510;1648;1026;3664
310610;201403;561;1934;520;1843;153;641;173;551;326;1192
310620;201403;188241;604772;156738;540930;42743;164576;57394;189136;100137;353712
310630;201403;4160;13804;3952;13419;875;3417;2432;7966;3307;11383
310640;201403;1454;4548;1199;4100;401;1489;324;1039;725;2528
310650;201403;2905;9390;2397;8531;524;2028;1202;4391;1726;6419
310660;201403;1325;4118;1167;3892;192;725;813;2662;1005;3387
310665;201403;1184;3752;1096;3628;206;725;716;2426;922;3151
310670;201403;55968;178547;51997;169727;16110;55784;21162;67884;37272;123668
310680;201403;799;2403;739;2307;175;593;366;1119;541;1712
310690;201403;1253;4332;1051;3897;299;1264;253;895;552;2159
310700;201403;524;1471;447;1358;131;447;214;615;345;1062
310710;201403;7305;24043;5897;21731;1501;6253;1910;6848;3411;13101
310720;201403;855;2669;780;2532;243;918;334;987;577;1905
310730;201403;9467;30462;8773;29385;2100;7620;4959;16675;7059;24295
310740;201403;5082;17593;4395;16106;1572;6266;965;3339;2537;9605
310750;201403;1618;4257;1340;3884;253;771;839;2447;1092;3218
310760;201403;629;1985;543;1837;134;491;227;764;361;1255
310770;201403;747;2784;735;2763;299;1263;282;995;581;2258
310780;201403;3638;10572;3281;9961;648;2012;1902;5801;2550;7813
310790;201403;1790;5807;1647;5577;473;1689;800;2778;1273;4467
310800;201403;3089;10207;2530;9074;1006;3940;356;1221;1362;5161
310810;201403;1526;4319;1405;4121;359;1176;650;1792;1009;2968
310820;201403;1496;4313;1099;3615;317;1146;328;1030;645;2176
310825;201403;2411;8339;1972;7577;148;787;1470;5575;1618;6362
310830;201403;1435;4923;1218;4458;425;1659;338;1163;763;2822
310840;201403;2252;7637;2025;7162;766;2992;511;1667;1277;4659
310850;201403;1540;4711;1326;4425;237;891;902;2986;1139;3877
310855;201403;3106;10286;2834;9846;725;2666;1541;5513;2266;8179
310860;201403;7659;24505;6889;23196;1303;4565;3847;13436;5150;18001
310870;201403;1030;2995;876;2731;202;692;398;1225;600;1917
310880;201403;1252;3932;961;3387;197;794;441;1539;638;2333
310890;201403;2764;8911;2209;7863;652;2595;514;1713;1166;4308
310900;201403;4356;14807;3823;13756;1174;4699;1469;5078;2643;9777
310910;201403;2045;6010;1464;4914;425;1620;329;1033;754;2653
310920;201403;1876;5870;1520;5350;415;1674;703;2444;1118;4118
310925;201403;951;3194;871;3060;322;1261;257;895;579;2156
310930;201403;5328;15942;4350;14413;918;3272;2369;8094;3287;11366
310940;201403;6224;18684;5426;17497;1100;3858;2976;9651;4076;13509
310945;201403;1310;3763;1069;3428;237;878;577;1768;814;2646
310950;201403;1998;6747;1623;5935;560;2285;445;1497;1005;3782
310960;201403;464;1615;417;1525;149;600;138;506;287;1106
310970;201403;1471;5257;1152;4389;427;1770;123;406;550;2176
310980;201403;483;1289;337;1009;59;213;144;376;203;589
310990;201403;1165;4069;1014;3750;233;982;349;1200;582;2182
311000;201403;4610;16254;4151;15265;1333;5472;1349;4711;2682;10183
311010;201403;962;3138;858;2952;271;992;383;1288;654;2280
311020;201403;883;2809;762;2611;161;629;326;1050;487;1679
311030;201403;1889;5752;1481;4910;487;1797;467;1368;954;3165
311040;201403;501;1716;436;1539;114;421;102;345;216;766
311050;201403;2618;8536;2241;7800;718;2727;810;2806;1528;5533
311060;201403;2394;7631;1964;6684;545;2000;452;1485;997;3485
311070;201403;1724;6187;1532;5790;443;1917;474;1737;917;3654
311080;201403;1209;3298;1089;3110;161;540;705;2015;866;2555
311090;201403;1690;6501;1491;6064;508;2355;257;963;765;3318
311100;201403;2345;8279;2094;7756;940;3649;459;1706;1399;5355
311110;201403;4076;9909;2941;8326;599;1894;1445;4019;2044;5913
311115;201403;1099;3427;965;3227;128;537;606;2047;734;2584
311120;201403;7603;21995;6119;19301;1600;5710;1606;4683;3206;10393
311130;201403;2416;7512;1962;6908;624;2527;780;2627;1404;5154
311140;201403;1286;3779;1118;3572;190;718;757;2359;947;3077
311150;201403;2430;8161;2248;7855;608;2224;1054;3755;1662;5979
311160;201403;4913;16838;4193;15603;1527;6088;1250;4577;2777;10665
311170;201403;748;2358;599;2067;55;215;331;1197;386;1412
311180;201403;1615;4544;1182;3694;355;1241;243;665;598;1906
311190;201403;1098;3358;938;3034;245;925;351;1037;596;1962
311200;201403;2541;7948;2213;7271;862;3091;490;1443;1352;4534
311205;201403;1192;3938;1062;3686;277;1091;375;1341;652;2432
311210;201403;933;3080;864;2969;168;582;597;2113;765;2695
311220;201403;923;2986;743;2574;204;744;233;797;437;1541
311230;201403;9016;27792;7667;25464;1678;6079;3703;12677;5381;18756
311240;201403;1347;4183;1130;3829;374;1423;321;1028;695;2451
311250;201403;1327;4477;1215;4306;388;1508;357;1117;745;2625
311260;201403;2962;8195;2260;6966;728;2456;591;1736;1319;4192
311265;201403;1319;3572;1024;3165;161;607;667;2040;828;2647
311270;201403;3404;11394;3078;10961;635;2666;1892;6568;2527;9234
311280;201403;1421;4016;1078;3371;278;956;321;977;599;1933
311290;201403;2323;7670;2155;7319;430;1429;1204;4257;1634;5686
311300;201403;5030;16874;4581;16166;769;3085;2894;10284;3663;13369
311310;201403;491;1768;476;1743;118;503;182;626;300;1129
311320;201403;4096;13951;3611;12860;963;3866;1172;3927;2135;7793
311330;201403;5507;17087;4747;15866;1725;6207;1429;4768;3154;10975
311340;201403;12232;40099;11231;38230;3939;14519;3224;10861;7163;25380
311350;201403;2330;7007;2007;6432;458;1742;879;2674;1337;4416
311360;201403;1339;3814;1078;3469;468;1592;284;945;752;2537
311370;201403;4540;13741;4062;12923;1001;3924;1655;4904;2656;8828
311380;201403;479;1601;406;1463;124;495;108;358;232;853
311390;201403;1959;7389;1878;7233;822;3523;566;2079;1388;5602
311400;201403;1707;5775;1583;5556;465;1844;668;2160;1133;4004
311410;201403;2017;7404;1891;7220;663;2712;884;3406;1547;6118
311420;201403;2359;8267;2041;7480;732;2861;418;1353;1150;4214
311430;201403;3927;12556;3027;10575;712;2740;566;1932;1278;4672
311440;201403;2327;8111;1932;7446;742;3200;433;1625;1175;4825
311450;201403;2115;7576;1835;6890;562;2279;459;1631;1021;3910
311455;201403;1574;4333;1376;4054;300;1011;741;2099;1041;3110
311460;201403;633;2108;509;1852;124;573;131;444;255;1017
311470;201403;609;1953;489;1691;134;560;140;433;274;993
311480;201403;810;2306;773;2249;271;816;300;819;571;1635
311490;201403;319;1267;309;1235;117;496;97;374;214;870
311500;201403;515;1567;427;1405;155;561;146;462;301;1023
311510;201403;3157;9945;2639;8971;1026;3933;659;2088;1685;6021
311520;201403;689;2395;652;2319;247;948;232;806;479;1754
311530;201403;11297;30403;7860;24393;2164;8009;2127;6186;4291;14195
311535;201403;723;2244;535;1865;136;540;105;355;241;895
311540;201403;709;2586;679;2540;257;975;301;1121;558;2096
311545;201403;2194;6984;2081;6822;350;1282;1403;4590;1753;5872
311547;201403;1663;4704;1421;4335;141;472;955;2936;1096;3408
311550;201403;3372;11117;2956;10258;916;3520;889;2995;1805;6515
311560;201403;280;766;251;730;57;187;134;371;191;558
311570;201403;2038;5263;1713;4873;130;396;1404;4059;1534;4455
311580;201403;2343;5267;1981;4827;598;1434;1085;2726;1683;4160
311590;201403;374;1225;329;1165;92;390;88;305;180;695
311600;201403;1340;4102;1172;3888;252;861;658;2286;910;3147
311610;201403;3456;12118;3213;11736;1061;3890;1389;5495;2450;9385
311615;201403;2669;8921;2351;8366;318;1272;1589;5675;1907;6947
311620;201403;452;1475;408;1415;113;458;199;653;312;1111
311630;201403;1458;4390;1251;4016;351;1124;588;1928;939;3052
311640;201403;893;2816;752;2589;143;528;495;1715;638;2243
311650;201403;2437;7036;2046;6420;305;1103;1169;3710;1474;4813
311660;201403;2580;9264;2312;8620;686;2849;428;1387;1114;4236
311670;201403;1417;4454;1242;4131;468;1720;457;1459;925;3179
311680;201403;2270;7231;1935;6740;516;1904;1002;3580;1518;5484
311690;201403;526;1483;445;1385;86;299;286;875;372;1174
311700;201403;2131;6293;1905;5956;198;812;1440;4380;1638;5192
311710;201403;1731;5422;1376;4780;582;2231;356;1183;938;3414
311720;201403;407;1405;377;1346;78;306;227;792;305;1098
311730;201403;5146;13877;3416;10858;1065;3763;1153;3386;2218;7149
311740;201403;1005;2906;879;2758;396;1253;360;1189;756;2442
311750;201403;3867;13309;3595;12908;635;2535;2262;8209;2897;10744
311760;201403;799;2779;749;2674;245;1021;262;793;507;1814
311770;201403;2573;8217;2126;7426;585;2311;640;2153;1225;4464
311780;201403;1044;3989;912;3654;323;1456;160;603;483;2059
311783;201403;2056;6785;1854;6414;208;894;1206;4280;1414;5174
311787;201403;643;2272;476;1769;96;387;92;286;188;673
311790;201403;1286;4209;1076;3790;300;1134;243;832;543;1966
311800;201403;3866;13414;2878;10348;676;2628;225;660;901;3288
311810;201403;1048;3574;1009;3501;45;210;872;2990;917;3200
311820;201403;824;2747;708;2473;238;957;308;975;546;1932
311830;201403;10451;38002;9606;35875;3961;15554;2020;7489;5981;23043
311840;201403;3455;10445;2985;9739;999;3600;1154;3661;2153;7261
311850;201403;319;971;278;904;77;262;126;409;203;671
311860;201403;49248;155910;43348;144566;11695;42882;18000;58179;29695;101061
311870;201403;2365;7171;1920;6332;480;1840;617;1866;1097;3706
311880;201403;7106;21508;6456;20725;1000;3227;4478;15031;5478;18258
311890;201403;1613;5136;1369;4618;409;1538;491;1580;900;3118
311900;201403;803;2534;731;2435;155;533;442;1546;597;2079
311910;201403;4678;13998;3871;12905;1174;4269;1512;5067;2686;9336
311920;201403;2066;6850;1800;6455;213;879;1229;4364;1442;5243
311930;201403;4809;14525;4317;13721;1690;5834;1186;3738;2876;9572
311940;201403;11810;36842;10146;33402;3193;11627;2312;7152;5505;18779
311950;201403;2283;6881;1972;6484;125;406;1622;5417;1747;5823
311960;201403;370;1317;340;1252;118;467;113;398;231;865
311970;201403;468;1710;410;1585;132;566;70;248;202;814
311980;201403;750;2146;580;1881;141;485;253;848;394;1333
311990;201403;513;1570;457;1485;187;663;139;407;326;1070
311995;201403;1095;3434;802;2711;178;672;191;535;369;1207
312000;201403;678;2162;647;2114;111;408;366;1181;477;1589
312010;201403;1042;3392;955;3209;200;727;423;1428;623;2155
312015;201403;1590;4966;1379;4600;229;905;779;2623;1008;3528
312020;201403;922;3039;829;2906;218;860;431;1488;649;2348
312030;201403;1804;5459;1626;5232;226;808;1222;3902;1448;4710
312040;201403;681;2620;588;2337;162;719;113;421;275;1140
312050;201403;1486;5181;1300;4788;399;1631;256;881;655;2512
312060;201403;750;2318;669;2209;322;1134;172;505;494;1639
312070;201403;965;3036;654;2344;181;701;222;779;403;1480
312080;201403;2593;7378;2043;6520;467;1797;913;2636;1380;4433
312083;201403;946;2734;796;2521;112;412;484;1511;596;1923
312087;201403;2336;7208;2099;6882;377;1299;1402;4702;1779;6001
312090;201403;9827;32315;9053;30981;2896;10911;3551;11688;6447;22599
312100;201403;1360;4679;1203;4417;263;1091;652;2442;915;3533
312110;201403;1181;4259;1064;4002;377;1563;198;660;575;2223
312120;201403;915;3224;831;3035;262;1081;209;668;471;1749
312125;201403;1222;4028;1094;3750;303;1126;474;1625;777;2751
312130;201403;825;2553;674;2227;165;636;245;760;410;1396
312140;201403;1155;3661;977;3242;226;822;350;1050;576;1872
312150;201403;569;1645;483;1460;52;182;311;915;363;1097
312160;201403;8064;27958;7446;26714;2432;9573;2493;8963;4925;18536
312170;201403;1020;3088;928;2900;131;443;564;1787;695;2230
312180;201403;1606;5045;1478;4828;448;1544;554;1794;1002;3338
312190;201403;670;2240;530;1961;213;883;95;317;308;1200
312200;201403;4747;14578;4163;13599;562;1928;2816;9299;3378;11227
312210;201403;1160;3270;941;2944;261;920;398;1177;659;2097
312220;201403;1903;6335;1728;6137;274;1042;1246;4589;1520;5631
312230;201403;18035;60888;15384;55560;7126;27480;2613;9658;9739;37138
312235;201403;1766;5111;1482;4673;187;726;961;3010;1148;3736
312240;201403;1123;3873;963;3531;287;1119;318;1158;605;2277
312245;201403;2383;7078;2084;6678;182;529;1665;5466;1847;5995
312247;201403;913;2731;708;2404;215;813;319;1098;534;1911
312250;201403;1139;3390;1003;3155;231;827;452;1374;683;2201
312260;201403;929;3015;785;2815;122;543;528;1869;650;2412
312270;201403;800;2570;696;2360;168;696;238;677;406;1373
312280;201403;471;1641;434;1553;183;700;49;167;232;867
312290;201403;802;2819;756;2752;295;1192;164;588;459;1780
312300;201403;1119;3771;948;3369;286;1082;115;353;401;1435
312310;201403;948;3661;869;3463;273;1182;333;1280;606;2462
312320;201403;2428;7016;1980;6118;555;1934;497;1278;1052;3212
312330;201403;1147;3531;1029;3359;290;1089;507;1643;797;2732
312340;201403;310;841;291;813;49;175;211;553;260;728
312350;201403;379;992;355;964;49;160;282;728;331;888
312352;201403;1657;5495;1540;5331;533;1887;784;2811;1317;4698
312360;201403;3686;12674;3261;11803;1062;4142;806;2869;1868;7011
312370;201403;1669;5516;1551;5314;555;2107;520;1689;1075;3796
312380;201403;1991;5965;1834;5716;258;862;1268;4069;1526;4931
312385;201403;1231;3928;1143;3759;169;686;763;2403;932;3089
312390;201403;2021;6887;1744;6283;534;2054;323;1097;857;3151
312400;201403;3397;11396;3072;10769;1049;3795;1187;4350;2236;8145
312410;201403;10611;36051;9626;34081;2908;11281;3283;11283;6191;22564
312420;201403;4031;13124;3849;12910;792;2718;2509;8685;3301;11403
312430;201403;8512;25676;7594;24310;1420;4830;4768;15748;6188;20578
312440;201403;630;2075;563;1946;168;639;233;803;401;1442
312450;201403;1149;4240;1062;4053;479;1877;340;1296;819;3173
312460;201403;398;1236;358;1191;92;353;179;564;271;917
312470;201403;762;2205;535;1749;131;504;114;355;245;859
312480;201403;1295;4022;1124;3823;401;1440;471;1581;872;3021
312490;201403;2332;6165;1845;5496;302;1061;1023;2928;1325;3989
312500;201403;604;2154;574;2101;155;670;284;1003;439;1673
312510;201403;2222;7613;1888;6856;519;2111;601;1985;1120;4096
312520;201403;398;1373;355;1281;122;476;106;384;228;860
312530;201403;575;1940;550;1887;110;456;302;976;412;1432
312540;201403;1461;4744;1190;4208;247;1001;646;2203;893;3204
312550;201403;631;2058;570;1930;64;257;367;1212;431;1469
312560;201403;2162;5854;1905;5519;234;794;1409;4100;1643;4894
312570;201403;2706;8387;2398;7825;749;2640;697;2172;1446;4812
312580;201403;525;1788;428;1595;105;460;169;594;274;1054
312590;201403;1840;6273;1634;5822;502;2036;508;1618;1010;3654
312595;201403;2030;6945;1811;6408;539;2066;746;2548;1285;4614
312600;201403;801;2932;738;2793;215;925;298;1056;513;1981
312610;201403;8513;27170;7391;24961;2691;9845;2059;6704;4750;16549
312620;201403;2067;6048;1586;5418;101;355;1296;4591;1397;4946
312630;201403;510;1746;473;1675;135;548;199;666;334;1214
312640;201403;590;1976;492;1770;121;496;189;634;310;1130
312650;201403;2340;7054;1732;5919;195;805;914;3086;1109;3891
312660;201403;1262;3534;1087;3311;161;587;714;2124;875;2711
312670;201403;5942;18741;5521;18085;1434;5415;2692;8544;4126;13959
312675;201403;1466;4671;1275;4293;241;863;680;2324;921;3187
312680;201403;1721;5323;1542;5034;252;959;909;3002;1161;3961
312690;201403;2414;6720;2001;6141;400;1431;1076;3154;1476;4585
312695;201403;899;3249;847;3169;160;607;548;2129;708;2736
312700;201403;2180;6485;1702;5571;311;1168;861;2771;1172;3939
312705;201403;1401;4199;1235;3966;179;597;845;2723;1024;3320
312707;201403;1763;5521;1470;5022;268;1085;773;2591;1041;3676
312710;201403;7992;23078;6107;19783;2308;8331;1330;3967;3638;12298
312720;201403;757;2604;692;2482;198;795;272;918;470;1713
312730;201403;1868;4739;1430;4267;205;722;886;2652;1091;3374
312733;201403;1755;4791;1362;4065;117;448;965;2760;1082;3208
312735;201403;883;2691;788;2550;282;968;353;1140;635;2108
312737;201403;1042;2568;737;2153;254;784;269;832;523;1616
312738;201403;512;1684;418;1507;139;586;149;490;288;1076
312740;201403;501;1450;344;1245;126;502;87;313;213;815
312750;201403;1294;4762;1240;4649;335;1416;567;2086;902;3502
312760;201403;2427;7957;1955;7042;605;2434;432;1582;1037;4016
312770;201403;44891;125792;35496;111601;10461;35927;11050;34436;21511;70363
312780;201403;2803;10082;2522;9591;562;2342;1366;5325;1928;7667
312790;201403;369;1003;236;769;72;252;57;172;129;424
312800;201403;5211;17942;4565;16614;1465;5784;1361;5027;2826;10811
312810;201403;2209;6915;1644;5887;556;2200;326;1080;882;3280
312820;201403;2143;6455;1977;6181;264;980;1234;3735;1498;4715
312825;201403;1519;4216;1346;4006;141;457;1056;3130;1197;3587
312830;201403;2751;8999;2040;7538;561;2297;343;1252;904;3549
312840;201403;1161;3917;991;3589;203;853;414;1434;617;2287
312850;201403;698;2313;601;2112;167;678;187;641;354;1319
312860;201403;1308;3841;1024;3413;357;1379;313;923;670;2302
312870;201403;5642;18150;4453;15900;1252;5064;1187;4012;2439;9076
312880;201403;1204;3693;1017;3371;232;887;463;1465;695;2352
312890;201403;1607;5019;1264;4353;424;1650;409;1342;833;2992
312900;201403;1416;4711;1339;4601;355;1281;768;2677;1123;3958
312910;201403;1496;3503;1174;3069;322;1006;510;1215;832;2221
312920;201403;1026;3386;908;3223;311;1234;359;1219;670;2453
312930;201403;2210;6684;1976;6354;453;1551;998;3270;1451;4821
312940;201403;934;3170;845;3001;241;1014;258;846;499;1860
312950;201403;3501;10118;2878;9185;1004;3512;1107;3486;2111;6998
312960;201403;1917;5924;1734;5682;226;748;1282;4315;1508;5063
312965;201403;1766;5784;1542;5377;355;1338;818;2933;1173;4271
312970;201403;1141;3991;1027;3828;414;1741;176;632;590;2373
312980;201403;20907;74376;20192;72627;7918;30553;6834;23799;14752;54352
312990;201403;393;1226;304;1066;110;425;89;304;199;729
313000;201403;510;1737;442;1607;138;626;146;442;284;1068
313005;201403;2620;8620;2345;8160;394;1520;1424;4966;1818;6486
313010;201403;4076;13863;3685;13200;1132;4450;1409;4798;2541;9248
313020;201403;1042;3611;948;3394;308;1243;277;869;585;2112
313030;201403;1579;4515;1285;4116;376;1390;625;1870;1001;3260
313040;201403;966;3445;825;3045;209;848;217;757;426;1605
313050;201403;1881;6278;1591;5840;520;2110;536;1891;1056;4001
313055;201403;1498;5084;1400;4940;147;532;1030;3740;1177;4272
313060;201403;961;3377;887;3206;392;1481;143;501;535;1982
313065;201403;1921;6483;1773;6254;284;1144;1258;4399;1542;5543
313070;201403;1264;3781;1032;3343;269;1021;476;1442;745;2463
313080;201403;472;1503;389;1343;118;472;108;305;226;777
313090;201403;5299;16252;4901;15562;820;2870;3230;10350;4050;13220
313100;201403;1143;3725;1067;3611;175;665;744;2483;919;3148
313110;201403;1702;5123;1358;4472;328;1240;483;1468;811;2708
313115;201403;2886;10253;2766;10007;898;3625;1197;4103;2095;7728
313120;201403;3821;11194;3336;10491;1136;3826;1523;4789;2659;8615
313130;201403;26543;85625;24025;80299;7217;26540;8045;25466;15262;52006
313140;201403;725;1920;540;1633;42;151;351;1051;393;1202
313150;201403;1662;5254;1504;4971;656;2253;385;1319;1041;3572
313160;201403;1180;3613;1060;3418;219;833;616;1890;835;2723
313170;201403;9728;36241;9057;34578;3501;13962;1816;6964;5317;20926
313180;201403;2722;7229;2084;6398;656;2276;677;1985;1333;4261
313190;201403;3516;13035;3168;12015;872;3561;1071;3959;1943;7520
313200;201403;1504;4798;1357;4572;221;887;844;2855;1065;3742
313210;201403;4596;14747;3954;13884;970;3917;2053;7033;3023;10950
313220;201403;1281;3947;977;3293;246;945;240;712;486;1657
313230;201403;2541;9093;2389;8861;424;1678;1487;5711;1911;7389
313240;201403;8199;28186;7089;26106;2066;8351;2716;10020;4782;18371
313250;201403;7706;24423;7024;23306;1306;4496;4144;14141;5450;18637
313260;201403;613;1948;514;1758;138;540;127;403;265;943
313270;201403;5599;16764;5048;15942;795;2661;3398;10897;4193;13558
313280;201403;531;1775;424;1509;90;366;95;305;185;671
313290;201403;1045;3799;872;3446;285;1210;203;750;488;1960
313300;201403;1942;6778;1687;6118;526;2058;336;1108;862;3166
313310;201403;1073;3835;985;3649;256;1080;184;621;440;1701
313320;201403;2419;7440;2037;6790;452;1607;829;2784;1281;4391
313330;201403;3849;12832;3451;12087;741;3003;1674;5788;2415;8791
313340;201403;2189;5416;1734;4774;381;1132;957;2571;1338;3703
313350;201403;3358;10635;2639;9018;676;2471;509;1573;1185;4044
313360;201403;1186;3668;923;3168;301;1217;374;1150;675;2367
313370;201403;1482;5219;1408;5009;289;1198;624;2042;913;3240
313375;201403;2061;5611;1415;4656;376;1493;498;1579;874;3072
313380;201403;6786;23523;5963;21713;2333;9177;1529;5230;3862;14407
313390;201403;913;3377;883;3330;142;618;569;2115;711;2733
313400;201403;3735;11086;3479;10770;448;1498;2632;8285;3080;9783
313410;201403;1376;3964;1178;3700;265;936;673;2098;938;3034
313420;201403;19441;48950;12916;37339;3080;10147;2949;8169;6029;18316
313430;201403;1319;4339;1192;4115;365;1408;412;1341;777;2749
313440;201403;6547;16046;4984;14217;770;2404;3415;9757;4185;12161
313450;201403;739;2228;597;1931;141;560;203;583;344;1143
313460;201403;2597;9316;2352;8879;821;3387;666;2404;1487;5791
313470;201403;3447;9757;3285;9569;385;1016;2682;8049;3067;9065
313480;201403;1143;3401;886;2945;166;635;376;1195;542;1830
313490;201403;1571;5242;1177;4559;470;1846;259;1008;729;2854
313500;201403;447;1436;426;1399;90;340;256;820;346;1160
313505;201403;8830;26587;8349;26007;547;1345;7371;23783;7918;25128
313507;201403;1314;3949;1197;3772;238;888;681;2144;919;3032
313510;201403;15918;47961;14389;46055;2504;8331;9943;32629;12447;40960
313520;201403;16288;49668;13931;45728;2147;8192;8755;28558;10902;36750
313530;201403;540;1898;480;1775;77;330;188;640;265;970
313535;201403;2518;7696;2267;7284;395;1354;1395;4554;1790;5908
313540;201403;1140;3651;908;3069;270;958;226;705;496;1663
313545;201403;1396;5173;1243;4892;251;1189;729;2758;980;3947
313550;201403;1955;6744;1869;6566;524;1990;903;3050;1427;5040
313560;201403;2307;5777;2034;5462;261;696;1532;4285;1793;4981
313570;201403;819;3032;721;2842;284;1226;229;839;513;2065
313580;201403;6191;17860;5398;16792;781;2594;3855;12125;4636;14719
313590;201403;1090;3282;887;3041;423;1542;305;1028;728;2570
313600;201403;3880;12072;3460;11404;640;2331;2012;6731;2652;9062
313610;201403;1158;3678;1011;3393;282;1046;406;1332;688;2378
313620;201403;7462;25316;7069;24480;2419;8948;2256;7662;4675;16610
313630;201403;8769;27522;7573;25658;2337;8718;2511;8892;4848;17610
313640;201403;843;2728;744;2594;275;1031;276;963;551;1994
313650;201403;2304;7635;2057;7242;294;1072;1469;5296;1763;6368
313652;201403;1026;3732;947;3574;179;727;559;2139;738;2866
313655;201403;991;3322;837;3063;200;826;476;1697;676;2523
313657;201403;1169;3954;1074;3795;167;754;700;2282;867;3036
313660;201403;906;3162;841;3050;238;996;390;1339;628;2335
313665;201403;3085;10379;2888;9971;692;2708;1358;4532;2050;7240
313670;201403;48445;140565;34116;116307;10069;38114;10166;33502;20235;71616
313680;201403;1110;3385;985;3195;122;410;706;2321;828;2731
313690;201403;946;3455;868;3296;250;969;328;1289;578;2258
313695;201403;1497;4963;1293;4634;175;743;893;3189;1068;3932
313700;201403;3962;13266;3387;12495;559;2181;2321;8700;2880;10881
313710;201403;1412;4003;1198;3687;374;1271;540;1608;914;2879
313720;201403;5409;18418;4727;16966;1304;5200;1360;4381;2664;9581
313730;201403;1286;3579;1027;3265;151;526;663;2130;814;2656
313740;201403;2095;7673;1749;6778;601;2625;223;805;824;3430
313750;201403;2970;9244;2618;8572;835;2990;687;2077;1522;5067
313753;201403;1856;5705;1574;5218;488;1747;572;1932;1060;3679
313760;201403;4332;14573;3749;13375;1188;4671;1049;3571;2237;8242
313770;201403;3667;12514;3492;12114;1224;4517;968;3296;2192;7813
313780;201403;3951;11441;3231;10377;856;3166;1436;4461;2292;7627
313790;201403;557;1955;540;1930;120;448;300;1092;420;1540
313800;201403;1264;3649;1134;3443;187;665;692;2078;879;2743
313810;201403;1490;4655;1433;4571;223;725;1007;3304;1230;4029
313820;201403;13063;38995;11053;35410;3115;11134;4009;12786;7124;23920
313830;201403;449;1551;387;1422;124;517;114;405;238;922
313835;201403;1071;3585;1030;3519;248;921;537;1820;785;2741
313840;201403;7589;23246;6481;21396;1927;7127;2074;6550;4001;13677
313850;201403;1279;3637;1158;3424;277;965;590;1630;867;2595
313860;201403;2702;8530;2297;7674;681;2525;491;1488;1172;4013
313862;201403;1125;3064;819;2567;238;800;237;743;475;1543
313865;201403;2249;7243;2098;6982;337;1267;1418;4677;1755;5944
313867;201403;1067;3765;914;3441;326;1292;292;1114;618;2406
313868;201403;1565;5596;1401;5246;176;770;931;3491;1107;4261
313870;201403;921;2922;827;2784;234;919;318;987;552;1906
313880;201403;2272;7382;2086;7137;484;1962;1032;3259;1516;5221
313890;201403;2011;5582;1721;5213;304;928;1103;3417;1407;4345
313900;201403;4764;17625;4480;16996;1682;7104;1189;4440;2871;11544
313910;201403;774;2662;669;2438;280;1118;108;349;388;1467
313920;201403;3711;12075;3400;11551;596;2076;2054;7287;2650;9363
313925;201403;2124;5723;1573;4701;134;468;1044;3111;1178;3579
313930;201403;5360;17879;4546;16458;831;3293;2552;9501;3383;12794
313940;201403;7473;26377;6582;24908;2310;9502;2427;9438;4737;18940
313950;201403;4865;14366;4111;13135;1294;4730;1361;4110;2655;8840
313960;201403;6125;16828;5093;15404;1695;5780;1282;3810;2977;9590
313970;201403;1511;4461;1265;4184;257;933;789;2631;1046;3564
313980;201403;1215;4103;1061;3824;329;1343;310;1072;639;2415
313990;201403;2017;7703;1806;7220;661;2849;414;1513;1075;4362
314000;201403;8230;28524;7665;27434;2210;8858;3855;13471;6065;22329
314010;201403;1096;3260;926;3047;181;699;505;1596;686;2295
314015;201403;1615;6107;1493;5833;532;2193;432;1698;964;3891
314020;201403;512;1665;431;1480;142;540;117;369;259;909
314030;201403;841;2748;676;2369;117;455;230;782;347;1237
314040;201403;643;1922;562;1778;191;645;260;793;451;1438
314050;201403;1910;6356;1616;5750;504;1999;443;1450;947;3449
314053;201403;1485;5003;1403;4901;253;871;946;3445;1199;4316
314055;201403;2254;6817;2011;6476;208;693;1495;4927;1703;5620
314060;201403;1101;3608;960;3351;136;555;595;2057;731;2612
314070;201403;3601;11653;2886;10177;836;3246;713;2377;1549;5623
314080;201403;1901;5966;1381;4836;271;1059;326;1037;597;2096
314085;201403;1882;6667;1651;6348;553;2349;576;2222;1129;4571
314090;201403;3536;12247;3208;11607;1035;4089;1141;4169;2176;8258
314100;201403;3546;9692;3114;9079;381;1133;2355;7006;2736;8139
314110;201403;4469;14956;3969;13921;1012;4063;1430;4612;2442;8675
314120;201403;1069;2648;599;1894;184;673;150;441;334;1114
314130;201403;688;2010;416;1380;82;289;85;264;167;553
314140;201403;5081;16139;4552;15133;1058;3846;2128;7113;3186;10959
314150;201403;1773;4759;1396;4162;272;917;648;1890;920;2807
314160;201403;2439;6642;1998;6056;161;537;1627;5011;1788;5548
314170;201403;1082;3421;930;3094;174;686;468;1473;642;2159
314180;201403;6548;21073;5866;20046;1686;6315;2476;8613;4162;14928
314190;201403;822;2642;738;2504;246;960;259;832;505;1792
314200;201403;3087;10131;2794;9605;425;1665;1857;6304;2282;7969
314210;201403;2004;6324;1802;5945;412;1488;913;2899;1325;4387
314220;201403;1751;5815;1484;5248;501;1967;331;1018;832;2985
314225;201403;1181;3712;1070;3557;73;192;944;3227;1017;3419
314230;201403;706;2488;660;2404;203;817;218;747;421;1564
314240;201403;1136;3670;1016;3484;255;870;600;2135;855;3005
314250;201403;520;1607;416;1393;132;498;138;424;270;922
314260;201403;1306;4780;1245;4650;414;1644;454;1697;868;3341
314270;201403;2717;9535;2569;9275;320;1316;1747;6340;2067;7656
314280;201403;3270;9530;2414;7918;742;2798;617;1762;1359;4560
314290;201403;5452;15518;4675;14274;778;2547;3117;9551;3895;12098
314300;201403;1987;6767;1840;6423;637;2380;633;2133;1270;4513
314310;201403;6652;21560;5895;20006;2272;8236;1484;4843;3756;13079
314315;201403;974;3747;912;3625;154;700;529;2130;683;2830
314320;201403;3395;10512;2808;9690;980;3709;1040;3523;2020;7232
314330;201403;54229;177676;51272;172516;16139;59362;22240;73696;38379;133058
314340;201403;2536;7277;1448;4984;375;1424;139;311;514;1735
314345;201403;1314;4490;1175;4275;368;1389;553;2073;921;3462
314350;201403;1419;4231;1161;3805;469;1680;287;934;756;2614
314360;201403;714;2303;523;1912;146;625;123;418;269;1043
314370;201403;569;2025;531;1971;173;707;247;894;420;1601
314380;201403;1137;3555;877;3094;341;1280;220;797;561;2077
314390;201403;15708;48063;12908;42711;4134;14888;3434;10875;7568;25763
314400;201403;5485;15789;4523;14466;1374;4426;2421;8103;3795;12529
314410;201403;2650;8763;2341;8119;749;2916;765;2486;1514;5402
314420;201403;783;2305;644;2113;95;384;480;1554;575;1938
314430;201403;8227;24867;7440;23446;2505;8690;2243;7157;4748;15847
314435;201403;1235;4103;1125;3895;157;662;716;2411;873;3073
314437;201403;1201;3152;1064;2956;102;280;815;2287;917;2567
314440;201403;761;2132;540;1831;197;744;114;356;311;1100
314450;201403;1778;5332;1535;4981;518;1945;647;1938;1165;3883
314460;201403;4661;16351;4140;15169;1375;5507;758;2749;2133;8256
314465;201403;2411;7812;2223;7477;221;916;1639;5406;1860;6322
314467;201403;1114;3208;969;2966;180;540;593;1872;773;2412
314470;201403;2406;7996;1930;6882;546;2269;428;1254;974;3523
314480;201403;7344;25677;5539;20747;1309;5276;532;1789;1841;7065
314490;201403;996;3029;822;2687;234;893;343;1056;577;1949
314500;201403;2826;8221;2367;7341;724;2516;791;2448;1515;4964
314505;201403;1794;5629;1699;5459;389;1389;965;3100;1354;4489
314510;201403;1977;5681;1431;4854;524;1951;337;1088;861;3039
314520;201403;3806;14748;3203;13167;1100;4967;549;2040;1649;7007
314530;201403;7247;25871;6710;25036;1255;4895;3933;15267;5188;20162
314535;201403;2793;8070;2466;7637;369;1252;1644;5152;2013;6404
314537;201403;1444;4413;1221;4014;270;1052;561;1846;831;2898
314540;201403;466;1461;412;1340;127;477;123;364;250;841
314545;201403;1370;4436;1225;4213;271;1023;641;2204;912;3227
314550;201403;604;1780;472;1598;127;516;130;401;257;917
314560;201403;5341;19251;4728;17654;1256;5176;1152;4154;2408;9330
314570;201403;370;1170;332;1093;100;352;150;475;250;827
314580;201403;462;1625;393;1478;149;636;89;310;238;946
314585;201403;742;2584;588;2259;173;729;161;602;334;1331
314587;201403;1729;5636;1563;5333;301;1069;817;2811;1118;3880
314590;201403;4287;15073;3223;12133;745;3040;386;1321;1131;4361
314600;201403;2123;7397;1782;6795;681;2893;334;1174;1015;4067
314610;201403;8438;30440;7956;29315;2549;10202;2551;9028;5100;19230
314620;201403;1777;5336;1606;5122;233;747;1172;3860;1405;4607
314625;201403;1562;5205;1526;5161;209;776;1143;3911;1352;4687
314630;201403;5161;15550;4549;14573;676;2395;2992;9759;3668;12154
314640;201403;834;2422;715;2210;244;816;180;508;424;1324
314650;201403;1308;4010;1049;3522;270;1044;414;1260;684;2304
314655;201403;1698;5110;1330;4433;266;923;649;2179;915;3102
314660;201403;213;602;171;517;25;88;97;280;122;368
314670;201403;1491;4221;1220;3743;226;756;674;2059;900;2815
314675;201403;1889;5886;1698;5562;218;815;1076;3567;1294;4382
314690;201403;2743;8862;2372;8189;705;2799;640;2025;1345;4824
314700;201403;10286;39266;9263;37018;4140;17471;1936;7972;6076;25443
314710;201403;8499;27646;6102;22254;1447;5958;737;2444;2184;8402
314720;201403;2676;9110;2267;8279;689;2778;871;3133;1560;5911
314730;201403;2545;7967;2140;7377;760;2943;626;2043;1386;4986
314740;201403;3089;10529;2815;10022;895;3477;1005;3438;1900;6915
314750;201403;333;1111;301;1038;63;262;138;457;201;719
314760;201403;1754;6165;1307;4999;294;1337;271;845;565;2182
314770;201403;1202;3854;773;2683;94;395;107;281;201;676
314780;201403;320;898;244;794;90;336;92;281;182;617
314790;201403;13629;42329;10593;37007;4073;16274;2446;7907;6519;24181
314795;201403;1527;4731;1361;4460;155;683;1015;3166;1170;3849
314800;201403;17274;53640;14498;48036;5777;20189;2713;9138;8490;29327
314810;201403;13081;40012;10379;35110;3321;12639;2370;7902;5691;20541
314820;201403;1117;3144;786;2653;270;1011;243;746;513;1757
314830;201403;1705;5904;1515;5529;547;2205;529;1943;1076;4148
314840;201403;1125;3997;901;3662;183;869;527;2138;710;3007
314850;201403;2282;6664;1928;6055;372;1367;1040;3227;1412;4594
314860;201403;3289;11460;3040;11058;617;2488;1804;6572;2421;9060
314870;201403;5754;18837;5175;18044;825;3283;3547;12515;4372;15798
314875;201403;1725;5946;1686;5889;329;1113;1248;4455;1577;5568
314880;201403;821;2448;732;2304;76;255;516;1625;592;1880
314890;201403;604;1906;463;1632;143;567;109;326;252;893
314900;201403;425;1362;346;1221;108;404;148;513;256;917
314910;201403;1750;6178;1547;5824;606;2506;358;1263;964;3769
314915;201403;2524;8056;2243;7649;236;929;1730;5857;1966;6786
314920;201403;651;1909;494;1677;98;380;221;701;319;1081
314930;201403;5207;18035;4625;16773;1507;5979;988;3517;2495;9496
314940;201403;416;1237;394;1196;99;312;195;579;294;891
314950;201403;386;1354;333;1242;95;397;67;231;162;628
314960;201403;808;2671;667;2387;201;783;161;544;362;1327
314970;201403;882;3191;804;3020;314;1307;179;628;493;1935
314980;201403;2254;6991;2046;6653;810;2817;276;841;1086;3658
314990;201403;3184;10385;2602;9095;932;3566;425;1322;1357;4888
314995;201403;1578;5008;1439;4812;251;999;948;3075;1199;4074
315000;201403;1057;3181;889;2937;170;682;529;1694;699;2376
315010;201403;494;1616;411;1441;130;531;136;418;266;949
315015;201403;1929;6048;1771;5856;334;1173;1212;4146;1546;5319
315020;201403;758;2489;648;2255;164;640;243;772;407;1412
315030;201403;1013;3137;881;2894;347;1252;166;516;513;1768
315040;201403;947;2965;873;2836;183;621;519;1672;702;2293
315050;201403;1642;4962;1378;4526;467;1700;439;1380;906;3080
315053;201403;1156;3479;1008;3241;256;993;400;1216;656;2209
315057;201403;1899;6539;1564;6034;244;975;976;3898;1220;4873
315060;201403;953;3279;808;2918;243;959;188;706;431;1665
315070;201403;682;2106;633;2031;172;606;336;1036;508;1642
315080;201403;3496;12198;3172;11518;854;3359;1386;5050;2240;8409
315090;201403;757;2770;679;2606;197;817;230;930;427;1747
315100;201403;1185;4137;965;3650;276;1161;227;805;503;1966
315110;201403;1667;5165;1468;4813;432;1529;590;1916;1022;3445
315120;201403;13878;34056;10145;29253;1964;6219;5198;15835;7162;22054
315130;201403;1827;6125;1655;5773;559;2121;382;1271;941;3392
315140;201403;2510;8582;2120;7719;594;2485;627;2005;1221;4490
315150;201403;4790;13470;3662;11474;894;3230;1325;3990;2219;7220
315160;201403;1357;3921;1231;3749;253;861;703;2106;956;2967
315170;201403;1397;4256;1220;4007;280;1012;670;2288;950;3300
315180;201403;13922;43971;10956;37692;3066;11952;2566;8398;5632;20350
315190;201403;2413;6521;1981;5896;625;1982;848;2548;1473;4530
315200;201403;4530;15504;3810;13894;1181;4741;964;3370;2145;8111
315210;201403;8841;27552;7553;25029;2641;9515;2279;7353;4920;16868
315213;201403;1140;3710;1099;3653;106;329;912;3124;1018;3453
315217;201403;2737;9340;2313;8611;391;1641;1299;4883;1690;6524
315220;201403;10209;30611;9119;29129;1882;6145;5547;18298;7429;24443
315230;201403;2505;6827;2308;6593;146;366;2016;5882;2162;6248
315240;201403;3314;10822;3037;10344;630;2383;1747;5926;2377;8309
315250;201403;9252;30360;7230;26559;2466;10172;2124;7701;4590;17873
315260;201403;1074;3620;918;3263;338;1318;143;437;481;1755
315270;201403;879;3176;767;2935;254;1045;161;580;415;1625
315280;201403;3979;12378;3203;10623;1112;3929;720;2225;1832;6154
315290;201403;1274;3708;997;3264;366;1318;169;550;535;1868
315300;201403;540;1556;420;1407;217;775;116;360;333;1135
315310;201403;1226;4167;1119;3985;161;648;734;2576;895;3224
315320;201403;857;2895;734;2719;231;927;318;1205;549;2132
315330;201403;797;2879;600;2393;237;1050;82;303;319;1353
315340;201403;4236;12487;3642;11560;1017;3532;1575;5049;2592;8581
315350;201403;1866;5374;1538;4928;215;665;1105;3685;1320;4350
315360;201403;1705;5836;1408;5040;336;1284;442;1491;778;2775
315370;201403;618;1891;546;1783;134;499;288;917;422;1416
315380;201403;285;1031;260;959;80;321;42;139;122;460
315390;201403;1959;7060;1724;6513;608;2492;373;1373;981;3865
315400;201403;4644;14540;4159;13595;1074;3823;1965;6422;3039;10245
315410;201403;1773;5003;1508;4578;320;1196;829;2387;1149;3583
315415;201403;1181;4018;1094;3883;455;1631;426;1577;881;3208
315420;201403;1529;4861;1158;4150;357;1349;179;612;536;1961
315430;201403;4054;11225;3093;9591;790;2811;915;2696;1705;5507
315440;201403;979;3045;881;2896;182;688;472;1544;654;2232
315445;201403;2185;6301;1851;5855;300;1088;1218;3827;1518;4915
315450;201403;2505;8102;2359;7886;498;1695;1480;5119;1978;6814
315460;201403;39294;133448;35369;125095;11948;45808;8451;28909;20399;74717
315470;201403;557;1760;499;1661;87;309;305;1001;392;1310
315480;201403;1433;4563;1020;3638;217;890;213;707;430;1597
315490;201403;3267;9448;2834;8836;546;2031;1581;4766;2127;6797
315500;201403;458;1486;317;1130;65;277;120;358;185;635
315510;201403;1491;4364;1295;4044;138;483;889;2777;1027;3260
315520;201403;1162;3669;982;3426;163;655;585;1969;748;2624
315530;201403;502;1787;474;1740;230;885;139;483;369;1368
315540;201403;1282;3963;1035;3559;223;943;361;1212;584;2155
315550;201403;1710;5113;1472;4803;506;1844;574;1835;1080;3679
315560;201403;7200;24092;6643;23346;981;3819;4477;15803;5458;19622
315570;201403;2394;7610;2249;7395;499;1863;1259;4060;1758;5923
315580;201403;2727;8575;2250;7669;632;2550;794;2499;1426;5049
315590;201403;889;2626;817;2522;132;477;529;1594;661;2071
315600;201403;2607;9426;2184;8726;379;1626;1282;5343;1661;6969
315610;201403;1005;3055;861;2749;206;795;298;787;504;1582
315620;201403;337;1208;330;1193;97;361;156;582;253;943
315630;201403;997;3252;865;3034;239;886;225;778;464;1664
315640;201403;755;2403;658;2213;222;868;197;595;419;1463
315645;201403;872;2824;761;2555;308;1150;162;497;470;1647
315650;201403;1899;5653;1710;5387;164;654;1276;3926;1440;4580
315660;201403;2675;7428;2426;7077;441;1398;1482;4311;1923;5709
315670;201403;11819;42651;10908;40822;4007;16141;3218;11785;7225;27926
315680;201403;2889;10248;2400;9304;904;3647;550;2242;1454;5889
315690;201403;3302;10617;2733;9592;969;3766;719;2513;1688;6279
315700;201403;7411;23916;6450;21957;1414;5511;2957;9598;4371;15109
315710;201403;1839;5509;1505;4987;226;878;883;2898;1109;3776
315720;201403;3001;9887;2747;9406;763;2892;1163;3785;1926;6677
315725;201403;1637;5109;1330;4706;458;1660;597;2168;1055;3828
315727;201403;656;2116;592;1983;140;507;284;935;424;1442
315730;201403;998;3129;910;2961;197;694;495;1619;692;2313
315733;201403;1162;3804;1079;3636;470;1677;310;1016;780;2693
315737;201403;1381;4236;1127;3789;115;448;727;2474;842;2922
315740;201403;1036;3379;911;3148;251;1003;392;1245;643;2248
315750;201403;1149;3605;1035;3448;106;445;761;2471;867;2916
315760;201403;945;2693;921;2660;21;56;880;2559;901;2615
315765;201403;1478;4627;1382;4474;161;556;1030;3382;1191;3938
315770;201403;1684;5513;1545;5221;458;1676;527;1733;985;3409
315780;201403;23664;79274;22063;75817;7384;27252;6337;21807;13721;49059
315790;201403;3230;11288;2945;10675;331;1189;1951;7323;2282;8512
315800;201403;1550;6104;1308;5400;410;1864;239;935;649;2799
315810;201403;1507;4370;1293;4029;235;793;793;2399;1028;3192
315820;201403;3072;10224;2635;9566;730;2795;1285;4780;2015;7575
315830;201403;1488;5101;1379;4878;341;1390;417;1387;758;2777
315840;201403;745;2058;582;1754;110;378;181;496;291;874
315850;201403;1342;4836;1306;4767;396;1504;514;1845;910;3349
315860;201403;437;1628;371;1486;118;539;80;317;198;856
315870;201403;478;1452;408;1343;120;445;134;399;254;844
315880;201403;1109;3079;932;2857;272;966;415;1238;687;2204
315890;201403;1684;5774;1526;5534;473;1795;735;2767;1208;4562
315895;201403;5173;16455;4829;15808;1379;5013;2088;6629;3467;11642
315900;201403;786;2560;738;2477;182;735;396;1217;578;1952
315910;201403;618;2214;576;2131;228;877;236;855;464;1732
315920;201403;1470;4413;1070;3575;306;1146;300;916;606;2062
315930;201403;1119;3191;926;2842;294;979;283;835;577;1814
315935;201403;1170;3988;1090;3815;328;1269;331;1115;659;2384
315940;201403;647;2124;590;2016;186;720;239;788;425;1508
315950;201403;1244;3903;1165;3748;346;1140;631;2074;977;3214
315960;201403;2841;9719;2245;8511;1056;4569;152;491;1208;5060
315970;201403;808;2312;660;2098;81;259;476;1571;557;1830
315980;201403;4103;10504;2880;8378;780;2596;840;2089;1620;4685
315990;201403;4363;13264;3892;12527;922;3523;1994;6252;2916;9775
316000;201403;584;1944;518;1836;232;906;141;475;373;1381
316010;201403;450;1662;403;1551;107;475;109;366;216;841
316020;201403;1194;3820;962;3415;186;753;513;1816;699;2569
316030;201403;3648;10529;2711;9047;381;1411;1429;4914;1810;6325
316040;201403;3527;11252;2554;9008;426;1720;288;767;714;2487
316045;201403;2114;6939;1970;6698;288;908;1369;4953;1657;5861
316050;201403;378;1243;332;1175;79;315;168;575;247;890
316060;201403;781;2412;647;2223;125;537;369;1203;494;1740
316070;201403;6085;20603;5652;19729;1850;7108;2293;7614;4143;14722
316080;201403;747;2819;679;2633;165;716;134;514;299;1230
316090;201403;620;1863;478;1566;113;422;119;344;232;766
316095;201403;1310;4406;1196;4190;346;1273;666;2375;1012;3648
316100;201403;2724;9324;2170;7903;591;2434;402;1342;993;3776
316105;201403;957;2730;728;2349;172;606;318;1055;490;1661
316110;201403;12446;44340;11362;42303;1579;6618;7775;29641;9354;36259
316120;201403;1291;4499;1188;4257;386;1443;434;1544;820;2987
316130;201403;1261;3070;958;2651;197;637;530;1444;727;2081
316140;201403;1089;3258;847;2868;140;529;490;1681;630;2210
316150;201403;1339;4190;1280;4100;360;1341;648;1988;1008;3329
316160;201403;1248;3780;1002;3297;143;552;544;1766;687;2318
316165;201403;970;2714;816;2474;169;595;438;1301;607;1896
316170;201403;1392;4095;1052;3488;231;887;412;1274;643;2161
316180;201403;1260;4091;1010;3578;294;1208;270;885;564;2093
316190;201403;2702;8444;1465;5208;283;1060;242;750;525;1810
316200;201403;3825;12610;3010;10989;887;3783;855;2971;1742;6754
316210;201403;5075;16798;4695;16001;2112;7719;941;3197;3053;10916
316220;201403;670;2088;467;1691;113;482;56;212;169;694
316225;201403;1092;3250;973;3093;144;543;644;1989;788;2532
316230;201403;462;1399;382;1257;77;283;191;647;268;930
316240;201403;6349;20218;5566;19199;704;2494;4149;14543;4853;17037
316245;201403;3106;11091;2940;10816;296;1369;2216;8095;2512;9464
316250;201403;9235;29527;8167;27355;3234;11696;2103;6613;5337;18309
316255;201403;2384;7664;2122;7354;353;1163;1493;5325;1846;6488
316257;201403;1400;3998;1100;3465;278;1006;386;1138;664;2144
316260;201403;1845;5374;1416;4758;313;1186;735;2492;1048;3678
316265;201403;1200;3514;1050;3218;108;382;737;2217;845;2599
316270;201403;5199;16906;4851;16195;1393;5062;2035;6855;3428;11917
316280;201403;3314;11180;3002;10557;600;2373;1595;5609;2195;7982
316290;201403;3196;10718;2931;10209;762;3027;1254;4129;2016;7156
316292;201403;3827;12939;3540;12380;1092;4260;1419;4678;2511;8938
316294;201403;799;2661;529;2001;125;562;77;261;202;823
316295;201403;1974;7114;1859;6878;458;1957;951;3289;1409;5246
316300;201403;960;3036;841;2827;94;333;555;1918;649;2251
316310;201403;705;2247;551;1928;126;491;189;650;315;1141
316320;201403;574;1957;514;1871;135;563;133;455;268;1018
316330;201403;990;3056;820;2718;143;475;457;1555;600;2030
316340;201403;1158;3840;1028;3578;325;1288;280;871;605;2159
316350;201403;1478;4900;1352;4687;292;1052;716;2634;1008;3686
316360;201403;777;2062;618;1846;83;268;452;1354;535;1622
316370;201403;5088;17017;4556;15954;1582;5965;989;3521;2571;9486
316380;201403;1475;4225;1228;3857;129;465;854;2691;983;3156
316390;201403;929;2861;780;2595;269;982;303;1020;572;2002
316400;201403;1483;5063;1321;4771;357;1395;509;1865;866;3260
316410;201403;1228;4138;1149;4012;278;1084;623;2139;901;3223
316420;201403;2015;6901;1874;6710;291;1177;1188;4303;1479;5480
316430;201403;961;2967;800;2691;250;934;281;901;531;1835
316440;201403;641;2165;565;2065;244;1015;192;659;436;1674
316443;201403;697;2154;592;1946;149;547;222;699;371;1246
316447;201403;1349;4514;1290;4410;164;629;1027;3490;1191;4119
316450;201403;2232;7847;1997;7376;472;1801;1114;4250;1586;6051
316460;201403;884;2863;830;2777;227;868;450;1413;677;2281
316470;201403;8215;27375;6549;23610;2106;8679;1830;6194;3936;14873
316480;201403;254;886;229;841;65;254;72;252;137;506
316490;201403;373;1215;355;1174;116;410;141;449;257;859
316500;201403;1068;3947;759;2990;173;758;46;169;219;927
316510;201403;977;3577;877;3358;359;1439;204;765;563;2204
316520;201403;1214;3832;1019;3541;273;1108;367;1143;640;2251
316530;201403;1168;3818;978;3422;259;1100;364;1067;623;2167
316540;201403;1020;3384;921;3219;263;1090;307;956;570;2046
316550;201403;1261;4365;1166;4215;254;1025;718;2595;972;3620
316553;201403;2266;8435;1931;7628;654;2752;406;1555;1060;4307
316555;201403;2774;9969;2496;9646;240;933;1986;7854;2226;8787
316556;201403;586;1689;492;1512;48;186;334;975;382;1161
316557;201403;731;2718;706;2677;320;1285;219;813;539;2098
316560;201403;371;1273;313;1139;80;349;78;248;158;597
316570;201403;1430;4606;1270;4272;250;906;648;2169;898;3075
316580;201403;292;857;232;744;65;238;73;214;138;452
316590;201403;1435;4206;1161;3718;222;854;635;1948;857;2802
316600;201403;1186;3931;1081;3719;173;644;641;2176;814;2820
316610;201403;609;2280;571;2209;142;626;320;1214;462;1840
316620;201403;2194;7090;1939;6571;495;1891;845;2781;1340;4672
316630;201403;1531;5181;1359;4825;596;2218;351;1254;947;3472
316640;201403;257;852;226;785;61;248;87;276;148;524
316650;201403;953;3740;864;3589;208;911;452;1978;660;2889
316660;201403;136;420;119;391;25;99;57;175;82;274
316670;201403;1868;5614;1520;4926;573;2123;320;887;893;3010
316680;201403;2010;6047;1759;5653;234;788;1323;4328;1557;5116
316690;201403;1154;4008;1052;3824;388;1602;330;1144;718;2746
316695;201403;1263;3961;1133;3732;109;362;754;2595;863;2957
316700;201403;351;1197;328;1139;80;322;153;493;233;815
316710;201403;3443;13264;3036;12366;1059;4527;869;3755;1928;8282
316720;201403;20205;69439;17599;63635;6360;24345;4269;15260;10629;39605
316730;201403;435;1392;385;1296;101;385;184;564;285;949
316740;201403;761;2647;692;2513;271;1072;178;597;449;1669
316750;201403;424;1506;389;1431;104;437;122;406;226;843
316760;201403;3615;12350;3098;11763;1853;7179;769;3070;2622;10249
316770;201403;1501;4508;1348;4303;228;810;881;2898;1109;3708
316780;201403;707;2481;665;2398;258;998;175;599;433;1597
316790;201403;855;2553;644;2185;182;710;225;732;407;1442
316800;201403;5888;19882;5381;18938;1181;4868;2677;8959;3858;13827
316805;201403;889;2411;846;2356;143;391;622;1788;765;2179
316810;201403;580;1836;513;1693;140;521;232;741;372;1262
316820;201403;396;1144;274;939;104;391;50;160;154;551
316830;201403;622;2233;602;2197;224;874;217;761;441;1635
316840;201403;2957;9084;2571;8366;736;2739;982;2997;1718;5736
316850;201403;2158;6940;1994;6638;488;1803;1018;3347;1506;5150
316860;201403;24129;76033;22027;72121;6271;22922;9340;30177;15611;53099
316870;201403;7161;24344;6329;22314;2305;8804;1246;4264;3551;13068
316880;201403;891;3072;863;3028;359;1393;249;811;608;2204
316890;201403;1467;3843;1169;3434;491;1607;417;1163;908;2770
316900;201403;2745;8796;2425;8154;754;2851;748;2270;1502;5121
316905;201403;468;1648;425;1550;178;701;119;408;297;1109
316910;201403;729;2534;589;2223;151;599;185;720;336;1319
316920;201403;1563;4802;1272;4345;212;813;645;2174;857;2987
316930;201403;9716;33862;8366;30890;2479;10262;1799;6197;4278;16459
316935;201403;4935;15060;3682;12769;1261;4870;833;2737;2094;7607
316940;201403;7033;24138;6020;21992;1577;6384;1620;5734;3197;12118
316950;201403;1526;4594;1351;4360;217;825;881;2791;1098;3616
316960;201403;5307;14142;4529;13121;1042;3311;2524;7272;3566;10583
316970;201403;3571;11865;3400;11565;1344;5154;902;2815;2246;7969
316980;201403;983;3079;784;2743;382;1442;181;628;563;2070
316990;201403;10024;34091;9157;32152;3776;14387;1238;4119;5014;18506
317000;201403;2704;9619;2621;9518;285;854;2059;8187;2344;9041
317005;201403;2474;8129;2348;7964;404;1398;1661;5733;2065;7131
317010;201403;30953;84307;20728;67164;5956;21612;4882;16430;10838;38042
317020;201403;49942;149505;34360;116750;8857;33300;7926;25198;16783;58498
317030;201403;884;2535;751;2332;122;461;420;1296;542;1757
317040;201403;13049;40488;11679;37926;4292;14717;4143;13604;8435;28321
317043;201403;852;2476;726;2307;176;595;403;1293;579;1888
317047;201403;1157;3191;914;2774;165;567;424;1276;589;1843
317050;201403;1855;6712;1628;6167;473;1926;540;1967;1013;3893
317052;201403;2442;7987;2184;7595;279;1064;1593;5609;1872;6673
317057;201403;1796;5274;1412;4613;229;912;712;2263;941;3175
317060;201403;388;1173;301;982;83;313;106;315;189;628
317065;201403;1222;4128;1110;3942;149;608;821;2899;970;3507
317070;201403;9543;32268;7664;28035;2369;9546;1656;6088;4025;15634
317075;201403;1263;3998;1098;3695;390;1432;337;1084;727;2516
317080;201403;7131;20792;6529;19787;2094;6901;2322;7000;4416;13901
317090;201403;4890;16894;4594;16376;821;2998;2952;10804;3773;13802
317100;201403;3314;9903;2881;9178;990;3506;1103;3319;2093;6825
317103;201403;1998;7068;1703;6453;362;1711;750;2742;1112;4453
317107;201403;1343;4256;1174;3913;273;1038;582;1845;855;2883
317110;201403;752;2090;532;1660;152;571;193;541;345;1112
317115;201403;1094;3553;963;3263;142;509;612;2077;754;2586
317120;201403;13407;46183;11644;41982;3921;15118;3998;14166;7919;29284
317130;201403;8950;29099;8163;27655;2271;8696;3389;11153;5660;19849
317140;201403;665;2318;625;2241;85;337;395;1418;480;1755
317150;201403;1059;2939;901;2758;115;420;652;1977;767;2397
317160;201403;3837;10452;2927;9304;421;1587;1905;5955;2326;7542
317170;201403;2026;6018;1826;5680;244;905;1080;3206;1324;4111
317180;201403;1827;6321;1476;5517;419;1725;450;1624;869;3349
317190;201403;1278;3929;1152;3757;114;412;897;2926;1011;3338
317200;201403;4613;15601;4233;14782;1448;5511;1091;3663;2539;9174
317210;201403;1079;3445;927;3199;277;1079;401;1372;678;2451
317220;201403;355;1289;346;1279;129;480;170;650;299;1130
320010;201403;5940;18890;5307;17457;939;3384;2640;8640;3579;12024
320013;201403;2064;6131;1498;5100;221;797;822;2883;1043;3680
320016;201403;3528;9965;3007;9223;541;1679;1975;6195;2516;7874
320020;201403;4221;13904;3907;13222;1348;4876;1401;4727;2749;9603
320030;201403;1763;5853;1593;5476;481;1787;611;2040;1092;3827
320035;201403;1815;5644;1644;5361;553;1988;585;1817;1138;3805
320040;201403;3166;10867;2693;9741;708;2788;754;2627;1462;5415
320050;201403;1926;5389;1661;4869;306;1004;928;2651;1234;3655
320060;201403;11369;36242;9006;30748;2296;8689;3072;9938;5368;18627
320070;201403;1840;6260;1619;5727;507;1906;401;1310;908;3216
320080;201403;5654;16899;4608;14815;1445;5006;1425;4493;2870;9499
320090;201403;9176;26546;7217;22691;2062;6962;2987;9068;5049;16030
320100;201403;3270;9989;2733;8908;655;2306;1240;3966;1895;6272
320110;201403;1543;4782;1416;4529;384;1317;469;1472;853;2789
320115;201403;1829;6790;1750;6609;848;3292;601;2317;1449;5609
320120;201403;17640;60391;15603;56355;5665;21935;4192;15204;9857;37139
320130;201403;41099;138715;38369;132906;11524;43414;16596;55958;28120;99372
320140;201403;4101;13515;2975;10705;729;2925;307;1018;1036;3943
320150;201403;18223;52611;13896;44300;4327;14930;2292;7131;6619;22061
320160;201403;5295;16582;4650;15531;1278;4821;1928;5958;3206;10779
320170;201403;1976;6568;1776;6131;585;2111;563;2004;1148;4115
320180;201403;915;3052;827;2916;308;1139;303;1070;611;2209
320190;201403;4392;16040;4003;14982;1415;5531;1068;3951;2483;9482
320200;201403;1142;3807;1024;3557;315;1189;422;1473;737;2662
320210;201403;6063;16837;5283;15501;1294;4327;2649;7476;3943;11803
320220;201403;2896;8959;2307;7914;699;2632;804;2774;1503;5406
320225;201403;1485;5328;1310;4869;470;1865;261;995;731;2860
320230;201403;4298;14554;4024;14023;1406;5312;1359;4843;2765;10155
320240;201403;9466;29514;7696;26026;2314;8429;1963;6750;4277;15179
320245;201403;4180;14469;3925;13859;1289;4819;1423;4943;2712;9762
320250;201403;1800;5667;1359;4645;346;1310;281;869;627;2179
320255;201403;2054;6947;1790;6484;754;2946;574;2116;1328;5062
320260;201403;1210;3851;975;3223;259;955;340;967;599;1922
320265;201403;2530;7881;2152;7422;284;1017;1552;5526;1836;6543
320270;201403;2707;8418;2136;7287;549;2027;922;3111;1471;5138
320280;201403;7266;22311;6694;21332;1484;5215;3540;11108;5024;16323
320290;201403;1613;5489;1392;4911;514;1894;325;1067;839;2961
320300;201403;4263;14674;3989;14047;1245;4649;1370;4832;2615;9481
320305;201403;4758;15852;4373;14966;1128;4280;1949;6457;3077;10737
320310;201403;2007;6180;1807;5816;475;1659;774;2408;1249;4067
320313;201403;2381;7283;1724;5753;471;1826;290;851;761;2677
320316;201403;2238;7117;2118;6838;614;2092;921;2944;1535;5036
320320;201403;18993;62317;16585;57626;5089;19699;6210;20931;11299;40630
320330;201403;2980;9194;2613;8564;573;1880;1455;4953;2028;6833
320332;201403;4992;17195;4559;16395;1559;5945;1728;6384;3287;12329
320334;201403;1509;5322;1247;4688;426;1783;234;795;660;2578
320335;201403;2253;6870;1651;5514;550;2045;304;945;854;2990
320340;201403;5796;16711;4710;14823;1175;4111;2104;6513;3279;10624
320350;201403;5626;14738;4185;12293;865;2866;1914;5511;2779;8377
320360;201403;1773;4801;1368;4045;268;898;655;1817;923;2715
320370;201403;3484;11684;3053;10820;944;3472;1143;4087;2087;7559
320380;201403;2801;8723;2520;8179;574;2008;1307;4156;1881;6164
320390;201403;8317;25570;6985;22905;2090;7624;2290;7204;4380;14828
320400;201403;4193;12197;3526;11222;807;2923;1890;5813;2697;8736
320405;201403;4140;12480;3815;12048;1193;4208;1997;6108;3190;10316
320410;201403;6248;15662;4599;13771;831;2609;2984;9043;3815;11652
320420;201403;2084;6429;1611;5678;647;2488;246;793;893;3281
320425;201403;2455;6342;2018;5705;323;1093;1191;3331;1514;4424
320430;201403;2382;7138;2158;6690;449;1534;1055;3205;1504;4739
320435;201403;2520;8624;2171;7871;990;3768;660;2444;1650;6212
320440;201403;1443;4889;1298;4481;397;1485;383;1234;780;2719
320450;201403;2539;8244;2187;7500;642;2433;903;2989;1545;5422
320455;201403;4760;17002;3788;14512;1171;4730;735;2742;1906;7472
320460;201403;3103;10283;2528;9023;782;3019;793;2702;1575;5721
320465;201403;1652;5321;1322;4518;284;1053;507;1678;791;2731
320470;201403;4533;14165;3315;11474;1032;3960;471;1449;1503;5409
320480;201403;1974;6093;1666;5489;418;1598;703;2187;1121;3785
320490;201403;17826;57476;15181;52205;5230;19372;4651;16362;9881;35734
320495;201403;1453;4653;1172;4001;459;1705;273;908;732;2613
320500;201403;46605;147672;40788;136521;13210;47897;16421;53794;29631;101691
320501;201403;3624;12100;3361;11649;1200;4681;1366;4519;2566;9200
320503;201403;2344;8557;2047;7797;696;2852;521;1782;1217;4634
320506;201403;3288;10534;2352;8143;721;2705;255;783;976;3488
320510;201403;8647;27827;7655;25839;2615;9479;2737;9072;5352;18551
320515;201403;2130;6185;1906;5758;543;1762;662;1967;1205;3729
320517;201403;2249;7501;1899;6729;709;2707;403;1345;1112;4052
320520;201403;33218;108384;28735;99547;9384;35993;11397;39090;20781;75083
320530;201403;28026;89006;24420;81751;6646;25373;10237;32486;16883;57859
330010;201403;16950;54341;15826;52022;3364;12546;9201;29094;12565;41640
330015;201403;1987;5610;1725;5110;457;1523;612;1745;1069;3268
330020;201403;16673;50906;15338;48753;3757;12919;8255;26080;12012;38999
330022;201403;1670;5430;1498;5093;311;1213;777;2524;1088;3737
330023;201403;3420;11259;3225;10845;869;3229;1253;4010;2122;7239
330025;201403;3345;10407;3098;10018;804;2821;1795;5705;2599;8526
330030;201403;7626;26840;7067;25659;2060;8248;2957;10199;5017;18447
330040;201403;14525;42206;12401;38782;3480;11688;5830;17888;9310;29576
330045;201403;66443;194495;61067;186241;9747;32035;40630;123391;50377;155426
330050;201403;2951;9549;2650;8948;964;3635;665;2051;1629;5686
330060;201403;5616;17398;5073;16613;1181;4353;2958;9719;4139;14072
330070;201403;25544;80283;23488;76554;6645;23302;10069;32757;16714;56059
330080;201403;9420;27304;8991;26713;1864;5480;5927;18222;7791;23702
330090;201403;3245;9163;3046;8810;881;2791;1399;3930;2280;6721
330093;201403;1986;5918;1734;5490;440;1505;673;2074;1113;3579
330095;201403;1198;4209;1122;4031;419;1667;177;553;596;2220
330100;201403;55142;185274;51495;178905;12089;46850;25930;90415;38019;137265
330110;201403;2684;8599;2474;8212;785;2815;800;2663;1585;5478
330115;201403;2470;7558;2301;7262;752;2601;931;2822;1683;5423
330120;201403;2533;7506;2320;7216;744;2480;955;2891;1699;5371
330130;201403;4007;13403;3655;12711;1222;4605;1345;4634;2567;9239
330140;201403;3404;10538;3115;10142;850;3062;1421;4628;2271;7690
330150;201403;2588;7843;2026;6667;553;2026;440;1374;993;3400
330160;201403;1398;4916;1301;4709;476;1880;417;1448;893;3328
330170;201403;104015;320225;97833;310591;15218;51967;68034;216204;83252;268171
330180;201403;1774;5527;1619;5224;250;1046;1008;3001;1258;4047
330185;201403;7987;25609;7455;24691;1987;6971;3899;13246;5886;20217
330187;201403;4374;12682;3902;11905;840;2906;2236;6744;3076;9650
330190;201403;28318;86545;27071;84500;6943;23088;15511;47751;22454;70839
330200;201403;13764;43946;12465;41474;3001;10290;6473;21947;9474;32237
330205;201403;2593;7163;2316;6688;539;1821;1128;3103;1667;4924
330210;201403;4733;12417;3407;9978;1025;3271;734;2104;1759;5375
330220;201403;11472;36732;10680;35086;3506;12495;3233;10049;6739;22544
330225;201403;4094;13055;3867;12708;569;2216;2713;8893;3282;11109
330227;201403;17735;51075;16073;48794;4021;13039;8874;26488;12895;39527
330230;201403;1521;4552;1401;4335;435;1513;531;1513;966;3026
330240;201403;20537;64529;18404;60661;7011;25332;3186;10207;10197;35539
330245;201403;1249;4036;1044;3602;313;1173;212;735;525;1908
330250;201403;37602;111534;35349;107844;10397;32364;17894;55771;28291;88135
330260;201403;3944;12570;3674;11994;926;3333;1608;5032;2534;8365
330270;201403;14306;42470;12153;39014;3634;12463;4357;14162;7991;26625
330280;201403;2015;6439;1738;5877;398;1504;778;2468;1176;3972
330285;201403;18685;56062;17217;53967;3842;12815;10391;32716;14233;45531
330290;201403;3626;10258;3236;9726;669;2312;1855;5301;2524;7613
330300;201403;4171;13728;3940;13315;935;3433;2039;6922;2974;10355
330310;201403;2773;8201;2533;7798;630;2043;1234;3758;1864;5801
330320;201403;12324;37371;11594;36251;1938;6575;8002;24965;9940;31540
330330;201403;32068;93230;29626;89371;7408;24212;17098;50801;24506;75013
330340;201403;14780;46205;12214;41078;3805;13801;3430;11366;7235;25167
330350;201403;92643;299779;90214;296298;16798;55844;63203;211308;80001;267152
330360;201403;5556;17784;5434;17594;788;2805;4023;12966;4811;15771
330370;201403;3834;14310;3639;13826;1432;5672;1162;4439;2594;10111
330380;201403;4458;14677;3941;13724;1080;4072;1811;6252;2891;10324
330385;201403;4093;14346;3807;13765;1311;5063;1351;4871;2662;9934
330390;201403;24265;82484;22343;78645;5526;21776;11068;37933;16594;59709
330395;201403;3356;10142;3145;9788;533;1833;1929;5997;2462;7830
330400;201403;2586;8758;2374;8358;535;2176;1144;3703;1679;5879
330410;201403;3111;9997;2697;9154;626;2249;1308;4450;1934;6699
330411;201403;2541;8148;2303;7678;480;1854;1188;3724;1668;5578
330412;201403;1397;4859;1126;4331;278;1220;387;1428;665;2648
330414;201403;25918;74433;22331;69611;4601;15247;13556;42440;18157;57687
330415;201403;3686;11745;3284;11013;837;3118;1409;4719;2246;7837
330420;201403;8232;26473;6262;22435;1832;7226;1070;3762;2902;10988
330430;201403;8267;24770;7464;23377;1780;6263;3629;11072;5409;17335
330440;201403;2120;7164;1792;6479;595;2426;397;1304;992;3730
330450;201403;1628;5725;1541;5542;482;1952;604;2106;1086;4058
330452;201403;10508;32883;8816;29522;2484;9252;3483;11143;5967;20395
330455;201403;475528;1408726;410198;1301794;112463;383053;197870;624686;310333;1007739
330460;201403;1403;4778;1318;4620;362;1468;602;2054;964;3522
330470;201403;4503;14870;4188;14237;1455;5354;1313;4343;2768;9697
330475;201403;8299;26628;7509;25306;2052;7624;3618;12127;5670;19751
330480;201403;6495;19903;6142;19269;1764;5991;2545;7907;4309;13898
330490;201403;101158;286545;94342;276646;13176;40749;70625;207947;83801;248696
330500;201403;6924;21324;6519;20522;1433;4880;3420;11014;4853;15894
330510;201403;42318;137876;39934;133940;13796;47205;18359;63186;32155;110391
330513;201403;1602;4868;1474;4617;578;1895;479;1490;1057;3385
330515;201403;3082;9897;2839;9448;964;3426;1022;3362;1986;6788
330520;201403;13478;40721;12444;39045;3239;10737;6467;20355;9706;31092
330530;201403;1568;4719;1451;4516;387;1345;688;2064;1075;3409
330540;201403;3323;10215;2918;9583;886;3149;1111;3554;1997;6703
330550;201403;9091;30261;8061;28323;3287;12318;1860;6628;5147;18946
330555;201403;10434;32216;9436;30694;1950;6550;5797;19248;7747;25798
330560;201403;4221;13091;3962;12663;874;3243;2165;6717;3039;9960
330570;201403;3696;10756;3192;9906;866;2850;1570;4921;2436;7771
330575;201403;5543;16778;5065;15930;1208;4097;2804;8563;4012;12660
330580;201403;17025;55656;15072;51689;5110;18397;5163;18098;10273;36495
330590;201403;1972;6002;1845;5775;540;1768;894;2827;1434;4595
330600;201403;9842;29755;8411;27423;1353;5332;5046;15720;6399;21052
330610;201403;9045;29620;8379;28378;2182;8266;3933;13098;6115;21364
330615;201403;1666;5991;1540;5637;679;2596;397;1506;1076;4102
330620;201403;4055;14329;3752;13718;1327;5211;1012;3838;2339;9049
330630;201403;21496;70948;19372;66574;5357;20541;8926;29237;14283;49778
350010;201403;2998;9453;2367;8134;715;2616;428;1399;1143;4015
350020;201403;615;1750;477;1495;121;436;179;520;300;956
350030;201403;4754;15364;4009;13696;1414;5328;1078;3515;2492;8843
350040;201403;595;2168;519;2000;169;714;102;349;271;1063
350050;201403;1407;4652;1188;4250;328;1354;376;1220;704;2574
350055;201403;620;2082;599;2046;174;647;292;975;466;1622
350060;201403;86;294;79;281;24;106;28;84;52;190
350070;201403;2716;9167;2237;8030;518;2066;402;1256;920;3322
350075;201403;513;1865;472;1779;159;646;123;434;282;1080
350080;201403;605;1791;484;1543;128;479;176;541;304;1020
350090;201403;590;1703;449;1464;120;422;121;358;241;780
350100;201403;1972;6840;1670;6095;549;2148;464;1614;1013;3762
350110;201403;473;1463;377;1246;104;384;118;351;222;735
350115;201403;1361;4489;1212;4117;274;1075;543;1687;817;2762
350120;201403;529;1446;299;957;64;232;76;227;140;459
350130;201403;3730;11573;3407;10936;867;3080;1456;4336;2323;7416
350140;201403;691;2197;627;2067;164;620;251;781;415;1401
350150;201403;435;1508;399;1423;154;582;95;332;249;914
350160;201403;6113;19515;4724;16450;1439;5514;1651;5290;3090;10804
350170;201403;2293;8228;2064;7646;724;2805;452;1593;1176;4398
350180;201403;1454;3829;1219;3435;310;925;515;1411;825;2336
350190;201403;3275;11278;2849;10416;846;3587;1253;4100;2099;7687
350200;201403;416;1431;378;1365;126;520;128;440;254;960
350210;201403;7638;21680;6141;19070;2329;7840;1881;5524;4210;13364
350220;201403;3149;10256;2895;9769;1003;3833;800;2427;1803;6260
350230;201403;758;2591;700;2496;234;914;230;817;464;1731
350240;201403;596;1823;518;1698;118;462;281;874;399;1336
350250;201403;2763;10318;2673;10138;1120;4528;845;3155;1965;7683
350260;201403;1078;2914;900;2592;214;642;375;1104;589;1746
350270;201403;5321;16572;4733;15361;974;3390;2249;7279;3223;10669
350275;201403;2045;6852;1838;6529;561;2219;693;2281;1254;4500
350280;201403;23195;61557;15393;47293;3882;12808;3164;9809;7046;22617
350290;201403;1790;6270;1602;5830;478;1802;458;1719;936;3521
350300;201403;504;1610;469;1536;146;517;161;541;307;1058
350310;201403;1027;3448;963;3298;224;891;404;1322;628;2213
350315;201403;568;1810;469;1602;74;329;152;495;226;824
350320;201403;12155;40488;11246;38414;3571;13068;1903;6306;5474;19374
350330;201403;9568;28536;8441;26208;2099;7227;4211;12200;6310;19427
350335;201403;562;1672;520;1586;132;415;202;678;334;1093
350340;201403;1062;3406;852;3022;234;923;234;799;468;1722
350350;201403;760;2440;670;2287;184;711;214;727;398;1438
350360;201403;846;3034;745;2790;239;939;242;918;481;1857
350370;201403;707;2221;545;1841;107;410;112;336;219;746
350380;201403;3825;12570;3234;11630;1324;5136;714;2423;2038;7559
350390;201403;8744;28568;7806;26843;2179;8018;3547;11859;5726;19877
350395;201403;327;1037;250;876;74;281;51;174;125;455
350400;201403;8342;24774;6940;22249;2045;7202;2444;7460;4489;14662
350410;201403;7679;28651;6855;26695;2431;10223;1526;5708;3957;15931
350420;201403;1026;3290;839;2926;395;1460;75;250;470;1710
350430;201403;870;2767;754;2559;206;834;361;1172;567;2006
350440;201403;1438;4634;1358;4487;483;1717;629;1990;1112;3707
350450;201403;7890;24382;6422;21429;1965;7085;1682;5387;3647;12472
350460;201403;1551;4638;1145;3763;328;1195;321;937;649;2132
350470;201403;238;698;203;638;54;193;90;261;144;454
350480;201403;790;2472;541;1868;91;362;84;237;175;599
350490;201403;2139;6284;1835;5874;518;1910;835;2494;1353;4404
350500;201403;619;1848;538;1724;137;498;217;650;354;1148
350510;201403;1110;3587;951;3231;298;1148;327;993;625;2141
350520;201403;1295;5096;1171;4837;446;1916;288;1181;734;3097
350530;201403;2567;7825;2136;6876;791;2760;517;1503;1308;4263
350535;201403;1497;4478;1456;4420;81;286;1264;3840;1345;4126
350540;201403;2071;6013;1763;5469;499;1688;652;2028;1151;3716
350550;201403;11020;32789;8978;29281;2519;9268;3357;10255;5876;19523
350560;201403;3500;11890;3187;11248;653;2456;1616;5831;2269;8287
350570;201403;21382;74611;19674;70669;6364;24445;6913;23843;13277;48288
350580;201403;2090;6939;1725;6087;504;1965;254;767;758;2732
350590;201403;4220;13777;3278;11717;1016;4035;1075;3485;2091;7520
350600;201403;39607;102129;27918;83603;5816;18987;13194;38309;19010;57296
350610;201403;9257;27465;7495;24471;2034;7459;3280;10247;5314;17706
350620;201403;471;1455;394;1336;92;356;164;528;256;884
350630;201403;1689;5329;1351;4654;420;1658;166;505;586;2163
350635;201403;5091;16691;4147;14818;1269;4799;1491;5358;2760;10157
350640;201403;684;2215;557;1870;157;567;160;500;317;1067
350650;201403;4562;14957;3280;11872;1187;4734;315;1096;1502;5830
350660;201403;3740;11991;3284;11191;889;3252;1550;5234;2439;8486
350670;201403;1890;5924;1774;5718;366;1323;1102;3401;1468;4724
350680;201403;1240;3885;1001;3394;292;1177;398;1291;690;2468
350690;201403;1072;3677;935;3371;283;1135;231;762;514;1897
350700;201403;2760;9629;2425;8867;961;3892;854;2778;1815;6670
350710;201403;2211;7064;2029;6784;336;1283;1354;4473;1690;5756
350715;201403;1130;3489;1010;3263;277;1004;372;1106;649;2110
350720;201403;140;435;130;416;50;178;41;107;91;285
350730;201403;434;1665;409;1592;125;544;116;410;241;954
350740;201403;2434;7471;2198;6952;578;2003;893;2819;1471;4822
350745;201403;352;1143;290;994;66;272;120;353;186;625
350750;201403;9975;31038;7790;26623;2132;8021;1947;6234;4079;14255
350760;201403;12346;39937;11261;37935;3644;13755;4778;15169;8422;28924
350770;201403;927;2754;669;2241;144;553;243;787;387;1340
350775;201403;633;1894;582;1808;134;486;261;796;395;1282
350780;201403;2140;6576;1623;5487;438;1660;220;689;658;2349
350790;201403;2156;7123;1740;6223;526;1998;336;1074;862;3072
350800;201403;3120;10779;2976;10535;656;2578;1782;6205;2438;8783
350810;201403;2620;7758;2313;7215;778;2668;676;2096;1454;4764
350820;201403;565;1580;421;1273;92;325;154;413;246;738
350830;201403;891;2864;649;2262;127;501;129;367;256;868
350840;201403;2324;8470;1951;7500;621;2635;355;1173;976;3808
350850;201403;6746;23189;5636;20532;1923;7422;1221;4197;3144;11619
350860;201403;3412;11198;3277;10987;526;2011;2397;7982;2923;9993
350870;201403;2463;8477;2212;8091;757;2983;1083;3974;1840;6957
350880;201403;1711;5866;1471;5325;440;1716;289;1039;729;2755
350890;201403;652;1973;533;1723;98;357;175;476;273;833
350900;201403;4630;15662;3902;14048;1062;4178;1053;3540;2115;7718
350910;201403;884;2767;836;2665;367;1221;271;844;638;2065
350920;201403;9854;29901;9125;28692;1814;6306;5646;17100;7460;23406
350925;201403;5354;16879;4803;15778;1443;5206;1964;6208;3407;11414
350930;201403;1577;4423;1328;4011;158;586;928;2685;1086;3271
350940;201403;2324;7868;2133;7556;463;1912;1254;4244;1717;6156
350945;201403;954;3216;850;2997;221;860;346;1164;567;2024
350950;201403;72481;235155;61926;213664;18279;68972;23928;80019;42207;148991
350960;201403;4671;16660;4177;15537;837;3595;2229;7915;3066;11510
350970;201403;4411;16148;3979;15085;1487;6058;1136;4113;2623;10171
350980;201403;705;2304;644;2200;297;1100;131;441;428;1541
350990;201403;1828;6482;1623;6091;579;2353;495;1814;1074;4167
350995;201403;822;2995;780;2914;215;914;377;1343;592;2257
351000;201403;3627;11189;3158;10302;533;2007;1764;5534;2297;7541
351010;201403;421;1294;312;1064;119;447;65;221;184;668
351015;201403;966;3254;840;3012;315;1273;238;780;553;2053
351020;201403;7966;26327;7118;25037;1883;7119;3690;13208;5573;20327
351030;201403;1445;5383;1343;5148;381;1669;451;1636;832;3305
351040;201403;3751;12149;3484;11680;830;3243;1970;6192;2800;9435
351050;201403;9631;31324;7877;27878;2707;10417;2463;8645;5170;19062
351060;201403;33935;107807;28862;98337;9522;34461;9662;32896;19184;67357
351070;201403;1857;5378;1373;4508;467;1673;254;747;721;2420
351080;201403;2831;8673;2245;7953;660;2563;994;3439;1654;6002
351090;201403;384;1359;311;1204;111;492;52;182;163;674
351100;201403;1923;6292;1713;5879;692;2450;461;1597;1153;4047
351110;201403;9564;26084;6149;20087;1845;6653;1608;4934;3453;11587
351120;201403;614;1900;524;1693;75;288;249;716;324;1004
351130;201403;884;2493;462;1596;93;370;106;330;199;700
351140;201403;2029;7091;1859;6714;702;2770;553;1926;1255;4696
351150;201403;2241;7878;1844;6806;498;2018;414;1387;912;3405
351160;201403;1543;5488;1402;5160;479;1954;450;1586;929;3540
351170;201403;1657;5533;1342;4794;372;1422;493;1623;865;3045
351190;201403;697;2278;575;1959;120;424;126;371;246;795
351200;201403;2260;6898;1963;6359;343;1315;964;2868;1307;4183
351210;201403;1115;3541;944;3203;290;1076;278;868;568;1944
351220;201403;3568;12231;3174;11412;888;3499;1335;4724;2223;8223
351230;201403;1922;6527;1746;6181;542;2136;810;2776;1352;4912
351240;201403;1012;3316;745;2696;209;828;156;489;365;1317
351250;201403;892;2616;666;2157;147;525;311;959;458;1484
351260;201403;1198;3618;1085;3382;293;1003;411;1223;704;2226
351270;201403;408;1484;377;1423;114;493;117;392;231;885
351280;201403;5381;16374;3970;13139;1056;3740;1147;3419;2203;7159
351290;201403;1070;3271;906;2944;281;949;273;834;554;1783
351300;201403;10255;38072;8974;35057;2650;11255;3156;12205;5806;23460
351310;201403;3431;10900;2903;9926;711;2817;1353;4267;2064;7084
351320;201403;1012;3598;890;3310;292;1181;207;678;499;1859
351330;201403;280;824;252;772;106;328;61;180;167;508
351340;201403;6718;23658;6087;22362;1796;6965;2822;10380;4618;17345
351350;201403;7944;26401;7115;24631;2160;7894;2505;8329;4665;16223
351360;201403;4892;15151;4614;14678;1302;4691;2101;6468;3403;11159
351370;201403;2030;6677;1673;5917;552;2173;402;1272;954;3445
351380;201403;37835;119845;35276;114716;9477;33728;16258;50589;25735;84317
351385;201403;253;807;247;798;94;312;83;263;177;575
351390;201403;1264;4310;1129;4026;437;1686;361;1198;798;2884
351400;201403;1240;4032;1181;3900;424;1488;389;1310;813;2798
351410;201403;2994;9230;2676;8674;616;2164;1340;4275;1956;6439
351420;201403;458;1362;333;1085;73;259;57;175;130;434
351430;201403;916;2937;838;2794;163;601;545;1801;708;2402
351440;201403;4763;14735;4148;13418;1550;5243;999;3036;2549;8279
351450;201403;1829;5287;1622;5015;501;1569;818;2636;1319;4205
351460;201403;852;2717;729;2475;345;1249;205;667;550;1916
351470;201403;1106;3452;991;3232;403;1444;274;861;677;2305
351480;201403;2969;9891;2718;9464;683;2847;1286;4308;1969;7155
351490;201403;2030;6937;1823;6483;368;1532;964;3273;1332;4805
351492;201403;311;1061;243;881;53;228;73;216;126;444
351495;201403;160;557;131;480;41;159;39;131;80;290
351500;201403;20779;67846;18595;63532;5921;21973;7107;23639;13028;45612
351510;201403;7695;25357;6692;23638;1742;6684;3282;11484;5024;18168
351512;201403;425;1287;371;1184;87;293;158;501;245;794
351515;201403;2076;6958;1665;5996;506;1965;433;1481;939;3446
351518;201403;1651;5791;1266;5110;372;1644;256;964;628;2608
351519;201403;821;2691;713;2440;202;790;263;813;465;1603
351520;201403;820;2312;403;1456;63;266;52;169;115;435
351530;201403;472;1511;408;1347;88;315;123;358;211;673
351535;201403;2646;6955;2164;6265;264;890;1452;4121;1716;5011
351540;201403;2172;7047;1950;6633;944;3423;349;1138;1293;4561
351550;201403;5815;17964;4637;15541;1618;5750;1240;4018;2858;9768
351560;201403;436;1441;384;1319;136;515;64;212;200;727
351565;201403;240;823;223;778;71;291;85;263;156;554
351570;201403;12747;41985;11176;38775;3424;12348;4767;16580;8191;28928
351580;201403;404;1137;305;927;61;185;92;257;153;442
351590;201403;505;1399;396;1174;134;426;77;208;211;634
351600;201403;1928;5627;1732;5279;402;1437;805;2231;1207;3668
351610;201403;633;1806;534;1638;110;399;262;754;372;1153
351620;201403;17755;59050;13970;50768;3603;14450;3360;10871;6963;25321
351630;201403;15052;51649;13924;49792;4029;14994;7109;25787;11138;40781
351640;201403;8487;27635;7088;25211;1786;6951;3476;12165;5262;19116
351650;201403;393;1194;254;853;65;234;36;112;101;346
351660;201403;854;2685;670;2260;158;620;191;566;349;1186
351670;201403;4280;13671;3639;12309;741;2872;1788;5738;2529;8610
351680;201403;650;2031;434;1480;93;347;71;207;164;554
351685;201403;448;1375;365;1228;113;393;125;435;238;828
351690;201403;1351;4068;1073;3446;453;1472;255;758;708;2230
351700;201403;1502;4572;1366;4311;461;1514;440;1350;901;2864
351710;201403;808;2565;683;2282;162;544;199;628;361;1172
351720;201403;1705;5480;1299;4417;283;1074;429;1385;712;2459
351730;201403;1123;3410;961;3184;408;1497;251;765;659;2262
351740;201403;4691;13617;4030;12224;1078;3523;1256;3550;2334;7073
351750;201403;1503;5036;1319;4646;412;1594;325;1049;737;2643
351760;201403;3796;12435;3382;11526;931;3444;1410;4604;2341;8048
351770;201403;2295;7561;2005;7024;715;2594;866;3031;1581;5625
351780;201403;1633;4697;1113;3579;295;1053;220;640;515;1693
351790;201403;1163;3508;993;3263;354;1225;401;1293;755;2518
351800;201403;352;849;305;760;39;115;187;433;226;548
351810;201403;1205;3726;1139;3644;300;1115;686;2082;986;3197
351820;201403;2177;6782;1659;5802;601;2225;179;597;780;2822
351830;201403;4126;13700;3754;12889;931;3541;1690;5570;2621;9111
351840;201403;9037;31603;8146;29749;2786;10763;2488;9043;5274;19806
351850;201403;1350;4565;1124;4084;316;1278;248;797;564;2075
351860;201403;3639;11915;3363;11362;878;3322;1653;5300;2531;8622
351870;201403;35608;111665;32754;106676;7874;27742;18553;60149;26427;87891
351880;201403;113483;373588;100434;347291;32266;118317;29328;100856;61594;219173
351885;201403;666;2457;623;2356;176;710;263;964;439;1674
351890;201403;815;2471;652;2122;206;710;142;429;348;1139
351900;201403;1451;4532;1273;4246;406;1455;451;1509;857;2964
351905;201403;418;1464;363;1358;96;420;171;578;267;998
351907;201403;15223;48699;13378;45143;3039;11555;6509;20974;9548;32529
351910;201403;1180;3820;1096;3673;262;989;383;1200;645;2189
351920;201403;1202;3511;1142;3422;276;946;659;1914;935;2860
351925;201403;997;2957;932;2855;142;559;616;1745;758;2304
351930;201403;3163;10932;2937;10457;819;3336;1284;4147;2103;7483
351940;201403;1031;3202;966;3084;273;964;561;1715;834;2679
351950;201403;1412;3994;1039;3261;215;743;458;1359;673;2102
351960;201403;4229;13645;3459;12234;1177;4237;1392;5173;2569;9410
351970;201403;7043;26861;6408;25487;2331;9807;1970;7784;4301;17591
351980;201403;987;3047;825;2741;179;700;325;959;504;1659
351990;201403;1609;4675;1324;4120;367;1336;355;935;722;2271
352000;201403;2485;8113;2283;7705;573;2100;993;3203;1566;5303
352010;201403;2286;7900;2088;7390;741;2770;423;1484;1164;4254
352020;201403;1526;4994;1377;4694;439;1573;436;1480;875;3053
352030;201403;4532;14438;4135;13917;1001;3580;2291;7861;3292;11441
352040;201403;1856;6615;1613;6001;461;1819;365;1282;826;3101
352042;201403;2356;6822;1784;5608;452;1580;854;2598;1306;4178
352044;201403;1407;4819;1129;4102;259;1015;235;777;494;1792
352050;201403;7900;27119;5918;22498;1832;7602;1005;3359;2837;10961
352060;201403;825;2486;734;2339;204;770;290;829;494;1599
352070;201403;744;2050;689;1960;293;906;208;615;501;1521
352080;201403;538;1677;459;1541;121;462;152;457;273;919
352090;201403;1735;5690;1434;5053;347;1373;456;1462;803;2835
352100;201403;1812;6279;1628;5910;552;2236;566;1849;1118;4085
352110;201403;446;1693;399;1581;121;527;122;459;243;986
352115;201403;378;1248;323;1131;97;373;148;488;245;861
352120;201403;983;2943;864;2776;186;644;477;1567;663;2211
352130;201403;1823;5245;1366;4429;358;1258;500;1474;858;2732
352140;201403;1502;4858;1160;4082;327;1223;454;1583;781;2806
352150;201403;639;1960;517;1723;174;612;193;613;367;1225
352160;201403;1255;3591;1159;3454;258;829;649;1945;907;2774
352170;201403;3215;9954;2933;9460;820;2895;1369;4186;2189;7081
352180;201403;3632;10567;3206;9777;853;2853;1375;3968;2228;6821
352190;201403;1092;3398;1002;3240;211;815;506;1515;717;2330
352200;201403;424;1492;356;1355;74;310;164;644;238;954
352210;201403;16035;44130;12934;39523;2598;8408;7617;23883;10215;32291
352215;201403;572;1831;518;1752;81;313;290;988;371;1301
352220;201403;14973;50540;13965;48483;4730;17493;5080;17573;9810;35066
352230;201403;13715;47636;12154;44657;3771;15192;4459;16067;8230;31259
352240;201403;9571;30905;8812;29553;2984;11314;3327;10411;6311;21725
352250;201403;22789;74446;20244;69277;5385;20210;7759;26206;13144;46416
352260;201403;5451;17052;3930;13876;1043;4100;1236;3994;2279;8094
352265;201403;945;3041;816;2835;138;556;497;1678;635;2234
352270;201403;2552;8777;2217;8018;846;3239;476;1634;1322;4873
352280;201403;2474;7833;2117;7236;591;2267;697;2284;1288;4551
352290;201403;1320;4335;1157;3982;290;1138;322;974;612;2112
352300;201403;968;2935;814;2660;239;843;334;1071;573;1914
352310;201403;32809;111355;29754;106063;8232;31519;16692;58514;24924;90033
352320;201403;5726;17969;5009;16621;1572;5696;1641;4912;3213;10608
352330;201403;2215;7340;1940;7001;702;2727;642;2322;1344;5049
352340;201403;5860;20345;4862;17894;1639;6483;883;2955;2522;9438
352350;201403;1783;6625;1625;6270;452;1913;544;1994;996;3907
352360;201403;1207;4038;1081;3780;300;1248;575;1846;875;3094
352370;201403;911;3130;832;2961;193;772;376;1313;569;2085
352380;201403;1032;3326;914;3125;354;1357;249;807;603;2164
352390;201403;12411;37555;9686;32264;2176;8345;4512;14005;6688;22350
352400;201403;3385;10244;2297;8080;659;2572;840;2794;1499;5366
352410;201403;3781;11243;2930;9788;955;3446;864;2762;1819;6208
352420;201403;1295;3752;1213;3609;455;1517;431;1256;886;2773
352430;201403;6332;20234;5628;19067;2200;8134;1757;5745;3957;13879
352440;201403;16052;51193;13361;45877;3619;13443;4960;16538;8579;29981
352450;201403;640;1932;451;1563;119;459;95;286;214;745
352460;201403;2726;9258;2467;8768;874;3474;795;2574;1669;6048
352470;201403;4922;14091;3060;10186;580;2124;1246;4039;1826;6163
352480;201403;5436;15580;4495;13855;1193;4260;1808;5115;3001;9375
352490;201403;749;2696;640;2443;154;665;122;443;276;1108
352500;201403;8906;29113;8405;28268;3913;14163;2325;7140;6238;21303
352510;201403;3447;12066;2872;10825;1007;4100;665;2439;1672;6539
352520;201403;2452;8793;2211;8244;577;2325;1174;4307;1751;6632
352530;201403;6504;21286;4976;17985;1435;5647;808;2670;2243;8317
352540;201403;490;1633;398;1429;97;385;118;412;215;797
352550;201403;1124;3824;897;3303;290;1167;195;676;485;1843
352560;201403;558;1726;461;1523;91;348;200;590;291;938
352570;201403;1604;5195;1160;4146;255;1042;277;871;532;1913
352580;201403;932;2849;818;2653;291;1085;330;974;621;2059
352585;201403;232;778;183;669;41;173;42;133;83;306
352590;201403;13827;45436;12444;42749;2950;11345;6520;21623;9470;32968
352600;201403;1933;6331;1795;6029;616;2151;623;2048;1239;4199
352610;201403;3641;11798;3261;11178;1243;4674;994;3245;2237;7919
352620;201403;5567;18003;5287;17627;1244;4378;3349;11217;4593;15595
352630;201403;857;2871;809;2752;240;903;359;1187;599;2090
352640;201403;3127;10100;2586;8907;568;2179;1074;3575;1642;5754
352650;201403;853;2583;651;2173;146;520;208;665;354;1185
352660;201403;1095;3858;897;3379;279;1124;249;930;528;2054
352670;201403;7839;26986;6893;25111;2618;9998;1548;5595;4166;15593
352680;201403;3308;11867;2675;10259;657;2788;703;2399;1360;5187
352690;201403;25657;77194;20190;66383;5199;18777;8164;25844;13363;44621
352700;201403;772;2316;619;2080;188;728;259;820;447;1548
352710;201403;5301;15950;3948;13211;1055;3960;1385;4366;2440;8326
352720;201403;8950;30462;8400;29305;2789;10290;3125;10839;5914;21129
352725;201403;416;1261;286;961;54;217;78;240;132;457
352730;201403;2650;9320;2335;8466;616;2447;677;2205;1293;4652
352740;201403;2281;6883;1962;6311;543;2069;854;2464;1397;4533
352750;201403;409;1271;316;1075;98;368;66;192;164;560
352760;201403;964;3397;894;3272;302;1219;449;1569;751;2788
352770;201403;932;2917;881;2821;246;868;317;1003;563;1871
352780;201403;620;2119;546;1948;150;600;170;541;320;1141
352790;201403;661;1958;535;1741;153;544;98;307;251;851
352800;201403;1156;4373;941;3769;272;1123;162;563;434;1686
352810;201403;1042;2813;776;2311;147;513;281;787;428;1300
352820;201403;582;1803;493;1646;205;727;87;299;292;1026
352830;201403;429;1267;331;1059;86;273;52;145;138;418
352840;201403;3596;12709;3187;11805;960;3812;1022;3756;1982;7568
352850;201403;9973;32792;8791;30694;2559;9555;3191;11267;5750;20822
352860;201403;1058;3566;986;3405;398;1447;244;774;642;2221
352870;201403;1125;2873;888;2435;130;465;474;1171;604;1636
352880;201403;2352;7118;1858;6016;444;1558;455;1333;899;2891
352885;201403;314;1086;299;1053;89;347;121;402;210;749
352890;201403;748;2138;648;1946;142;494;238;641;380;1135
352900;201403;19265;59374;14911;50346;3987;14681;5664;18318;9651;32999
352910;201403;288;932;252;850;75;262;28;78;103;340
352920;201403;3412;10579;2924;9615;980;3571;958;2895;1938;6466
352930;201403;7119;22938;5744;19871;1629;6071;1053;3512;2682;9583
352940;201403;27065;92547;23559;84116;8205;30898;4142;14203;12347;45101
352950;201403;319;1018;231;826;59;254;61;192;120;446
352960;201403;557;1811;399;1414;77;297;62;205;139;502
352965;201403;376;1078;306;946;77;257;44;131;121;388
352970;201403;3379;8979;3010;8494;401;1233;2133;6111;2534;7344
352980;201403;1512;4553;1291;4204;426;1438;506;1730;932;3168
352990;201403;3580;12088;3323;11646;1139;4375;1076;3611;2215;7986
353000;201403;534;1519;399;1235;85;294;101;269;186;563
353010;201403;2819;8122;2147;6744;566;2029;758;2178;1324;4207
353020;201403;4452;12476;3200;9806;541;1879;1301;3611;1842;5490
353030;201403;3820;11469;3219;10258;971;3413;768;2263;1739;5676
353040;201403;706;2045;613;1900;208;703;218;651;426;1354
353050;201403;5585;19602;4804;17955;1759;7076;1366;4832;3125;11908
353060;201403;34040;111372;31850;107932;5619;22637;21057;68178;26676;90815
353070;201403;8893;30746;7137;26650;2450;9649;1627;6103;4077;15752
353080;201403;4875;16920;4029;14962;1308;5267;1054;3621;2362;8888
353090;201403;601;2032;536;1897;91;391;259;830;350;1221
353100;201403;272;823;225;715;98;324;45;130;143;454
353110;201403;7936;25157;7156;23722;1749;6196;3821;12808;5570;19004
353120;201403;457;1562;394;1422;134;546;82;262;216;808
353130;201403;3038;9611;2703;9014;1041;3799;909;2840;1950;6639
353140;201403;2617;7504;2150;6573;644;2163;656;1810;1300;3973
353150;201403;1958;6267;1642;5662;607;2206;367;1306;974;3512
353160;201403;632;1902;519;1668;149;504;95;278;244;782
353170;201403;528;1886;481;1799;186;784;179;631;365;1415
353180;201403;5580;17906;4930;16691;785;3109;3042;9930;3827;13039
353190;201403;3668;11867;3201;10775;777;2910;1450;4514;2227;7424
353200;201403;890;3176;804;2986;266;1119;292;1021;558;2140
353205;201403;543;1761;448;1544;104;362;149;524;253;886
353210;201403;1045;2838;863;2515;121;422;543;1546;664;1968
353215;201403;574;1821;501;1666;105;395;168;557;273;952
353220;201403;920;2870;836;2704;225;800;274;850;499;1650
353230;201403;973;3125;895;2993;225;858;278;846;503;1704
353240;201403;2219;7476;2022;7064;643;2503;798;2575;1441;5078
353250;201403;1254;3606;1059;3254;296;981;370;1070;666;2051
353260;201403;1167;3455;1035;3241;332;1112;393;1167;725;2279
353270;201403;668;2038;580;1869;182;633;157;466;339;1099
353280;201403;575;1916;504;1793;171;652;127;429;298;1081
353282;201403;1755;5919;1707;5843;312;1206;1115;3715;1427;4921
353284;201403;341;980;262;830;68;217;73;231;141;448
353286;201403;152;468;102;348;25;83;13;51;38;134
353290;201403;448;1603;403;1523;169;665;132;493;301;1158
353300;201403;1863;6046;1654;5576;572;2067;501;1528;1073;3595
353310;201403;354;1130;335;1081;141;481;88;265;229;746
353320;201403;544;1559;472;1441;113;411;223;633;336;1044
353325;201403;531;1882;451;1709;117;493;57;209;174;702
353330;201403;497;1544;421;1384;100;379;177;528;277;907
353340;201403;3200;10480;2790;9653;941;3517;961;3218;1902;6735
353350;201403;3492;10764;3104;10069;1044;3661;1338;4193;2382;7854
353360;201403;439;1547;389;1426;103;440;198;674;301;1114
353370;201403;718;2365;654;2203;172;617;306;1025;478;1642
353380;201403;413;1369;370;1290;99;386;155;521;254;907
353390;201403;5532;14993;3973;12157;894;3044;1407;3894;2301;6938
353400;201403;627;1991;526;1776;120;446;146;418;266;864
353410;201403;690;2136;587;1971;176;655;283;922;459;1577
353420;201403;697;2079;527;1654;164;559;149;420;313;979
353430;201403;2483;8726;1812;6765;439;1700;116;344;555;2044
353440;201403;60834;202027;54669;187391;16927;61044;16815;56025;33742;117069
353450;201403;463;1426;412;1337;107;414;150;457;257;871
353460;201403;3594;10166;3044;9199;609;1994;1578;4741;2187;6735
353470;201403;11429;36571;9059;31588;2765;10534;1989;6691;4754;17225
353475;201403;1738;5073;1291;4072;303;1040;340;944;643;1984
353480;201403;1549;4678;1400;4410;321;1160;748;2237;1069;3397
353490;201403;1644;4749;1382;4217;369;1266;365;984;734;2250
353500;201403;1221;3560;1130;3403;479;1529;374;1065;853;2594
353510;201403;1383;4524;1167;3940;330;1238;338;988;668;2226
353520;201403;1160;3620;993;3316;380;1361;262;873;642;2234
353530;201403;2783;8449;2511;7951;641;2277;1100;3328;1741;5605
353540;201403;2014;6268;1848;5983;656;2223;707;2318;1363;4541
353550;201403;6786;19752;6048;18552;1161;4161;3341;9567;4502;13728
353560;201403;2194;7349;1847;6714;449;1859;673;2353;1122;4212
353570;201403;524;1686;429;1489;96;376;220;694;316;1070
353580;201403;2465;8167;2312;7894;746;2862;1207;3926;1953;6788
353590;201403;806;2336;685;2122;257;866;163;522;420;1388
353600;201403;1913;5556;1743;5260;395;1343;854;2566;1249;3909
353610;201403;605;2154;535;2007;145;629;163;567;308;1196
353620;201403;2358;8272;2130;7825;689;2767;683;2376;1372;5143
353625;201403;378;1056;270;865;96;348;67;186;163;534
353630;201403;1721;5957;1389;5146;329;1353;256;844;585;2197
353640;201403;1628;4753;1453;4395;369;1199;605;1841;974;3040
353650;201403;6788;20869;4888;16594;1056;3885;1741;5547;2797;9432
353657;201403;336;1107;308;1047;67;275;114;359;181;634
353660;201403;1405;3659;1051;3095;449;1462;157;314;606;1776
353670;201403;4895;16315;4330;15114;1398;5346;1343;4379;2741;9725
353680;201403;677;2432;645;2375;313;1209;176;634;489;1843
353690;201403;535;1488;374;1217;105;392;133;393;238;785
353700;201403;2345;7646;2069;7038;492;1880;665;2108;1157;3988
353710;201403;3395;9211;1821;6491;537;2135;529;1859;1066;3994
353715;201403;483;1464;415;1335;85;313;187;583;272;896
353720;201403;2110;6698;1848;6302;385;1387;1032;3604;1417;4991
353730;201403;4473;14108;3641;12198;887;3205;940;2895;1827;6100
353740;201403;2331;7164;1895;6240;627;2171;488;1536;1115;3707
353750;201403;731;2598;602;2281;178;737;152;576;330;1313
353760;201403;7960;25256;6608;22778;1970;7229;2726;9474;4696;16703
353770;201403;793;2516;534;1862;108;419;53;117;161;536
353780;201403;5926;21261;5391;20170;2513;9682;1267;4946;3780;14628
353790;201403;3133;11297;2812;10620;989;4125;517;1984;1506;6109
353800;201403;14650;47715;11893;42328;3346;13135;4572;15681;7918;28816
353810;201403;1192;4004;1058;3691;329;1211;401;1398;730;2609
353820;201403;1252;4460;1205;4380;405;1702;488;1607;893;3309
353830;201403;798;2201;636;1899;131;438;254;745;385;1183
353850;201403;1861;6188;1745;5990;442;1640;814;2688;1256;4328
353860;201403;2464;8480;2089;7611;694;2727;611;2159;1305;4886
353870;201403;23723;74962;18202;63604;4224;16555;5931;18713;10155;35268
353880;201403;2176;7268;1986;6969;355;1487;1210;4106;1565;5593
353890;201403;2466;6498;1854;5513;519;1738;778;2183;1297;3921
353900;201403;1159;3661;869;3001;211;801;192;579;403;1380
353910;201403;2152;7657;2049;7383;671;2564;818;2980;1489;5544
353920;201403;2522;7603;1941;6395;452;1569;345;1032;797;2601
353930;201403;3973;14198;3416;12981;1196;4835;730;2703;1926;7538
353940;201403;1531;4960;1341;4558;322;1264;529;1645;851;2909
353950;201403;3654;12043;3367;11524;556;2205;2144;7151;2700;9356
353960;201403;610;1982;498;1731;117;450;138;418;255;868
353970;201403;530;1578;464;1494;56;225;327;1024;383;1249
353980;201403;14464;43348;12285;39795;3052;10662;6184;19798;9236;30460
353990;201403;519;1643;480;1547;146;521;172;491;318;1012
354000;201403;1944;5845;1369;4696;302;1168;131;382;433;1550
354010;201403;390;1223;352;1160;151;511;107;354;258;865
354020;201403;4826;14922;4385;14011;1417;4887;1740;5190;3157;10077
354025;201403;1062;3118;865;2759;230;803;203;619;433;1422
354030;201403;651;1749;464;1469;140;498;151;442;291;940
354040;201403;798;2193;634;1890;97;347;357;986;454;1333
354050;201403;961;3276;890;3126;337;1299;227;765;564;2064
354060;201403;4650;15287;3766;13381;1021;3907;1479;5065;2500;8972
354070;201403;3675;12414;3220;11366;1157;4389;742;2570;1899;6959
354075;201403;2260;8638;2168;8474;768;3254;908;3497;1676;6751
354080;201403;1932;6003;1533;5034;401;1380;433;1291;834;2671
354085;201403;309;865;276;805;32;128;194;516;226;644
354090;201403;1188;3612;1128;3519;160;561;830;2554;990;3115
354100;201403;16942;58592;14713;54418;4051;16044;6258;23010;10309;39054
354105;201403;881;2850;747;2592;182;736;286;877;468;1613
354110;201403;842;2449;691;2216;195;716;204;583;399;1299
354120;201403;2274;6504;1936;5893;535;1814;658;1878;1193;3692
354130;201403;5343;16408;4624;14986;1775;6146;1245;3793;3020;9939
354140;201403;20879;55647;13856;42112;2683;9323;5498;15437;8181;24760
354150;201403;4532;12802;3603;11135;1032;3535;1449;4282;2481;7817
354160;201403;4058;13535;3590;12526;1054;3966;1400;4711;2454;8677
354165;201403;413;1553;379;1466;138;579;87;341;225;920
354170;201403;1632;5374;1349;4687;287;1144;465;1434;752;2578
354180;201403;522;1596;508;1571;63;235;343;995;406;1230
354190;201403;1661;5623;1452;5137;513;1919;434;1486;947;3405
354200;201403;1166;3427;959;3033;209;769;365;1011;574;1780
354210;201403;855;3014;773;2826;175;764;302;1006;477;1770
354220;201403;3152;10050;2869;9511;960;3383;1107;3546;2067;6929
354230;201403;796;2665;751;2584;235;853;338;1164;573;2017
354240;201403;1358;4653;1121;4125;320;1296;256;887;576;2183
354250;201403;546;1782;451;1617;193;775;122;402;315;1177
354260;201403;9619;29405;8774;28061;2753;9695;3421;10842;6174;20537
354270;201403;1143;4131;1071;3970;324;1351;415;1531;739;2882
354280;201403;907;2693;845;2588;174;605;461;1400;635;2005
354290;201403;1328;4765;1228;4543;392;1552;344;1257;736;2809
354300;201403;3194;11282;3103;11107;847;3190;1534;5479;2381;8669
354310;201403;790;2650;633;2259;176;689;162;573;338;1262
354320;201403;840;2573;728;2344;209;764;228;672;437;1436
354323;201403;362;1077;301;978;104;368;94;272;198;640
354325;201403;1331;4621;1203;4347;323;1307;444;1486;767;2793
354330;201403;8082;25626;7316;24119;2005;7160;3624;11527;5629;18687
354340;201403;30218;99800;26077;92162;9884;37527;8622;29552;18506;67079
354350;201403;1177;3570;1108;3442;325;1062;544;1630;869;2692
354360;201403;454;1496;371;1334;91;356;36;113;127;469
354370;201403;1152;3894;1014;3600;149;661;684;2341;833;3002
354380;201403;1322;4031;1110;3658;412;1516;183;511;595;2027
354390;201403;11727;38530;9038;32498;2293;9047;2404;8223;4697;17270
354400;201403;2152;7752;1894;7128;484;2002;559;1977;1043;3979
354410;201403;6450;19951;5411;18275;1329;4934;2689;8979;4018;13913
354420;201403;1685;5058;1415;4463;430;1447;461;1386;891;2833
354425;201403;3528;10300;3109;9548;1065;3508;939;2938;2004;6446
354430;201403;1376;4584;1270;4414;338;1324;598;1973;936;3297
354440;201403;568;1719;456;1489;94;347;195;614;289;961
354450;201403;493;1452;336;1104;56;240;90;247;146;487
354460;201403;825;2478;729;2304;261;875;309;960;570;1835
354470;201403;468;1393;382;1216;68;277;172;490;240;767
354480;201403;782;2382;702;2252;141;529;355;1029;496;1558
354490;201403;775;2663;620;2278;143;566;200;650;343;1216
354500;201403;2566;8793;2359;8415;847;3321;622;2213;1469;5534
354510;201403;716;2401;649;2260;177;679;300;1029;477;1708
354515;201403;359;1275;296;1121;70;303;89;307;159;610
354520;201403;5864;20926;4615;17508;1454;6146;1555;5604;3009;11750
354530;201403;2841;10348;2672;10020;799;3268;1352;4995;2151;8263
354540;201403;1380;4305;1215;4010;408;1432;436;1469;844;2901
354550;201403;571;1901;510;1759;108;392;195;625;303;1017
354560;201403;1467;4527;1159;3830;313;1058;355;1144;668;2202
354570;201403;656;2060;550;1805;190;684;110;337;300;1021
354580;201403;9254;27551;7594;24399;1627;5844;3485;10625;5112;16469
354600;201403;1732;6036;1553;5684;495;2103;621;2086;1116;4189
354610;201403;479;1362;342;1082;65;222;94;254;159;476
354620;201403;434;1520;360;1375;106;482;116;405;222;887
354625;201403;279;940;238;857;65;267;59;197;124;464
354630;201403;1920;6797;1748;6390;739;2712;530;1848;1269;4560
354640;201403;4166;14147;3595;12891;1053;4266;760;2491;1813;6757
354650;201403;1006;3098;916;2911;186;690;510;1557;696;2247
354660;201403;1997;6126;1589;5359;445;1671;636;2102;1081;3773
354670;201403;1626;5354;1313;4550;372;1433;316;931;688;2364
354680;201403;5366;18200;4946;17294;1429;5317;1820;6133;3249;11450
354690;201403;874;2980;626;2359;124;494;175;603;299;1097
354700;201403;1196;3439;841;2666;145;542;347;959;492;1501
354710;201403;628;1890;544;1720;140;535;183;512;323;1047
354720;201403;193;563;158;491;57;179;36;113;93;292
354730;201403;6539;23276;5852;21871;1722;6953;2428;8748;4150;15701
354740;201403;234;782;199;703;49;179;42;149;91;328
354750;201403;2310;7516;1980;7066;679;2631;732;2570;1411;5201
354760;201403;2210;7477;1886;6728;614;2329;412;1405;1026;3734
354765;201403;283;760;196;610;37;146;33;91;70;237
354770;201403;2832;8418;2288;7518;1001;3583;371;1123;1372;4706
354780;201403;36053;116089;33508;110355;8427;30709;16092;50357;24519;81066
354790;201403;881;2914;776;2729;216;830;313;1013;529;1843
354800;201403;1910;5798;1747;5575;494;1731;969;3093;1463;4824
354805;201403;905;2849;702;2394;111;439;131;405;242;844
354810;201403;703;2366;531;1963;169;694;86;279;255;973
354820;201403;1068;3846;970;3654;297;1268;228;761;525;2029
354830;201403;438;1367;387;1271;122;463;133;399;255;862
354840;201403;812;2456;745;2329;231;768;275;844;506;1612
354850;201403;14826;48657;11555;41727;3169;12731;3926;13181;7095;25912
354860;201403;1286;4253;1182;4074;289;1220;559;1792;848;3012
354870;201403;43128;140794;40585;135497;12755;45471;18162;59205;30917;104676
354880;201403;4111;13062;3020;10582;842;3221;692;2136;1534;5357
354890;201403;15227;47531;13300;43702;3730;13352;4427;13976;8157;27328
354900;201403;607;1733;492;1565;168;588;176;552;344;1140
354910;201403;6550;20527;3881;14149;857;3427;436;1528;1293;4955
354920;201403;508;1525;397;1325;116;416;93;292;209;708
354925;201403;373;1089;226;782;42;163;36;107;78;270
354930;201403;257;800;236;747;74;267;63;194;137;461
354940;201403;2328;8343;1825;6948;707;2824;263;947;970;3771
354950;201403;1491;5042;1367;4863;250;1031;845;2957;1095;3988
354960;201403;793;2558;695;2395;204;789;251;833;455;1622
354970;201403;4014;13605;3586;12725;793;3226;1828;6171;2621;9397
354980;201403;32588;81893;18641;57658;4049;14043;6077;17381;10126;31424
354990;201403;38749;129248;34954;121412;8138;31334;17495;58899;25633;90233
354995;201403;1984;6349;1868;6175;485;1683;945;3158;1430;4841
355000;201403;1665;5690;1465;5323;505;1956;336;1192;841;3148
355010;201403;3678;11889;3139;10663;838;3145;1315;4367;2153;7512
355020;201403;3275;11874;2837;11021;1392;5753;686;2656;2078;8409
355030;201403;902669;2669080;831518;2529663;221556;733555;346577;1028874;568133;1762429
355040;201403;2954;9850;2663;9315;915;3537;1195;3971;2110;7508
355050;201403;1268;4084;1056;3651;324;1199;249;852;573;2051
355060;201403;4986;17388;4059;15272;1086;4601;895;3031;1981;7632
355070;201403;6342;20302;5723;19265;1339;5213;2985;9468;4324;14681
355080;201403;1371;4961;1085;4203;311;1349;139;447;450;1796
355090;201403;1104;4034;942;3649;224;958;386;1408;610;2366
355100;201403;29124;95561;26165;90401;9222;33734;8639;30418;17861;64152
355110;201403;1318;4655;1210;4417;409;1618;380;1344;789;2962
355120;201403;665;2155;580;1987;185;689;226;743;411;1432
355130;201403;554;1520;347;1065;90;311;116;299;206;610
355140;201403;1035;3798;991;3697;299;1231;434;1582;733;2813
355150;201403;3525;11987;3111;11192;991;3722;1145;3992;2136;7714
355160;201403;1569;5443;1361;5089;557;2334;356;1165;913;3499
355170;201403;9931;28772;7130;23714;2350;8511;1760;5705;4110;14216
355180;201403;2905;9135;2526;8432;701;2706;954;2981;1655;5687
355190;201403;1287;4598;1187;4370;507;1912;325;1158;832;3070
355200;201403;918;3442;882;3365;428;1717;200;748;628;2465
355210;201403;2792;9788;2571;9330;775;3167;1008;3377;1783;6544
355220;201403;30072;103886;27743;99167;12004;44541;7042;25911;19046;70452
355230;201403;1207;3598;772;2604;139;551;182;517;321;1068
355240;201403;22219;69470;17374;58652;4139;15523;6602;20604;10741;36127
355250;201403;25507;86883;23109;82149;6949;26414;9741;34196;16690;60610
355255;201403;899;2561;669;2090;121;403;195;577;316;980
355260;201403;1623;4819;1465;4531;403;1389;539;1541;942;2930
355270;201403;1658;5173;1581;5051;237;955;1118;3383;1355;4338
355280;201403;23649;72556;20746;66880;5116;18604;8977;27449;14093;46053
355290;201403;867;2836;805;2724;178;659;373;1202;551;1861
355300;201403;899;2960;699;2520;163;622;194;647;357;1269
355310;201403;1054;3306;942;3099;240;830;426;1444;666;2274
355320;201403;748;2428;667;2239;188;708;222;629;410;1337
355330;201403;1589;5814;1370;5383;489;2125;389;1403;878;3528
355340;201403;3144;8707;2925;8328;784;2500;1531;4128;2315;6628
355350;201403;1398;4992;1249;4668;412;1663;331;1225;743;2888
355360;201403;1226;4307;1138;4126;273;1117;725;2593;998;3710
355365;201403;316;1012;270;921;73;280;67;217;140;497
355370;201403;7277;19202;5339;16820;1918;6635;1906;6030;3824;12665
355380;201403;3693;11380;2884;9490;789;2847;588;1650;1377;4497
355385;201403;1000;3297;949;3202;387;1445;232;722;619;2167
355390;201403;1428;4049;1240;3683;339;1091;429;1227;768;2318
355395;201403;1748;5480;1370;4577;257;977;545;1648;802;2625
355400;201403;9063;31833;8282;30160;2930;11664;2966;10288;5896;21952
355410;201403;13250;49214;12364;47269;4840;19747;3229;12440;8069;32187
355420;201403;828;3064;792;2979;322;1289;241;906;563;2195
355430;201403;3690;11076;3217;10236;809;2837;1471;4527;2280;7364
355440;201403;896;3022;754;2661;214;782;189;599;403;1381
355450;201403;2619;8857;2224;8027;647;2597;681;2308;1328;4905
355460;201403;579;1661;445;1414;122;469;129;337;251;806
355465;201403;445;1383;382;1262;118;418;96;316;214;734
355470;201403;963;3027;788;2724;279;1079;248;787;527;1866
355475;201403;138;535;122;486;31;129;37;161;68;290
355480;201403;3256;12071;3078;11672;979;3983;1299;4800;2278;8783
355490;201403;841;2520;681;2191;183;643;160;518;343;1161
355495;201403;731;2485;687;2398;187;732;271;903;458;1635
355500;201403;8517;26083;6050;20568;1416;5332;1190;3669;2606;9001
355510;201403;2153;6059;1470;4695;317;1162;418;1229;735;2391
355520;201403;401;1042;263;774;55;189;74;182;129;371
355530;201403;221;566;122;378;21;75;24;74;45;149
355535;201403;702;2184;577;1935;163;658;152;410;315;1068
355540;201403;10325;33782;9815;32938;2845;10335;4675;15330;7520;25665
355550;201403;713;2280;669;2194;196;713;303;968;499;1681
355560;201403;1435;4296;1086;3594;269;1001;223;606;492;1607
355570;201403;194;654;168;591;38;129;38;123;76;252
355580;201403;1276;3893;1108;3559;396;1436;395;1201;791;2637
355590;201403;256;733;228;675;50;187;111;313;161;500
355600;201403;1067;3496;897;3096;350;1313;194;638;544;1951
355610;201403;1445;4308;1240;3983;376;1313;475;1477;851;2790
355620;201403;3988;13041;3256;11372;761;3023;1282;4056;2043;7079
355630;201403;3318;9794;2127;7236;452;1751;654;2014;1106;3765
355635;201403;994;3372;877;3157;182;723;519;1847;701;2570
355640;201403;3835;12972;3249;11575;1122;4204;569;1961;1691;6165
355645;201403;3424;12530;3255;12210;671;2785;1955;7266;2626;10051
355650;201403;6648;21425;5853;19854;1255;5106;3302;10383;4557;15489
355660;201403;1346;4417;1132;3993;357;1415;398;1307;755;2722
355670;201403;2301;7471;1595;5802;404;1679;497;1573;901;3252
355680;201403;1786;6181;1456;5370;541;2117;275;955;816;3072
355690;201403;354;1229;317;1154;207;801;28;66;235;867
355695;201403;335;1038;247;824;32;109;19;50;51;159
355700;201403;6505;23464;5975;22166;1814;7315;2379;8452;4193;15767
355710;201403;12650;33009;8162;24722;2599;8472;1971;5667;4570;14139
355715;201403;252;761;168;584;41;155;32;99;73;254
355720;201403;1480;4935;1240;4420;404;1587;372;1188;776;2775
355730;201403;772;2728;702;2579;283;1106;143;528;426;1634
410010;201403;1637;5282;1494;4974;412;1491;425;1391;837;2882
410020;201403;1254;4327;1176;4161;372;1379;403;1417;775;2796
410030;201403;1091;3798;937;3424;276;1087;168;616;444;1703
410040;201403;13074;44255;12045;42137;4180;15726;3314;11417;7494;27143
410045;201403;1098;3167;815;2615;248;849;242;724;490;1573
410050;201403;3071;8985;2157;7241;693;2538;535;1714;1228;4252
410060;201403;2003;6498;1814;6118;548;2048;623;2029;1171;4077
410070;201403;2180;6290;1782;5469;663;2211;342;933;1005;3144
410080;201403;1470;4487;1238;4053;302;1065;604;1889;906;2954
410090;201403;1134;3660;1034;3447;352;1274;327;1030;679;2304
410100;201403;2800;8534;2104;6932;628;2386;408;1200;1036;3586
410105;201403;515;1647;399;1383;91;364;59;160;150;524
410110;201403;2663;8329;2354;7688;597;2214;800;2509;1397;4723
410115;201403;569;1626;492;1459;99;339;161;435;260;774
410120;201403;2921;10157;2775;9942;1097;4160;1073;3936;2170;8096
410130;201403;1394;4724;1276;4447;403;1386;543;1927;946;3313
410140;201403;15686;44078;11289;35911;3289;11644;3638;11435;6927;23079
410150;201403;18398;46913;9127;27809;1840;6322;1726;4664;3566;10986
410160;201403;3364;10881;3090;10431;1010;3774;1062;3606;2072;7380
410165;201403;790;2394;655;2100;140;480;298;928;438;1408
410170;201403;1804;5639;1548;5086;603;2150;428;1349;1031;3499
410180;201403;8791;28614;7720;26279;1989;7704;3387;10694;5376;18398
410185;201403;662;1856;603;1752;169;526;337;989;506;1515
410190;201403;2231;6773;1970;6194;621;2117;507;1486;1128;3603
410200;201403;5036;14679;4173;12948;1345;4590;655;1930;2000;6520
410210;201403;2621;8119;2098;6964;491;1858;419;1197;910;3055
410220;201403;643;1899;509;1617;100;355;188;574;288;929
410230;201403;1866;6111;1716;5852;662;2494;565;1841;1227;4335
410240;201403;5217;16528;4824;15689;1585;5583;1664;5307;3249;10890
410250;201403;2512;7275;1872;5975;610;2186;360;1001;970;3187
410260;201403;1725;5441;1529;5063;453;1608;539;1744;992;3352
410270;201403;547;1647;468;1489;127;452;188;590;315;1042
410275;201403;941;2843;656;2215;115;424;333;1123;448;1547
410280;201403;2893;8782;2123;7115;462;1783;369;1161;831;2944
410290;201403;3290;10386;2928;9694;785;2795;1225;4060;2010;6855
410300;201403;617;1791;556;1664;89;324;295;800;384;1124
410302;201403;585;1708;484;1543;53;176;312;1016;365;1192
410304;201403;1468;4865;1347;4611;408;1476;538;1896;946;3372
410305;201403;2208;5959;1903;5514;521;1618;1058;3113;1579;4731
410310;201403;2343;7932;2154;7566;653;2463;748;2680;1401;5143
410315;201403;626;1949;495;1675;117;417;151;468;268;885
410320;201403;1257;3756;838;2875;170;679;72;207;242;886
410322;201403;594;1805;442;1462;120;410;117;372;237;782
410330;201403;1509;4279;1284;3854;365;1215;390;1122;755;2337
410335;201403;1061;3177;910;2910;250;911;331;985;581;1896
410337;201403;820;2239;703;2031;141;481;288;765;429;1246
410340;201403;589;1788;467;1473;86;307;140;369;226;676
410345;201403;1874;5726;1549;5025;485;1732;360;1072;845;2804
410347;201403;836;2417;619;2000;163;586;158;485;321;1071
410350;201403;1039;3339;802;2836;224;906;116;355;340;1261
410360;201403;3425;10665;3106;10130;1002;3562;905;2937;1907;6499
410370;201403;13054;39042;10000;32348;2580;9524;2818;8381;5398;17905
410380;201403;1398;4514;1292;4285;315;1136;601;1934;916;3070
410390;201403;2847;8456;2334;7520;861;2998;603;1786;1464;4784
410395;201403;902;3126;819;2938;220;911;374;1307;594;2218
410400;201403;5178;17058;4634;15990;1464;5658;1361;4518;2825;10176
410405;201403;979;2922;795;2545;212;789;286;857;498;1646
410410;201403;1346;4662;1286;4560;494;1947;301;1014;795;2961
410420;201403;9620;31920;8581;29579;2908;10914;2097;6698;5005;17612
410425;201403;3169;10355;2347;8441;520;2091;335;1159;855;3250
410430;201403;15673;44133;12083;37436;3418;11787;3486;10653;6904;22440
410440;201403;3593;11523;3311;10994;920;3344;1484;4897;2404;8241
410442;201403;2965;10421;2723;9854;925;3533;813;2938;1738;6471
410445;201403;2382;8073;2068;7507;640;2518;739;2818;1379;5336
410450;201403;2627;7628;2136;6706;678;2283;393;1135;1071;3418
410460;201403;2397;7313;2027;6550;551;1943;723;2209;1274;4152
410465;201403;1884;7070;1724;6676;606;2453;531;1934;1137;4387
410470;201403;1949;6339;1715;5793;512;1825;540;1813;1052;3638
410480;201403;30400;90314;24936;79640;9161;31960;6226;19044;15387;51004
410490;201403;11580;38218;9713;34081;3091;11895;2941;10084;6032;21979
410500;201403;1529;4946;1277;4375;490;1845;308;1048;798;2893
410510;201403;2438;6637;1814;5390;472;1526;720;1980;1192;3506
410520;201403;3233;11493;3082;11174;1195;4597;1020;3699;2215;8296
410530;201403;1676;4888;1421;4372;372;1334;549;1567;921;2901
410540;201403;3851;11366;2806;9355;716;2588;920;3029;1636;5617
410550;201403;6658;20965;5327;17909;1614;6026;817;2453;2431;8479
410560;201403;1295;4238;1045;3583;245;909;258;723;503;1632
410570;201403;2916;9678;2686;9283;821;2952;1109;4125;1930;7077
410580;201403;25602;82458;22678;76280;7556;27900;6413;20352;13969;48252
410590;201403;1262;4096;864;2949;155;582;202;602;357;1184
410600;201403;1953;5905;1684;5370;480;1624;703;2241;1183;3865
410610;201403;834;2601;719;2386;189;674;298;945;487;1619
410620;201403;1730;6351;1569;5938;510;2042;364;1334;874;3376
410630;201403;2519;7612;2112;6778;565;1995;693;2107;1258;4102
410640;201403;5024;14970;4094;13194;1350;4936;886;2692;2236;7628
410645;201403;1276;4574;1223;4470;532;2111;346;1266;878;3377
410650;201403;2490;7766;2068;6898;712;2514;483;1522;1195;4036
410655;201403;925;2854;781;2567;228;824;220;704;448;1528
410657;201403;660;2027;548;1796;153;585;202;584;355;1169
410660;201403;3830;11292;3052;9588;1067;3601;624;1814;1691;5415
410670;201403;999;2895;776;2457;199;697;192;572;391;1269
410680;201403;2436;8639;2072;7680;579;2184;681;2654;1260;4838
410685;201403;677;2077;634;2006;110;334;421;1351;531;1685
410690;201403;109615;322860;78217;257729;18948;69528;18760;55519;37708;125047
410700;201403;2346;7581;2199;7296;709;2586;863;2728;1572;5314
410710;201403;1102;3496;889;2986;251;937;235;721;486;1658
410712;201403;787;2461;698;2284;329;1171;162;547;491;1718
410715;201403;1062;3411;930;3111;244;905;317;1014;561;1919
410720;201403;4273;13423;3538;11839;1034;3721;955;3009;1989;6730
410725;201403;1084;3177;787;2582;171;603;195;543;366;1146
410730;201403;727;2232;667;2096;293;982;167;512;460;1494
410740;201403;962;2929;701;2381;157;621;299;989;456;1610
410750;201403;1825;5594;1638;5172;531;1862;459;1326;990;3188
410752;201403;261;791;217;703;46;179;94;274;140;453
410753;201403;465;1430;364;1211;74;283;145;454;219;737
410754;201403;1007;3109;893;2919;115;419;592;1990;707;2409
410755;201403;750;2091;600;1845;114;414;300;864;414;1278
410760;201403;2458;8099;2356;7901;908;3255;801;2600;1709;5855
410765;201403;15813;48189;12122;40666;2864;10727;1963;6371;4827;17098
410770;201403;913;2635;755;2329;251;853;200;558;451;1411
410773;201403;1239;3845;1111;3623;285;1048;519;1577;804;2625
410775;201403;1835;5499;1765;5383;515;1521;1032;3300;1547;4821
410780;201403;535;1595;414;1374;130;449;144;528;274;977
410785;201403;928;3060;757;2553;267;926;254;859;521;1785
410790;201403;600;1873;504;1652;131;504;100;261;231;765
410800;201403;2457;6977;2036;6247;804;2726;611;1765;1415;4491
410810;201403;330;1039;267;891;35;134;112;363;147;497
410820;201403;1078;3320;916;2938;266;925;214;671;480;1596
410830;201403;31521;95915;26340;86589;8103;29161;8743;28395;16846;57556
410832;201403;1171;3566;1071;3387;241;905;517;1501;758;2406
410840;201403;7407;23347;5913;19977;1934;7136;1014;3041;2948;10177
410845;201403;1582;4798;1407;4440;275;967;774;2454;1049;3421
410850;201403;2800;8391;2520;7984;576;2118;1327;4172;1903;6290
410855;201403;729;2077;612;1834;168;559;207;612;375;1171
410860;201403;3802;11089;3268;10117;794;2588;1522;4867;2316;7455
410865;201403;1673;5863;1516;5550;422;1671;716;2683;1138;4354
410870;201403;1369;4283;1294;4157;673;2371;295;855;968;3226
410880;201403;4507;13576;3693;12077;949;3613;859;2431;1808;6044
410890;201403;1112;3474;856;2993;254;977;99;275;353;1252
410895;201403;1096;3888;993;3649;358;1410;312;1095;670;2505
410900;201403;880;2523;698;2235;135;497;215;645;350;1142
410910;201403;324;1003;293;948;57;201;145;452;202;653
410920;201403;846;2627;705;2378;210;776;203;631;413;1407
410930;201403;2113;6675;1867;6233;556;2183;669;2134;1225;4317
410940;201403;21044;71987;18912;67973;6273;24577;7297;26286;13570;50863
410950;201403;1911;6401;1746;6094;372;1368;1013;3597;1385;4965
410960;201403;6689;19193;4721;15492;1555;5620;1391;4570;2946;10190
410965;201403;1071;3438;962;3205;296;1071;381;1263;677;2334
410970;201403;5225;16041;4355;14264;1454;5378;938;3053;2392;8431
410975;201403;1478;4410;1239;3997;225;850;618;1994;843;2844
410980;201403;5091;15192;3429;11652;826;3142;776;2519;1602;5661
410990;201403;1078;3341;817;2778;248;928;203;612;451;1540
411000;201403;420;1312;287;1000;60;243;39;114;99;357
411005;201403;507;1529;369;1161;89;282;59;160;148;442
411007;201403;2132;6959;1969;6619;595;2128;848;2950;1443;5078
411010;201403;3992;13909;3705;13257;1391;5500;837;2732;2228;8232
411020;201403;2617;8497;2403;8124;842;3213;752;2519;1594;5732
411030;201403;854;2350;736;2135;223;722;199;528;422;1250
411040;201403;402;1325;337;1171;106;395;79;267;185;662
411050;201403;2130;7757;1927;7292;674;2753;338;1198;1012;3951
411060;201403;2101;6752;1834;6166;521;1926;295;890;816;2816
411065;201403;398;1235;327;1093;59;208;108;335;167;543
411070;201403;4652;15165;3494;12501;1063;4210;448;1401;1511;5611
411080;201403;2022;6416;1866;6087;514;1885;654;2083;1168;3968
411090;201403;620;1593;492;1423;89;317;117;304;206;621
411095;201403;1607;4710;1267;4042;307;1099;324;982;631;2081
411100;201403;1500;4399;1147;3717;252;922;259;785;511;1707
411110;201403;937;2861;716;2363;200;707;112;311;312;1018
411120;201403;1724;5496;1525;5083;475;1726;460;1489;935;3215
411125;201403;4722;15601;4600;15361;1652;5787;2030;6688;3682;12475
411130;201403;786;2427;658;2160;188;652;205;693;393;1345
411140;201403;2092;7656;1824;6960;679;2723;379;1518;1058;4241
411150;201403;6046;17278;4971;15147;1433;4741;1208;3329;2641;8070
411155;201403;1188;3565;1068;3309;365;1258;359;1021;724;2279
411160;201403;310;952;280;894;107;358;81;248;188;606
411170;201403;807;2774;730;2584;215;808;220;766;435;1574
411180;201403;6267;19452;5541;18074;1624;5844;1668;5353;3292;11197
411190;201403;1828;5482;1568;4995;459;1623;452;1357;911;2980
411200;201403;4093;12948;3558;12065;1212;4508;1298;4255;2510;8763
411210;201403;2781;8151;2304;7270;854;2932;334;1000;1188;3932
411220;201403;1200;3509;983;3101;250;913;401;1141;651;2054
411230;201403;1243;3616;829;2739;245;917;177;519;422;1436
411240;201403;1401;3509;854;2653;255;873;211;582;466;1455
411250;201403;3111;8788;2594;7841;778;2467;794;2406;1572;4873
411260;201403;266;773;207;677;52;194;81;245;133;439
411270;201403;2050;6600;1892;6305;604;2245;776;2506;1380;4751
411275;201403;1544;4709;1361;4282;392;1280;356;1060;748;2340
411280;201403;1751;5502;1415;4759;387;1483;223;665;610;2148
411290;201403;1040;2950;880;2636;229;735;301;948;530;1683
411295;201403;1082;3247;1005;3117;216;759;409;1229;625;1988
411300;201403;1323;3489;947;2772;82;280;378;1003;460;1283
411310;201403;859;2495;676;2185;143;549;285;886;428;1435
411320;201403;5641;17564;4660;15571;1277;4456;1176;3816;2453;8272
411325;201403;1557;5081;1409;4794;215;849;895;3033;1110;3882
411330;201403;3567;11837;3246;11258;1250;4685;945;3221;2195;7906
411340;201403;993;2953;673;2193;149;560;255;820;404;1380
411342;201403;898;2601;741;2256;203;680;193;516;396;1196
411345;201403;1070;3474;995;3331;289;1066;465;1547;754;2613
411350;201403;2691;8496;2044;7159;638;2439;262;814;900;3253
411360;201403;527;1361;337;992;49;188;131;310;180;498
411370;201403;44511;131303;34449;111982;7449;28488;11771;34934;19220;63422
411373;201403;1437;4621;1227;4198;337;1328;303;982;640;2310
411375;201403;1058;3078;880;2709;235;779;281;797;516;1576
411380;201403;1289;3505;824;2530;139;480;240;701;379;1181
411390;201403;1823;5659;1626;5348;383;1438;888;2813;1271;4251
411400;201403;1744;5375;1408;4592;331;1220;432;1326;763;2546
411410;201403;2462;7827;2166;7130;706;2652;552;1535;1258;4187
411420;201403;4537;13346;3595;11338;960;3406;708;1919;1668;5325
411430;201403;2891;9528;2512;8817;772;2916;1011;3446;1783;6362
411435;201403;570;1856;494;1663;125;463;173;561;298;1024
411440;201403;2496;8304;2305;7951;856;3160;664;2359;1520;5519
411450;201403;2092;6481;1920;6195;453;1578;1059;3419;1512;4997
411460;201403;4430;14260;3490;11973;1266;4650;626;2019;1892;6669
411470;201403;929;2914;681;2289;169;628;120;348;289;976
411480;201403;4652;14589;3836;13018;1667;6119;748;2377;2415;8496
411490;201403;1663;5322;1522;5077;629;2396;358;1060;987;3456
411500;201403;1538;4601;1154;3816;335;1231;258;816;593;2047
411510;201403;2464;7368;1982;6405;618;2208;387;1104;1005;3312
411520;201403;28335;82182;19705;64099;6230;22438;3917;12022;10147;34460
411530;201403;913;2651;634;2124;243;920;102;277;345;1197
411535;201403;457;1392;242;876;43;188;24;72;67;260
411540;201403;3076;8493;2478;7415;452;1420;1346;4130;1798;5550
411545;201403;1027;3649;957;3512;222;892;582;2139;804;3031
411550;201403;744;2106;604;1869;255;862;131;379;386;1241
411560;201403;2620;8085;2164;6983;589;2089;467;1373;1056;3462
411570;201403;6006;16954;4615;14578;1332;4763;1093;3574;2425;8337
411573;201403;997;3091;950;3008;221;764;507;1620;728;2384
411575;201403;1451;4761;1273;4368;339;1247;464;1575;803;2822
411580;201403;3650;11033;2754;9200;621;2439;475;1360;1096;3799
411585;201403;483;1704;379;1404;87;351;61;209;148;560
411590;201403;576;1745;519;1627;123;440;160;480;283;920
411600;201403;369;1136;306;1008;66;267;78;259;144;526
411605;201403;2330;6615;1743;5486;460;1602;657;1995;1117;3597
411610;201403;2264;6703;2127;6469;522;1710;1326;3975;1848;5685
411620;201403;2759;9222;2608;8961;847;3151;1041;3650;1888;6801
411630;201403;724;1973;450;1531;127;504;79;235;206;739
411640;201403;593;1850;499;1647;137;501;181;561;318;1062
411650;201403;187;616;166;576;40;159;55;171;95;330
411660;201403;810;2398;695;2179;182;597;282;903;464;1500
411670;201403;1697;5014;1521;4672;480;1681;525;1487;1005;3168
411680;201403;1720;5329;1515;4984;388;1277;821;2874;1209;4151
411690;201403;3648;11143;3105;10134;1081;3746;767;2534;1848;6280
411695;201403;823;2683;700;2434;139;495;335;1191;474;1686
411700;201403;1845;5496;1425;4702;373;1391;377;1146;750;2537
411705;201403;2275;7908;2007;7380;483;1834;1129;4275;1612;6109
411710;201403;2175;6792;1776;5901;506;1834;391;1158;897;2992
411720;201403;678;2065;532;1718;110;399;133;400;243;799
411721;201403;722;2204;612;1975;183;649;143;410;326;1059
411722;201403;685;2119;564;1865;144;546;160;479;304;1025
411725;201403;1307;4315;939;3404;238;946;217;797;455;1743
411727;201403;2313;6747;1899;5862;498;1681;764;2237;1262;3918
411729;201403;549;1529;431;1338;83;276;164;473;247;749
411730;201403;5617;16865;4831;15354;1694;5749;1578;5015;3272;10764
411740;201403;556;1647;446;1417;111;416;175;513;286;929
411745;201403;885;2811;747;2479;192;693;168;520;360;1213
411750;201403;4394;14024;3499;11748;1054;3932;607;1855;1661;5787
411760;201403;8786;26744;7972;25357;2834;9634;2439;8043;5273;17677
411770;201403;3870;13845;3459;12830;1345;5213;731;2766;2076;7979
411780;201403;3015;10081;2924;9969;405;1340;2117;7647;2522;8987
411790;201403;2448;7251;1906;6156;592;2201;591;1807;1183;4008
411800;201403;1245;3806;840;2825;143;533;129;329;272;862
411810;201403;1554;4917;1372;4510;384;1449;390;1094;774;2543
411820;201403;16466;52449;13950;47823;4829;17148;4110;14877;8939;32025
411830;201403;431;1205;357;1105;107;317;145;488;252;805
411840;201403;8783;26814;7221;23743;2146;7771;1927;6102;4073;13873
411845;201403;524;1711;419;1467;109;421;76;261;185;682
411850;201403;5780;17919;4886;16068;1281;4577;1355;4408;2636;8985
411860;201403;880;2861;756;2590;201;731;205;644;406;1375
411870;201403;1022;3661;818;3089;139;567;203;720;342;1287
411880;201403;2468;7184;2127;6583;510;1791;939;2893;1449;4684
411885;201403;1444;4054;1183;3639;361;1250;363;999;724;2249
411890;201403;1340;4194;989;3362;254;963;193;572;447;1535
411900;201403;925;3048;713;2499;223;799;102;351;325;1150
411910;201403;1216;4244;1071;3918;320;1277;334;1161;654;2438
411915;201403;11769;34264;8053;26374;1881;6884;1820;5341;3701;12225
411920;201403;1038;3691;927;3398;256;1037;193;659;449;1696
411925;201403;619;1817;485;1573;147;509;144;451;291;960
411930;201403;6160;20707;5501;19344;1922;7254;1700;6012;3622;13266
411940;201403;3597;12300;3254;11556;1052;3925;847;2971;1899;6896
411950;201403;9739;32048;8514;29648;2548;9705;3683;12588;6231;22293
411960;201403;5435;16832;5122;16235;1384;4905;2335;7166;3719;12071
411965;201403;538;1697;429;1497;104;412;127;447;231;859
411970;201403;762;2231;613;1984;209;744;152;459;361;1203
411980;201403;2106;5924;1511;4966;210;753;758;2479;968;3232
411990;201403;28947;100921;25592;93765;9297;36497;6586;24318;15883;60815
411995;201403;3076;9874;2812;9328;1144;4111;693;2229;1837;6340
412000;201403;2043;5741;1660;5072;361;1272;675;1836;1036;3108
412010;201403;714;2461;635;2266;177;666;155;527;332;1193
412015;201403;653;2055;546;1825;106;395;275;908;381;1303
412020;201403;427;1275;329;1084;117;420;121;371;238;791
412030;201403;597;1922;414;1472;88;377;120;393;208;770
412033;201403;738;2327;568;1925;140;525;102;299;242;824
412035;201403;978;2862;789;2511;200;737;306;897;506;1634
412040;201403;729;2438;664;2268;248;884;187;621;435;1505
412050;201403;1597;4877;1264;4152;323;1193;262;811;585;2004
412060;201403;6789;24225;6271;23019;1995;7807;2341;8555;4336;16362
412065;201403;982;3036;835;2728;243;898;238;718;481;1616
412070;201403;1120;3233;1014;3006;213;698;399;1153;612;1851
412080;201403;1935;6205;1394;4980;367;1449;139;412;506;1861
412085;201403;306;882;178;606;46;173;46;145;92;318
412090;201403;4820;16107;4629;15753;1029;3807;2880;9909;3909;13716
412100;201403;2207;7062;1964;6643;641;2299;668;2241;1309;4540
412110;201403;1040;3109;787;2575;251;874;232;743;483;1617
412120;201403;2323;8048;2140;7614;575;2263;973;3308;1548;5571
412125;201403;964;3023;866;2862;255;926;324;1067;579;1993
412130;201403;730;2128;544;1769;111;415;122;368;233;783
412135;201403;556;1622;423;1348;86;300;173;503;259;803
412140;201403;1834;5689;1570;5152;448;1582;431;1419;879;3001
412150;201403;2883;8722;2528;7994;425;1496;1432;4421;1857;5917
412160;201403;1205;3867;928;3172;273;1066;321;1055;594;2121
412170;201403;4440;15008;3839;13797;1353;5179;1291;4589;2644;9768
412175;201403;1485;5228;1356;4942;403;1614;507;1859;910;3473
412180;201403;1749;5631;1382;4968;529;2125;359;1199;888;3324
412190;201403;3036;9298;2523;8437;926;3294;629;2196;1555;5490
412200;201403;2286;7748;1675;6061;392;1530;505;1799;897;3329
412210;201403;749;2165;471;1550;105;408;89;262;194;670
412215;201403;3196;10622;2903;10075;498;1773;1842;6622;2340;8395
412217;201403;1175;3518;1116;3411;224;788;682;1966;906;2754
412220;201403;5742;19315;5516;18871;1939;7027;2643;9025;4582;16052
412230;201403;2981;10292;2642;9579;791;3144;776;2678;1567;5822
412240;201403;9145;24395;5391;17230;1119;4023;788;2190;1907;6213
412250;201403;2186;6766;1968;6312;705;2461;457;1343;1162;3804
412260;201403;1307;3950;899;3063;196;772;266;798;462;1570
412265;201403;1200;3858;1110;3680;277;1108;514;1643;791;2751
412270;201403;764;2595;616;2221;135;548;96;325;231;873
412280;201403;684;2136;547;1860;196;702;196;640;392;1342
412290;201403;1253;3575;1049;3171;222;751;380;1083;602;1834
412300;201403;1794;5421;1499;4843;475;1740;374;1130;849;2870
412310;201403;1215;3496;1083;3319;213;576;702;2395;915;2971
412320;201403;696;1934;514;1619;145;534;163;495;308;1029
412330;201403;2012;5583;1563;4794;379;1275;698;2113;1077;3388
412340;201403;744;2388;532;1834;106;405;104;335;210;740
412350;201403;2541;8195;2132;7268;654;2414;415;1296;1069;3710
412360;201403;344;1111;293;980;64;235;78;213;142;448
412370;201403;1136;3604;902;3140;308;1126;247;846;555;1972
412380;201403;2022;6189;1750;5595;497;1685;467;1451;964;3136
412382;201403;720;2099;539;1716;143;519;139;398;282;917
412385;201403;2489;8074;2313;7703;691;2438;821;2790;1512;5228
412390;201403;2460;7469;2264;7129;809;2778;790;2441;1599;5219
412395;201403;972;2748;793;2468;125;410;497;1573;622;1983
412400;201403;1187;3714;1063;3479;329;1146;404;1366;733;2512
412402;201403;2072;6500;1762;5823;533;1922;467;1393;1000;3315
412405;201403;4101;12095;2738;9119;670;2578;293;846;963;3424
412410;201403;6303;20779;5743;19628;2437;9156;1084;3616;3521;12772
412420;201403;539;1624;435;1412;130;471;119;319;249;790
412430;201403;460;1395;387;1245;112;406;154;445;266;851
412440;201403;4012;12219;3547;11414;687;2464;1468;4942;2155;7406
412450;201403;403;1293;329;1104;75;284;60;153;135;437
412460;201403;987;2821;701;2283;162;613;158;484;320;1097
412470;201403;1805;6309;1644;5910;550;2117;559;2011;1109;4128
412480;201403;1283;3836;933;3066;208;766;166;443;374;1209
412490;201403;1282;3855;1146;3531;296;953;295;875;591;1828
412500;201403;2047;6176;1756;5596;485;1744;436;1211;921;2955
412510;201403;2769;9495;2459;8667;794;3039;820;2800;1614;5839
412520;201403;1813;5193;1419;4538;404;1390;482;1522;886;2912
412530;201403;803;2424;680;2149;203;687;176;533;379;1220
412535;201403;428;1309;314;1016;81;287;93;257;174;544
412540;201403;1216;3620;951;3050;170;629;356;1129;526;1758
412545;201403;899;2605;750;2289;140;477;259;708;399;1185
412550;201403;24219;74310;17130;58437;4568;16956;3182;10109;7750;27065
412555;201403;313;993;234;789;46;167;42;115;88;282
412560;201403;4412;14886;3765;13508;1140;4567;815;2594;1955;7161
412570;201403;4436;13730;3438;11399;943;3466;716;2270;1659;5736
412575;201403;1059;3374;890;2977;216;805;263;811;479;1616
412580;201403;1484;4137;1099;3465;254;856;337;1000;591;1856
412590;201403;510;1566;407;1368;150;537;102;349;252;886
412600;201403;1498;4837;1308;4452;425;1618;395;1239;820;2857
412610;201403;787;2572;642;2224;213;820;154;463;367;1283
412620;201403;1282;4282;1091;3870;388;1503;230;767;618;2270
412625;201403;13843;39873;11703;35850;4216;13964;2388;7193;6604;21157
412627;201403;998;3152;720;2531;220;825;79;266;299;1091
412630;201403;3521;11388;3153;10603;863;3135;948;3088;1811;6223
412635;201403;547;1673;396;1336;91;317;57;173;148;490
412640;201403;873;2673;632;2112;139;520;123;365;262;885
412650;201403;2279;6586;1887;5846;495;1691;632;1739;1127;3430
412660;201403;3068;9374;2582;8377;655;2432;614;1847;1269;4279
412665;201403;730;1986;467;1513;136;497;131;395;267;892
412667;201403;1469;4468;1199;3939;303;1129;330;993;633;2122
412670;201403;663;2101;468;1635;109;448;73;193;182;641
412680;201403;1495;4956;1249;4358;343;1279;315;985;658;2264
412690;201403;696;2226;566;1934;199;743;90;291;289;1034
412700;201403;1854;6148;1635;5777;608;2408;565;1924;1173;4332
412710;201403;8819;28008;7467;25197;2093;7715;1824;5876;3917;13591
412720;201403;1668;5336;1188;4075;257;950;135;369;392;1319
412730;201403;2820;8619;2000;6852;591;2182;245;738;836;2920
412740;201403;2155;7170;1923;6627;732;2687;269;961;1001;3648
412750;201403;3448;11519;3191;11066;597;2386;2078;7016;2675;9402
412760;201403;2318;7842;2218;7662;668;2571;887;2918;1555;5489
412770;201403;12042;35756;8156;27175;1811;6762;1640;4931;3451;11693
412780;201403;1492;4973;1330;4595;394;1454;401;1306;795;2760
412785;201403;2513;7453;1864;6060;598;2123;716;2252;1314;4375
412788;201403;1363;4601;1287;4458;333;1329;539;1749;872;3078
412790;201403;1178;3732;985;3314;210;770;294;910;504;1680
412795;201403;1043;3140;907;2887;299;1024;262;798;561;1822
412796;201403;2621;8489;2453;8152;650;2393;1082;3461;1732;5854
412800;201403;3569;10777;2893;9451;768;2765;840;2574;1608;5339
412810;201403;10219;29295;6472;20897;1676;5905;1398;4062;3074;9967
412820;201403;6389;19870;4872;16846;1424;5372;974;3381;2398;8753
412830;201403;405;1324;345;1199;96;396;81;233;177;629
412840;201403;2254;6557;1881;5824;532;1860;463;1376;995;3236
412850;201403;2552;7871;2248;7430;427;1628;1124;3581;1551;5209
412853;201403;1610;4817;1439;4522;196;799;839;2432;1035;3231
412855;201403;1667;4885;1371;4297;440;1606;352;941;792;2547
412860;201403;1291;3970;1128;3664;287;1068;485;1506;772;2574
412862;201403;821;2290;644;1934;171;569;223;629;394;1198
412863;201403;1216;4218;1174;4141;176;666;805;2831;981;3497
412865;201403;665;2105;496;1685;107;398;178;617;285;1015
412870;201403;1032;3016;882;2776;318;1081;278;872;596;1953
412880;201403;1586;4392;1360;4027;387;1264;316;883;703;2147
420005;201403;510;1589;355;1229;75;289;154;502;229;791
420010;201403;3245;10234;2791;9484;447;1632;1913;6569;2360;8201
420020;201403;761;2566;483;1790;79;333;64;204;143;537
420030;201403;538;1568;321;1144;89;361;53;167;142;528
420040;201403;1003;3167;688;2543;226;941;141;440;367;1381
420050;201403;824;2634;664;2258;202;710;245;812;447;1522
420055;201403;319;1034;224;805;56;213;45;143;101;356
420060;201403;379;1355;292;1125;73;304;36;129;109;433
420070;201403;2028;6527;1715;5740;344;1277;688;2389;1032;3666
420075;201403;201;602;117;396;30;119;30;83;60;202
420080;201403;584;1999;518;1855;184;722;98;343;282;1065
420090;201403;688;2468;540;2117;130;530;99;390;229;920
420100;201403;1483;4868;1376;4720;378;1322;796;2790;1174;4112
420110;201403;452;1569;410;1471;123;453;174;640;297;1093
420120;201403;332;1174;279;1062;112;459;49;172;161;631
420125;201403;362;1508;346;1470;133;604;99;385;232;989
420127;201403;600;1884;280;1053;91;365;34;123;125;488
420130;201403;2717;9449;2420;8841;739;3011;865;2911;1604;5922
420140;201403;5109;15219;3658;12445;1001;3860;725;2279;1726;6139
420150;201403;795;2417;551;1855;163;593;141;421;304;1014
420160;201403;298;888;195;651;48;192;36;93;84;285
420165;201403;211;702;152;544;27;107;34;124;61;231
420170;201403;241;805;169;654;63;284;18;51;81;335
420180;201403;470;1517;296;1080;77;292;70;240;147;532
420190;201403;576;1847;377;1408;120;489;57;191;177;680
420195;201403;1424;4176;1146;3790;288;1031;542;1858;830;2889
420200;201403;2914;9654;1931;7365;616;2640;305;1010;921;3650
420205;201403;1074;3648;974;3462;307;1176;394;1389;701;2565
420207;201403;1345;4096;985;3335;312;1176;254;780;566;1956
420208;201403;485;1475;337;1187;131;504;91;306;222;810
420209;201403;363;1188;229;841;44;170;55;206;99;376
420210;201403;1778;5915;1247;4826;347;1557;173;600;520;2157
420213;201403;873;3270;838;3194;183;736;539;2056;722;2792
420215;201403;509;1688;384;1350;114;429;64;210;178;639
420220;201403;427;1685;400;1623;168;728;82;291;250;1019
420230;201403;4480;14115;3560;12419;917;3615;1704;5779;2621;9394
420240;201403;12528;39129;8806;31449;1983;8438;3393;10841;5376;19279
420243;201403;579;1835;477;1612;130;508;145;474;275;982
420245;201403;1170;3753;855;3090;223;941;177;547;400;1488
420250;201403;845;2743;791;2654;307;1135;295;994;602;2129
420253;201403;672;1810;555;1644;132;403;254;844;386;1247
420257;201403;431;1349;331;1155;93;325;145;507;238;832
420260;201403;1352;4615;1224;4368;362;1420;540;1916;902;3336
420270;201403;556;1826;253;942;34;131;30;101;64;232
420280;201403;2342;6729;1576;5357;420;1682;519;1522;939;3204
420285;201403;155;458;61;229;10;42;1;2;11;44
420287;201403;655;2043;572;1885;148;530;224;736;372;1266
420290;201403;6422;19422;4233;14332;1010;3759;1373;4327;2383;8086
420300;201403;5536;17562;3770;13742;954;3962;700;2542;1654;6504
420310;201403;857;2641;820;2579;184;621;497;1514;681;2135
420315;201403;961;3232;775;2839;210;854;297;1084;507;1938
420320;201403;4869;15624;4113;14265;1237;4882;1586;5256;2823;10138
420325;201403;464;1520;451;1489;153;572;136;425;289;997
420330;201403;1297;4604;1030;3858;344;1401;194;609;538;2010
420340;201403;1494;4731;1203;4032;286;1056;329;1045;615;2101
420350;201403;1611;5265;1400;4824;410;1515;576;1992;986;3507
420360;201403;3747;12213;2871;10190;1022;3982;474;1532;1496;5514
420370;201403;2015;5792;1791;5489;241;746;1428;4384;1669;5130
420380;201403;5422;18557;4657;16753;1466;5736;1203;4248;2669;9984
420390;201403;2092;6336;1318;4681;422;1646;274;874;696;2520
420395;201403;2057;6497;1597;5455;388;1496;327;979;715;2475
420400;201403;1492;4546;1143;3863;343;1344;333;1040;676;2384
420410;201403;818;2321;595;1952;161;597;278;893;439;1490
420415;201403;514;1659;413;1400;126;463;134;442;260;905
420417;201403;802;2649;695;2402;151;538;317;1109;468;1647
420419;201403;432;1426;329;1232;156;637;76;278;232;915
420420;201403;15154;47264;12010;40736;3914;14482;3592;11958;7506;26440
420425;201403;1211;3424;771;2483;94;382;322;932;416;1314
420430;201403;4134;13176;2878;10193;859;3359;753;2577;1612;5936
420435;201403;219;750;161;598;66;273;26;92;92;365
420440;201403;1477;4364;925;3197;329;1244;152;465;481;1709
420445;201403;452;1318;350;1136;92;316;158;517;250;833
420450;201403;1280;3842;779;2795;180;741;146;435;326;1176
420455;201403;2269;7131;2042;6733;603;2299;847;2689;1450;4988
420460;201403;9843;31567;8094;28239;2354;9279;2896;9599;5250;18878
420470;201403;1221;3472;836;2731;248;909;226;705;474;1614
420475;201403;181;594;119;438;43;161;25;97;68;258
420480;201403;6058;18351;5091;16681;2037;7491;791;2484;2828;9975
420490;201403;775;2575;608;2230;179;699;149;509;328;1208
420500;201403;2121;6641;1774;6012;532;1973;858;2907;1390;4880
420510;201403;196;833;183;796;72;323;43;169;115;492
420515;201403;161;588;134;523;40;169;20;77;60;246
420517;201403;956;2984;880;2838;145;499;552;1796;697;2295
420519;201403;446;1270;336;1043;64;206;119;376;183;582
420520;201403;773;2268;625;2050;175;626;262;831;437;1457
420530;201403;1381;4850;1138;4234;373;1525;254;823;627;2348
420535;201403;250;780;178;621;53;205;30;87;83;292
420540;201403;18820;58059;14734;49493;5080;18968;4155;13141;9235;32109
420543;201403;496;1370;370;1157;51;175;217;714;268;889
420545;201403;1600;5271;1327;4652;384;1519;385;1256;769;2775
420550;201403;4785;15932;4083;14298;1200;4765;1257;4269;2457;9034
420555;201403;470;1552;396;1389;141;542;112;380;253;922
420560;201403;586;1765;486;1555;91;329;244;780;335;1109
420570;201403;1990;6672;1630;5792;487;1958;472;1564;959;3522
420580;201403;1139;3865;975;3571;292;1171;435;1625;727;2796
420590;201403;3329;10656;2483;8687;630;2439;503;1609;1133;4048
420600;201403;882;3127;810;2957;221;883;331;1218;552;2101
420610;201403;630;2085;450;1668;136;553;73;241;209;794
420620;201403;1209;3858;1078;3616;401;1460;247;798;648;2258
420630;201403;1114;3695;876;3071;259;1007;247;730;506;1737
420640;201403;650;2155;332;1309;82;380;31;120;113;500
420650;201403;2132;6650;1253;4500;238;975;213;614;451;1589
420660;201403;675;2040;556;1816;116;417;281;897;397;1314
420665;201403;804;2366;526;1771;98;372;168;493;266;865
420670;201403;1744;5667;1341;4759;326;1307;215;686;541;1993
420675;201403;244;795;180;637;45;177;75;249;120;426
420680;201403;517;1314;324;1010;65;243;107;315;172;558
420690;201403;792;2794;577;2182;135;560;170;588;305;1148
420700;201403;5869;18206;4927;16267;1627;5992;1294;4051;2921;10043
420710;201403;797;2901;668;2631;249;1054;169;638;418;1692
420720;201403;1994;6222;1729;5859;504;1796;940;3190;1444;4986
420730;201403;4681;14826;4110;13775;1512;5428;1412;4652;2924;10080
420740;201403;773;2596;757;2571;182;667;492;1649;674;2316
420750;201403;2478;8236;1810;6582;405;1703;540;1714;945;3417
420757;201403;118;403;98;370;26;111;28;97;54;208
420760;201403;443;1464;333;1160;74;281;97;320;171;601
420765;201403;639;2195;429;1634;128;530;81;300;209;830
420768;201403;1291;4610;1091;4132;378;1487;359;1407;737;2894
420770;201403;880;2837;595;2169;177;706;148;504;325;1210
420775;201403;701;2286;505;1770;145;530;125;413;270;943
420780;201403;1710;5294;1183;3994;319;1162;326;1035;645;2197
420785;201403;324;1008;229;764;32;125;85;257;117;382
420790;201403;1375;5030;1140;4371;333;1379;430;1580;763;2959
420800;201403;937;2806;585;1995;168;648;121;363;289;1011
420810;201403;2617;9200;2120;8017;715;3048;526;1903;1241;4951
420820;201403;8067;27881;6711;25479;2368;10037;2225;8349;4593;18386
420830;201403;2779;9492;2414;8794;925;3658;804;2824;1729;6482
420840;201403;921;2814;573;2109;152;634;154;524;306;1158
420845;201403;1208;4169;1014;3772;360;1491;177;598;537;2089
420850;201403;2007;6715;1402;5425;484;2047;259;1000;743;3047
420860;201403;686;2034;469;1633;186;734;159;527;345;1261
420870;201403;1397;4135;1125;3742;446;1645;315;979;761;2624
420880;201403;1486;5046;1240;4405;322;1190;237;806;559;1996
420890;201403;12826;31000;6112;19371;1181;4410;2270;6466;3451;10876
420895;201403;236;658;115;384;41;148;27;87;68;235
420900;201403;2355;6929;1593;5406;437;1632;375;1191;812;2823
420910;201403;23489;73087;15946;56813;3912;15975;4019;13324;7931;29299
420915;201403;662;2617;609;2478;178;735;256;1091;434;1826
420917;201403;424;1315;243;788;54;208;77;198;131;406
420920;201403;202;594;109;381;50;190;12;37;62;227
420930;201403;20292;62920;17613;58114;5641;20401;5793;18945;11434;39346
420940;201403;4467;13892;3882;12598;1126;4112;1138;3320;2264;7432
420945;201403;242;766;159;558;44;172;40;129;84;301
420950;201403;569;1752;311;1174;77;330;53;184;130;514
420960;201403;1453;4615;1254;4255;422;1595;393;1219;815;2814
420970;201403;2737;8734;2424;8235;691;2563;1221;4220;1912;6783
420980;201403;457;1505;385;1378;121;435;177;688;298;1123
420985;201403;587;1780;362;1296;101;400;99;337;200;737
420990;201403;911;2759;639;2274;159;625;178;587;337;1212
421000;201403;682;2450;489;1941;146;636;54;164;200;800
421003;201403;671;1965;291;1032;59;232;43;127;102;359
421005;201403;262;855;219;775;66;258;100;345;166;603
421010;201403;6988;21843;5433;18708;1774;6632;1526;4946;3300;11578
421020;201403;540;1787;430;1566;88;325;217;846;305;1171
421030;201403;1041;3869;966;3678;347;1406;293;1131;640;2537
421040;201403;899;2816;772;2589;258;951;271;838;529;1789
421050;201403;1981;5392;1206;4068;316;1218;366;1132;682;2350
421055;201403;287;948;194;709;48;187;47;149;95;336
421060;201403;551;2046;460;1787;128;534;104;376;232;910
421070;201403;804;2567;542;1934;146;590;143;512;289;1102
421080;201403;687;2253;623;2113;197;726;257;845;454;1571
421085;201403;546;1532;321;1129;82;313;69;262;151;575
421090;201403;431;1296;328;1054;82;274;138;439;220;713
421100;201403;1043;3283;771;2668;202;756;178;517;380;1273
421105;201403;1436;4764;1276;4457;332;1257;505;1816;837;3073
421110;201403;1646;5469;1437;5118;514;2022;431;1426;945;3448
421120;201403;1621;5419;1259;4503;296;1236;365;1169;661;2405
421125;201403;421;1332;336;1150;108;404;116;371;224;775
421130;201403;3432;11607;2876;10554;1053;4266;917;3352;1970;7618
421140;201403;438;1397;358;1226;104;388;127;407;231;795
421145;201403;574;1914;442;1550;79;317;186;619;265;936
421150;201403;559;1860;435;1622;115;466;176;651;291;1117
421160;201403;875;2737;604;2160;130;524;178;573;308;1097
421165;201403;326;1175;263;977;62;246;102;393;164;639
421170;201403;1863;6120;1598;5406;494;1774;736;2440;1230;4214
421175;201403;1384;4244;1116;3795;359;1424;354;1081;713;2505
421180;201403;548;1624;339;1156;102;398;122;368;224;766
421185;201403;468;1368;366;1169;65;203;188;624;253;827
421187;201403;324;1020;257;882;76;270;93;297;169;567
421189;201403;533;1651;482;1551;134;469;170;539;304;1008
421190;201403;10379;33678;7954;28556;2421;9325;2153;7659;4574;16984
421200;201403;1089;3701;954;3398;280;1079;312;1076;592;2155
421205;201403;238;766;179;633;41;169;40;118;81;287
421210;201403;2132;6705;1816;5913;584;2032;524;1660;1108;3692
421220;201403;2510;8681;2243;8123;746;2953;640;2305;1386;5258
421223;201403;777;2252;502;1781;148;552;231;816;379;1368
421225;201403;1209;3812;1017;3412;295;1075;367;1209;662;2284
421227;201403;960;3255;869;3115;248;887;488;1815;736;2702
421230;201403;747;2569;679;2400;194;755;226;744;420;1499
421240;201403;571;1939;385;1396;91;361;52;155;143;516
421250;201403;1948;6139;1377;5087;490;1987;344;1236;834;3223
421260;201403;297;906;165;635;41;153;34;125;75;278
421265;201403;284;977;247;874;51;192;49;182;100;374
421270;201403;712;1979;448;1528;152;562;84;314;236;876
421280;201403;1662;5336;1362;4871;462;1882;390;1389;852;3271
421290;201403;2072;5923;1330;4446;418;1481;282;860;700;2341
421300;201403;321;1024;283;946;114;427;98;308;212;735
421310;201403;518;1806;455;1636;152;556;106;377;258;933
421315;201403;375;1139;223;812;54;204;23;82;77;286
421320;201403;546;1874;385;1432;69;284;70;202;139;486
421330;201403;651;2308;572;2139;226;956;68;234;294;1190
421335;201403;573;1920;466;1703;129;518;88;318;217;836
421340;201403;1868;6091;1666;5730;504;1920;758;2567;1262;4487
421350;201403;1099;3780;925;3397;300;1218;243;842;543;2060
421360;201403;3301;10093;2244;7980;525;2157;697;2310;1222;4467
421370;201403;1093;3941;951;3620;319;1338;246;906;565;2244
421380;201403;1047;3095;881;2776;164;568;424;1321;588;1889
421390;201403;201;663;156;543;22;82;42;152;64;234
421400;201403;396;1541;328;1374;132;577;73;282;205;859
421410;201403;367;1166;300;1029;74;264;135;482;209;746
421415;201403;338;1109;208;814;66;269;52;195;118;464
421420;201403;1442;4577;1117;3774;256;920;234;731;490;1651
421430;201403;301;1009;238;882;81;351;44;146;125;497
421440;201403;846;2585;589;2089;178;682;208;697;386;1379
421450;201403;598;2065;459;1724;159;651;88;308;247;959
421460;201403;691;2257;480;1807;121;512;111;386;232;898
421470;201403;527;1986;457;1829;132;558;181;713;313;1271
421480;201403;2924;9327;2067;7578;654;2749;537;1752;1191;4501
421490;201403;294;1029;192;764;81;346;41;156;122;502
421500;201403;2711;9813;2430;9228;1003;4223;502;1822;1505;6045
421505;201403;407;1416;372;1326;126;461;121;436;247;897
421507;201403;643;2157;503;1815;118;443;185;660;303;1103
421510;201403;307;1160;282;1110;87;401;116;389;203;790
421520;201403;824;2247;546;1681;54;206;282;787;336;993
421530;201403;481;1647;328;1302;96;444;107;397;203;841
421535;201403;713;2249;450;1670;104;416;204;746;308;1162
421540;201403;420;1256;363;1146;93;319;135;399;228;718
421545;201403;1237;4373;1028;3939;323;1390;204;736;527;2126
421550;201403;2238;7719;2033;7325;747;2931;585;2039;1332;4970
421555;201403;287;920;144;520;33;130;34;115;67;245
421560;201403;190;591;98;353;22;86;19;64;41;150
421565;201403;1103;3529;1009;3367;444;1590;309;991;753;2581
421567;201403;949;3594;830;3274;390;1588;159;618;549;2206
421568;201403;492;1655;392;1437;115;438;123;455;238;893
421569;201403;205;676;123;472;24;105;27;98;51;203
421570;201403;1076;3690;804;3015;278;1140;191;683;469;1823
421575;201403;612;2107;549;1977;116;441;288;1048;404;1489
421580;201403;4281;14444;3484;12630;1322;5348;757;2433;2079;7781
421590;201403;262;842;212;735;48;177;95;311;143;488
421600;201403;560;1714;428;1431;124;454;105;344;229;798
421605;201403;687;2189;497;1801;127;528;117;402;244;930
421610;201403;1858;4925;1478;4383;202;643;929;2767;1131;3410
421620;201403;4981;15645;3692;12917;1285;4858;1135;3971;2420;8829
421625;201403;397;1307;248;915;67;276;73;256;140;532
421630;201403;2746;8423;1786;6235;469;1779;390;1313;859;3092
421635;201403;306;1073;258;981;75;306;91;317;166;623
421640;201403;1096;3607;983;3418;217;761;594;2119;811;2880
421650;201403;2384;8145;2094;7480;812;3180;318;1049;1130;4229
421660;201403;9289;31826;7686;28663;2605;10731;2195;7709;4800;18440
421670;201403;1177;3929;914;3319;262;1037;260;944;522;1981
421680;201403;1489;4970;1322;4566;515;1910;228;720;743;2630
421690;201403;2090;7011;1644;5914;452;1746;264;893;716;2639
421700;201403;715;2279;483;1769;164;666;121;366;285;1032
421710;201403;341;1238;275;1050;107;415;70;258;177;673
421715;201403;315;917;197;670;54;195;56;188;110;383
421720;201403;1825;5711;1397;4901;551;2174;372;1157;923;3331
421725;201403;129;466;125;457;38;148;52;187;90;335
421730;201403;627;1963;349;1291;86;353;76;225;162;578
421740;201403;726;2333;545;1898;161;662;126;347;287;1009
421750;201403;1473;4530;1154;3851;335;1225;405;1227;740;2452
421755;201403;469;1509;342;1182;102;394;96;298;198;692
421760;201403;497;1666;317;1196;86;367;129;462;215;829
421770;201403;3759;11628;3107;10302;1276;4437;731;2483;2007;6920
421775;201403;586;1759;393;1397;89;330;120;424;209;754
421780;201403;1768;6220;1435;5448;564;2315;380;1352;944;3667
421790;201403;1023;2958;655;2319;197;805;153;476;350;1281
421795;201403;406;1259;286;961;45;159;86;288;131;447
421800;201403;2662;8850;2115;7741;585;2397;682;2277;1267;4674
421810;201403;666;2189;509;1814;141;553;85;284;226;837
421820;201403;1133;3731;949;3338;220;940;294;918;514;1858
421825;201403;1388;4779;1280;4512;231;913;689;2344;920;3257
421830;201403;3149;10954;2954;10559;768;2872;1466;5430;2234;8302
421835;201403;182;587;144;522;54;228;56;177;110;405
421840;201403;517;1865;465;1732;189;774;151;526;340;1300
421850;201403;579;1710;435;1460;148;523;126;442;274;965
421860;201403;382;1277;269;1028;55;233;71;266;126;499
421870;201403;5232;15787;3822;12814;1146;4138;671;2175;1817;6313
421875;201403;392;1215;212;790;53;226;49;160;102;386
421880;201403;1090;3672;889;3172;265;1070;213;690;478;1760
421885;201403;359;1286;327;1201;84;315;131;481;215;796
421890;201403;1096;3812;952;3502;319;1282;272;970;591;2252
421895;201403;436;1498;407;1440;115;419;204;744;319;1163
421900;201403;897;2954;752;2598;210;782;252;789;462;1571
421910;201403;540;1775;392;1415;101;410;98;309;199;719
421915;201403;622;1923;485;1610;109;398;158;479;267;877
421917;201403;583;1856;464;1635;147;618;157;504;304;1122
421920;201403;774;2432;634;2230;300;1154;178;558;478;1712
421930;201403;4043;11653;2847;9447;862;3199;457;1467;1319;4666
421935;201403;892;3189;725;2798;200;841;248;940;448;1781
421940;201403;344;1258;244;979;86;379;50;174;136;553
421950;201403;4414;12766;2567;8894;770;2848;515;1793;1285;4641
421960;201403;264;866;213;747;56;215;56;190;112;405
421970;201403;2140;6663;1650;5544;571;2116;320;933;891;3049
421985;201403;461;1323;285;961;43;179;86;296;129;475
422000;201403;175;525;145;467;27;102;80;260;107;362
430003;201403;925;2719;740;2395;206;746;229;719;435;1465
430005;201403;301;1026;266;948;63;242;140;474;203;716
430010;201403;2189;6385;1709;5451;553;1848;589;1937;1142;3785
430020;201403;1117;3036;987;2841;239;795;537;1457;776;2252
430030;201403;1539;4312;1353;3957;391;1214;532;1486;923;2700
430040;201403;13084;34291;11230;31416;3533;10310;4417;12564;7950;22874
430045;201403;749;2087;604;1802;112;372;341;989;453;1361
430047;201403;212;612;162;511;38;122;74;233;112;355
430050;201403;1108;3140;748;2431;154;595;296;904;450;1499
430055;201403;280;816;197;628;42;149;92;288;134;437
430057;201403;79;212;37;126;8;32;11;24;19;56
430060;201403;15399;51099;13796;48203;4339;15824;6272;22451;10611;38275
430063;201403;1098;3325;900;2893;259;885;392;1282;651;2167
430064;201403;1717;5164;1451;4719;403;1340;670;2269;1073;3609
430066;201403;172;451;128;382;33;112;64;179;97;291
430070;201403;594;1886;426;1487;108;409;117;364;225;773
430080;201403;626;2075;503;1790;129;518;130;419;259;937
430085;201403;680;1960;508;1655;159;576;194;605;353;1181
430087;201403;999;3063;957;2984;105;349;752;2327;857;2676
430090;201403;784;2143;305;1008;40;145;75;254;115;399
430100;201403;1033;3306;838;2929;289;1109;185;543;474;1652
430105;201403;773;2532;627;2235;211;822;138;470;349;1292
430107;201403;264;894;208;726;46;174;75;244;121;418
430110;201403;2237;6666;2071;6387;684;2283;893;2709;1577;4992
430120;201403;1794;5571;1453;4825;312;1100;836;2740;1148;3840
430130;201403;4608;11884;4194;11315;743;2140;2596;7081;3339;9221
430140;201403;1230;4012;965;3379;309;1116;313;1081;622;2197
430150;201403;941;2557;651;2016;150;513;190;572;340;1085
430155;201403;511;1630;391;1353;105;358;154;542;259;900
430160;201403;18781;55880;17554;53842;3886;13212;9674;30213;13560;43425
430163;201403;1908;5853;1653;5372;397;1470;760;2468;1157;3938
430165;201403;297;1044;249;944;110;433;46;167;156;600
430170;201403;800;2362;404;1421;96;368;81;248;177;616
430175;201403;966;3112;796;2743;177;553;399;1483;576;2036
430180;201403;1147;3164;983;2890;246;796;445;1299;691;2095
430185;201403;766;1932;406;1231;59;199;125;325;184;524
430187;201403;756;2364;665;2188;190;734;244;752;434;1486
430190;201403;2292;6870;2040;6429;511;1868;971;3040;1482;4908
430192;201403;190;593;103;330;17;60;35;103;52;163
430195;201403;254;777;84;313;15;57;12;33;27;90
430200;201403;1843;6013;1577;5484;522;1956;313;1074;835;3030
430205;201403;518;1561;415;1377;50;203;277;906;327;1109
430210;201403;6532;18865;3765;12836;982;3603;677;2146;1659;5749
430215;201403;338;999;259;836;60;213;112;343;172;556
430220;201403;677;1797;338;1133;63;246;53;165;116;411
430222;201403;326;1011;256;858;64;250;102;317;166;567
430223;201403;340;1034;307;983;59;194;200;655;259;849
430225;201403;61;179;37;120;6;14;7;20;13;34
430230;201403;2164;6892;2040;6762;339;1049;1558;5353;1897;6402
430235;201403;277;938;224;801;66;252;56;194;122;446
430237;201403;410;1158;343;1040;50;183;218;633;268;816
430240;201403;1134;3420;896;2943;309;1150;261;757;570;1907
430245;201403;880;2974;734;2640;212;799;298;1100;510;1899
430250;201403;1619;4536;1474;4277;585;1809;450;1315;1035;3124
430258;201403;212;606;149;478;21;69;69;226;90;295
430260;201403;850;2426;574;1848;69;258;323;1048;392;1306
430265;201403;326;1046;272;916;88;311;31;81;119;392
430270;201403;3552;10185;3221;9626;840;2862;1574;4609;2414;7471
430280;201403;5379;15529;4676;14213;1417;4635;1931;5775;3348;10410
430290;201403;2502;6972;2383;6844;321;934;1933;5651;2254;6585
430300;201403;10097;31295;8654;28524;3354;11665;3102;10482;6456;22147
430310;201403;8722;27911;7821;26131;2590;9347;3076;9990;5666;19337
430320;201403;832;2547;607;2078;87;270;305;1108;392;1378
430330;201403;1003;2796;856;2516;255;799;324;870;579;1669
430340;201403;765;1973;455;1540;105;406;212;702;317;1108
430350;201403;6281;20316;5436;18457;2098;7501;1741;5808;3839;13309
430355;201403;245;669;161;513;29;107;40;109;69;216
430360;201403;1170;3120;1016;2852;175;551;574;1590;749;2141
430367;201403;351;980;241;779;38;140;75;229;113;369
430370;201403;630;1874;506;1624;165;578;130;375;295;953
430380;201403;873;2275;485;1563;135;451;165;551;300;1002
430390;201403;4412;13215;3375;10963;834;2972;986;3025;1820;5997
430400;201403;1344;3271;952;2700;257;833;452;1200;709;2033
430410;201403;706;1941;555;1694;98;337;277;840;375;1177
430420;201403;4660;13753;3813;11822;1172;3729;1445;4492;2617;8221
430430;201403;818;2280;537;1739;167;588;133;407;300;995
430435;201403;2040;5644;1708;5036;390;1184;905;2707;1295;3891
430440;201403;4792;15010;3971;13364;794;2962;1786;6233;2580;9195
430450;201403;9178;26712;7502;23244;2759;9086;2185;6709;4944;15795
430460;201403;26650;82408;22068;73947;7073;25461;7411;24875;14484;50336
430461;201403;483;1362;173;562;39;134;38;120;77;254
430462;201403;341;1022;291;941;115;407;98;308;213;715
430463;201403;3949;13198;3543;12358;943;3614;1663;5806;2606;9420
430465;201403;651;1814;555;1649;122;411;353;1028;475;1439
430466;201403;4381;13108;4142;12676;1257;4179;1940;5914;3197;10093
430467;201403;601;1855;530;1738;134;488;256;811;390;1299
430468;201403;1470;4381;1296;4105;542;1890;275;827;817;2717
430469;201403;154;418;53;192;7;26;14;54;21;80
430470;201403;7489;20289;5641;17229;1853;6150;1534;4653;3387;10803
430471;201403;924;3143;836;2953;300;1106;190;683;490;1789
430480;201403;865;2432;496;1628;80;292;104;297;184;589
430485;201403;241;764;137;502;25;87;48;190;73;277
430490;201403;541;1617;385;1319;110;393;131;462;241;855
430495;201403;427;1293;300;1015;70;266;76;244;146;510
430500;201403;1656;4695;1426;4298;420;1400;647;1912;1067;3312
430510;201403;27492;86240;21422;71679;7233;26614;5655;17921;12888;44535
430511;201403;479;1473;257;876;62;201;33;99;95;300
430512;201403;1347;3579;1198;3332;340;989;447;1298;787;2287
430513;201403;688;1952;496;1546;78;247;229;720;307;967
430515;201403;619;1851;496;1590;102;345;205;674;307;1019
430517;201403;1422;4756;1268;4418;249;939;773;2650;1022;3589
430520;201403;1792;5333;1432;4561;470;1608;511;1569;981;3177
430530;201403;913;2600;524;1692;104;393;132;368;236;761
430535;201403;2438;7985;2111;7254;551;2104;669;2249;1220;4353
430537;201403;629;1824;445;1516;52;168;339;1188;391;1356
430540;201403;761;1861;579;1622;133;415;321;866;454;1281
430543;201403;606;1607;546;1546;132;407;344;990;476;1397
430544;201403;718;2445;635;2220;153;579;311;1042;464;1621
430545;201403;1426;4651;1247;4424;456;1546;596;2355;1052;3901
430550;201403;629;1984;497;1685;121;458;188;620;309;1078
430558;201403;122;369;83;282;34;133;11;25;45;158
430560;201403;396;1014;250;749;50;193;107;300;157;493
430570;201403;1206;3209;871;2595;210;722;416;1134;626;1856
430580;201403;1074;3115;756;2476;257;886;204;685;461;1571
430583;201403;129;358;49;165;11;44;4;10;15;54
430585;201403;367;1004;247;747;81;276;100;277;181;553
430587;201403;299;940;257;849;110;381;68;222;178;603
430590;201403;1545;4415;1470;4297;359;1168;825;2371;1184;3539
430593;201403;37;145;35;137;13;58;9;28;22;86
430595;201403;175;544;107;390;34;131;13;36;47;167
430597;201403;393;1238;321;1073;57;215;129;413;186;628
430600;201403;2112;5936;1379;4299;315;1038;474;1447;789;2485
430605;201403;1353;4313;1111;3785;281;1054;439;1523;720;2577
430607;201403;706;1959;615;1799;130;426;353;1008;483;1434
430610;201403;8371;22830;6673;20117;1628;5446;2892;8736;4520;14182
430613;201403;254;648;136;415;35;111;36;92;71;203
430620;201403;988;3082;824;2694;234;854;306;926;540;1780
430630;201403;471;1423;298;990;83;280;58;174;141;454
430632;201403;728;2062;491;1567;89;336;257;758;346;1094
430635;201403;695;1938;497;1551;111;348;223;695;334;1043
430637;201403;547;1579;499;1483;89;323;316;885;405;1208
430640;201403;1957;5663;1075;3597;226;800;201;557;427;1357
430642;201403;485;1309;336;1061;65;229;171;549;236;778
430645;201403;191;578;112;390;24;94;27;87;51;181
430650;201403;2084;7025;1838;6470;398;1451;1002;3644;1400;5095
430655;201403;312;949;277;870;66;233;99;259;165;492
430660;201403;6110;18343;4949;16178;1536;5532;1905;6149;3441;11681
430670;201403;501;1477;456;1388;45;136;340;1068;385;1204
430673;201403;780;1949;451;1398;128;402;181;560;309;962
430675;201403;196;612;129;444;24;94;53;180;77;274
430676;201403;4629;14256;4210;13557;1311;4573;1750;5769;3061;10342
430680;201403;1208;3618;904;2947;196;731;350;1051;546;1782
430690;201403;4545;13356;3829;11973;1214;3976;1404;4519;2618;8495
430692;201403;282;979;215;830;31;120;127;505;158;625
430693;201403;1784;5113;1377;4194;307;1010;377;1113;684;2123
430695;201403;510;1492;425;1323;97;347;202;584;299;931
430697;201403;462;1330;361;1156;117;370;132;460;249;830
430700;201403;11051;29486;5803;18966;1085;3994;717;2105;1802;6099
430705;201403;411;1311;383;1262;135;484;144;470;279;954
430710;201403;1884;4984;1503;4353;314;997;750;2264;1064;3261
430720;201403;912;2300;605;1847;174;574;227;727;401;1301
430730;201403;1898;5205;1520;4599;366;1106;800;2566;1166;3672
430740;201403;617;1811;395;1330;120;431;55;155;175;586
430745;201403;540;1585;384;1239;74;250;133;423;207;673
430750;201403;1821;5317;1596;4894;382;1300;796;2341;1178;3641
430755;201403;661;1889;478;1486;111;406;203;551;314;957
430760;201403;3698;9521;2933;8588;641;2073;1579;4802;2220;6875
430770;201403;6985;21195;5937;19376;1446;5216;2804;9009;4250;14225
430780;201403;2538;7316;1787;5810;488;1720;661;2036;1149;3756
430781;201403;653;2000;492;1677;149;544;164;547;313;1091
430783;201403;579;1523;454;1301;86;274;202;532;288;806
430786;201403;127;439;103;370;35;133;14;47;49;180
430790;201403;3892;11002;2659;8447;558;2078;1147;3399;1705;5477
430800;201403;816;2521;623;2047;162;563;200;628;362;1191
430805;201403;479;1395;364;1181;41;148;229;761;270;909
430807;201403;342;1061;279;916;65;258;88;252;153;510
430810;201403;683;1938;361;1234;58;230;66;207;124;437
430820;201403;1105;3605;862;2986;241;893;246;802;487;1695
430825;201403;463;1321;255;813;47;162;78;226;125;388
430830;201403;2731;8099;2541;7804;393;1246;1632;5307;2025;6553
430840;201403;1002;3166;915;2976;238;760;407;1403;645;2163
430843;201403;99;324;74;243;15;48;29;89;44;137
430845;201403;428;1280;360;1154;125;430;55;164;180;594
430850;201403;3366;10426;3020;9790;924;3185;1179;3818;2103;7003
430860;201403;735;2418;574;2037;184;778;131;400;315;1178
430865;201403;732;2032;672;1926;222;654;301;869;523;1523
430870;201403;647;1885;430;1458;141;491;121;394;262;885
430880;201403;1407;4172;1158;3670;461;1575;277;897;738;2472
430885;201403;180;576;154;532;50;190;46;148;96;338
430890;201403;1606;4395;1299;3834;69;233;834;2447;903;2680
430900;201403;3345;9085;3146;8829;581;1701;2121;6073;2702;7774
430905;201403;1099;3329;794;2641;270;970;192;614;462;1584
430910;201403;1854;6054;1577;5480;587;2190;562;1893;1149;4083
430912;201403;591;1678;464;1466;74;265;250;773;324;1038
430915;201403;408;1447;304;1223;87;372;78;333;165;705
430920;201403;18189;58274;16799;55670;5776;19934;8684;28690;14460;48624
430925;201403;91;263;74;229;21;73;37;112;58;185
430930;201403;9541;30314;7926;26985;2408;8704;2911;10286;5319;18990
430940;201403;1132;3579;922;3169;217;847;286;944;503;1791
430950;201403;1618;4633;1260;3858;367;1181;349;1039;716;2220
430955;201403;104;346;82;287;26;100;22;68;48;168
430957;201403;322;1092;266;967;66;254;112;406;178;660
430960;201403;1776;5193;1538;4775;591;1943;469;1482;1060;3425
430965;201403;1399;4277;1213;3926;174;640;859;2742;1033;3382
430970;201403;543;1584;346;1155;88;324;92;299;180;623
430975;201403;647;2141;502;1784;92;353;261;921;353;1274
430980;201403;562;1389;349;1072;94;333;128;337;222;670
430990;201403;664;2182;515;1793;170;617;115;388;285;1005
430995;201403;733;2204;656;2054;231;739;232;727;463;1466
431000;201403;1732;4766;1020;3274;241;892;137;365;378;1257
431010;201403;2849;8603;2013;6860;534;2003;607;1928;1141;3931
431020;201403;14632;37066;10416;29347;2864;8478;3177;9252;6041;17730
431030;201403;395;1224;242;852;60;225;56;201;116;426
431033;201403;2873;8454;2640;8106;647;2104;1441;4627;2088;6731
431036;201403;210;611;99;333;20;72;29;87;49;159
431040;201403;1049;3085;886;2800;239;827;449;1384;688;2211
431041;201403;592;1669;533;1582;194;612;178;560;372;1172
431043;201403;412;1374;320;1163;155;612;102;332;257;944
431046;201403;118;365;87;289;24;84;32;102;56;186
431050;201403;1855;4768;1567;4320;344;995;903;2510;1247;3505
431053;201403;639;2137;547;1943;175;683;175;606;350;1289
431055;201403;704;2004;652;1912;83;257;457;1350;540;1607
431057;201403;338;987;208;736;58;223;81;280;139;503
431060;201403;6334;18869;6010;18466;1472;4307;3773;12198;5245;16505
431065;201403;445;1381;424;1344;51;175;283;898;334;1073
431070;201403;772;2280;485;1625;107;372;113;337;220;709
431075;201403;291;887;194;672;34;131;61;214;95;345
431080;201403;709;2308;591;2056;167;619;110;361;277;980
431085;201403;946;2544;765;2242;138;426;438;1281;576;1707
431087;201403;631;1822;560;1688;83;237;361;1106;444;1343
431090;201403;553;1438;312;973;99;318;60;174;159;492
431100;201403;4806;13547;4071;12236;1165;3717;1597;4955;2762;8672
431110;201403;1629;4480;1273;3761;326;1044;616;1769;942;2813
431112;201403;666;2133;639;2089;229;745;291;983;520;1728
431113;201403;668;2019;508;1651;167;547;129;427;296;974
431115;201403;1502;4548;1376;4318;313;1049;793;2455;1106;3504
431120;201403;2734;8932;2458;8381;756;2869;992;3246;1748;6115
431123;201403;532;1692;451;1531;119;416;216;759;335;1175
431125;201403;1414;4429;1116;3792;349;1231;395;1426;744;2657
431127;201403;127;357;69;221;12;39;11;34;23;73
431130;201403;3944;11584;3299;10490;961;3353;1343;4281;2304;7634
431140;201403;4006;10602;2369;7786;482;1857;644;1863;1126;3720
431142;201403;550;1688;505;1603;68;238;314;1014;382;1252
431150;201403;1350;4143;1101;3655;302;1032;378;1289;680;2321
431160;201403;973;2932;838;2645;170;541;411;1382;581;1923
431162;201403;458;1249;242;811;38;146;36;105;74;251
431164;201403;123;340;38;144;13;44;1;4;14;48
431170;201403;965;2865;761;2449;240;810;204;647;444;1457
431171;201403;886;2698;784;2489;249;833;174;511;423;1344
431173;201403;489;1493;456;1433;108;350;267;848;375;1198
431175;201403;1325;3709;1156;3455;400;1278;447;1320;847;2598
431177;201403;994;3333;899;3117;305;1160;362;1238;667;2398
431179;201403;130;348;83;255;19;64;28;75;47;139
431180;201403;2731;8288;2191;7057;597;2109;635;1903;1232;4012
431190;201403;775;2176;467;1557;134;496;140;463;274;959
431198;201403;381;1270;333;1170;153;591;66;212;219;803
431200;201403;319;935;130;440;23;83;15;50;38;133
431205;201403;317;1057;238;835;59;220;86;283;145;503
431210;201403;787;2272;685;2062;180;559;351;1057;531;1616
431213;201403;318;999;267;898;73;272;91;290;164;562
431215;201403;344;1027;179;609;29;101;21;56;50;157
431217;201403;248;768;195;649;65;233;48;168;113;401
431220;201403;1219;3174;902;2576;124;424;473;1280;597;1704
431225;201403;1377;4156;1221;3888;284;981;648;2071;932;3052
431230;201403;954;2899;754;2487;119;447;417;1379;536;1826
431235;201403;76;183;36;110;12;41;9;24;21;65
431237;201403;458;1510;404;1433;128;520;174;587;302;1107
431238;201403;54;174;45;151;9;35;14;45;23;80
431240;201403;2882;9043;2495;8367;901;3245;718;2370;1619;5615
431242;201403;429;1404;406;1359;161;612;33;96;194;708
431244;201403;463;1143;343;964;74;252;154;395;228;647
431245;201403;1063;2985;927;2762;178;561;595;1776;773;2337
431247;201403;221;706;184;633;72;261;62;205;134;466
431250;201403;1909;6128;1714;5833;568;2112;646;2247;1214;4359
431260;201403;394;1160;280;933;70;263;60;182;130;445
431261;201403;221;793;190;724;43;187;55;206;98;393
431262;201403;362;1029;169;582;27;130;68;219;95;349
431265;201403;1376;3753;838;2601;204;713;238;622;442;1335
431267;201403;199;613;166;550;49;173;68;210;117;383
431270;201403;2451;6990;2119;6479;675;2219;1001;3082;1676;5301
431275;201403;218;726;146;524;42;138;25;79;67;217
431280;201403;175;548;112;390;26;103;27;75;53;178
431290;201403;360;1183;285;986;78;307;64;204;142;511
431295;201403;220;710;131;451;25;100;29;83;54;183
431300;201403;211;661;96;372;32;131;7;24;39;155
431301;201403;246;813;181;643;38;147;40;127;78;274
431303;201403;740;2017;546;1637;141;488;201;568;342;1056
431306;201403;2165;6165;1716;5321;328;1204;584;1618;912;2822
431308;201403;58;203;54;192;39;143;11;36;50;179
431310;201403;771;2475;569;2019;106;405;211;768;317;1173
431320;201403;903;2664;581;2019;174;676;128;407;302;1083
431330;201403;2293;5951;1197;3853;357;1265;187;579;544;1844
431333;201403;362;983;202;619;39;130;63;168;102;298
431335;201403;101;298;85;262;19;59;28;76;47;135
431337;201403;2688;8352;2130;7110;601;2089;565;1870;1166;3959
431339;201403;634;1847;496;1528;109;360;223;686;332;1046
431340;201403;28050;76036;20890;63790;5182;17584;7556;22569;12738;40153
431342;201403;643;1714;546;1547;152;457;283;771;435;1228
431344;201403;369;1051;294;917;22;69;184;590;206;659
431346;201403;303;826;189;565;55;169;48;144;103;313
431349;201403;625;1827;473;1465;99;303;151;467;250;770
431350;201403;3978;12147;3554;11376;665;2458;2034;6284;2699;8742
431360;201403;788;2176;612;1889;174;571;224;696;398;1267
431365;201403;1352;4228;1192;3962;464;1692;421;1381;885;3073
431370;201403;5596;16360;4759;14949;1380;4665;1932;6168;3312;10833
431380;201403;1142;3474;1079;3341;177;586;745;2272;922;2858
431390;201403;3623;10570;2610;8578;829;3021;713;2193;1542;5214
431395;201403;1619;4911;1457;4647;400;1356;566;1832;966;3188
431400;201403;195;647;130;501;39;162;11;28;50;190
431402;201403;1222;3144;801;2361;154;492;374;1057;528;1549
431403;201403;326;979;249;840;85;319;51;170;136;489
431405;201403;4638;13390;3740;12044;864;3256;1775;5472;2639;8728
431406;201403;815;2597;638;2162;211;741;229;760;440;1501
431407;201403;644;2000;485;1627;160;560;107;332;267;892
431410;201403;17006;53311;13892;47171;5329;19459;3189;11273;8518;30732
431413;201403;211;530;103;330;10;35;45;143;55;178
431415;201403;947;2740;781;2424;194;654;362;1078;556;1732
431417;201403;684;1780;552;1578;95;294;290;858;385;1152
431420;201403;1622;4570;1443;4279;360;1141;765;2320;1125;3461
431430;201403;605;1688;458;1439;115;401;160;462;275;863
431440;201403;33218;98388;29874;92824;10103;32926;12637;40885;22740;73811
431442;201403;210;681;169;578;54;204;19;45;73;249
431445;201403;508;1422;351;1070;60;188;131;384;191;572
431446;201403;511;1517;383;1243;100;340;159;514;259;854
431447;201403;856;2454;616;1914;109;366;281;891;390;1257
431449;201403;932;2686;764;2399;132;451;383;1233;515;1684
431450;201403;2300;6123;2117;5844;552;1597;1252;3437;1804;5034
431455;201403;654;1707;421;1215;119;364;124;325;243;689
431460;201403;3699;10598;3215;9648;925;2901;1165;3579;2090;6480
431470;201403;2172;6454;1805;5632;502;1565;754;2489;1256;4054
431475;201403;153;453;59;236;12;52;5;23;17;75
431477;201403;638;1841;515;1593;106;361;277;828;383;1189
431478;201403;200;533;95;285;19;57;36;107;55;164
431480;201403;2767;8241;2222;7223;751;2652;638;2010;1389;4662
431490;201403;111547;320285;98776;301078;17874;62434;63346;189161;81220;251595
431500;201403;1196;3147;967;2717;281;806;336;951;617;1757
431505;201403;379;1080;354;1044;34;92;285;855;319;947
431507;201403;457;1130;369;966;82;210;217;579;299;789
431510;201403;2250;6276;1882;5627;374;1213;967;2819;1341;4032
431513;201403;216;612;114;372;30;102;54;177;84;279
431514;201403;113;289;44;141;9;32;3;6;12;38
431515;201403;760;2317;579;1874;129;461;265;789;394;1250
431517;201403;94;310;87;293;39;140;22;67;61;207
431520;201403;494;1504;317;1066;62;237;72;242;134;479
431530;201403;4697;11620;3687;10453;1068;3102;1909;5752;2977;8854
431531;201403;292;842;207;669;51;182;80;263;131;445
431532;201403;564;1617;509;1508;181;585;152;436;333;1021
431535;201403;390;1165;279;879;63;224;75;213;138;437
431540;201403;2269;7314;2044;6991;303;975;1315;4833;1618;5808
431545;201403;140;424;63;229;5;20;13;53;18;73
431550;201403;2492;7609;2298;7254;540;1932;1099;3402;1639;5334
431555;201403;788;2094;698;1963;172;489;353;1003;525;1492
431560;201403;24388;77102;21130;70408;8738;29774;6164;21590;14902;51364
431570;201403;5769;16704;5255;15934;1661;5148;2790;8603;4451;13751
431575;201403;490;1332;359;1110;53;192;128;375;181;567
431580;201403;722;2328;615;2076;157;596;218;683;375;1279
431590;201403;1014;2873;718;2274;91;302;367;1166;458;1468
431595;201403;642;1826;532;1585;131;415;184;551;315;966
431600;201403;2289;6907;1749;5764;457;1696;349;978;806;2674
431610;201403;1704;4867;1273;4065;322;1105;584;1848;906;2953
431620;201403;408;1306;259;859;91;327;91;270;182;597
431630;201403;1444;3986;1117;3298;282;865;539;1618;821;2483
431640;201403;6162;18581;5628;17727;1558;5431;2887;8907;4445;14338
431642;201403;525;1587;464;1460;75;282;252;763;327;1045
431643;201403;227;614;197;560;44;147;106;270;150;417
431645;201403;1822;5568;1674;5316;407;1320;905;2961;1312;4281
431647;201403;175;500;125;382;39;119;26;63;65;182
431650;201403;250;802;179;652;40;162;34;102;74;264
431660;201403;1508;4599;1181;3896;387;1330;398;1262;785;2592
431670;201403;1401;3966;1150;3513;327;1125;464;1339;791;2464
431673;201403;240;716;156;529;42;154;38;123;80;277
431675;201403;315;1064;236;816;55;194;62;188;117;382
431680;201403;10704;30106;8295;25902;2554;8566;2739;8654;5293;17220
431690;201403;26021;76035;21484;68841;6814;23472;7840;25494;14654;48966
431695;201403;150;514;111;409;23;86;27;75;50;161
431697;201403;528;1507;472;1401;132;399;197;605;329;1004
431700;201403;1689;4799;1458;4358;292;946;750;2189;1042;3135
431710;201403;13296;39572;11109;35761;3310;11211;4192;14087;7502;25298
431720;201403;7291;20914;6106;18681;1410;4893;3039;9087;4449;13980
431725;201403;38;135;36;131;22;84;5;18;27;102
431730;201403;3861;12063;3198;10784;958;3613;1088;3699;2046;7312
431740;201403;6057;18095;5422;16855;1961;6600;1507;4467;3468;11067
431750;201403;10724;30916;9246;28502;1983;6590;4769;15043;6752;21633
431755;201403;274;724;82;286;16;63;14;40;30;103
431760;201403;4110;12649;3463;11402;988;3526;1005;3185;1993;6711
431770;201403;2390;6624;2036;6056;536;1693;993;2918;1529;4611
431775;201403;255;733;199;627;82;270;46;127;128;397
431780;201403;2379;6442;1829;5418;512;1650;504;1399;1016;3049
431790;201403;1211;3860;1083;3636;285;1032;539;1779;824;2811
431795;201403;481;1459;389;1236;80;269;184;580;264;849
431800;201403;9787;29394;8302;26609;2784;9784;2340;7307;5124;17091
431805;201403;308;750;89;300;14;57;18;58;32;115
431810;201403;3702;10415;3088;9136;702;2260;1409;4125;2111;6385
431820;201403;2870;9144;2560;8540;763;2798;914;2973;1677;5771
431830;201403;11301;30110;9481;27273;3322;10450;3332;9546;6654;19996
431840;201403;3615;10943;3205;10154;991;3267;1365;4405;2356;7672
431842;201403;758;1988;452;1393;97;316;137;407;234;723
431843;201403;361;1066;328;1007;75;255;180;538;255;793
431844;201403;169;510;131;438;36;140;40;125;76;265
431845;201403;553;1688;506;1587;62;196;336;1076;398;1272
431846;201403;545;1646;470;1511;86;314;268;863;354;1177
431848;201403;203;560;110;373;20;83;22;69;42;152
431849;201403;377;946;127;396;26;89;33;88;59;177
431850;201403;5044;14996;4537;14043;1095;3698;2230;6759;3325;10457
431860;201403;978;2784;804;2502;194;676;394;1166;588;1842
431861;201403;96;306;62;215;13;43;9;29;22;72
431862;201403;497;1710;420;1546;155;625;98;338;253;963
431870;201403;26769;76582;22621;69162;6284;21194;9234;27357;15518;48551
431880;201403;4840;15522;4083;13780;1223;4532;1565;5092;2788;9624
431890;201403;6073;17446;5232;15931;2006;6491;1522;4736;3528;11227
431900;201403;986;3057;793;2685;227;873;308;938;535;1811
431910;201403;926;2255;481;1404;106;347;177;473;283;820
431912;201403;620;1833;495;1574;152;469;170;570;322;1039
431915;201403;1426;3940;1080;3309;303;984;371;1153;674;2137
431920;201403;1555;4443;1436;4280;201;573;1080;3312;1281;3885
431930;201403;1344;3759;1050;3276;158;482;615;2048;773;2530
431935;201403;112;429;103;406;42;181;24;73;66;254
431936;201403;487;1415;445;1342;77;229;284;928;361;1157
431937;201403;349;952;207;650;45;162;48;143;93;305
431940;201403;2820;7856;1932;6121;531;1789;524;1633;1055;3422
431950;201403;1964;6314;1761;5940;514;1880;659;2132;1173;4012
431960;201403;3759;11288;3453;10695;1061;3503;1154;3598;2215;7101
431970;201403;527;1459;288;946;44;163;80;253;124;416
431971;201403;134;402;113;374;31;104;47;153;78;257
431973;201403;482;1720;427;1605;69;262;247;999;316;1261
431975;201403;16;63;12;52;2;12;4;14;6;26
431980;201403;1575;4617;1402;4258;359;1280;537;1483;896;2763
431990;201403;8950;25220;7178;22373;1482;5327;3014;8999;4496;14326
432000;201403;11340;33685;9380;30205;3085;10396;3731;12106;6816;22502
432010;201403;2552;7658;2227;7036;517;1870;1048;3192;1565;5062
432020;201403;2309;6056;1966;5596;322;993;1267;3573;1589;4566
432023;201403;540;1596;417;1317;106;381;161;475;267;856
432026;201403;1225;3862;1042;3449;245;827;487;1631;732;2458
432030;201403;419;1258;356;1116;102;337;136;404;238;741
432032;201403;555;1498;382;1173;75;262;203;598;278;860
432035;201403;859;2805;786;2653;208;745;425;1415;633;2160
432040;201403;778;2306;556;1843;130;466;120;308;250;774
432045;201403;204;687;176;629;50;192;68;248;118;440
432050;201403;798;2338;719;2189;144;461;402;1256;546;1717
432055;201403;849;2660;730;2421;159;590;426;1361;585;1951
432057;201403;470;1250;377;1070;37;134;242;634;279;768
432060;201403;470;1349;211;745;60;233;45;144;105;377
432065;201403;248;727;191;621;46;170;82;240;128;410
432067;201403;1008;3331;768;2750;204;764;340;1204;544;1968
432070;201403;2619;7158;1986;5915;635;2134;619;1741;1254;3875
432080;201403;4355;12832;3843;11890;1234;4063;1469;4470;2703;8533
432085;201403;256;834;221;769;78;314;61;196;139;510
432090;201403;1797;5622;1535;5064;593;2099;437;1281;1030;3380
432100;201403;1238;3731;715;2491;172;620;121;361;293;981
432110;201403;3130;9512;2547;8316;827;2986;454;1423;1281;4409
432120;201403;5448;16682;4724;15326;1736;6051;1370;4417;3106;10468
432130;201403;2413;7139;2095;6707;579;2006;1137;3687;1716;5693
432132;201403;425;1336;264;936;47;169;92;290;139;459
432135;201403;805;2439;765;2369;139;453;500;1551;639;2004
432140;201403;2965;8790;2429;7804;691;2360;898;3152;1589;5512
432143;201403;1395;4302;1215;3998;302;1015;652;2218;954;3233
432145;201403;1121;3581;770;2748;245;951;142;441;387;1392
432146;201403;282;896;206;706;68;244;51;168;119;412
432147;201403;846;2700;684;2345;197;703;265;931;462;1634
432149;201403;424;1273;305;988;89;301;96;302;185;603
432150;201403;3848;11364;3022;9770;977;3451;893;2772;1870;6223
432160;201403;4655;15296;4193;14513;1471;5385;1562;5658;3033;11043
432162;201403;341;844;100;327;23;84;24;67;47;151
432163;201403;363;965;106;338;19;61;20;67;39;128
432166;201403;819;2480;673;2172;136;505;313;927;449;1432
432170;201403;865;2915;635;2400;134;553;122;424;256;977
432180;201403;2893;7765;2097;6432;596;1996;604;1776;1200;3772
432183;201403;408;1377;377;1310;165;598;80;272;245;870
432185;201403;885;2570;602;1968;130;471;222;703;352;1174
432190;201403;3596;10103;2695;8094;725;2323;788;2209;1513;4532
432195;201403;1306;3761;1177;3556;209;685;730;2192;939;2877
432200;201403;3225;10066;2669;9089;826;3028;1106;3859;1932;6887
432210;201403;439;1312;380;1223;108;404;176;522;284;926
432215;201403;903;2856;806;2690;159;504;481;1696;640;2200
432218;201403;319;899;244;750;41;132;107;306;148;438
432220;201403;4000;10885;3346;9814;456;1558;2127;6123;2583;7681
432225;201403;65;221;55;203;29;110;12;45;41;155
432230;201403;1192;3363;896;2738;276;936;353;959;629;1895
432232;201403;583;1732;461;1499;109;393;220;704;329;1097
432234;201403;551;1550;421;1226;97;289;174;484;271;773
432235;201403;76;237;46;164;14;63;7;23;21;86
432237;201403;508;1425;460;1350;39;150;356;1005;395;1155
432240;201403;15900;53193;13941;50555;3335;13328;8050;29767;11385;43095
432250;201403;5637;19950;5336;19323;2363;9270;1346;4933;3709;14203
432252;201403;483;1450;407;1298;133;446;174;566;307;1012
432253;201403;1268;4261;993;3538;328;1221;294;1056;622;2277
432254;201403;595;1631;209;694;42;149;32;94;74;243
432255;201403;214;534;119;386;32;110;39;128;71;238
432260;201403;7264;18947;5287;15641;1355;4224;2297;6883;3652;11107
432270;201403;2791;8723;2462;8152;729;2485;1140;3868;1869;6353
432280;201403;1305;3840;828;2802;185;705;203;581;388;1286
432285;201403;140;455;70;238;20;73;13;36;33;109
432290;201403;607;1864;417;1413;93;353;152;479;245;832
432300;201403;23948;74322;22012;70989;5975;20572;11189;35997;17164;56569
432310;201403;1012;3152;877;2902;200;746;434;1388;634;2134
432320;201403;283;802;182;594;51;166;57;193;108;359
432330;201403;240;709;104;367;15;48;10;31;25;79
432335;201403;207;609;91;322;23;89;8;23;31;112
432340;201403;310;812;161;497;41;135;42;122;83;257
432345;201403;776;2229;718;2137;158;568;379;1039;537;1607
432350;201403;468;1337;325;1068;79;270;84;257;163;527
432360;201403;46;149;36;129;15;53;11;38;26;91
432370;201403;491;1407;400;1230;37;108;268;849;305;957
432375;201403;879;2280;714;2008;133;389;414;1187;547;1576
432377;201403;82;282;41;136;7;22;12;31;19;53
432380;201403;885;3170;824;3037;367;1504;254;859;621;2363
500020;201403;2205;7152;1725;6147;501;1997;510;1681;1011;3678
500025;201403;1015;2599;660;1980;138;434;275;807;413;1241
500060;201403;6366;18796;5223;17023;726;2368;3556;12098;4282;14466
500070;201403;4054;12279;3492;11316;814;3027;1612;5115;2426;8142
500080;201403;1819;5449;1375;4641;465;1710;383;1349;848;3059
500085;201403;2142;5830;1616;5019;211;723;964;2895;1175;3618
500090;201403;2369;7130;1863;6209;411;1436;943;3250;1354;4686
500100;201403;2572;7905;2394;7618;819;2979;1032;3107;1851;6086
500110;201403;8209;24427;6816;22316;1146;4176;3891;13337;5037;17513
500124;201403;1903;6239;1649;5810;298;1021;940;3598;1238;4619
500150;201403;1371;3725;1132;3345;297;983;527;1487;824;2470
500190;201403;4975;13383;3961;12131;925;3087;2059;6557;2984;9644
500200;201403;2628;6790;1948;5815;380;1334;1063;3058;1443;4392
500210;201403;4929;15012;4286;14014;1041;3637;2076;6996;3117;10633
500215;201403;1735;5487;1474;4974;347;1335;594;1871;941;3206
500220;201403;2719;8717;2250;7834;558;2131;823;2921;1381;5052
500230;201403;2581;6966;2039;6153;715;2404;730;2164;1445;4568
500240;201403;4931;15348;3721;12939;728;2845;1583;5732;2311;8577
500260;201403;2533;6986;2081;6252;429;1434;998;2806;1427;4240
500270;201403;108143;287687;74735;230653;21352;72053;18188;56285;39540;128338
500280;201403;1335;3955;1149;3697;209;704;712;2362;921;3066
500290;201403;3941;10272;2630;8047;732;2592;852;2370;1584;4962
500295;201403;2480;7763;1845;6187;419;1634;489;1409;908;3043
500310;201403;823;2219;722;2076;179;567;357;987;536;1554
500315;201403;2936;9410;2559;8871;571;1912;1513;5595;2084;7507
500320;201403;13664;46396;12092;43543;4084;15663;4273;16313;8357;31976
500325;201403;4207;11287;3218;9692;903;3019;1384;4010;2287;7029
500330;201403;5735;16151;4589;13996;1468;4843;1701;5095;3169;9938
500345;201403;2482;7329;2098;6693;521;1857;1011;3116;1532;4973
500348;201403;2503;7379;2264;6991;280;992;1632;5007;1912;5999
500350;201403;1240;3828;807;2840;132;499;230;825;362;1324
500370;201403;23422;74033;18768;64990;4841;18765;6580;22837;11421;41602
500375;201403;2760;7637;2052;6344;461;1513;883;2823;1344;4336
500380;201403;2946;8649;2522;7842;826;2781;745;2237;1571;5018
500390;201403;598;1308;396;1022;57;180;269;652;326;832
500400;201403;1345;4292;1093;3688;330;1238;301;914;631;2152
500410;201403;2144;6080;1753;5503;465;1606;762;2404;1227;4010
500430;201403;2699;8183;2219;7477;565;2046;950;3349;1515;5395
500440;201403;1346;3974;1149;3657;280;1015;587;1796;867;2811
500450;201403;2169;6861;1747;6003;452;1763;339;1042;791;2805
500460;201403;3632;11222;2970;10197;824;3089;1096;3733;1920;6822
500470;201403;3064;9274;2325;7657;650;2347;383;1158;1033;3505
500480;201403;2001;6543;1860;6330;200;692;1452;5090;1652;5782
500490;201403;1081;3138;914;2858;293;1039;287;899;580;1938
500500;201403;3548;11056;2881;10075;1068;4229;880;3036;1948;7265
500510;201403;875;2394;614;1957;134;508;237;678;371;1186
500515;201403;1903;5187;1538;4691;272;811;938;3083;1210;3894
500520;201403;2847;10003;2543;9576;612;2461;1453;5678;2065;8139
500525;201403;1185;3871;1022;3555;231;866;522;1906;753;2772
500540;201403;5283;15644;3498;12066;1042;4115;707;2259;1749;6374
500560;201403;4718;15944;4270;15291;901;3402;2762;10066;3663;13468
500568;201403;3911;10436;2965;9036;712;2362;1386;4268;2098;6630
500570;201403;7566;21270;5541;17702;1679;5763;1975;6347;3654;12110
500580;201403;3510;10413;2814;9171;484;1720;1720;5619;2204;7339
500600;201403;3050;8669;2328;7443;647;2300;868;2722;1515;5022
500620;201403;7690;22005;5763;18679;1289;4754;2856;9145;4145;13899
500625;201403;688;2088;466;1611;107;420;147;475;254;895
500627;201403;387;1106;292;921;61;212;69;233;130;445
500630;201403;6202;17652;5014;15918;1711;6054;1463;4602;3174;10656
500635;201403;2388;9428;2112;9018;310;1284;1347;6243;1657;7527
500640;201403;1484;3816;1199;3408;148;484;816;2259;964;2743
500660;201403;16115;49109;13325;44310;3149;11887;5856;19290;9005;31177
500690;201403;3051;8843;2505;8161;847;2885;1030;3577;1877;6462
500710;201403;3596;11192;3265;10662;838;2938;1659;5434;2497;8372
500720;201403;5702;15895;3876;12525;1117;4021;1066;3338;2183;7359
500730;201403;965;2827;772;2432;177;622;285;847;462;1469
500740;201403;3706;10526;2737;8772;600;2224;1184;3569;1784;5793
500750;201403;824;2499;764;2417;193;652;422;1376;615;2028
500755;201403;1271;3813;973;3247;244;905;338;1043;582;1948
500769;201403;4729;12903;3212;9876;698;2392;974;2706;1672;5098
500770;201403;1707;5163;1368;4507;395;1413;444;1464;839;2877
500780;201403;1093;3455;961;3195;286;1041;408;1303;694;2344
500790;201403;8749;25157;7399;22794;1479;5369;3933;11510;5412;16879
500793;201403;2367;6987;1908;6221;350;1278;878;2747;1228;4025
500795;201403;2344;7112;2119;6793;281;771;1543;5315;1824;6086
500797;201403;934;2602;724;2260;154;535;329;1030;483;1565
500800;201403;2460;7209;2031;6595;693;2534;774;2515;1467;5049
500830;201403;16083;47921;12071;39671;3473;12483;3345;10656;6818;23139
500840;201403;1389;4087;1068;3459;214;748;465;1495;679;2243
510010;201403;1272;4075;1190;3928;419;1445;481;1649;900;3094
510020;201403;2869;8495;2086;7001;603;2130;533;1729;1136;3859
510025;201403;9074;27822;8016;26028;2474;8966;3176;9979;5650;18945
510030;201403;2122;5844;1801;5356;580;1812;749;2220;1329;4032
510035;201403;899;2708;762;2492;162;543;411;1409;573;1952
510040;201403;1706;4817;1362;4298;292;1034;683;2139;975;3173
510050;201403;1855;5494;1385;4628;381;1422;512;1684;893;3106
510060;201403;1262;3798;1000;3297;266;949;324;1042;590;1991
510080;201403;1317;4141;1111;3791;333;1334;349;1053;682;2387
510100;201403;658;1814;445;1377;90;308;152;441;242;749
510120;201403;295;616;194;504;19;41;154;405;173;446
510125;201403;3082;8315;2455;7225;490;1760;1117;3083;1607;4843
510130;201403;2102;5881;1798;5402;568;1807;701;2138;1269;3945
510140;201403;2939;9752;2467;9012;917;3569;708;2576;1625;6145
510160;201403;1283;4383;1225;4314;92;368;1068;3759;1160;4127
510170;201403;5980;18708;5090;17057;1237;4634;2315;7548;3552;12182
510180;201403;10960;30553;8320;26263;2650;8901;2838;9781;5488;18682
510185;201403;1200;3947;1115;3819;237;789;728;2639;965;3428
510190;201403;1649;5684;1365;5198;333;1403;572;2289;905;3692
510250;201403;13646;43866;11901;41442;3807;14180;5361;19143;9168;33323
510260;201403;2542;9716;2333;9266;709;3010;988;4127;1697;7137
510263;201403;4190;11858;3215;10206;927;3223;1035;3149;1962;6372
510267;201403;5298;15519;3899;12508;924;3278;1304;3998;2228;7276
510268;201403;894;2662;774;2490;212;751;376;1206;588;1957
510269;201403;828;2685;756;2578;223;790;334;1177;557;1967
510270;201403;2458;7816;2235;7464;361;1205;1374;4816;1735;6021
510279;201403;2055;6674;1887;6396;689;2630;604;1854;1293;4484
510285;201403;1487;4626;1260;4217;365;1333;418;1339;783;2672
510300;201403;3164;9763;2808;9259;395;1464;2054;6773;2449;8237
510305;201403;1617;5225;1343;4701;362;1401;414;1452;776;2853
510310;201403;1104;3221;873;2840;300;1078;255;802;555;1880
510320;201403;3584;10705;2823;9172;817;3109;540;1490;1357;4599
510325;201403;5441;17677;4778;16733;645;2238;3599;13064;4244;15302
510330;201403;2713;9107;2371;8475;633;2512;904;3299;1537;5811
510335;201403;4410;14194;3937;13554;687;2367;2779;9978;3466;12345
510336;201403;554;1717;482;1588;109;395;219;712;328;1107
510337;201403;2250;7648;1968;7096;810;3024;534;2118;1344;5142
510340;201403;61965;184953;50032;166767;19828;72692;10425;36522;30253;109214
510343;201403;1131;3422;1038;3311;118;358;834;2743;952;3101
510345;201403;1666;4986;1423;4554;364;1277;469;1409;833;2686
510350;201403;3424;10075;2851;9284;828;2932;1292;4290;2120;7222
510360;201403;1846;4945;1362;4339;277;957;851;2661;1128;3618
510370;201403;891;3278;803;3130;225;912;402;1627;627;2539
510380;201403;483;1585;387;1388;138;546;63;204;201;750
510385;201403;914;3479;766;3079;135;602;346;1478;481;2080
510390;201403;1157;3629;1068;3528;285;849;607;2214;892;3063
510395;201403;850;2213;646;1951;121;390;360;1156;481;1546
510410;201403;4070;13592;3839;13178;1114;4097;1846;6392;2960;10489
510420;201403;2295;6111;1766;5217;292;1024;917;2677;1209;3701
510450;201403;585;1663;449;1471;136;504;151;479;287;983
510452;201403;617;2033;452;1638;119;489;148;496;267;985
510454;201403;804;2573;710;2439;154;553;405;1456;559;2009
510455;201403;1015;3148;790;2726;189;777;302;994;491;1771
510460;201403;2045;5893;1796;5544;349;1247;1150;3432;1499;4679
510480;201403;4252;11733;3260;9857;814;2654;1033;3035;1847;5689
510490;201403;1476;4924;1326;4698;348;1358;740;2575;1088;3933
510500;201403;1414;4374;1065;3716;288;1149;468;1566;756;2715
510510;201403;3057;10921;2722;10343;1068;4309;896;3411;1964;7720
510515;201403;5693;17976;4693;15900;1182;4480;1314;4251;2496;8731
510517;201403;1767;5397;1554;5073;475;1522;869;3002;1344;4524
510520;201403;2186;5701;1699;5026;134;468;1258;3718;1392;4186
510523;201403;1079;3301;921;3033;251;901;473;1532;724;2433
510525;201403;7906;20471;5231;16274;1276;4336;1848;5660;3124;9996
510530;201403;561;1620;492;1520;84;310;284;873;368;1183
510550;201403;2721;9097;2370;8486;671;2519;1016;3757;1687;6276
510558;201403;2088;6135;1664;5502;501;1823;672;2193;1173;4016
510560;201403;1640;5431;1204;4643;427;1743;268;1087;695;2830
510562;201403;5141;15937;4531;14749;1568;5606;1455;4779;3023;10385
510590;201403;2794;8136;2260;7451;663;2395;956;3193;1619;5588
510600;201403;1479;3852;1035;3163;168;569;508;1489;676;2058
510610;201403;2773;8323;2500;7954;288;1052;1936;6129;2224;7181
510615;201403;2105;6953;1878;6565;643;2421;775;2684;1418;5105
510617;201403;551;1711;485;1611;80;295;342;1150;422;1445
510618;201403;1333;4006;986;3304;248;949;433;1430;681;2379
510619;201403;784;2193;520;1707;102;372;146;477;248;849
510620;201403;1214;3312;819;2720;294;1104;169;518;463;1622
510621;201403;1053;3724;935;3467;274;1118;316;1112;590;2230
510622;201403;3618;11196;2462;8591;581;2293;391;1144;972;3437
510623;201403;3716;10817;3122;9832;1044;3481;1179;3681;2223;7162
510624;201403;1238;3872;979;3386;222;881;409;1323;631;2204
510625;201403;2313;6886;1884;6117;543;1991;480;1464;1023;3455
510626;201403;1272;4054;1041;3688;343;1338;473;1678;816;3016
510627;201403;709;2153;562;1886;201;743;162;543;363;1286
510628;201403;1568;4071;1208;3583;176;591;821;2440;997;3031
510629;201403;1841;6128;1590;5586;536;2088;401;1320;937;3408
510630;201403;2617;8852;2213;8136;708;2944;544;2031;1252;4975
510631;201403;403;1189;362;1125;79;249;226;701;305;950
510637;201403;2691;8222;2429;7753;735;2586;1108;3438;1843;6024
510642;201403;4763;15701;4096;14806;1351;5170;1841;6976;3192;12146
510645;201403;734;1861;589;1681;220;646;186;584;406;1230
510650;201403;6022;20560;5596;20036;1375;5209;3350;12556;4725;17765
510665;201403;1239;3431;871;2809;222;799;310;959;532;1758
510670;201403;349;865;212;662;42;157;87;254;129;411
510675;201403;6265;20863;5407;19204;1817;7090;1377;4745;3194;11835
510677;201403;2553;6567;1914;5733;281;881;1328;4138;1609;5019
510680;201403;805;2533;691;2337;149;553;294;935;443;1488
510682;201403;2414;7633;1951;6785;507;1926;704;2490;1211;4416
510685;201403;964;2639;825;2466;103;363;590;1750;693;2113
510700;201403;4106;11243;3031;9592;661;2276;1664;5305;2325;7581
510704;201403;8120;23280;6792;21014;1778;6194;3213;9616;4991;15810
510706;201403;1729;5436;1372;4862;425;1584;600;2128;1025;3712
510710;201403;3641;10428;2862;8868;817;2848;906;2505;1723;5353
510715;201403;706;1854;487;1498;117;397;176;504;293;901
510718;201403;1727;5242;1525;4975;511;1725;735;2467;1246;4192
510719;201403;449;1034;275;808;33;135;124;334;157;469
510720;201403;1278;3046;952;2662;87;264;734;2082;821;2346
510724;201403;824;2564;696;2317;165;597;356;1141;521;1738
510726;201403;660;1807;546;1618;156;475;181;509;337;984
510729;201403;697;1907;556;1695;158;519;221;683;379;1202
510730;201403;2321;7350;2077;6916;530;2020;1061;3361;1591;5381
510735;201403;1052;3658;895;3396;322;1309;359;1359;681;2668
510740;201403;1002;2590;819;2333;188;526;472;1390;660;1916
510757;201403;680;2386;621;2268;181;700;286;1042;467;1742
510760;201403;28381;80980;22682;71235;8019;27111;7195;22612;15214;49723
510770;201403;4478;12095;4053;11606;639;1832;2553;8245;3192;10077
510774;201403;389;1132;323;1026;75;280;158;466;233;746
510775;201403;853;2426;681;2154;237;862;236;741;473;1603
510776;201403;443;1263;369;1133;84;291;173;517;257;808
510777;201403;1456;4537;1160;4166;273;1114;699;2479;972;3593
510779;201403;639;1923;487;1642;83;304;184;642;267;946
510780;201403;3921;11709;3389;10964;791;2757;1827;6100;2618;8857
510785;201403;1908;5765;1576;5210;540;1896;542;1834;1082;3730
510787;201403;2178;6779;1899;6322;620;2249;684;2212;1304;4461
510788;201403;359;1118;330;1079;169;563;87;279;256;842
510790;201403;15141;44886;10602;36287;2939;11634;1359;4473;4298;16107
510792;201403;6087;19991;4569;16845;1123;4784;824;2789;1947;7573
510794;201403;1363;4262;1085;3826;488;1818;206;653;694;2471
510795;201403;9351;30322;7357;26295;2346;9115;1759;6312;4105;15427
510800;201403;1818;5272;1537;4906;440;1550;700;2126;1140;3676
510805;201403;1875;5335;1558;4882;246;846;1088;3411;1334;4257
510810;201403;691;1705;547;1511;161;472;264;718;425;1190
510820;201403;835;2103;648;1826;158;530;243;605;401;1135
510830;201403;567;1989;510;1891;172;684;238;934;410;1618
510835;201403;702;2198;551;1913;195;747;197;620;392;1367
510840;201403;50722;129227;41259;117357;10532;31956;20921;61627;31453;93583
510850;201403;1678;4995;1370;4523;595;2216;210;545;805;2761
510860;201403;2456;8354;2025;7405;706;2815;330;1140;1036;3955
510880;201403;826;2808;725;2628;249;947;268;979;517;1926
510885;201403;579;1658;442;1457;92;349;197;648;289;997
510890;201403;893;3044;776;2828;257;1061;196;619;453;1680
510895;201403;1136;3696;1017;3479;301;1151;399;1285;700;2436
520005;201403;1258;4142;1175;4015;373;1345;533;1852;906;3197
520010;201403;1882;6560;1670;6108;722;2964;279;876;1001;3840
520013;201403;3978;11235;3055;9603;757;2535;1330;4226;2087;6761
520015;201403;581;1622;473;1460;137;437;175;556;312;993
520017;201403;1237;3873;1077;3614;309;1118;431;1409;740;2527
520020;201403;422;1141;328;991;91;290;160;507;251;797
520025;201403;23184;75789;22581;75052;3410;11946;17532;58542;20942;70488
520030;201403;4642;15189;4115;14333;1346;5052;1553;5502;2899;10554
520050;201403;340;1033;314;979;65;229;203;609;268;838
520055;201403;663;2030;570;1870;149;485;284;964;433;1449
520060;201403;1663;5264;1477;4905;336;1263;575;1958;911;3221
520080;201403;1662;5237;1462;4934;393;1357;731;2561;1124;3918
520082;201403;668;2182;621;2101;157;515;349;1241;506;1756
520085;201403;1034;3279;905;2983;209;756;332;1093;541;1849
520090;201403;923;2288;752;2059;144;377;410;1207;554;1584
520110;201403;40167;122335;31913;109920;12829;48778;7646;26719;20475;75497
520120;201403;262;693;156;504;39;155;35;111;74;266
520130;201403;3719;11071;3442;10653;714;2389;2075;6437;2789;8826
520140;201403;43278;145656;39073;137404;14025;53520;10409;36192;24434;89712
520145;201403;542;1405;401;1204;99;328;155;444;254;772
520150;201403;681;1833;564;1698;157;516;268;795;425;1311
520160;201403;884;2635;756;2438;259;890;263;858;522;1748
520170;201403;4028;9922;3265;9101;573;1730;2290;6523;2863;8253
520180;201403;1877;5760;1594;5289;454;1662;603;1954;1057;3616
520215;201403;1758;4637;1531;4314;268;809;930;2638;1198;3447
520235;201403;832;2269;652;2009;199;673;265;787;464;1460
520250;201403;1108;3765;1038;3650;350;1305;487;1751;837;3056
520260;201403;770;2043;564;1658;98;330;263;740;361;1070
520280;201403;577;1693;529;1622;251;844;117;394;368;1238
520310;201403;1018;2609;812;2339;209;630;413;1284;622;1914
520320;201403;1563;5079;1314;4589;194;724;784;2811;978;3535
520330;201403;2855;8988;2213;7834;665;2553;424;1407;1089;3960
520340;201403;1921;4954;1542;4506;238;653;1159;3509;1397;4162
520350;201403;3122;9441;2700;8611;960;3284;1091;3380;2051;6664
520355;201403;1125;3976;1092;3901;451;1691;409;1445;860;3136
520357;201403;894;2458;764;2269;68;229;527;1547;595;1776
520360;201403;606;1702;540;1595;144;440;240;708;384;1148
520380;201403;1178;3250;877;2721;174;600;431;1356;605;1956
520390;201403;1203;3224;851;2741;274;1016;319;936;593;1952
520393;201403;572;1521;514;1426;93;273;327;915;420;1188
520396;201403;703;2299;655;2218;104;399;437;1497;541;1896
520400;201403;1722;4959;1473;4620;288;988;900;2841;1188;3829
520410;201403;1521;4158;1217;3734;356;1205;558;1683;914;2888
520420;201403;344;962;262;815;50;184;109;310;159;494
520425;201403;1432;4040;1343;3882;435;1348;621;1765;1056;3113
520430;201403;1981;5337;1461;4440;315;1091;590;1724;905;2815
520440;201403;3261;8886;2475;7617;885;3005;610;1861;1495;4866
520450;201403;9589;28136;7464;24080;2050;7391;1314;3889;3364;11280
520455;201403;692;2089;571;1886;221;788;153;511;374;1299
520460;201403;863;2527;706;2261;184;660;282;866;466;1526
520465;201403;814;2257;715;2126;169;627;326;882;495;1509
520470;201403;1751;5756;1603;5537;395;1385;971;3503;1366;4888
520480;201403;992;2933;843;2698;194;656;474;1543;668;2199
520485;201403;1196;4111;1110;3952;428;1623;477;1709;905;3332
520490;201403;4370;13691;3524;12395;1484;5642;1127;3975;2611;9617
520495;201403;1398;3826;1154;3528;90;271;970;3031;1060;3302
520500;201403;2052;5531;1836;5238;632;1935;734;2247;1366;4182
520505;201403;899;2587;779;2408;208;675;440;1382;648;2057
520510;201403;11366;32217;7756;26132;2368;8848;1810;6082;4178;14930
520520;201403;1046;3071;884;2850;333;1148;334;1093;667;2241
520530;201403;2385;7444;2049;6897;480;1643;987;3686;1467;5329
520540;201403;3016;9287;2622;8610;858;2981;1000;3277;1858;6258
520545;201403;1315;4104;1135;3743;334;1169;317;1001;651;2170
520547;201403;817;2600;677;2360;242;936;183;585;425;1521
520549;201403;8731;27053;7635;25690;2357;8410;3611;12277;5968;20687
520551;201403;3778;11575;3619;11383;1150;3821;1937;6301;3087;10122
520552;201403;703;2332;682;2303;121;446;447;1499;568;1945
520570;201403;575;1699;436;1467;190;682;79;260;269;942
520580;201403;1993;5882;1667;5401;510;1855;556;1715;1066;3570
520590;201403;1535;4360;1278;3938;343;1110;461;1351;804;2461
520620;201403;7210;23510;6604;22603;1539;5702;3836;13233;5375;18935
520630;201403;643;1848;556;1743;165;513;285;911;450;1424
520640;201403;2739;8061;2402;7528;808;2684;947;3124;1755;5808
520650;201403;827;2392;714;2182;275;888;263;797;538;1685
520660;201403;397;1215;337;1119;105;381;97;323;202;704
520670;201403;810;2465;782;2421;71;183;679;2147;750;2330
520680;201403;610;1832;524;1713;179;640;194;630;373;1270
520690;201403;317;844;230;727;30;96;117;390;147;486
520710;201403;486;1241;327;936;14;42;199;560;213;602
520725;201403;1801;4781;1407;4201;326;1117;729;2122;1055;3239
520735;201403;684;2066;556;1840;188;675;156;493;344;1168
520740;201403;1696;4973;1434;4611;394;1345;675;2166;1069;3511
520750;201403;754;1986;570;1735;153;517;299;925;452;1442
520753;201403;1245;3622;1182;3530;187;525;844;2648;1031;3173
520760;201403;1129;3185;1000;3020;327;1073;529;1583;856;2656
520780;201403;2069;5145;1743;4706;219;566;1312;3647;1531;4213
520790;201403;2532;7216;2261;6839;386;1265;1554;4756;1940;6021
520800;201403;17493;52164;15638;49958;3698;11649;9165;31676;12863;43325
520810;201403;960;2678;861;2554;150;462;618;1907;768;2369
520815;201403;438;1505;350;1329;164;703;35;120;199;823
520830;201403;1700;4367;1331;3979;61;164;1202;3679;1263;3843
520840;201403;1652;5650;1502;5354;524;1979;507;1853;1031;3832
520850;201403;782;2340;617;2096;185;650;240;808;425;1458
520860;201403;7064;20288;5301;17888;1511;5520;2401;8333;3912;13853
520870;201403;123816;351656;90590;292366;29390;103544;25032;79552;54422;183096
520880;201403;7086;20601;5179;17576;1495;5740;725;2274;2220;8014
520890;201403;3754;11147;3321;10468;790;2664;1690;5330;2480;7994
520910;201403;3370;10490;2707;9116;830;3102;624;2018;1454;5120
520915;201403;926;2676;701;2240;170;570;266;814;436;1384
520920;201403;3229;8838;2311;7342;612;2100;651;2125;1263;4225
520929;201403;445;1309;398;1254;124;408;195;610;319;1018
520940;201403;966;2998;872;2848;126;476;615;1969;741;2445
520945;201403;662;1669;569;1525;202;534;224;606;426;1140
520960;201403;891;2646;738;2406;127;450;407;1330;534;1780
520970;201403;3386;10020;2793;8963;643;2323;1069;3344;1712;5667
520980;201403;1009;2770;932;2669;252;809;570;1592;822;2401
520990;201403;3664;11544;3359;10984;688;2491;1740;6255;2428;8746
520993;201403;1154;3238;950;2879;140;462;565;1698;705;2160
520995;201403;2605;7237;2346;6888;377;1156;1647;4856;2024;6012
521000;201403;7831;23850;6740;22046;1600;5842;3267;10617;4867;16459
521010;201403;3890;12225;3364;11233;874;3168;1349;4529;2223;7697
521015;201403;678;1941;581;1786;138;436;294;920;432;1356
521020;201403;4435;13217;3497;11253;1169;4060;675;1937;1844;5997
521030;201403;810;2190;713;2055;153;462;451;1318;604;1780
521040;201403;5451;16244;5007;15550;2005;6330;2225;7266;4230;13596
521056;201403;983;3046;836;2800;297;1046;324;1127;621;2173
521060;201403;1122;3197;989;2990;239;726;414;1258;653;1984
521080;201403;1208;3058;793;2363;159;562;262;644;421;1206
521090;201403;3217;9504;2746;8862;999;3466;905;2990;1904;6456
521100;201403;1422;3735;1310;3608;272;724;875;2509;1147;3233
521120;201403;4757;13910;4359;13279;1136;3468;2238;7016;3374;10484
521130;201403;1112;3193;909;2828;216;775;449;1392;665;2167
521140;201403;909;3065;830;2888;292;1085;192;645;484;1730
521150;201403;13144;34859;8911;26685;2724;9112;3027;8888;5751;18000
521160;201403;739;1926;497;1430;91;291;268;726;359;1017
521170;201403;1335;3260;1125;2982;363;946;578;1540;941;2486
521180;201403;6457;22030;5923;20953;2086;7952;1632;5728;3718;13680
521190;201403;8602;25973;6549;22410;2242;8136;1961;6780;4203;14916
521200;201403;846;2270;792;2200;117;353;556;1535;673;1888
521205;201403;553;1706;461;1535;73;257;252;862;325;1119
521210;201403;896;2624;653;2140;239;911;219;622;458;1533
521220;201403;3788;10900;3196;10077;1102;3755;1188;3681;2290;7436
521225;201403;386;1007;310;911;52;158;200;610;252;768
521230;201403;1338;4258;1236;4048;485;1687;508;1600;993;3287
521250;201403;25721;86992;24516;85116;9748;36514;9602;33652;19350;70166
521260;201403;818;2034;654;1747;115;392;368;913;483;1305
521270;201403;1785;5705;1644;5480;167;484;1257;4421;1424;4905
521280;201403;1817;5700;1573;5260;504;1827;575;1900;1079;3727
521290;201403;541;1580;402;1350;123;492;143;449;266;941
521295;201403;1117;3138;1034;3026;151;462;799;2350;950;2812
521300;201403;1834;5390;1702;5181;422;1315;938;2963;1360;4278
521305;201403;844;2259;712;2080;185;544;406;1227;591;1771
521308;201403;5046;15180;4065;13519;858;3171;2137;6996;2995;10167
521310;201403;7301;22674;5952;20086;2078;7429;1393;4521;3471;11950
521340;201403;259;817;232;772;61;231;108;340;169;571
521350;201403;2186;5683;1806;5172;250;773;1161;3527;1411;4300
521370;201403;1021;3301;931;3133;346;1246;277;875;623;2121
521375;201403;1370;4019;1188;3711;315;1094;575;1728;890;2822
521377;201403;1008;2950;963;2896;85;237;823;2531;908;2768
521380;201403;3985;11741;3102;10161;812;2822;759;2501;1571;5323
521385;201403;604;1716;540;1631;172;550;234;703;406;1253
521390;201403;1106;2927;825;2537;245;857;260;784;505;1641
521400;201403;2374;6485;2038;6093;332;1106;1470;4354;1802;5460
521405;201403;1326;3904;1124;3528;402;1394;391;1207;793;2601
521410;201403;747;2431;683;2320;305;1021;246;884;551;1905
521440;201403;1485;4153;1471;4138;145;371;1255;3630;1400;4001
521450;201403;4998;15337;4223;13923;1346;4745;1033;3279;2379;8024
521460;201403;7037;22210;6507;21397;1944;6978;3086;10075;5030;17053
521470;201403;707;2011;530;1670;141;491;74;210;215;701
521480;201403;514;1512;380;1268;115;382;104;347;219;729
521483;201403;3046;8213;2552;7371;715;2208;1013;2856;1728;5064
521486;201403;1628;4579;1477;4295;361;1161;909;2556;1270;3717
521487;201403;554;1565;445;1388;111;347;200;643;311;990
521490;201403;835;2441;673;2213;107;406;455;1507;562;1913
521500;201403;1254;4162;1138;3929;220;844;632;2057;852;2901
521520;201403;910;2168;814;2048;228;528;364;1038;592;1566
521523;201403;11320;42616;10678;41486;3528;15114;2709;10902;6237;26016
521525;201403;1121;2927;990;2754;134;422;666;1802;800;2224
521530;201403;2039;6116;1430;4893;536;1932;236;753;772;2685
521540;201403;972;2700;688;2186;184;685;205;586;389;1271
521550;201403;983;2513;884;2368;260;754;458;1190;718;1944
521560;201403;4938;15209;3978;13930;1634;6251;1061;3589;2695;9840
521565;201403;695;1837;596;1713;110;313;398;1171;508;1484
521570;201403;4675;13255;3387;10670;1116;3751;990;3118;2106;6869
521580;201403;672;1658;493;1412;176;552;139;386;315;938
521590;201403;749;2126;620;1911;228;760;113;367;341;1127
521600;201403;625;1651;454;1353;115;365;149;399;264;764
521630;201403;1793;4901;1510;4466;534;1836;259;604;793;2440
521640;201403;1849;5302;1592;4905;500;1793;462;1451;962;3244
521645;201403;659;2017;552;1764;123;433;233;679;356;1112
521680;201403;1466;4707;1258;4261;680;2447;195;616;875;3063
521690;201403;592;1774;534;1665;126;471;249;714;375;1185
521710;201403;2247;7110;1993;6605;430;1521;1109;3663;1539;5184
521720;201403;2034;6097;1867;5865;492;1607;1069;3460;1561;5067
521730;201403;3853;13006;3575;12455;1567;5993;901;2853;2468;8846
521740;201403;3552;9864;2860;8984;1317;4324;979;3220;2296;7544
521760;201403;12389;42683;11616;41449;2169;8613;7490;26958;9659;35571
521770;201403;2759;8482;2359;7674;1040;3624;519;1565;1559;5189
521800;201403;8713;26088;7543;24347;2751;9412;3190;10676;5941;20088
521805;201403;977;2262;776;1955;224;527;393;1106;617;1633
521810;201403;818;2415;722;2255;175;594;360;1106;535;1700
521830;201403;5444;18494;5139;18024;1084;4152;3302;11546;4386;15698
521839;201403;653;1969;539;1737;131;469;204;608;335;1077
521850;201403;6781;19461;5873;17889;1422;4368;2891;8876;4313;13244
521860;201403;1735;5326;1516;4890;424;1496;523;1617;947;3113
521870;201403;556;1959;516;1856;156;607;140;469;296;1076
521878;201403;574;1896;480;1667;139;542;180;585;319;1127
521880;201403;25520;68141;17617;55176;5963;20156;4908;15527;10871;35683
521890;201403;3643;11472;3103;10386;1183;4262;715;2354;1898;6616
521900;201403;1668;4498;1372;4092;357;1171;529;1475;886;2646
521910;201403;1213;3401;1062;3226;273;929;576;1790;849;2719
521920;201403;402;1215;360;1148;139;472;128;393;267;865
521925;201403;639;2002;574;1874;136;495;235;712;371;1207
521930;201403;3954;12850;3588;12138;1314;4707;1027;3497;2341;8204
521935;201403;664;2007;630;1942;197;637;322;969;519;1606
521940;201403;1126;3068;921;2719;329;1031;298;885;627;1916
521945;201403;674;2336;629;2276;139;459;426;1661;565;2120
521950;201403;540;1669;460;1530;145;517;177;595;322;1112
521960;201403;937;2771;799;2538;195;665;357;1107;552;1772
521970;201403;2478;7182;2269;6909;352;1080;1612;5056;1964;6136
521971;201403;1000;2754;789;2392;187;640;303;888;490;1528
521973;201403;885;2971;799;2799;226;853;252;855;478;1708
521975;201403;13414;38767;12651;37794;2535;8281;7901;23759;10436;32040
521980;201403;1782;5645;1709;5565;281;904;1306;4410;1587;5314
521990;201403;1059;3338;977;3200;172;623;603;1950;775;2573
522000;201403;2088;6205;1842;5884;390;1348;1067;3530;1457;4878
522005;201403;378;993;289;853;76;236;132;387;208;623
522010;201403;3013;9058;2574;8330;916;3215;701;2186;1617;5401
522015;201403;1013;2992;850;2748;239;852;384;1238;623;2090
522020;201403;4524;12699;4032;12080;972;3185;2384;7034;3356;10219
522026;201403;652;1869;466;1674;207;804;133;494;340;1298
522028;201403;536;1611;484;1531;127;437;280;866;407;1303
522040;201403;3065;7966;2288;6974;811;2640;893;2742;1704;5382
522045;201403;12724;42264;10933;38566;3686;14297;2287;7810;5973;22107
522050;201403;1022;3028;836;2718;274;992;321;983;595;1975
522060;201403;3011;9500;2544;8791;810;3012;1209;4127;2019;7139
522068;201403;1543;5062;1448;4958;154;469;1177;4253;1331;4722
522070;201403;838;2549;755;2419;117;455;488;1544;605;1999
522100;201403;806;2264;720;2133;276;928;304;820;580;1748
522108;201403;937;2791;831;2632;89;291;602;1970;691;2261
522119;201403;1287;3985;1083;3717;139;475;766;2759;905;3234
522130;201403;508;1461;439;1385;137;464;217;697;354;1161
522140;201403;17687;50697;15564;47554;4917;16339;6140;18344;11057;34683
522145;201403;949;2680;883;2575;445;1379;232;661;677;2040
522150;201403;1265;3359;1056;3071;384;1200;374;1135;758;2335
522155;201403;765;2276;689;2164;158;516;395;1305;553;1821
522157;201403;686;2027;605;1894;68;245;466;1454;534;1699
522160;201403;6089;17491;4448;14668;1719;6306;694;2157;2413;8463
522170;201403;3171;8894;2677;8192;806;2526;1058;3395;1864;5921
522180;201403;459;1326;346;1152;150;556;111;364;261;920
522185;201403;14511;45660;13381;44125;3009;10717;7891;26287;10900;37004
522190;201403;840;2311;729;2118;127;376;421;1248;548;1624
522200;201403;1561;5304;1451;5073;498;1895;423;1413;921;3308
522205;201403;1319;3854;1101;3486;321;1069;475;1516;796;2585
522220;201403;1377;3881;1121;3557;265;930;544;1871;809;2801
522230;201403;1116;3456;1023;3309;184;677;659;2127;843;2804
530010;201403;254008;831633;229711;783459;70556;266351;75339;254726;145895;521077
110001;201402;4448;14680;3869;13752;1105;4087;2041;7362;3146;11449
110002;201402;13123;42668;11588;39976;3832;14279;4790;16599;8622;30878
110003;201402;978;3214;919;3120;272;986;381;1259;653;2245
110004;201402;9547;31594;8275;28949;2673;10197;2531;8868;5204;19065
110005;201402;2369;8026;2255;7808;878;3139;885;3094;1763;6233
110006;201402;3424;9269;2177;7551;728;2695;606;1963;1334;4658
110007;201402;1509;4842;1403;4692;332;1185;776;2760;1108;3945
110008;201402;2588;8935;2432;8707;578;1993;1614;6089;2192;8082
110009;201402;5348;15609;4220;13969;1150;4120;1898;6169;3048;10289
110010;201402;8442;24416;7476;23219;1578;4547;4663;15760;6241;20307
110011;201402;10813;33537;8990;30410;3394;12214;3093;10463;6487;22677
110012;201402;17003;52825;14764;48552;5095;17848;5212;17014;10307;34862
110013;201402;5235;16764;4388;15539;1410;5290;1921;6918;3331;12208
110014;201402;4292;12926;3667;12046;858;2964;2142;7139;3000;10103
110015;201402;5189;16868;4254;15180;1650;6286;1362;4898;3012;11184
110018;201402;5167;15365;4257;14186;1351;5032;1889;6064;3240;11096
110020;201402;56327;166993;47656;156244;11099;37693;27739;93964;38838;131657
110025;201402;4486;13281;3792;12044;643;2177;2635;8359;3278;10536
110026;201402;828;2420;700;2268;156;515;454;1518;610;2033
110028;201402;7508;22495;5749;19587;1764;6596;1539;5130;3303;11726
110029;201402;1707;5074;1380;4511;476;1610;554;1865;1030;3475
110030;201402;11281;32903;9336;30424;2558;8975;4826;16300;7384;25275
110032;201402;4147;13657;3728;12729;1090;3861;1534;5308;2624;9169
110033;201402;5509;17872;5155;17327;1743;5949;2298;8290;4041;14239
110034;201402;3885;10261;3264;9519;533;1522;2465;7303;2998;8825
110037;201402;2066;7076;1821;6619;507;1869;957;3544;1464;5413
110040;201402;3539;11666;3306;11251;1096;4026;1470;4955;2566;8981
110045;201402;5202;18042;4806;17569;1454;5671;2707;9881;4161;15552
110050;201402;1835;5920;1539;5533;548;2028;770;2823;1318;4851
110060;201402;994;3489;886;3295;264;1043;445;1652;709;2695
110070;201402;1946;6704;1895;6584;329;1199;1335;4658;1664;5857
110080;201402;3429;11111;3298;10946;728;2276;2392;8224;3120;10500
110090;201402;948;2813;758;2506;240;896;300;906;540;1802
110092;201402;1722;5598;1572;5406;372;1305;881;3209;1253;4514
110094;201402;3196;10221;2937;9849;747;2673;1702;5844;2449;8517
110100;201402;2659;8542;2315;7974;718;2589;1125;3897;1843;6486
110110;201402;1786;5816;1674;5686;759;2615;703;2507;1462;5122
110120;201402;1622;5514;1377;4915;383;1421;507;1822;890;3243
110130;201402;2797;8069;2138;7114;581;2039;1013;3411;1594;5450
110140;201402;2512;8706;2368;8483;528;1913;1524;5589;2052;7502
110143;201402;1579;5174;1248;4595;314;1184;674;2473;988;3657
110145;201402;1003;3087;890;2908;176;624;555;1820;731;2444
110146;201402;457;1477;417;1416;107;382;226;777;333;1159
110147;201402;901;2719;713;2409;201;739;249;760;450;1499
110148;201402;1341;4058;1080;3531;352;1276;352;1081;704;2357
110149;201402;3740;11068;2968;9879;734;2603;1776;5993;2510;8596
110150;201402;2875;8542;2385;7817;392;1404;1520;5011;1912;6415
110155;201402;941;3160;893;3051;298;1093;431;1436;729;2529
110160;201402;2209;6997;1833;6333;617;2194;826;2883;1443;5077
110170;201402;3220;9387;2521;8193;564;1958;1513;4967;2077;6925
110175;201402;1642;5301;1277;4831;124;502;943;3628;1067;4130
110180;201402;1698;5348;1459;4954;347;1212;865;2984;1212;4196
120001;201402;2880;10366;2792;10214;734;2883;1525;5683;2259;8566
120005;201402;1551;6224;1510;6148;179;700;1161;4922;1340;5622
120010;201402;4472;15960;4297;15655;980;3405;2760;10534;3740;13939
120013;201402;1855;7271;1815;7204;416;1669;1138;4738;1554;6407
120017;201402;2108;7581;1993;7366;561;2180;928;3744;1489;5924
120020;201402;14230;62765;14015;62272;2589;10948;9982;46501;12571;57449
120025;201402;2718;9489;2645;9374;648;2444;1533;5498;2181;7942
120030;201402;6028;24244;5973;24167;530;2033;5051;20912;5581;22945
120032;201402;1372;6659;1328;6553;193;1122;957;4737;1150;5859
120033;201402;3624;13882;3595;13828;229;917;3168;12349;3397;13266
120034;201402;1803;7279;1782;7246;84;382;1648;6718;1732;7100
120035;201402;2727;13255;2695;13175;274;1289;2214;11199;2488;12488
120038;201402;3195;11776;3086;11544;892;3442;1597;6165;2489;9607
120039;201402;1440;7913;1417;7862;185;1094;1115;6274;1300;7368
120040;201402;44881;163732;41613;156956;12693;50504;19314;74826;32007;125330
120042;201402;2762;12115;2661;11866;430;1992;1857;8491;2287;10483
120043;201402;839;4036;815;3980;69;339;683;3406;752;3745
120045;201402;4446;15563;4395;15482;1114;3924;2890;10499;4004;14423
120050;201402;8171;33877;7923;33357;1499;6087;5212;23336;6711;29423
120060;201402;6701;31632;6601;31447;808;3890;5263;25800;6071;29690
120070;201402;2793;10645;2743;10519;594;2190;1743;7025;2337;9215
120080;201402;3712;14091;3562;13841;634;2504;2521;10135;3155;12639
130002;201402;2834;12102;2682;11846;285;1292;2113;9506;2398;10798
130006;201402;1700;7379;1536;7073;200;1020;1101;5139;1301;6159
130008;201402;1989;8186;1910;8040;178;803;1521;6543;1699;7346
130010;201402;2724;9171;2371;8759;246;827;1955;7440;2201;8267
130014;201402;3443;11201;2993;10537;484;1841;1950;6960;2434;8801
130020;201402;2462;8717;2451;8704;47;178;2379;8455;2426;8633
130030;201402;6883;27312;6690;27055;578;1986;5753;24004;6331;25990
130040;201402;3500;11112;3307;10849;324;1169;2803;9194;3127;10363
130050;201402;5849;23641;5197;22611;759;3134;3604;16854;4363;19988
130060;201402;5902;25840;5565;25361;623;2775;4469;20886;5092;23661
130063;201402;3211;14370;3191;14329;370;1586;2655;12226;3025;13812
130068;201402;2995;12702;2790;12308;350;1707;1991;8846;2341;10553
130070;201402;6525;22148;5979;21436;739;2582;4641;17133;5380;19715
130080;201402;5059;22570;4900;22345;863;4055;3444;16212;4307;20267
130083;201402;1860;7650;1774;7519;320;1495;1201;5114;1521;6609
130090;201402;2422;8918;2311;8762;192;849;1962;7427;2154;8276
130100;201402;5389;20830;5192;20564;465;1999;4343;17395;4808;19394
130110;201402;6599;21484;6187;20989;805;2617;4886;17174;5691;19791
130115;201402;3675;13728;3516;13520;127;383;3302;12856;3429;13239
130120;201402;13129;51126;12843;50726;1247;4541;10798;44043;12045;48584
130130;201402;3325;14448;3236;14287;471;2059;2467;11201;2938;13260
130140;201402;5727;23179;5687;23127;147;453;5487;22561;5634;23014
130150;201402;3484;13054;3410;12959;222;1048;2981;11302;3203;12350
130160;201402;3892;16164;3819;16064;248;906;3467;14807;3715;15713
130165;201402;2729;11359;2692;11296;464;1981;2056;8746;2520;10727
130170;201402;8620;32240;7604;30937;1442;5999;5107;21753;6549;27752
130180;201402;3351;10719;3286;10630;118;348;3065;9983;3183;10331
130185;201402;8949;32166;8651;31775;1514;5327;6404;24510;7918;29837
130190;201402;16441;58409;14618;56125;3131;11742;9211;37630;12342;49372
130195;201402;1763;7421;1708;7338;100;456;1500;6533;1600;6989
130200;201402;1968;7206;1834;6981;352;1396;1202;4669;1554;6065
130210;201402;1136;4543;1081;4447;164;655;806;3451;970;4106
130220;201402;2018;8365;1863;8082;364;1765;1084;4760;1448;6525
130230;201402;3307;15128;3147;14862;409;2029;2328;11409;2737;13438
130240;201402;8182;32022;7580;31126;507;2360;6416;26780;6923;29140
130250;201402;17204;63456;16689;62723;2955;10605;12062;47521;15017;58126
130255;201402;3937;14398;3741;14067;171;538;3333;12894;3504;13432
130260;201402;247371;809255;225391;774837;64467;227902;113975;406881;178442;634783
130270;201402;7276;30509;6591;29438;1137;4934;4613;21702;5750;26636
130280;201402;3176;12542;3107;12443;142;465;2797;11508;2939;11973
130290;201402;10625;38533;10459;38294;236;663;9868;36746;10104;37409
130300;201402;4346;17049;4114;16720;354;1572;3358;13848;3712;15420
130310;201402;4836;18550;4428;18042;639;2515;3314;14014;3953;16529
130320;201402;2836;9881;2606;9571;380;1448;1851;6980;2231;8428
130330;201402;3487;13005;3136;12528;235;992;2629;10711;2864;11703
130340;201402;16867;66204;16364;65393;3237;12193;10833;46377;14070;58570
130350;201402;3194;13060;3067;12911;354;1423;2462;10706;2816;12129
130353;201402;5657;17990;5006;17095;1334;4564;2782;10169;4116;14733
130356;201402;4229;15476;4079;15254;493;1679;3240;12710;3733;14389
130360;201402;2771;8007;2499;7692;49;97;2344;7417;2393;7514
130370;201402;4881;19422;4194;18508;264;1430;3513;15614;3777;17044
130380;201402;6721;28477;6497;28131;451;2131;5549;24233;6000;26364
130390;201402;4403;19965;4141;19520;497;2385;3164;15413;3661;17798
130395;201402;2006;7437;1851;7160;294;1268;1197;4647;1491;5915
130400;201402;2143;7856;2078;7766;120;492;1850;6974;1970;7466
130406;201402;9490;36401;8497;34865;2119;8472;4800;21179;6919;29651
130410;201402;4076;15672;3767;15103;924;3822;2076;8698;3000;12520
130420;201402;9877;42436;9567;41827;2986;12828;5200;24100;8186;36928
130423;201402;3075;12089;2924;11889;236;1122;2489;10151;2725;11273
130426;201402;1998;8657;1924;8527;345;1529;1329;6165;1674;7694
130430;201402;3414;12407;3245;12172;400;1652;2346;8985;2746;10637
130440;201402;3747;13704;3465;13399;204;674;3078;12291;3282;12965
140002;201402;1430;4825;1353;4712;184;631;961;3506;1145;4137
140005;201402;2611;8085;2450;7911;128;373;2222;7285;2350;7658
140010;201402;44207;145260;40251;138781;9572;35268;22398;79119;31970;114387
140015;201402;2801;9360;2708;9234;261;606;2293;8229;2554;8835
140017;201402;2846;9086;2713;8919;212;628;2316;7809;2528;8437
140020;201402;4254;14639;3982;14275;479;1638;3079;11446;3558;13084
140023;201402;1922;6804;1752;6522;266;1056;1175;4493;1441;5549
140028;201402;2110;5963;2053;5896;106;233;1859;5492;1965;5725
140030;201402;3508;11411;3367;11232;410;1039;2804;9850;3214;10889
140040;201402;1473;7133;1425;6994;132;728;1055;5296;1187;6024
140045;201402;2364;8656;2226;8467;315;1033;1683;6869;1998;7902
140047;201402;5186;14721;4765;14149;1556;4831;1992;6349;3548;11180
140050;201402;1478;4597;1378;4462;182;619;1033;3405;1215;4024
140060;201402;1389;4441;1273;4277;325;1138;745;2599;1070;3737
140070;201402;1410;6972;1408;6967;58;235;1336;6689;1394;6924
150010;201402;32504;106085;31201;104363;2297;8145;26449;89659;28746;97804
150013;201402;1549;4880;1502;4828;144;504;1229;3956;1373;4460
150020;201402;10769;38072;10520;37710;1418;5083;8220;30172;9638;35255
150030;201402;6258;27521;6104;27266;687;2607;5015;23444;5702;26051
150034;201402;4362;11996;4140;11727;156;358;3899;11205;4055;11563
150040;201402;12227;42723;10810;40967;2453;8605;6938;28559;9391;37164
150050;201402;5966;23041;5837;22803;653;2761;4651;18346;5304;21107
150060;201402;14998;49919;14253;48821;3588;12091;8569;30701;12157;42792
150070;201402;5385;22935;4936;22416;530;2449;4061;18804;4591;21253
150080;201402;59505;164871;53330;157168;7821;21510;38642;117848;46463;139358
150085;201402;5034;18024;4823;17720;729;2331;3720;14400;4449;16731
150090;201402;9842;38481;9316;37758;1223;4729;7236;30267;8459;34996
150095;201402;5075;17761;4723;17218;530;1934;3714;13935;4244;15869
150100;201402;3442;13049;3236;12747;276;1306;2618;10241;2894;11547
150110;201402;3131;15068;3120;15040;180;735;2866;14040;3046;14775
150120;201402;5840;23265;5723;23046;1037;4047;4169;17209;5206;21256
150125;201402;788;2452;731;2366;169;575;435;1410;604;1985
150130;201402;19659;63564;18786;62299;1806;6011;15177;51180;16983;57191
150140;201402;145127;439072;140216;433013;18490;57171;111330;348996;129820;406167
150145;201402;4848;15408;4506;14977;693;2421;3264;11015;3957;13436
150150;201402;9365;31228;8834;30392;1936;6891;5572;19490;7508;26381
150157;201402;2860;9127;2608;8779;403;1401;1975;6716;2378;8117
150160;201402;2779;9524;2660;9353;707;2396;1570;5814;2277;8210
150170;201402;21764;81250;20713;79878;4340;16445;14225;56161;18565;72606
150172;201402;2971;10431;2699;10026;358;1367;2108;7980;2466;9347
150175;201402;2019;6379;1956;6305;150;447;1713;5653;1863;6100
150178;201402;10639;33664;9275;32070;545;1619;8293;29424;8838;31043
150180;201402;17425;71213;16922;70527;1654;7236;14055;59453;15709;66689
150190;201402;7124;23044;6765;22561;446;1065;5898;20534;6344;21599
150195;201402;4539;16188;4257;15708;478;1786;3364;12626;3842;14412
150200;201402;4949;16348;4814;16185;147;455;4495;15298;4642;15753
150210;201402;22132;85608;21821;85169;2334;8656;18280;72900;20614;81556
150215;201402;5847;19014;5357;18289;1344;4725;3017;10623;4361;15348
150220;201402;12455;40400;11453;38826;2847;9882;6151;21569;8998;31451
150230;201402;11022;38210;10034;36819;868;3865;8211;29946;9079;33811
150240;201402;33212;103130;30451;98486;9386;31700;13243;44277;22629;75977
150250;201402;3897;15886;3778;15707;713;2832;2669;11674;3382;14506
150260;201402;1953;8099;1876;7950;406;1831;1122;4874;1528;6705
150270;201402;9497;29215;7434;26652;1705;6512;4516;16547;6221;23059
150275;201402;5695;21128;5411;20660;882;3427;3873;15143;4755;18570
150276;201402;2087;6354;1950;6180;343;1136;1451;4627;1794;5763
150277;201402;4905;15757;4366;15113;550;1957;3396;12089;3946;14046
150280;201402;5754;25420;5615;25106;913;3996;4102;18900;5015;22896
150285;201402;2617;10670;2586;10604;280;1149;2120;8846;2400;9995
150290;201402;8587;27268;8377;27013;878;2548;6884;23055;7762;25603
150293;201402;8330;26423;7203;24698;2491;8867;3023;10955;5514;19822
150295;201402;5676;19543;5052;18746;1186;4527;3192;12219;4378;16746
150300;201402;1782;6354;1744;6306;125;428;1464;5465;1589;5893
150304;201402;4076;12880;3547;12163;522;1812;2545;9026;3067;10838
150307;201402;6479;22615;6056;22018;480;1688;5033;18860;5513;20548
150309;201402;6400;23113;5973;22526;1646;6216;3629;14328;5275;20544
150310;201402;4921;23144;4847;23031;566;2565;3927;19253;4493;21818
150320;201402;8484;22995;8145;22627;587;1512;7087;20142;7674;21654
150330;201402;12992;47921;12399;46972;1585;5998;9563;37217;11148;43215
150340;201402;2141;7384;2021;7208;388;1459;1335;4842;1723;6301
150345;201402;6337;22629;5945;22099;697;2612;4779;18187;5476;20799
150350;201402;7197;24393;6869;23924;1003;3427;5085;18123;6088;21550
150360;201402;20719;66548;18287;63470;2950;10493;12767;45881;15717;56374
150370;201402;9999;37898;9619;37385;1168;4183;7826;31575;8994;35758
150375;201402;2726;11681;2674;11612;211;711;2317;10541;2528;11252
150380;201402;9260;29124;8443;27994;902;3170;6911;23053;7813;26223
150390;201402;8061;34984;7713;34284;1865;7861;4633;21853;6498;29714
150400;201402;5317;22440;5174;22140;670;2804;3819;16914;4489;19718
150405;201402;8111;25658;7398;24764;1494;4581;5008;17857;6502;22438
150410;201402;1696;6597;1664;6540;328;1352;1047;4227;1375;5579
150420;201402;33902;122188;30723;117029;8115;32652;15912;63145;24027;95797
150430;201402;6432;24208;6238;23864;802;3321;4764;18408;5566;21729
150440;201402;5297;18731;5187;18568;830;2901;3834;14079;4664;16980
150442;201402;21129;62020;19455;59868;3389;10658;13150;41737;16539;52395
150445;201402;5013;18084;4648;17560;715;2542;3508;13699;4223;16241
150450;201402;4214;20263;4080;20085;428;2081;3376;17013;3804;19094
150460;201402;6774;24976;5673;23803;472;2114;4875;20918;5347;23032
150470;201402;16854;52501;16330;51842;1358;3592;14229;46517;15587;50109
150475;201402;628;2055;549;1949;181;598;278;1107;459;1705
150480;201402;13932;48133;13448;47426;1021;3367;11362;41201;12383;44568
150490;201402;6380;24979;6267;24828;348;1374;5665;22687;6013;24061
150495;201402;4637;17237;4543;17085;321;1223;4008;15174;4329;16397
150497;201402;3233;11397;2968;10951;878;3283;1626;6257;2504;9540
150500;201402;2888;8572;2783;8413;422;1238;2073;6352;2495;7590
150503;201402;3740;12001;3227;11348;1196;4413;1396;5142;2592;9555
150506;201402;12239;43879;11319;42595;2785;9537;7274;29520;10059;39057
150510;201402;9574;38139;9031;37209;1484;6168;6291;27065;7775;33233
150520;201402;6031;25132;5943;25005;479;1626;5266;22761;5745;24387
150530;201402;11328;41254;10415;39894;1462;5112;7682;30690;9144;35802
150540;201402;4574;14334;4190;13773;359;1223;3459;11409;3818;12632
150543;201402;4819;15615;4466;15114;1369;4695;2491;8669;3860;13364
150548;201402;8067;26556;7623;25989;602;1897;6612;23049;7214;24946
150549;201402;2186;7033;2087;6915;112;276;1884;6415;1996;6691
150550;201402;20708;67110;18650;63604;5664;20061;8454;29555;14118;49616
150553;201402;20734;76840;18656;71920;7445;30819;3409;12971;10854;43790
150555;201402;1666;5315;1472;5041;239;883;1026;3562;1265;4445
150560;201402;1981;6461;1914;6310;254;913;1413;4632;1667;5545
150563;201402;2820;9523;2650;9225;620;2312;1558;5424;2178;7736
150565;201402;3356;12210;3158;11920;258;1072;2550;9803;2808;10875
150570;201402;5163;20131;5085;19993;432;1637;4242;17166;4674;18803
150580;201402;9270;38453;9114;38253;831;3069;7838;34041;8669;37110
150590;201402;5375;21890;5241;21733;116;462;4987;20859;5103;21321
150600;201402;7464;29682;7313;29434;610;2256;6277;25982;6887;28238
150610;201402;2352;8245;2180;7883;257;1067;1518;5414;1775;6481
150611;201402;2590;9623;2483;9380;297;1184;1792;6849;2089;8033
150613;201402;11079;35176;9827;33426;3346;11712;4526;16253;7872;27965
150616;201402;3041;8936;2424;8165;556;1874;1480;5121;2036;6995
150618;201402;7333;26123;7062;25613;2318;8818;3391;12567;5709;21385
150619;201402;5127;18100;4845;17687;740;2861;3435;12729;4175;15590
150620;201402;5993;22181;5479;21518;832;3265;4103;16750;4935;20015
150630;201402;5252;16849;5056;16605;453;1481;4228;14147;4681;15628
150635;201402;4473;14867;4229;14406;820;2865;2595;9199;3415;12064
150640;201402;1401;4606;1388;4585;45;127;1305;4373;1350;4500
150650;201402;11846;37366;10878;35658;2973;10189;5478;18333;8451;28522
150655;201402;5277;17751;4873;17163;704;2597;3618;12907;4322;15504
150658;201402;4169;13661;3883;13247;387;1571;2967;10189;3354;11760
150660;201402;5593;18039;5142;17468;1418;4768;2937;10427;4355;15195
150670;201402;6063;18072;5318;17180;1759;5747;2769;9563;4528;15310
150680;201402;49720;198669;46952;193591;16515;68244;20801;92434;37316;160678
150690;201402;1776;5956;1665;5752;275;980;1080;3842;1355;4822
150700;201402;5748;18333;5420;17910;1152;3807;3583;12151;4735;15958
150710;201402;4145;13483;3769;12897;419;1240;3003;10643;3422;11883
150715;201402;4879;16224;4414;15557;640;2337;3334;11938;3974;14275
150720;201402;6386;26592;6078;26040;1036;4168;4292;19397;5328;23565
150730;201402;8970;31552;8474;30888;1149;4086;6809;25429;7958;29515
150740;201402;3617;11795;3335;11300;491;1764;2242;7753;2733;9517
150745;201402;5863;18727;5466;18198;991;3501;3856;12950;4847;16451
150746;201402;1379;4610;1322;4511;201;753;879;3046;1080;3799
150747;201402;4918;16487;4567;16028;451;1491;3637;13310;4088;14801
150750;201402;2646;9367;2592;9305;108;235;2445;8979;2553;9214
150760;201402;11245;37179;10744;36496;2783;9433;6313;22347;9096;31780
150770;201402;5530;21182;5360;20925;886;3232;3981;16524;4867;19756
150775;201402;1115;3613;1011;3414;201;822;607;1959;808;2781
150780;201402;2994;10236;2969;10209;91;222;2807;9819;2898;10041
150790;201402;4868;15917;4603;15590;352;999;3908;13765;4260;14764
150795;201402;14832;46819;13547;44948;2355;7546;9429;32589;11784;40135
150796;201402;2780;8691;2677;8559;433;1333;1996;6655;2429;7988
150797;201402;3705;12623;3556;12399;177;682;3136;11013;3313;11695
150800;201402;13937;47330;12791;45921;3191;10942;8083;30884;11274;41826
150803;201402;6733;24711;6444;24302;908;3561;4703;18240;5611;21801
150805;201402;2693;9560;2514;9303;377;1347;1821;6964;2198;8311
150808;201402;5780;20141;5030;18755;2172;8611;1107;4283;3279;12894
150810;201402;19141;61297;16300;57845;2702;9216;11416;42849;14118;52065
150812;201402;5267;16556;4877;16012;462;1919;3739;11946;4201;13865
150815;201402;8735;28269;7924;27271;1256;4138;5992;21390;7248;25528
150820;201402;10450;31260;9585;30315;637;1336;8530;28007;9167;29343
150830;201402;12287;48104;11748;47230;787;3319;9615;39976;10402;43295
150835;201402;1955;7308;1826;7013;535;2184;806;3100;1341;5284
150840;201402;7322;21549;5931;19666;1468;5453;3126;10125;4594;15578
160005;201402;688;2654;654;2587;119;547;390;1528;509;2075
160010;201402;1536;5284;1525;5272;159;418;1311;4722;1470;5140
160015;201402;1533;5840;1500;5781;255;933;1075;4372;1330;5305
160020;201402;2276;7684;2126;7481;311;1143;1513;5474;1824;6617
160021;201402;802;3537;782;3504;144;689;535;2470;679;3159
160023;201402;982;3871;966;3845;91;331;835;3391;926;3722
160025;201402;1240;3593;1207;3558;21;72;1165;3435;1186;3507
160027;201402;7958;25071;7508;24557;2571;8521;3804;13121;6375;21642
160030;201402;39301;147205;36627;141478;8782;33754;22490;89822;31272;123576
160040;201402;3907;15532;3837;15428;185;805;3489;14076;3674;14881
160050;201402;3402;12818;3086;12359;1101;4300;1480;6446;2581;10746
160053;201402;2457;9856;2405;9785;656;2707;1472;6176;2128;8883
160055;201402;760;2993;746;2975;143;629;525;2105;668;2734
160060;201402;17366;58881;16393;57792;4839;16189;9789;36796;14628;52985
160070;201402;1984;8520;1962;8478;214;905;1647;7260;1861;8165
160080;201402;2609;9839;2597;9817;122;407;2420;9276;2542;9683
170025;201402;563;1946;516;1871;184;696;224;848;408;1544
170030;201402;1198;3973;1095;3781;313;1148;472;1647;785;2795
170035;201402;1526;4661;1275;4187;447;1606;383;1276;830;2882
170040;201402;1783;6013;1591;5730;286;1201;1008;3618;1294;4819
170070;201402;2073;5711;1712;5260;496;1665;840;2612;1336;4277
170100;201402;2501;7042;2217;6550;347;1136;1598;4693;1945;5829
170105;201402;732;2428;626;2224;130;578;332;1136;462;1714
170110;201402;1200;3748;1056;3511;227;769;599;2016;826;2785
170130;201402;1407;4504;1250;4279;216;755;825;2943;1041;3698
170190;201402;1662;4856;1359;4411;625;2034;328;1212;953;3246
170200;201402;1458;4554;1151;4000;318;1227;366;1223;684;2450
170210;201402;28534;89393;24912;83111;9079;32797;7600;26083;16679;58880
170215;201402;1150;3705;1041;3539;137;494;781;2691;918;3185
170220;201402;6459;21634;5976;20875;940;3475;4007;14379;4947;17854
170230;201402;1499;5024;1314;4678;339;1386;608;2105;947;3491
170240;201402;2972;8505;2407;7766;343;1243;1613;5238;1956;6481
170255;201402;3635;11751;3103;10903;1062;3781;1239;4633;2301;8414
170270;201402;1058;2742;767;2348;121;398;490;1494;611;1892
170290;201402;2935;8986;2606;8589;203;599;2178;7497;2381;8096
170300;201402;2028;6506;1794;6115;297;1126;1174;4028;1471;5154
170305;201402;741;2331;619;2110;126;481;349;1184;475;1665
170307;201402;1074;3814;941;3577;250;976;417;1737;667;2713
170310;201402;1689;4672;1354;4141;364;1155;588;1900;952;3055
170320;201402;1000;2960;809;2634;223;750;371;1254;594;2004
170330;201402;840;2574;711;2415;131;462;463;1572;594;2034
170360;201402;454;1610;433;1575;102;394;188;671;290;1065
170370;201402;1371;4146;1162;3840;189;733;695;2287;884;3020
170380;201402;2125;6778;1747;6211;415;1684;905;3158;1320;4842
170382;201402;554;1863;489;1762;99;390;312;1115;411;1505
170384;201402;1526;6390;1452;6261;368;1647;876;3868;1244;5515
170386;201402;920;2779;782;2578;199;742;347;1158;546;1900
170388;201402;655;1985;569;1837;123;472;222;698;345;1170
170389;201402;920;3164;858;3072;100;437;641;2261;741;2698
170390;201402;1342;4010;1170;3793;183;642;847;2809;1030;3451
170410;201402;472;1570;447;1524;61;235;303;1038;364;1273
170460;201402;521;1445;395;1240;108;375;133;417;241;792
170510;201402;754;2627;648;2460;127;553;338;1283;465;1836
170550;201402;5520;17418;4602;15765;1771;6511;1236;4353;3007;10864
170555;201402;1370;4046;1121;3673;296;1064;572;1869;868;2933
170560;201402;980;3388;825;3210;168;688;539;2173;707;2861
170600;201402;1301;3789;1163;3621;80;274;960;3049;1040;3323
170610;201402;1634;4994;1298;4457;189;733;772;2682;961;3415
170625;201402;441;1388;355;1215;94;336;94;329;188;665
170650;201402;1259;4101;1121;3855;291;1098;529;1834;820;2932
170700;201402;3961;13292;3355;12304;838;3393;1570;5974;2408;9367
170710;201402;1741;5210;1438;4714;196;756;958;3127;1154;3883
170720;201402;1830;4949;1589;4576;294;856;1074;3154;1368;4010
170730;201402;1116;3239;927;2958;287;1029;405;1279;692;2308
170740;201402;2202;7906;1960;7483;316;1316;1309;5032;1625;6348
170755;201402;880;2785;751;2512;194;710;286;919;480;1629
170765;201402;1584;4323;1285;3840;335;1101;533;1630;868;2731
170770;201402;1814;6322;1701;6113;380;1405;984;3663;1364;5068
170820;201402;4163;13399;3773;12794;1111;4000;1541;5357;2652;9357
170825;201402;765;2361;593;2033;137;516;244;841;381;1357
170830;201402;1342;4034;1266;3920;43;90;1180;3706;1223;3796
170900;201402;2830;10093;2726;9901;348;1261;2017;7605;2365;8866
170930;201402;4229;13021;3490;11956;1359;4909;1125;3834;2484;8743
170950;201402;12728;37707;9948;33059;3897;14579;2207;6926;6104;21505
170980;201402;523;1583;421;1422;103;383;237;798;340;1181
171050;201402;1291;4652;1228;4535;56;253;1089;3980;1145;4233
171070;201402;1702;5456;1578;5295;337;1184;968;3350;1305;4534
171090;201402;945;2769;803;2547;135;449;539;1729;674;2178
171110;201402;655;1940;538;1763;169;603;275;873;444;1476
171150;201402;853;2565;647;2184;125;456;354;1208;479;1664
171180;201402;632;1999;494;1720;136;527;181;657;317;1184
171190;201402;1884;6854;1636;6350;392;1616;782;3164;1174;4780
171195;201402;871;3170;796;3036;107;450;507;1996;614;2446
171200;201402;694;2279;576;2062;149;617;265;901;414;1518
171215;201402;469;1420;367;1242;67;252;157;542;224;794
171240;201402;797;2745;752;2670;88;274;575;2142;663;2416
171245;201402;666;2213;565;1982;122;473;241;841;363;1314
171250;201402;1163;3374;1036;3221;65;207;879;2775;944;2982
171270;201402;420;1737;394;1682;106;431;185;864;291;1295
171280;201402;909;2855;807;2680;192;622;407;1497;599;2119
171320;201402;4072;12550;3515;11720;1144;4009;1605;5374;2749;9383
171330;201402;2815;8570;2494;8098;641;2254;1341;4380;1982;6634
171360;201402;1507;4928;1288;4599;308;1131;695;2559;1003;3690
171370;201402;743;2115;670;2001;149;521;355;1020;504;1541
171380;201402;1314;4466;1141;4124;355;1294;497;1858;852;3152
171395;201402;893;2788;750;2532;156;611;372;1240;528;1851
171420;201402;2276;7017;1852;6261;491;1806;781;2646;1272;4452
171430;201402;1040;3297;927;3133;206;717;558;1907;764;2624
171488;201402;2455;7619;2262;7343;582;1884;1200;4114;1782;5998
171500;201402;890;2767;793;2583;133;395;446;1507;579;1902
171510;201402;918;3316;836;3191;163;650;511;2042;674;2692
171515;201402;624;1812;492;1617;112;376;236;791;348;1167
171525;201402;601;2027;513;1864;107;430;274;982;381;1412
171550;201402;341;1159;294;1066;121;503;43;157;164;660
171570;201402;1246;3937;1109;3722;258;883;671;2319;929;3202
171575;201402;1961;5703;1567;4988;406;1326;673;2260;1079;3586
171610;201402;6153;21247;5649;20293;1916;7325;1900;6847;3816;14172
171620;201402;2308;7285;2105;6982;191;695;1700;5692;1891;6387
171630;201402;895;2992;749;2736;186;754;303;1095;489;1849
171650;201402;2420;7625;2023;6919;553;2038;836;2818;1389;4856
171660;201402;2619;7323;2106;6423;461;1505;1104;3420;1565;4925
171665;201402;1407;4310;1194;3961;216;798;731;2485;947;3283
171670;201402;2363;6433;1930;5857;461;1513;1061;3157;1522;4670
171700;201402;1121;3764;1019;3587;167;643;636;2262;803;2905
171720;201402;700;2226;618;2077;212;754;256;873;468;1627
171750;201402;1264;4190;1130;3930;397;1457;384;1359;781;2816
171780;201402;1191;3396;890;2967;157;591;500;1651;657;2242
171790;201402;1736;5612;1429;5176;290;1069;848;3225;1138;4294
171800;201402;710;2303;655;2224;97;370;442;1508;539;1878
171820;201402;9624;30102;8861;29158;2193;7814;4979;16611;7172;24425
171830;201402;1622;5961;1500;5700;378;1530;683;2617;1061;4147
171840;201402;787;2322;700;2202;61;210;541;1709;602;1919
171845;201402;815;2214;643;1927;92;325;370;1074;462;1399
171850;201402;1016;3689;911;3467;108;477;588;2239;696;2716
171855;201402;1246;3998;1134;3813;116;488;854;2804;970;3292
171865;201402;489;1587;415;1478;106;412;202;704;308;1116
171870;201402;661;2145;550;1945;125;464;247;918;372;1382
171875;201402;1382;4404;1168;4080;169;672;827;2872;996;3544
171880;201402;990;3553;973;3525;123;472;723;2705;846;3177
171884;201402;902;2610;668;2260;157;588;251;873;408;1461
171886;201402;1487;5093;1332;4767;452;1709;439;1620;891;3329
171888;201402;668;2086;574;1911;103;358;339;1170;442;1528
171889;201402;487;1611;463;1560;102;331;270;952;372;1283
171890;201402;1118;3750;1014;3598;139;593;675;2380;814;2973
171900;201402;440;1760;421;1715;106;425;221;930;327;1355
172000;201402;659;2141;564;2002;97;406;330;1145;427;1551
172010;201402;1173;4068;1117;3975;117;476;867;3098;984;3574
172015;201402;354;1348;309;1278;56;229;184;811;240;1040
172020;201402;2321;7746;2100;7424;307;1190;1485;5324;1792;6514
172025;201402;755;2222;611;1964;106;359;322;1041;428;1400
172030;201402;1088;3767;992;3592;158;674;636;2301;794;2975
172049;201402;1122;3218;1051;3120;144;419;779;2377;923;2796
172065;201402;1230;3654;1036;3408;130;488;816;2673;946;3161
172080;201402;2653;8165;2264;7505;292;1122;1504;4907;1796;6029
172085;201402;506;1400;393;1197;85;281;121;369;206;650
172090;201402;3482;10495;2723;9488;567;2121;1620;5807;2187;7928
172093;201402;583;1884;459;1661;190;777;170;595;360;1372
172097;201402;701;2080;586;1890;163;578;213;674;376;1252
172100;201402;26035;89741;23234;84046;8078;32019;6167;22218;14245;54237
172110;201402;1691;6194;1565;6011;147;541;1236;4914;1383;5455
172120;201402;5572;16745;4639;15564;492;1752;3494;11978;3986;13730
172125;201402;324;998;267;916;57;220;125;437;182;657
172130;201402;520;1515;459;1423;72;240;300;965;372;1205
172208;201402;2172;6786;2040;6569;442;1535;1111;3619;1553;5154
172210;201402;2284;6991;2148;6805;234;818;1708;5369;1942;6187
210005;201402;21572;70893;19458;67564;6222;22966;9226;32493;15448;55459
210010;201402;1622;5791;1464;5578;168;623;1107;4381;1275;5004
210015;201402;3501;10975;3230;10588;263;545;2716;9480;2979;10025
210020;201402;7214;18273;6782;17754;493;1421;5494;14607;5987;16028
210030;201402;5860;19725;5567;19327;454;1880;4631;16012;5085;17892
210040;201402;1953;5668;1781;5461;203;647;1350;4192;1553;4839
210043;201402;5938;18261;5556;17698;513;1620;4462;14587;4975;16207
210047;201402;6702;26418;6269;25657;916;4102;4250;17583;5166;21685
210050;201402;2486;8882;2000;8191;482;1957;1020;4451;1502;6408
210055;201402;1681;5798;1574;5652;214;728;1186;4366;1400;5094
210060;201402;7900;29340;7155;28170;799;3498;5272;21207;6071;24705
210070;201402;6844;20571;6479;20118;317;1079;5719;17879;6036;18958
210080;201402;3716;12915;3649;12819;85;332;3424;12083;3509;12415
210083;201402;3844;13664;3720;13518;175;626;3397;12511;3572;13137
210087;201402;2557;8058;2412;7888;200;707;2061;6773;2261;7480
210090;201402;9839;32749;9490;32180;489;1867;8243;28088;8732;29955
210095;201402;6142;23542;5999;23310;753;2854;4755;18963;5508;21817
210100;201402;7544;22612;7128;22127;328;1206;6334;19644;6662;20850
210110;201402;3191;11075;3105;10966;198;751;2619;9440;2817;10191
210120;201402;25363;74805;21766;70406;2407;8245;16515;54520;18922;62765
210125;201402;3366;11195;3238;11055;232;732;2849;9926;3081;10658
210130;201402;3834;11805;3692;11615;413;1272;2922;9310;3335;10582
210135;201402;1652;4886;1472;4622;124;394;1205;3853;1329;4247
210140;201402;17169;55555;14657;52268;3391;12394;8862;32984;12253;45378
210150;201402;4600;11778;4218;11306;149;399;3848;10316;3997;10715
210160;201402;18397;60471;17259;58800;2690;8730;12879;45492;15569;54222
210170;201402;13959;52119;13762;51845;1014;3459;12032;46353;13046;49812
210173;201402;1775;7688;1729;7594;137;645;1492;6601;1629;7246
210177;201402;2931;9645;2782;9458;324;1249;2189;7374;2513;8623
210180;201402;1473;4647;1403;4542;94;331;1189;3852;1283;4183
210190;201402;5089;16506;4796;16010;375;1669;3634;11833;4009;13502
210193;201402;1438;4631;1336;4460;94;361;1079;3651;1173;4012
210197;201402;1809;6359;1709;6250;124;491;1470;5451;1594;5942
210200;201402;9176;31115;8507;30149;1263;4220;6141;22824;7404;27044
210203;201402;6202;21202;5858;20768;494;1606;5014;18153;5508;19759
210207;201402;2972;10109;2823;9851;408;1392;2060;7395;2468;8787
210210;201402;8788;29909;8450;29439;305;1139;7419;26404;7724;27543
210215;201402;1721;6852;1672;6767;186;840;1334;5422;1520;6262
210220;201402;6216;24253;6014;23916;512;2031;4871;19913;5383;21944
210230;201402;5354;18306;4988;17728;448;1655;3999;14395;4447;16050
210232;201402;11584;40770;10396;39264;2109;7983;6848;27524;8957;35507
210235;201402;3484;10943;3157;10535;254;873;2649;8941;2903;9814
210237;201402;2530;9247;2503;9212;49;122;2413;8998;2462;9120
210240;201402;2971;9472;2854;9299;286;814;2285;7677;2571;8491
210250;201402;5030;15843;4828;15592;153;561;4474;14514;4627;15075
210255;201402;2724;8966;2507;8594;575;2133;1514;5241;2089;7374
210260;201402;5201;16758;4804;16178;685;2258;3524;12180;4209;14438
210270;201402;5257;15138;4733;14434;174;598;4203;12925;4377;13523
210275;201402;3483;8965;3275;8742;135;288;3072;8312;3207;8600
210280;201402;5959;17580;5195;16617;366;1278;4353;14057;4719;15335
210290;201402;5816;18698;5378;18159;520;1718;4398;15198;4918;16916
210300;201402;36177;111247;30993;104513;3199;11645;24342;83798;27541;95443
210310;201402;2856;8314;2728;8122;126;376;2395;7165;2521;7541
210312;201402;2178;7078;2139;7017;127;498;1896;6204;2023;6702
210315;201402;2350;8472;2260;8339;142;596;1929;7175;2071;7771
210317;201402;4321;12941;4150;12720;318;953;3559;11083;3877;12036
210320;201402;19505;61855;18346;60470;1215;3979;15984;53721;17199;57700
210325;201402;3577;11474;3234;10959;336;1252;2521;8598;2857;9850
210330;201402;32229;86728;27765;81853;3846;9847;20462;65651;24308;75498
210340;201402;11934;37469;10977;36304;1431;4076;8230;29121;9661;33197
210350;201402;10360;32899;9672;31943;789;2721;7829;26336;8618;29057
210355;201402;3955;14281;3645;13891;138;382;3347;13139;3485;13521
210360;201402;16645;51813;15671;50420;1468;4859;12332;40449;13800;45308
210370;201402;8107;21746;7312;20896;386;916;6471;18992;6857;19908
210375;201402;3245;10014;2827;9517;471;1737;2039;6966;2510;8703
210380;201402;6256;18409;5660;17542;678;1892;4463;14293;5141;16185
210390;201402;2761;9872;2564;9546;119;548;2260;8432;2379;8980
210400;201402;4869;15698;4704;15497;358;1108;4067;13636;4425;14744
210405;201402;8688;24501;7147;22407;2192;6951;3205;10949;5397;17900
210407;201402;2089;7408;1888;7097;194;679;1452;5712;1646;6391
210408;201402;2140;8706;2047;8593;85;347;1864;8018;1949;8365
210409;201402;3900;14220;3717;13939;287;1109;2991;11519;3278;12628
210410;201402;3563;11543;3339;11265;353;1137;2755;9514;3108;10651
210420;201402;4196;14061;3935;13602;356;1238;3163;11152;3519;12390
210430;201402;2018;6515;1978;6465;166;564;1671;5510;1837;6074
210440;201402;4244;13400;4153;13258;212;684;3707;11960;3919;12644
210450;201402;2874;9202;2635;8841;237;866;2119;7107;2356;7973
210455;201402;4181;12660;3623;11822;766;2558;2222;7492;2988;10050
210460;201402;4060;13130;3833;12836;207;795;3290;11112;3497;11907
210462;201402;1774;6443;1714;6332;180;691;1305;4937;1485;5628
210465;201402;2705;8929;2557;8742;385;1126;1984;7119;2369;8245
210467;201402;6161;20820;5775;20338;484;1520;4810;17608;5294;19128
210470;201402;1865;5459;1578;5041;100;372;1252;4035;1352;4407
210480;201402;13575;45947;12113;43958;3850;13932;5930;23308;9780;37240
210490;201402;3422;10470;3199;10141;355;1202;2498;7938;2853;9140
210500;201402;6740;26589;6480;26138;734;2894;5026;21076;5760;23970
210510;201402;6876;22940;6658;22695;344;753;5915;21142;6259;21895
210515;201402;3431;11272;3354;11177;188;559;3032;10279;3220;10838
210520;201402;2706;8602;2546;8378;216;726;2091;7012;2307;7738
210530;201402;39735;133242;34781;125643;11365;44220;16779;61800;28144;106020
210535;201402;3132;11122;3059;10991;163;598;2694;9787;2857;10385
210540;201402;12545;44169;11244;42073;2867;10684;5800;23653;8667;34337
210542;201402;6438;18774;5650;17914;332;951;4965;16156;5297;17107
210545;201402;2220;7561;2123;7395;92;432;1835;6357;1927;6789
210547;201402;3703;13193;3481;12853;257;957;2854;10727;3111;11684
210550;201402;6343;18117;5540;17222;316;765;4993;15957;5309;16722
210560;201402;3983;12948;3658;12439;265;1047;3028;10272;3293;11319
210565;201402;1532;5305;1330;5005;132;612;982;3687;1114;4299
210570;201402;12651;36650;11567;35395;1036;2730;9641;30619;10677;33349
210580;201402;3099;9536;2760;9106;362;1001;2089;7405;2451;8406
210590;201402;4463;13792;4209;13490;312;980;3633;11862;3945;12842
210592;201402;2482;7975;2416;7873;104;393;2121;6906;2225;7299
210594;201402;2745;7972;2330;7428;165;495;1971;6446;2136;6941
210596;201402;2827;10695;2701;10469;340;1338;1995;7886;2335;9224
210598;201402;1994;6208;1874;6063;122;484;1659;5308;1781;5792
210600;201402;3303;9849;3074;9534;391;1227;2338;7307;2729;8534
210610;201402;2646;8499;2382;8180;258;941;1935;6685;2193;7626
210620;201402;1808;5633;1678;5464;55;146;1536;5073;1591;5219
210630;201402;3382;12675;2977;11890;537;2167;1775;7390;2312;9557
210632;201402;4809;16699;4430;16170;512;1865;3480;12948;3992;14813
210635;201402;1852;6730;1797;6649;91;309;1629;6137;1720;6446
210637;201402;2706;9369;2611;9241;130;484;2342;8387;2472;8871
210640;201402;4230;14289;4157;14205;25;82;4061;13957;4086;14039
210650;201402;6785;20828;6676;20696;179;533;6335;19779;6514;20312
210660;201402;7436;23371;6999;22682;294;822;6382;20851;6676;21673
210663;201402;2684;7879;2543;7696;152;535;2162;6568;2314;7103
210667;201402;1665;6155;1600;6059;90;400;1381;5266;1471;5666
210670;201402;4719;17739;4582;17505;459;1765;3576;14093;4035;15858
210675;201402;4816;13581;4580;13285;305;814;3954;11717;4259;12531
210680;201402;4467;12884;4026;12380;234;699;3482;10843;3716;11542
210690;201402;6810;23522;6541;23233;304;1051;5935;21362;6239;22413
210700;201402;2594;7343;2318;7024;225;448;1854;6176;2079;6624
210710;201402;4902;16070;4717;15783;199;697;4178;14060;4377;14757
210720;201402;2402;9045;2300;8896;160;697;1983;7676;2143;8373
210725;201402;1178;4411;1025;4137;130;578;643;2643;773;3221
210730;201402;1199;3780;1071;3640;113;349;871;3042;984;3391
210735;201402;3760;14016;3557;13672;661;2591;2418;9595;3079;12186
210740;201402;4960;13792;4630;13458;196;451;4288;12731;4484;13182
210745;201402;3679;11365;3483;11094;340;921;2845;9265;3185;10186
210750;201402;19992;56291;18408;54493;2303;6850;14629;44046;16932;50896
210760;201402;5899;16216;5630;15925;82;259;5454;15431;5536;15690
210770;201402;6212;17084;5311;16056;269;875;4687;14203;4956;15078
210780;201402;8643;29473;8078;28424;1175;4376;5664;20329;6839;24705
210790;201402;4770;14476;4134;13766;306;800;3526;12295;3832;13095
210800;201402;4986;14258;4569;13799;216;714;3886;12193;4102;12907
210805;201402;3712;15805;3622;15634;190;846;3116;13758;3306;14604
210810;201402;5621;17305;5088;16700;505;1206;4290;14814;4795;16020
210820;201402;8935;25867;8430;25186;1549;4635;5681;17496;7230;22131
210825;201402;5521;18692;5360;18486;248;857;4807;16821;5055;17678
210830;201402;8459;26646;8158;26316;351;995;7354;24275;7705;25270
210840;201402;3765;10542;3494;10162;336;819;2735;8129;3071;8948
210845;201402;5503;17687;5306;17466;303;845;4646;15840;4949;16685
210850;201402;5959;22291;5592;21643;967;4181;3801;14781;4768;18962
210860;201402;17168;53827;16192;52509;1388;4851;13167;42971;14555;47822
210870;201402;6379;21096;5817;20371;812;2746;4246;15341;5058;18087
210880;201402;4057;13385;3985;13286;220;723;3566;12047;3786;12770
210890;201402;5356;16306;5026;15892;499;1735;4058;12823;4557;14558
210900;201402;4690;15478;4327;14852;1492;5259;1903;6893;3395;12152
210905;201402;1823;5776;1738;5666;126;327;1501;5059;1627;5386
210910;201402;10535;33508;9954;32610;1941;6843;6490;21446;8431;28289
210920;201402;3436;11511;3352;11400;156;486;3017;10471;3173;10957
210923;201402;1530;5725;1469;5630;204;816;1040;4156;1244;4972
210927;201402;4679;14943;4569;14830;36;97;4497;14652;4533;14749
210930;201402;2662;9758;2561;9621;208;951;2137;8008;2345;8959
210940;201402;2889;11550;2850;11472;320;1168;2302;9536;2622;10704
210945;201402;5906;17471;5710;17270;196;252;5453;16906;5649;17158
210950;201402;5599;17714;4948;16758;692;2414;3483;12130;4175;14544
210955;201402;1918;6462;1746;6180;296;1141;1170;4208;1466;5349
210960;201402;9232;30786;8908;30306;2283;7538;5614;20146;7897;27684
210970;201402;1375;5058;1227;4839;185;803;871;3483;1056;4286
210975;201402;1700;5999;1625;5863;176;649;1256;4609;1432;5258
210980;201402;8975;22625;8760;22385;647;1402;7651;20025;8298;21427
210990;201402;16376;47626;13184;43868;2537;8998;8428;28727;10965;37725
211000;201402;16200;52926;14816;51185;1054;3728;12597;44391;13651;48119
211003;201402;5103;18018;4713;17426;633;2505;3337;12694;3970;15199
211010;201402;6643;22552;6501;22384;142;472;6090;21212;6232;21684
211020;201402;7486;23146;7419;23064;193;390;7104;22360;7297;22750
211023;201402;2426;8309;2359;8192;172;620;1962;6957;2134;7577
211027;201402;3055;11935;2944;11760;292;1098;2333;9727;2625;10825
211030;201402;4251;13106;3836;12633;843;2307;2708;9553;3551;11860
211040;201402;4090;15856;3984;15681;158;682;3498;14050;3656;14732
211050;201402;10131;27638;9986;27470;471;1231;9265;25650;9736;26881
211060;201402;5680;21025;5573;20831;684;2380;4408;17031;5092;19411
211065;201402;1705;5942;1578;5775;62;236;1457;5385;1519;5621
211070;201402;8695;29590;8239;28803;818;2912;6496;23158;7314;26070
211080;201402;1342;4222;1105;3896;86;437;901;3086;987;3523
211085;201402;2028;6888;1771;6551;326;1177;1274;4893;1600;6070
211090;201402;3535;11207;3341;10941;220;866;2817;9159;3037;10025
211100;201402;6803;17984;6641;17793;96;346;6306;16849;6402;17195
211102;201402;3121;11670;3024;11529;350;1263;2444;9600;2794;10863
211105;201402;2822;8980;2513;8571;204;760;2081;7107;2285;7867
211107;201402;4491;13980;4142;13515;215;702;3648;12110;3863;12812
211110;201402;6494;19704;5185;17862;919;3089;3331;12161;4250;15250
211120;201402;32017;89417;28088;84491;4171;12264;19900;62355;24071;74619
211125;201402;2189;7099;1999;6804;184;616;1613;5589;1797;6205
211130;201402;146543;436414;138205;425777;29352;90331;92068;291490;121420;381821
211140;201402;5652;18325;5383;17904;293;1047;4643;15495;4936;16542
211150;201402;9894;30376;9395;29758;739;2349;8007;25753;8746;28102
211153;201402;3209;9706;2949;9407;320;824;2411;8074;2731;8898
211157;201402;1240;4118;1069;3858;142;625;731;2721;873;3346
211160;201402;4197;14513;3657;13617;396;1698;2731;10196;3127;11894
211163;201402;1694;5662;1620;5563;60;208;1464;5110;1524;5318
211167;201402;1474;5074;1375;4916;54;220;1223;4395;1277;4615
211170;201402;6702;18132;6502;17893;154;523;6055;16609;6209;17132
211172;201402;2388;7073;2112;6659;178;686;1698;5231;1876;5917
211174;201402;2841;8496;2618;8216;126;514;2273;7064;2399;7578
211176;201402;5621;16513;4810;15584;575;1573;3757;12799;4332;14372
211178;201402;3094;9947;3033;9884;73;197;2900;9553;2973;9750
211180;201402;4398;15827;4145;15429;419;1719;3242;12232;3661;13951
211190;201402;2801;9503;2563;9162;139;601;2180;7838;2319;8439
211195;201402;1463;4641;1266;4402;118;409;1021;3653;1139;4062
211200;201402;2166;7587;1961;7313;288;1009;1415;5601;1703;6610
211210;201402;6736;22243;6581;22013;536;1746;5545;18857;6081;20603
211220;201402;35479;106910;31342;101522;7359;24626;18780;62913;26139;87539
211223;201402;5957;17238;5554;16596;748;2307;3770;11801;4518;14108
211227;201402;1565;5933;1498;5830;159;727;1170;4546;1329;5273
211230;201402;8956;30661;8306;29544;1359;4927;5736;20939;7095;25866
211240;201402;8376;28281;8147;28016;351;1232;7493;25953;7844;27185
211245;201402;5143;15474;5076;15391;194;502;4711;14500;4905;15002
211250;201402;11940;44405;11376;43752;1469;4416;9192;37534;10661;41950
211260;201402;8274;26125;8163;25965;462;1357;7379;23773;7841;25130
211270;201402;10031;35973;9520;35306;658;2707;7937;29866;8595;32573
211280;201402;12261;36138;11794;35594;1334;3334;9743;30627;11077;33961
211285;201402;2006;7080;1747;6619;427;1712;842;3369;1269;5081
211290;201402;7732;25467;7574;25277;640;1846;6464;22153;7104;23999
211300;201402;8610;26688;7831;25567;637;2180;6385;21040;7022;23220
211400;201402;12105;35974;10559;34223;2532;8205;6069;21842;8601;30047
220005;201402;1702;5057;1636;4958;53;247;1439;4243;1492;4490
220010;201402;1723;4616;1317;4114;129;485;1027;3141;1156;3626
220020;201402;3721;11493;3536;11180;622;2114;2305;7249;2927;9363
220025;201402;2146;5393;2004;5181;63;197;1779;4539;1842;4736
220027;201402;1394;3852;1301;3737;105;239;1091;3230;1196;3469
220030;201402;3359;10182;3300;10087;319;1028;2709;8340;3028;9368
220040;201402;8454;26478;8094;25897;1612;5432;4983;16056;6595;21488
220045;201402;1439;4694;1312;4487;153;597;943;3185;1096;3782
220050;201402;4827;14020;4269;13230;361;1351;3430;10462;3791;11813
220060;201402;2043;5392;1949;5281;106;290;1751;4759;1857;5049
220070;201402;2574;7685;2308;7307;216;701;1801;5781;2017;6482
220080;201402;827;2575;785;2506;97;389;550;1686;647;2075
220090;201402;1787;4847;1597;4572;137;466;1269;3542;1406;4008
220095;201402;667;1896;638;1848;28;85;588;1691;616;1776
220100;201402;1407;4291;1211;3968;143;457;892;3006;1035;3463
220105;201402;2229;7430;2095;7181;220;785;1535;5311;1755;6096
220110;201402;3588;10492;3175;9892;279;1049;2561;7838;2840;8887
220115;201402;2177;8068;2102;7948;324;1271;1599;6116;1923;7387
220117;201402;1424;3795;1180;3444;78;252;953;2760;1031;3012
220120;201402;12677;36888;11818;35827;386;1470;10740;32518;11126;33988
220130;201402;807;2954;713;2834;53;160;620;2549;673;2709
220140;201402;1612;4351;1495;4206;291;650;1142;3396;1433;4046
220150;201402;7266;23040;6977;22636;450;1771;5898;19028;6348;20799
220155;201402;1053;3370;903;3094;82;353;626;2088;708;2441
220157;201402;1051;2722;967;2599;44;116;823;2217;867;2333
220160;201402;2856;8591;2571;8099;195;758;1955;6101;2150;6859
220170;201402;1304;4234;1211;4075;108;405;957;3245;1065;3650
220173;201402;2105;6429;1740;5732;81;373;1394;4530;1475;4903
220177;201402;1703;5065;1675;5018;78;249;1525;4573;1603;4822
220180;201402;1164;3194;1043;3004;61;207;793;2236;854;2443
220190;201402;4633;15313;4075;14606;519;1903;3112;11321;3631;13224
220191;201402;1440;4905;1381;4810;258;859;953;3363;1211;4222
220192;201402;1753;5093;1422;4530;164;514;1013;3266;1177;3780
220194;201402;1726;5055;1566;4777;194;650;1133;3368;1327;4018
220196;201402;2052;6195;1926;5983;213;764;1456;4491;1669;5255
220198;201402;1321;3699;1090;3394;26;93;1012;3172;1038;3265
220200;201402;4663;16208;4423;15837;743;2891;3037;10867;3780;13758
220202;201402;2063;6528;1885;6207;64;262;1655;5424;1719;5686
220205;201402;2928;7749;2598;7307;101;385;2255;6244;2356;6629
220207;201402;919;2838;807;2643;98;364;595;1940;693;2304
220208;201402;1685;5870;1552;5643;269;1149;1021;3665;1290;4814
220209;201402;1582;5010;1462;4808;98;390;1126;3719;1224;4109
220210;201402;1868;4991;1641;4698;92;322;1283;3683;1375;4005
220211;201402;1636;4964;1554;4854;108;479;1281;3959;1389;4438
220213;201402;1825;5334;1709;5120;110;385;1341;3956;1451;4341
220217;201402;1802;5891;1740;5813;73;215;1584;5374;1657;5589
220220;201402;11726;33998;10853;32620;1369;4054;7624;23561;8993;27615
220225;201402;994;3098;925;2990;40;170;804;2577;844;2747
220230;201402;6080;16216;5088;14888;265;794;4422;13005;4687;13799
220240;201402;2713;8793;2593;8579;214;787;2036;6682;2250;7469
220245;201402;1428;3954;1343;3842;61;164;1187;3444;1248;3608
220250;201402;3379;9171;3068;8759;61;147;2863;8272;2924;8419
220253;201402;1865;5589;1627;5171;126;467;1195;3825;1321;4292
220255;201402;1778;5072;1578;4728;110;435;1275;3707;1385;4142
220260;201402;5233;16950;4748;16058;482;1826;3510;11888;3992;13714
220265;201402;1239;4528;1183;4433;110;516;862;3211;972;3727
220270;201402;6727;22438;6572;22162;421;1912;5553;18271;5974;20183
220271;201402;1544;4413;1480;4324;79;226;1298;3851;1377;4077
220272;201402;1776;5589;1658;5408;109;458;1306;4227;1415;4685
220273;201402;1308;3794;1147;3545;115;384;857;2628;972;3012
220275;201402;2076;5562;1795;5203;81;263;1559;4532;1640;4795
220277;201402;2578;7119;2211;6568;175;566;1688;5060;1863;5626
220280;201402;1787;4667;1566;4348;104;377;1252;3429;1356;3806
220285;201402;1679;4581;1510;4347;99;304;1252;3694;1351;3998
220290;201402;6611;21606;5619;20343;556;2158;4356;16007;4912;18165
220300;201402;1926;6299;1705;6002;98;439;1446;5083;1544;5522
220310;201402;2613;8480;2175;7955;92;293;1960;7384;2052;7677
220320;201402;3397;10133;2867;9249;438;1490;1998;6482;2436;7972
220323;201402;1433;5372;1317;5207;211;902;944;3761;1155;4663
220325;201402;1278;4047;1182;3866;162;579;777;2612;939;3191
220327;201402;1367;4399;1246;4196;74;358;993;3277;1067;3635
220330;201402;3709;10660;3523;10416;288;945;2947;8755;3235;9700
220335;201402;2100;6100;1902;5860;99;355;1627;5051;1726;5406
220340;201402;1838;5281;1627;4980;159;540;1254;3812;1413;4352
220342;201402;1210;4007;1163;3937;122;489;848;2994;970;3483
220345;201402;2898;7979;2495;7335;81;228;2163;6377;2244;6605
220350;201402;4484;12183;3973;11504;300;961;3136;9095;3436;10056
220360;201402;1481;4075;1178;3602;109;361;854;2612;963;2973
220370;201402;9151;26546;8384;25539;472;1357;7426;22809;7898;24166
220375;201402;1574;4916;1464;4769;85;324;1298;4207;1383;4531
220380;201402;1406;3872;1216;3607;88;283;943;2816;1031;3099
220385;201402;707;1953;640;1825;35;122;527;1453;562;1575
220390;201402;10299;32781;9472;31194;2423;8505;4328;14364;6751;22869
220400;201402;1457;3534;1320;3348;67;221;1140;2826;1207;3047
220410;201402;1379;4000;1181;3728;107;449;936;2870;1043;3319
220415;201402;892;2411;808;2298;91;255;602;1723;693;1978
220420;201402;2268;6622;2068;6224;162;481;1652;4992;1814;5473
220430;201402;2983;8746;2838;8553;375;1169;2134;6452;2509;7621
220435;201402;1662;4911;1551;4739;83;266;1296;3959;1379;4225
220440;201402;2812;8484;2342;7952;144;397;2069;7168;2213;7565
220450;201402;2729;8148;2375;7669;587;1995;1399;4540;1986;6535
220455;201402;1427;4377;1283;4180;52;175;1156;3811;1208;3986
220460;201402;1038;2903;988;2832;70;201;842;2413;912;2614
220465;201402;2475;8192;2289;7917;540;2005;1389;4830;1929;6835
220470;201402;4076;12342;3708;11711;258;912;2859;8921;3117;9833
220480;201402;2355;7138;2169;6865;162;539;1777;5636;1939;6175
220490;201402;2410;7039;2289;6878;136;487;1953;5831;2089;6318
220500;201402;3417;9260;2932;8447;185;729;2344;6548;2529;7277
220510;201402;2954;8312;2254;7280;96;435;1778;5711;1874;6146
220515;201402;1982;4981;1757;4701;87;240;1475;3967;1562;4207
220520;201402;5068;14443;4769;14025;222;625;4176;12425;4398;13050
220525;201402;1466;4177;1365;4031;107;392;1101;3176;1208;3568
220527;201402;1452;4628;1356;4426;152;489;1042;3477;1194;3966
220530;201402;1199;3529;1114;3402;108;412;907;2683;1015;3095
220535;201402;894;2813;864;2769;82;327;683;2150;765;2477
220540;201402;3635;12249;3503;12043;296;1213;2835;9718;3131;10931
220545;201402;1441;4983;1386;4889;207;827;959;3338;1166;4165
220550;201402;9336;30824;8858;29975;1594;5767;5873;19919;7467;25686
220551;201402;1435;4931;1351;4788;131;547;1038;3645;1169;4192
220552;201402;1678;5306;1447;4910;129;598;1055;3435;1184;4033
220553;201402;1634;4890;1421;4590;85;311;1162;3748;1247;4059
220554;201402;933;2614;814;2451;114;348;579;1783;693;2131
220555;201402;2444;7230;2296;7047;101;344;1959;6102;2060;6446
220556;201402;1481;4738;1356;4497;105;436;1012;3323;1117;3759
220557;201402;1627;5421;1498;5177;210;820;975;3358;1185;4178
220558;201402;1037;3279;966;3149;109;420;725;2313;834;2733
220559;201402;1561;4488;1442;4311;78;265;1232;3683;1310;3948
220560;201402;1765;4436;1487;4057;83;228;1248;3392;1331;3620
220570;201402;7547;24236;7108;23633;1160;3615;5212;17952;6372;21567
220580;201402;6609;21695;6443;21500;414;1366;5736;19384;6150;20750
220585;201402;1934;7242;1878;7142;147;600;1571;6000;1718;6600
220590;201402;1428;4507;1293;4303;261;907;791;2676;1052;3583
220595;201402;2485;7238;2301;6995;87;295;2052;6268;2139;6563
220600;201402;1327;3338;1144;3119;230;515;738;2152;968;2667
220605;201402;2079;6208;1844;5846;114;382;1457;4636;1571;5018
220610;201402;2808;8792;2726;8677;173;681;2305;7270;2478;7951
220620;201402;7812;26821;7573;26469;417;1669;6593;23097;7010;24766
220630;201402;413;1269;354;1161;71;266;184;601;255;867
220635;201402;1891;6765;1767;6490;155;661;1159;4246;1314;4907
220640;201402;2811;8366;2691;8188;278;939;2076;6313;2354;7252
220650;201402;2495;7033;2251;6658;151;506;1818;5366;1969;5872
220660;201402;2505;8362;2050;7780;212;901;1692;6411;1904;7312
220665;201402;1228;4233;1179;4156;55;241;1037;3629;1092;3870
220667;201402;1765;6001;1682;5889;81;327;1442;5043;1523;5370
220669;201402;1897;6279;1777;6060;262;1006;1210;4125;1472;5131
220670;201402;2165;6599;2037;6437;169;447;1739;5685;1908;6132
220672;201402;2290;6646;2215;6553;242;690;1831;5506;2073;6196
220675;201402;1369;4014;1285;3876;143;390;939;2894;1082;3284
220680;201402;2257;7448;2169;7318;219;714;1720;5931;1939;6645
220690;201402;1731;4977;1555;4692;129;474;1217;3628;1346;4102
220695;201402;872;2680;829;2608;76;263;626;1966;702;2229
220700;201402;9107;26704;8324;25543;791;2672;6393;19646;7184;22318
220710;201402;767;2326;670;2158;70;209;483;1589;553;1798
220720;201402;2143;5821;2034;5675;98;218;1809;5145;1907;5363
220730;201402;1379;3837;1209;3578;55;202;1014;2971;1069;3173
220735;201402;1048;2767;900;2524;73;238;670;1878;743;2116
220740;201402;1395;4516;1187;4227;278;921;758;2873;1036;3794
220750;201402;4016;11870;3797;11538;558;1511;2817;8914;3375;10425
220755;201402;1196;3548;1134;3448;68;195;964;2946;1032;3141
220760;201402;2657;9445;2486;9194;127;513;2169;8101;2296;8614
220770;201402;23560;81650;22192;79163;7720;28722;8917;32869;16637;61591
220775;201402;1191;2998;1172;2977;20;35;1144;2923;1164;2958
220777;201402;1707;4925;1604;4773;134;418;1303;3855;1437;4273
220779;201402;1156;3558;1124;3512;68;266;990;3054;1058;3320
220780;201402;6273;16503;5686;15739;469;1236;4654;13117;5123;14353
220785;201402;1341;3636;1301;3553;66;179;1184;3223;1250;3402
220790;201402;9440;31090;9137;30530;984;3578;7182;23927;8166;27505
220793;201402;922;2653;854;2541;68;224;692;2051;760;2275
220795;201402;1546;4368;1500;4300;111;345;1263;3640;1374;3985
220800;201402;17167;49343;16030;47652;1917;6608;12029;35097;13946;41705
220810;201402;3358;9959;2919;9174;241;927;2273;7067;2514;7994
220820;201402;5597;15888;5150;15308;317;1061;4387;13103;4704;14164
220830;201402;7718;22049;7355;21449;932;2723;5525;16311;6457;19034
220840;201402;14953;48611;13779;46258;3619;12440;6187;21568;9806;34008
220850;201402;2734;10015;2623;9845;343;1389;2018;7642;2361;9031
220855;201402;623;1964;563;1854;64;240;403;1313;467;1553
220860;201402;946;2691;889;2602;54;218;727;2077;781;2295
220865;201402;2677;7575;2207;6810;110;495;1806;5452;1916;5947
220870;201402;2435;8101;2148;7744;130;515;1869;6749;1999;7264
220880;201402;5410;14292;4974;13763;249;845;4363;12062;4612;12907
220885;201402;1337;4742;1186;4476;122;567;862;3241;984;3808
220887;201402;1356;3640;1187;3408;48;146;1056;3054;1104;3200
220890;201402;1623;5814;1458;5553;142;539;1160;4545;1302;5084
220900;201402;1889;5749;1711;5366;122;369;1374;4360;1496;4729
220910;201402;1736;5140;1556;4876;74;261;1350;4276;1424;4537
220915;201402;1041;3038;926;2843;50;226;724;2157;774;2383
220920;201402;1324;4955;1267;4877;121;544;984;3783;1105;4327
220930;201402;1486;4850;1320;4633;105;425;1068;3784;1173;4209
220935;201402;1047;3269;953;3075;67;294;693;2148;760;2442
220937;201402;1556;4347;1340;3972;75;268;1055;3062;1130;3330
220940;201402;1473;4528;1366;4300;103;394;1044;3267;1147;3661
220945;201402;481;1760;451;1666;60;262;307;1125;367;1387
220950;201402;1268;3254;935;2686;45;177;694;1933;739;2110
220955;201402;1627;4546;1390;4182;134;450;1065;3191;1199;3641
220960;201402;832;2345;732;2171;65;254;551;1589;616;1843
220965;201402;1694;5171;1605;5044;65;266;1392;4367;1457;4633
220970;201402;2158;5817;1588;4864;173;534;1060;3279;1233;3813
220975;201402;558;2127;556;2122;56;214;482;1848;538;2062
220980;201402;1492;4494;1340;4219;130;466;898;2921;1028;3387
220985;201402;1366;3952;1309;3873;132;462;992;2899;1124;3361
220987;201402;1491;4928;1400;4768;119;480;1051;3515;1170;3995
220990;201402;1802;5343;1597;4986;78;330;1237;3802;1315;4132
220995;201402;1222;3737;1020;3424;91;360;766;2606;857;2966
220997;201402;2108;6797;2015;6643;130;449;1791;5901;1921;6350
221000;201402;4497;14048;4203;13546;548;1892;3025;9761;3573;11653
221005;201402;1422;4563;1348;4427;430;1350;677;2350;1107;3700
221010;201402;1243;3385;1099;3195;58;181;939;2750;997;2931
221020;201402;1926;6031;1812;5822;124;552;1378;4326;1502;4878
221030;201402;1810;5072;1591;4761;88;367;1278;3762;1366;4129
221035;201402;1566;4281;1424;4104;88;253;1239;3617;1327;3870
221037;201402;637;1968;578;1866;36;159;463;1429;499;1588
221038;201402;645;1851;526;1659;47;168;359;1136;406;1304
221039;201402;939;2782;888;2706;69;225;757;2297;826;2522
221040;201402;5211;16153;4955;15739;419;1456;3889;12505;4308;13961
221050;201402;3762;11728;3489;11331;231;901;2946;9500;3177;10401
221060;201402;9258;25451;7976;23722;907;2831;6002;17972;6909;20803
221062;201402;1287;4574;1232;4498;37;113;1150;4228;1187;4341
221063;201402;1134;3694;1062;3558;353;1153;543;1976;896;3129
221065;201402;2717;8101;2552;7838;295;924;1955;6023;2250;6947
221070;201402;4396;13545;4005;12947;266;1029;3156;10176;3422;11205
221080;201402;3479;9584;3150;9138;228;743;2559;7445;2787;8188
221090;201402;1328;3704;1176;3472;50;196;975;2827;1025;3023
221093;201402;1806;5429;1723;5269;339;1116;980;2933;1319;4049
221095;201402;984;2674;860;2501;38;115;769;2261;807;2376
221097;201402;807;2341;722;2194;61;251;542;1624;603;1875
221100;201402;124004;383556;117744;373233;25669;89642;74402;230881;100071;320523
221110;201402;10054;33744;9661;33244;728;2879;8109;27866;8837;30745
221120;201402;4384;14698;4201;14370;1206;4092;2418;8603;3624;12695
221130;201402;4696;14182;4179;13134;1032;3386;2251;7050;3283;10436
221135;201402;1467;4700;1378;4564;176;677;1014;3315;1190;3992
221140;201402;1408;3596;1302;3456;150;339;1037;2824;1187;3163
221150;201402;1237;3229;1043;2890;26;111;831;2284;857;2395
221160;201402;911;2441;860;2361;63;188;651;1802;714;1990
221170;201402;1106;3645;1065;3561;80;331;874;2877;954;3208
230010;201402;3435;9392;2826;8343;191;674;2240;6592;2431;7266
230015;201402;2717;9650;2556;9310;445;1884;1711;6073;2156;7957
230020;201402;14272;47929;13807;47077;1071;4000;11186;38339;12257;42339
230030;201402;12491;37408;11770;36280;995;3421;9371;28847;10366;32268
230040;201402;4523;13047;3886;11944;343;1208;2972;9065;3315;10273
230050;201402;2533;8849;2191;7980;397;1587;1093;4003;1490;5590
230060;201402;1992;6082;1788;5698;156;569;1328;4209;1484;4778
230070;201402;4675;13044;4167;12327;394;1253;3128;9461;3522;10714
230075;201402;8776;32926;8314;31956;956;4489;6102;23255;7058;27744
230080;201402;2339;6637;2001;6156;124;432;1630;5011;1754;5443
230090;201402;3431;10673;3092;10054;295;1156;2325;7429;2620;8585
230100;201402;17247;54171;15967;51767;4455;15325;7554;24853;12009;40178
230110;201402;13965;46653;13128;44885;2598;9713;7674;26168;10272;35881
230120;201402;7975;22407;7084;21183;825;2705;5204;15672;6029;18377
230125;201402;2889;8656;2435;7786;198;803;1790;5640;1988;6443
230130;201402;5602;19002;4788;17231;455;1948;3366;11979;3821;13927
230140;201402;3485;11538;3036;10711;471;1772;1921;6936;2392;8708
230150;201402;1749;5609;1543;5193;292;1140;944;3047;1236;4187
230160;201402;6312;19479;5597;18418;595;2169;4138;13691;4733;15860
230170;201402;6489;20989;5657;19451;516;2070;4044;13763;4560;15833
230180;201402;1945;5679;1725;5286;150;561;1193;3584;1343;4145
230185;201402;4167;14217;3888;13680;723;2556;2400;8800;3123;11356
230190;201402;12243;41331;11339;39537;2261;8936;6260;21646;8521;30582
230195;201402;4951;15718;4517;15027;358;1538;3491;11253;3849;12791
230200;201402;5691;16901;5133;15812;683;2196;3576;11056;4259;13252
230205;201402;4393;14117;3950;13364;385;1664;2834;9545;3219;11209
230210;201402;9203;26913;8157;25254;2399;7595;3861;12448;6260;20043
230220;201402;13580;40967;12606;39307;1991;6973;8398;25855;10389;32828
230230;201402;7369;24841;6673;23365;1157;4181;3965;14088;5122;18269
230240;201402;13352;39783;12186;37665;845;3217;9350;28393;10195;31610
230250;201402;10228;31769;10016;31464;566;2132;8429;26333;8995;28465
230260;201402;14845;51311;13870;49297;3143;11899;7288;26530;10431;38429
230270;201402;6751;20950;6040;19722;665;2410;4492;14726;5157;17136
230280;201402;20128;61882;18560;59240;2834;9393;12740;41042;15574;50435
230290;201402;5132;16027;4519;14808;656;2218;2957;9832;3613;12050
230300;201402;4728;14987;4548;14710;525;1976;3363;10780;3888;12756
230310;201402;4920;15013;4398;14162;390;1557;3294;10427;3684;11984
230320;201402;7383;24129;6941;23354;848;3261;5018;16908;5866;20169
230330;201402;4644;14160;4179;13250;422;1552;2922;9147;3344;10699
230340;201402;3387;11978;3196;11564;540;2198;1957;6934;2497;9132
230350;201402;18260;57046;16504;54017;3002;10761;10128;33482;13130;44243
230360;201402;3012;9123;2651;8471;330;1216;1902;6012;2232;7228
230365;201402;2936;8740;2597;8178;203;772;1969;6167;2172;6939
230370;201402;54773;185133;51082;178885;15597;57370;24140;87275;39737;144645
230380;201402;7115;20913;6137;19260;585;2090;4294;13482;4879;15572
230390;201402;3652;11774;3280;11169;415;1718;2246;7541;2661;9259
230393;201402;3383;11444;2930;10489;270;1342;2049;7078;2319;8420
230395;201402;4905;15836;4594;15226;700;2683;2986;9781;3686;12464
230400;201402;5121;16304;4513;15425;424;1822;3468;11615;3892;13437
230410;201402;15790;50808;14290;48020;2549;9236;8335;28096;10884;37332
230420;201402;24202;81717;22828;78921;5830;22039;11105;38190;16935;60229
230423;201402;4811;15914;4490;15311;528;2005;3095;10746;3623;12751
230425;201402;5438;18637;5055;17777;750;2898;3400;11894;4150;14792
230426;201402;2828;8037;2356;7162;155;624;1769;5257;1924;5881
230427;201402;1745;5415;1330;4496;127;477;872;2856;999;3333
230428;201402;9120;30425;8909;30047;1814;6852;5586;18628;7400;25480
230430;201402;4609;15150;4368;14676;444;1808;3166;10466;3610;12274
230435;201402;4947;16630;4484;15819;1088;4208;2253;8128;3341;12336
230440;201402;356696;1127376;338241;1094312;87958;307250;164640;533684;252598;840934
230445;201402;4719;13011;4080;12110;370;1120;3018;9148;3388;10268
230450;201402;3680;12035;3181;11134;470;1882;2010;7049;2480;8931
230460;201402;1918;6467;1769;6179;196;807;1263;4380;1459;5187
230465;201402;4188;12826;3450;11467;332;1414;2254;7302;2586;8716
230470;201402;11284;41814;10904;41062;1503;6080;7774;29800;9277;35880
230480;201402;1464;4809;1297;4489;239;872;811;2832;1050;3704
230490;201402;2966;8795;2624;8172;473;1689;1361;4180;1834;5869
230495;201402;5699;19451;5195;18621;961;4082;3002;10739;3963;14821
230500;201402;10692;36733;10283;36056;911;3518;7857;28150;8768;31668
230510;201402;1521;5542;1297;4980;330;1367;522;2086;852;3453
230520;201402;5027;15471;4437;14442;514;1955;2986;9645;3500;11600
230523;201402;13573;46011;12585;43837;3733;14440;3593;12691;7326;27131
230526;201402;4146;13019;3671;12185;413;1593;2539;8455;2952;10048
230530;201402;5211;17710;4816;17172;1046;3781;3112;11303;4158;15084
230533;201402;3979;11465;3594;10736;269;891;2741;8123;3010;9014
230535;201402;5430;16402;4813;15291;519;1756;3472;11175;3991;12931
230540;201402;18914;55228;16904;52257;1201;4383;13744;42189;14945;46572
230550;201402;20056;61815;18440;58774;4366;15175;9589;30278;13955;45453
230560;201402;6839;19957;6196;18793;338;1310;4876;14620;5214;15930
230565;201402;3270;9694;2708;8559;280;998;1855;5812;2135;6810
230570;201402;3955;10943;3554;10431;237;876;2929;8495;3166;9371
230580;201402;10393;32494;9946;31871;633;2131;8595;27813;9228;29944
230590;201402;9543;30753;8724;29274;822;3419;6371;20979;7193;24398
230600;201402;3655;10430;2808;8682;202;709;1891;5766;2093;6475
230610;201402;6048;20365;5683;19786;858;3247;3997;14058;4855;17305
230620;201402;2060;5952;1731;5278;163;590;1116;3314;1279;3904
230625;201402;7602;25682;6913;24114;2000;7572;2290;8032;4290;15604
230630;201402;11202;37265;10313;35525;2586;8720;5095;18600;7681;27320
230640;201402;26589;90394;25155;88254;3909;14585;17760;63056;21669;77641
230650;201402;4950;16045;4563;15278;397;1698;3457;11338;3854;13036
230655;201402;8601;33056;8300;32558;758;3093;6879;27343;7637;30436
230660;201402;6339;20195;5617;18907;558;2263;3991;13509;4549;15772
230670;201402;5978;16559;4924;14757;265;988;3774;11018;4039;12006
230680;201402;2775;8259;2375;7534;391;1364;1416;4485;1807;5849
230690;201402;6385;21355;6245;21091;513;2206;4516;14944;5029;17150
230700;201402;9231;27365;8232;25594;877;3334;5598;16900;6475;20234
230710;201402;7671;25116;6868;23655;902;3117;4919;17384;5821;20501
230720;201402;1943;6156;1681;5652;228;846;1096;3700;1324;4546
230725;201402;3768;12883;3400;11996;682;2598;1838;6375;2520;8973
230730;201402;56832;176662;48834;164292;13399;49170;21673;74177;35072;123347
230740;201402;5337;17222;5058;16716;328;1383;4125;13447;4453;14830
230750;201402;8975;26404;7698;24322;711;2687;5738;18000;6449;20687
230760;201402;10142;31819;9835;31120;1445;5496;6886;20833;8331;26329
230763;201402;4215;13575;3988;13125;329;1498;3016;9558;3345;11056
230765;201402;41722;139342;39123;134108;12508;46181;13531;46999;26039;93180
230770;201402;23700;67288;22052;64941;2043;6947;16519;48309;18562;55256
230780;201402;5943;23897;5712;23333;1414;5876;2887;12512;4301;18388
230790;201402;2551;8826;2449;8651;306;1191;1862;6633;2168;7824
230800;201402;7873;28872;7296;27564;1762;7170;3406;12991;5168;20161
230810;201402;12444;41247;11922;40365;1429;5105;9005;30935;10434;36040
230820;201402;3418;11839;3062;11066;622;2526;1638;5927;2260;8453
230830;201402;7872;24238;7096;22826;731;2736;4973;15959;5704;18695
230835;201402;4135;11465;3567;10694;301;1010;2773;8304;3074;9314
230837;201402;3150;10997;2764;10208;389;1623;1801;6685;2190;8308
230840;201402;9359;31537;8601;30193;1339;5073;5681;20339;7020;25412
230850;201402;11188;34672;10547;33850;1379;4960;7706;24630;9085;29590
230860;201402;5054;15456;4675;14724;405;1525;3495;10903;3900;12428
230870;201402;18920;53308;17098;50319;1679;5721;12707;37090;14386;42811
230880;201402;1925;6775;1802;6531;264;1110;1159;4163;1423;5273
230890;201402;4103;15110;3792;14473;546;2413;2470;9309;3016;11722
230900;201402;3000;10208;2654;9475;532;1915;1433;5251;1965;7166
230910;201402;2972;9158;2455;8168;259;1039;1706;5562;1965;6601
230920;201402;4647;13922;4314;13507;333;1127;3515;11187;3848;12314
230930;201402;7766;24145;7053;22813;910;3169;4855;15764;5765;18933
230940;201402;7680;22140;6829;20891;385;1195;5705;17645;6090;18840
230945;201402;5847;18030;5104;16978;587;2143;3629;12226;4216;14369
230950;201402;6917;19382;5971;18097;416;1409;4612;14023;5028;15432
230960;201402;12396;40577;11499;38814;2705;10053;5483;18534;8188;28587
230970;201402;13317;43466;12205;41255;2620;10166;6087;20076;8707;30242
230980;201402;2836;9527;2599;9026;846;2961;1083;3977;1929;6938
230990;201402;1619;5097;1331;4499;161;691;871;2861;1032;3552
231000;201402;2870;7875;2311;6817;269;927;1447;4131;1716;5058
231010;201402;3005;8819;2629;8215;296;1169;1912;5853;2208;7022
231020;201402;7920;26898;7501;26052;1399;5133;4679;16591;6078;21724
231025;201402;7789;25018;7110;23857;1208;4236;4493;15468;5701;19704
231030;201402;7956;26724;6856;24437;1353;5138;3877;13993;5230;19131
231040;201402;2988;10140;2724;9580;286;1185;1881;6542;2167;7727
231050;201402;11967;35619;10686;33314;1138;3948;7599;23767;8737;27715
231060;201402;2422;7841;2239;7516;202;918;1620;5287;1822;6205
231070;201402;9307;29957;8677;28734;1580;5666;5303;17685;6883;23351
231080;201402;4285;13596;3952;13011;279;1258;2931;9281;3210;10539
231085;201402;4726;15462;4591;15233;754;2631;3278;11071;4032;13702
231090;201402;4092;11727;3462;10475;226;840;2513;7486;2739;8326
231095;201402;2221;7542;1947;7003;238;920;1327;4844;1565;5764
231100;201402;3024;9600;2547;8640;226;847;1820;6104;2046;6951
231110;201402;3734;12679;3644;12524;410;1520;2633;9125;3043;10645
231120;201402;2430;8062;2271;7787;385;1369;1453;5049;1838;6418
231123;201402;2216;6154;1894;5618;146;440;1490;4429;1636;4869
231126;201402;6693;18829;5517;17151;423;1533;4175;12849;4598;14382
231130;201402;20104;64139;18564;61426;4733;16453;9485;32801;14218;49254
231135;201402;4646;13836;3945;12753;397;1534;2857;9097;3254;10631
231140;201402;15295;50974;14343;49042;1509;6956;9997;32811;11506;39767
231150;201402;5898;17643;5119;16181;1020;3609;2666;8207;3686;11816
231160;201402;5753;19936;5490;19432;1414;5268;3213;11403;4627;16671
231170;201402;4757;15526;4426;14867;475;1959;3020;10011;3495;11970
231180;201402;15013;46410;13829;44145;2677;9332;8243;25993;10920;35325
231190;201402;5076;14328;4255;13151;374;1326;3260;9973;3634;11299
231195;201402;4640;16105;4067;14984;388;1702;3011;11142;3399;12844
231200;201402;7600;26978;6796;25364;695;3231;4852;17899;5547;21130
231210;201402;5088;16039;4444;15151;323;1407;3391;11638;3714;13045
231220;201402;14138;41076;12143;37683;1244;4553;7834;24459;9078;29012
231230;201402;9631;34378;9083;33372;1274;5237;6383;23526;7657;28763
231240;201402;11765;38318;10740;36470;1641;6271;6783;23282;8424;29553
231250;201402;2073;6084;1448;4562;304;977;558;1680;862;2657
231260;201402;4022;11574;3671;11086;511;1651;2455;7567;2966;9218
231270;201402;7693;21992;6903;20712;639;2518;5000;14636;5639;17154
231280;201402;1727;5811;1633;5623;163;603;1195;4155;1358;4758
231290;201402;33248;119511;30736;113278;7726;31341;12594;45369;20320;76710
231300;201402;4559;13633;3807;12089;358;1396;2665;8163;3023;9559
231310;201402;7494;22019;6435;19887;1347;4386;3296;10082;4643;14468
231320;201402;6963;21939;6197;20458;431;1733;4645;15285;5076;17018
231325;201402;2560;8015;2306;7560;204;741;1706;5631;1910;6372
231330;201402;14167;44681;12100;40736;2020;6979;7416;25315;9436;32294
231335;201402;5127;15018;4542;13956;333;1328;3584;10754;3917;12082
231340;201402;17961;59576;16935;58123;1540;5088;13551;47891;15091;52979
231350;201402;12225;42150;12003;41806;1463;4945;9558;34082;11021;39027
231355;201402;4287;14147;4152;13921;244;835;3572;12154;3816;12989
231360;201402;7153;24043;6669;23213;1773;6052;3693;13501;5466;19553
231370;201402;2379;6911;1930;6227;117;463;1441;4593;1558;5056
231375;201402;4125;14383;3936;14023;413;1867;3011;10489;3424;12356
231380;201402;5281;17436;4979;17018;834;3045;3372;11806;4206;14851
231390;201402;3429;10947;3249;10682;287;1148;2447;7958;2734;9106
231395;201402;4237;13818;3821;13156;789;2855;2281;8036;3070;10891
231400;201402;10436;31675;9590;30145;1012;3702;6680;21081;7692;24783
231410;201402;14859;49720;13620;48032;1590;5630;9786;35869;11376;41499
240010;201402;2453;7800;2213;7254;550;2031;953;2995;1503;5026
240020;201402;11856;37670;10686;35469;2910;10410;4692;15850;7602;26260
240030;201402;2540;7646;2469;7532;232;902;1940;5769;2172;6671
240040;201402;794;2405;686;2200;52;256;486;1468;538;1724
240050;201402;3662;10200;3234;9469;225;808;2432;7018;2657;7826
240060;201402;1439;4361;1373;4251;128;478;1039;3121;1167;3599
240070;201402;2844;8327;2720;8095;461;1455;1735;5113;2196;6568
240080;201402;3094;8437;2817;8064;273;751;2218;6474;2491;7225
240090;201402;2237;6222;1919;5613;64;266;1517;4338;1581;4604
240100;201402;10292;30046;9638;28777;1258;4472;5966;17608;7224;22080
240110;201402;5232;16125;4687;15152;951;3510;2690;8313;3641;11823
240120;201402;3010;10101;2919;9940;601;2204;1795;6245;2396;8449
240130;201402;2800;7790;2431;7224;213;766;1849;5422;2062;6188
240140;201402;2210;6968;1990;6556;417;1567;1050;3409;1467;4976
240145;201402;6243;19773;5650;18709;1606;5986;2742;9004;4348;14990
240150;201402;1020;3165;847;2820;135;554;494;1578;629;2132
240160;201402;1459;4844;1336;4632;155;621;917;3211;1072;3832
240165;201402;915;2996;820;2804;114;420;528;1838;642;2258
240170;201402;2546;7819;2309;7372;608;2119;1077;3476;1685;5595
240180;201402;2982;9439;2809;9142;737;2544;1423;4808;2160;7352
240185;201402;1499;5043;1458;4970;182;646;1067;3700;1249;4346
240190;201402;957;2944;893;2817;93;364;628;1933;721;2297
240200;201402;14493;37905;12231;35159;2417;7095;7410;22333;9827;29428
240210;201402;2757;7945;2563;7691;244;848;2085;6205;2329;7053
240220;201402;7282;23794;6988;23384;371;1645;6146;20334;6517;21979
240230;201402;5488;15863;5082;15155;463;1618;3909;11507;4372;13125
240240;201402;1801;5729;1410;4688;382;1375;297;874;679;2249
240250;201402;2874;8367;2732;8163;211;772;2181;6412;2392;7184
240260;201402;14921;50521;14262;49442;2498;9852;9205;31870;11703;41722
240270;201402;2373;7902;2260;7701;260;898;1641;5722;1901;6620
240280;201402;1637;4739;1479;4455;129;473;1068;3175;1197;3648
240290;201402;1424;4517;1230;4161;112;536;786;2552;898;3088
240300;201402;2086;5917;1640;5005;415;1381;636;1885;1051;3266
240310;201402;10452;30152;9582;28751;2226;7269;4885;14664;7111;21933
240320;201402;2047;6168;1695;5440;105;463;1196;3695;1301;4158
240325;201402;37682;106102;30326;93954;9452;31928;9274;29277;18726;61205
240330;201402;1540;4703;1313;4249;167;680;797;2469;964;3149
240340;201402;1650;4998;1469;4727;249;851;971;3133;1220;3984
240350;201402;2122;6544;1999;6364;247;949;1562;4880;1809;5829
240360;201402;7400;22590;6541;21334;1053;3723;4270;14295;5323;18018
240370;201402;2001;5571;1790;5230;133;477;1326;3856;1459;4333
240375;201402;895;2400;806;2281;143;460;464;1276;607;1736
240380;201402;2689;8126;2259;7193;344;1136;1288;4086;1632;5222
240390;201402;923;2639;771;2343;78;289;523;1566;601;1855
240400;201402;1454;3944;1270;3692;128;459;946;2667;1074;3126
240410;201402;545;1788;501;1698;78;315;317;1056;395;1371
240420;201402;4892;18690;4715;18285;1445;5713;2249;9256;3694;14969
240430;201402;3509;10248;3257;9807;353;1222;2329;6941;2682;8163
240440;201402;2698;7316;2543;7033;668;1929;1326;3693;1994;5622
240450;201402;3875;11754;3545;11136;530;2026;2158;6661;2688;8687
240460;201402;2876;9347;2794;9215;295;1181;2181;7104;2476;8285
240470;201402;3673;11340;3006;9947;488;1781;1776;5824;2264;7605
240480;201402;412;1081;378;1017;37;86;242;660;279;746
240485;201402;2144;6553;1912;6119;403;1417;1046;3347;1449;4764
240490;201402;1656;4283;1455;4000;83;313;1136;3007;1219;3320
240500;201402;2104;6432;2018;6292;208;727;1535;4797;1743;5524
240510;201402;1784;5547;1669;5326;239;841;1195;3830;1434;4671
240520;201402;1442;4240;1277;4002;215;774;839;2564;1054;3338
240530;201402;2211;7071;1990;6714;267;976;1401;4726;1668;5702
240540;201402;1860;5691;1789;5568;176;625;1330;4113;1506;4738
240550;201402;785;2273;708;2146;54;197;541;1599;595;1796
240560;201402;3290;9688;3123;9436;338;1106;2471;7446;2809;8552
240570;201402;3116;8987;2575;7785;604;2078;1116;3065;1720;5143
240580;201402;8110;25514;7689;24808;1288;4446;5506;17665;6794;22111
240590;201402;848;2431;758;2277;55;218;552;1620;607;1838
240600;201402;1526;4588;1242;4002;188;694;679;2086;867;2780
240610;201402;5002;14166;4458;13225;509;1685;3007;8778;3516;10463
240615;201402;1057;3053;887;2730;151;476;500;1554;651;2030
240620;201402;1671;5541;1565;5350;232;891;1146;3903;1378;4794
240630;201402;2055;6388;1964;6230;190;584;1474;4871;1664;5455
240640;201402;925;2767;786;2548;95;415;512;1604;607;2019
240650;201402;3766;11825;3499;11436;310;1151;2778;9105;3088;10256
240660;201402;2522;8151;2418;7981;284;988;1805;6072;2089;7060
240670;201402;2752;8330;2373;7563;346;1288;1356;4207;1702;5495
240680;201402;1511;4478;1236;3977;162;538;733;2409;895;2947
240690;201402;1091;3124;966;2918;104;376;690;2069;794;2445
240700;201402;2649;8069;2237;7284;140;629;1707;5390;1847;6019
240710;201402;18659;47960;16623;45358;3144;8710;10157;28670;13301;37380
240720;201402;5607;16424;5380;16075;1456;4781;2859;8497;4315;13278
240725;201402;1075;3246;831;2699;77;262;468;1496;545;1758
240730;201402;2266;7106;2053;6701;206;749;1429;4615;1635;5364
240740;201402;2275;6890;2057;6490;265;905;1340;4243;1605;5148
240750;201402;2249;8400;2077;8080;475;1988;1138;4510;1613;6498
240760;201402;1201;3695;1153;3621;106;301;927;3028;1033;3329
240770;201402;3511;10393;3242;9987;418;1440;2280;7041;2698;8481
240780;201402;5976;17030;4955;15421;905;3033;2783;8847;3688;11880
240790;201402;857;2703;700;2411;44;174;530;1842;574;2016
240800;201402;40828;119789;37452;113997;10683;34803;15345;47473;26028;82276
240810;201402;93997;285839;89009;276775;28870;93533;39414;124669;68284;218202
240820;201402;6935;20846;6029;19428;1158;4137;3152;10545;4310;14682
240830;201402;9360;29013;8890;28337;778;2638;7204;23315;7982;25953
240840;201402;1308;3690;1141;3414;113;408;715;2121;828;2529
240850;201402;1161;3626;926;3144;189;729;456;1464;645;2193
240860;201402;1316;3764;1142;3491;89;318;830;2498;919;2816
240870;201402;1172;3286;1015;2984;127;465;667;1846;794;2311
240880;201402;1171;4060;1114;3981;151;672;781;2740;932;3412
240890;201402;5489;15644;4830;14473;831;2825;2647;7849;3478;10674
240895;201402;2791;9608;2559;9199;387;1484;1722;6304;2109;7788
240910;201402;2633;8497;2467;8174;247;982;1823;5990;2070;6972
240920;201402;860;2815;790;2654;199;750;392;1277;591;2027
240930;201402;3593;9850;3293;9449;308;943;2604;7554;2912;8497
240933;201402;1468;4427;1313;4158;278;980;712;2278;990;3258
240940;201402;6602;18847;5648;17182;1170;3771;2948;8971;4118;12742
240950;201402;1160;3690;1101;3595;105;446;778;2523;883;2969
240960;201402;778;2494;715;2367;76;312;522;1704;598;2016
240970;201402;2043;5828;1751;5331;165;597;1204;3639;1369;4236
240980;201402;3317;11064;3117;10685;714;2685;1820;6225;2534;8910
240990;201402;3062;9252;2883;8900;574;2001;1764;5305;2338;7306
241000;201402;1093;3115;966;2895;95;353;691;2036;786;2389
241010;201402;3005;10176;2734;9684;452;1853;1802;6235;2254;8088
241020;201402;2098;6020;1770;5404;185;668;1070;3116;1255;3784
241025;201402;1520;4770;1417;4579;133;560;998;3162;1131;3722
241030;201402;2557;8491;2354;8135;156;576;1887;6619;2043;7195
241040;201402;2142;7567;1981;7275;219;940;1438;5310;1657;6250
241050;201402;1326;3977;1213;3780;107;436;898;2708;1005;3144
241060;201402;996;2901;914;2769;116;368;676;2060;792;2428
241070;201402;916;2681;803;2474;98;366;552;1642;650;2008
241080;201402;1175;3560;1046;3331;85;362;719;2214;804;2576
241090;201402;2182;6343;1892;5830;130;542;1517;4614;1647;5156
241100;201402;1219;3676;1077;3352;101;360;741;2268;842;2628
241105;201402;1151;3546;1098;3452;198;670;654;2125;852;2795
241110;201402;855;2754;730;2490;88;383;431;1433;519;1816
241120;201402;7983;24318;7301;23236;1492;4868;4717;15400;6209;20268
241140;201402;3445;9808;3085;9100;426;1316;2022;5899;2448;7215
241142;201402;699;2113;508;1698;148;566;132;394;280;960
241150;201402;5774;17555;5337;16808;909;3026;3460;11023;4369;14049
241160;201402;1111;3274;1052;3163;167;551;709;2129;876;2680
241170;201402;1360;4032;1253;3829;158;539;771;2449;929;2988
241180;201402;1013;2794;812;2432;112;380;466;1340;578;1720
241190;201402;1066;3015;928;2747;84;330;624;1728;708;2058
241200;201402;20730;62799;19315;60519;5286;17752;9492;30257;14778;48009
241210;201402;1497;4461;1284;4037;279;977;614;1911;893;2888
241220;201402;7956;27127;7627;26504;1841;6820;4115;14636;5956;21456
241230;201402;3036;9247;2776;8873;217;837;2213;7031;2430;7868
241240;201402;1123;3296;870;2748;75;246;503;1644;578;1890
241250;201402;5512;17690;4849;16371;325;1584;3884;12783;4209;14367
241255;201402;1865;7172;1776;6972;492;2011;777;3193;1269;5204
241260;201402;5008;13687;4090;12250;342;1294;2859;8387;3201;9681
241270;201402;2061;6242;1819;5777;263;951;1033;3300;1296;4251
241280;201402;2150;6326;2011;6052;387;1206;1239;3812;1626;5018
241290;201402;3290;9189;2677;8223;496;1646;1551;4768;2047;6414
241300;201402;1412;4153;1280;3940;79;280;1004;3114;1083;3394
241310;201402;1536;4896;1465;4783;222;708;1027;3469;1249;4177
241320;201402;909;3073;848;2943;171;656;455;1599;626;2255
241330;201402;1537;4908;1447;4785;158;621;1158;3790;1316;4411
241335;201402;2610;8154;2483;7931;208;656;2053;6613;2261;7269
241340;201402;1954;6140;1764;5740;459;1647;825;2616;1284;4263
241350;201402;1950;6311;1840;6097;169;721;1389;4474;1558;5195
241355;201402;1276;3613;1138;3375;69;233;980;2873;1049;3106
241360;201402;2114;5921;1887;5487;144;514;1356;3782;1500;4296
241370;201402;1345;4202;1104;3686;196;706;568;1884;764;2590
241380;201402;726;2110;635;1925;98;357;342;1024;440;1381
241390;201402;2922;9889;2779;9619;649;2347;1620;5758;2269;8105
241400;201402;3662;10988;3443;10684;428;1549;2591;8009;3019;9558
241410;201402;2655;7981;2436;7676;449;1550;1634;5121;2083;6671
241415;201402;1591;4929;1482;4731;136;521;1080;3390;1216;3911
241420;201402;2198;7761;1945;7336;598;2523;738;2750;1336;5273
241430;201402;468;1439;421;1325;52;185;278;841;330;1026
241440;201402;5965;22037;5621;21444;990;4002;3926;15121;4916;19123
241445;201402;1035;3244;981;3164;159;453;736;2517;895;2970
241450;201402;3264;9238;3024;8901;466;1535;2131;6209;2597;7744
241460;201402;3565;10539;3205;9840;288;1087;2289;6934;2577;8021
241470;201402;1346;3855;1174;3642;136;541;862;2596;998;3137
241475;201402;1236;3905;1094;3643;68;325;782;2537;850;2862
241480;201402;3246;10676;2977;10266;995;3558;1114;4201;2109;7759
241490;201402;636;1730;526;1561;55;226;361;1010;416;1236
241500;201402;731;2360;714;2338;11;47;676;2221;687;2268
250010;201402;2676;8590;2378;8076;231;985;1724;5723;1955;6708
250020;201402;1681;4881;1316;4218;115;484;860;2661;975;3145
250030;201402;7904;22928;7195;21952;916;2868;5337;16682;6253;19550
250040;201402;4495;15353;4188;14760;809;3067;2584;9187;3393;12254
250050;201402;3591;11488;3381;11184;538;1988;2265;7610;2803;9598
250053;201402;1281;3902;1238;3841;194;659;817;2535;1011;3194
250057;201402;727;2695;708;2670;43;132;615;2433;658;2565
250060;201402;4912;15784;4737;15492;650;2448;3519;11290;4169;13738
250070;201402;4045;12784;3812;12381;380;1602;3008;9458;3388;11060
250073;201402;778;2384;702;2238;77;282;486;1545;563;1827
250077;201402;2253;6674;1906;6119;277;960;1071;3490;1348;4450
250080;201402;4738;13963;4582;13740;588;1874;3358;10105;3946;11979
250090;201402;2623;7962;2538;7827;143;545;2131;6448;2274;6993
250100;201402;3963;13533;3797;13237;456;1779;2868;9978;3324;11757
250110;201402;5736;17633;5496;17293;813;2878;4049;12653;4862;15531
250115;201402;556;1846;495;1707;53;251;299;973;352;1224
250120;201402;2243;6717;1945;6165;183;682;1417;4442;1600;5124
250130;201402;5698;17540;5389;17106;319;1156;4482;14364;4801;15520
250135;201402;1080;3335;992;3181;117;419;686;2223;803;2642
250140;201402;2102;6846;1944;6640;264;929;1430;4987;1694;5916
250150;201402;5057;17219;4676;16518;540;2206;3361;11784;3901;13990
250153;201402;1581;4212;1435;4001;133;462;1106;3061;1239;3523
250157;201402;1620;5726;1498;5465;357;1283;808;3084;1165;4367
250160;201402;3313;10462;3214;10300;220;825;2722;8775;2942;9600
250170;201402;1592;4723;1495;4567;323;1056;915;2838;1238;3894
250180;201402;16629;52601;16125;51747;2607;9751;11023;34381;13630;44132
250190;201402;3967;11933;3695;11470;613;2047;2386;7342;2999;9389
250200;201402;2215;6184;1778;5594;143;519;1459;4562;1602;5081
250205;201402;1005;3371;924;3220;87;409;592;2112;679;2521
250210;201402;1632;5399;1514;5223;187;795;1074;3635;1261;4430
250215;201402;1415;4893;1376;4818;210;857;859;2990;1069;3847
250220;201402;817;2321;683;2152;48;175;582;1817;630;1992
250230;201402;1705;4394;1400;3893;141;441;1077;2918;1218;3359
250240;201402;2653;8541;2355;8081;230;861;1756;6093;1986;6954
250250;201402;4554;13929;4191;13431;398;1373;3346;10815;3744;12188
250260;201402;1908;5877;1686;5509;130;518;1266;4123;1396;4641
250270;201402;1277;4107;1178;3981;155;550;886;3029;1041;3579
250280;201402;3793;11515;3512;11060;738;2392;2169;7123;2907;9515
250290;201402;2140;5721;1774;5248;61;228;1550;4576;1611;4804
250300;201402;5462;16280;5175;15922;622;2564;4062;11953;4684;14517
250310;201402;1151;3710;1047;3536;162;657;746;2484;908;3141
250320;201402;7939;25292;7573;24529;1192;4416;4975;15673;6167;20089
250330;201402;2562;8138;2246;7707;265;1045;1674;5700;1939;6745
250340;201402;1133;3300;1060;3190;57;207;890;2673;947;2880
250350;201402;4545;12478;4157;11997;188;657;3589;10464;3777;11121
250355;201402;2127;6523;1941;6235;122;520;1504;4763;1626;5283
250360;201402;2038;6145;1900;5950;116;441;1482;4660;1598;5101
250370;201402;13638;38892;11916;36824;896;2867;10218;31883;11114;34750
250375;201402;1098;3491;1041;3393;66;266;864;2819;930;3085
250380;201402;1660;4751;1579;4649;103;359;1368;4008;1471;4367
250390;201402;1958;5298;1629;4752;215;686;1074;3143;1289;3829
250400;201402;67390;190281;60809;180729;14981;47651;32551;98463;47532;146114
250403;201402;1507;5080;1457;5005;212;808;1064;3616;1276;4424
250407;201402;1165;3392;1014;3133;65;231;794;2414;859;2645
250410;201402;681;2181;600;2035;67;289;450;1500;517;1789
250415;201402;1842;5852;1701;5569;103;441;1292;4143;1395;4584
250420;201402;1313;4132;1223;3989;101;411;1006;3211;1107;3622
250430;201402;6598;18611;6254;18111;510;1791;5070;14386;5580;16177
250435;201402;1635;5014;1475;4716;181;688;887;2903;1068;3591
250440;201402;4570;13734;4360;13451;281;1015;3676;11329;3957;12344
250450;201402;2087;5942;1865;5647;99;365;1650;4973;1749;5338
250460;201402;6293;19332;5888;18777;794;2728;4359;14059;5153;16787
250470;201402;1605;4462;1467;4266;144;520;1065;3028;1209;3548
250480;201402;3980;11992;3602;11450;170;682;3122;9871;3292;10553
250485;201402;619;1658;524;1499;27;104;413;1135;440;1239
250490;201402;4173;13560;4078;13422;807;2866;2653;8799;3460;11665
250500;201402;1912;5909;1792;5705;352;1177;1075;3492;1427;4669
250510;201402;4961;13985;4398;13211;316;1153;3563;10640;3879;11793
250520;201402;1874;5859;1786;5706;352;1282;1016;3156;1368;4438
250523;201402;1800;5749;1714;5631;247;858;1260;4203;1507;5061
250527;201402;1472;4488;1386;4376;58;258;1238;3858;1296;4116
250530;201402;675;2089;597;1988;51;199;484;1615;535;1814
250535;201402;1302;4219;1245;4103;85;365;1001;3222;1086;3587
250540;201402;2483;7355;2334;7190;86;280;2129;6610;2215;6890
250550;201402;913;3042;843;2931;72;308;636;2177;708;2485
250560;201402;1750;5696;1713;5642;140;526;1441;4743;1581;5269
250570;201402;2508;8328;2284;7893;212;867;1703;5825;1915;6692
250580;201402;1117;3171;933;2866;135;527;618;1812;753;2339
250590;201402;1050;3244;951;3113;82;352;738;2367;820;2719
250600;201402;7851;22729;7490;22202;744;2225;5925;17802;6669;20027
250610;201402;3398;10179;3179;9850;401;1366;2266;7017;2667;8383
250620;201402;867;2540;806;2420;135;436;518;1543;653;1979
250625;201402;2161;7116;2127;7070;83;225;1959;6608;2042;6833
250630;201402;10339;33706;9846;32841;2298;8274;5326;17789;7624;26063
250640;201402;3892;11585;3648;11299;297;1171;3029;9218;3326;10389
250650;201402;912;2727;865;2638;165;616;450;1394;615;2010
250660;201402;2171;5280;1672;4685;30;77;1575;4438;1605;4515
250670;201402;2701;9173;2567;8924;279;1165;1839;6379;2118;7544
250680;201402;4987;14378;4747;14038;278;1004;4034;11898;4312;12902
250690;201402;6334;17094;6128;16818;642;1977;5111;13845;5753;15822
250700;201402;5344;16175;5009;15681;794;2771;3440;10628;4234;13399
250710;201402;4573;14732;4222;14271;669;2326;2914;10172;3583;12498
250720;201402;2550;7823;2439;7633;162;644;1990;6168;2152;6812
250730;201402;3655;11518;3511;11296;484;1769;2488;7947;2972;9716
250740;201402;2019;6079;1778;5664;219;777;1231;3879;1450;4656
250750;201402;102323;306569;97221;298840;19076;64897;61636;186723;80712;251620
250760;201402;2243;6733;2089;6497;214;828;1539;4713;1753;5541
250770;201402;3894;13542;3716;13299;814;3138;2203;7940;3017;11078
250780;201402;1893;5756;1658;5326;190;755;1105;3465;1295;4220
250790;201402;2470;8145;2341;7960;621;2090;1417;4985;2038;7075
250800;201402;2722;8017;2413;7508;177;647;1811;5508;1988;6155
250810;201402;1365;4064;1192;3813;123;497;938;2931;1061;3428
250820;201402;2015;6293;1967;6217;113;416;1636;5227;1749;5643
250830;201402;5911;19757;5646;19231;753;3060;3825;12775;4578;15835
250840;201402;1041;3347;912;3083;120;461;575;1941;695;2402
250850;201402;2438;7108;2186;6702;202;805;1414;4483;1616;5288
250855;201402;1094;3291;1038;3204;68;245;855;2603;923;2848
250860;201402;2882;9907;2679;9510;647;2518;1157;4110;1804;6628
250870;201402;1202;3487;1043;3233;80;306;748;2242;828;2548
250880;201402;1384;4099;1298;3979;128;424;1007;3099;1135;3523
250890;201402;9349;30449;8725;29581;1584;6313;5604;18666;7188;24979
250900;201402;3072;10262;2753;9666;314;1141;1912;6838;2226;7979
250905;201402;2105;6654;2013;6532;349;1183;1428;4676;1777;5859
250910;201402;5385;15909;5051;15402;527;1767;3819;11677;4346;13444
250915;201402;1739;5204;1597;4992;152;476;1299;4134;1451;4610
250920;201402;3539;10174;3342;9904;452;1326;2357;7241;2809;8567
250930;201402;1950;6428;1872;6302;360;1407;1244;4106;1604;5513
250933;201402;1193;3876;1150;3808;140;532;821;2722;961;3254
250937;201402;872;2724;785;2547;113;453;465;1500;578;1953
250939;201402;1711;5408;1558;5158;247;884;1005;3340;1252;4224
250940;201402;3968;11745;3709;11342;260;935;2918;8961;3178;9896
250950;201402;1363;4263;1251;4124;75;264;1033;3454;1108;3718
250960;201402;1351;4252;1206;4059;74;276;1011;3455;1085;3731
250970;201402;8948;24729;8085;23548;1315;3958;5410;15890;6725;19848
250980;201402;2674;8232;2475;7883;267;1078;1717;5282;1984;6360
250990;201402;2113;7435;2003;7212;292;1240;1363;4809;1655;6049
251000;201402;2573;7381;2123;6741;133;508;1690;5338;1823;5846
251010;201402;2857;8328;2615;7979;217;782;2038;6244;2255;7026
251020;201402;1659;5131;1542;4985;155;555;1254;4100;1409;4655
251030;201402;1319;3750;1203;3556;130;455;762;2256;892;2711
251040;201402;1940;6225;1758;5947;181;852;1256;4087;1437;4939
251050;201402;1137;3403;1012;3187;159;542;549;1808;708;2350
251060;201402;1052;2588;855;2341;86;312;645;1681;731;1993
251065;201402;590;1771;519;1663;77;280;312;960;389;1240
251070;201402;599;1743;573;1702;54;223;449;1254;503;1477
251080;201402;21364;60136;20046;57955;5419;16673;10569;30900;15988;47573
251090;201402;3059;9751;2746;9179;311;1193;1954;6471;2265;7664
251100;201402;1003;3284;902;3105;133;532;587;1966;720;2498
251110;201402;2125;6198;1918;5861;224;763;1316;4028;1540;4791
251120;201402;5997;20641;5829;20348;821;3392;4481;15321;5302;18713
251130;201402;3985;10447;3581;9998;46;146;3446;9633;3492;9779
251140;201402;4360;13662;4081;13228;259;1053;3148;10175;3407;11228
251150;201402;2826;9327;2622;9047;341;1381;1906;6637;2247;8018
251160;201402;1888;6309;1818;6216;98;392;1597;5481;1695;5873
251170;201402;1425;4461;1383;4408;136;516;1121;3514;1257;4030
251180;201402;2927;8841;2699;8549;629;2089;1548;5006;2177;7095
251190;201402;4322;12593;4201;12449;284;894;3699;10999;3983;11893
251200;201402;4240;13152;4044;12899;249;910;3499;11195;3748;12105
251203;201402;1334;4239;1248;4055;112;471;757;2559;869;3030
251207;201402;1244;3927;1084;3630;89;379;756;2476;845;2855
251210;201402;8096;23499;7149;22203;1049;3262;5091;16199;6140;19461
251220;201402;1299;3545;1142;3297;177;541;712;2129;889;2670
251230;201402;5203;15869;4605;15164;453;1705;3830;12572;4283;14277
251240;201402;3165;10505;3089;10389;332;1335;2420;8040;2752;9375
251250;201402;10438;31820;9784;30788;1661;5733;6668;20776;8329;26509
251260;201402;540;1669;488;1602;41;146;365;1201;406;1347
251270;201402;4180;13095;3973;12837;160;682;3565;11488;3725;12170
251272;201402;1383;4251;1301;4135;122;405;1018;3300;1140;3705
251274;201402;1000;3190;951;3095;129;525;550;1841;679;2366
251275;201402;1400;3993;1331;3887;140;532;984;2770;1124;3302
251276;201402;1502;4509;1426;4372;219;737;859;2719;1078;3456
251278;201402;625;2023;547;1837;85;321;315;1104;400;1425
251280;201402;2315;7444;2238;7308;297;1098;1632;5310;1929;6408
251290;201402;6058;17576;5779;17222;891;3055;4046;11771;4937;14826
251300;201402;759;2621;704;2540;68;316;497;1754;565;2070
251310;201402;3233;9578;2984;9216;222;859;2383;7286;2605;8145
251315;201402;1709;6102;1665;6018;317;1238;996;3663;1313;4901
251320;201402;2148;6078;1792;5508;138;506;1282;4004;1420;4510
251330;201402;2063;5397;1716;4947;114;476;1442;3999;1556;4475
251335;201402;999;3476;959;3404;110;462;691;2419;801;2881
251340;201402;3926;11033;3354;10161;334;1279;2354;6953;2688;8232
251350;201402;1626;5057;1484;4860;256;928;956;3153;1212;4081
251360;201402;1837;6048;1744;5943;124;508;1466;5024;1590;5532
251365;201402;900;2679;730;2318;65;260;474;1475;539;1735
251370;201402;22194;75717;21797;75068;4194;16181;14853;50209;19047;66390
251380;201402;1395;4338;1228;4048;95;412;950;3053;1045;3465
251385;201402;870;2456;799;2340;78;289;541;1530;619;1819
251390;201402;5760;20744;5458;20259;1024;4129;3643;13469;4667;17598
251392;201402;1071;3179;996;3056;115;373;709;2219;824;2592
251394;201402;619;1924;522;1733;36;146;365;1204;401;1350
251396;201402;872;2531;797;2400;92;310;590;1745;682;2055
251398;201402;1135;3313;949;2963;87;331;643;1982;730;2313
251400;201402;1367;3946;1258;3796;155;607;873;2533;1028;3140
251410;201402;1622;4295;1478;4056;166;521;994;2774;1160;3295
251420;201402;2200;6388;1892;6045;190;707;1427;4516;1617;5223
251430;201402;1732;6214;1579;5968;119;533;1284;4863;1403;5396
251440;201402;1464;4451;1250;4040;169;628;862;2754;1031;3382
251445;201402;1575;4950;1505;4845;126;501;1245;3950;1371;4451
251450;201402;4834;15276;4335;14638;174;730;3762;12718;3936;13448
251455;201402;1217;3818;1081;3595;86;372;761;2522;847;2894
251460;201402;880;2748;848;2692;148;479;624;2006;772;2485
251465;201402;500;1581;458;1493;52;208;292;932;344;1140
251470;201402;1303;3768;1082;3356;137;522;618;1925;755;2447
251480;201402;1129;3098;1024;2923;62;238;821;2302;883;2540
251490;201402;2097;6220;1827;5853;305;1152;1154;3614;1459;4766
251500;201402;1751;5839;1706;5768;208;815;1293;4320;1501;5135
251510;201402;2603;8760;2434;8400;431;1605;1445;5043;1876;6648
251520;201402;1100;3055;1008;2914;153;475;541;1574;694;2049
251530;201402;11937;35294;11469;34612;819;3131;9714;28822;10533;31953
251540;201402;2848;9454;2643;9012;277;1173;1954;6612;2231;7785
251550;201402;4000;10002;3393;9243;181;629;2759;7315;2940;7944
251560;201402;750;2328;694;2236;112;467;413;1199;525;1666
251570;201402;1049;3135;905;2844;115;444;564;1800;679;2244
251580;201402;2204;6085;2038;5857;346;935;1467;4336;1813;5271
251590;201402;1698;5665;1677;5642;116;415;1447;4943;1563;5358
251593;201402;1026;3272;972;3188;151;565;614;1948;765;2513
251597;201402;1947;6094;1870;5976;188;736;1421;4434;1609;5170
251600;201402;7345;21860;7013;21322;957;3000;5070;15770;6027;18770
251610;201402;3644;11022;3379;10679;367;1258;2551;8153;2918;9411
251615;201402;1217;3542;1046;3237;116;421;656;2084;772;2505
251620;201402;17437;49927;15483;47452;2376;7742;10901;33886;13277;41628
251630;201402;5375;13729;4731;12943;396;1132;3722;10302;4118;11434
251640;201402;2681;7865;2200;6997;256;974;1506;4733;1762;5707
251650;201402;4374;12503;3950;11977;335;1139;3203;9857;3538;10996
251660;201402;3594;12148;3320;11728;272;1280;2657;9196;2929;10476
251670;201402;4027;11841;3633;11301;145;491;3166;9870;3311;10361
251675;201402;755;2541;721;2484;172;640;387;1305;559;1945
251680;201402;2883;8091;2356;7314;144;614;1920;5843;2064;6457
251690;201402;3449;10894;3210;10466;402;1464;2183;7065;2585;8529
251700;201402;2091;6957;1990;6820;218;851;1557;5319;1775;6170
251710;201402;949;2505;726;2116;98;357;375;1031;473;1388
251720;201402;1396;4346;1293;4174;118;481;986;3124;1104;3605
251740;201402;743;2112;604;1865;118;397;330;1035;448;1432
260005;201402;24982;62233;22235;58561;4949;13520;13301;35163;18250;48683
260010;201402;9614;26493;7795;24231;841;2796;5909;18421;6750;21217
260020;201402;5804;17288;5193;16367;630;1977;3722;12222;4352;14199
260030;201402;5401;16448;5013;15876;536;1885;3844;12165;4380;14050
260040;201402;10220;24855;8495;22892;610;1454;7024;19600;7634;21054
260050;201402;10870;35637;10162;34836;672;2473;8842;30662;9514;33135
260060;201402;4084;11418;3767;10916;345;1045;2932;8596;3277;9641
260070;201402;9436;29052;9024;28458;2267;7774;5315;16768;7582;24542
260080;201402;5461;15952;4886;15117;593;2094;3429;10507;4022;12601
260090;201402;5240;14503;4964;14127;1094;2925;3282;9781;4376;12706
260100;201402;3513;9470;3240;9106;245;907;2592;7314;2837;8221
260105;201402;4516;13691;4368;13418;877;2896;2748;8373;3625;11269
260110;201402;21706;64652;20122;62755;1595;4939;16921;53510;18516;58449
260120;201402;11597;36140;11143;35342;3171;10371;5486;18159;8657;28530
260130;201402;3117;9056;2974;8827;525;1425;2030;6281;2555;7706
260140;201402;13438;34943;11508;32568;1254;4050;8673;24825;9927;28875
260150;201402;3132;9220;2798;8736;237;890;2170;6821;2407;7711
260160;201402;5994;18268;5443;17621;489;1720;4426;14584;4915;16304
260170;201402;17636;48859;16964;47981;1541;4122;13837;39856;15378;43978
260180;201402;3478;10816;3198;10416;239;962;2598;8386;2837;9348
260190;201402;16056;39041;15232;38012;986;2683;13043;32566;14029;35249
260200;201402;11298;32994;10340;31561;1265;4064;7377;23357;8642;27421
260210;201402;11375;35728;10562;34571;787;2888;8678;28745;9465;31633
260220;201402;9026;28768;8832;28483;788;3213;7401;23375;8189;26588
260230;201402;9733;29077;9300;28480;680;2199;7639;23837;8319;26036
260240;201402;2932;9306;2611;8853;409;1472;1782;6106;2191;7578
260250;201402;2773;7510;2563;7247;189;524;2145;6160;2334;6684
260260;201402;11456;33867;11216;33567;939;3125;9298;28363;10237;31488
260270;201402;3544;10851;3349;10564;416;1566;2593;8050;3009;9616
260280;201402;12680;42633;11733;41135;829;3245;9696;34414;10525;37659
260290;201402;33789;103610;32782;102002;5968;21084;21920;66801;27888;87885
260300;201402;8393;25830;7506;24541;647;2539;5855;19211;6502;21750
260310;201402;5123;15507;4832;15060;1558;4579;2321;7853;3879;12432
260320;201402;6818;23259;6390;22640;552;2125;5101;18311;5653;20436
260330;201402;3121;9771;2896;9393;275;1102;1917;6437;2192;7539
260340;201402;1883;5611;1792;5484;117;426;1554;4714;1671;5140
260345;201402;25957;86380;25034;84549;7633;28073;11346;36962;18979;65035
260350;201402;4419;12861;4202;12519;457;1550;3156;9381;3613;10931
260360;201402;2377;7548;2285;7398;566;1958;1229;4061;1795;6019
260370;201402;6053;18925;5535;18002;768;2591;3898;12954;4666;15545
260380;201402;4980;16445;4646;16027;435;1491;3711;13050;4146;14541
260390;201402;4747;14985;4161;14082;503;1952;2959;9859;3462;11811
260392;201402;3503;11184;3326;10950;181;719;2927;9588;3108;10307
260400;201402;13745;41074;13262;40297;2689;9218;8623;25589;11312;34807
260410;201402;62498;187114;59536;182226;20162;62686;26921;85311;47083;147997
260415;201402;4047;13195;3569;12271;551;2256;2135;7266;2686;9522
260420;201402;12044;28451;11034;27375;759;2125;9267;22982;10026;25107
260430;201402;2704;9165;2487;8819;262;1082;1872;6570;2134;7652
260440;201402;3400;10579;3187;10165;566;2027;1894;5936;2460;7963
260450;201402;5057;15721;4822;15316;439;1564;3757;11978;4196;13542
260460;201402;5844;18199;5524;17720;930;3323;3558;11270;4488;14593
260470;201402;5080;14887;4796;14496;510;1640;3726;11493;4236;13133
260480;201402;3875;11507;3493;10932;639;2168;2303;7175;2942;9343
260490;201402;6058;15985;5356;14876;701;2345;3547;9814;4248;12159
260500;201402;6779;18949;6307;18282;731;2255;4616;13610;5347;15865
260510;201402;10399;27702;9727;26796;840;2469;7609;21617;8449;24086
260515;201402;4604;14558;3657;12568;431;1665;2199;7632;2630;9297
260520;201402;15958;43606;15528;43048;3654;9638;9948;28753;13602;38391
260530;201402;10296;30866;9085;29215;530;1609;7851;25793;8381;27402
260540;201402;5792;15257;5526;14966;700;1638;4357;12232;5057;13870
260545;201402;42;162;29;119;4;19;6;23;10;42
260550;201402;2828;9601;2532;9036;674;2694;1148;4064;1822;6758
260560;201402;6760;17548;6105;16619;338;925;5303;14484;5641;15409
260570;201402;6623;22846;6210;22122;1068;4238;4166;14918;5234;19156
260580;201402;3926;11021;3730;10731;340;1087;3072;8703;3412;9790
260590;201402;5871;15364;5667;15127;279;674;5133;13913;5412;14587
260600;201402;25897;81650;24672;79570;4778;16506;15427;50372;20205;66878
260610;201402;7087;21356;6772;20921;1287;4207;4647;14410;5934;18617
260620;201402;17349;54366;16768;53399;3357;11970;10521;32778;13878;44748
260630;201402;2297;6944;1995;6451;229;890;1437;4602;1666;5492
260640;201402;17507;48390;16668;47180;2385;7349;11937;33690;14322;41039
260650;201402;5568;17826;5305;17386;796;2623;3478;12222;4274;14845
260660;201402;8279;23596;7513;22609;647;2054;6128;18649;6775;20703
260670;201402;2405;6937;2053;6460;284;1026;1355;4287;1639;5313
260680;201402;23465;64551;22205;62475;5109;15448;12143;33759;17252;49207
260690;201402;3565;9985;3113;9273;240;885;2453;7218;2693;8103
260700;201402;5547;16560;5438;16447;90;202;5247;16068;5337;16270
260710;201402;1307;4060;1197;3899;143;569;882;2818;1025;3387
260720;201402;17428;57662;16624;56224;4692;16327;8445;29416;13137;45743
260730;201402;7362;24502;6646;23458;890;3300;4881;17491;5771;20791
260740;201402;1360;4190;1204;3917;174;613;738;2441;912;3054
260750;201402;6747;21846;6361;21315;584;1937;5259;17998;5843;19935
260760;201402;4730;13386;4459;13035;533;1659;3331;9827;3864;11486
260765;201402;7929;28379;7712;28067;1553;6456;4874;17696;6427;24152
260770;201402;4301;11291;3949;10827;245;882;3173;8519;3418;9401
260775;201402;5301;15529;5032;15121;621;2231;3552;10373;4173;12604
260780;201402;3961;13225;3838;13000;925;3481;2157;7268;3082;10749
260790;201402;119237;310981;115101;305073;26766;74860;68395;181196;95161;256056
260795;201402;3037;9868;2854;9580;488;1763;1878;6422;2366;8185
260800;201402;4744;13093;4425;12667;248;991;3793;10574;4041;11565
260805;201402;4125;12147;3731;11538;591;1974;2482;7702;3073;9676
260810;201402;7421;21605;7240;21370;465;1650;6289;18445;6754;20095
260820;201402;4588;13397;4316;13024;1352;4156;2248;6869;3600;11025
260825;201402;3065;9958;2903;9723;304;1034;2325;7888;2629;8922
260830;201402;3680;12074;3432;11629;1028;3329;1839;6589;2867;9918
260840;201402;4204;12412;3896;11970;261;998;3290;10025;3551;11023
260845;201402;4193;12596;3919;12063;705;2335;2544;7832;3249;10167
260850;201402;4941;17115;4531;16236;1156;4748;2143;7443;3299;12191
260860;201402;3009;9998;2815;9677;349;1224;2031;7106;2380;8330
260870;201402;4165;11768;3805;11320;585;1643;2724;8376;3309;10019
260875;201402;7418;19992;6750;18962;1053;3063;4374;12667;5427;15730
260880;201402;8970;28873;8594;28339;1038;3497;6724;22484;7762;25981
260890;201402;14938;43218;14357;42364;1636;5526;10683;31548;12319;37074
260900;201402;6101;19061;5295;17701;1028;3644;3087;10487;4115;14131
260910;201402;3073;9512;2802;9099;305;1158;2140;6940;2445;8098
260915;201402;4555;15282;4430;15107;111;362;4121;14284;4232;14646
260920;201402;3502;10701;3334;10474;527;1833;2366;7579;2893;9412
260930;201402;4153;13314;3737;12733;535;1833;2637;9211;3172;11044
260940;201402;14209;40550;13202;38785;2552;8827;7446;21293;9998;30120
260950;201402;6107;19864;5840;19337;879;3711;3786;11767;4665;15478
260960;201402;67532;190556;64288;185384;14006;43234;36689;106590;50695;149824
260970;201402;5351;17603;5035;17127;662;2640;3594;12148;4256;14788
260980;201402;4003;12847;3827;12616;261;980;3190;10680;3451;11660
260990;201402;18059;56818;16784;55116;2421;7721;12068;41517;14489;49238
261000;201402;15265;44018;12713;39868;2844;9535;6664;21347;9508;30882
261010;201402;2807;7898;2634;7677;244;538;2190;6718;2434;7256
261020;201402;6219;18671;5754;17979;462;1747;4600;14008;5062;15755
261030;201402;3461;11573;3300;11305;336;1249;2603;8892;2939;10141
261040;201402;5393;17618;4706;16526;600;2422;3355;11748;3955;14170
261050;201402;8721;24953;8188;24126;1300;4003;5313;15650;6613;19653
261060;201402;11334;35535;10946;34886;1860;6585;7624;23950;9484;30535
261070;201402;48989;128566;44877;122920;10593;30358;25049;69522;35642;99880
261080;201402;5740;17791;5456;17326;455;1455;4498;14549;4953;16004
261090;201402;16157;45887;15190;44568;1658;5085;11929;35297;13587;40382
261100;201402;7303;23610;6820;22871;617;2499;5324;17746;5941;20245
261110;201402;66811;193629;61418;185870;15672;48838;32890;105149;48562;153987
261120;201402;3634;10039;3338;9669;155;474;2926;8564;3081;9038
261130;201402;7091;18577;6803;18255;282;774;6184;16599;6466;17373
261140;201402;3230;9262;3000;8901;640;2106;1779;5212;2419;7318
261150;201402;5553;16909;5028;16171;675;2442;3576;11629;4251;14071
261153;201402;1974;5745;1679;5336;111;433;1379;4399;1490;4832
261160;201402;224123;591589;214762;579040;47712;132683;126809;351165;174521;483848
261170;201402;6024;17073;5628;16503;918;2767;4070;12055;4988;14822
261180;201402;9504;27346;9222;26947;1199;3631;6989;20627;8188;24258
261190;201402;5413;17268;5168;16952;815;3535;3553;11007;4368;14542
261200;201402;3929;9788;3717;9509;620;1619;2571;6653;3191;8272
261210;201402;1941;5268;1872;5177;153;423;1595;4473;1748;4896
261220;201402;12584;41748;11185;38673;2189;8355;6016;20655;8205;29010
261230;201402;4058;12741;3842;12471;177;619;3449;11237;3626;11856
261240;201402;4888;14644;4657;14220;837;2509;3148;9805;3985;12314
261245;201402;3860;12235;3369;11411;261;1135;2449;8350;2710;9485
261247;201402;3518;11025;3082;10224;430;1506;2085;6999;2515;8505
261250;201402;19409;52751;18751;51879;3479;9906;13691;38046;17170;47952
261255;201402;4378;13505;3947;12801;332;1216;3048;10034;3380;11250
261260;201402;12207;35445;11276;34362;674;1860;9873;30709;10547;32569
261270;201402;3827;11178;3586;10810;513;1700;2486;7469;2999;9169
261280;201402;2744;8567;2513;8232;280;1045;1851;6056;2131;7101
261290;201402;3001;8709;2710;8336;241;839;2193;6824;2434;7663
261300;201402;10280;35054;9382;33503;1700;6851;5862;20798;7562;27649
261310;201402;8471;25989;8103;25376;1895;6284;4723;14803;6618;21087
261320;201402;5933;18766;5614;18150;688;2221;4116;13652;4804;15873
261330;201402;5486;16560;5343;16351;504;1636;4278;13162;4782;14798
261340;201402;4575;15096;4387;14809;685;2687;2846;9627;3531;12314
261350;201402;7975;27382;7598;26723;656;2839;5949;20710;6605;23549
261360;201402;9482;24759;8690;23693;1262;3577;5957;16579;7219;20156
261370;201402;20904;62942;19863;61404;3954;12979;12848;39949;16802;52928
261380;201402;4155;14529;3892;14084;627;2322;2618;9774;3245;12096
261390;201402;17094;53238;15761;50953;2786;9977;9507;30531;12293;40508
261400;201402;4850;17166;4472;16427;631;2625;3003;11126;3634;13751
261410;201402;8166;24479;7764;23851;1097;3525;5559;17397;6656;20922
261420;201402;7948;26966;7707;26605;2014;7641;4363;15270;6377;22911
261430;201402;3608;11257;3090;10576;420;1449;2239;7880;2659;9329
261440;201402;1659;5113;1552;4946;122;491;1247;3937;1369;4428
261450;201402;14139;41622;13776;41139;1068;3376;12007;35882;13075;39258
261460;201402;8504;24697;7980;23967;837;2400;5882;19059;6719;21459
261470;201402;3952;10855;3645;10501;235;770;3108;8915;3343;9685
261480;201402;3446;12760;3235;12375;423;1780;2373;8955;2796;10735
261485;201402;4926;15465;4591;14883;1050;3683;2507;8213;3557;11896
261500;201402;5934;16560;5316;15737;764;2059;3923;12206;4687;14265
261510;201402;2036;6548;1922;6383;167;578;1515;5083;1682;5661
261520;201402;2593;8560;2312;8069;203;824;1620;5674;1823;6498
261530;201402;12443;40809;11133;38287;2502;9619;5259;18046;7761;27665
261540;201402;7344;23963;7121;23574;1612;5146;4630;15870;6242;21016
261550;201402;3461;10554;3327;10361;461;1804;2539;7608;3000;9412
261560;201402;6875;22598;6343;21913;1377;4669;4247;15237;5624;19906
261570;201402;3524;11112;3219;10639;477;1636;2200;7388;2677;9024
261580;201402;5872;18947;5264;17966;465;1758;4158;14479;4623;16237
261590;201402;2850;8026;2522;7577;346;1116;1748;5351;2094;6467
261600;201402;5132;14518;4428;13521;521;1698;3260;10065;3781;11763
261610;201402;2306;7097;2026;6694;157;639;1656;5391;1813;6030
261618;201402;2566;7414;2429;7231;289;937;1869;5523;2158;6460
261620;201402;4568;14180;4350;13850;470;1590;3168;10304;3638;11894
261630;201402;8123;24116;7224;22541;1378;4936;4001;12185;5379;17121
261640;201402;32906;86815;30583;83885;2625;7463;24846;69302;27471;76765
261650;201402;3810;12325;3592;12003;501;1890;2655;8889;3156;10779
270010;201402;4445;17139;4091;16422;523;2423;2792;11233;3315;13656
270020;201402;3924;12201;3687;11830;544;2043;2644;8315;3188;10358
270030;201402;45160;138030;43277;135172;11870;38021;23974;76861;35844;114882
270040;201402;10359;32416;9940;31943;1665;4895;7372;24631;9037;29526
270050;201402;3996;11777;3715;11402;440;1639;2779;8401;3219;10040
270060;201402;1601;5481;1546;5397;381;1460;906;3155;1287;4615
270070;201402;4139;13002;3900;12660;173;781;3397;10883;3570;11664
270080;201402;1290;4137;1168;3956;257;966;698;2332;955;3298
270090;201402;2064;6587;2016;6527;59;237;1893;6116;1952;6353
270100;201402;6439;20345;6179;19999;1372;4723;3954;12756;5326;17479
270110;201402;3426;9862;3171;9565;586;1837;2003;6488;2589;8325
270120;201402;3047;9032;2761;8644;153;585;2345;7379;2498;7964
270130;201402;5049;16002;4818;15727;651;2064;3701;12485;4352;14549
270135;201402;1718;4987;1644;4903;97;196;1480;4554;1577;4750
270140;201402;9382;24511;8388;23236;879;3472;6474;16775;7353;20247
270150;201402;2630;9214;2571;9137;230;944;2164;7657;2394;8601
270160;201402;4959;16944;4602;16496;337;1212;3837;13925;4174;15137
270170;201402;4019;13423;3722;12973;811;3220;1993;6887;2804;10107
270180;201402;2234;7553;2013;7274;179;819;1594;5712;1773;6531
270190;201402;1898;6355;1816;6230;156;602;1423;4926;1579;5528
270200;201402;2734;9280;2579;9041;254;1128;2029;6959;2283;8087
270210;201402;4205;14494;4094;14341;488;1998;3311;11529;3799;13527
270220;201402;1709;5419;1595;5197;292;1114;870;2896;1162;4010
270230;201402;11135;36933;9912;35015;1576;6579;6588;22931;8164;29510
270235;201402;6485;21719;6189;21226;371;1628;5259;17966;5630;19594
270240;201402;9730;29592;8690;28222;1620;5555;5703;18670;7323;24225
270250;201402;3457;8979;3167;8653;191;515;2837;7781;3028;8296
270255;201402;5088;15732;4255;14289;429;1837;2965;9763;3394;11600
270260;201402;6312;20567;6152;20285;886;3426;4466;14750;5352;18176
270270;201402;1201;3494;1113;3361;188;604;701;2068;889;2672
270280;201402;3697;11143;3502;10866;458;1722;2480;7511;2938;9233
270290;201402;8318;29723;7952;29073;900;3711;6118;22327;7018;26038
270300;201402;3281;11500;3119;11309;198;878;2744;9930;2942;10808
270310;201402;7210;22757;6559;21622;434;1974;5259;16942;5693;18916
270320;201402;6296;20848;6100;20508;1709;6527;3041;10236;4750;16763
270330;201402;4832;16170;4580;15831;417;1567;3739;13040;4156;14607
270340;201402;1783;5594;1625;5388;214;759;1197;4053;1411;4812
270350;201402;2098;5933;1948;5743;323;974;1264;3981;1587;4955
270360;201402;2098;6601;2054;6548;276;859;1635;5358;1911;6217
270370;201402;1715;5677;1594;5468;191;744;1074;3817;1265;4561
270375;201402;2896;9122;2768;8934;421;1699;1985;6150;2406;7849
270380;201402;6108;18820;5827;18432;613;2000;4470;14458;5083;16458
270390;201402;1442;4024;1304;3852;189;650;878;2514;1067;3164
270400;201402;6124;19105;5676;18471;594;2258;4126;13281;4720;15539
270410;201402;5021;15664;4797;15246;610;2113;3437;10885;4047;12998
270420;201402;5474;18094;5332;17895;295;1374;4531;14952;4826;16326
270430;201402;141380;415417;136020;407972;36513;112428;75033;231881;111546;344309
270440;201402;4992;15653;4748;15284;392;1454;3773;12217;4165;13671
270450;201402;6489;20631;6308;20398;644;2477;4993;16119;5637;18596
270460;201402;3568;10027;3230;9557;274;1032;2578;7444;2852;8476
270470;201402;10776;35394;10342;34634;1662;5646;6816;23546;8478;29192
270480;201402;3092;9973;2872;9582;360;1460;1872;6016;2232;7476
270490;201402;994;3210;940;3129;98;405;701;2288;799;2693
270500;201402;5356;18684;5186;18437;535;1973;4097;14972;4632;16945
270510;201402;6042;18892;5552;18205;945;3976;3929;12197;4874;16173
270520;201402;3705;12121;3504;11796;1013;3664;1738;5945;2751;9609
270530;201402;1542;4610;1377;4395;228;729;918;3050;1146;3779
270540;201402;2037;7171;1887;6947;184;907;1479;5311;1663;6218
270550;201402;7069;21626;6312;20621;1147;3966;4076;13662;5223;17628
270560;201402;2996;9551;2852;9321;565;2135;1891;6019;2456;8154
270570;201402;4324;14334;3992;13826;503;2096;2714;9384;3217;11480
270580;201402;2000;6780;1926;6657;331;1238;1346;4705;1677;5943
270590;201402;1379;4761;1297;4616;101;455;1089;3838;1190;4293
270600;201402;2841;9695;2603;9356;222;1093;2014;7046;2236;8139
270610;201402;3247;10418;3036;10110;340;1218;2344;7799;2684;9017
270620;201402;1471;5029;1341;4834;149;700;1007;3539;1156;4239
270630;201402;18289;51425;17316;49948;2678;7839;12378;36301;15056;44140
270640;201402;5859;18451;5351;17834;452;1908;4352;14248;4804;16156
270642;201402;2482;8582;2330;8337;429;1753;1470;5267;1899;7020
270644;201402;2318;6944;2137;6743;254;727;1737;5631;1991;6358
270650;201402;4019;13019;3880;12828;889;3532;2202;7049;3091;10581
270660;201402;2501;6559;2041;5854;158;571;1448;4078;1606;4649
270670;201402;15467;42962;13668;40785;1813;5781;10013;30570;11826;36351
270680;201402;4140;12855;4019;12712;250;748;3580;11458;3830;12206
270690;201402;8793;25338;8223;24648;2808;8272;3733;12183;6541;20455
270700;201402;803;2537;766;2479;129;513;478;1496;607;2009
270710;201402;5546;18970;5326;18673;697;2495;4137;14730;4834;17225
270720;201402;3311;11543;3085;11155;291;1361;2434;8669;2725;10030
270730;201402;6610;20791;6308;20409;1230;4009;4384;14490;5614;18499
270740;201402;2389;7202;2255;7003;379;1309;1452;4492;1831;5801
270750;201402;4757;15611;4470;15175;583;2069;3361;11526;3944;13595
270760;201402;3564;10804;3252;10291;423;1436;2321;7392;2744;8828
270770;201402;17938;49214;15430;46152;3023;9666;9549;29189;12572;38855
270780;201402;1938;6348;1809;6150;276;1000;1261;4345;1537;5345
270790;201402;1613;5183;1479;4965;404;1475;689;2324;1093;3799
270800;201402;11314;34555;10682;33732;1006;3526;8644;27338;9650;30864
270810;201402;3420;10656;2835;9579;397;1581;1738;5847;2135;7428
270820;201402;1890;6468;1744;6213;294;1196;1132;3998;1426;5194
270830;201402;5350;16669;4915;16106;1221;4513;2821;9241;4042;13754
270840;201402;7399;25882;6826;25130;494;2374;5661;20591;6155;22965
270850;201402;7602;25373;7446;25184;1517;6390;5032;16066;6549;22456
270860;201402;11563;35348;10861;34392;1759;6625;7734;23861;9493;30486
270870;201402;2288;6768;1866;5877;312;1047;1098;3467;1410;4514
270880;201402;7811;25709;7417;25141;538;2301;6207;20754;6745;23055
270890;201402;2649;8225;2470;7926;418;1604;1652;5162;2070;6766
270895;201402;3047;11424;2902;11234;285;1139;2360;9321;2645;10460
270900;201402;1917;5328;1584;4846;106;415;1223;3642;1329;4057
270910;201402;3238;11492;3181;11376;311;1408;2569;8945;2880;10353
270915;201402;9910;34426;9091;32924;1944;8036;5057;18198;7001;26234
270920;201402;6298;20125;5934;19612;309;1431;5143;16817;5452;18248
270930;201402;17129;47332;14310;43822;3138;10227;7963;25151;11101;35378
270940;201402;5836;20037;5668;19830;873;3309;4145;14595;5018;17904
280010;201402;717;2142;633;2006;69;275;405;1269;474;1544
280020;201402;4959;15072;4454;14156;930;3125;2636;8397;3566;11522
280030;201402;72544;195635;65533;185226;16686;50083;33356;95551;50042;145634
280040;201402;3183;10086;2883;9682;367;1272;2133;7369;2500;8641
280050;201402;4122;13421;3865;13034;1112;3834;2030;7164;3142;10998
280060;201402;4237;14505;4098;14271;960;3671;2400;8410;3360;12081
280067;201402;7597;21894;6497;20407;752;2630;4774;14945;5526;17575
280070;201402;1827;6476;1763;6382;345;1328;1185;4345;1530;5673
280100;201402;4033;12833;3661;12162;1018;3558;1711;5822;2729;9380
280110;201402;1407;4312;1300;4139;102;403;1033;3248;1135;3651
280120;201402;7906;25288;7386;24462;1300;4045;4987;17461;6287;21506
280130;201402;7791;22876;7361;22240;1311;4530;4828;14349;6139;18879
280140;201402;5484;15370;4985;14708;616;1848;3773;11303;4389;13151
280150;201402;3338;10569;3088;10113;497;1926;1938;6081;2435;8007
280160;201402;1539;4450;1409;4246;174;615;996;2981;1170;3596
280170;201402;4604;14172;4239;13714;523;1683;3235;10831;3758;12514
280190;201402;1119;3283;1022;3131;108;430;724;2123;832;2553
280200;201402;1096;3487;1032;3382;176;720;720;2266;896;2986
280210;201402;12593;40585;12068;39807;2590;8965;7603;25739;10193;34704
280220;201402;1574;4868;1510;4786;99;385;1305;4118;1404;4503
280230;201402;3856;11421;3478;10787;716;2351;2013;6428;2729;8779
280240;201402;3457;10481;3185;10059;280;846;2491;8011;2771;8857
280250;201402;785;2135;703;2016;122;411;414;1104;536;1515
280260;201402;2056;5489;1888;5282;122;356;1616;4543;1738;4899
280270;201402;2215;7071;1965;6655;148;580;1516;5083;1664;5663
280280;201402;4056;13657;3792;13229;957;2944;2027;7972;2984;10916
280290;201402;16596;54467;15430;52466;2870;10545;10291;35328;13161;45873
280300;201402;10074;30910;9412;30165;867;2899;7772;25262;8639;28161
280310;201402;1442;4140;1289;3907;105;399;915;2696;1020;3095
280320;201402;7725;26171;7238;25312;1461;5764;3784;13222;5245;18986
280330;201402;4563;13256;4324;12952;542;1825;3313;9900;3855;11725
280340;201402;3750;11632;3610;11448;338;1119;2915;9514;3253;10633
280350;201402;21280;63681;20077;61880;3034;9714;14055;44190;17089;53904
280360;201402;5834;18843;5535;18379;1241;4654;3275;10748;4516;15402
280370;201402;1945;5622;1785;5365;211;753;1288;3776;1499;4529
280380;201402;986;3092;920;3003;108;428;701;2242;809;2670
280390;201402;3227;9669;2882;9053;772;2275;1577;5113;2349;7388
280400;201402;4402;12835;4052;12364;899;2653;2526;8092;3425;10745
280410;201402;2374;7865;2166;7481;364;1463;1286;4321;1650;5784
280420;201402;4162;12195;3892;11785;251;809;3341;10198;3592;11007
280430;201402;2179;5934;2063;5790;179;600;1693;4725;1872;5325
280440;201402;5067;15044;4753;14660;488;1559;3870;12080;4358;13639
280445;201402;2442;7079;2266;6777;112;440;1867;5475;1979;5915
280450;201402;8978;24530;8354;23802;772;1876;6940;20501;7712;22377
280460;201402;6891;19106;6222;18191;1092;3348;4207;12576;5299;15924
280470;201402;1802;5497;1648;5265;184;653;1234;3942;1418;4595
280480;201402;30732;94287;29717;92811;5302;19268;19632;59816;24934;79084
280490;201402;3709;11576;3429;11036;438;1584;2497;8010;2935;9594
280500;201402;888;2401;841;2343;34;111;744;2055;778;2166
280510;201402;2740;8132;2380;7654;315;1185;1744;5620;2059;6805
280520;201402;1718;4964;1590;4797;208;572;1209;3806;1417;4378
280530;201402;2077;6503;1983;6376;258;894;1513;4966;1771;5860
280540;201402;9141;25154;8636;24486;337;1162;7710;21728;8047;22890
280550;201402;7114;19434;6406;18319;656;2226;4626;13103;5282;15329
280560;201402;7878;23483;7477;22834;569;1930;6067;18465;6636;20395
280570;201402;6654;18913;6107;18211;916;3172;4197;12350;5113;15522
280580;201402;5637;17361;4911;16161;878;3057;3140;10495;4018;13552
280590;201402;2380;7337;2191;7109;299;1195;1603;5149;1902;6344
280600;201402;4017;12508;3797;12120;402;1563;2732;8568;3134;10131
280610;201402;2329;6921;2212;6746;332;1145;1440;4360;1772;5505
280620;201402;5103;15839;4596;14868;801;2738;2908;9547;3709;12285
280630;201402;3790;12639;3655;12429;371;1138;2928;10386;3299;11524
280640;201402;2248;6476;2104;6310;131;308;1868;5734;1999;6042
280650;201402;1112;3511;1036;3368;183;659;667;2180;850;2839
280660;201402;2615;7758;2518;7599;303;982;2044;6117;2347;7099
280670;201402;15795;42451;15066;41503;1864;5477;11358;31329;13222;36806
280680;201402;2782;7498;2427;7042;170;548;2042;5921;2212;6469
280690;201402;990;2878;865;2693;129;456;559;1688;688;2144
280700;201402;1156;3444;1019;3244;90;294;741;2407;831;2701
280710;201402;10499;29495;9898;28769;638;1908;8502;24821;9140;26729
280720;201402;2468;6809;2228;6519;196;608;1733;5147;1929;5755
280730;201402;941;2861;906;2812;87;292;752;2349;839;2641
280740;201402;12702;35311;11159;33051;1790;5213;7481;22868;9271;28081
280750;201402;3531;11136;3281;10694;295;1243;2385;7628;2680;8871
280760;201402;5719;17895;5279;17328;744;2426;3868;13255;4612;15681
290010;201402;3013;6802;2219;5588;84;341;1753;4154;1837;4495
290020;201402;4982;15841;4556;15406;399;1200;3942;13656;4341;14856
290030;201402;3213;10461;3107;10294;491;1775;2258;7408;2749;9183
290035;201402;4569;12521;4134;11957;321;984;3423;10031;3744;11015
290040;201402;3772;11097;3478;10744;286;1108;2829;8591;3115;9699
290050;201402;2723;8984;2567;8751;269;1040;1943;6666;2212;7706
290060;201402;1311;3393;1101;3146;240;776;731;2017;971;2793
290070;201402;30981;81985;27028;77066;6057;17913;14299;43064;20356;60977
290080;201402;5901;18286;5253;17459;672;2314;3919;13381;4591;15695
290090;201402;2271;5102;1831;4640;253;672;1443;3696;1696;4368
290100;201402;10198;29585;9030;27654;1783;5488;5130;16492;6913;21980
290110;201402;5259;16100;5089;15817;958;3246;3326;10250;4284;13496
290115;201402;4841;14750;4312;14047;322;1139;3329;11044;3651;12183
290120;201402;6738;18750;6290;18197;466;1350;5378;15690;5844;17040
290130;201402;4539;12051;3998;11423;346;988;3324;9617;3670;10605
290135;201402;5165;13477;4549;12492;486;1607;3028;8226;3514;9833
290140;201402;3870;12732;3440;12186;359;1396;2767;9839;3126;11235
290150;201402;2106;6323;2033;6223;198;651;1690;5164;1888;5815
290160;201402;3465;9738;3388;9645;360;704;2889;8592;3249;9296
290170;201402;2831;9578;2608;9225;239;985;2106;7456;2345;8441
290180;201402;3033;8741;2687;8235;297;1031;1941;5971;2238;7002
290190;201402;4159;13903;4027;13678;433;1573;3049;10457;3482;12030
290195;201402;2211;6246;1919;5817;151;519;1523;4658;1674;5177
290200;201402;3836;12473;3527;11929;433;1549;2599;8844;3032;10393
290205;201402;2889;9260;2691;8966;427;1694;1861;6045;2288;7739
290210;201402;15780;43916;14887;42872;2490;5932;10626;33399;13116;39331
290220;201402;2407;7386;2311;7240;324;1222;1623;4920;1947;6142
290225;201402;3060;8377;2887;8191;207;458;2514;7384;2721;7842
290230;201402;2351;7917;2314;7868;217;770;1916;6602;2133;7372
290240;201402;3863;10414;3499;9910;412;1284;2534;7113;2946;8397
290250;201402;3781;12168;3231;11311;311;1158;2429;8627;2740;9785
290260;201402;4698;14629;4388;14144;474;1642;3403;11001;3877;12643
290265;201402;3352;10992;3181;10686;320;1291;2406;8047;2726;9338
290270;201402;11985;44686;11359;43781;1507;6148;8528;33534;10035;39682
290280;201402;5115;17237;4879;16790;694;2562;3360;11822;4054;14384
290290;201402;9605;31376;8850;30150;1715;6125;5684;19763;7399;25888
290300;201402;4382;12625;3382;10841;320;1048;2325;7692;2645;8740
290310;201402;1513;4675;1422;4547;249;912;944;2963;1193;3875
290320;201402;26331;82491;23713;79013;5279;18793;13867;46891;19146;65684
290323;201402;4058;11063;3360;10325;213;778;2864;8752;3077;9530
290327;201402;3983;12989;3727;12493;534;1909;2544;8555;3078;10464
290330;201402;1892;5102;1815;5018;269;842;1424;3878;1693;4720
290340;201402;5020;16124;4667;15663;1269;4434;2550;8749;3819;13183
290350;201402;4969;15269;4124;14148;586;2033;2814;10001;3400;12034
290360;201402;4116;13334;3754;12844;227;827;3243;11270;3470;12097
290370;201402;4537;13756;4227;13358;553;1752;3306;10615;3859;12367
290380;201402;5590;16648;4972;15780;400;1531;4024;12674;4424;14205
290390;201402;14973;48998;14319;47908;3063;10048;8759;30941;11822;40989
290395;201402;2780;9126;2529;8702;252;1088;1872;6429;2124;7517
290400;201402;3626;11345;3265;10843;551;1801;2254;7645;2805;9446
290405;201402;4436;14358;3897;13423;520;1878;2590;9184;3110;11062
290410;201402;6007;18188;5156;16961;584;2420;3726;11952;4310;14372
290420;201402;3331;9926;2791;9166;255;990;2178;7103;2433;8093
290430;201402;3485;11100;3152;10598;719;2476;1849;6424;2568;8900
290440;201402;3027;8096;2526;7455;207;703;2011;6008;2218;6711
290450;201402;3548;10548;3204;10056;632;1912;2045;6682;2677;8594
290460;201402;13161;41267;12420;40037;3754;12920;5464;17472;9218;30392
290470;201402;4774;13550;3820;12304;911;3356;1947;6340;2858;9696
290475;201402;5016;17832;4603;17109;520;2083;3362;12709;3882;14792
290480;201402;2618;6887;2337;6524;337;1042;1596;4502;1933;5544
290485;201402;4738;15483;4310;14860;465;2115;3334;11321;3799;13436
290490;201402;7913;21791;7673;21470;866;2657;6123;17093;6989;19750
290500;201402;4608;14860;3996;13741;798;2955;1940;6634;2738;9589
290510;201402;3424;10137;3025;9583;249;946;2374;7536;2623;8482
290515;201402;2817;8968;2686;8751;180;555;2158;7220;2338;7775
290520;201402;11680;36520;9610;32681;1140;4570;6057;20504;7197;25074
290530;201402;5266;15374;4538;14342;420;1394;3629;11541;4049;12935
290540;201402;3943;11475;3758;11239;500;1445;2849;8756;3349;10201
290550;201402;4389;11844;3886;11227;183;543;3450;10014;3633;10557
290560;201402;6069;18178;5420;17250;1142;3853;3275;10576;4417;14429
290570;201402;40195;118346;37876;114904;5302;17203;27334;82564;32636;99767
290580;201402;7285;25886;7012;25477;1520;5459;4516;17140;6036;22599
290590;201402;7477;24249;6329;22361;465;1923;5033;17773;5498;19696
290600;201402;18048;56612;17127;55196;2668;8739;11562;38478;14230;47217
290610;201402;2345;8313;1999;7631;201;947;1458;5486;1659;6433
290620;201402;7230;21735;6535;20746;548;1922;5348;17026;5896;18948
290630;201402;8188;22506;7252;21508;871;2612;5744;17243;6615;19855
290640;201402;2706;8091;2279;7363;264;946;1585;5117;1849;6063
290650;201402;11725;35219;11070;34236;3213;10043;5921;19047;9134;29090
290660;201402;3704;10481;3086;9608;201;726;2456;7691;2657;8417
290670;201402;6519;20850;6033;20110;938;3017;4430;15405;5368;18422
290680;201402;10314;30977;9623;30159;577;1987;8157;25749;8734;27736
290682;201402;4369;13215;3965;12660;210;841;3281;10400;3491;11241
290685;201402;3240;8495;2469;7412;324;1059;1486;4577;1810;5636
290687;201402;8216;22383;6588;20436;1193;3987;4047;12827;5240;16814
290689;201402;3144;9038;2672;8290;279;906;2034;6372;2313;7278
290690;201402;5434;16174;5013;15621;610;2060;3860;12088;4470;14148
290700;201402;2237;7152;2152;7033;231;816;1660;5464;1891;6280
290710;201402;7677;25123;7171;24319;402;1354;6236;21380;6638;22734
290720;201402;18497;55190;16584;52841;2246;6688;12848;42359;15094;49047
290730;201402;7367;20780;6749;19992;1343;3882;4380;13407;5723;17289
290740;201402;942;2867;808;2645;140;468;493;1667;633;2135
290750;201402;10056;29179;8772;26929;1598;5789;4814;13917;6412;19706
290755;201402;2418;6947;2064;6364;127;483;1627;4985;1754;5468
290760;201402;4468;13346;3711;12263;392;1291;2725;9128;3117;10419
290770;201402;2555;9051;2385;8827;151;666;1941;7232;2092;7898
290780;201402;8838;23511;7909;22252;1009;2510;5874;17198;6883;19708
290790;201402;4622;14073;4333;13662;494;1546;3308;10797;3802;12343
290800;201402;7269;16169;5574;14364;1037;2475;3969;10716;5006;13191
290810;201402;4915;15934;4320;15014;324;1216;3285;11592;3609;12808
290820;201402;5411;15783;4880;15062;546;1934;3654;11232;4200;13166
290830;201402;4070;11984;3868;11649;330;1353;3024;8782;3354;10135
290840;201402;17591;50390;16203;48484;2601;7541;11208;35062;13809;42603
290850;201402;6700;20325;6567;20125;1361;4155;4535;14335;5896;18490
290860;201402;4777;17345;4564;17065;744;2810;3280;12657;4024;15467
290870;201402;4770;14462;4035;13468;480;1912;2915;9610;3395;11522
290880;201402;1394;3939;1160;3579;116;364;770;2433;886;2797
290890;201402;6197;17854;5929;17498;747;2253;4543;13501;5290;15754
290900;201402;2434;7202;1853;6248;287;1097;950;3168;1237;4265
290910;201402;4791;13559;4167;12663;297;980;3413;10430;3710;11410
290920;201402;4787;14413;4359;13841;353;990;3552;11547;3905;12537
290930;201402;7365;24147;6727;23020;874;3328;4678;15861;5552;19189
290940;201402;3505;11344;3293;11081;281;1002;2765;9472;3046;10474
290950;201402;1550;4446;1428;4278;214;677;990;2981;1204;3658
290960;201402;5931;17329;5462;16725;402;1259;4430;13784;4832;15043
290970;201402;3661;12114;3406;11681;481;1712;2253;7929;2734;9641
290980;201402;10693;32337;9565;30146;2795;9233;3742;11820;6537;21053
290990;201402;9192;27936;8280;26462;906;3068;6298;20206;7204;23274
291000;201402;3106;9587;2870;9279;401;1358;2157;7115;2558;8473
291005;201402;13196;37959;12030;36266;2228;7206;7759;23732;9987;30938
291010;201402;3077;10121;2523;8879;366;1401;1501;5301;1867;6702
291020;201402;1381;3735;1078;3198;129;482;623;1773;752;2255
291030;201402;2124;6108;1741;5303;171;561;1113;3353;1284;3914
291040;201402;5460;17406;5074;16845;750;2665;3621;12112;4371;14777
291050;201402;8016;27004;7392;25844;1963;7346;3751;13186;5714;20532
291060;201402;6231;23254;5958;22921;826;3645;4418;16896;5244;20541
291070;201402;16045;48200;14825;46457;1909;5716;10892;35225;12801;40941
291072;201402;20877;66033;18351;61116;6317;22599;6129;21309;12446;43908
291075;201402;5164;15348;4718;14751;324;1016;3666;11792;3990;12808
291077;201402;1541;4578;1318;4230;142;555;900;2846;1042;3401
291080;201402;81370;253096;73927;240111;21954;74832;28754;92821;50708;167653
291085;201402;5663;15405;4971;14478;609;1855;3799;11152;4408;13007
291090;201402;1425;3720;1269;3518;136;516;983;2598;1119;3114
291100;201402;2677;7248;2256;6804;125;516;1922;5736;2047;6252
291110;201402;4983;18128;4542;17438;772;3245;3026;11619;3798;14864
291120;201402;7565;20545;7140;19952;1007;2972;5296;14857;6303;17829
291125;201402;1647;3715;1350;3402;147;379;1002;2616;1149;2995
291130;201402;2996;9285;2638;8693;251;983;1877;6156;2128;7139
291140;201402;4097;12500;3846;12059;563;1845;2633;8359;3196;10204
291150;201402;2009;5290;1925;5189;178;518;1509;4042;1687;4560
291160;201402;5562;17165;4937;16252;1187;4059;2828;9406;4015;13465
291165;201402;2414;7271;1994;6486;142;612;1444;4573;1586;5185
291170;201402;20704;54176;17997;50849;1320;4491;14317;40165;15637;44656
291180;201402;6463;17263;5332;15736;615;1996;3852;11338;4467;13334
291185;201402;3873;10669;3668;10405;311;984;3027;8497;3338;9481
291190;201402;7471;21327;6765;20480;891;2682;5031;15806;5922;18488
291200;201402;3087;9395;2628;8599;311;1185;1812;5908;2123;7093
291210;201402;7448;17901;6555;16907;562;1542;5206;13513;5768;15055
291220;201402;4174;13400;3968;13048;613;2283;2765;8967;3378;11250
291230;201402;3986;10552;3592;10092;163;451;3205;9101;3368;9552
291240;201402;4809;13309;4093;12070;296;918;3191;9346;3487;10264
291250;201402;3762;11424;3010;10176;321;1138;2095;7205;2416;8343
291260;201402;1163;3498;1104;3410;108;372;847;2600;955;2972
291270;201402;4418;15110;4194;14706;570;2229;3026;10660;3596;12889
291280;201402;2416;6223;1850;5544;505;1512;1048;3267;1553;4779
291290;201402;5968;16979;5405;16292;977;3048;3410;10582;4387;13630
291300;201402;4490;13426;3774;12231;499;1787;2488;8085;2987;9872
291310;201402;5356;15647;4754;14655;444;1450;3594;11103;4038;12553
291320;201402;5888;19413;5194;18086;1482;5697;2395;8178;3877;13875
291330;201402;1581;4992;1496;4854;206;784;949;2951;1155;3735
291340;201402;3873;11615;3114;10542;354;1392;2348;7890;2702;9282
291345;201402;3471;11522;3304;11344;256;925;2870;9978;3126;10903
291350;201402;6122;18385;5482;17419;620;2101;3701;12044;4321;14145
291360;201402;35994;105682;33802;102485;8419;25665;20630;64751;29049;90416
291370;201402;9082;26856;8730;26402;1073;3147;6611;20612;7684;23759
291380;201402;3846;11996;3420;11301;338;1142;2431;8289;2769;9431
291390;201402;10467;29545;9609;28543;1427;4136;7157;21686;8584;25822
291400;201402;16948;44969;13894;40907;2309;6966;8800;26984;11109;33950
291410;201402;3279;8620;2439;7403;199;822;1799;5284;1998;6106
291420;201402;2268;6049;2027;5760;101;276;1846;5291;1947;5567
291430;201402;3354;10001;2976;9507;253;1005;2318;7323;2571;8328
291440;201402;5971;19320;5149;17827;595;2200;3855;13535;4450;15735
291450;201402;7383;23213;6881;22417;420;1379;5678;18902;6098;20281
291460;201402;13115;40466;11804;38571;2389;8332;7336;24223;9725;32555
291465;201402;8153;23900;7451;23097;874;3005;5804;18001;6678;21006
291470;201402;15448;43764;13880;41841;1314;4064;10732;33328;12046;37392
291480;201402;35444;97091;31778;92035;5566;17997;20077;57837;25643;75834
291490;201402;4264;14577;4183;14464;515;1783;3370;11845;3885;13628
291500;201402;4195;12339;3667;11603;275;968;2948;9347;3223;10315
291510;201402;3555;11118;3352;10839;153;553;3029;9842;3182;10395
291520;201402;4085;11304;3651;10722;606;1684;2413;7556;3019;9240
291530;201402;2105;6231;1807;5763;499;1720;847;2780;1346;4500
291535;201402;4345;12814;3939;12225;360;1165;2933;9458;3293;10623
291540;201402;2206;5420;1908;5109;183;442;1572;4341;1755;4783
291550;201402;5651;15413;5119;14680;1332;3865;2673;7859;4005;11724
291560;201402;16953;44343;13471;40401;1608;5006;10076;30978;11684;35984
291570;201402;2355;6411;2253;6280;179;463;1936;5495;2115;5958
291580;201402;5893;18237;5291;17322;777;3038;3477;11327;4254;14365
291590;201402;2019;6343;1820;6020;310;1113;1154;3958;1464;5071
291600;201402;5543;15638;4162;13681;1029;3735;1997;6460;3026;10195
291610;201402;5208;15405;5066;15213;435;1469;4196;12567;4631;14036
291620;201402;3063;7340;2555;6803;182;463;2024;5607;2206;6070
291630;201402;3209;8158;2845;7754;283;737;2361;6605;2644;7342
291640;201402;17682;49022;14851;45339;3875;12940;6328;19460;10203;32400
291650;201402;8048;24435;7468;23763;705;1858;6222;20607;6927;22465
291660;201402;2381;6365;2133;6028;269;905;1449;3955;1718;4860
291670;201402;2512;7093;2332;6809;352;1092;1326;4125;1678;5217
291680;201402;4993;14396;4536;13667;1148;3956;2078;6446;3226;10402
291685;201402;4366;11303;3869;10717;432;1184;2889;8368;3321;9552
291690;201402;4017;11131;3341;10076;329;1023;2298;7015;2627;8038
291700;201402;9439;29774;8772;28693;1093;3694;6350;21237;7443;24931
291710;201402;5924;16064;5187;15104;1101;3449;2930;8908;4031;12357
291720;201402;3817;13502;3513;12870;398;1720;2591;9329;2989;11049
291730;201402;5835;18966;5492;18520;1237;4316;3490;12117;4727;16433
291733;201402;2626;7827;2254;7344;309;1046;1500;4966;1809;6012
291735;201402;2381;6984;2061;6499;128;489;1704;5318;1832;5807
291740;201402;4008;11775;3203;10538;332;1266;2227;7330;2559;8596
291750;201402;21969;58489;17573;51995;3948;12232;9280;27916;13228;40148
291760;201402;12134;39257;11320;37819;4019;14702;4765;16039;8784;30741
291770;201402;8027;23493;7327;22311;1272;4202;4716;14232;5988;18434
291780;201402;4287;13457;4077;13062;568;1807;2958;9581;3526;11388
291790;201402;2450;7853;2325;7687;152;618;1955;6420;2107;7038
291800;201402;31606;93003;28781;88992;6228;20158;17101;54258;23329;74416
291810;201402;10713;31142;9294;29466;681;2433;7496;24024;8177;26457
291820;201402;3604;11003;3283;10551;375;1226;2446;7989;2821;9215
291830;201402;4368;11967;4106;11587;563;1747;3051;8580;3614;10327
291835;201402;6099;19325;5108;17709;1218;4522;3031;10524;4249;15046
291840;201402;47596;134330;41319;127649;5353;16502;31912;100955;37265;117457
291845;201402;2992;8779;2706;8462;269;823;2292;7271;2561;8094
291850;201402;4819;13600;4076;12572;461;1398;3020;9581;3481;10979
291855;201402;1666;4517;1439;4221;229;768;1016;2932;1245;3700
291860;201402;2032;6150;1775;5656;169;584;1157;3698;1326;4282
291870;201402;1355;3727;1090;3254;111;426;702;2054;813;2480
291875;201402;2870;9259;2596;8820;249;1022;1798;5992;2047;7014
291880;201402;4594;14795;4425;14541;337;1105;3749;12484;4086;13589
291890;201402;1415;3604;1200;3341;188;545;810;2296;998;2841
291900;201402;1316;3803;1144;3537;120;428;863;2632;983;3060
291905;201402;2950;7886;2496;7159;221;754;1773;5140;1994;5894
291910;201402;2589;7182;2286;6802;178;654;1848;5444;2026;6098
291915;201402;6665;20948;5977;19606;531;1856;4851;16147;5382;18003
291920;201402;32604;96571;30319;93257;6402;20320;17987;57017;24389;77337
291930;201402;2553;7646;2325;7306;263;931;1719;5403;1982;6334
291940;201402;3583;10353;2748;8880;407;1485;1545;4850;1952;6335
291950;201402;9224;31526;8417;30220;2131;7757;4375;16241;6506;23998
291955;201402;7989;26265;7774;25940;1808;6121;4725;16256;6533;22377
291960;201402;3390;10167;2930;9531;354;1093;2075;7124;2429;8217
291970;201402;4413;13320;3942;12726;616;2116;2689;8831;3305;10947
291980;201402;11468;33439;8834;29659;1159;4053;6139;21145;7298;25198
291990;201402;2157;7063;1992;6806;210;753;1450;5084;1660;5837
291992;201402;2806;8771;2749;8662;509;1688;1903;5957;2412;7645
291995;201402;2121;6310;1904;6001;240;796;1403;4490;1643;5286
292000;201402;2335;7026;2127;6724;454;1606;1299;4049;1753;5655
292010;201402;6270;16384;4872;14306;501;1521;3677;10858;4178;12379
292020;201402;4441;15254;4124;14744;657;2572;2831;10242;3488;12814
292030;201402;2215;6997;1984;6669;250;939;1289;4372;1539;5311
292040;201402;4610;13012;4121;12504;357;1028;3427;10810;3784;11838
292045;201402;2468;8845;2441;8799;100;336;2273;8251;2373;8587
292050;201402;6377;20134;5656;18708;574;2380;3876;12591;4450;14971
292060;201402;10873;30983;10458;30428;1077;3187;8491;24835;9568;28022
292070;201402;4363;14124;4262;13999;398;1156;3706;12429;4104;13585
292080;201402;3699;9859;3231;9256;297;903;2590;7487;2887;8390
292090;201402;4274;11561;3698;10908;346;1169;2990;8849;3336;10018
292100;201402;11059;31064;9637;29299;2727;8662;4946;15678;7673;24340
292105;201402;3175;9799;2775;9241;209;851;2203;7311;2412;8162
292110;201402;7061;18823;5454;16490;1228;3880;3071;9585;4299;13465
292120;201402;8542;24407;7697;22927;1541;4799;4167;13057;5708;17856
292130;201402;3218;8680;2900;8240;625;1684;1856;5467;2481;7151
292140;201402;5506;14361;4804;13433;631;1741;3286;9575;3917;11316
292145;201402;2681;8315;2453;7967;215;689;1834;6243;2049;6932
292150;201402;13614;41839;12680;40354;910;3362;9920;31925;10830;35287
292160;201402;2726;7927;2360;7442;192;581;1933;6271;2125;6852
292170;201402;8724;26424;7535;24371;1146;4089;4685;15400;5831;19489
292180;201402;3507;10272;2880;9295;438;1462;1793;5913;2231;7375
292190;201402;3238;9285;2848;8736;584;1926;1795;5551;2379;7477
292200;201402;5707;19565;5186;18487;1599;6155;1983;7092;3582;13247
292205;201402;3979;12520;3667;12101;276;1063;2932;9675;3208;10738
292210;201402;6620;19259;5835;18202;527;1763;4584;14618;5111;16381
292220;201402;1915;5517;1819;5381;433;1217;1090;3285;1523;4502
292225;201402;3010;9609;2792;9290;193;706;2273;7634;2466;8340
292230;201402;6233;18973;5973;18575;688;2585;4523;13708;5211;16293
292240;201402;4398;14151;4104;13503;658;2365;2505;8131;3163;10496
292250;201402;5250;16348;4943;15789;1099;3676;2582;8324;3681;12000
292260;201402;3092;9680;2951;9471;321;1097;2305;7397;2626;8494
292265;201402;3069;10151;2809;9687;237;985;2086;7146;2323;8131
292270;201402;3910;10868;3194;10027;264;1038;2559;8010;2823;9048
292273;201402;2799;6882;2168;6095;302;842;1537;4511;1839;5353
292275;201402;1884;4971;1773;4819;223;692;1331;3589;1554;4281
292280;201402;2056;6211;1881;6021;209;546;1435;4913;1644;5459
292285;201402;2606;7419;2323;7018;236;822;1772;5426;2008;6248
292290;201402;7376;22458;6247;21007;453;1741;4935;16884;5388;18625
292300;201402;8470;26296;7470;25182;2267;7787;4140;14480;6407;22267
292303;201402;2778;8923;2615;8700;120;469;2257;7528;2377;7997
292305;201402;3162;8686;3016;8496;107;333;2705;7653;2812;7986
292310;201402;5898;17843;5396;17154;261;928;4549;14501;4810;15429
292320;201402;5958;18403;5390;17426;600;2269;4062;13028;4662;15297
292330;201402;1987;5738;1875;5594;237;789;1420;4185;1657;4974
292335;201402;5319;13997;4807;13335;409;1164;4003;11186;4412;12350
292340;201402;6564;19189;5750;17947;563;1885;4171;13134;4734;15019
292350;201402;2161;6618;2005;6424;266;963;1507;4825;1773;5788
292360;201402;4923;14479;4752;13976;181;550;4156;12501;4337;13051
292370;201402;8533;26235;7777;25107;1100;3483;5334;18079;6434;21562
292380;201402;7397;21740;6948;21040;609;1703;5658;17428;6267;19131
292390;201402;3710;8507;3298;8064;110;209;3084;7634;3194;7843
292400;201402;22079;65978;21187;64549;3202;10444;14727;45712;17929;56156
292405;201402;4363;11857;3824;11206;274;822;3184;9458;3458;10280
292410;201402;1910;5190;1825;5093;156;452;1579;4406;1735;4858
292420;201402;3782;12260;3651;12111;173;489;3322;11272;3495;11761
292430;201402;5520;16996;4454;15492;260;1083;3452;11974;3712;13057
292440;201402;8562;28341;7987;27501;298;1180;6964;24327;7262;25507
292450;201402;4417;13265;3647;12044;349;1255;2631;8843;2980;10098
292460;201402;5643;17123;5023;16010;990;3256;3064;9925;4054;13181
292465;201402;2355;7304;2050;6808;242;950;1455;4836;1697;5786
292467;201402;2170;7166;2063;6984;431;1575;1303;4467;1734;6042
292470;201402;3202;8678;2689;7861;231;812;2001;5769;2232;6581
292480;201402;6012;16745;5195;15615;373;1288;4261;12847;4634;14135
292490;201402;2316;6509;1966;5993;185;683;1470;4409;1655;5092
292500;201402;6579;20049;5747;18614;567;2164;4165;13570;4732;15734
292510;201402;13172;38233;11757;36261;1210;4089;9007;28190;10217;32279
292520;201402;5843;18053;5426;17352;1633;5314;2570;8394;4203;13708
292525;201402;5518;14629;4844;13838;409;1235;3876;11233;4285;12468
292530;201402;25457;77030;23416;74573;5404;17954;13796;45451;19200;63405
292540;201402;2847;8450;2595;8091;413;1517;1820;5598;2233;7115
292550;201402;6325;20947;5721;20060;947;3479;3881;13965;4828;17444
292560;201402;4207;11690;3625;10936;309;1126;2915;8664;3224;9790
292570;201402;4039;12060;3891;11904;128;397;3421;10812;3549;11209
292575;201402;5965;20726;5829;20477;1040;3796;4115;14506;5155;18302
292580;201402;7182;21374;6685;20754;574;1784;5521;17396;6095;19180
292590;201402;7205;23168;6904;22687;978;3248;4980;16609;5958;19857
292593;201402;3265;8652;2780;7942;264;761;2120;6053;2384;6814
292595;201402;5952;16831;5238;15911;530;1724;3927;12055;4457;13779
292600;201402;10583;30198;9994;29463;1259;2975;7991;24689;9250;27664
292610;201402;4348;12744;3612;11520;498;1681;2315;7540;2813;9221
292620;201402;5861;18259;5189;17473;331;1251;4618;15598;4949;16849
292630;201402;9915;25324;8678;23521;827;2338;6519;17987;7346;20325
292640;201402;8236;26940;7337;25744;660;2437;5637;20300;6297;22737
292650;201402;4889;13484;4699;13266;518;1104;3756;11397;4274;12501
292660;201402;11042;34058;10558;33342;1479;4799;7762;25069;9241;29868
292665;201402;2861;8496;2802;8414;91;253;2612;7934;2703;8187
292670;201402;3869;11131;3045;9746;338;1203;1962;6327;2300;7530
292680;201402;3613;11057;3425;10793;339;1088;2777;8775;3116;9863
292690;201402;3339;9211;2462;7876;318;1134;1609;5239;1927;6373
292700;201402;9191;28303;8051;26650;1173;3689;5689;19769;6862;23458
292710;201402;1934;6418;1847;6289;95;358;1639;5599;1734;5957
292720;201402;9500;24858;8446;23674;770;2255;6999;19826;7769;22081
292730;201402;3370;10507;3269;10340;564;1751;2211;7221;2775;8972
292740;201402;350706;999684;334892;976768;81208;251202;195737;572102;276945;823304
292750;201402;5914;16456;5367;15731;390;1159;4347;12974;4737;14133
292760;201402;4200;13678;3901;13156;576;2124;2515;8597;3091;10721
292770;201402;6056;18818;5705;18264;1365;4473;3357;11135;4722;15608
292780;201402;1860;4572;1482;4110;197;681;1053;2859;1250;3540
292790;201402;3365;9104;3225;8953;269;628;2680;7790;2949;8418
292800;201402;9442;28858;8875;27950;942;3228;6788;21399;7730;24627
292805;201402;3155;9410;2908;9056;588;1992;1849;5802;2437;7794
292810;201402;9921;30555;8467;28642;1245;4413;6142;21278;7387;25691
292820;201402;7386;21435;5472;18737;441;1688;4366;15055;4807;16743
292830;201402;1878;5649;1706;5413;122;492;1380;4334;1502;4826
292840;201402;7223;24058;6764;23425;462;1785;5761;19986;6223;21771
292850;201402;3235;8623;2698;7835;335;1026;1882;5424;2217;6450
292860;201402;15186;41846;14618;41140;2058;5829;11139;31775;13197;37604
292870;201402;19176;54039;17136;50867;3351;10988;9835;28749;13186;39737
292880;201402;11802;35587;10730;33921;2032;6515;6574;21107;8606;27622
292890;201402;5500;19285;5007;18350;1029;3958;2810;10607;3839;14565
292895;201402;2739;6971;2242;6215;287;812;1616;4454;1903;5266
292900;201402;3039;9592;2881;9333;429;1671;1922;6006;2351;7677
292905;201402;4204;12495;3586;11715;316;941;2978;10053;3294;10994
292910;201402;5076;15941;4715;15272;846;2947;2948;9500;3794;12447
292920;201402;8548;25735;8162;25129;940;3164;6125;18421;7065;21585
292925;201402;5101;16139;4556;15384;414;1490;3535;12020;3949;13510
292930;201402;6454;21098;6169;20575;827;3387;4437;14417;5264;17804
292935;201402;2129;6126;1804;5770;132;335;1519;5086;1651;5421
292937;201402;3330;8592;2847;7988;316;1024;2182;6031;2498;7055
292940;201402;3058;8623;2456;7807;305;988;1629;5418;1934;6406
292950;201402;8238;25270;7889;24686;1036;3852;5654;17212;6690;21064
292960;201402;4546;13007;4236;12550;486;1605;2982;8743;3468;10348
292970;201402;4254;13366;3932;12954;191;789;3312;10897;3503;11686
292975;201402;3356;9362;3251;9202;370;1077;2645;7536;3015;8613
292980;201402;3551;10059;2926;9307;402;1549;2009;6349;2411;7898
292990;201402;12152;35320;11167;33851;763;2454;9440;28734;10203;31188
293000;201402;2952;7878;2433;7227;129;453;2107;6246;2236;6699
293010;201402;18700;53567;16517;50163;3221;10838;9942;30123;13163;40961
293015;201402;7968;26298;6549;24228;1146;4556;4085;15079;5231;19635
293020;201402;9381;31459;8804;30653;641;2513;7201;25358;7842;27871
293030;201402;5550;16413;4563;14962;469;1675;3134;10615;3603;12290
293040;201402;3794;12182;3638;12010;258;920;3127;10377;3385;11297
293050;201402;19788;56878;17720;54227;2925;9236;11540;36483;14465;45719
293060;201402;4315;11154;3665;10130;416;1261;2463;6750;2879;8011
293070;201402;20164;62180;18782;59825;5349;17781;9336;30373;14685;48154
293075;201402;3470;11132;3166;10770;297;1078;2580;8851;2877;9929
293076;201402;3719;10589;3490;10269;295;836;2892;8686;3187;9522
293077;201402;5062;15787;4408;14957;879;3186;2663;9180;3542;12366
293080;201402;4895;15475;4513;14859;324;1389;3558;11493;3882;12882
293090;201402;3569;11309;2953;10446;313;1109;2242;8090;2555;9199
293100;201402;5669;17572;4898;16232;562;1969;3543;11969;4105;13938
293105;201402;3863;13043;3442;12225;584;2124;2219;8064;2803;10188
293110;201402;1947;5919;1833;5737;114;433;1518;4731;1632;5164
293120;201402;4053;13720;3777;13335;351;1267;2998;10771;3349;12038
293130;201402;3923;11556;3218;10762;192;726;2814;9551;3006;10277
293135;201402;28180;74109;22204;66220;4232;14962;11328;33390;15560;48352
293140;201402;2098;6333;2030;6234;203;784;1559;4657;1762;5441
293150;201402;5850;19318;5297;18276;1108;3872;3013;10850;4121;14722
293160;201402;3456;9573;3285;9364;511;1132;2465;7486;2976;8618
293170;201402;3413;10595;3211;10294;465;1593;2299;7527;2764;9120
293180;201402;5371;15277;4509;13952;373;1381;3509;10694;3882;12075
293190;201402;13771;42344;13123;41363;592;2644;11298;34897;11890;37541
293200;201402;6325;18737;5660;17780;282;1059;4887;15273;5169;16332
293210;201402;4714;14487;4396;13957;541;1824;3111;10017;3652;11841
293220;201402;5172;15814;4695;15086;1239;4215;2342;7698;3581;11913
293230;201402;3917;12440;3632;12047;438;1670;2783;9189;3221;10859
293240;201402;4518;11931;3605;10662;184;540;2831;8380;3015;8920
293245;201402;4397;12920;4039;12342;523;1630;2804;8893;3327;10523
293250;201402;5974;17085;5502;16400;808;2573;3828;11424;4636;13997
293260;201402;4726;14349;3988;13301;367;1353;2965;10070;3332;11423
293270;201402;5836;16144;5546;15830;591;1562;4656;13607;5247;15169
293280;201402;5704;16269;5002;15355;434;1262;3853;12274;4287;13536
293290;201402;16427;55721;15635;54111;3666;13178;8597;30468;12263;43646
293300;201402;6365;16303;5505;15341;486;1331;4382;12375;4868;13706
293305;201402;4722;12025;4196;11303;302;894;3433;9247;3735;10141
293310;201402;2721;7089;2255;6332;246;783;1534;4256;1780;5039
293315;201402;4922;12653;4498;12017;745;1975;2791;7873;3536;9848
293317;201402;2552;7619;2333;7220;306;961;1517;4750;1823;5711
293320;201402;8152;26848;7973;26616;961;3496;6396;21315;7357;24811
293325;201402;1926;5654;1607;5158;306;1060;1002;3254;1308;4314
293330;201402;54934;175551;49790;167011;11381;41568;26572;90443;37953;132011
293340;201402;2721;7846;2177;6918;312;1138;1473;4581;1785;5719
293345;201402;3428;10505;2918;9776;371;1228;2035;7085;2406;8313
293350;201402;6732;18872;6466;18558;471;1262;5638;16509;6109;17771
293360;201402;13773;42213;12619;40697;800;2582;10660;35174;11460;37756
310010;201402;1230;3378;905;2860;235;894;375;1079;610;1973
310020;201402;3848;12277;3235;10944;1082;3959;567;1741;1649;5700
310030;201402;2457;8301;2194;7792;726;2700;921;3285;1647;5985
310040;201402;977;2724;839;2536;106;396;591;1738;697;2134
310050;201402;1924;6767;1720;6270;369;1601;812;2880;1181;4481
310060;201402;3077;10899;2935;10684;355;1346;2268;8415;2623;9761
310070;201402;309;895;228;739;38;159;108;312;146;471
310080;201402;769;2404;630;2136;174;678;199;623;373;1301
310090;201402;4841;14590;4204;13497;753;2713;2476;7950;3229;10663
310100;201402;3291;10284;2794;9474;328;1298;2029;6832;2357;8130
310110;201402;5887;16874;5007;15575;1116;4018;2669;8167;3785;12185
310120;201402;582;1940;556;1892;232;924;203;571;435;1495
310130;201402;462;1464;423;1405;104;398;206;646;310;1044
310140;201402;268;930;234;866;70;302;52;162;122;464
310150;201402;4852;15299;4447;14559;988;3679;2240;7265;3228;10944
310160;201402;7140;23445;6247;21835;1891;7330;2330;7987;4221;15317
310163;201402;777;2669;703;2512;193;789;255;873;448;1662
310170;201402;9726;28286;9004;27189;1803;5820;5455;17054;7258;22874
310180;201402;1836;5416;1499;4947;394;1484;689;2191;1083;3675
310190;201402;2528;8582;2300;8199;681;2698;338;1239;1019;3937
310200;201402;1890;6468;1605;5889;486;1943;500;1807;986;3750
310205;201402;961;3076;873;2895;184;611;493;1688;677;2299
310210;201402;2455;7905;2281;7632;390;1459;1556;5180;1946;6639
310220;201402;1268;3662;1032;3364;217;775;588;1897;805;2672
310230;201402;2910;9701;2542;8885;758;3076;937;2974;1695;6050
310240;201402;1015;3618;871;3339;151;658;445;1785;596;2443
310250;201402;961;3374;939;3341;190;782;580;1976;770;2758
310260;201402;3165;10362;2708;9386;740;2909;995;3356;1735;6265
310270;201402;2351;7177;2123;6837;255;929;1560;5062;1815;5991
310280;201402;2118;6246;1920;5930;643;2305;753;2185;1396;4490
310285;201402;2209;7865;2090;7689;262;929;1580;6012;1842;6941
310290;201402;1324;4194;1239;4065;387;1476;557;1611;944;3087
310300;201402;1895;6536;1798;6341;507;1964;954;3327;1461;5291
310310;201402;400;1128;295;904;57;196;141;424;198;620
310320;201402;370;1292;332;1193;81;331;144;502;225;833
310330;201402;489;1273;372;1071;39;150;212;549;251;699
310340;201402;8335;26790;7454;25331;1551;5585;4264;14927;5815;20512
310350;201402;14489;43347;11861;38552;4256;15036;2971;9696;7227;24732
310360;201402;451;1452;439;1431;87;335;285;873;372;1208
310370;201402;1447;5180;1394;5078;456;1745;645;2362;1101;4107
310375;201402;1278;3533;957;2969;156;569;476;1429;632;1998
310380;201402;395;1130;320;1023;135;480;117;337;252;817
310390;201402;485;1764;414;1602;118;510;67;227;185;737
310400;201402;10175;31008;8251;27564;2752;10150;2175;7185;4927;17335
310410;201402;1027;3342;680;2798;243;1084;114;449;357;1533
310420;201402;5681;16722;3436;11480;822;3116;530;1553;1352;4669
310430;201402;1601;5572;1359;5067;459;1826;335;1233;794;3059
310440;201402;619;1835;545;1720;156;562;196;572;352;1134
310445;201402;1189;4111;1029;3840;159;662;655;2486;814;3148
310450;201402;4451;13273;3731;12214;825;2853;2168;7323;2993;10176
310460;201402;1549;5118;1370;4796;470;1786;305;1133;775;2919
310470;201402;3732;9802;3196;9142;328;1104;2485;7124;2813;8228
310480;201402;1022;3258;891;3008;226;862;368;1163;594;2025
310490;201402;3297;11311;2905;10560;966;3855;1024;3712;1990;7567
310500;201402;1490;5243;1385;5041;437;1746;529;1884;966;3630
310510;201402;2502;8379;2204;7697;795;3013;461;1530;1256;4543
310520;201402;1312;3728;1132;3425;92;285;740;2252;832;2537
310530;201402;851;2759;580;2075;122;488;95;332;217;820
310540;201402;3665;12276;3415;11904;1195;4438;1254;4452;2449;8890
310550;201402;1176;3673;1002;3380;316;1244;366;1140;682;2384
310560;201402;16097;51265;14082;47351;4653;17424;4578;14632;9231;32056
310570;201402;1262;3976;1188;3876;167;627;869;2805;1036;3432
310590;201402;4134;12408;3341;10900;660;2481;1212;3749;1872;6230
310600;201402;1624;5531;1539;5349;513;1996;514;1676;1027;3672
310610;201402;560;1926;519;1835;154;644;173;551;327;1195
310620;201402;186925;602601;156026;539829;42762;165181;57376;189761;100138;354942
310630;201402;4134;13769;3930;13393;889;3463;2392;7871;3281;11334
310640;201402;1447;4537;1194;4093;398;1480;329;1062;727;2542
310650;201402;2887;9370;2394;8537;525;2037;1198;4376;1723;6413
310660;201402;1294;4090;1148;3881;188;733;799;2641;987;3374
310665;201402;1180;3747;1093;3625;208;732;715;2424;923;3156
310670;201402;55874;178517;51965;169827;16126;55931;21297;68378;37423;124309
310680;201402;798;2412;739;2317;175;597;368;1134;543;1731
310690;201402;1241;4303;1041;3869;292;1245;251;892;543;2137
310700;201402;520;1456;445;1346;131;448;210;597;341;1045
310710;201402;7285;24061;5897;21783;1488;6187;2001;7192;3489;13379
310720;201402;845;2658;776;2531;243;919;339;1011;582;1930
310730;201402;9363;30298;8714;29285;2073;7559;4985;16819;7058;24378
310740;201402;5059;17556;4387;16103;1600;6405;992;3447;2592;9852
310750;201402;1606;4241;1339;3881;253;775;837;2436;1090;3211
310760;201402;623;1973;536;1824;137;509;221;739;358;1248
310770;201402;720;2694;712;2682;311;1298;265;938;576;2236
310780;201402;3602;10529;3274;9977;628;1943;1938;5960;2566;7903
310790;201402;1760;5742;1620;5518;468;1678;804;2802;1272;4480
310800;201402;3050;10119;2517;9049;1029;4026;355;1236;1384;5262
310810;201402;1520;4316;1405;4131;366;1202;651;1808;1017;3010
310820;201402;1490;4300;1101;3617;323;1155;326;1025;649;2180
310825;201402;2384;8310;1961;7570;164;849;1455;5547;1619;6396
310830;201402;1430;4926;1214;4468;439;1725;339;1190;778;2915
310840;201402;2237;7632;2028;7194;778;3036;518;1706;1296;4742
310850;201402;1531;4714;1320;4431;233;893;898;2977;1131;3870
310855;201402;3078;10219;2811;9793;748;2758;1511;5430;2259;8188
310860;201402;7658;24557;6901;23267;1298;4554;3884;13606;5182;18160
310870;201402;1030;2997;876;2733;205;707;397;1220;602;1927
310880;201402;1249;3927;960;3385;197;793;445;1561;642;2354
310890;201402;2729;8849;2179;7805;652;2624;476;1583;1128;4207
310900;201402;4315;14692;3796;13674;1167;4676;1481;5133;2648;9809
310910;201402;2018;5946;1469;4926;431;1633;335;1054;766;2687
310920;201402;1861;5877;1523;5382;409;1653;719;2529;1128;4182
310925;201402;940;3176;860;3042;321;1262;252;883;573;2145
310930;201402;5263;15811;4321;14338;926;3299;2347;8027;3273;11326
310940;201402;6207;18719;5427;17555;1087;3861;3004;9742;4091;13603
310945;201402;1296;3747;1058;3418;241;901;562;1742;803;2643
310950;201402;1937;6620;1607;5935;596;2449;430;1474;1026;3923
310960;201402;461;1607;415;1519;147;590;139;512;286;1102
310970;201402;1471;5259;1156;4397;431;1786;125;418;556;2204
310980;201402;471;1253;334;999;61;218;141;367;202;585
310990;201402;1146;4001;1004;3712;223;940;359;1239;582;2179
311000;201402;4596;16219;4141;15243;1337;5482;1358;4759;2695;10241
311010;201402;964;3157;860;2971;272;997;389;1309;661;2306
311020;201402;875;2808;761;2620;153;601;336;1094;489;1695
311030;201402;1852;5689;1471;4902;483;1809;477;1403;960;3212
311040;201402;501;1721;436;1544;120;446;103;351;223;797
311050;201402;2598;8481;2223;7750;719;2733;824;2866;1543;5599
311060;201402;2361;7550;1954;6654;549;2005;446;1482;995;3487
311070;201402;1716;6188;1526;5797;456;1979;470;1733;926;3712
311080;201402;1191;3244;1074;3062;162;538;695;1988;857;2526
311090;201402;1673;6471;1479;6044;507;2347;267;1011;774;3358
311100;201402;2298;8182;2078;7732;943;3660;473;1769;1416;5429
311110;201402;3980;9779;2914;8298;613;1972;1435;3985;2048;5957
311115;201402;1093;3410;962;3215;128;537;606;2045;734;2582
311120;201402;7644;22145;6194;19527;1626;5828;1661;4819;3287;10647
311130;201402;2403;7463;1954;6870;652;2627;772;2589;1424;5216
311140;201402;1255;3735;1094;3535;191;724;735;2329;926;3053
311150;201402;2424;8163;2243;7859;599;2188;1072;3851;1671;6039
311160;201402;4874;16754;4183;15592;1527;6108;1264;4625;2791;10733
311170;201402;746;2353;599;2066;55;215;329;1191;384;1406
311180;201402;1584;4466;1163;3638;365;1269;235;652;600;1921
311190;201402;1092;3347;936;3028;245;918;342;1007;587;1925
311200;201402;2531;7914;2212;7260;880;3158;486;1422;1366;4580
311205;201402;1184;3924;1057;3677;279;1106;380;1360;659;2466
311210;201402;916;3040;847;2929;168;587;589;2093;757;2680
311220;201402;914;2970;739;2568;205;749;231;794;436;1543
311230;201402;8976;27719;7668;25482;1675;6071;3785;12964;5460;19035
311240;201402;1352;4218;1136;3864;378;1448;321;1027;699;2475
311250;201402;1323;4469;1211;4298;389;1506;351;1101;740;2607
311260;201402;2938;8138;2241;6908;725;2456;592;1728;1317;4184
311265;201402;1320;3578;1030;3181;161;609;675;2061;836;2670
311270;201402;3381;11353;3061;10934;637;2670;1887;6579;2524;9249
311280;201402;1401;3979;1075;3369;285;982;327;1005;612;1987
311290;201402;2320;7667;2154;7320;425;1414;1213;4292;1638;5706
311300;201402;5014;16896;4592;16244;774;3109;2910;10368;3684;13477
311310;201402;490;1762;475;1737;121;513;177;606;298;1119
311320;201402;4040;13805;3563;12737;975;3947;1161;3914;2136;7861
311330;201402;5493;17096;4738;15885;1723;6232;1462;4883;3185;11115
311340;201402;12128;39867;11155;38046;3978;14700;3191;10778;7169;25478
311350;201402;2312;6982;1998;6426;448;1721;890;2722;1338;4443
311360;201402;1329;3803;1070;3460;471;1613;287;958;758;2571
311370;201402;4489;13643;4027;12858;1004;3932;1652;4941;2656;8873
311380;201402;480;1605;407;1467;126;503;107;352;233;855
311390;201402;1959;7400;1878;7244;821;3525;567;2088;1388;5613
311400;201402;1704;5769;1583;5557;472;1876;664;2143;1136;4019
311410;201402;2000;7361;1877;7182;665;2730;874;3373;1539;6103
311420;201402;2338;8213;2033;7465;736;2885;417;1354;1153;4239
311430;201402;3908;12497;3022;10555;716;2759;571;1946;1287;4705
311440;201402;2278;7974;1907;7365;762;3283;430;1620;1192;4903
311450;201402;2344;8471;2080;7842;715;2868;522;1867;1237;4735
311455;201402;1563;4328;1374;4063;307;1035;743;2120;1050;3155
311460;201402;607;2044;503;1827;123;566;127;430;250;996
311470;201402;592;1903;480;1666;131;545;143;450;274;995
311480;201402;800;2294;766;2240;269;823;286;781;555;1604
311490;201402;316;1260;306;1228;117;494;94;369;211;863
311500;201402;508;1556;421;1396;157;570;140;448;297;1018
311510;201402;3135;9898;2629;8943;1016;3905;656;2072;1672;5977
311520;201402;684;2389;651;2321;251;966;236;817;487;1783
311530;201402;11128;30111;7777;24215;2181;8123;2103;6174;4284;14297
311535;201402;714;2221;533;1855;135;532;109;367;244;899
311540;201402;706;2575;676;2529;254;969;300;1115;554;2084
311545;201402;2147;6907;2047;6761;350;1283;1375;4535;1725;5818
311547;201402;1663;4700;1424;4338;147;487;951;2922;1098;3409
311550;201402;3333;11018;2940;10224;936;3609;885;2991;1821;6600
311560;201402;279;757;248;718;58;192;133;367;191;559
311570;201402;2014;5210;1704;4844;130;396;1412;4078;1542;4474
311580;201402;2325;5242;1974;4815;583;1404;1096;2749;1679;4153
311590;201402;374;1221;328;1158;91;386;88;305;179;691
311600;201402;1334;4102;1168;3892;250;860;669;2332;919;3192
311610;201402;3482;12204;3236;11818;1005;3672;1488;5876;2493;9548
311615;201402;2631;8841;2335;8328;318;1272;1587;5694;1905;6966
311620;201402;446;1461;402;1401;116;472;193;633;309;1105
311630;201402;1456;4391;1255;4025;350;1112;589;1937;939;3049
311640;201402;893;2814;755;2591;142;523;506;1746;648;2269
311650;201402;2435;7022;2046;6407;318;1154;1146;3607;1464;4761
311660;201402;2558;9182;2303;8579;680;2828;435;1415;1115;4243
311670;201402;1402;4426;1233;4115;466;1716;452;1452;918;3168
311680;201402;2264;7219;1935;6748;512;1896;1011;3616;1523;5512
311690;201402;524;1491;445;1396;89;311;283;872;372;1183
311700;201402;2130;6294;1906;5961;200;821;1440;4377;1640;5198
311710;201402;1720;5408;1370;4777;589;2269;359;1197;948;3466
311720;201402;403;1395;375;1340;73;280;230;809;303;1089
311730;201402;5052;13688;3373;10759;1048;3720;1142;3372;2190;7092
311740;201402;1004;2909;878;2761;393;1245;362;1199;755;2444
311750;201402;3846;13279;3596;12928;631;2510;2311;8402;2942;10912
311760;201402;795;2774;747;2672;247;1034;257;779;504;1813
311770;201402;2567;8198;2132;7432;594;2347;668;2235;1262;4582
311780;201402;1024;3922;894;3593;314;1404;147;566;461;1970
311783;201402;2063;6846;1862;6477;213;926;1213;4322;1426;5248
311787;201402;649;2294;481;1792;98;386;89;287;187;673
311790;201402;1275;4182;1070;3772;301;1139;236;806;537;1945
311800;201402;3820;13298;2856;10302;687;2699;221;649;908;3348
311810;201402;1042;3564;1005;3494;47;224;867;2970;914;3194
311820;201402;819;2746;706;2475;237;957;308;974;545;1931
311830;201402;10392;37898;9593;35881;3966;15597;2043;7587;6009;23184
311840;201402;3435;10414;2970;9713;1009;3646;1136;3604;2145;7250
311850;201402;318;971;277;904;76;261;126;410;202;671
311860;201402;48656;154643;42960;143689;11711;43124;17873;57952;29584;101076
311870;201402;2320;7097;1916;6335;491;1866;622;1904;1113;3770
311880;201402;7054;21449;6449;20714;994;3215;4480;15033;5474;18248
311890;201402;1604;5124;1366;4620;412;1551;494;1596;906;3147
311900;201402;801;2529;730;2431;156;534;439;1536;595;2070
311910;201402;4668;14004;3860;12906;1190;4329;1504;5066;2694;9395
311920;201402;2057;6837;1799;6460;220;913;1239;4400;1459;5313
311930;201402;4767;14505;4290;13719;1655;5767;1210;3841;2865;9608
311940;201402;11725;36690;10119;33382;3248;11924;2344;7261;5592;19185
311950;201402;2272;6869;1980;6505;129;426;1653;5510;1782;5936
311960;201402;370;1321;341;1257;119;472;113;398;232;870
311970;201402;468;1706;410;1581;134;572;69;240;203;812
311980;201402;745;2138;577;1876;141;493;256;858;397;1351
311990;201402;494;1540;447;1471;187;663;134;406;321;1069
311995;201402;1073;3375;795;2691;183;694;190;533;373;1227
312000;201402;680;2176;651;2134;114;426;373;1209;487;1635
312010;201402;1036;3371;947;3179;196;714;428;1441;624;2155
312015;201402;1584;4955;1382;4611;227;896;788;2648;1015;3544
312020;201402;922;3047;830;2915;221;878;429;1476;650;2354
312030;201402;1787;5433;1615;5210;246;893;1187;3788;1433;4681
312040;201402;669;2587;596;2373;205;917;132;503;337;1420
312050;201402;1488;5193;1303;4802;399;1631;258;892;657;2523
312060;201402;744;2303;664;2195;324;1142;171;505;495;1647
312070;201402;945;2996;647;2332;178;697;225;797;403;1494
312080;201402;2594;7391;2046;6532;469;1813;914;2635;1383;4448
312083;201402;938;2746;798;2549;112;415;494;1568;606;1983
312087;201402;2329;7207;2094;6885;380;1322;1394;4682;1774;6004
312090;201402;9794;32312;9030;30998;2863;10900;3613;11916;6476;22816
312100;201402;1345;4645;1193;4403;277;1145;644;2435;921;3580
312110;201402;1175;4254;1059;4001;375;1561;199;671;574;2232
312120;201402;914;3224;831;3038;263;1089;209;667;472;1756
312125;201402;1192;3943;1069;3672;287;1075;456;1563;743;2638
312130;201402;820;2545;672;2224;163;622;246;771;409;1393
312140;201402;1151;3649;976;3237;223;813;357;1068;580;1881
312150;201402;575;1664;489;1488;55;195;306;908;361;1103
312160;201402;7994;27830;7402;26656;2432;9617;2509;9077;4941;18694
312170;201402;1014;3090;925;2907;129;442;567;1811;696;2253
312180;201402;1588;5021;1473;4828;453;1562;556;1813;1009;3375
312190;201402;658;2206;523;1936;213;880;94;317;307;1197
312200;201402;4697;14517;4132;13566;542;1882;2857;9466;3399;11348
312210;201402;1155;3258;936;2930;262;922;394;1170;656;2092
312220;201402;1886;6301;1716;6108;284;1068;1231;4556;1515;5624
312230;201402;17873;60515;15306;55366;7127;27490;2603;9671;9730;37161
312235;201402;1768;5116;1484;4678;190;741;963;3013;1153;3754
312240;201402;1113;3850;960;3529;291;1152;315;1141;606;2293
312245;201402;2386;7106;2094;6719;183;546;1685;5540;1868;6086
312247;201402;899;2717;708;2414;220;835;328;1127;548;1962
312250;201402;1137;3382;1005;3156;227;816;462;1400;689;2216
312260;201402;911;3013;782;2841;117;529;535;1912;652;2441
312270;201402;792;2564;697;2378;181;754;228;651;409;1405
312280;201402;472;1646;435;1558;184;705;49;167;233;872
312290;201402;785;2758;739;2691;290;1175;160;572;450;1747
312300;201402;1114;3756;943;3353;289;1093;115;354;404;1447
312310;201402;944;3651;863;3448;275;1182;337;1311;612;2493
312320;201402;2418;6988;1995;6160;556;1945;512;1322;1068;3267
312330;201402;1136;3513;1023;3346;301;1127;489;1588;790;2715
312340;201402;306;826;287;798;49;182;206;528;255;710
312350;201402;375;988;351;960;49;162;277;718;326;880
312352;201402;1635;5489;1533;5349;537;1909;784;2836;1321;4745
312360;201402;3667;12636;3242;11761;1061;4151;797;2852;1858;7003
312370;201402;1668;5528;1554;5332;554;2109;534;1755;1088;3864
312380;201402;1988;5967;1831;5718;268;897;1252;4021;1520;4918
312385;201402;1213;3884;1138;3739;167;676;772;2433;939;3109
312390;201402;2011;6889;1752;6342;560;2189;340;1182;900;3371
312400;201402;3354;11327;3061;10767;1046;3791;1236;4523;2282;8314
312410;201402;10527;35860;9565;33947;2914;11323;3260;11257;6174;22580
312420;201402;3991;13083;3813;12874;758;2621;2546;8868;3304;11489
312430;201402;8494;25701;7586;24351;1440;4902;4759;15767;6199;20669
312440;201402;607;2011;544;1894;175;666;213;743;388;1409
312450;201402;1151;4271;1067;4091;479;1882;334;1285;813;3167
312460;201402;396;1229;356;1184;92;353;177;557;269;910
312470;201402;753;2191;531;1743;132;510;104;330;236;840
312480;201402;1293;4044;1128;3853;411;1482;469;1580;880;3062
312490;201402;2322;6176;1849;5538;287;1020;1077;3130;1364;4150
312500;201402;596;2135;566;2082;156;675;279;991;435;1666
312510;201402;2096;7298;1845;6732;525;2147;594;1972;1119;4119
312520;201402;395;1372;353;1283;119;470;107;388;226;858
312530;201402;567;1922;543;1870;109;452;296;963;405;1415
312540;201402;1451;4731;1185;4207;210;867;681;2340;891;3207
312550;201402;627;2050;566;1922;67;269;361;1192;428;1461
312560;201402;2142;5829;1900;5511;235;793;1401;4083;1636;4876
312570;201402;2658;8310;2380;7801;749;2638;680;2146;1429;4784
312580;201402;519;1766;424;1578;110;479;166;581;276;1060
312590;201402;1831;6288;1636;5869;527;2144;497;1601;1024;3745
312595;201402;2021;6951;1809;6433;539;2070;748;2573;1287;4643
312600;201402;789;2890;730;2759;218;934;287;1015;505;1949
312610;201402;8479;27111;7360;24901;2701;9871;2060;6733;4761;16604
312620;201402;2041;6020;1572;5410;100;337;1289;4608;1389;4945
312630;201402;509;1746;473;1677;137;553;196;660;333;1213
312640;201402;585;1952;486;1743;117;474;195;657;312;1131
312650;201402;2336;7080;1739;5966;204;841;913;3091;1117;3932
312660;201402;1248;3515;1079;3299;174;632;698;2084;872;2716
312670;201402;5910;18665;5507;18031;1426;5395;2717;8607;4143;14002
312675;201402;1445;4659;1293;4361;250;887;677;2320;927;3207
312680;201402;1717;5329;1538;5033;257;980;908;3006;1165;3986
312690;201402;2408;6722;2010;6163;395;1426;1102;3248;1497;4674
312695;201402;892;3232;840;3152;159;597;543;2120;702;2717
312700;201402;2169;6455;1697;5556;322;1216;855;2740;1177;3956
312705;201402;1384;4185;1228;3970;187;635;847;2754;1034;3389
312707;201402;1758;5531;1469;5040;273;1116;760;2562;1033;3678
312710;201402;7956;23017;6098;19776;2322;8392;1341;4020;3663;12412
312720;201402;758;2612;693;2490;196;785;271;918;467;1703
312730;201402;1870;4751;1436;4286;211;742;904;2711;1115;3453
312733;201402;1756;4812;1374;4108;120;458;971;2783;1091;3241
312735;201402;876;2679;782;2538;285;983;346;1122;631;2105
312737;201402;1037;2564;734;2151;251;774;269;836;520;1610
312738;201402;502;1654;411;1483;140;589;147;480;287;1069
312740;201402;502;1454;346;1250;126;504;90;326;216;830
312750;201402;1282;4740;1229;4630;338;1425;564;2095;902;3520
312760;201402;2401;7893;1940;7002;602;2433;441;1617;1043;4050
312770;201402;44548;125172;35324;111288;10493;36111;11053;34573;21546;70684
312780;201402;2776;10055;2508;9590;570;2386;1365;5334;1935;7720
312790;201402;367;997;235;766;72;249;57;175;129;424
312800;201402;5167;17859;4551;16587;1469;5806;1361;5063;2830;10869
312810;201402;2192;6856;1645;5895;565;2234;326;1084;891;3318
312820;201402;2133;6457;1971;6193;270;1008;1230;3734;1500;4742
312825;201402;1516;4217;1346;4010;146;479;1053;3118;1199;3597
312830;201402;2722;8898;2030;7500;569;2339;327;1183;896;3522
312840;201402;1151;3891;988;3584;215;914;399;1371;614;2285
312850;201402;696;2313;603;2121;178;724;189;641;367;1365
312860;201402;1305;3822;1020;3390;356;1385;317;920;673;2305
312870;201402;5617;18108;4444;15902;1274;5171;1187;4034;2461;9205
312880;201402;1194;3670;1009;3350;235;894;456;1447;691;2341
312890;201402;1571;4938;1263;4378;446;1753;411;1350;857;3103
312900;201402;1366;4654;1319;4580;358;1295;745;2634;1103;3929
312910;201402;1486;3501;1167;3072;327;1023;497;1198;824;2221
312920;201402;1010;3354;893;3192;305;1222;352;1203;657;2425
312930;201402;2176;6631;1961;6332;447;1556;1005;3304;1452;4860
312940;201402;928;3160;840;2992;238;1005;259;856;497;1861
312950;201402;3468;10046;2856;9136;995;3487;1119;3541;2114;7028
312960;201402;1903;5900;1723;5664;220;727;1278;4317;1498;5044
312965;201402;1756;5790;1538;5391;354;1347;818;2940;1172;4287
312970;201402;1132;3956;1021;3807;416;1751;174;625;590;2376
312980;201402;20743;73993;20065;72338;7908;30517;6862;23993;14770;54510
312990;201402;401;1262;310;1098;116;459;90;306;206;765
313000;201402;507;1747;449;1637;144;648;144;440;288;1088
313005;201402;2598;8581;2328;8127;396;1529;1405;4924;1801;6453
313010;201402;4032;13738;3657;13109;1131;4453;1397;4765;2528;9218
313020;201402;1043;3621;949;3402;308;1251;286;901;594;2152
313030;201402;1564;4488;1272;4091;372;1381;625;1875;997;3256
313040;201402;958;3422;817;3020;208;851;210;737;418;1588
313050;201402;1864;6261;1588;5842;516;2098;535;1901;1051;3999
313055;201402;1485;5097;1398;4974;150;532;1045;3850;1195;4382
313060;201402;939;3336;882;3206;401;1512;147;528;548;2040
313065;201402;1914;6486;1777;6278;284;1154;1267;4428;1551;5582
313070;201402;1254;3756;1026;3331;269;1025;474;1448;743;2473
313080;201402;469;1499;386;1339;116;466;106;305;222;771
313090;201402;5232;16151;4878;15532;813;2831;3253;10482;4066;13313
313100;201402;1107;3653;1037;3550;175;676;724;2435;899;3111
313110;201402;1685;5113;1349;4481;333;1294;488;1501;821;2795
313115;201402;2839;10143;2726;9915;912;3702;1162;3982;2074;7684
313120;201402;3802;11202;3317;10496;1164;3915;1460;4642;2624;8557
313130;201402;26153;84766;23813;79877;7233;26780;8062;25634;15295;52414
313140;201402;721;1911;537;1625;45;165;342;1018;387;1183
313150;201402;1646;5223;1498;4970;661;2276;391;1348;1052;3624
313160;201402;1177;3614;1059;3424;223;852;614;1889;837;2741
313170;201402;9691;36156;9037;34539;3521;14050;1832;7032;5353;21082
313180;201402;2706;7227;2080;6414;662;2305;675;1994;1337;4299
313190;201402;3479;12933;3171;12046;877;3570;1147;4307;2024;7877
313200;201402;1503;4791;1356;4564;219;889;839;2832;1058;3721
313210;201402;4582;14738;3948;13888;980;3951;2034;7000;3014;10951
313220;201402;1260;3905;973;3293;253;974;238;710;491;1684
313230;201402;2542;9095;2394;8875;424;1659;1495;5762;1919;7421
313240;201402;8123;28052;7048;26038;2066;8373;2730;10114;4796;18487
313250;201402;7646;24372;7004;23350;1279;4388;4204;14462;5483;18850
313260;201402;608;1935;513;1755;143;562;129;412;272;974
313270;201402;5535;16680;5011;15901;840;2828;3325;10718;4165;13546
313280;201402;531;1775;424;1509;90;366;95;305;185;671
313290;201402;1037;3781;871;3443;284;1210;205;755;489;1965
313300;201402;1945;6792;1690;6133;528;2065;337;1114;865;3179
313310;201402;1061;3797;972;3611;260;1107;195;660;455;1767
313320;201402;2383;7386;2026;6775;462;1660;822;2753;1284;4413
313330;201402;3861;12896;3492;12205;760;3063;1676;5789;2436;8852
313340;201402;2173;5365;1727;4740;373;1094;964;2594;1337;3688
313350;201402;3329;10563;2630;9008;680;2494;501;1550;1181;4044
313360;201402;1190;3688;929;3191;306;1238;376;1157;682;2395
313370;201402;1466;5185;1394;4981;293;1214;605;1992;898;3206
313375;201402;2034;5552;1405;4631;373;1489;506;1611;879;3100
313380;201402;6704;23334;5913;21601;2333;9189;1488;5123;3821;14312
313390;201402;910;3365;880;3318;139;612;570;2115;709;2727
313400;201402;3723;11097;3468;10782;441;1490;2627;8302;3068;9792
313410;201402;1367;3961;1173;3702;269;951;671;2103;940;3054
313420;201402;19241;48620;12861;37263;3110;10269;2955;8213;6065;18482
313430;201402;1311;4321;1186;4105;365;1414;407;1326;772;2740
313440;201402;6523;16019;4993;14248;778;2435;3448;9873;4226;12308
313450;201402;731;2203;596;1927;147;589;205;586;352;1175
313460;201402;2651;9554;2408;9123;850;3505;686;2494;1536;5999
313470;201402;3433;9763;3280;9585;386;1023;2678;8063;3064;9086
313480;201402;1147;3422;891;2968;176;679;380;1205;556;1884
313490;201402;1515;5106;1151;4478;466;1826;249;987;715;2813
313500;201402;442;1417;422;1382;90;340;253;807;343;1147
313505;201402;8800;26486;8323;25910;555;1359;7340;23674;7895;25033
313507;201402;1307;3945;1190;3768;240;895;671;2126;911;3021
313510;201402;15870;47984;14358;46101;2487;8343;9964;32782;12451;41125
313520;201402;16151;49536;13884;45776;2133;8251;8826;28907;10959;37158
313530;201402;537;1895;479;1774;78;335;188;643;266;978
313535;201402;2506;7658;2261;7262;395;1356;1395;4556;1790;5912
313540;201402;1145;3670;922;3116;277;1001;235;730;512;1731
313545;201402;1391;5153;1242;4882;252;1193;728;2749;980;3942
313550;201402;1953;6790;1879;6631;531;2026;929;3160;1460;5186
313560;201402;2294;5772;2031;5467;253;668;1547;4338;1800;5006
313570;201402;809;3000;712;2811;281;1218;221;808;502;2026
313580;201402;6146;17799;5387;16781;757;2499;3878;12239;4635;14738
313590;201402;1081;3260;883;3026;422;1532;312;1055;734;2587
313600;201402;3856;12032;3442;11381;649;2369;1986;6675;2635;9044
313610;201402;1158;3682;1011;3397;281;1043;405;1332;686;2375
313620;201402;7440;25293;7059;24485;2412;8929;2296;7838;4708;16767
313630;201402;8593;27257;7551;25686;2365;8855;2506;8883;4871;17738
313640;201402;843;2735;746;2605;275;1034;278;971;553;2005
313650;201402;2296;7611;2059;7236;296;1087;1474;5295;1770;6382
313652;201402;1026;3729;949;3577;185;744;552;2115;737;2859
313655;201402;973;3292;826;3048;197;841;475;1703;672;2544
313657;201402;1155;3900;1067;3749;171;778;690;2204;861;2982
313660;201402;904;3161;839;3049;236;994;392;1350;628;2344
313665;201402;3053;10308;2864;9920;689;2710;1356;4538;2045;7248
313670;201402;49670;145724;35560;121954;10955;41581;10459;34684;21414;76265
313680;201402;1109;3382;986;3194;121;407;708;2324;829;2731
313690;201402;936;3418;864;3281;246;948;334;1321;580;2269
313695;201402;1498;4975;1299;4657;178;751;896;3199;1074;3950
313700;201402;3928;13211;3366;12452;546;2121;2327;8759;2873;10880
313710;201402;1398;3981;1191;3677;378;1290;541;1611;919;2901
313720;201402;5351;18273;4705;16925;1303;5223;1357;4369;2660;9592
313730;201402;1280;3573;1026;3264;152;528;661;2128;813;2656
313740;201402;2074;7620;1740;6750;616;2695;221;795;837;3490
313750;201402;2950;9201;2610;8549;836;3004;690;2083;1526;5087
313753;201402;1858;5723;1577;5237;487;1750;575;1942;1062;3692
313760;201402;4308;14507;3732;13321;1200;4754;1049;3555;2249;8309
313770;201402;3655;12482;3485;12100;1255;4643;974;3324;2229;7967
313780;201402;3923;11414;3213;10362;865;3195;1389;4339;2254;7534
313790;201402;555;1955;539;1931;117;440;304;1109;421;1549
313800;201402;1262;3658;1133;3454;187;665;691;2085;878;2750
313810;201402;1479;4629;1422;4545;233;765;977;3203;1210;3968
313820;201402;13119;39246;11101;35650;3161;11316;4019;12862;7180;24178
313830;201402;449;1552;387;1423;130;541;112;402;242;943
313835;201402;1061;3608;1019;3538;230;877;561;1941;791;2818
313840;201402;7510;23113;6439;21349;1948;7254;2109;6683;4057;13937
313850;201402;1269;3618;1154;3423;268;930;611;1713;879;2643
313860;201402;2646;8393;2287;7642;690;2566;496;1507;1186;4073
313862;201402;1110;3049;812;2570;238;819;229;717;467;1536
313865;201402;2239;7228;2096;6978;349;1306;1406;4640;1755;5946
313867;201402;1048;3718;906;3423;323;1278;295;1135;618;2413
313868;201402;1553;5586;1400;5257;179;787;931;3503;1110;4290
313870;201402;916;2901;823;2762;231;902;327;1013;558;1915
313880;201402;2273;7402;2087;7156;487;1981;1046;3318;1533;5299
313890;201402;1998;5561;1716;5210;302;928;1096;3400;1398;4328
313900;201402;4728;17567;4453;16956;1689;7174;1182;4438;2871;11612
313910;201402;768;2645;664;2422;278;1110;111;359;389;1469
313920;201402;3683;12036;3393;11542;591;2054;2063;7345;2654;9399
313925;201402;2117;5721;1592;4753;134;467;1050;3130;1184;3597
313930;201402;5315;17809;4526;16434;844;3370;2554;9526;3398;12896
313940;201402;7349;26137;6513;24764;2313;9545;2422;9469;4735;19014
313950;201402;4830;14319;4099;13131;1301;4741;1337;4072;2638;8813
313960;201402;6061;16766;5093;15436;1717;5898;1283;3832;3000;9730
313970;201402;1501;4450;1260;4181;257;939;784;2615;1041;3554
313980;201402;1205;4100;1056;3829;330;1355;305;1058;635;2413
313990;201402;2004;7696;1799;7228;662;2864;426;1572;1088;4436
314000;201402;8145;28425;7605;27383;2217;8915;3865;13649;6082;22564
314010;201402;1082;3233;914;3022;178;692;493;1565;671;2257
314015;201402;1602;6077;1483;5813;538;2216;423;1681;961;3897
314020;201402;494;1620;418;1446;142;544;115;367;257;911
314030;201402;834;2744;668;2364;120;476;232;799;352;1275
314040;201402;643;1924;567;1788;194;658;268;811;462;1469
314050;201402;1915;6385;1621;5779;505;2005;445;1464;950;3469
314053;201402;1463;4964;1387;4868;248;860;950;3465;1198;4325
314055;201402;2246;6788;2010;6457;209;692;1495;4921;1704;5613
314060;201402;1094;3593;962;3351;142;589;591;2023;733;2612
314070;201402;3624;11736;2927;10299;865;3352;749;2505;1614;5857
314080;201402;1868;5866;1364;4784;273;1070;327;1049;600;2119
314085;201402;1857;6635;1633;6325;544;2328;574;2231;1118;4559
314090;201402;3510;12201;3205;11620;1056;4189;1160;4261;2216;8450
314100;201402;3525;9668;3098;9060;381;1138;2334;6970;2715;8108
314110;201402;4453;14931;3955;13897;1014;4073;1437;4670;2451;8743
314120;201402;1054;2617;597;1892;192;703;149;436;341;1139
314130;201402;686;2016;431;1439;99;364;88;266;187;630
314140;201402;5059;16133;4558;15192;1078;3919;2143;7197;3221;11116
314150;201402;1761;4722;1388;4135;271;914;670;1954;941;2868
314160;201402;2403;6578;2003;6045;164;547;1632;4998;1796;5545
314170;201402;1077;3416;926;3092;180;715;468;1472;648;2187
314180;201402;6512;21106;5858;20126;1679;6350;2530;8862;4209;15212
314190;201402;818;2638;733;2497;241;940;268;868;509;1808
314200;201402;3069;10110;2785;9600;436;1704;1846;6295;2282;7999
314210;201402;1973;6261;1782;5902;440;1583;863;2762;1303;4345
314220;201402;1748;5809;1484;5245;506;1986;341;1039;847;3025
314225;201402;1180;3708;1070;3554;73;188;944;3230;1017;3418
314230;201402;700;2476;657;2396;205;832;219;752;424;1584
314240;201402;1135;3669;1017;3486;257;877;600;2134;857;3011
314250;201402;520;1611;420;1405;131;501;141;431;272;932
314260;201402;1305;4779;1245;4651;411;1636;463;1732;874;3368
314270;201402;2721;9565;2574;9306;323;1328;1749;6356;2072;7684
314280;201402;3252;9509;2410;7927;746;2819;618;1787;1364;4606
314290;201402;5421;15516;4659;14307;704;2336;3184;9821;3888;12157
314300;201402;1964;6716;1834;6420;647;2422;642;2174;1289;4596
314310;201402;6603;21474;5857;19934;2308;8390;1431;4687;3739;13077
314315;201402;973;3756;912;3637;160;729;530;2139;690;2868
314320;201402;3348;10422;2784;9639;967;3679;1019;3469;1986;7148
314330;201402;53943;177351;51110;172371;16176;59566;22210;73811;38386;133377
314340;201402;2515;7218;1434;4937;377;1454;155;351;532;1805
314345;201402;1282;4446;1151;4242;362;1390;551;2102;913;3492
314350;201402;1420;4236;1165;3819;470;1689;288;936;758;2625
314360;201402;706;2294;522;1911;151;645;122;417;273;1062
314370;201402;567;2029;532;1985;174;708;263;969;437;1677
314380;201402;1112;3483;864;3048;334;1259;225;809;559;2068
314390;201402;15418;47694;12891;42784;4194;15189;3516;11211;7710;26400
314400;201402;5480;15763;4520;14444;1382;4447;2434;8146;3816;12593
314410;201402;2544;8522;2273;7961;749;2934;768;2530;1517;5464
314420;201402;776;2299;642;2112;95;384;477;1550;572;1934
314430;201402;8178;24779;7406;23385;2495;8659;2245;7203;4740;15862
314435;201402;1214;4066;1108;3863;162;692;696;2353;858;3045
314437;201402;1197;3159;1064;2969;106;296;825;2329;931;2625
314440;201402;756;2116;534;1815;196;739;110;349;306;1088
314450;201402;1755;5294;1523;4963;515;1948;636;1905;1151;3853
314460;201402;4623;16264;4134;15169;1395;5604;768;2790;2163;8394
314465;201402;2398;7791;2214;7464;225;932;1637;5416;1862;6348
314467;201402;1090;3165;961;2951;191;575;574;1823;765;2398
314470;201402;2407;8008;1930;6893;556;2314;428;1267;984;3581
314480;201402;7279;25559;5535;20794;1339;5410;529;1789;1868;7199
314490;201402;987;3027;822;2705;238;921;343;1055;581;1976
314500;201402;2811;8193;2350;7309;722;2510;779;2426;1501;4936
314505;201402;1785;5618;1693;5453;391;1400;960;3085;1351;4485
314510;201402;1907;5577;1415;4818;526;1955;334;1093;860;3048
314520;201402;3798;14777;3199;13199;1112;5029;558;2095;1670;7124
314530;201402;7226;26004;6702;25191;1248;4931;3988;15559;5236;20490
314535;201402;2775;8054;2457;7638;382;1304;1633;5141;2015;6445
314537;201402;1438;4416;1219;4028;274;1067;562;1867;836;2934
314540;201402;467;1463;412;1341;127;478;122;360;249;838
314545;201402;1363;4432;1223;4217;277;1044;634;2181;911;3225
314550;201402;558;1726;456;1581;142;580;119;381;261;961
314560;201402;5318;19219;4713;17647;1272;5257;1137;4123;2409;9380
314570;201402;370;1173;333;1099;101;364;150;469;251;833
314580;201402;458;1618;395;1488;151;646;95;342;246;988
314585;201402;704;2488;569;2216;170;714;161;626;331;1340
314587;201402;1713;5610;1557;5322;301;1078;803;2770;1104;3848
314590;201402;4236;14931;3195;12053;744;3035;382;1314;1126;4349
314600;201402;2128;7430;1790;6833;689;2933;334;1174;1023;4107
314610;201402;8378;30357;7913;29269;2568;10297;2513;8957;5081;19254
314620;201402;1738;5262;1571;5055;229;742;1159;3846;1388;4588
314625;201402;1561;5173;1525;5129;213;783;1120;3811;1333;4594
314630;201402;5148;15550;4541;14583;682;2423;3005;9844;3687;12267
314640;201402;834;2432;714;2216;247;834;186;526;433;1360
314650;201402;1285;3971;1039;3514;277;1083;418;1282;695;2365
314655;201402;1695;5123;1333;4464;276;969;646;2177;922;3146
314660;201402;208;591;166;506;25;88;93;270;118;358
314670;201402;1482;4219;1220;3764;226;773;670;2045;896;2818
314675;201402;1871;5831;1683;5514;224;840;1065;3526;1289;4366
314690;201402;2743;8879;2379;8230;735;2927;676;2152;1411;5079
314700;201402;10099;38809;9160;36780;4153;17572;1943;8061;6096;25633
314710;201402;8445;27535;6084;22239;1459;6027;736;2465;2195;8492
314720;201402;2676;9135;2267;8305;700;2829;873;3152;1573;5981
314730;201402;2507;7892;2134;7358;766;2967;629;2057;1395;5024
314740;201402;3057;10454;2796;9975;916;3567;991;3400;1907;6967
314750;201402;331;1111;301;1039;62;257;139;460;201;717
314760;201402;1748;6165;1314;5036;295;1336;268;836;563;2172
314770;201402;1200;3859;783;2726;97;407;107;291;204;698
314780;201402;311;875;237;773;91;341;86;259;177;600
314790;201402;13472;42080;10539;36894;4094;16379;2424;7826;6518;24205
314795;201402;1530;4737;1364;4466;155;683;1018;3172;1173;3855
314800;201402;17177;53446;14497;48100;5837;20444;2749;9284;8586;29728
314810;201402;12987;39832;10336;35030;3321;12694;2392;7990;5713;20684
314820;201402;1114;3154;786;2662;276;1040;241;742;517;1782
314830;201402;1687;5871;1496;5494;548;2230;528;1933;1076;4163
314840;201402;1127;4004;903;3669;184;872;528;2142;712;3014
314850;201402;2230;6574;1926;6064;386;1420;1037;3224;1423;4644
314860;201402;3279;11468;3037;11076;616;2497;1813;6620;2429;9117
314870;201402;5726;18848;5162;18076;831;3311;3538;12556;4369;15867
314875;201402;1722;5930;1685;5878;323;1112;1246;4431;1569;5543
314880;201402;822;2455;732;2307;76;255;516;1627;592;1882
314890;201402;603;1908;463;1635;143;568;109;328;252;896
314900;201402;411;1324;336;1191;108;406;142;494;250;900
314910;201402;1732;6145;1535;5796;603;2495;349;1245;952;3740
314915;201402;2511;8044;2236;7654;242;964;1748;5960;1990;6924
314920;201402;647;1911;492;1681;102;396;219;701;321;1097
314930;201402;5170;17963;4603;16725;1516;6014;983;3526;2499;9540
314940;201402;409;1232;387;1191;98;310;189;575;287;885
314950;201402;369;1320;329;1230;96;414;71;238;167;652
314960;201402;794;2651;669;2401;205;806;165;558;370;1364
314970;201402;867;3136;791;2967;309;1288;178;623;487;1911
314980;201402;2244;6970;2041;6642;836;2915;285;874;1121;3789
314990;201402;3166;10333;2593;9069;935;3582;430;1335;1365;4917
314995;201402;1568;4984;1432;4793;256;1025;936;3028;1192;4053
315000;201402;1048;3169;886;2936;156;623;546;1774;702;2397
315010;201402;495;1620;412;1445;132;537;137;426;269;963
315015;201402;1895;5971;1754;5802;332;1165;1205;4129;1537;5294
315020;201402;757;2520;686;2396;199;788;261;815;460;1603
315030;201402;1004;3123;879;2896;345;1245;173;554;518;1799
315040;201402;942;2956;870;2834;180;616;526;1701;706;2317
315050;201402;1622;4935;1371;4515;472;1717;428;1355;900;3072
315053;201402;1148;3460;1002;3226;260;1012;390;1183;650;2195
315057;201402;1902;6549;1567;6044;246;978;979;3913;1225;4891
315060;201402;951;3274;806;2913;243;959;188;708;431;1667
315070;201402;668;2071;623;2003;165;589;344;1071;509;1660
315080;201402;3498;12212;3174;11532;854;3351;1392;5078;2246;8429
315090;201402;753;2767;675;2603;195;820;222;905;417;1725
315100;201402;1179;4137;963;3657;274;1152;234;850;508;2002
315110;201402;1658;5136;1464;4801;434;1538;582;1892;1016;3430
315120;201402;13749;33819;10101;29152;1967;6245;5211;15891;7178;22136
315130;201402;1824;6131;1663;5813;615;2348;423;1428;1038;3776
315140;201402;2451;8414;2067;7556;591;2496;601;1928;1192;4424
315150;201402;4757;13400;3654;11445;893;3230;1328;3995;2221;7225
315160;201402;1362;3941;1237;3770;255;869;707;2118;962;2987
315170;201402;1377;4225;1202;3980;283;1027;662;2273;945;3300
315180;201402;13709;43474;10906;37562;3106;12153;2598;8511;5704;20664
315190;201402;2403;6506;1974;5887;628;2003;846;2541;1474;4544
315200;201402;4507;15446;3800;13864;1184;4765;964;3363;2148;8128
315210;201402;8680;27238;7476;24890;2682;9709;2235;7247;4917;16956
315213;201402;1131;3707;1097;3659;103;314;913;3145;1016;3459
315217;201402;2739;9372;2318;8650;401;1694;1308;4926;1709;6620
315220;201402;10121;30465;9061;29034;1831;6047;5592;18437;7423;24484
315230;201402;2473;6770;2291;6555;136;359;2007;5840;2143;6199
315240;201402;3295;10834;3023;10362;619;2353;1754;5998;2373;8351
315250;201402;9138;30104;7165;26409;2455;10154;2125;7744;4580;17898
315260;201402;1074;3625;922;3279;346;1355;147;452;493;1807
315270;201402;874;3166;765;2931;254;1044;160;583;414;1627
315280;201402;3959;12317;3200;10610;1131;3994;722;2237;1853;6231
315290;201402;1267;3678;991;3236;376;1364;168;548;544;1912
315300;201402;525;1529;412;1387;216;777;111;344;327;1121
315310;201402;1219;4153;1114;3975;160;634;735;2601;895;3235
315320;201402;850;2871;727;2695;240;954;312;1186;552;2140
315330;201402;804;2917;623;2486;254;1123;88;330;342;1453
315340;201402;4218;12460;3628;11549;991;3450;1616;5192;2607;8642
315350;201402;1859;5384;1545;4964;210;646;1118;3741;1328;4387
315360;201402;1697;5810;1404;5026;341;1298;432;1462;773;2760
315370;201402;621;1897;550;1790;134;499;292;924;426;1423
315380;201402;284;1023;259;951;80;318;41;135;121;453
315390;201402;1957;7053;1724;6507;614;2510;376;1385;990;3895
315400;201402;4524;14344;4105;13521;1102;3921;1917;6353;3019;10274
315410;201402;1756;4980;1498;4569;329;1226;811;2353;1140;3579
315415;201402;1150;3923;1068;3796;471;1707;387;1435;858;3142
315420;201402;1527;4863;1159;4159;355;1345;182;621;537;1966
315430;201402;4032;11189;3081;9577;778;2767;944;2822;1722;5589
315440;201402;973;3034;881;2893;174;657;483;1581;657;2238
315445;201402;2175;6298;1848;5861;306;1114;1196;3759;1502;4873
315450;201402;2504;8098;2360;7883;482;1636;1511;5218;1993;6854
315460;201402;39058;132852;35217;124700;11878;45653;8646;29651;20524;75304
315470;201402;545;1746;498;1659;92;337;298;969;390;1306
315480;201402;1421;4536;1024;3661;217;886;227;763;444;1649
315490;201402;3253;9434;2829;8838;545;2031;1591;4801;2136;6832
315500;201402;456;1487;315;1130;67;288;124;380;191;668
315510;201402;1471;4338;1279;4023;149;520;849;2676;998;3196
315520;201402;1160;3667;980;3424;164;661;585;1974;749;2635
315530;201402;502;1793;475;1748;232;891;136;479;368;1370
315540;201402;1281;3962;1035;3558;224;953;364;1217;588;2170
315550;201402;1688;5081;1468;4795;504;1835;582;1856;1086;3691
315560;201402;7169;24063;6618;23322;987;3861;4495;15904;5482;19765
315570;201402;2397;7634;2253;7423;487;1824;1280;4144;1767;5968
315580;201402;2701;8507;2237;7628;635;2567;794;2504;1429;5071
315590;201402;881;2612;814;2515;127;464;540;1637;667;2101
315600;201402;2604;9491;2184;8801;368;1594;1320;5554;1688;7148
315610;201402;994;3026;854;2727;206;793;294;776;500;1569
315620;201402;335;1207;328;1192;101;378;153;571;254;949
315630;201402;994;3245;864;3035;243;903;228;788;471;1691
315640;201402;744;2379;652;2199;224;872;195;596;419;1468
315645;201402;859;2792;752;2532;306;1148;159;494;465;1642
315650;201402;1871;5631;1701;5390;167;673;1279;3958;1446;4631
315660;201402;2670;7422;2429;7087;438;1398;1495;4346;1933;5744
315670;201402;11659;42226;10785;40481;4010;16219;3186;11712;7196;27931
315680;201402;2869;10224;2395;9317;899;3636;569;2337;1468;5973
315690;201402;3205;10426;2679;9475;967;3775;710;2498;1677;6273
315700;201402;7324;23726;6382;21807;1416;5545;2969;9670;4385;15215
315710;201402;1818;5492;1504;5004;234;916;867;2847;1101;3763
315720;201402;3000;9946;2744;9452;803;3101;1102;3593;1905;6694
315725;201402;1637;5111;1327;4707;455;1645;600;2189;1055;3834
315727;201402;651;2109;587;1976;140;506;280;936;420;1442
315730;201402;992;3123;906;2959;203;714;483;1587;686;2301
315733;201402;1158;3802;1081;3646;473;1686;312;1024;785;2710
315737;201402;1377;4260;1145;3864;130;504;724;2474;854;2978
315740;201402;1034;3379;911;3153;260;1034;385;1227;645;2261
315750;201402;1139;3599;1031;3452;105;441;759;2473;864;2914
315760;201402;928;2661;908;2632;24;66;864;2521;888;2587
315765;201402;1458;4607;1365;4456;172;603;1013;3351;1185;3954
315770;201402;1676;5478;1543;5209;466;1707;536;1757;1002;3464
315780;201402;23565;79006;22005;75665;7434;27419;6415;22147;13849;49566
315790;201402;3190;11201;2921;10620;335;1194;1936;7297;2271;8491
315800;201402;1535;6081;1304;5406;417;1899;232;921;649;2820
315810;201402;1496;4352;1284;4014;269;895;746;2273;1015;3168
315820;201402;3065;10256;2644;9637;723;2781;1338;5001;2061;7782
315830;201402;1475;5067;1367;4846;340;1384;426;1440;766;2824
315840;201402;734;2042;581;1756;108;369;184;509;292;878
315850;201402;1340;4843;1305;4775;397;1508;509;1840;906;3348
315860;201402;434;1622;371;1488;122;557;74;298;196;855
315870;201402;473;1442;405;1336;119;443;133;396;252;839
315880;201402;1101;3073;925;2852;270;958;412;1242;682;2200
315890;201402;1664;5749;1509;5516;461;1759;738;2809;1199;4568
315895;201402;5137;16386;4803;15758;1419;5167;2047;6520;3466;11687
315900;201402;775;2539;727;2456;187;752;382;1184;569;1936
315910;201402;620;2221;578;2138;229;883;237;856;466;1739
315920;201402;1459;4396;1071;3582;312;1166;307;937;619;2103
315930;201402;1113;3178;926;2841;293;977;286;845;579;1822
315935;201402;1164;3977;1087;3811;331;1272;332;1125;663;2397
315940;201402;645;2134;594;2042;184;715;241;803;425;1518
315950;201402;1228;3869;1152;3718;346;1151;623;2045;969;3196
315960;201402;2844;9808;2288;8676;1059;4591;166;547;1225;5138
315970;201402;807;2312;660;2099;83;265;479;1580;562;1845
315980;201402;4073;10523;2925;8546;811;2708;863;2167;1674;4875
315990;201402;4354;13274;3889;12545;914;3493;2000;6292;2914;9785
316000;201402;581;1936;515;1828;229;893;140;476;369;1369
316010;201402;452;1671;405;1560;111;491;107;360;218;851
316020;201402;1193;3818;959;3408;185;750;511;1812;696;2562
316030;201402;3633;10513;2710;9060;389;1459;1443;4955;1832;6414
316040;201402;3501;11171;2540;8956;426;1702;287;768;713;2470
316045;201402;2103;6935;1962;6702;291;917;1363;4963;1654;5880
316050;201402;375;1238;331;1173;79;312;166;570;245;882
316060;201402;782;2414;647;2222;126;541;370;1204;496;1745
316070;201402;6063;20562;5643;19717;1858;7174;2299;7637;4157;14811
316080;201402;741;2813;673;2624;164;711;134;524;298;1235
316090;201402;615;1850;474;1556;112;424;116;340;228;764
316095;201402;1301;4395;1192;4185;350;1286;660;2364;1010;3650
316100;201402;2725;9353;2177;7949;604;2497;409;1388;1013;3885
316105;201402;949;2720;721;2342;169;605;312;1046;481;1651
316110;201402;12349;44239;11285;42232;1547;6558;7802;29861;9349;36419
316120;201402;1280;4483;1186;4267;384;1442;443;1584;827;3026
316130;201402;1208;2989;937;2611;200;651;495;1357;695;2008
316140;201402;1077;3229;840;2849;146;555;480;1643;626;2198
316150;201402;1312;4136;1255;4051;351;1318;629;1950;980;3268
316160;201402;1241;3777;1004;3317;143;551;548;1796;691;2347
316165;201402;954;2698;820;2484;167;587;449;1330;616;1917
316170;201402;1404;4142;1066;3540;232;896;413;1270;645;2166
316180;201402;1231;4035;1011;3597;299;1241;279;915;578;2156
316190;201402;2692;8421;1461;5213;283;1067;242;753;525;1820
316200;201402;3801;12546;2996;10951;887;3792;844;2920;1731;6712
316210;201402;5030;16694;4675;15961;2132;7813;945;3214;3077;11027
316220;201402;672;2103;478;1733;119;503;55;209;174;712
316225;201402;1091;3256;973;3101;145;546;645;1998;790;2544
316230;201402;460;1395;382;1256;78;287;191;646;269;933
316240;201402;6255;20061;5485;19060;702;2486;4089;14458;4791;16944
316245;201402;3074;11033;2916;10772;302;1392;2203;8082;2505;9474
316250;201402;9156;29360;8126;27254;3273;11829;2083;6568;5356;18397
316255;201402;2372;7678;2112;7371;357;1186;1473;5298;1830;6484
316257;201402;1378;3950;1086;3430;282;1028;386;1132;668;2160
316260;201402;1837;5352;1421;4754;331;1250;740;2490;1071;3740
316265;201402;1182;3491;1043;3209;108;378;733;2225;841;2603
316270;201402;5169;16906;4843;16237;1433;5254;2024;6826;3457;12080
316280;201402;3301;11188;2993;10574;621;2476;1566;5514;2187;7990
316290;201402;3183;10711;2931;10229;758;3015;1270;4189;2028;7204
316292;201402;3786;12825;3510;12297;1087;4244;1421;4702;2508;8946
316294;201402;790;2650;525;2001;127;578;71;249;198;827
316295;201402;1961;7065;1847;6831;462;1976;937;3231;1399;5207
316300;201402;959;3041;841;2833;94;329;559;1941;653;2270
316310;201402;699;2229;546;1913;126;498;186;637;312;1135
316320;201402;568;1954;508;1868;140;588;126;434;266;1022
316330;201402;982;3025;822;2720;144;480;458;1556;602;2036
316340;201402;1153;3823;1025;3567;334;1311;276;870;610;2181
316350;201402;1473;4915;1350;4710;285;1025;729;2708;1014;3733
316360;201402;765;2040;608;1826;84;267;442;1336;526;1603
316370;201402;5074;17009;4557;15978;1575;5959;1008;3592;2583;9551
316380;201402;1468;4211;1225;3850;135;484;850;2686;985;3170
316390;201402;917;2828;771;2568;268;980;298;1002;566;1982
316400;201402;1473;5038;1317;4757;353;1386;510;1866;863;3252
316410;201402;1214;4116;1136;3993;270;1067;621;2146;891;3213
316420;201402;2006;6911;1868;6726;299;1209;1187;4341;1486;5550
316430;201402;945;2921;793;2659;254;943;274;873;528;1816
316440;201402;629;2147;557;2051;246;1027;191;660;437;1687
316443;201402;694;2154;590;1947;151;552;213;678;364;1230
316447;201402;1342;4524;1284;4423;168;646;1017;3481;1185;4127
316450;201402;2212;7829;1980;7359;483;1855;1086;4186;1569;6041
316460;201402;873;2827;819;2741;226;864;446;1400;672;2264
316470;201402;8162;27223;6504;23476;2121;8729;1816;6149;3937;14878
316480;201402;255;890;231;846;67;262;73;252;140;514
316490;201402;370;1213;352;1172;115;409;141;454;256;863
316500;201402;1064;3942;761;3004;193;847;50;178;243;1025
316510;201402;954;3506;868;3332;361;1436;213;818;574;2254
316520;201402;1207;3829;1013;3538;282;1142;368;1165;650;2307
316530;201402;1187;3880;1001;3489;271;1154;392;1155;663;2309
316540;201402;1021;3389;925;3231;269;1111;315;989;584;2100
316550;201402;1261;4377;1166;4227;252;1023;723;2611;975;3634
316553;201402;2237;8326;1910;7541;655;2760;401;1543;1056;4303
316555;201402;2771;9944;2496;9624;242;941;1988;7833;2230;8774
316556;201402;586;1696;495;1529;50;194;329;965;379;1159
316557;201402;730;2730;707;2692;305;1213;241;918;546;2131
316560;201402;371;1273;312;1136;80;347;78;249;158;596
316570;201402;1420;4584;1269;4268;258;942;646;2164;904;3106
316580;201402;291;857;233;747;66;243;73;213;139;456
316590;201402;1413;4200;1155;3741;221;868;637;1980;858;2848
316600;201402;1180;3920;1078;3714;179;666;634;2155;813;2821
316610;201402;611;2285;574;2218;143;635;323;1223;466;1858
316620;201402;2189;7096;1938;6583;495;1893;853;2828;1348;4721
316630;201402;1529;5184;1363;4849;588;2186;362;1307;950;3493
316640;201402;260;870;237;828;69;282;93;295;162;577
316650;201402;944;3721;854;3569;214;931;448;1969;662;2900
316660;201402;137;423;120;394;33;134;44;126;77;260
316670;201402;1845;5550;1509;4873;566;2085;318;879;884;2964
316680;201402;1987;6028;1752;5658;235;791;1317;4328;1552;5119
316690;201402;1140;3960;1042;3783;397;1622;322;1117;719;2739
316695;201402;1266;3975;1138;3750;113;371;758;2618;871;2989
316700;201402;351;1199;328;1141;80;323;153;494;233;817
316710;201402;3434;13272;3041;12406;1063;4541;883;3829;1946;8370
316720;201402;20161;69347;17585;63625;6386;24446;4306;15421;10692;39867
316730;201402;430;1387;380;1287;101;388;179;549;280;937
316740;201402;750;2631;682;2498;271;1084;177;600;448;1684
316750;201402;419;1483;385;1411;103;432;124;409;227;841
316760;201402;3598;12349;3089;11778;1838;7117;793;3206;2631;10323
316770;201402;1492;4502;1342;4300;230;824;873;2878;1103;3702
316780;201402;702;2472;659;2386;259;1007;175;600;434;1607
316790;201402;849;2540;640;2182;182;710;224;733;406;1443
316800;201402;5880;19870;5376;18935;1187;4891;2694;9040;3881;13931
316805;201402;885;2401;843;2348;141;378;622;1794;763;2172
316810;201402;558;1781;506;1675;140;522;236;751;376;1273
316820;201402;393;1138;270;931;101;382;48;155;149;537
316830;201402;607;2203;587;2166;220;866;209;744;429;1610
316840;201402;3034;9338;2644;8612;770;2853;1015;3111;1785;5964
316850;201402;2139;6886;1982;6596;489;1809;1002;3291;1491;5100
316860;201402;24105;76075;22030;72214;6287;23007;9381;30386;15668;53393
316870;201402;7078;24166;6310;22314;2335;8925;1268;4350;3603;13275
316880;201402;884;3065;856;3021;360;1398;241;796;601;2194
316890;201402;1445;3809;1153;3408;494;1626;402;1129;896;2755
316900;201402;2712;8724;2405;8117;762;2895;742;2264;1504;5159
316905;201402;446;1586;412;1508;177;694;115;398;292;1092
316910;201402;710;2492;585;2213;144;570;194;752;338;1322
316920;201402;1552;4786;1265;4334;207;795;634;2148;841;2943
316930;201402;9584;33592;8381;31046;2571;10738;1918;6690;4489;17428
316935;201402;4872;14896;3668;12751;1270;4902;843;2786;2113;7688
316940;201402;7039;24185;6043;22096;1591;6433;1637;5797;3228;12230
316950;201402;1515;4568;1342;4336;222;848;868;2750;1090;3598
316960;201402;5285;14124;4512;13116;1026;3276;2529;7318;3555;10594
316970;201402;3529;11807;3364;11517;1378;5306;870;2719;2248;8025
316980;201402;945;3032;777;2757;392;1483;186;662;578;2145
316990;201402;9941;33872;9102;32001;3761;14356;1268;4246;5029;18602
317000;201402;2581;9490;2509;9400;283;851;2056;8178;2339;9029
317005;201402;2392;7955;2300;7835;400;1403;1650;5705;2050;7108
317010;201402;29854;82691;20493;66777;5943;21664;4855;16434;10798;38098
317020;201402;49020;147488;34168;116279;8885;33511;7960;25314;16845;58825
317030;201402;886;2546;754;2344;132;503;417;1285;549;1788
317040;201402;12888;40151;11591;37741;4297;14739;4141;13680;8438;28419
317043;201402;839;2444;714;2277;179;606;390;1258;569;1864
317047;201402;1143;3142;906;2738;161;555;427;1283;588;1838
317050;201402;1836;6682;1617;6161;478;1983;533;1947;1011;3930
317052;201402;2429;7963;2174;7579;288;1092;1578;5570;1866;6662
317057;201402;1781;5248;1407;4606;233;920;705;2257;938;3177
317060;201402;387;1171;300;978;84;315;105;313;189;628
317065;201402;1217;4122;1107;3938;152;617;811;2876;963;3493
317070;201402;9497;32145;7651;28003;2384;9633;1671;6148;4055;15781
317075;201402;1260;3999;1102;3713;397;1463;345;1106;742;2569
317080;201402;7025;20617;6477;19710;2109;6992;2324;7062;4433;14054
317090;201402;4841;16823;4561;16326;803;2960;2954;10831;3757;13791
317100;201402;3277;9827;2853;9108;991;3531;1103;3318;2094;6849
317103;201402;1990;7058;1699;6449;360;1700;752;2761;1112;4461
317107;201402;1331;4239;1167;3910;280;1057;569;1818;849;2875
317110;201402;749;2100;534;1682;153;580;192;543;345;1123
317115;201402;1086;3535;964;3268;148;530;617;2100;765;2630
317120;201402;13285;45886;11598;41883;3959;15270;3982;14150;7941;29420
317130;201402;8894;29005;8136;27619;2274;8727;3413;11247;5687;19974
317140;201402;665;2323;626;2247;88;346;394;1417;482;1763
317150;201402;1048;2913;891;2733;113;411;642;1947;755;2358
317160;201402;3834;10466;2936;9332;425;1605;1908;5967;2333;7572
317170;201402;1997;5965;1812;5653;252;930;1077;3197;1329;4127
317180;201402;1813;6303;1471;5524;425;1744;447;1640;872;3384
317190;201402;1252;3896;1149;3756;104;393;918;2992;1022;3385
317200;201402;4557;15473;4202;14699;1452;5542;1065;3571;2517;9113
317210;201402;1079;3452;928;3207;279;1090;405;1386;684;2476
317220;201402;353;1284;344;1274;129;482;166;636;295;1118
320010;201402;5938;18899;5321;17500;943;3394;2663;8710;3606;12104
320013;201402;2027;6036;1490;5083;215;779;834;2930;1049;3709
320016;201402;3514;9961;3002;9235;537;1688;1981;6216;2518;7904
320020;201402;4208;13906;3900;13235;1353;4909;1394;4723;2747;9632
320030;201402;1747;5811;1588;5459;480;1785;613;2051;1093;3836
320035;201402;1755;5562;1588;5275;539;1967;535;1725;1074;3692
320040;201402;3123;10745;2667;9665;701;2763;766;2703;1467;5466
320050;201402;1915;5400;1652;4880;313;1036;907;2622;1220;3658
320060;201402;11194;35768;8930;30511;2286;8660;3077;9951;5363;18611
320070;201402;1826;6227;1609;5703;520;1973;398;1305;918;3278
320080;201402;5587;16794;4564;14739;1440;5013;1433;4554;2873;9567
320090;201402;9103;26372;7206;22651;2061;6977;3036;9203;5097;16180
320100;201402;3260;9956;2730;8896;658;2313;1239;3962;1897;6275
320110;201402;1545;4792;1419;4541;391;1347;465;1454;856;2801
320115;201402;1853;6892;1783;6730;770;2998;728;2784;1498;5782
320120;201402;17340;59779;15531;56219;5670;21989;4222;15352;9892;37341
320130;201402;40740;137970;38161;132469;11560;43642;16557;55973;28117;99615
320140;201402;4112;13576;3004;10802;742;2976;317;1063;1059;4039
320150;201402;18064;52294;13806;44154;4353;15054;2257;7060;6610;22114
320160;201402;5312;16670;4677;15643;1276;4816;1988;6187;3264;11003
320170;201402;1952;6478;1762;6070;599;2162;551;1956;1150;4118
320180;201402;915;3055;827;2919;308;1145;303;1067;611;2212
320190;201402;4312;15835;3966;14912;1418;5562;1076;3996;2494;9558
320200;201402;1129;3780;1018;3543;319;1200;418;1468;737;2668
320210;201402;6032;16774;5264;15464;1292;4309;2650;7520;3942;11829
320220;201402;2899;8983;2309;7933;699;2632;808;2789;1507;5421
320225;201402;1462;5266;1295;4823;468;1862;263;995;731;2857
320230;201402;4273;14503;4004;13986;1363;5181;1377;4904;2740;10085
320240;201402;9283;29053;7558;25658;2311;8429;1897;6573;4208;15002
320245;201402;4178;14503;3937;13933;1288;4812;1503;5262;2791;10074
320250;201402;1777;5618;1357;4644;353;1337;281;883;634;2220
320255;201402;2035;6906;1776;6451;741;2897;587;2187;1328;5084
320260;201402;1214;3883;991;3293;274;1014;364;1069;638;2083
320265;201402;2523;7867;2146;7412;285;1030;1552;5520;1837;6550
320270;201402;2704;8445;2144;7335;544;2005;935;3180;1479;5185
320280;201402;7241;22247;6685;21309;1450;5070;3637;11520;5087;16590
320290;201402;1606;5469;1400;4934;530;1965;332;1083;862;3048
320300;201402;4261;14711;3999;14116;1233;4624;1459;5168;2692;9792
320305;201402;4724;15782;4351;14921;1134;4306;1943;6462;3077;10768
320310;201402;1991;6152;1798;5801;469;1639;780;2422;1249;4061
320313;201402;2370;7253;1723;5758;476;1845;291;858;767;2703
320316;201402;2236;7121;2120;6850;618;2114;922;2948;1540;5062
320320;201402;18798;61823;16493;57372;5058;19646;6320;21363;11378;41009
320330;201402;2956;9178;2604;8568;579;1915;1448;4938;2027;6853
320332;201402;4949;17105;4535;16346;1549;5897;1755;6517;3304;12414
320334;201402;1482;5247;1232;4635;425;1767;228;783;653;2550
320335;201402;2213;6768;1654;5531;567;2103;299;936;866;3039
320340;201402;5755;16625;4684;14763;1168;4109;2091;6469;3259;10578
320350;201402;5538;14503;4171;12239;877;2917;1906;5462;2783;8379
320360;201402;1769;4797;1364;4043;268;897;667;1864;935;2761
320370;201402;3450;11626;3035;10804;945;3502;1143;4090;2088;7592
320380;201402;2777;8683;2499;8144;587;2072;1262;4017;1849;6089
320390;201402;8280;25560;7003;23021;2103;7713;2353;7427;4456;15140
320400;201402;4202;12219;3558;11291;772;2784;2023;6246;2795;9030
320405;201402;4156;12525;3833;12098;1196;4222;2020;6178;3216;10400
320410;201402;6188;15589;4583;13747;789;2457;3046;9290;3835;11747
320420;201402;2303;7331;1843;6607;787;3057;296;1013;1083;4070
320425;201402;2450;6338;2017;5706;319;1081;1205;3374;1524;4455
320430;201402;2375;7129;2155;6694;442;1505;1054;3219;1496;4724
320435;201402;2423;8386;2117;7713;962;3674;636;2369;1598;6043
320440;201402;1428;4861;1287;4461;399;1497;385;1248;784;2745
320450;201402;2528;8237;2192;7531;644;2438;910;3026;1554;5464
320455;201402;4738;17027;3855;14803;1196;4811;744;2794;1940;7605
320460;201402;3075;10215;2514;8989;792;3064;768;2614;1560;5678
320465;201402;1624;5253;1310;4480;279;1028;508;1682;787;2710
320470;201402;4465;14002;3289;11413;1041;3979;475;1501;1516;5480
320480;201402;1959;6049;1659;5470;421;1607;687;2134;1108;3741
320490;201402;17708;57269;15120;52106;5217;19334;4736;16754;9953;36088
320495;201402;1448;4651;1173;4008;460;1708;275;916;735;2624
320500;201402;45659;145368;40222;134995;13292;48330;16243;53373;29535;101703
320501;201402;3550;11902;3306;11478;1166;4545;1396;4659;2562;9204
320503;201402;2321;8519;2028;7767;701;2867;503;1745;1204;4612
320506;201402;3262;10470;2346;8127;713;2677;269;835;982;3512
320510;201402;8550;27577;7589;25659;2636;9545;2677;8904;5313;18449
320515;201402;2105;6127;1893;5727;549;1788;675;2015;1224;3803
320517;201402;2212;7444;1890;6734;696;2682;409;1372;1105;4054
320520;201402;32883;107679;28540;99134;9343;35910;11406;39261;20749;75171
320530;201402;27717;88396;24227;81399;6697;25586;10094;32245;16791;57831
330010;201402;16469;53131;15415;50958;3375;12615;8889;28312;12264;40927
330015;201402;1978;5603;1720;5112;471;1571;594;1698;1065;3269
330020;201402;16518;50563;15242;48525;3746;12892;8262;26150;12008;39042
330022;201402;1665;5410;1498;5083;314;1222;773;2508;1087;3730
330023;201402;3386;11156;3198;10761;867;3221;1252;4029;2119;7250
330025;201402;3318;10348;3077;9970;784;2743;1805;5772;2589;8515
330030;201402;7553;26648;7003;25489;2066;8301;2914;10085;4980;18386
330040;201402;14469;42113;12380;38763;3465;11655;5875;18073;9340;29728
330045;201402;65666;192932;60491;185003;9717;32003;40337;122952;50054;154955
330050;201402;2939;9551;2637;8948;968;3685;663;2054;1631;5739
330060;201402;5506;17231;4997;16500;1171;4355;2955;9794;4126;14149
330070;201402;25411;79996;23398;76351;6679;23463;10038;32676;16717;56139
330080;201402;9324;27107;8910;26537;1867;5515;5857;18050;7724;23565
330090;201402;3206;9095;3019;8763;876;2771;1388;3931;2264;6702
330093;201402;1975;5884;1734;5480;437;1490;681;2104;1118;3594
330095;201402;1199;4220;1126;4051;431;1718;175;542;606;2260
330100;201402;54932;185096;51377;178941;12240;47471;25870;90443;38110;137914
330110;201402;2670;8568;2461;8177;807;2910;780;2585;1587;5495
330115;201402;2464;7558;2298;7270;760;2628;925;2823;1685;5451
330120;201402;2521;7487;2309;7198;741;2480;948;2882;1689;5362
330130;201402;3979;13342;3639;12679;1212;4582;1347;4653;2559;9235
330140;201402;3399;10515;3111;10118;843;3034;1429;4642;2272;7676
330150;201402;2579;7836;2026;6685;565;2063;430;1359;995;3422
330160;201402;1390;4900;1295;4695;480;1898;409;1421;889;3319
330170;201402;103364;318738;97361;309409;14979;51183;68185;216964;83164;268147
330180;201402;1754;5480;1605;5194;260;1090;1008;3006;1268;4096
330185;201402;7952;25513;7428;24615;1971;6917;3919;13327;5890;20244
330187;201402;4319;12537;3870;11804;830;2888;2238;6746;3068;9634
330190;201402;28076;86123;26874;84161;6918;23108;15425;47599;22343;70707
330200;201402;13642;43679;12392;41301;2957;10167;6517;22149;9474;32316
330205;201402;2581;7136;2317;6694;529;1796;1138;3135;1667;4931
330210;201402;4745;12460;3434;10053;1042;3329;757;2179;1799;5508
330220;201402;11351;36425;10605;34901;3507;12539;3264;10188;6771;22727
330225;201402;4062;12963;3837;12619;588;2282;2673;8764;3261;11046
330227;201402;17690;50975;16070;48754;3995;12973;8968;26716;12963;39689
330230;201402;1520;4557;1403;4345;436;1518;534;1521;970;3039
330240;201402;20367;64087;18347;60518;7054;25533;3210;10303;10264;35836
330245;201402;1234;3995;1044;3599;313;1187;219;760;532;1947
330250;201402;37393;111060;35261;107621;10270;31973;18277;56963;28547;88936
330260;201402;3804;12171;3554;11646;915;3311;1550;4886;2465;8197
330270;201402;14199;42279;12125;38947;3647;12516;4403;14304;8050;26820
330280;201402;1994;6406;1724;5853;407;1572;774;2444;1181;4016
330285;201402;18326;55304;16939;53338;3819;12762;10219;32356;14038;45118
330290;201402;3594;10191;3210;9667;674;2331;1833;5242;2507;7573
330300;201402;4153;13692;3945;13332;940;3452;2051;6974;2991;10426
330310;201402;2759;8195;2531;7810;629;2063;1244;3790;1873;5853
330320;201402;12198;37091;11491;36012;1924;6546;7947;24872;9871;31418
330330;201402;31760;92502;29388;88785;7428;24325;16929;50384;24357;74709
330340;201402;14626;45903;12147;40924;3807;13853;3424;11340;7231;25193
330350;201402;92208;299339;89923;296102;16735;55696;63225;212038;79960;267734
330360;201402;5539;17760;5419;17572;800;2858;3998;12891;4798;15749
330370;201402;3806;14280;3622;13823;1438;5730;1168;4478;2606;10208
330380;201402;4398;14541;3901;13631;1120;4236;1772;6178;2892;10414
330385;201402;4053;14278;3783;13739;1307;5069;1339;4847;2646;9916
330390;201402;24255;82526;22355;78733;5535;21829;11105;38097;16640;59926
330395;201402;3361;10191;3152;9840;531;1821;1963;6148;2494;7969
330400;201402;2581;8760;2375;8369;541;2215;1149;3713;1690;5928
330410;201402;3103;10012;2695;9182;629;2263;1309;4480;1938;6743
330411;201402;2529;8116;2295;7656;493;1899;1177;3692;1670;5591
330412;201402;1387;4825;1124;4318;274;1204;390;1440;664;2644
330414;201402;25879;74379;22305;69584;4608;15314;13540;42383;18148;57697
330415;201402;3668;11718;3275;11006;838;3140;1407;4713;2245;7853
330420;201402;7909;25857;6175;22240;1831;7258;1081;3836;2912;11094
330430;201402;8257;24776;7464;23393;1809;6359;3603;10997;5412;17356
330440;201402;2119;7172;1794;6495;594;2428;407;1340;1001;3768
330450;201402;1616;5706;1530;5526;480;1948;596;2092;1076;4040
330452;201402;10601;33217;8919;29880;2538;9424;3513;11270;6051;20694
330455;201402;469865;1398426;406985;1295395;111866;382252;197842;627198;309708;1009450
330460;201402;1394;4758;1316;4611;366;1470;610;2084;976;3554
330470;201402;4468;14804;4178;14226;1485;5474;1285;4247;2770;9721
330475;201402;8271;26600;7504;25333;2038;7618;3663;12287;5701;19905
330480;201402;6464;19822;6112;19190;1753;5958;2523;7851;4276;13809
330490;201402;100563;285580;93918;275962;13226;40988;70346;207584;83572;248572
330500;201402;6894;21266;6490;20465;1458;4972;3383;10917;4841;15889
330510;201402;42172;137713;39872;133928;13883;47551;18351;63284;32234;110835
330513;201402;1580;4806;1463;4579;574;1891;474;1465;1048;3356
330515;201402;3072;9877;2834;9441;972;3471;1018;3340;1990;6811
330520;201402;13461;40713;12450;39081;3234;10713;6531;20573;9765;31286
330530;201402;1562;4721;1451;4528;394;1374;699;2103;1093;3477
330540;201402;3307;10205;2906;9581;895;3196;1110;3570;2005;6766
330550;201402;9029;30127;8033;28276;3278;12306;1886;6740;5164;19046
330555;201402;10404;32175;9415;30666;1941;6550;5798;19262;7739;25812
330560;201402;4199;13076;3953;12671;868;3238;2198;6859;3066;10097
330570;201402;3680;10746;3211;9961;861;2816;1611;5067;2472;7883
330575;201402;5419;16619;5011;15864;1215;4140;2816;8653;4031;12793
330580;201402;16810;55169;14984;51494;5139;18547;5124;18000;10263;36547
330590;201402;1962;5996;1840;5783;547;1815;883;2793;1430;4608
330600;201402;9596;29287;8307;27235;1342;5376;5132;16042;6474;21418
330610;201402;8977;29480;8324;28268;2208;8385;3912;13077;6120;21462
330615;201402;1668;6008;1543;5660;682;2608;399;1517;1081;4125
330620;201402;4040;14309;3748;13726;1329;5227;1023;3895;2352;9122
330630;201402;21166;70319;19193;66207;5400;20756;8793;28927;14193;49683
350010;201402;2942;9346;2369;8137;719;2645;432;1410;1151;4055
350020;201402;615;1758;477;1503;119;428;181;535;300;963
350030;201402;4737;15361;4023;13764;1443;5460;1117;3668;2560;9128
350040;201402;595;2174;521;2013;168;707;103;359;271;1066
350050;201402;1405;4650;1187;4250;322;1331;378;1228;700;2559
350055;201402;620;2092;600;2060;177;661;291;979;468;1640
350060;201402;86;294;79;281;24;106;28;84;52;190
350070;201402;2684;9078;2211;7954;522;2080;403;1271;925;3351
350075;201402;507;1852;469;1770;157;644;124;430;281;1074
350080;201402;602;1789;485;1550;135;503;176;545;311;1048
350090;201402;592;1713;451;1474;122;432;121;358;243;790
350100;201402;1954;6819;1665;6107;556;2189;465;1631;1021;3820
350110;201402;467;1446;373;1233;103;381;115;345;218;726
350115;201402;1334;4422;1196;4075;273;1068;531;1652;804;2720
350120;201402;526;1449;309;992;68;248;82;249;150;497
350130;201402;3709;11516;3393;10897;871;3118;1435;4259;2306;7377
350140;201402;691;2198;628;2070;164;620;251;781;415;1401
350150;201402;436;1509;400;1424;151;572;95;330;246;902
350160;201402;6106;19566;4751;16583;1468;5657;1654;5307;3122;10964
350170;201402;2279;8193;2057;7633;731;2823;452;1599;1183;4422
350180;201402;1438;3799;1205;3409;309;923;516;1428;825;2351
350190;201402;3241;11225;2820;10371;862;3649;1213;4007;2075;7656
350200;201402;418;1440;380;1374;128;529;128;440;256;969
350210;201402;7610;21630;6131;19057;2332;7865;1878;5523;4210;13388
350220;201402;3144;10261;2895;9786;1013;3877;801;2439;1814;6316
350230;201402;747;2573;691;2481;236;928;224;800;460;1728
350240;201402;599;1837;522;1715;119;466;282;880;401;1346
350250;201402;2757;10304;2667;10127;1122;4521;844;3181;1966;7702
350260;201402;1066;2889;897;2584;214;639;374;1103;588;1742
350270;201402;5288;16488;4721;15329;1006;3507;2236;7238;3242;10745
350275;201402;2038;6827;1831;6503;564;2230;700;2310;1264;4540
350280;201402;22990;61248;15294;47126;3898;12924;3110;9669;7008;22593
350290;201402;1755;6182;1578;5765;481;1832;458;1722;939;3554
350300;201402;490;1574;460;1507;149;532;149;490;298;1022
350310;201402;1020;3432;958;3288;221;888;410;1350;631;2238
350315;201402;565;1803;469;1601;78;342;155;500;233;842
350320;201402;12065;40246;11173;38208;3574;13104;1923;6383;5497;19487
350330;201402;9633;28905;8549;26657;2096;7293;4389;12767;6485;20060
350335;201402;553;1654;510;1564;131;414;193;657;324;1071
350340;201402;1043;3362;837;2983;232;914;221;761;453;1675
350350;201402;763;2461;672;2307;187;726;218;752;405;1478
350360;201402;830;2963;731;2724;229;896;242;925;471;1821
350370;201402;704;2209;546;1842;105;404;115;344;220;748
350380;201402;3785;12469;3204;11553;1324;5157;706;2401;2030;7558
350390;201402;8728;28559;7830;26941;2120;7847;3699;12320;5819;20167
350395;201402;322;1026;248;872;73;279;51;175;124;454
350400;201402;8285;24658;6901;22170;2043;7195;2426;7430;4469;14625
350410;201402;7579;28378;6798;26524;2439;10258;1549;5811;3988;16069
350420;201402;1020;3267;835;2907;392;1449;75;246;467;1695
350430;201402;868;2754;758;2565;207;842;366;1175;573;2017
350440;201402;1409;4547;1335;4410;477;1688;620;1974;1097;3662
350450;201402;8051;25002;6635;22155;2080;7469;1772;5715;3852;13184
350460;201402;1539;4613;1142;3765;332;1211;319;933;651;2144
350470;201402;238;703;204;645;54;198;90;260;144;458
350480;201402;786;2452;538;1850;90;353;84;242;174;595
350490;201402;2119;6218;1820;5822;524;1935;841;2502;1365;4437
350500;201402;617;1848;539;1730;140;511;220;658;360;1169
350510;201402;1105;3587;955;3255;301;1161;330;1004;631;2165
350520;201402;1281;5045;1168;4795;451;1936;291;1169;742;3105
350530;201402;2551;7790;2127;6852;807;2816;508;1477;1315;4293
350535;201402;1470;4407;1438;4361;79;276;1260;3834;1339;4110
350540;201402;2067;6040;1773;5529;507;1736;659;2051;1166;3787
350550;201402;10960;32652;8946;29194;2519;9274;3349;10252;5868;19526
350560;201402;3492;11854;3190;11246;648;2439;1648;5958;2296;8397
350570;201402;21179;74115;19507;70271;6349;24491;6865;23756;13214;48247
350580;201402;2030;6753;1720;6064;516;2012;253;768;769;2780
350590;201402;4162;13670;3260;11698;1017;4043;1073;3490;2090;7533
350600;201402;39194;101196;27639;82979;5836;19124;13027;37985;18863;57109
350610;201402;9232;27408;7495;24463;2034;7467;3305;10312;5339;17779
350620;201402;468;1450;391;1331;91;351;164;533;255;884
350630;201402;1657;5268;1339;4636;422;1671;151;462;573;2133
350635;201402;5051;16619;4124;14777;1272;4805;1492;5407;2764;10212
350640;201402;679;2194;560;1872;158;571;172;531;330;1102
350650;201402;4393;14507;3230;11721;1207;4828;305;1046;1512;5874
350660;201402;3773;12152;3323;11362;923;3391;1551;5258;2474;8649
350670;201402;1886;5932;1774;5733;365;1330;1106;3419;1471;4749
350680;201402;1223;3860;995;3390;294;1189;392;1276;686;2465
350690;201402;1070;3677;938;3387;284;1142;237;786;521;1928
350700;201402;2708;9483;2390;8760;945;3843;859;2803;1804;6646
350710;201402;2199;7020;2015;6735;349;1326;1329;4385;1678;5711
350715;201402;1128;3485;1011;3262;272;984;380;1134;652;2118
350720;201402;142;440;132;421;50;178;43;112;93;290
350730;201402;432;1663;408;1591;128;555;113;401;241;956
350740;201402;2412;7414;2186;6921;589;2043;898;2839;1487;4882
350745;201402;352;1141;290;992;67;277;121;355;188;632
350750;201402;9906;30888;7772;26587;2147;8091;1921;6158;4068;14249
350760;201402;12249;39684;11202;37754;3654;13783;4770;15161;8424;28944
350770;201402;917;2741;668;2247;145;562;240;786;385;1348
350775;201402;635;1906;585;1820;136;492;259;792;395;1284
350780;201402;2126;6547;1627;5504;430;1625;230;731;660;2356
350790;201402;2143;7107;1738;6234;534;2036;334;1073;868;3109
350800;201402;3100;10754;2961;10518;656;2598;1777;6203;2433;8801
350810;201402;2613;7751;2309;7212;779;2662;683;2134;1462;4796
350820;201402;555;1560;414;1258;92;318;144;393;236;711
350830;201402;887;2857;647;2254;123;476;123;350;246;826
350840;201402;2317;8462;1948;7495;625;2655;358;1194;983;3849
350850;201402;6859;23605;5757;20957;1953;7531;1258;4315;3211;11846
350860;201402;3402;11189;3273;10996;533;2042;2407;8035;2940;10077
350870;201402;2434;8436;2193;8065;762;3009;1068;3938;1830;6947
350880;201402;1704;5857;1468;5325;445;1735;284;1026;729;2761
350890;201402;653;1981;534;1728;99;361;176;479;275;840
350900;201402;4594;15580;3889;14029;1065;4195;1072;3615;2137;7810
350910;201402;881;2771;836;2676;370;1234;274;861;644;2095
350920;201402;9778;29811;9110;28704;1807;6334;5677;17215;7484;23549
350925;201402;5341;16880;4801;15806;1450;5238;1976;6263;3426;11501
350930;201402;1558;4380;1311;3971;160;595;917;2666;1077;3261
350940;201402;2305;7807;2114;7493;458;1896;1253;4241;1711;6137
350945;201402;952;3213;850;2997;223;871;348;1174;571;2045
350950;201402;72120;234356;61719;213234;18274;69053;23931;80219;42205;149272
350960;201402;4648;16587;4156;15470;835;3576;2225;7937;3060;11513
350970;201402;4339;15960;3938;14968;1510;6168;1132;4127;2642;10295
350980;201402;687;2260;634;2172;289;1079;130;437;419;1516
350990;201402;1820;6473;1621;6093;583;2382;510;1878;1093;4260
350995;201402;811;2968;770;2890;220;938;367;1307;587;2245
351000;201402;3559;11079;3118;10235;531;2034;1759;5550;2290;7584
351010;201402;422;1299;314;1070;120;451;65;221;185;672
351015;201402;960;3231;834;2992;317;1293;237;768;554;2061
351020;201402;7863;26108;7029;24844;1850;7061;3726;13383;5576;20444
351030;201402;1419;5315;1320;5082;383;1680;438;1599;821;3279
351040;201402;3708;12042;3447;11593;826;3236;1954;6154;2780;9390
351050;201402;9366;30735;7750;27566;2693;10381;2467;8739;5160;19120
351060;201402;33444;106510;28517;97390;9527;34534;9471;32443;18998;66977
351070;201402;1834;5326;1358;4476;468;1696;250;730;718;2426
351080;201402;2794;8587;2214;7875;660;2570;963;3362;1623;5932
351090;201402;385;1362;312;1207;110;488;51;179;161;667
351100;201402;1923;6285;1715;5877;686;2432;469;1621;1155;4053
351110;201402;8780;24697;6016;19776;1882;6817;1635;5083;3517;11900
351120;201402;607;1896;520;1695;74;291;249;726;323;1017
351130;201402;885;2481;462;1590;90;361;115;352;205;713
351140;201402;2009;7035;1845;6676;700;2762;550;1926;1250;4688
351150;201402;2240;7875;1843;6794;501;2022;419;1404;920;3426
351160;201402;1530;5453;1394;5135;479;1958;448;1585;927;3543
351170;201402;1650;5514;1334;4770;377;1455;484;1583;861;3038
351190;201402;770;2548;652;2236;153;558;142;422;295;980
351200;201402;2214;6771;1927;6249;352;1358;946;2797;1298;4155
351210;201402;1107;3522;943;3201;294;1088;278;873;572;1961
351220;201402;3546;12174;3158;11370;900;3540;1295;4590;2195;8130
351230;201402;1889;6461;1718;6122;557;2203;784;2719;1341;4922
351240;201402;1028;3389;760;2767;214;856;169;547;383;1403
351250;201402;891;2622;668;2168;147;521;312;969;459;1490
351260;201402;1194;3628;1083;3394;298;1027;407;1225;705;2252
351270;201402;395;1438;364;1377;117;508;108;358;225;866
351280;201402;5338;16279;3936;13056;1054;3729;1139;3422;2193;7151
351290;201402;1016;3169;907;2949;284;958;266;817;550;1775
351300;201402;10155;37814;8923;34918;2645;11237;3157;12242;5802;23479
351310;201402;3410;10848;2891;9900;720;2859;1338;4221;2058;7080
351320;201402;1007;3592;888;3311;299;1227;205;672;504;1899
351330;201402;283;835;255;783;106;330;64;190;170;520
351340;201402;6691;23607;6085;22366;1790;6946;2877;10602;4667;17548
351350;201402;7869;26202;7076;24512;2146;7853;2513;8367;4659;16220
351360;201402;4901;15175;4625;14705;1300;4679;2117;6519;3417;11198
351370;201402;1968;6513;1618;5770;549;2187;357;1125;906;3312
351380;201402;37774;119948;35289;114977;9544;34007;16307;50882;25851;84889
351385;201402;252;807;246;798;92;306;87;277;179;583
351390;201402;1253;4283;1123;4012;435;1677;359;1194;794;2871
351400;201402;1237;4027;1181;3902;427;1498;401;1363;828;2861
351410;201402;2965;9177;2658;8652;626;2202;1334;4278;1960;6480
351420;201402;458;1361;333;1084;74;265;56;168;130;433
351430;201402;908;2917;830;2774;167;621;532;1758;699;2379
351440;201402;4741;14712;4144;13443;1567;5320;1017;3112;2584;8432
351450;201402;1822;5276;1614;5001;495;1562;831;2671;1326;4233
351460;201402;840;2687;719;2447;342;1249;200;642;542;1891
351470;201402;1096;3419;982;3205;394;1420;281;884;675;2304
351480;201402;2964;9876;2717;9456;692;2883;1288;4319;1980;7202
351490;201402;2018;6914;1816;6474;376;1572;963;3274;1339;4846
351492;201402;302;1036;233;850;50;219;66;195;116;414
351495;201402;161;564;134;491;40;156;45;155;85;311
351500;201402;20451;66933;18360;62847;5888;21857;7120;23738;13008;45595
351510;201402;7636;25197;6650;23512;1718;6612;3288;11519;5006;18131
351512;201402;409;1248;359;1153;92;320;144;455;236;775
351515;201402;2038;6886;1660;6008;520;2023;436;1512;956;3535
351518;201402;1627;5715;1252;5064;375;1667;249;943;624;2610
351519;201402;803;2650;701;2418;198;787;261;824;459;1611
351520;201402;822;2321;406;1467;65;274;52;167;117;441
351530;201402;470;1501;408;1345;89;317;125;362;214;679
351535;201402;2634;6943;2152;6246;268;900;1440;4094;1708;4994
351540;201402;2135;6944;1920;6545;945;3415;347;1145;1292;4560
351550;201402;5782;17919;4617;15521;1622;5767;1214;3964;2836;9731
351560;201402;432;1433;381;1315;140;535;58;191;198;726
351565;201402;239;818;223;774;68;282;86;262;154;544
351570;201402;12629;41685;11093;38560;3440;12439;4719;16431;8159;28870
351580;201402;399;1125;301;917;58;176;94;265;152;441
351590;201402;459;1309;401;1176;141;445;79;214;220;659
351600;201402;1894;5575;1727;5276;410;1463;803;2230;1213;3693
351610;201402;654;1862;559;1702;116;421;278;790;394;1211
351620;201402;17570;58607;13887;50563;3645;14628;3343;10882;6988;25510
351630;201402;14844;51057;13730;49226;3994;14870;7029;25611;11023;40481
351640;201402;8341;27306;7007;24976;1776;6940;3470;12155;5246;19095
351650;201402;379;1156;254;852;66;247;37;112;103;359
351660;201402;878;2788;698;2374;170;662;200;601;370;1263
351670;201402;4250;13593;3620;12264;753;2920;1762;5661;2515;8581
351680;201402;628;1959;439;1491;99;367;77;231;176;598
351685;201402;443;1364;359;1214;110;391;122;424;232;815
351690;201402;1344;4049;1067;3431;450;1457;256;764;706;2221
351700;201402;1475;4509;1350;4280;455;1509;437;1334;892;2843
351710;201402;807;2564;681;2277;167;567;201;635;368;1202
351720;201402;1686;5430;1299;4416;289;1101;432;1394;721;2495
351730;201402;1115;3397;960;3184;405;1490;253;774;658;2264
351740;201402;4609;13433;4008;12160;1079;3532;1279;3643;2358;7175
351750;201402;1501;5028;1320;4648;407;1569;333;1082;740;2651
351760;201402;3781;12420;3387;11562;915;3406;1441;4713;2356;8119
351770;201402;2268;7477;1976;6928;730;2669;838;2941;1568;5610
351780;201402;1635;4714;1121;3612;295;1046;230;681;525;1727
351790;201402;1157;3494;989;3255;342;1198;413;1330;755;2528
351800;201402;347;847;303;763;44;133;183;425;227;558
351810;201402;1193;3687;1128;3606;297;1111;682;2058;979;3169
351820;201402;2252;6946;1684;5868;647;2416;189;631;836;3047
351830;201402;4086;13608;3726;12816;933;3551;1686;5589;2619;9140
351840;201402;8975;31467;8101;29636;2774;10737;2487;9069;5261;19806
351850;201402;1331;4544;1113;4068;311;1259;230;753;541;2012
351860;201402;3613;11841;3347;11321;840;3201;1713;5500;2553;8701
351870;201402;35408;111409;32715;106740;7811;27582;18799;61034;26610;88616
351880;201402;112718;371868;99927;346158;32387;118903;29121;100419;61508;219322
351885;201402;659;2436;617;2337;172;693;266;978;438;1671
351890;201402;817;2477;654;2128;207;712;142;429;349;1141
351900;201402;1452;4545;1275;4260;410;1479;458;1527;868;3006
351905;201402;409;1443;355;1341;97;425;161;552;258;977
351907;201402;14920;47971;13160;44557;3024;11536;6395;20656;9419;32192
351910;201402;1170;3815;1087;3668;266;1013;367;1157;633;2170
351920;201402;1207;3535;1148;3447;273;942;670;1945;943;2887
351925;201402;982;2933;924;2841;138;547;618;1761;756;2308
351930;201402;3156;10936;2930;10457;837;3401;1258;4074;2095;7475
351940;201402;1019;3168;953;3047;277;978;549;1680;826;2658
351950;201402;1402;3974;1035;3251;222;768;451;1334;673;2102
351960;201402;3975;13194;3437;12184;1204;4374;1389;5118;2593;9492
351970;201402;7027;26857;6411;25535;2366;9966;2002;7932;4368;17898
351980;201402;976;3020;820;2724;181;708;327;976;508;1684
351990;201402;1606;4680;1326;4132;369;1346;363;963;732;2309
352000;201402;2483;8123;2285;7722;570;2087;1007;3266;1577;5353
352010;201402;2281;7888;2093;7414;754;2830;439;1545;1193;4375
352020;201402;1513;4954;1370;4665;438;1574;438;1488;876;3062
352030;201402;4511;14408;4127;13915;984;3548;2325;7984;3309;11532
352040;201402;1837;6547;1598;5946;459;1810;356;1245;815;3055
352042;201402;2321;6771;1769;5595;451;1601;849;2590;1300;4191
352044;201402;1374;4752;1119;4096;274;1078;241;806;515;1884
352050;201402;7779;26740;5831;22203;1810;7542;984;3295;2794;10837
352060;201402;820;2472;732;2334;210;786;286;818;496;1604
352070;201402;739;2034;684;1944;296;913;201;597;497;1510
352080;201402;536;1680;461;1552;123;470;152;459;275;929
352090;201402;1719;5633;1425;5017;345;1362;474;1527;819;2889
352100;201402;1804;6275;1624;5917;547;2238;575;1887;1122;4125
352110;201402;436;1655;390;1546;118;514;112;420;230;934
352115;201402;378;1249;323;1132;97;374;148;488;245;862
352120;201402;982;2942;864;2780;180;624;489;1620;669;2244
352130;201402;1800;5156;1359;4400;366;1299;511;1510;877;2809
352140;201402;1470;4781;1150;4053;337;1254;443;1552;780;2806
352150;201402;612;1855;503;1660;178;635;183;574;361;1209
352160;201402;1253;3595;1157;3458;259;834;645;1944;904;2778
352170;201402;3201;9943;2929;9469;822;2907;1369;4208;2191;7115
352180;201402;3616;10515;3203;9760;865;2884;1398;4033;2263;6917
352190;201402;1073;3365;985;3208;222;879;499;1496;721;2375
352200;201402;422;1484;354;1347;74;310;162;636;236;946
352210;201402;15915;43909;12887;39430;2579;8375;7626;23932;10205;32307
352215;201402;562;1809;508;1730;78;297;291;1014;369;1311
352220;201402;14960;50596;13980;48607;4731;17510;5163;17890;9894;35400
352230;201402;13628;47399;12105;44536;3762;15176;4496;16196;8258;31372
352240;201402;10048;32454;9312;31138;3199;11992;3524;11114;6723;23106
352250;201402;22719;74236;20198;69129;5373;20186;7814;26404;13187;46590
352260;201402;5403;16939;3908;13824;1049;4132;1222;3950;2271;8082
352265;201402;941;3045;823;2858;142;575;503;1703;645;2278
352270;201402;2578;8873;2248;8128;881;3364;476;1637;1357;5001
352280;201402;2452;7806;2117;7260;597;2294;695;2306;1292;4600
352290;201402;1308;4310;1148;3961;288;1129;326;999;614;2128
352300;201402;967;2934;813;2658;237;830;340;1107;577;1937
352310;201402;32029;109587;29205;104738;8108;31320;16421;57857;24529;89177
352320;201402;5719;17967;5018;16656;1599;5789;1645;4919;3244;10708
352330;201402;2210;7357;1943;7032;717;2788;645;2341;1362;5129
352340;201402;5824;20239;4856;17877;1633;6485;894;2991;2527;9476
352350;201402;1776;6610;1618;6251;447;1895;537;1976;984;3871
352360;201402;1198;4011;1073;3754;303;1258;567;1819;870;3077
352370;201402;907;3119;829;2952;195;778;374;1313;569;2091
352380;201402;1025;3320;908;3122;355;1369;249;816;604;2185
352390;201402;11717;35986;9435;31616;2170;8400;4418;13784;6588;22184
352400;201402;3299;10031;2265;7984;655;2569;841;2793;1496;5362
352410;201402;3734;11141;2894;9710;950;3449;858;2749;1808;6198
352420;201402;1290;3753;1209;3614;461;1539;422;1243;883;2782
352430;201402;6300;20168;5600;19003;2213;8193;1720;5638;3933;13831
352440;201402;15930;50951;13291;45758;3614;13478;5005;16760;8619;30238
352450;201402;635;1927;449;1567;123;471;91;280;214;751
352460;201402;2708;9231;2459;8766;873;3462;809;2660;1682;6122
352470;201402;4909;14048;3058;10179;575;2095;1266;4119;1841;6214
352480;201402;5418;15528;4484;13818;1201;4276;1820;5160;3021;9436
352490;201402;743;2688;639;2447;153;665;120;439;273;1104
352500;201402;8814;28866;8320;28032;3841;13958;2344;7205;6185;21163
352510;201402;3417;11968;2850;10743;1000;4079;671;2455;1671;6534
352520;201402;2452;8800;2228;8294;578;2328;1205;4417;1783;6745
352530;201402;6453;21149;4948;17909;1429;5675;818;2726;2247;8401
352540;201402;492;1638;403;1443;101;405;130;460;231;865
352550;201402;1097;3750;882;3258;297;1189;203;712;500;1901
352560;201402;552;1714;459;1517;95;369;202;592;297;961
352570;201402;1575;5103;1134;4060;262;1072;277;873;539;1945
352580;201402;934;2853;823;2667;292;1085;335;990;627;2075
352585;201402;223;752;175;647;44;186;42;134;86;320
352590;201402;13742;45220;12391;42607;2923;11289;6546;21746;9469;33035
352600;201402;1907;6251;1769;5944;618;2157;600;1975;1218;4132
352610;201402;3639;11828;3265;11220;1250;4723;1001;3286;2251;8009
352620;201402;5527;17954;5256;17594;1248;4407;3328;11212;4576;15619
352630;201402;851;2850;804;2733;238;896;356;1177;594;2073
352640;201402;3092;10019;2560;8846;577;2212;1037;3473;1614;5685
352650;201402;850;2571;651;2168;148;529;203;646;351;1175
352660;201402;1093;3858;897;3383;278;1123;255;953;533;2076
352670;201402;7793;26827;6866;25022;2621;10010;1592;5747;4213;15757
352680;201402;3270;11765;2667;10217;655;2776;709;2421;1364;5197
352690;201402;25115;76008;19991;65943;5203;18882;8149;25918;13352;44800
352700;201402;776;2343;624;2109;193;754;265;842;458;1596
352710;201402;5241;15810;3915;13130;1054;3960;1365;4323;2419;8283
352720;201402;8922;30430;8388;29307;2780;10285;3170;11026;5950;21311
352725;201402;415;1259;285;959;54;217;77;238;131;455
352730;201402;2631;9248;2322;8411;620;2455;678;2207;1298;4662
352740;201402;2263;6828;1948;6265;545;2072;841;2428;1386;4500
352750;201402;398;1243;324;1104;106;395;68;200;174;595
352760;201402;953;3373;885;3249;297;1196;452;1597;749;2793
352770;201402;932;2923;881;2825;243;857;322;1025;565;1882
352780;201402;612;2113;543;1958;159;645;169;541;328;1186
352790;201402;661;1958;537;1744;154;554;101;318;255;872
352800;201402;1153;4378;944;3792;278;1157;162;572;440;1729
352810;201402;1035;2800;784;2344;149;520;302;863;451;1383
352820;201402;571;1778;487;1627;206;732;84;288;290;1020
352830;201402;426;1267;333;1066;90;289;50;140;140;429
352840;201402;3562;12603;3177;11777;968;3844;1048;3875;2016;7719
352850;201402;9931;32714;8766;30654;2555;9540;3212;11365;5767;20905
352860;201402;1046;3520;973;3356;398;1451;234;736;632;2187
352870;201402;1100;2851;884;2435;132;477;484;1199;616;1676
352880;201402;2322;7060;1846;5986;444;1557;458;1348;902;2905
352885;201402;312;1080;297;1047;88;344;118;393;206;737
352890;201402;709;2068;628;1902;148;516;211;572;359;1088
352900;201402;19098;59025;14855;50272;4010;14782;5638;18318;9648;33100
352910;201402;286;935;254;863;77;271;33;93;110;364
352920;201402;3409;10586;2931;9647;982;3579;961;2907;1943;6486
352930;201402;7080;22883;5727;19865;1647;6137;1066;3584;2713;9721
352940;201402;27079;92794;23641;84561;8312;31375;4275;14723;12587;46098
352950;201402;314;1004;228;816;60;258;57;178;117;436
352960;201402;525;1739;400;1412;79;304;63;202;142;506
352965;201402;370;1054;305;933;77;250;43;128;120;378
352970;201402;3372;8981;3011;8512;392;1217;2152;6173;2544;7390
352980;201402;1492;4490;1278;4153;427;1445;497;1688;924;3133
352990;201402;3552;12043;3305;11615;1136;4373;1077;3625;2213;7998
353000;201402;533;1512;406;1251;89;308;108;294;197;602
353010;201402;2823;8150;2155;6783;582;2072;758;2189;1340;4261
353020;201402;4428;12443;3210;9854;543;1890;1320;3678;1863;5568
353030;201402;3792;11401;3196;10201;966;3410;762;2245;1728;5655
353040;201402;696;2024;604;1881;204;691;214;645;418;1336
353050;201402;5549;19538;4804;17986;1799;7244;1379;4898;3178;12142
353060;201402;33827;111008;31684;107660;5641;22755;20929;67975;26570;90730
353070;201402;8781;30441;7069;26476;2460;9716;1603;6050;4063;15766
353080;201402;4734;16626;3987;14862;1314;5292;1061;3675;2375;8967
353090;201402;601;2032;537;1900;92;394;259;836;351;1230
353100;201402;272;825;226;719;98;324;46;134;144;458
353110;201402;7901;25101;7130;23680;1726;6121;3852;12954;5578;19075
353120;201402;462;1595;405;1465;143;583;92;300;235;883
353130;201402;3021;9567;2688;8974;1027;3754;914;2866;1941;6620
353140;201402;2609;7510;2148;6587;661;2230;652;1808;1313;4038
353150;201402;1953;6289;1643;5696;610;2231;373;1333;983;3564
353160;201402;624;1897;521;1684;152;520;96;281;248;801
353170;201402;525;1883;478;1796;187;788;177;629;364;1417
353180;201402;5500;17722;4875;16556;782;3112;3015;9879;3797;12991
353190;201402;3638;11828;3184;10765;785;2950;1438;4501;2223;7451
353200;201402;864;3089;785;2919;257;1080;287;1002;544;2082
353205;201402;541;1756;445;1534;107;374;146;512;253;886
353210;201402;1038;2831;858;2513;123;432;532;1520;655;1952
353215;201402;563;1792;490;1636;105;395;164;556;269;951
353220;201402;914;2855;831;2690;224;796;276;860;500;1656
353230;201402;975;3131;896;2998;227;867;288;885;515;1752
353240;201402;2195;7410;2003;7007;638;2494;783;2518;1421;5012
353250;201402;1235;3561;1046;3217;298;995;364;1052;662;2047
353260;201402;1156;3433;1025;3219;333;1113;383;1151;716;2264
353270;201402;654;2012;571;1853;185;653;156;462;341;1115
353280;201402;569;1897;498;1774;173;667;120;403;293;1070
353282;201402;1756;5938;1708;5862;311;1201;1114;3728;1425;4929
353284;201402;333;959;257;816;72;235;69;215;141;450
353286;201402;146;441;98;325;24;75;13;47;37;122
353290;201402;447;1609;406;1534;170;667;134;502;304;1169
353300;201402;1851;6022;1661;5602;585;2116;516;1588;1101;3704
353310;201402;352;1126;335;1080;140;476;90;273;230;749
353320;201402;534;1534;466;1423;112;408;221;629;333;1037
353325;201402;522;1860;444;1693;120;499;55;205;175;704
353330;201402;496;1538;420;1378;100;377;173;516;273;893
353340;201402;3177;10417;2768;9592;940;3525;949;3173;1889;6698
353350;201402;3464;10707;3091;10037;1024;3594;1372;4317;2396;7911
353360;201402;436;1546;387;1426;101;436;197;673;298;1109
353370;201402;720;2375;657;2218;174;624;302;1012;476;1636
353380;201402;419;1407;377;1329;101;399;157;532;258;931
353390;201402;5493;14897;3954;12087;903;3065;1409;3888;2312;6953
353400;201402;623;1970;523;1757;118;436;147;418;265;854
353410;201402;688;2135;587;1975;177;661;296;968;473;1629
353420;201402;702;2089;532;1663;165;556;155;440;320;996
353430;201402;2474;8694;1804;6740;449;1751;115;338;564;2089
353440;201402;60270;200944;54644;187360;17016;61492;16983;56627;33999;118119
353450;201402;461;1421;410;1332;107;413;147;449;254;862
353460;201402;3572;10132;3043;9198;612;2012;1584;4751;2196;6763
353470;201402;11338;36402;9003;31478;2755;10541;1995;6742;4750;17283
353475;201402;1728;5064;1293;4102;315;1103;351;1008;666;2111
353480;201402;1535;4652;1396;4404;322;1172;746;2231;1068;3403
353490;201402;1638;4745;1382;4230;367;1260;365;998;732;2258
353500;201402;1208;3533;1127;3396;483;1552;381;1085;864;2637
353510;201402;1376;4518;1166;3950;331;1245;336;981;667;2226
353520;201402;1155;3612;988;3307;382;1368;260;875;642;2243
353530;201402;2770;8450;2502;7959;649;2314;1083;3293;1732;5607
353540;201402;1980;6180;1823;5914;660;2225;683;2257;1343;4482
353550;201402;6753;19736;6038;18571;1173;4232;3328;9534;4501;13766
353560;201402;2196;7349;1849;6709;441;1828;693;2420;1134;4248
353570;201402;507;1630;422;1452;99;394;219;673;318;1067
353580;201402;2430;8073;2280;7805;763;2939;1175;3807;1938;6746
353590;201402;801;2333;685;2130;256;867;168;538;424;1405
353600;201402;1903;5550;1737;5262;395;1339;858;2604;1253;3943
353610;201402;606;2160;537;2017;148;643;164;572;312;1215
353620;201402;2359;8289;2141;7870;696;2792;703;2445;1399;5237
353625;201402;372;1039;265;849;95;343;64;175;159;518
353630;201402;1716;5934;1390;5144;336;1398;266;875;602;2273
353640;201402;1592;4665;1447;4379;375;1224;601;1832;976;3056
353650;201402;6732;20715;4840;16449;1052;3888;1737;5544;2789;9432
353657;201402;335;1107;306;1043;68;278;114;358;182;636
353660;201402;1389;3614;1043;3081;455;1490;156;309;611;1799
353670;201402;4863;16223;4307;15046;1379;5267;1364;4486;2743;9753
353680;201402;670;2422;638;2365;324;1255;172;628;496;1883
353690;201402;528;1470;370;1203;106;393;129;380;235;773
353700;201402;2324;7608;2066;7032;504;1939;652;2051;1156;3990
353710;201402;2317;7635;1709;6373;596;2484;516;1855;1112;4339
353715;201402;477;1438;411;1317;84;309;191;596;275;905
353720;201402;2096;6663;1846;6286;373;1313;1063;3730;1436;5043
353730;201402;4463;14127;3659;12290;912;3314;967;2995;1879;6309
353740;201402;2316;7136;1885;6228;631;2193;484;1527;1115;3720
353750;201402;686;2460;578;2196;190;781;146;566;336;1347
353760;201402;7673;24585;6395;22235;1977;7296;2557;8969;4534;16265
353770;201402;790;2514;532;1858;106;410;52;120;158;530
353780;201402;5896;21204;5372;20140;2537;9784;1266;4972;3803;14756
353790;201402;3121;11282;2811;10631;1002;4192;511;1967;1513;6159
353800;201402;14535;47456;11841;42191;3350;13159;4562;15687;7912;28846
353810;201402;1197;4021;1063;3709;330;1216;409;1420;739;2636
353820;201402;1244;4449;1198;4371;404;1699;488;1621;892;3320
353830;201402;798;2209;637;1910;135;453;249;729;384;1182
353850;201402;1861;6225;1752;6037;443;1661;840;2788;1283;4449
353860;201402;2448;8449;2093;7642;717;2824;628;2247;1345;5071
353870;201402;23631;74958;18183;63691;4240;16601;5981;18965;10221;35566
353880;201402;2271;7627;2084;7340;404;1674;1249;4267;1653;5941
353890;201402;2434;6449;1836;5485;526;1772;761;2148;1287;3920
353900;201402;1158;3664;872;3012;209;794;194;583;403;1377
353910;201402;2136;7622;2037;7357;670;2572;815;2971;1485;5543
353920;201402;2517;7609;1943;6423;455;1590;360;1089;815;2679
353930;201402;3907;14042;3387;12923;1207;4898;734;2727;1941;7625
353940;201402;1529;4961;1347;4580;334;1324;527;1629;861;2953
353950;201402;3624;11998;3344;11489;560;2231;2127;7120;2687;9351
353960;201402;590;1929;491;1703;114;445;137;403;251;848
353970;201402;528;1572;462;1488;57;228;325;1018;382;1246
353980;201402;14385;43240;12251;39797;3035;10618;6258;20120;9293;30738
353990;201402;520;1644;480;1547;147;522;172;493;319;1015
354000;201402;1934;5825;1368;4696;301;1164;135;396;436;1560
354010;201402;382;1210;346;1149;154;525;100;334;254;859
354020;201402;4771;14800;4344;13916;1444;4992;1695;5073;3139;10065
354025;201402;1059;3116;863;2758;232;819;203;624;435;1443
354030;201402;630;1700;447;1425;142;511;139;405;281;916
354040;201402;793;2193;634;1900;99;360;367;1029;466;1389
354050;201402;958;3264;888;3115;338;1301;226;763;564;2064
354060;201402;4626;15218;3755;13361;1018;3898;1485;5091;2503;8989
354070;201402;3657;12370;3214;11348;1159;4403;744;2593;1903;6996
354075;201402;2257;8641;2168;8482;768;3261;914;3518;1682;6779
354080;201402;1905;5969;1531;5051;405;1394;451;1382;856;2776
354085;201402;301;852;269;795;33;130;186;503;219;633
354090;201402;1173;3585;1115;3494;166;591;818;2522;984;3113
354100;201402;16903;58549;14687;54409;4038;16018;6281;23142;10319;39160
354105;201402;875;2841;741;2583;183;747;277;856;460;1603
354110;201402;840;2449;691;2219;197;719;205;596;402;1315
354120;201402;2247;6451;1938;5898;542;1849;654;1856;1196;3705
354130;201402;5275;16239;4604;14918;1762;6121;1291;3932;3053;10053
354140;201402;20536;54951;13719;41805;2676;9350;5454;15343;8130;24693
354150;201402;4509;12799;3607;11184;1050;3597;1434;4265;2484;7862
354160;201402;4032;13492;3577;12512;1052;3970;1402;4731;2454;8701
354165;201402;409;1545;376;1460;138;576;86;346;224;922
354170;201402;1626;5365;1344;4679;290;1159;463;1429;753;2588
354180;201402;518;1586;504;1561;58;216;346;1010;404;1226
354190;201402;1652;5595;1449;5134;511;1916;440;1507;951;3423
354200;201402;1159;3421;961;3053;223;835;376;1051;599;1886
354210;201402;855;3028;773;2841;177;778;299;1000;476;1778
354220;201402;3134;9999;2851;9459;951;3351;1098;3529;2049;6880
354230;201402;789;2649;744;2568;240;870;334;1162;574;2032
354240;201402;1341;4620;1111;4105;322;1305;254;883;576;2188
354250;201402;539;1761;448;1605;191;765;123;409;314;1174
354260;201402;9577;29331;8742;28014;2731;9650;3450;10955;6181;20605
354270;201402;1136;4114;1063;3951;334;1385;407;1506;741;2891
354280;201402;907;2700;848;2600;180;632;458;1393;638;2025
354290;201402;1324;4751;1224;4529;394;1566;338;1233;732;2799
354300;201402;3923;13820;3832;13644;1080;4054;1964;6959;3044;11013
354310;201402;788;2657;632;2265;181;709;154;548;335;1257
354320;201402;836;2558;724;2328;212;770;228;672;440;1442
354323;201402;352;1048;289;942;110;389;88;251;198;640
354325;201402;1327;4616;1203;4351;332;1345;437;1457;769;2802
354330;201402;7999;25473;7285;24043;2000;7153;3636;11612;5636;18765
354340;201402;30035;99387;25963;91908;9837;37456;8666;29769;18503;67225
354350;201402;1154;3514;1085;3390;323;1071;539;1623;862;2694
354360;201402;447;1464;370;1323;93;360;38;125;131;485
354370;201402;1141;3850;1008;3570;154;665;683;2338;837;3003
354380;201402;1311;3996;1103;3634;411;1513;180;504;591;2017
354390;201402;11662;38414;8994;32423;2282;9036;2446;8401;4728;17437
354400;201402;2132;7696;1884;7104;492;2040;571;2037;1063;4077
354410;201402;6440;19959;5415;18311;1322;4921;2728;9141;4050;14062
354420;201402;1677;5051;1407;4452;441;1498;457;1372;898;2870
354425;201402;3533;10339;3119;9598;1075;3546;936;2927;2011;6473
354430;201402;1379;4614;1279;4462;338;1328;601;2007;939;3335
354440;201402;564;1713;457;1493;94;343;193;607;287;950
354450;201402;491;1444;333;1096;59;256;88;241;147;497
354460;201402;808;2433;715;2263;262;884;305;948;567;1832
354470;201402;462;1383;375;1205;66;271;166;483;232;754
354480;201402;771;2365;694;2239;146;555;347;1012;493;1567
354490;201402;768;2645;613;2260;145;574;194;639;339;1213
354500;201402;2566;8818;2363;8447;857;3356;655;2366;1512;5722
354510;201402;701;2376;634;2235;185;713;275;953;460;1666
354515;201402;354;1250;290;1092;71;304;84;288;155;592
354520;201402;5797;20725;4568;17366;1462;6180;1508;5466;2970;11646
354530;201402;2822;10316;2655;9992;801;3268;1357;5041;2158;8309
354540;201402;1370;4293;1207;4002;401;1416;432;1470;833;2886
354550;201402;555;1864;495;1718;106;390;186;593;292;983
354560;201402;1446;4452;1151;3793;328;1107;350;1121;678;2228
354570;201402;641;2020;539;1783;188;675;112;351;300;1026
354580;201402;9149;27302;7571;24301;1600;5785;3582;10914;5182;16699
354600;201402;1728;6035;1549;5683;503;2150;611;2063;1114;4213
354610;201402;473;1333;339;1059;64;213;96;259;160;472
354620;201402;431;1517;357;1372;100;460;121;428;221;888
354625;201402;279;943;238;860;64;264;59;200;123;464
354630;201402;1903;6749;1733;6347;738;2712;531;1860;1269;4572
354640;201402;4142;14114;3599;12930;1056;4295;779;2563;1835;6858
354650;201402;998;3089;912;2908;188;697;504;1541;692;2238
354660;201402;1977;6063;1573;5298;472;1777;596;1940;1068;3717
354670;201402;1630;5383;1321;4588;380;1459;324;958;704;2417
354680;201402;5352;18176;4937;17284;1441;5386;1829;6187;3270;11573
354690;201402;870;2977;626;2368;126;516;174;599;300;1115
354700;201402;1180;3405;828;2639;142;526;339;946;481;1472
354710;201402;624;1890;539;1713;143;546;177;500;320;1046
354720;201402;193;564;159;493;58;183;40;127;98;310
354730;201402;6611;23624;5935;22253;1775;7174;2441;8857;4216;16031
354740;201402;234;784;201;710;47;171;48;171;95;342
354750;201402;2313;7545;1988;7103;685;2651;735;2590;1420;5241
354760;201402;2209;7493;1897;6773;622;2361;425;1459;1047;3820
354765;201402;282;758;195;608;37;147;32;88;69;235
354770;201402;2813;8374;2276;7488;1010;3625;380;1150;1390;4775
354780;201402;35328;114386;32962;109046;8410;30758;15892;49948;24302;80706
354790;201402;875;2896;770;2711;218;840;310;999;528;1839
354800;201402;1878;5728;1718;5511;479;1683;967;3112;1446;4795
354805;201402;897;2837;703;2412;110;440;133;409;243;849
354810;201402;696;2360;526;1964;172;704;84;292;256;996
354820;201402;1057;3815;965;3639;304;1304;225;751;529;2055
354830;201402;436;1367;385;1271;122;464;130;395;252;859
354840;201402;797;2424;737;2311;226;754;266;816;492;1570
354850;201402;14820;48873;11593;42046;3212;12917;3914;13236;7126;26153
354860;201402;1276;4239;1173;4065;307;1305;551;1768;858;3073
354870;201402;42937;140453;40479;135346;12691;45354;18339;59843;31030;105197
354880;201402;4088;13029;3038;10667;866;3321;725;2275;1591;5596
354890;201402;15090;47197;13203;43463;3720;13397;4451;14063;8171;27460
354900;201402;605;1729;491;1563;168;591;175;546;343;1137
354910;201402;6498;20430;3883;14178;879;3516;441;1537;1320;5053
354920;201402;503;1506;391;1303;116;414;92;290;208;704
354925;201402;370;1085;227;785;43;165;36;107;79;272
354930;201402;259;808;238;755;74;267;66;205;140;472
354940;201402;2334;8383;1833;6991;722;2895;276;1006;998;3901
354950;201402;1482;5037;1361;4862;254;1054;838;2944;1092;3998
354960;201402;786;2542;689;2381;204;789;243;809;447;1598
354970;201402;4001;13556;3576;12682;798;3241;1816;6140;2614;9381
354980;201402;32584;81985;18711;57922;4061;14126;6089;17438;10150;31564
354990;201402;37778;126863;34334;119745;8102;31309;17271;58381;25373;89690
354995;201402;1983;6347;1871;6181;485;1688;950;3173;1435;4861
355000;201402;1643;5622;1447;5264;512;1998;343;1223;855;3221
355010;201402;3636;11784;3120;10615;829;3127;1364;4545;2193;7672
355020;201402;3239;11794;2822;10980;1403;5794;683;2655;2086;8449
355030;201402;879273;2612626;813167;2484387;221230;735570;336216;1003117;557446;1738687
355040;201402;2919;9779;2629;9240;921;3577;1168;3900;2089;7477
355050;201402;1258;4081;1051;3659;315;1183;264;910;579;2093
355060;201402;4934;17278;4039;15228;1107;4684;873;2970;1980;7654
355070;201402;6322;20290;5712;19278;1353;5256;2971;9475;4324;14731
355080;201402;1331;4851;1078;4184;325;1409;144;466;469;1875
355090;201402;1093;3996;939;3631;221;946;391;1429;612;2375
355100;201402;29572;97451;26669;92387;9515;34784;8800;31200;18315;65984
355110;201402;1308;4631;1201;4394;412;1632;377;1344;789;2976
355120;201402;660;2149;579;1986;186;693;224;735;410;1428
355130;201402;543;1504;347;1072;91;315;113;295;204;610
355140;201402;1031;3797;987;3696;300;1248;432;1574;732;2822
355150;201402;3499;11929;3089;11140;989;3733;1133;3952;2122;7685
355160;201402;1553;5422;1355;5089;564;2376;356;1183;920;3559
355170;201402;9844;28556;7059;23535;2305;8381;1762;5723;4067;14104
355180;201402;2891;9124;2523;8444;707;2738;955;3009;1662;5747
355190;201402;1280;4584;1183;4367;508;1918;323;1161;831;3079
355200;201402;912;3429;876;3352;430;1735;197;735;627;2470
355210;201402;2767;9735;2551;9289;776;3182;996;3353;1772;6535
355220;201402;29688;102743;27457;98296;12011;44621;7049;25996;19060;70617
355230;201402;1168;3503;757;2566;143;559;173;503;316;1062
355240;201402;22015;69001;17270;58420;4136;15582;6632;20749;10768;36331
355250;201402;25145;85957;22813;81361;6874;26262;9736;34309;16610;60571
355255;201402;898;2557;667;2080;125;423;192;562;317;985
355260;201402;1607;4782;1453;4501;398;1381;538;1541;936;2922
355270;201402;1660;5195;1583;5073;241;973;1115;3384;1356;4357
355280;201402;23567;72474;20748;67013;5156;18772;9097;27999;14253;46771
355290;201402;855;2803;795;2695;175;652;375;1216;550;1868
355300;201402;876;2887;687;2479;168;650;192;634;360;1284
355310;201402;1055;3310;948;3116;246;854;425;1437;671;2291
355320;201402;748;2424;666;2234;186;701;223;630;409;1331
355330;201402;1583;5797;1372;5387;500;2175;377;1351;877;3526
355340;201402;3131;8695;2919;8332;788;2511;1518;4109;2306;6620
355350;201402;1375;4941;1239;4649;411;1647;329;1236;740;2883
355360;201402;1193;4227;1119;4086;280;1152;711;2552;991;3704
355365;201402;310;998;266;911;74;285;66;216;140;501
355370;201402;7149;18968;5314;16764;1930;6675;1913;6072;3843;12747
355380;201402;3686;11368;2902;9546;825;2973;600;1702;1425;4675
355385;201402;986;3266;938;3180;388;1458;229;714;617;2172
355390;201402;1413;4005;1229;3649;336;1071;423;1221;759;2292
355395;201402;1728;5430;1359;4546;254;969;537;1636;791;2605
355400;201402;8928;31470;8177;29878;2886;11571;2964;10314;5850;21885
355410;201402;13109;48867;12279;47063;4847;19784;3223;12460;8070;32244
355420;201402;826;3071;791;2988;329;1319;242;916;571;2235
355430;201402;3672;11059;3209;10239;815;2861;1465;4527;2280;7388
355440;201402;889;2997;746;2632;214;786;183;569;397;1355
355450;201402;2589;8783;2215;8001;645;2596;686;2326;1331;4922
355460;201402;574;1662;446;1425;126;480;129;345;255;825
355465;201402;438;1358;376;1239;116;412;94;304;210;716
355470;201402;965;3034;790;2731;281;1087;248;786;529;1873
355475;201402;138;535;122;486;31;129;37;161;68;290
355480;201402;3244;12055;3068;11662;983;4020;1294;4790;2277;8810
355490;201402;835;2498;679;2180;190;678;162;515;352;1193
355495;201402;726;2467;685;2388;195;765;272;898;467;1663
355500;201402;8439;25944;6045;20610;1449;5493;1178;3639;2627;9132
355510;201402;2117;5972;1471;4688;334;1226;422;1242;756;2468
355520;201402;391;1034;264;788;58;200;72;183;130;383
355530;201402;220;561;121;373;24;85;22;65;46;150
355535;201402;710;2208;585;1961;160;648;166;457;326;1105
355540;201402;10267;33683;9767;32855;2831;10289;4687;15464;7518;25753
355550;201402;715;2289;671;2203;195;709;306;978;501;1687
355560;201402;1436;4304;1099;3642;274;1026;229;632;503;1658
355570;201402;191;650;168;594;41;148;39;127;80;275
355580;201402;1248;3822;1089;3500;401;1448;374;1134;775;2582
355590;201402;257;738;230;684;49;184;113;321;162;505
355600;201402;1042;3443;881;3063;345;1299;191;624;536;1923
355610;201402;1443;4300;1240;3976;377;1320;474;1464;851;2784
355620;201402;3955;12959;3239;11338;769;3074;1290;4096;2059;7170
355630;201402;3278;9703;2125;7234;450;1743;664;2043;1114;3786
355635;201402;994;3376;877;3161;183;733;516;1835;699;2568
355640;201402;3828;12955;3250;11586;1133;4249;571;1972;1704;6221
355645;201402;3398;12454;3237;12151;675;2814;1946;7222;2621;10036
355650;201402;6559;21184;5783;19644;1262;5138;3256;10251;4518;15389
355660;201402;1331;4371;1122;3962;357;1415;389;1279;746;2694
355670;201402;2281;7449;1584;5807;405;1703;487;1544;892;3247
355680;201402;1780;6188;1453;5380;546;2143;279;977;825;3120
355690;201402;351;1226;315;1153;207;805;27;63;234;868
355695;201402;336;1038;251;835;34;116;19;48;53;164
355700;201402;6436;23293;5932;22065;1821;7362;2382;8488;4203;15850
355710;201402;12515;32826;8148;24745;2616;8553;1986;5748;4602;14301
355715;201402;249;758;166;584;42;160;30;101;72;261
355720;201402;1472;4932;1238;4428;406;1607;374;1203;780;2810
355730;201402;774;2742;705;2599;287;1126;147;548;434;1674
410010;201402;1640;5291;1496;4979;420;1522;423;1378;843;2900
410020;201402;1246;4301;1171;4143;371;1383;403;1416;774;2799
410030;201402;1074;3769;926;3406;285;1142;169;622;454;1764
410040;201402;12966;43954;11970;41909;4188;15748;3284;11345;7472;27093
410045;201402;1087;3152;819;2645;253;884;248;741;501;1625
410050;201402;3046;8940;2152;7232;688;2527;548;1759;1236;4286
410060;201402;1969;6411;1787;6047;550;2066;610;2004;1160;4070
410070;201402;2180;6298;1784;5474;670;2244;347;943;1017;3187
410080;201402;1449;4436;1231;4038;304;1079;612;1915;916;2994
410090;201402;1131;3652;1030;3436;361;1301;320;1007;681;2308
410100;201402;2936;8990;2276;7493;686;2613;439;1301;1125;3914
410105;201402;514;1655;403;1404;96;386;72;214;168;600
410110;201402;2626;8260;2331;7637;600;2230;800;2532;1400;4762
410115;201402;559;1594;483;1429;100;337;157;427;257;764
410120;201402;2905;10113;2767;9910;1094;4166;1086;3970;2180;8136
410130;201402;1383;4709;1269;4441;395;1369;550;1955;945;3324
410140;201402;15380;43543;11157;35681;3276;11677;3691;11706;6967;23383
410150;201402;18180;46464;9118;27788;1832;6323;1736;4690;3568;11013
410160;201402;3347;10847;3079;10410;1017;3804;1056;3584;2073;7388
410165;201402;772;2356;653;2103;142;502;304;942;446;1444
410170;201402;1774;5558;1531;5036;597;2135;426;1346;1023;3481
410180;201402;8679;28309;7636;26053;1992;7732;3381;10706;5373;18438
410185;201402;660;1850;602;1748;169;527;336;986;505;1513
410190;201402;2196;6698;1960;6166;625;2141;513;1502;1138;3643
410200;201402;5001;14653;4227;13127;1414;4852;692;2056;2106;6908
410210;201402;2602;8068;2093;6952;495;1877;411;1175;906;3052
410220;201402;625;1846;499;1591;100;356;185;568;285;924
410230;201402;1845;6038;1699;5787;657;2469;563;1836;1220;4305
410240;201402;5192;16512;4814;15715;1592;5633;1666;5332;3258;10965
410250;201402;2485;7199;1866;5952;609;2181;375;1059;984;3240
410260;201402;1715;5427;1525;5064;458;1626;539;1757;997;3383
410270;201402;537;1616;460;1464;124;436;189;596;313;1032
410275;201402;934;2828;659;2228;114;428;356;1201;470;1629
410280;201402;2873;8736;2112;7092;460;1770;366;1169;826;2939
410290;201402;3258;10324;2915;9675;808;2879;1187;3952;1995;6831
410300;201402;610;1774;551;1651;86;315;298;811;384;1126
410302;201402;582;1699;484;1544;55;180;310;1012;365;1192
410304;201402;1461;4857;1342;4609;402;1448;560;1982;962;3430
410305;201402;2199;5951;1897;5515;529;1642;1040;3079;1569;4721
410310;201402;2325;7921;2147;7579;681;2617;751;2713;1432;5330
410315;201402;629;1962;498;1688;117;419;150;467;267;886
410320;201402;1250;3743;846;2901;172;688;75;220;247;908
410322;201402;585;1790;443;1474;119;411;124;399;243;810
410330;201402;1501;4275;1282;3857;363;1212;388;1114;751;2326
410335;201402;1056;3180;912;2923;252;918;330;986;582;1904
410337;201402;805;2205;693;2007;136;462;292;790;428;1252
410340;201402;582;1768;463;1460;87;310;138;368;225;678
410345;201402;1864;5712;1551;5043;493;1770;367;1096;860;2866
410347;201402;826;2391;608;1971;164;591;153;473;317;1064
410350;201402;1019;3282;793;2811;224;897;112;349;336;1246
410360;201402;3384;10593;3081;10087;1014;3607;898;2961;1912;6568
410370;201402;12912;38662;9954;32258;2598;9600;2833;8472;5431;18072
410380;201402;1379;4468;1287;4274;308;1099;664;2188;972;3287
410390;201402;2827;8432;2327;7521;848;2954;620;1856;1468;4810
410395;201402;889;3087;809;2905;218;901;369;1293;587;2194
410400;201402;5097;16863;4574;15843;1461;5682;1325;4421;2786;10103
410405;201402;965;2871;791;2520;213;799;292;856;505;1655
410410;201402;1349;4689;1288;4585;502;1974;294;1007;796;2981
410420;201402;9593;31884;8585;29627;2919;10970;2132;6842;5051;17812
410425;201402;3161;10346;2350;8461;528;2139;346;1200;874;3339
410430;201402;15492;43762;12016;37289;3447;11892;3467;10617;6914;22509
410440;201402;3580;11511;3301;10987;918;3313;1503;5006;2421;8319
410442;201402;2947;10407;2711;9851;934;3591;822;3002;1756;6593
410445;201402;2371;8071;2072;7537;655;2579;744;2828;1399;5407
410450;201402;2616;7623;2132;6710;679;2283;396;1155;1075;3438
410460;201402;2382;7294;2018;6543;544;1946;731;2249;1275;4195
410465;201402;1818;6894;1673;6537;603;2451;506;1878;1109;4329
410470;201402;1939;6319;1715;5801;524;1882;580;1959;1104;3841
410480;201402;30011;89468;24811;79359;9239;32271;6338;19461;15577;51732
410490;201402;11465;37975;9688;34071;3120;12006;2997;10372;6117;22378
410500;201402;1517;4915;1274;4362;484;1830;306;1046;790;2876
410510;201402;2400;6560;1812;5390;472;1530;728;2016;1200;3546
410520;201402;3229;11510;3083;11203;1213;4673;1020;3704;2233;8377
410530;201402;1652;4851;1409;4358;375;1350;534;1537;909;2887
410540;201402;3833;11325;2798;9349;716;2586;931;3074;1647;5660
410550;201402;6570;20748;5268;17767;1643;6140;788;2387;2431;8527
410560;201402;1265;4175;1035;3579;243;905;264;776;507;1681
410570;201402;2851;9482;2635;9124;818;2943;1089;4050;1907;6993
410580;201402;25253;81637;22481;75844;7594;28122;6436;20571;14030;48693
410590;201402;1252;4073;866;2965;159;596;202;604;361;1200
410600;201402;1901;5809;1652;5318;475;1617;694;2240;1169;3857
410610;201402;828;2604;720;2404;195;702;303;966;498;1668
410620;201402;1714;6306;1560;5910;515;2065;373;1373;888;3438
410630;201402;2501;7567;2125;6816;578;2051;737;2250;1315;4301
410640;201402;4978;14891;4080;13187;1338;4909;910;2776;2248;7685
410645;201402;1282;4606;1229;4502;534;2119;348;1287;882;3406
410650;201402;2473;7734;2069;6921;722;2574;494;1561;1216;4135
410655;201402;924;2857;781;2572;228;826;221;706;449;1532
410657;201402;629;1948;534;1756;153;589;201;587;354;1176
410660;201402;3818;11279;3054;9608;1084;3670;625;1825;1709;5495
410670;201402;998;2897;781;2467;201;705;196;579;397;1284
410680;201402;2410;8579;2059;7653;570;2163;687;2684;1257;4847
410685;201402;673;2074;632;2007;113;348;416;1342;529;1690
410690;201402;108374;319809;77715;256516;18997;69896;18742;55763;37739;125659
410700;201402;2314;7538;2177;7277;708;2617;855;2716;1563;5333
410710;201402;1095;3489;892;3007;245;916;234;725;479;1641
410712;201402;783;2454;696;2283;321;1134;163;561;484;1695
410715;201402;1045;3381;925;3113;241;885;317;1033;558;1918
410720;201402;4166;13203;3520;11830;1053;3800;961;3056;2014;6856
410725;201402;1070;3143;785;2571;179;644;211;599;390;1243
410730;201402;715;2198;658;2069;285;956;169;517;454;1473
410740;201402;953;2909;693;2364;158;623;296;991;454;1614
410750;201402;1808;5579;1632;5170;533;1877;458;1332;991;3209
410752;201402;262;797;220;716;48;187;98;290;146;477
410753;201402;461;1423;362;1211;74;285;144;454;218;739
410754;201402;1002;3109;891;2926;116;423;598;2028;714;2451
410755;201402;726;2047;590;1821;117;429;290;838;407;1267
410760;201402;2433;8051;2335;7863;902;3243;800;2618;1702;5861
410765;201402;15659;47811;12104;40603;2911;10898;2021;6626;4932;17524
410770;201402;896;2594;755;2330;254;859;202;567;456;1426
410773;201402;1213;3798;1095;3590;286;1054;501;1524;787;2578
410775;201402;1831;5500;1763;5386;510;1505;1042;3345;1552;4850
410780;201402;546;1639;428;1427;130;453;151;555;281;1008
410785;201402;926;3070;758;2570;264;937;267;905;531;1842
410790;201402;598;1857;503;1640;132;510;102;264;234;774
410800;201402;2409;6903;2024;6224;811;2753;604;1752;1415;4505
410810;201402;329;1035;267;889;35;132;112;363;147;495
410820;201402;1074;3317;920;2967;263;928;228;720;491;1648
410830;201402;31154;95298;26202;86422;8102;29282;8728;28500;16830;57782
410832;201402;1165;3565;1070;3395;244;912;520;1522;764;2434
410840;201402;7306;23215;5957;20157;2002;7406;1071;3229;3073;10635
410845;201402;1581;4810;1412;4468;274;962;786;2512;1060;3474
410850;201402;2764;8327;2500;7948;566;2090;1326;4193;1892;6283
410855;201402;727;2077;612;1842;169;566;207;612;376;1178
410860;201402;3730;10958;3224;10031;791;2585;1491;4806;2282;7391
410865;201402;1672;5874;1517;5567;418;1660;715;2686;1133;4346
410870;201402;1372;4316;1299;4193;665;2355;309;910;974;3265
410880;201402;4491;13561;3692;12110;979;3755;879;2495;1858;6250
410890;201402;1103;3468;855;3008;259;1001;108;313;367;1314
410895;201402;1079;3855;985;3637;360;1426;309;1088;669;2514
410900;201402;872;2509;693;2223;136;500;214;652;350;1152
410910;201402;324;1008;293;953;59;212;143;446;202;658
410920;201402;836;2600;700;2363;216;796;197;608;413;1404
410930;201402;2083;6598;1845;6176;561;2197;647;2074;1208;4271
410940;201402;20851;71618;18810;67794;6305;24797;7338;26506;13643;51303
410950;201402;1904;6381;1742;6080;371;1363;1008;3579;1379;4942
410960;201402;6599;19013;4673;15404;1533;5561;1424;4720;2957;10281
410965;201402;1073;3465;967;3241;273;993;413;1391;686;2384
410970;201402;5184;15991;4340;14260;1460;5410;952;3118;2412;8528
410975;201402;1450;4344;1227;3957;225;849;617;1992;842;2841
410980;201402;4993;15017;3396;11595;833;3184;768;2501;1601;5685
410990;201402;1071;3328;813;2771;251;940;204;625;455;1565
411000;201402;453;1401;325;1104;62;244;50;142;112;386
411005;201402;488;1474;375;1191;96;309;63;174;159;483
411007;201402;2172;7134;2026;6829;612;2198;912;3176;1524;5374
411010;201402;3966;13819;3689;13199;1398;5513;839;2743;2237;8256
411020;201402;2594;8451;2384;8084;823;3150;776;2619;1599;5769
411030;201402;832;2312;725;2116;222;720;194;522;416;1242
411040;201402;401;1324;336;1170;107;398;78;267;185;665
411050;201402;2124;7736;1919;7265;682;2786;352;1257;1034;4043
411060;201402;2092;6742;1836;6189;573;2163;315;943;888;3106
411065;201402;395;1220;324;1078;57;199;107;330;164;529
411070;201402;4491;14770;3424;12295;1065;4246;444;1397;1509;5643
411080;201402;2028;6523;1885;6228;504;1874;780;2555;1284;4429
411090;201402;614;1589;490;1424;89;317;118;307;207;624
411095;201402;1594;4690;1266;4050;307;1100;321;980;628;2080
411100;201402;1492;4379;1143;3707;259;951;260;803;519;1754
411110;201402;926;2835;715;2363;202;713;110;307;312;1020
411120;201402;1705;5441;1513;5047;474;1715;462;1503;936;3218
411125;201402;4702;15556;4586;15332;1640;5792;2075;6826;3715;12618
411130;201402;780;2417;653;2150;190;661;209;701;399;1362
411140;201402;2188;7932;1917;7232;710;2813;382;1528;1092;4341
411150;201402;5983;17113;4994;15203;1447;4808;1241;3419;2688;8227
411155;201402;1168;3545;1053;3295;364;1258;346;1001;710;2259
411160;201402;310;951;280;893;107;358;82;250;189;608
411170;201402;806;2771;734;2604;219;829;231;803;450;1632
411180;201402;6204;19312;5497;17967;1621;5843;1693;5479;3314;11322
411190;201402;1809;5434;1553;4957;452;1604;449;1354;901;2958
411200;201402;4060;12876;3535;12009;1222;4562;1290;4248;2512;8810
411210;201402;2797;8201;2328;7341;868;2982;335;1000;1203;3982
411220;201402;1194;3502;977;3096;243;887;401;1151;644;2038
411230;201402;1080;3339;837;2794;268;996;198;603;466;1599
411240;201402;1395;3493;851;2644;253;869;207;568;460;1437
411250;201402;3111;8804;2596;7864;780;2470;802;2442;1582;4912
411260;201402;262;762;208;674;56;206;87;259;143;465
411270;201402;2035;6564;1883;6283;607;2251;771;2499;1378;4750
411275;201402;1536;4705;1361;4303;392;1283;357;1074;749;2357
411280;201402;1747;5485;1417;4761;405;1564;220;650;625;2214
411290;201402;1029;2931;868;2615;223;726;299;946;522;1672
411295;201402;1051;3189;976;3062;214;749;401;1232;615;1981
411300;201402;1316;3477;942;2767;84;286;374;1000;458;1286
411310;201402;828;2446;677;2193;147;565;293;915;440;1480
411320;201402;5599;17491;4660;15617;1293;4553;1216;3962;2509;8515
411325;201402;1548;5073;1405;4794;209;828;910;3097;1119;3925
411330;201402;3531;11778;3235;11254;1269;4768;942;3238;2211;8006
411340;201402;986;2935;670;2180;153;572;248;794;401;1366
411342;201402;899;2607;743;2263;206;694;190;507;396;1201
411345;201402;1052;3439;980;3303;281;1042;479;1611;760;2653
411350;201402;2645;8392;2029;7124;636;2443;266;834;902;3277
411360;201402;516;1331;335;989;49;189;133;317;182;506
411370;201402;43750;129513;34021;110962;7513;28872;11571;34471;19084;63343
411373;201402;1405;4574;1226;4205;341;1351;297;964;638;2315
411375;201402;1041;3048;881;2711;235;781;282;795;517;1576
411380;201402;1281;3495;826;2547;140;495;244;711;384;1206
411390;201402;1814;5633;1627;5338;377;1413;921;2911;1298;4324
411400;201402;1692;5208;1392;4541;335;1237;442;1374;777;2611
411410;201402;2440;7748;2159;7101;710;2668;557;1551;1267;4219
411420;201402;4489;13218;3584;11306;982;3481;714;1945;1696;5426
411430;201402;2857;9418;2493;8754;767;2901;1013;3450;1780;6351
411435;201402;562;1843;488;1652;130;483;165;536;295;1019
411440;201402;2587;8606;2402;8268;904;3348;689;2418;1593;5766
411450;201402;2038;6350;1878;6089;453;1576;1020;3323;1473;4899
411460;201402;4361;14073;3477;11957;1281;4718;622;2019;1903;6737
411470;201402;922;2893;683;2293;180;665;116;340;296;1005
411480;201402;4600;14441;3809;12928;1682;6206;763;2419;2445;8625
411490;201402;1645;5288;1505;5045;630;2400;348;1038;978;3438
411500;201402;1500;4540;1150;3815;354;1303;262;823;616;2126
411510;201402;2447;7330;1978;6407;626;2255;380;1071;1006;3326
411520;201402;28035;81501;19620;63914;6284;22643;3912;12040;10196;34683
411530;201402;905;2645;636;2143;245;935;106;295;351;1230
411535;201402;453;1375;239;861;44;186;21;64;65;250
411540;201402;3026;8371;2448;7324;470;1501;1311;3999;1781;5500
411545;201402;1025;3650;957;3516;225;908;584;2144;809;3052
411550;201402;734;2090;597;1858;253;864;130;377;383;1241
411560;201402;2586;7997;2156;6965;597;2120;473;1413;1070;3533
411570;201402;5909;16726;4574;14468;1339;4785;1096;3606;2435;8391
411573;201402;979;3075;935;2997;232;810;493;1603;725;2413
411575;201402;1442;4766;1270;4385;342;1262;471;1618;813;2880
411580;201402;3538;10773;2740;9170;636;2479;485;1419;1121;3898
411585;201402;482;1706;378;1406;89;356;58;201;147;557
411590;201402;567;1727;516;1620;131;472;152;454;283;926
411600;201402;363;1127;302;1001;68;277;76;259;144;536
411605;201402;2302;6562;1735;5484;461;1609;646;1970;1107;3579
411610;201402;2201;6582;2094;6397;515;1702;1309;3932;1824;5634
411620;201402;2720;9128;2576;8886;845;3160;1029;3623;1874;6783
411630;201402;703;1934;449;1523;128;505;82;246;210;751
411640;201402;589;1842;498;1645;136;496;180;554;316;1050
411650;201402;188;614;167;574;42;166;56;172;98;338
411660;201402;795;2369;689;2166;184;609;277;889;461;1498
411670;201402;1673;4971;1508;4658;491;1732;516;1465;1007;3197
411680;201402;1703;5302;1505;4969;390;1285;811;2850;1201;4135
411690;201402;3606;11048;3089;10096;1082;3794;776;2554;1858;6348
411695;201402;820;2678;704;2449;141;503;347;1230;488;1733
411700;201402;1839;5491;1427;4717;377;1416;379;1165;756;2581
411705;201402;2263;7909;2004;7410;482;1839;1141;4348;1623;6187
411710;201402;2161;6768;1764;5879;510;1850;379;1121;889;2971
411720;201402;673;2054;528;1710;110;401;134;404;244;805
411721;201402;715;2185;609;1965;181;640;144;410;325;1050
411722;201402;680;2097;564;1857;142;543;162;481;304;1024
411725;201402;1289;4256;938;3402;242;962;227;827;469;1789
411727;201402;2317;6762;1907;5885;504;1706;763;2245;1267;3951
411729;201402;547;1530;430;1339;82;273;161;464;243;737
411730;201402;5576;16770;4795;15274;1596;5460;1646;5236;3242;10696
411740;201402;525;1569;428;1362;118;444;164;475;282;919
411745;201402;872;2774;736;2443;185;670;171;527;356;1197
411750;201402;4298;13738;3447;11573;1038;3859;600;1842;1638;5701
411760;201402;8706;26634;7946;25352;2866;9762;2492;8262;5358;18024
411770;201402;3820;13721;3430;12769;1331;5190;734;2775;2065;7965
411780;201402;2991;10037;2903;9929;409;1358;2102;7606;2511;8964
411790;201402;2389;7149;1921;6228;610;2265;592;1832;1202;4097
411800;201402;1231;3776;826;2790;138;514;118;299;256;813
411810;201402;1543;4886;1364;4484;383;1440;377;1053;760;2493
411820;201402;16393;52284;13913;47736;4821;17121;4124;14957;8945;32078
411830;201402;433;1215;360;1116;108;329;146;494;254;823
411840;201402;8701;26642;7191;23675;2149;7808;1937;6148;4086;13956
411845;201402;517;1689;416;1457;114;439;75;262;189;701
411850;201402;5657;17612;4805;15868;1283;4613;1345;4397;2628;9010
411860;201402;869;2834;749;2567;207;755;204;646;411;1401
411870;201402;1012;3638;824;3123;142;582;201;714;343;1296
411880;201402;2465;7179;2135;6613;500;1748;1005;3144;1505;4892
411885;201402;1438;4043;1179;3636;363;1258;360;995;723;2253
411890;201402;1323;4147;986;3366;257;981;190;564;447;1545
411900;201402;913;3013;715;2501;228;813;103;352;331;1165
411910;201402;1204;4219;1071;3918;317;1269;349;1212;666;2481
411915;201402;11717;34330;8109;26657;1926;7074;1839;5413;3765;12487
411920;201402;984;3575;899;3345;271;1104;189;659;460;1763
411925;201402;609;1798;486;1580;148;511;148;463;296;974
411930;201402;6094;20598;5478;19353;1871;7080;1866;6701;3737;13781
411940;201402;3579;12253;3247;11538;1058;3967;864;3043;1922;7010
411950;201402;9605;31678;8430;29406;2536;9664;3676;12628;6212;22292
411960;201402;5413;16804;5111;16233;1395;4967;2336;7177;3731;12144
411965;201402;524;1672;420;1477;109;436;115;409;224;845
411970;201402;763;2246;614;2001;212;754;147;452;359;1206
411980;201402;2091;5892;1502;4954;200;735;799;2626;999;3361
411990;201402;28459;99662;25261;92896;9312;36593;6508;24281;15820;60874
411995;201402;3057;9836;2806;9323;1140;4092;696;2250;1836;6342
412000;201402;2028;5721;1651;5062;358;1263;668;1814;1026;3077
412010;201402;710;2450;637;2274;181;680;179;623;360;1303
412015;201402;644;2039;543;1822;106;395;276;919;382;1314
412020;201402;427;1279;330;1088;115;415;123;377;238;792
412030;201402;587;1878;411;1453;90;380;119;387;209;767
412033;201402;724;2295;569;1927;141;526;101;297;242;823
412035;201402;959;2829;783;2510;200;741;305;905;505;1646
412040;201402;721;2417;657;2252;243;876;188;623;431;1499
412050;201402;1578;4839;1260;4147;317;1171;272;849;589;2020
412060;201402;6749;24126;6248;22955;1988;7780;2346;8579;4334;16359
412065;201402;971;3008;832;2715;245;905;237;715;482;1620
412070;201402;1111;3213;1006;2991;215;705;394;1140;609;1845
412080;201402;1953;6291;1459;5195;406;1589;154;475;560;2064
412085;201402;302;871;173;595;49;184;42;134;91;318
412090;201402;4796;16080;4608;15733;1018;3775;2895;9996;3913;13771
412100;201402;2205;7081;1967;6673;645;2333;674;2262;1319;4595
412110;201402;1027;3087;794;2608;260;908;234;753;494;1661
412120;201402;2323;8037;2142;7615;561;2207;995;3395;1556;5602
412125;201402;959;3013;860;2850;256;933;321;1064;577;1997
412130;201402;747;2179;561;1821;119;449;127;380;246;829
412135;201402;552;1613;425;1351;86;303;179;520;265;823
412140;201402;1817;5659;1561;5142;448;1594;445;1470;893;3064
412150;201402;2819;8574;2500;7936;430;1528;1417;4384;1847;5912
412160;201402;1198;3849;931;3183;274;1062;323;1058;597;2120
412170;201402;4358;14861;3791;13713;1344;5187;1282;4592;2626;9779
412175;201402;1483;5245;1356;4964;395;1585;522;1930;917;3515
412180;201402;1738;5609;1376;4961;525;2112;364;1228;889;3340
412190;201402;2998;9241;2511;8424;948;3386;643;2262;1591;5648
412200;201402;2279;7752;1686;6109;401;1568;505;1797;906;3365
412210;201402;737;2137;469;1545;115;446;88;266;203;712
412215;201402;3168;10567;2888;10044;508;1828;1834;6594;2342;8422
412217;201402;1162;3497;1109;3401;229;811;682;1963;911;2774
412220;201402;5668;19163;5454;18741;1928;7006;2633;9025;4561;16031
412230;201402;2914;10189;2611;9532;813;3261;737;2563;1550;5824
412240;201402;9011;24168;5340;17114;1116;4010;777;2172;1893;6182
412250;201402;2156;6735;1972;6359;730;2561;453;1348;1183;3909
412260;201402;1295;3929;890;3052;202;803;257;772;459;1575
412265;201402;1181;3817;1095;3648;282;1141;507;1624;789;2765
412270;201402;761;2580;614;2209;136;547;97;328;233;875
412280;201402;670;2102;541;1844;175;635;229;753;404;1388
412290;201402;1236;3546;1047;3178;224;769;387;1111;611;1880
412300;201402;1780;5379;1486;4807;473;1736;379;1145;852;2881
412310;201402;1210;3494;1080;3324;215;581;698;2396;913;2977
412320;201402;682;1911;507;1607;139;521;162;494;301;1015
412330;201402;1992;5547;1550;4773;391;1316;681;2074;1072;3390
412340;201402;739;2371;532;1832;104;397;107;343;211;740
412350;201402;2501;8085;2110;7205;646;2401;407;1260;1053;3661
412360;201402;343;1114;298;1001;65;234;82;233;147;467
412370;201402;1120;3548;890;3096;303;1102;247;853;550;1955
412380;201402;2017;6177;1752;5605;489;1660;497;1567;986;3227
412382;201402;702;2056;537;1711;143;526;141;403;284;929
412385;201402;2477;8069;2308;7717;682;2397;858;2973;1540;5370
412390;201402;2447;7429;2256;7100;823;2822;780;2404;1603;5226
412395;201402;968;2735;790;2456;130;432;482;1519;612;1951
412400;201402;1188;3720;1064;3485;330;1157;408;1375;738;2532
412402;201402;2064;6482;1765;5834;544;1962;474;1426;1018;3388
412405;201402;4038;11950;2709;9049;672;2593;279;811;951;3404
412410;201402;6235;20649;5696;19541;2444;9230;1085;3637;3529;12867
412420;201402;530;1602;440;1431;137;495;118;323;255;818
412430;201402;452;1381;383;1235;119;429;153;447;272;876
412440;201402;3981;12184;3548;11443;693;2485;1504;5081;2197;7566
412450;201402;393;1257;326;1089;73;280;63;157;136;437
412460;201402;986;2819;700;2287;170;646;158;485;328;1131
412470;201402;1857;6471;1698;6081;558;2145;601;2144;1159;4289
412480;201402;1344;4044;998;3290;228;832;170;452;398;1284
412490;201402;1281;3869;1159;3587;300;965;327;1005;627;1970
412500;201402;2029;6149;1747;5590;497;1804;432;1210;929;3014
412510;201402;2754;9485;2460;8703;814;3133;809;2764;1623;5897
412520;201402;1817;5213;1423;4558;408;1404;482;1528;890;2932
412530;201402;796;2410;673;2133;207;701;170;516;377;1217
412535;201402;426;1305;312;1013;81;287;94;260;175;547
412540;201402;1214;3641;958;3089;174;652;378;1208;552;1860
412545;201402;898;2606;752;2294;142;480;258;705;400;1185
412550;201402;24226;74593;17295;59087;4721;17568;3248;10307;7969;27875
412555;201402;311;987;236;796;49;178;42;114;91;292
412560;201402;4315;14700;3738;13485;1163;4651;801;2574;1964;7225
412570;201402;4387;13628;3417;11370;954;3522;719;2300;1673;5822
412575;201402;1052;3374;892;2996;219;820;272;850;491;1670
412580;201402;1472;4106;1102;3468;257;874;354;1061;611;1935
412590;201402;496;1534;405;1363;151;540;101;348;252;888
412600;201402;1487;4820;1305;4452;433;1647;379;1195;812;2842
412610;201402;773;2528;632;2191;208;798;154;466;362;1264
412620;201402;1274;4257;1091;3862;391;1512;237;800;628;2312
412625;201402;13747;39618;11660;35716;4220;13998;2418;7307;6638;21305
412627;201402;985;3114;715;2518;224;845;79;267;303;1112
412630;201402;3506;11385;3146;10612;861;3132;951;3094;1812;6226
412635;201402;529;1635;391;1321;93;324;52;157;145;481
412640;201402;862;2640;635;2122;141;526;128;384;269;910
412650;201402;2272;6552;1886;5826;499;1700;646;1785;1145;3485
412660;201402;3055;9350;2581;8377;652;2430;621;1872;1273;4302
412665;201402;729;1990;467;1523;140;511;131;398;271;909
412667;201402;1473;4512;1211;3998;317;1201;336;1019;653;2220
412670;201402;658;2087;464;1622;111;454;70;185;181;639
412680;201402;1479;4932;1247;4371;343;1286;322;1024;665;2310
412690;201402;676;2175;550;1893;193;729;86;281;279;1010
412700;201402;1821;6077;1615;5726;605;2401;558;1908;1163;4309
412710;201402;8809;28037;7475;25274;2124;7875;1829;5914;3953;13789
412720;201402;1650;5297;1191;4108;269;999;129;355;398;1354
412730;201402;2807;8613;2012;6916;602;2229;250;770;852;2999
412740;201402;2133;7103;1921;6615;743;2723;262;945;1005;3668
412750;201402;3446;11556;3193;11100;603;2389;2094;7120;2697;9509
412760;201402;2275;7711;2184;7552;670;2568;868;2858;1538;5426
412770;201402;11949;35586;8158;27232;1828;6850;1631;4923;3459;11773
412780;201402;1483;4953;1325;4584;397;1467;398;1298;795;2765
412785;201402;2483;7382;1859;6048;596;2107;715;2258;1311;4365
412788;201402;1354;4591;1280;4452;337;1370;544;1772;881;3142
412790;201402;1140;3645;960;3258;206;770;287;873;493;1643
412795;201402;1035;3121;903;2878;309;1071;262;796;571;1867
412796;201402;2604;8443;2441;8118;646;2382;1090;3491;1736;5873
412800;201402;3538;10743;2885;9478;778;2818;843;2608;1621;5426
412810;201402;9968;28679;6449;20821;1755;6208;1435;4193;3190;10401
412820;201402;6301;19678;4828;16736;1425;5383;992;3476;2417;8859
412830;201402;404;1325;344;1200;100;412;81;236;181;648
412840;201402;2247;6550;1880;5827;541;1894;451;1346;992;3240
412850;201402;2548;7870;2248;7440;426;1628;1143;3655;1569;5283
412853;201402;1649;4981;1482;4694;251;1006;836;2431;1087;3437
412855;201402;1653;4879;1379;4354;460;1681;353;963;813;2644
412860;201402;1265;3919;1116;3643;291;1083;499;1561;790;2644
412862;201402;807;2257;635;1908;173;581;218;613;391;1194
412863;201402;1208;4203;1168;4132;179;687;798;2803;977;3490
412865;201402;662;2097;495;1683;110;409;173;601;283;1010
412870;201402;1031;3023;885;2793;319;1097;284;892;603;1989
412880;201402;1584;4383;1360;4021;391;1282;325;911;716;2193
420005;201402;497;1562;353;1232;73;283;154;509;227;792
420010;201402;3222;10186;2778;9448;449;1633;1907;6565;2356;8198
420020;201402;748;2535;488;1817;81;343;65;207;146;550
420030;201402;507;1514;316;1131;91;375;52;163;143;538
420040;201402;1006;3182;694;2565;227;941;150;479;377;1420
420050;201402;801;2589;654;2242;199;704;243;818;442;1522
420055;201402;318;1036;224;811;57;217;45;144;102;361
420060;201402;376;1341;289;1111;71;294;35;125;106;419
420070;201402;2014;6495;1733;5791;346;1282;705;2441;1051;3723
420075;201402;202;606;118;400;31;123;30;83;61;206
420080;201402;572;1974;511;1838;182;723;101;347;283;1070
420090;201402;685;2464;539;2118;134;544;96;386;230;930
420100;201402;1484;4872;1377;4724;377;1322;805;2817;1182;4139
420110;201402;446;1543;406;1452;129;470;159;582;288;1052
420120;201402;323;1147;272;1039;110;452;47;164;157;616
420125;201402;357;1502;343;1468;135;614;94;373;229;987
420127;201402;589;1860;284;1073;94;383;33;118;127;501
420130;201402;2712;9454;2433;8899;757;3130;886;2951;1643;6081
420140;201402;5019;15025;3650;12433;1036;3982;749;2385;1785;6367
420150;201402;754;2315;536;1812;168;611;138;415;306;1026
420160;201402;296;888;195;653;48;192;36;93;84;285
420165;201402;209;697;150;539;25;99;34;126;59;225
420170;201402;237;787;167;640;62;279;19;54;81;333
420180;201402;453;1483;287;1058;73;272;71;250;144;522
420190;201402;569;1833;382;1428;131;541;58;197;189;738
420195;201402;1411;4133;1138;3755;293;1056;539;1828;832;2884
420200;201402;2901;9615;1930;7357;618;2654;307;1014;925;3668
420205;201402;1047;3570;949;3386;303;1167;380;1349;683;2516
420207;201402;1307;3981;969;3266;303;1144;249;763;552;1907
420208;201402;562;1731;415;1441;156;583;121;405;277;988
420209;201402;357;1181;230;849;43;168;56;210;99;378
420210;201402;1761;5869;1237;4789;342;1537;169;583;511;2120
420213;201402;861;3233;826;3157;180;727;532;2036;712;2763
420215;201402;481;1642;380;1345;113;429;64;211;177;640
420220;201402;426;1681;399;1619;167;725;80;283;247;1008
420230;201402;4468;14126;3548;12415;912;3595;1720;5879;2632;9474
420240;201402;12384;38848;8756;31357;1992;8512;3374;10786;5366;19298
420243;201402;573;1828;470;1599;127;501;144;474;271;975
420245;201402;1139;3663;845;3051;221;932;178;553;399;1485
420250;201402;845;2750;792;2662;310;1151;295;996;605;2147
420253;201402;668;1801;555;1646;131;405;257;847;388;1252
420257;201402;429;1346;332;1158;95;331;145;508;240;839
420260;201402;1348;4609;1221;4363;365;1436;545;1937;910;3373
420270;201402;529;1754;258;969;33;128;29;99;62;227
420280;201402;2313;6689;1576;5381;429;1735;523;1562;952;3297
420285;201402;154;452;59;222;9;38;1;2;10;40
420287;201402;654;2044;572;1886;148;530;225;741;373;1271
420290;201402;6298;19097;4174;14168;1015;3799;1331;4193;2346;7992
420300;201402;5461;17440;3757;13727;963;4027;707;2557;1670;6584
420310;201402;852;2626;816;2566;186;629;491;1493;677;2122
420315;201402;958;3238;773;2847;208;861;300;1098;508;1959
420320;201402;4712;15246;4013;13989;1210;4800;1555;5177;2765;9977
420325;201402;467;1533;454;1502;154;574;138;436;292;1010
420330;201402;1282;4564;1023;3844;353;1441;184;574;537;2015
420340;201402;1485;4708;1200;4028;279;1031;349;1113;628;2144
420350;201402;1598;5235;1398;4820;415;1540;579;2004;994;3544
420360;201402;3672;12030;2861;10162;1036;4040;477;1556;1513;5596
420370;201402;2002;5749;1781;5451;246;768;1419;4333;1665;5101
420380;201402;5417;18569;4656;16770;1476;5774;1193;4227;2669;10001
420390;201402;2066;6292;1311;4670;424;1654;269;862;693;2516
420395;201402;2043;6455;1592;5438;403;1563;328;986;731;2549
420400;201402;1480;4516;1141;3853;342;1339;342;1065;684;2404
420410;201402;807;2289;590;1929;160;594;273;875;433;1469
420415;201402;508;1642;411;1395;127;469;136;447;263;916
420417;201402;804;2659;699;2417;152;543;321;1122;473;1665
420419;201402;424;1404;326;1223;157;633;77;292;234;925
420420;201402;15023;46997;11939;40584;3909;14486;3573;11946;7482;26432
420425;201402;1197;3394;772;2489;103;415;325;944;428;1359
420430;201402;4124;13164;2875;10200;859;3359;752;2584;1611;5943
420435;201402;208;716;156;582;67;278;24;85;91;363
420440;201402;1479;4398;930;3236;334;1272;153;473;487;1745
420445;201402;448;1308;346;1126;91;312;154;508;245;820
420450;201402;1275;3818;777;2780;182;747;147;428;329;1175
420455;201402;2265;7144;2040;6745;623;2374;827;2625;1450;4999
420460;201402;9754;31392;8047;28139;2344;9280;2910;9695;5254;18975
420470;201402;1210;3454;829;2720;249;910;226;714;475;1624
420475;201402;181;594;119;438;43;161;25;97;68;258
420480;201402;6014;18328;5075;16714;2052;7562;806;2566;2858;10128
420490;201402;719;2480;594;2205;176;690;143;500;319;1190
420500;201402;2119;6646;1780;6038;533;1977;866;2938;1399;4915
420510;201402;182;795;177;772;74;333;38;148;112;481
420515;201402;159;587;132;520;39;165;19;76;58;241
420517;201402;947;2959;873;2814;141;489;552;1792;693;2281
420519;201402;417;1208;317;1004;63;205;114;369;177;574
420520;201402;758;2255;620;2047;179;643;254;811;433;1454
420530;201402;1363;4817;1134;4237;374;1540;254;823;628;2363
420535;201402;253;783;181;628;54;202;32;102;86;304
420540;201402;18699;57842;14647;49336;5070;18985;4145;13167;9215;32152
420543;201402;495;1367;369;1154;52;180;215;706;267;886
420545;201402;1559;5144;1304;4573;381;1509;381;1257;762;2766
420550;201402;4791;16006;4101;14390;1217;4830;1260;4312;2477;9142
420555;201402;469;1547;396;1386;142;538;111;380;253;918
420560;201402;585;1770;485;1558;88;314;244;792;332;1106
420570;201402;1970;6609;1624;5771;491;1970;464;1534;955;3504
420580;201402;1103;3781;949;3505;286;1149;424;1602;710;2751
420590;201402;3279;10540;2450;8609;623;2416;491;1595;1114;4011
420600;201402;866;3089;795;2920;222;890;321;1190;543;2080
420610;201402;612;2042;445;1652;137;558;76;254;213;812
420620;201402;1204;3851;1076;3616;407;1489;245;797;652;2286
420630;201402;1083;3599;860;3013;265;1034;243;718;508;1752
420640;201402;648;2162;338;1335;87;402;31;121;118;523
420650;201402;2134;6681;1252;4518;239;981;214;634;453;1615
420660;201402;668;2024;554;1808;113;413;284;904;397;1317
420665;201402;792;2344;526;1775;95;365;175;515;270;880
420670;201402;1731;5645;1343;4774;336;1341;214;686;550;2027
420675;201402;238;778;175;623;43;171;74;242;117;413
420680;201402;513;1300;323;1001;65;242;106;307;171;549
420690;201402;778;2767;570;2174;137;587;170;598;307;1185
420700;201402;5931;18426;4991;16486;1649;6072;1308;4106;2957;10178
420710;201402;779;2865;662;2616;245;1039;167;638;412;1677
420720;201402;1983;6210;1719;5850;498;1779;940;3210;1438;4989
420730;201402;4647;14754;4093;13736;1517;5442;1399;4623;2916;10065
420740;201402;757;2577;742;2553;183;673;476;1624;659;2297
420750;201402;2452;8157;1805;6560;408;1719;546;1734;954;3453
420757;201402;116;401;98;370;26;111;28;97;54;208
420760;201402;442;1455;331;1150;74;278;97;323;171;601
420765;201402;626;2161;429;1633;128;534;83;306;211;840
420768;201402;1277;4599;1099;4178;377;1499;372;1467;749;2966
420770;201402;880;2845;595;2175;181;727;149;510;330;1237
420775;201402;674;2206;504;1765;144;527;124;411;268;938
420780;201402;1703;5299;1194;4049;330;1201;334;1070;664;2271
420785;201402;323;1011;228;767;30;120;87;266;117;386
420790;201402;1358;4995;1134;4361;331;1378;433;1595;764;2973
420800;201402;926;2781;582;1993;166;646;118;356;284;1002
420810;201402;2581;9110;2103;7986;719;3072;515;1895;1234;4967
420820;201402;7965;27700;6680;25454;2372;10111;2263;8498;4635;18609
420830;201402;2750;9410;2390;8723;927;3675;786;2766;1713;6441
420840;201402;869;2734;564;2096;155;658;156;534;311;1192
420845;201402;1184;4116;997;3734;362;1505;169;579;531;2084
420850;201402;1954;6576;1382;5359;477;2017;263;1027;740;3044
420860;201402;684;2031;466;1628;183;721;160;539;343;1260
420870;201402;1395;4139;1131;3764;449;1654;321;1018;770;2672
420880;201402;1481;5049;1239;4417;326;1205;238;810;564;2015
420890;201402;12657;30601;6099;19350;1203;4503;2280;6530;3483;11033
420895;201402;228;637;112;374;41;148;26;84;67;232
420900;201402;2334;6911;1591;5429;441;1654;373;1198;814;2852
420910;201402;23005;71954;15747;56279;3927;16075;3897;12987;7824;29062
420915;201402;661;2612;609;2477;174;726;266;1125;440;1851
420917;201402;423;1317;242;790;54;210;76;198;130;408
420920;201402;194;569;106;367;39;144;17;57;56;201
420930;201402;20087;62662;17575;58104;5680;20567;5776;18961;11456;39528
420940;201402;4463;13917;3898;12673;1140;4165;1161;3419;2301;7584
420945;201402;243;772;162;569;43;169;44;147;87;316
420950;201402;557;1721;305;1160;75;325;53;187;128;512
420960;201402;1457;4635;1258;4275;424;1605;395;1229;819;2834
420970;201402;2724;8715;2419;8226;676;2501;1229;4258;1905;6759
420980;201402;449;1500;380;1378;124;454;177;688;301;1142
420985;201402;567;1722;356;1269;104;410;93;314;197;724
420990;201402;895;2727;631;2266;162;645;177;582;339;1227
421000;201402;681;2447;492;1947;148;645;57;170;205;815
421003;201402;654;1922;290;1027;62;242;44;134;106;376
421005;201402;261;854;219;776;66;258;100;346;166;604
421010;201402;6761;21421;5418;18704;1804;6743;1554;5106;3358;11849
421020;201402;531;1767;425;1552;92;336;211;829;303;1165
421030;201402;1042;3873;968;3683;348;1410;296;1137;644;2547
421040;201402;887;2792;766;2578;257;952;274;856;531;1808
421050;201402;1967;5392;1208;4099;314;1217;388;1221;702;2438
421055;201402;278;924;194;706;46;185;48;153;94;338
421060;201402;540;2035;454;1790;130;545;99;366;229;911
421070;201402;798;2568;548;1961;146;592;155;567;301;1159
421080;201402;677;2233;623;2110;197;724;257;843;454;1567
421085;201402;537;1506;314;1108;81;313;68;258;149;571
421090;201402;417;1254;326;1051;83;278;138;443;221;721
421100;201402;1026;3256;765;2669;211;777;174;530;385;1307
421105;201402;1409;4700;1259;4407;331;1257;503;1818;834;3075
421110;201402;1646;5475;1437;5122;515;2024;433;1445;948;3469
421120;201402;1596;5355;1248;4477;294;1222;367;1190;661;2412
421125;201402;412;1321;336;1154;108;406;116;370;224;776
421130;201402;3428;11612;2871;10559;1065;4328;917;3361;1982;7689
421140;201402;435;1398;358;1231;107;400;125;406;232;806
421145;201402;559;1867;437;1525;75;296;187;619;262;915
421150;201402;555;1854;433;1618;114;461;173;642;287;1103
421160;201402;847;2662;587;2109;135;537;169;554;304;1091
421165;201402;328;1183;266;989;62;246;105;405;167;651
421170;201402;1846;6089;1590;5390;489;1775;730;2415;1219;4190
421175;201402;1370;4200;1102;3752;356;1416;346;1055;702;2471
421180;201402;533;1584;336;1147;103;403;126;384;229;787
421185;201402;458;1353;367;1172;65;202;188;627;253;829
421187;201402;322;1013;257;882;78;278;91;293;169;571
421189;201402;530;1639;479;1539;131;461;170;537;301;998
421190;201402;10116;33138;7874;28391;2454;9483;2169;7783;4623;17266
421200;201402;1074;3676;953;3401;288;1107;311;1076;599;2183
421205;201402;227;745;175;624;39;161;39;114;78;275
421210;201402;2117;6682;1811;5912;589;2047;532;1707;1121;3754
421220;201402;2501;8670;2241;8128;746;2951;665;2410;1411;5361
421223;201402;765;2243;504;1788;159;595;230;812;389;1407
421225;201402;1195;3769;1013;3394;296;1077;370;1218;666;2295
421227;201402;958;3269;875;3141;254;906;496;1855;750;2761
421230;201402;747;2573;682;2410;196;756;233;767;429;1523
421240;201402;561;1919;389;1413;90;354;53;163;143;517
421250;201402;1922;6073;1363;5045;487;1976;343;1244;830;3220
421260;201402;273;843;161;620;39;148;32;114;71;262
421265;201402;237;805;205;714;45;172;33;121;78;293
421270;201402;696;1936;438;1496;148;545;83;310;231;855
421280;201402;1651;5308;1356;4849;466;1902;383;1363;849;3265
421290;201402;1988;5765;1342;4507;434;1541;280;864;714;2405
421300;201402;315;1009;277;931;111;420;96;301;207;721
421310;201402;518;1811;456;1642;152;556;106;379;258;935
421315;201402;360;1119;224;825;53;197;34;124;87;321
421320;201402;534;1843;378;1413;69;284;64;182;133;466
421330;201402;643;2280;564;2111;227;966;64;221;291;1187
421335;201402;571;1912;465;1697;126;497;93;341;219;838
421340;201402;1815;5970;1632;5643;523;1999;708;2410;1231;4409
421350;201402;1086;3750;916;3381;302;1235;240;839;542;2074
421360;201402;3282;10084;2249;8014;515;2119;730;2447;1245;4566
421370;201402;1093;3949;950;3625;325;1369;245;905;570;2274
421380;201402;1039;3069;874;2751;175;605;419;1304;594;1909
421390;201402;199;658;154;538;22;82;40;145;62;227
421400;201402;393;1527;326;1363;133;582;76;295;209;877
421410;201402;365;1167;300;1035;75;268;133;479;208;747
421415;201402;326;1077;209;816;66;268;54;200;120;468
421420;201402;1422;4536;1116;3771;257;919;236;737;493;1656
421430;201402;297;999;238;880;81;352;44;143;125;495
421440;201402;827;2537;588;2094;174;680;212;712;386;1392
421450;201402;587;2055;465;1745;166;676;90;318;256;994
421460;201402;667;2225;477;1804;124;527;107;374;231;901
421470;201402;508;1948;455;1823;137;576;179;706;316;1282
421480;201402;2861;9182;2038;7478;639;2682;555;1831;1194;4513
421490;201402;287;1007;195;776;85;363;42;160;127;523
421500;201402;2693;9803;2427;9253;1018;4285;521;1905;1539;6190
421505;201402;403;1407;368;1317;130;473;122;443;252;916
421507;201402;640;2156;504;1823;120;451;185;665;305;1116
421510;201402;304;1156;281;1108;88;402;116;393;204;795
421520;201402;806;2222;539;1678;57;221;270;765;327;986
421530;201402;445;1523;319;1248;96;427;110;406;206;833
421535;201402;708;2229;447;1653;102;402;209;765;311;1167
421540;201402;405;1242;351;1135;87;317;130;393;217;710
421545;201402;1233;4362;1030;3948;323;1397;208;750;531;2147
421550;201402;2196;7637;2009;7278;762;2995;582;2038;1344;5033
421555;201402;284;915;145;525;33;130;33;113;66;243
421560;201402;183;576;96;355;23;90;16;62;39;152
421565;201402;1096;3509;1002;3347;445;1594;306;982;751;2576
421567;201402;951;3610;832;3290;391;1594;161;635;552;2229
421568;201402;483;1633;393;1439;118;451;122;456;240;907
421569;201402;199;662;120;461;24;105;26;93;50;198
421570;201402;1025;3536;791;2976;274;1128;190;682;464;1810
421575;201402;611;2106;549;1977;118;449;285;1037;403;1486
421580;201402;4254;14394;3475;12620;1324;5367;757;2451;2081;7818
421590;201402;261;838;211;731;47;173;94;308;141;481
421600;201402;558;1712;427;1434;130;472;108;356;238;828
421605;201402;689;2198;499;1810;128;532;116;401;244;933
421610;201402;1854;4897;1475;4355;205;654;931;2757;1136;3411
421620;201402;4961;15618;3690;12932;1297;4887;1137;4010;2434;8897
421625;201402;374;1265;246;911;66;275;75;261;141;536
421630;201402;2677;8260;1769;6196;476;1806;412;1396;888;3202
421635;201402;294;1047;256;978;72;300;91;317;163;617
421640;201402;1093;3606;981;3420;217;766;594;2122;811;2888
421650;201402;2366;8104;2087;7464;808;3181;322;1070;1130;4251
421660;201402;9199;31620;7647;28566;2602;10724;2191;7719;4793;18443
421670;201402;1144;3869;910;3319;263;1049;258;934;521;1983
421680;201402;1450;4871;1305;4516;530;1974;221;690;751;2664
421690;201402;2075;6970;1640;5895;459;1775;265;902;724;2677
421700;201402;729;2311;484;1771;163;662;124;377;287;1039
421710;201402;343;1244;277;1056;106;411;73;268;179;679
421715;201402;305;897;194;666;50;181;56;195;106;376
421720;201402;1792;5638;1388;4879;540;2129;392;1249;932;3378
421725;201402;129;466;125;457;39;154;51;183;90;337
421730;201402;620;1953;343;1272;86;354;75;226;161;580
421740;201402;706;2273;539;1872;161;662;123;333;284;995
421750;201402;1436;4471;1154;3866;343;1262;398;1207;741;2469
421755;201402;449;1468;344;1194;99;380;100;318;199;698
421760;201402;441;1474;305;1139;86;364;126;448;212;812
421770;201402;3730;11564;3098;10285;1292;4505;734;2499;2026;7004
421775;201402;567;1733;390;1390;90;332;120;426;210;758
421780;201402;1738;6146;1427;5448;579;2389;375;1336;954;3725
421790;201402;1015;2941;649;2307;195;799;152;478;347;1277
421795;201402;397;1240;285;958;46;164;84;284;130;448
421800;201402;2603;8698;2081;7638;585;2405;672;2248;1257;4653
421810;201402;630;2115;505;1813;145;568;87;299;232;867
421820;201402;1114;3673;943;3320;219;936;308;973;527;1909
421825;201402;1357;4704;1256;4454;225;898;678;2324;903;3222
421830;201402;3114;10906;2924;10526;748;2814;1477;5526;2225;8340
421835;201402;182;587;144;522;55;231;55;174;110;405
421840;201402;518;1868;466;1735;189;774;152;529;341;1303
421850;201402;575;1702;435;1458;145;509;128;450;273;959
421860;201402;455;1532;340;1286;72;301;98;356;170;657
421870;201402;5185;15665;3800;12746;1145;4140;664;2156;1809;6296
421875;201402;350;1107;211;781;48;203;50;164;98;367
421880;201402;1060;3619;873;3148;266;1091;209;676;475;1767
421885;201402;359;1294;328;1210;86;325;132;483;218;808
421890;201402;1091;3797;949;3494;322;1285;276;992;598;2277
421895;201402;438;1510;411;1457;119;433;206;753;325;1186
421900;201402;891;2949;750;2600;210;780;254;804;464;1584
421910;201402;534;1754;387;1399;103;418;95;295;198;713
421915;201402;615;1914;489;1629;112;412;164;510;276;922
421917;201402;569;1820;453;1603;148;623;143;456;291;1079
421920;201402;774;2445;634;2243;300;1157;180;567;480;1724
421930;201402;3950;11538;2833;9456;856;3190;451;1455;1307;4645
421935;201402;890;3194;724;2804;203;864;249;949;452;1813
421940;201402;310;1209;248;1018;88;397;50;180;138;577
421950;201402;4391;12718;2578;8945;782;2894;509;1787;1291;4681
421960;201402;263;861;213;746;56;215;56;189;112;404
421970;201402;2122;6628;1643;5530;565;2095;318;940;883;3035
421985;201402;455;1318;289;974;46;193;90;311;136;504
430003;201402;916;2697;736;2381;205;735;229;716;434;1451
430005;201402;298;1022;264;946;63;242;139;475;202;717
430010;201402;2157;6323;1689;5402;537;1798;591;1949;1128;3747
430020;201402;1112;3034;982;2839;236;790;532;1449;768;2239
430030;201402;1532;4297;1351;3951;393;1221;528;1468;921;2689
430040;201402;13080;34272;11260;31465;3553;10351;4575;13002;8128;23353
430045;201402;746;2080;602;1796;112;375;340;981;452;1356
430047;201402;211;613;169;527;43;137;79;249;122;386
430050;201402;1097;3106;741;2412;156;604;296;902;452;1506
430055;201402;275;810;194;625;43;153;89;279;132;432
430057;201402;79;212;37;126;8;32;11;24;19;56
430060;201402;15167;50467;13628;47687;4390;16049;6136;22017;10526;38066
430063;201402;1093;3314;901;2900;258;879;394;1295;652;2174
430064;201402;1700;5128;1442;4698;407;1369;667;2256;1074;3625
430066;201402;173;456;129;387;33;112;66;188;99;300
430070;201402;572;1842;425;1480;110;415;118;370;228;785
430080;201402;620;2061;498;1778;125;509;132;427;257;936
430085;201402;657;1920;499;1643;151;562;204;635;355;1197
430087;201402;998;3055;956;2976;104;346;756;2338;860;2684
430090;201402;772;2116;303;1002;40;146;76;256;116;402
430100;201402;1023;3289;834;2925;299;1156;189;559;488;1715
430105;201402;765;2518;626;2237;213;839;133;454;346;1293
430107;201402;264;897;210;734;45;175;81;260;126;435
430110;201402;2211;6638;2066;6395;670;2267;918;2789;1588;5056
430120;201402;1772;5512;1439;4783;303;1066;834;2743;1137;3809
430130;201402;4593;11847;4200;11322;732;2103;2652;7245;3384;9348
430140;201402;1216;3965;956;3349;306;1104;315;1085;621;2189
430150;201402;938;2552;652;2016;149;504;194;585;343;1089
430155;201402;511;1630;391;1353;106;361;152;537;258;898
430160;201402;18740;55793;17531;53784;3890;13248;9665;30177;13555;43425
430163;201402;1889;5799;1639;5329;397;1466;757;2465;1154;3931
430165;201402;286;1024;245;936;109;431;44;162;153;593
430170;201402;794;2340;404;1419;95;369;85;262;180;631
430175;201402;966;3120;798;2752;173;540;406;1510;579;2050
430180;201402;1148;3171;985;2898;241;778;461;1353;702;2131
430185;201402;754;1896;410;1233;64;219;127;325;191;544
430187;201402;753;2360;672;2207;178;690;275;858;453;1548
430190;201402;2282;6848;2034;6415;518;1900;962;3010;1480;4910
430192;201402;190;595;103;332;17;60;35;105;52;165
430195;201402;250;762;84;309;14;52;13;36;27;88
430200;201402;1826;6003;1570;5492;537;2019;306;1073;843;3092
430205;201402;508;1540;408;1362;49;199;273;897;322;1096
430210;201402;6436;18636;3741;12774;986;3612;672;2145;1658;5757
430215;201402;334;998;257;841;57;209;112;347;169;556
430220;201402;675;1802;338;1142;66;265;52;164;118;429
430222;201402;327;1026;257;873;65;252;102;326;167;578
430223;201402;332;1020;301;971;61;202;196;644;257;846
430225;201402;61;179;37;120;6;14;7;20;13;34
430230;201402;2157;6883;2032;6752;344;1071;1543;5313;1887;6384
430235;201402;262;893;216;777;64;250;53;179;117;429
430237;201402;400;1132;334;1015;52;186;210;612;262;798
430240;201402;1112;3363;882;2903;310;1161;256;742;566;1903
430245;201402;868;2953;732;2640;212;789;297;1103;509;1892
430250;201402;1611;4527;1474;4285;582;1808;467;1377;1049;3185
430258;201402;212;609;149;482;22;73;68;222;90;295
430260;201402;846;2431;569;1845;73;271;319;1049;392;1320
430265;201402;325;1045;270;910;96;342;31;81;127;423
430270;201402;3522;10130;3197;9577;855;2918;1553;4565;2408;7483
430280;201402;5347;15494;4662;14213;1427;4679;1920;5762;3347;10441
430290;201402;2495;7003;2378;6877;328;963;1921;5660;2249;6623
430300;201402;10030;31167;8631;28493;3375;11719;3096;10519;6471;22238
430310;201402;8645;27760;7778;26052;2597;9392;3084;10065;5681;19457
430320;201402;828;2532;606;2066;91;287;303;1089;394;1376
430330;201402;992;2782;858;2524;258;809;326;885;584;1694
430340;201402;742;1949;460;1559;103;396;217;725;320;1121
430350;201402;6254;20266;5428;18451;2083;7479;1757;5849;3840;13328
430355;201402;241;659;158;505;30;116;38;105;68;221
430360;201402;1168;3116;1026;2872;181;551;584;1629;765;2180
430367;201402;346;968;240;777;39;143;78;237;117;380
430370;201402;620;1850;505;1620;169;592;130;379;299;971
430380;201402;872;2274;485;1563;134;449;167;559;301;1008
430390;201402;4346;13078;3357;10937;836;2992;1027;3162;1863;6154
430400;201402;1328;3229;942;2677;255;823;449;1188;704;2011
430410;201402;707;1946;558;1701;100;346;281;850;381;1196
430420;201402;4629;13697;3802;11809;1164;3714;1459;4548;2623;8262
430430;201402;793;2240;532;1726;167;588;133;406;300;994
430435;201402;2028;5610;1710;5024;389;1175;921;2743;1310;3918
430440;201402;4700;14720;3936;13257;792;2951;1768;6177;2560;9128
430450;201402;9158;26715;7532;23352;2773;9145;2220;6814;4993;15959
430460;201402;26287;81460;21869;73337;7037;25366;7424;24966;14461;50332
430461;201402;481;1363;172;561;38;135;38;121;76;256
430462;201402;342;1028;291;945;114;400;99;318;213;718
430463;201402;3917;13090;3520;12277;939;3591;1651;5759;2590;9350
430465;201402;642;1799;546;1634;124;419;345;1012;469;1431
430466;201402;4348;13039;4113;12619;1259;4195;1917;5862;3176;10057
430467;201402;595;1834;526;1720;133;484;251;791;384;1275
430468;201402;1418;4272;1270;4032;536;1867;261;795;797;2662
430469;201402;155;422;54;196;7;26;15;58;22;84
430470;201402;7389;20054;5620;17143;1862;6193;1591;4821;3453;11014
430471;201402;922;3143;834;2952;302;1125;190;675;492;1800
430480;201402;863;2436;497;1637;80;295;104;297;184;592
430485;201402;239;758;135;496;25;88;46;183;71;271
430490;201402;537;1602;384;1312;107;385;132;459;239;844
430495;201402;420;1280;297;1013;70;265;74;239;144;504
430500;201402;1648;4687;1429;4305;414;1385;660;1950;1074;3335
430510;201402;27113;85664;21377;71674;7260;26772;5722;18201;12982;44973
430511;201402;479;1476;272;933;67;222;33;105;100;327
430512;201402;1340;3558;1197;3320;336;968;458;1331;794;2299
430513;201402;683;1948;491;1543;84;273;225;713;309;986
430515;201402;614;1840;496;1586;101;345;209;688;310;1033
430517;201402;1385;4681;1259;4412;245;930;768;2654;1013;3584
430520;201402;1775;5307;1436;4589;474;1611;529;1639;1003;3250
430530;201402;927;2669;540;1770;110;417;139;400;249;817
430535;201402;2417;7946;2102;7243;554;2118;670;2260;1224;4378
430537;201402;621;1804;438;1500;53;173;333;1173;386;1346
430540;201402;741;1838;577;1618;131;413;324;871;455;1284
430543;201402;603;1599;543;1538;135;412;338;974;473;1386
430544;201402;711;2432;630;2211;152;570;310;1044;462;1614
430545;201402;1406;4599;1231;4376;451;1526;593;2353;1044;3879
430550;201402;617;1947;496;1679;121;457;191;624;312;1081
430558;201402;120;356;81;269;32;120;11;25;43;145
430560;201402;395;1013;252;759;50;193;108;307;158;500
430570;201402;1199;3212;874;2618;217;740;414;1144;631;1884
430580;201402;1073;3119;758;2485;261;898;203;683;464;1581
430583;201402;118;332;49;165;11;44;4;10;15;54
430585;201402;366;1009;247;752;82;286;100;275;182;561
430587;201402;296;933;256;845;110;380;68;222;178;602
430590;201402;1549;4431;1476;4316;353;1159;825;2365;1178;3524
430593;201402;37;145;35;137;13;58;9;28;22;86
430595;201402;170;529;109;396;35;134;13;36;48;170
430597;201402;379;1199;317;1064;57;217;129;412;186;629
430600;201402;2047;5831;1395;4353;320;1053;484;1474;804;2527
430605;201402;1344;4293;1105;3770;276;1031;443;1552;719;2583
430607;201402;705;1953;615;1793;134;440;348;984;482;1424
430610;201402;8295;22675;6651;20065;1597;5377;2960;8925;4557;14302
430613;201402;238;618;136;421;36;114;37;97;73;211
430620;201402;968;3055;821;2713;242;898;303;924;545;1822
430630;201402;466;1416;298;993;83;280;58;175;141;455
430632;201402;725;2052;491;1565;88;331;259;767;347;1098
430635;201402;687;1925;500;1564;111;343;236;756;347;1099
430637;201402;545;1577;497;1481;88;318;316;886;404;1204
430640;201402;1896;5504;1062;3546;230;808;200;554;430;1362
430642;201402;486;1309;337;1061;67;233;173;558;240;791
430645;201402;189;576;112;391;24;94;27;87;51;181
430650;201402;2073;7008;1826;6447;399;1473;995;3614;1394;5087
430655;201402;312;949;277;870;66;233;99;259;165;492
430660;201402;6071;18276;4919;16121;1528;5506;1891;6122;3419;11628
430670;201402;500;1476;456;1390;45;137;341;1073;386;1210
430673;201402;772;1943;460;1430;130;407;197;620;327;1027
430675;201402;190;597;127;439;25;99;52;175;77;274
430676;201402;4567;14124;4184;13502;1287;4497;1814;6014;3101;10511
430680;201402;1211;3636;908;2970;199;750;356;1079;555;1829
430690;201402;4528;13333;3819;11965;1210;3986;1432;4627;2642;8613
430692;201402;280;966;212;819;35;137;127;500;162;637
430693;201402;1775;5108;1384;4224;307;1010;387;1151;694;2161
430695;201402;512;1490;426;1318;97;345;201;578;298;923
430697;201402;451;1294;353;1128;117;374;129;446;246;820
430700;201402;10953;29328;5821;19018;1101;4051;747;2189;1848;6240
430705;201402;410;1312;384;1267;136;490;146;480;282;970
430710;201402;1876;4959;1503;4343;301;955;785;2361;1086;3316
430720;201402;911;2307;606;1858;171;569;232;750;403;1319
430730;201402;1839;5088;1513;4589;368;1104;806;2597;1174;3701
430740;201402;618;1816;398;1338;120;429;55;155;175;584
430745;201402;537;1572;386;1238;69;233;146;461;215;694
430750;201402;1815;5306;1594;4893;385;1311;800;2360;1185;3671
430755;201402;658;1883;478;1488;111;406;204;553;315;959
430760;201402;3688;9499;2929;8574;631;2036;1593;4844;2224;6880
430770;201402;6871;20916;5851;19159;1446;5217;2765;8929;4211;14146
430780;201402;2471;7111;1779;5755;485;1707;669;2035;1154;3742
430781;201402;648;1996;487;1673;143;526;172;581;315;1107
430783;201402;576;1521;454;1306;86;274;200;528;286;802
430786;201402;123;423;102;362;36;141;13;42;49;183
430790;201402;3768;10650;2587;8223;553;2065;1125;3334;1678;5399
430800;201402;790;2459;618;2025;161;554;201;637;362;1191
430805;201402;477;1400;365;1193;40;143;232;778;272;921
430807;201402;330;1025;273;896;63;247;90;258;153;505
430810;201402;668;1906;358;1230;58;233;66;206;124;439
430820;201402;1258;4206;1031;3628;335;1280;299;984;634;2264
430825;201402;459;1309;260;822;47;164;79;226;126;390
430830;201402;2727;8104;2545;7819;393;1255;1634;5307;2027;6562
430840;201402;997;3159;915;2975;233;741;407;1400;640;2141
430843;201402;99;326;75;247;15;49;30;93;45;142
430845;201402;435;1313;369;1195;134;465;59;183;193;648
430850;201402;3321;10341;3008;9767;932;3225;1178;3814;2110;7039
430860;201402;719;2367;566;2003;180;760;130;400;310;1160
430865;201402;732;2041;675;1941;223;653;299;872;522;1525
430870;201402;632;1847;425;1444;140;488;122;399;262;887
430880;201402;1393;4143;1156;3672;462;1581;278;899;740;2480
430885;201402;181;581;155;537;50;190;46;148;96;338
430890;201402;1663;4557;1364;4015;97;337;904;2635;1001;2972
430900;201402;3304;9025;3122;8792;586;1720;2105;6051;2691;7771
430905;201402;1089;3309;795;2649;271;977;191;608;462;1585
430910;201402;1818;5943;1562;5431;592;2209;553;1860;1145;4069
430912;201402;589;1677;465;1470;72;256;251;774;323;1030
430915;201402;416;1474;314;1255;86;367;85;356;171;723
430920;201402;18013;57918;16677;55436;5782;19996;8621;28628;14403;48624
430925;201402;92;266;74;229;21;73;37;112;58;185
430930;201402;9398;29997;7864;26837;2383;8638;2935;10385;5318;19023
430940;201402;1122;3555;914;3146;217;849;281;932;498;1781
430950;201402;1614;4629;1259;3861;363;1170;355;1064;718;2234
430955;201402;105;349;83;290;26;100;23;71;49;171
430957;201402;320;1090;264;965;66;257;110;401;176;658
430960;201402;1755;5162;1521;4750;589;1945;463;1469;1052;3414
430965;201402;1356;4194;1183;3862;185;691;819;2626;1004;3317
430970;201402;533;1566;350;1169;92;340;94;307;186;647
430975;201402;641;2124;502;1779;92;350;263;925;355;1275
430980;201402;561;1395;350;1081;93;329;131;355;224;684
430990;201402;640;2133;499;1763;164;602;102;362;266;964
430995;201402;731;2207;657;2065;229;735;236;743;465;1478
431000;201402;1717;4733;1031;3308;244;903;140;371;384;1274
431010;201402;2837;8572;2014;6862;546;2054;604;1926;1150;3980
431020;201402;14521;36906;10418;29375;2880;8575;3192;9309;6072;17884
431030;201402;403;1255;253;888;58;211;60;220;118;431
431033;201402;2895;8528;2668;8197;641;2071;1493;4818;2134;6889
431036;201402;201;599;99;337;22;82;26;72;48;154
431040;201402;1021;3033;868;2767;238;833;432;1352;670;2185
431041;201402;591;1666;532;1579;194;615;177;556;371;1171
431043;201402;411;1369;319;1158;152;601;102;331;254;932
431046;201402;115;357;89;298;24;86;35;112;59;198
431050;201402;1848;4756;1578;4349;335;961;926;2588;1261;3549
431053;201402;630;2116;543;1928;172;674;179;617;351;1291
431055;201402;703;2004;651;1912;83;257;458;1355;541;1612
431057;201402;336;984;206;733;59;228;79;276;138;504
431060;201402;6326;18854;6004;18456;1405;4083;3869;12511;5274;16594
431065;201402;445;1382;424;1345;51;175;285;905;336;1080
431070;201402;770;2275;490;1633;108;374;119;354;227;728
431075;201402;288;881;192;668;34;131;62;217;96;348
431080;201402;703;2293;589;2052;164;604;110;373;274;977
431085;201402;940;2532;764;2239;138;430;434;1269;572;1699
431087;201402;629;1814;558;1680;79;220;364;1114;443;1334
431090;201402;534;1395;302;949;98;317;56;162;154;479
431100;201402;4779;13496;4060;12226;1168;3730;1631;5071;2799;8801
431110;201402;1626;4503;1294;3847;333;1072;638;1842;971;2914
431112;201402;664;2134;637;2090;231;755;297;1004;528;1759
431113;201402;651;1987;499;1629;168;552;131;440;299;992
431115;201402;1483;4520;1363;4301;312;1051;789;2461;1101;3512
431120;201402;2689;8846;2440;8359;752;2882;998;3265;1750;6147
431123;201402;530;1692;448;1530;124;437;214;754;338;1191
431125;201402;1402;4413;1112;3790;346;1221;402;1455;748;2676
431127;201402;125;351;68;219;11;37;11;34;22;71
431130;201402;3930;11580;3320;10555;974;3382;1364;4360;2338;7742
431140;201402;3907;10418;2351;7746;484;1867;652;1918;1136;3785
431142;201402;551;1687;507;1606;69;238;318;1029;387;1267
431150;201402;1348;4135;1101;3653;297;1002;386;1324;683;2326
431160;201402;969;2924;834;2637;170;540;411;1386;581;1926
431162;201402;453;1249;244;822;35;141;35;97;70;238
431164;201402;107;293;36;135;13;44;1;4;14;48
431170;201402;932;2819;764;2468;243;826;213;681;456;1507
431171;201402;880;2698;785;2507;251;847;177;520;428;1367
431173;201402;485;1479;452;1419;106;342;265;844;371;1186
431175;201402;1324;3711;1157;3461;399;1275;452;1338;851;2613
431177;201402;990;3316;902;3121;303;1154;371;1265;674;2419
431179;201402;130;348;83;255;19;64;28;75;47;139
431180;201402;2713;8275;2204;7108;594;2110;647;1936;1241;4046
431190;201402;772;2165;474;1577;135;496;147;487;282;983
431198;201402;376;1248;331;1154;150;579;64;200;214;779
431200;201402;294;868;124;421;24;85;15;50;39;135
431205;201402;312;1041;236;827;59;218;85;287;144;505
431210;201402;784;2267;684;2059;181;560;349;1049;530;1609
431213;201402;321;1009;270;908;74;277;93;295;167;572
431215;201402;344;1032;179;614;30;107;21;56;51;163
431217;201402;247;765;195;649;65;232;49;170;114;402
431220;201402;1220;3173;908;2588;125;426;482;1303;607;1729
431225;201402;1370;4160;1218;3899;284;989;644;2074;928;3063
431230;201402;950;2899;751;2487;120;447;416;1387;536;1834
431235;201402;76;183;36;110;12;41;9;24;21;65
431237;201402;450;1481;396;1404;135;549;164;547;299;1096
431238;201402;50;167;43;149;10;41;13;41;23;82
431240;201402;2843;8946;2467;8295;890;3218;719;2390;1609;5608
431242;201402;428;1411;405;1366;164;625;27;78;191;703
431244;201402;451;1125;343;964;73;249;155;399;228;648
431245;201402;1037;2924;903;2703;179;558;574;1732;753;2290
431247;201402;213;685;183;628;71;258;62;203;133;461
431250;201402;1905;6114;1711;5821;572;2125;648;2256;1220;4381
431260;201402;394;1165;281;939;71;269;60;182;131;451
431261;201402;223;810;193;743;46;207;54;203;100;410
431262;201402;353;1022;166;583;29;137;63;207;92;344
431265;201402;1367;3730;844;2614;204;706;244;638;448;1344
431267;201402;195;605;161;545;44;159;70;219;114;378
431270;201402;2418;6937;2105;6463;691;2279;994;3072;1685;5351
431275;201402;216;719;146;523;45;148;25;79;70;227
431280;201402;164;516;111;389;27;107;27;75;54;182
431290;201402;355;1169;280;972;75;296;60;196;135;492
431295;201402;219;707;132;452;25;100;28;79;53;179
431300;201402;181;589;97;376;34;139;7;24;41;163
431301;201402;246;814;181;644;38;147;40;128;78;275
431303;201402;713;1950;544;1626;140;486;209;591;349;1077
431306;201402;2156;6140;1716;5312;330;1223;592;1623;922;2846
431308;201402;58;203;54;192;39;143;11;36;50;179
431310;201402;774;2493;574;2040;109;412;214;781;323;1193
431320;201402;888;2619;573;1993;173;675;126;396;299;1071
431330;201402;2225;5798;1180;3806;358;1271;191;595;549;1866
431333;201402;292;792;199;607;39;129;64;172;103;301
431335;201402;101;301;85;265;19;59;28;76;47;135
431337;201402;2669;8335;2157;7216;625;2180;596;1981;1221;4161
431339;201402;619;1827;490;1526;113;380;220;689;333;1069
431340;201402;27916;75845;20892;63871;5189;17630;7724;23148;12913;40778
431342;201402;626;1690;544;1545;149;443;288;792;437;1235
431344;201402;372;1073;296;938;28;93;178;576;206;669
431346;201402;300;821;190;570;56;173;49;148;105;321
431349;201402;603;1778;467;1447;97;293;151;470;248;763
431350;201402;3946;12076;3544;11353;647;2384;2063;6394;2710;8778
431360;201402;784;2179;612;1898;173;571;224;694;397;1265
431365;201402;1322;4169;1170;3913;458;1677;419;1374;877;3051
431370;201402;5583;16360;4773;15011;1356;4578;1983;6369;3339;10947
431380;201402;1135;3469;1080;3355;175;584;755;2311;930;2895
431390;201402;3534;10453;2608;8623;834;3041;708;2208;1542;5249
431395;201402;1614;4927;1458;4676;389;1323;581;1906;970;3229
431400;201402;192;640;128;495;38;160;10;26;48;186
431402;201402;1211;3123;799;2362;159;516;376;1072;535;1588
431403;201402;326;980;249;841;84;317;52;173;136;490
431405;201402;4603;13296;3722;11977;852;3221;1793;5539;2645;8760
431406;201402;809;2588;636;2159;215;761;222;735;437;1496
431407;201402;647;2028;504;1696;168;584;112;351;280;935
431410;201402;16889;53118;13868;47166;5387;19697;3200;11343;8587;31040
431413;201402;214;537;106;337;12;43;47;146;59;189
431415;201402;931;2705;778;2415;187;627;375;1127;562;1754
431417;201402;668;1744;542;1548;97;302;289;853;386;1155
431420;201402;1617;4572;1436;4278;355;1133;764;2326;1119;3459
431430;201402;603;1683;454;1427;113;388;164;479;277;867
431440;201402;32977;97987;29772;92667;10049;32812;12802;41481;22851;74293
431442;201402;211;688;170;585;54;211;19;45;73;256
431445;201402;507;1422;354;1079;62;192;134;394;196;586
431446;201402;506;1504;383;1243;99;335;162;523;261;858
431447;201402;856;2454;619;1924;109;365;285;900;394;1265
431449;201402;931;2687;765;2402;131;453;386;1242;517;1695
431450;201402;2286;6120;2107;5847;545;1578;1261;3488;1806;5066
431455;201402;644;1681;425;1229;119;367;130;341;249;708
431460;201402;3690;10592;3224;9683;919;2890;1205;3697;2124;6587
431470;201402;2183;6490;1825;5693;516;1618;769;2528;1285;4146
431475;201402;151;451;59;236;12;52;5;23;17;75
431477;201402;635;1834;513;1588;107;364;271;812;378;1176
431478;201402;204;551;97;300;24;78;36;112;60;190
431480;201402;2719;8142;2179;7123;754;2661;588;1868;1342;4529
431490;201402;110065;317225;97651;298597;17884;62708;62582;187544;80466;250252
431500;201402;1195;3163;970;2742;289;841;333;937;622;1778
431505;201402;376;1079;350;1042;31;83;284;860;315;943
431507;201402;454;1130;371;973;83;212;218;585;301;797
431510;201402;2238;6264;1879;5635;373;1221;988;2890;1361;4111
431513;201402;172;500;110;360;29;97;49;157;78;254
431514;201402;118;301;50;156;10;35;7;17;17;52
431515;201402;756;2306;583;1886;131;471;272;809;403;1280
431517;201402;91;302;84;285;39;141;21;65;60;206
431520;201402;494;1508;325;1094;64;241;71;242;135;483
431530;201402;4676;11576;3689;10444;1043;3032;1950;5851;2993;8883
431531;201402;293;846;209;674;51;181;81;267;132;448
431532;201402;562;1615;507;1506;180;583;152;436;332;1019
431535;201402;389;1162;277;871;63;224;75;212;138;436
431540;201402;2228;7242;2013;6931;298;963;1292;4794;1590;5757
431545;201402;136;407;61;219;5;18;13;54;18;72
431550;201402;2478;7574;2299;7262;545;1957;1096;3393;1641;5350
431555;201402;784;2084;694;1953;167;474;353;1005;520;1479
431560;201402;24213;76726;21107;70382;8767;29874;6217;21846;14984;51720
431570;201402;5737;16638;5239;15900;1645;5103;2818;8692;4463;13795
431575;201402;489;1338;366;1137;52;186;142;431;194;617
431580;201402;722;2335;617;2093;154;587;229;725;383;1312
431590;201402;1009;2877;719;2290;82;276;385;1240;467;1516
431595;201402;634;1822;538;1615;133;428;189;570;322;998
431600;201402;2270;6878;1750;5771;463;1725;353;979;816;2704
431610;201402;1684;4829;1266;4055;318;1093;598;1906;916;2999
431620;201402;395;1270;254;844;88;313;92;281;180;594
431630;201402;1421;3950;1114;3296;283;876;543;1630;826;2506
431640;201402;6096;18497;5584;17675;1575;5511;2852;8845;4427;14356
431642;201402;522;1588;462;1462;76;289;251;763;327;1052
431643;201402;229;619;199;565;45;149;107;273;152;422
431645;201402;1821;5601;1677;5356;405;1323;923;3036;1328;4359
431647;201402;174;497;125;384;38;117;27;65;65;182
431650;201402;244;787;174;636;37;153;32;98;69;251
431660;201402;1506;4592;1184;3902;397;1362;397;1256;794;2618
431670;201402;1386;3950;1145;3515;335;1158;462;1339;797;2497
431673;201402;234;701;155;525;43;158;37;120;80;278
431675;201402;306;1031;235;810;56;196;63;193;119;389
431680;201402;10500;29855;8243;25886;2554;8632;2750;8736;5304;17368
431690;201402;25836;75739;21406;68752;6824;23559;7851;25583;14675;49142
431695;201402;146;505;108;403;24;90;26;73;50;163
431697;201402;526;1501;470;1395;134;410;196;599;330;1009
431700;201402;1676;4783;1452;4352;294;962;752;2208;1046;3170
431710;201402;13224;39491;11093;35761;3282;11111;4299;14446;7581;25557
431720;201402;7225;20850;6102;18753;1415;4926;3105;9344;4520;14270
431725;201402;38;135;36;131;22;84;5;18;27;102
431730;201402;3803;11950;3171;10734;971;3682;1108;3760;2079;7442
431740;201402;6062;18126;5444;16915;1969;6633;1559;4653;3528;11286
431750;201402;10620;30685;9184;28345;1950;6511;4804;15163;6754;21674
431755;201402;273;722;81;282;16;63;15;44;31;107
431760;201402;4064;12576;3444;11375;984;3531;996;3175;1980;6706
431770;201402;2380;6615;2033;6054;531;1692;1000;2931;1531;4623
431775;201402;253;726;198;621;80;265;51;140;131;405
431780;201402;2364;6427;1821;5407;519;1679;492;1364;1011;3043
431790;201402;1209;3866;1083;3645;286;1037;541;1801;827;2838
431795;201402;478;1454;392;1241;78;264;190;594;268;858
431800;201402;9758;29360;8308;26646;2786;9809;2387;7480;5173;17289
431805;201402;304;741;88;295;15;60;18;57;33;117
431810;201402;3717;10513;3147;9322;738;2395;1481;4338;2219;6733
431820;201402;2858;9111;2555;8524;771;2813;914;2971;1685;5784
431830;201402;11115;29869;9372;27139;3307;10476;3317;9573;6624;20049
431840;201402;3605;10945;3204;10174;987;3266;1367;4431;2354;7697
431842;201402;758;1985;453;1393;98;316;137;407;235;723
431843;201402;351;1051;319;993;80;278;171;510;251;788
431844;201402;170;510;132;438;36;140;41;125;77;265
431845;201402;544;1664;502;1574;58;187;343;1100;401;1287
431846;201402;535;1633;463;1501;86;316;263;851;349;1167
431848;201402;203;558;110;371;20;83;23;70;43;153
431849;201402;373;939;127;395;27;93;33;88;60;181
431850;201402;5038;14970;4536;14035;1095;3712;2253;6815;3348;10527
431860;201402;969;2786;807;2522;199;701;392;1165;591;1866
431861;201402;90;296;60;210;13;43;10;31;23;74
431862;201402;499;1726;424;1565;156;641;106;363;262;1004
431870;201402;26630;76386;22613;69220;6339;21392;9328;27734;15667;49126
431880;201402;4813;15469;4067;13753;1227;4574;1570;5119;2797;9693
431890;201402;5970;17351;5235;16016;2025;6558;1536;4824;3561;11382
431900;201402;988;3089;798;2721;231;894;309;951;540;1845
431910;201402;922;2251;485;1418;105;342;181;483;286;825
431912;201402;617;1828;495;1577;155;484;168;560;323;1044
431915;201402;1407;3914;1085;3328;302;978;369;1147;671;2125
431920;201402;1558;4465;1440;4303;199;570;1086;3337;1285;3907
431930;201402;1323;3721;1048;3269;158;482;614;2042;772;2524
431935;201402;108;416;100;397;43;185;22;67;65;252
431936;201402;489;1419;447;1346;76;225;288;942;364;1167
431937;201402;348;952;210;659;50;177;53;157;103;334
431940;201402;2815;7864;1934;6140;531;1791;532;1673;1063;3464
431950;201402;1949;6298;1745;5920;519;1918;656;2145;1175;4063
431960;201402;3756;11304;3460;10733;1070;3541;1165;3641;2235;7182
431970;201402;526;1453;292;956;48;177;77;239;125;416
431971;201402;134;406;113;378;31;106;46;150;77;256
431973;201402;479;1713;424;1598;66;250;250;1013;316;1263
431975;201402;15;62;11;51;2;12;3;13;5;25
431980;201402;1553;4579;1406;4285;382;1365;536;1489;918;2854
431990;201402;8928;25217;7225;22526;1492;5362;3120;9356;4612;14718
432000;201402;11222;33448;9316;30062;3059;10332;3743;12160;6802;22492
432010;201402;2544;7643;2224;7029;515;1870;1047;3184;1562;5054
432020;201402;2218;5952;1937;5572;329;1022;1237;3540;1566;4562
432023;201402;542;1599;420;1321;104;376;165;479;269;855
432026;201402;1226;3862;1055;3479;256;856;502;1696;758;2552
432030;201402;418;1254;355;1112;101;338;138;405;239;743
432032;201402;550;1484;380;1176;76;264;204;612;280;876
432035;201402;856;2804;783;2652;208;749;426;1423;634;2172
432040;201402;768;2283;551;1829;128;466;122;305;250;771
432045;201402;205;690;177;632;51;199;68;244;119;443
432050;201402;794;2341;718;2197;146;469;403;1264;549;1733
432055;201402;835;2626;724;2409;156;582;431;1383;587;1965
432057;201402;471;1256;378;1076;36;131;243;639;279;770
432060;201402;469;1348;212;748;60;234;48;155;108;389
432065;201402;245;726;192;630;47;173;81;239;128;412
432067;201402;1006;3330;764;2744;202;759;336;1194;538;1953
432070;201402;2481;6957;1958;5901;644;2181;599;1696;1243;3877
432080;201402;4323;12759;3821;11840;1229;4056;1474;4494;2703;8550
432085;201402;260;859;227;796;80;324;64;209;144;533
432090;201402;1780;5587;1523;5034;601;2140;427;1243;1028;3383
432100;201402;1230;3715;725;2531;178;653;128;385;306;1038
432110;201402;3128;9517;2565;8365;845;3046;473;1484;1318;4530
432120;201402;5389;16554;4683;15217;1690;5924;1368;4400;3058;10324
432130;201402;2396;7086;2080;6656;579;2002;1134;3669;1713;5671
432132;201402;423;1328;264;939;43;157;95;302;138;459
432135;201402;799;2433;760;2364;138;451;495;1546;633;1997
432140;201402;2970;8811;2439;7832;699;2392;910;3184;1609;5576
432143;201402;1387;4294;1212;3999;303;1022;656;2251;959;3273
432145;201402;1093;3517;760;2724;243;952;139;437;382;1389
432146;201402;279;889;205;703;69;250;52;172;121;422
432147;201402;843;2701;686;2356;195;691;271;960;466;1651
432149;201402;421;1266;301;978;89;307;93;291;182;598
432150;201402;3779;11229;2976;9685;982;3482;874;2755;1856;6237
432160;201402;4624;15245;4175;14488;1487;5455;1555;5651;3042;11106
432162;201402;341;843;102;334;25;91;24;67;49;158
432163;201402;362;963;109;349;19;61;19;65;38;126
432166;201402;818;2475;676;2177;137;506;317;939;454;1445
432170;201402;840;2839;626;2363;142;584;126;440;268;1024
432180;201402;2867;7719;2088;6421;597;1999;607;1793;1204;3792
432183;201402;406;1372;375;1305;158;571;82;283;240;854
432185;201402;867;2529;587;1933;133;481;216;700;349;1181
432190;201402;3591;10127;2694;8119;719;2321;801;2272;1520;4593
432195;201402;1299;3746;1174;3554;198;641;752;2280;950;2921
432200;201402;3192;10010;2656;9070;830;3047;1097;3836;1927;6883
432210;201402;439;1313;381;1229;108;404;176;521;284;925
432215;201402;898;2849;804;2691;162;521;481;1703;643;2224
432218;201402;318;898;244;750;43;141;108;308;151;449
432220;201402;3933;10767;3304;9732;477;1623;2066;5956;2543;7579
432225;201402;63;217;54;201;30;114;10;39;40;153
432230;201402;1121;3186;895;2737;280;960;368;1003;648;1963
432232;201402;581;1732;461;1501;106;381;230;747;336;1128
432234;201402;550;1552;421;1231;99;298;171;472;270;770
432235;201402;76;237;46;164;14;63;7;23;21;86
432237;201402;507;1428;460;1354;38;143;372;1073;410;1216
432240;201402;15778;52941;13856;50381;3350;13405;8011;29691;11361;43096
432250;201402;5633;19970;5335;19353;2377;9326;1345;4948;3722;14274
432252;201402;482;1445;409;1300;128;436;186;594;314;1030
432253;201402;1269;4284;1001;3582;340;1259;298;1077;638;2336
432254;201402;542;1461;203;669;44;154;28;82;72;236
432255;201402;213;538;121;396;32;108;42;146;74;254
432260;201402;7117;18722;5241;15580;1309;4109;2351;7068;3660;11177
432270;201402;2760;8650;2446;8109;732;2512;1149;3892;1881;6404
432280;201402;1261;3714;816;2748;184;711;206;583;390;1294
432285;201402;140;454;70;237;20;72;13;36;33;108
432290;201402;606;1869;417;1417;96;362;155;493;251;855
432300;201402;23665;73665;21818;70483;5995;20684;11094;35761;17089;56445
432310;201402;1014;3177;884;2935;202;758;436;1390;638;2148
432320;201402;283;803;182;595;51;166;57;194;108;360
432330;201402;238;715;110;391;19;65;12;37;31;102
432335;201402;208;613;92;326;23;89;8;23;31;112
432340;201402;304;798;160;494;40;131;41;121;81;252
432345;201402;777;2235;719;2143;158;568;378;1040;536;1608
432350;201402;462;1327;326;1074;77;266;86;266;163;532
432360;201402;45;144;35;124;15;53;11;38;26;91
432370;201402;487;1404;397;1229;37;109;262;835;299;944
432375;201402;884;2295;719;2023;131;379;423;1216;554;1595
432377;201402;80;273;39;127;7;22;12;31;19;53
432380;201402;863;3116;802;2983;356;1470;247;847;603;2317
500020;201402;2137;7023;1697;6086;501;1996;496;1661;997;3657
500025;201402;1010;2589;658;1974;132;411;274;806;406;1217
500060;201402;6308;18673;5208;16991;696;2267;3636;12376;4332;14643
500070;201402;4013;12215;3469;11286;814;3033;1606;5107;2420;8140
500080;201402;1821;5473;1378;4668;460;1709;391;1378;851;3087
500085;201402;2106;5737;1594;4945;205;712;964;2890;1169;3602
500090;201402;2346;7067;1859;6187;415;1448;946;3259;1361;4707
500100;201402;2550;7850;2378;7574;819;2973;1014;3060;1833;6033
500110;201402;8131;24238;6773;22189;1144;4200;3897;13330;5041;17530
500124;201402;1878;6176;1631;5763;306;1055;913;3512;1219;4567
500150;201402;1341;3667;1125;3335;303;1010;522;1480;825;2490
500190;201402;4884;13195;3890;11974;902;3036;2017;6435;2919;9471
500200;201402;2603;6763;1925;5795;387;1358;1042;3031;1429;4389
500210;201402;4888;14936;4265;13983;1027;3626;2122;7161;3149;10787
500215;201402;1735;5504;1477;5001;354;1369;596;1893;950;3262
500220;201402;2699;8671;2238;7797;555;2122;823;2925;1378;5047
500230;201402;2498;6819;1990;6050;730;2470;689;2051;1419;4521
500240;201402;4883;15249;3691;12882;732;2871;1563;5699;2295;8570
500260;201402;2510;6941;2078;6249;421;1407;1018;2884;1439;4291
500270;201402;106346;283733;74049;228758;21524;72764;18126;56266;39650;129030
500280;201402;1315;3924;1136;3676;212;719;693;2316;905;3035
500290;201402;3877;10166;2615;8020;732;2604;862;2415;1594;5019
500295;201402;2412;7568;1828;6141;427;1666;487;1422;914;3088
500310;201402;807;2170;717;2053;179;560;370;1016;549;1576
500315;201402;2896;9299;2528;8777;572;1929;1477;5490;2049;7419
500320;201402;13473;45991;11961;43270;4101;15766;4234;16274;8335;32040
500325;201402;4135;11149;3176;9607;895;3001;1359;3950;2254;6951
500330;201402;5641;15928;4561;13919;1480;4890;1722;5162;3202;10052
500345;201402;2458;7335;2098;6724;526;1882;1010;3137;1536;5019
500348;201402;2462;7328;2252;6984;288;1015;1625;5010;1913;6025
500350;201402;1235;3840;810;2870;140;530;234;859;374;1389
500370;201402;23080;73361;18678;64825;4846;18828;6708;23333;11554;42161
500375;201402;2703;7518;2050;6350;459;1529;938;2989;1397;4518
500380;201402;2925;8639;2514;7848;807;2718;762;2313;1569;5031
500390;201402;582;1285;389;1011;54;174;266;648;320;822
500400;201402;1329;4264;1089;3690;337;1270;300;914;637;2184
500410;201402;2140;6076;1759;5523;475;1628;763;2410;1238;4038
500430;201402;2668;8131;2202;7446;560;2029;958;3388;1518;5417
500440;201402;1342;3974;1146;3660;288;1047;590;1817;878;2864
500450;201402;2147;6798;1737;5965;454;1767;343;1050;797;2817
500460;201402;3602;11153;2956;10162;806;3040;1156;3920;1962;6960
500470;201402;2999;9133;2310;7610;660;2374;413;1266;1073;3640
500480;201402;2006;6571;1866;6359;204;715;1454;5094;1658;5809
500490;201402;1069;3128;912;2866;292;1036;290;915;582;1951
500500;201402;3487;10881;2840;9943;1064;4204;878;3030;1942;7234
500510;201402;870;2385;612;1950;137;524;233;666;370;1190
500515;201402;1897;5190;1537;4703;275;824;933;3077;1208;3901
500520;201402;2797;9891;2500;9476;616;2482;1415;5591;2031;8073
500525;201402;1166;3825;1009;3523;230;865;518;1892;748;2757
500540;201402;5201;15440;3482;12016;1034;4079;727;2353;1761;6432
500560;201402;4650;15806;4219;15181;897;3403;2726;9983;3623;13386
500568;201402;3868;10364;2945;9000;697;2293;1373;4265;2070;6558
500570;201402;7502;21136;5514;17646;1677;5767;1997;6435;3674;12202
500580;201402;3464;10343;2791;9129;516;1825;1658;5442;2174;7267
500600;201402;2953;8451;2290;7358;650;2294;860;2739;1510;5033
500620;201402;7565;21700;5692;18497;1271;4702;2848;9142;4119;13844
500625;201402;683;2082;466;1612;112;446;154;492;266;938
500627;201402;339;964;248;787;56;199;50;166;106;365
500630;201402;6111;17472;4972;15843;1736;6145;1416;4485;3152;10630
500635;201402;2357;9375;2098;8998;318;1314;1354;6302;1672;7616
500640;201402;1450;3749;1169;3349;152;500;783;2185;935;2685
500660;201402;15514;47767;12946;43350;3027;11379;5955;19899;8982;31278
500690;201402;3041;8882;2513;8229;771;2637;1181;4110;1952;6747
500710;201402;3560;11105;3237;10595;840;2951;1654;5438;2494;8389
500720;201402;4659;14230;3665;12231;1162;4294;1055;3395;2217;7689
500730;201402;944;2764;750;2365;171;595;282;850;453;1445
500740;201402;3679;10444;2734;8751;602;2242;1201;3620;1803;5862
500750;201402;810;2462;750;2379;200;679;402;1309;602;1988
500755;201402;1257;3800;974;3263;242;894;354;1110;596;2004
500769;201402;4641;12712;3206;9889;703;2426;990;2771;1693;5197
500770;201402;1673;5103;1357;4490;390;1386;447;1492;837;2878
500780;201402;1079;3436;957;3189;290;1061;416;1336;706;2397
500790;201402;8681;25022;7348;22691;1484;5405;3892;11434;5376;16839
500793;201402;2391;7060;1929;6288;352;1285;871;2714;1223;3999
500795;201402;2289;6948;2071;6638;276;754;1507;5192;1783;5946
500797;201402;930;2585;722;2245;158;547;334;1041;492;1588
500800;201402;2416;7138;2010;6555;673;2470;786;2567;1459;5037
500830;201402;15778;47249;11905;39272;3472;12536;3285;10502;6757;23038
500840;201402;1384;4094;1071;3486;219;772;472;1533;691;2305
510010;201402;1260;4052;1179;3909;407;1416;487;1681;894;3097
510020;201402;2786;8256;2053;6899;599;2134;519;1672;1118;3806
510025;201402;8976;27640;7969;25951;2498;9093;3168;10000;5666;19093
510030;201402;2104;5780;1786;5298;578;1808;748;2218;1326;4026
510035;201402;897;2701;765;2495;173;582;413;1417;586;1999
510040;201402;1695;4776;1356;4269;290;1033;684;2131;974;3164
510050;201402;1843;5461;1377;4606;383;1428;505;1673;888;3101
510060;201402;1237;3729;981;3245;275;995;311;999;586;1994
510080;201402;1307;4128;1104;3782;328;1311;361;1110;689;2421
510100;201402;645;1771;439;1361;96;335;159;467;255;802
510120;201402;293;606;196;500;15;32;169;440;184;472
510125;201402;3031;8203;2425;7159;483;1742;1136;3155;1619;4897
510130;201402;2079;5825;1789;5378;566;1803;702;2136;1268;3939
510140;201402;2942;9811;2481;9100;933;3614;779;2902;1712;6516
510160;201402;1273;4352;1218;4292;89;356;1069;3768;1158;4124
510170;201402;5965;18677;5086;17044;1277;4796;2287;7460;3564;12256
510180;201402;10769;30249;8238;26117;2608;8797;2826;9818;5434;18615
510185;201402;1161;3834;1088;3730;247;823;702;2544;949;3367
510190;201402;1628;5629;1351;5162;331;1414;579;2313;910;3727
510250;201402;13590;43829;11864;41433;3784;14140;5416;19399;9200;33539
510260;201402;2547;9704;2349;9294;716;3008;1008;4206;1724;7214
510263;201402;4162;11811;3208;10208;916;3213;1034;3146;1950;6359
510267;201402;5233;15367;3898;12520;925;3285;1334;4087;2259;7372
510268;201402;871;2583;754;2417;212;753;370;1176;582;1929
510269;201402;818;2679;745;2569;228;822;318;1130;546;1952
510270;201402;2391;7618;2183;7291;367;1224;1360;4785;1727;6009
510279;201402;2037;6656;1870;6374;701;2679;570;1760;1271;4439
510285;201402;1477;4619;1256;4225;364;1335;426;1376;790;2711
510300;201402;3095;9671;2778;9222;401;1498;2030;6725;2431;8223
510305;201402;1597;5176;1339;4699;372;1443;420;1488;792;2931
510310;201402;1095;3209;871;2848;308;1116;249;793;557;1909
510320;201402;3972;12064;3210;10524;995;3785;580;1622;1575;5407
510325;201402;5461;17743;4799;16802;619;2142;3647;13245;4266;15387
510330;201402;2697;9080;2358;8455;637;2529;905;3312;1542;5841
510335;201402;4417;14235;3943;13591;690;2377;2783;10003;3473;12380
510336;201402;542;1705;481;1593;104;371;225;745;329;1116
510337;201402;2237;7624;1976;7119;804;2992;552;2185;1356;5177
510340;201402;61275;183663;49717;166131;19822;72823;10488;36906;30310;109729
510343;201402;1127;3420;1039;3313;119;359;834;2746;953;3105
510345;201402;1660;4990;1427;4581;368;1285;474;1445;842;2730
510350;201402;3391;10028;2836;9264;826;2933;1300;4329;2126;7262
510360;201402;1810;4900;1362;4356;283;976;854;2685;1137;3661
510370;201402;872;3233;787;3090;228;923;388;1584;616;2507
510380;201402;477;1576;387;1389;141;559;62;204;203;763
510385;201402;891;3399;759;3054;132;584;352;1518;484;2102
510390;201402;1146;3617;1055;3512;271;821;604;2212;875;3033
510395;201402;828;2172;639;1930;117;373;370;1182;487;1555
510410;201402;3970;13299;3759;12924;1106;4086;1817;6272;2923;10358
510420;201402;2278;6083;1759;5220;307;1078;903;2641;1210;3719
510450;201402;583;1656;453;1477;138;513;151;475;289;988
510452;201402;606;1979;449;1610;114;461;158;523;272;984
510454;201402;745;2389;658;2260;160;583;357;1276;517;1859
510455;201402;1006;3128;785;2712;190;781;301;989;491;1770
510460;201402;1987;5779;1761;5464;362;1296;1120;3370;1482;4666
510480;201402;4165;11545;3238;9810;815;2666;1068;3154;1883;5820
510490;201402;1472;4928;1326;4709;356;1385;737;2577;1093;3962
510500;201402;1406;4368;1062;3722;289;1156;469;1576;758;2732
510510;201402;3038;10849;2709;10283;1057;4260;911;3486;1968;7746
510515;201402;5606;17670;4651;15706;1211;4600;1308;4183;2519;8783
510517;201402;1701;5251;1513;4976;457;1461;886;3060;1343;4521
510520;201402;2153;5676;1701;5049;134;469;1274;3776;1408;4245
510523;201402;1057;3251;898;2986;258;936;440;1431;698;2367
510525;201402;7821;20225;5170;16097;1262;4290;1834;5621;3096;9911
510530;201402;562;1627;493;1527;85;311;284;877;369;1188
510550;201402;2703;9071;2357;8467;668;2512;1026;3825;1694;6337
510558;201402;2073;6116;1650;5484;503;1841;644;2106;1147;3947
510560;201402;1618;5393;1204;4651;438;1781;269;1105;707;2886
510562;201402;5116;15892;4519;14724;1578;5660;1453;4773;3031;10433
510590;201402;2751;8025;2224;7357;644;2338;963;3229;1607;5567
510600;201402;1481;3856;1040;3173;163;548;529;1555;692;2103
510610;201402;2742;8275;2486;7931;288;1059;1932;6124;2220;7183
510615;201402;2109;7005;1882;6617;637;2417;781;2726;1418;5143
510617;201402;536;1683;480;1600;82;311;340;1141;422;1452
510618;201402;1300;3921;978;3290;245;940;434;1440;679;2380
510619;201402;774;2169;521;1715;105;375;151;502;256;877
510620;201402;1185;3266;816;2719;295;1110;172;531;467;1641
510621;201402;1042;3682;922;3423;272;1110;311;1093;583;2203
510622;201402;3580;11111;2451;8556;585;2307;388;1151;973;3458
510623;201402;3699;10780;3132;9859;1089;3608;1161;3637;2250;7245
510624;201402;1190;3765;971;3364;222;871;407;1324;629;2195
510625;201402;2301;6855;1875;6093;546;2012;492;1511;1038;3523
510626;201402;1273;4072;1042;3706;346;1348;471;1683;817;3031
510627;201402;700;2142;557;1883;203;756;168;564;371;1320
510628;201402;1525;3992;1210;3602;182;610;822;2448;1004;3058
510629;201402;1797;6019;1570;5544;557;2167;365;1208;922;3375
510630;201402;2606;8814;2214;8134;736;3051;567;2119;1303;5170
510631;201402;405;1201;364;1137;79;249;228;713;307;962
510637;201402;2619;8077;2388;7671;735;2616;1068;3330;1803;5946
510642;201402;4744;15664;4084;14784;1389;5305;1810;6867;3199;12172
510645;201402;704;1785;566;1617;217;646;170;542;387;1188
510650;201402;5972;20470;5575;19983;1383;5250;3345;12514;4728;17764
510665;201402;1230;3389;873;2805;221;797;327;1020;548;1817
510670;201402;348;874;212;676;46;170;76;227;122;397
510675;201402;6158;20593;5355;19055;1832;7149;1396;4844;3228;11993
510677;201402;2550;6569;1915;5739;282;889;1330;4143;1612;5032
510680;201402;790;2491;675;2294;153;579;285;900;438;1479
510682;201402;2359;7514;1939;6757;517;1935;760;2751;1277;4686
510685;201402;947;2631;815;2472;105;373;587;1770;692;2143
510700;201402;4016;11052;2986;9477;648;2264;1685;5359;2333;7623
510704;201402;7929;22954;6670;20776;1772;6231;3144;9450;4916;15681
510706;201402;1682;5332;1353;4793;427;1595;594;2096;1021;3691
510710;201402;3599;10364;2863;8901;831;2925;926;2574;1757;5499
510715;201402;703;1853;489;1507;124;417;177;510;301;927
510718;201402;1732;5269;1533;5005;497;1673;763;2574;1260;4247
510719;201402;447;1032;274;808;34;140;123;331;157;471
510720;201402;1274;3050;949;2665;88;273;731;2079;819;2352
510724;201402;814;2543;693;2315;161;594;388;1259;549;1853
510726;201402;660;1797;554;1619;155;475;199;558;354;1033
510729;201402;660;1845;540;1659;155;511;213;665;368;1176
510730;201402;2291;7257;2049;6826;508;1939;1080;3436;1588;5375
510735;201402;1051;3670;894;3405;335;1359;349;1328;684;2687
510740;201402;996;2590;818;2338;184;524;481;1420;665;1944
510757;201402;661;2346;613;2243;171;665;290;1059;461;1724
510760;201402;27789;79933;22497;70920;8023;27220;7178;22685;15201;49905
510770;201402;4467;12080;4050;11602;641;1839;2548;8239;3189;10078
510774;201402;381;1113;316;1008;70;252;155;472;225;724
510775;201402;848;2404;680;2141;240;873;239;743;479;1616
510776;201402;448;1285;373;1152;86;301;175;526;261;827
510777;201402;1429;4509;1147;4160;271;1110;686;2465;957;3575
510779;201402;632;1902;484;1628;83;303;179;625;262;928
510780;201402;3895;11635;3379;10917;795;2775;1849;6148;2644;8923
510785;201402;1877;5719;1564;5195;534;1883;556;1880;1090;3763
510787;201402;2076;6552;1823;6124;580;2136;676;2214;1256;4350
510788;201402;352;1104;322;1064;155;512;92;309;247;821
510790;201402;15039;44675;10594;36270;2986;11826;1375;4519;4361;16345
510792;201402;5836;19378;4466;16530;1141;4889;812;2779;1953;7668
510794;201402;1362;4259;1085;3827;488;1820;214;680;702;2500
510795;201402;8992;29491;7199;25856;2328;9118;1770;6377;4098;15495
510800;201402;1802;5242;1523;4878;431;1515;711;2187;1142;3702
510805;201402;1823;5215;1510;4767;258;919;1018;3193;1276;4112
510810;201402;687;1696;542;1500;155;459;271;738;426;1197
510820;201402;836;2112;651;1839;159;531;248;624;407;1155
510830;201402;562;1986;507;1893;176;701;228;907;404;1608
510835;201402;703;2216;555;1937;196;754;207;667;403;1421
510840;201402;49940;127725;40801;116350;10463;31854;20855;61604;31318;93458
510850;201402;1667;4976;1365;4516;597;2219;204;539;801;2758
510860;201402;2438;8326;2022;7407;699;2798;342;1181;1041;3979
510880;201402;826;2814;726;2638;251;958;265;973;516;1931
510885;201402;573;1644;437;1445;93;355;192;637;285;992
510890;201402;886;3039;771;2825;260;1067;191;623;451;1690
510895;201402;1123;3671;1007;3458;307;1179;387;1245;694;2424
520005;201402;1233;4068;1152;3943;370;1338;515;1781;885;3119
520010;201402;1865;6512;1653;6061;724;2974;256;801;980;3775
520013;201402;3950;11174;3059;9609;773;2599;1369;4347;2142;6946
520015;201402;579;1624;472;1463;135;431;173;551;308;982
520017;201402;1192;3797;1050;3560;302;1113;438;1444;740;2557
520020;201402;417;1123;323;973;90;287;157;495;247;782
520025;201402;22585;74434;22016;73744;3426;12075;16970;57132;20396;69207
520030;201402;4591;15083;4084;14262;1360;5142;1518;5396;2878;10538
520050;201402;340;1031;314;977;64;225;204;611;268;836
520055;201402;666;2043;573;1885;149;485;287;979;436;1464
520060;201402;1656;5240;1474;4892;338;1256;575;1959;913;3215
520080;201402;1622;5205;1435;4915;381;1346;726;2569;1107;3915
520082;201402;661;2168;617;2090;157;522;346;1230;503;1752
520085;201402;1037;3296;909;3001;211;766;345;1143;556;1909
520090;201402;922;2286;752;2058;140;361;416;1230;556;1591
520110;201402;39485;120919;31466;108844;12663;48207;7636;26945;20299;75152
520120;201402;261;692;156;506;40;158;33;105;73;263
520130;201402;3672;10983;3411;10587;727;2441;2042;6353;2769;8794
520140;201402;43112;145729;39082;137792;14088;53741;10660;37319;24748;91060
520145;201402;543;1410;403;1213;94;312;161;467;255;779
520150;201402;677;1816;560;1681;160;528;263;775;423;1303
520160;201402;842;2556;743;2408;261;898;271;896;532;1794
520170;201402;3934;9774;3193;8980;595;1805;2202;6322;2797;8127
520180;201402;1801;5603;1553;5195;459;1672;598;1976;1057;3648
520215;201402;1670;4444;1456;4141;277;869;877;2511;1154;3380
520235;201402;827;2266;650;2010;194;657;270;805;464;1462
520250;201402;1112;3800;1044;3690;357;1335;496;1791;853;3126
520260;201402;753;2022;570;1687;99;341;276;781;375;1122
520280;201402;579;1701;529;1626;245;814;130;447;375;1261
520310;201402;1010;2597;811;2338;211;638;416;1292;627;1930
520320;201402;1512;4928;1278;4471;212;792;730;2620;942;3412
520330;201402;2858;9013;2215;7852;670;2567;428;1436;1098;4003
520340;201402;1891;4914;1528;4487;230;637;1157;3519;1387;4156
520350;201402;3052;9273;2650;8485;945;3249;1064;3313;2009;6562
520355;201402;1113;3935;1083;3868;433;1620;433;1533;866;3153
520357;201402;893;2454;765;2269;70;233;530;1555;600;1788
520360;201402;603;1688;537;1583;148;447;236;699;384;1146
520380;201402;1127;3154;861;2693;175;605;431;1364;606;1969
520390;201402;1199;3217;850;2743;277;1021;319;948;596;1969
520393;201402;570;1517;516;1429;93;273;329;918;422;1191
520396;201402;705;2307;657;2226;102;395;439;1499;541;1894
520400;201402;1714;4960;1470;4625;292;998;895;2841;1187;3839
520410;201402;1491;4110;1203;3703;357;1210;543;1643;900;2853
520420;201402;343;961;260;811;49;181;110;314;159;495
520425;201402;1417;3998;1331;3848;436;1346;619;1761;1055;3107
520430;201402;1917;5188;1456;4420;313;1088;602;1754;915;2842
520440;201402;3211;8763;2444;7524;886;3022;605;1838;1491;4860
520450;201402;9395;27715;7396;23916;2092;7555;1351;4026;3443;11581
520455;201402;676;2053;561;1866;220;793;150;503;370;1296
520460;201402;842;2491;689;2234;188;682;270;845;458;1527
520465;201402;802;2237;707;2112;171;633;317;860;488;1493
520470;201402;1743;5733;1595;5514;414;1453;942;3410;1356;4863
520480;201402;957;2865;836;2671;191;643;481;1557;672;2200
520485;201402;1176;4064;1093;3908;428;1632;462;1660;890;3292
520490;201402;4316;13614;3509;12362;1501;5705;1098;3878;2599;9583
520495;201402;1391;3813;1153;3521;87;258;971;3032;1058;3290
520500;201402;2048;5538;1834;5247;632;1940;729;2242;1361;4182
520505;201402;895;2589;775;2410;172;544;479;1531;651;2075
520510;201402;11301;32038;7723;26012;2356;8794;1835;6173;4191;14967
520520;201402;1030;3038;875;2829;338;1169;329;1081;667;2250
520530;201402;2379;7442;2047;6902;481;1640;986;3701;1467;5341
520540;201402;2973;9197;2606;8575;853;2959;1001;3295;1854;6254
520545;201402;1317;4110;1139;3751;341;1198;316;987;657;2185
520547;201402;780;2500;643;2266;221;861;174;570;395;1431
520549;201402;8611;26771;7554;25465;2270;8130;3695;12574;5965;20704
520551;201402;3739;11488;3591;11310;1133;3743;1932;6315;3065;10058
520552;201402;685;2321;669;2298;121;467;446;1521;567;1988
520570;201402;578;1711;439;1479;189;681;80;262;269;943
520580;201402;1969;5868;1647;5390;501;1844;529;1659;1030;3503
520590;201402;1519;4336;1282;3955;348;1136;473;1382;821;2518
520620;201402;7091;23231;6499;22345;1525;5644;3760;13056;5285;18700
520630;201402;643;1852;558;1750;166;515;288;923;454;1438
520640;201402;2645;7866;2340;7393;807;2695;949;3146;1756;5841
520650;201402;807;2354;701;2157;283;920;248;761;531;1681
520660;201402;385;1199;334;1112;109;398;98;323;207;721
520670;201402;803;2436;777;2396;73;183;674;2129;747;2312
520680;201402;598;1812;519;1701;182;655;193;624;375;1279
520690;201402;311;828;225;712;34;111;122;401;156;512
520710;201402;464;1184;320;918;11;39;197;554;208;593
520725;201402;1789;4759;1400;4188;330;1131;725;2113;1055;3244
520735;201402;681;2058;555;1835;184;661;160;504;344;1165
520740;201402;1682;4953;1422;4594;398;1367;666;2140;1064;3507
520750;201402;698;1888;535;1668;142;503;299;925;441;1428
520753;201402;1198;3529;1144;3450;178;497;830;2628;1008;3125
520760;201402;1128;3194;1001;3031;333;1093;526;1576;859;2669
520780;201402;2047;5131;1731;4711;217;566;1311;3673;1528;4239
520790;201402;2498;7204;2245;6851;368;1227;1569;4830;1937;6057
520800;201402;17362;52014;15550;49866;3678;11628;9141;31699;12819;43327
520810;201402;947;2653;852;2533;150;462;610;1887;760;2349
520815;201402;431;1484;347;1319;166;718;33;112;199;830
520830;201402;1701;4380;1332;3992;60;162;1204;3694;1264;3856
520840;201402;1630;5570;1480;5274;515;1945;504;1839;1019;3784
520850;201402;781;2329;617;2089;186;655;240;800;426;1455
520860;201402;7034;20238;5291;17876;1491;5453;2442;8487;3933;13940
520870;201402;121497;346190;88902;287931;28843;102072;24907;79674;53750;181746
520880;201402;6849;20153;5077;17325;1491;5756;707;2222;2198;7978
520890;201402;3711;11051;3294;10411;781;2654;1700;5378;2481;8032
520910;201402;3270;10257;2661;8995;830;3126;625;2018;1455;5144
520915;201402;915;2640;693;2212;174;580;263;796;437;1376
520920;201402;3181;8721;2288;7282;609;2095;655;2134;1264;4229
520929;201402;444;1311;400;1261;118;387;203;636;321;1023
520940;201402;958;2977;870;2836;124;473;612;1955;736;2428
520945;201402;641;1646;565;1524;204;556;214;565;418;1121
520960;201402;881;2619;729;2381;126;444;409;1339;535;1783
520970;201402;3372;9987;2785;8939;637;2310;1073;3358;1710;5668
520980;201402;1007;2767;933;2670;243;781;585;1638;828;2419
520990;201402;3664;11535;3361;10978;687;2471;1740;6260;2427;8731
520993;201402;1129;3178;931;2828;148;493;543;1633;691;2126
520995;201402;2566;7181;2316;6846;384;1200;1615;4782;1999;5982
521000;201402;7735;23599;6694;21906;1569;5704;3345;10930;4914;16634
521010;201402;3802;12013;3301;11063;867;3142;1334;4506;2201;7648
521015;201402;674;1934;579;1782;139;440;292;916;431;1356
521020;201402;4424;13227;3516;11331;1198;4163;683;1969;1881;6132
521030;201402;804;2187;710;2055;151;458;455;1333;606;1791
521040;201402;5418;16155;4982;15472;1992;6287;2223;7255;4215;13542
521056;201402;981;3046;835;2801;295;1040;327;1136;622;2176
521060;201402;1123;3205;992;3001;249;780;401;1201;650;1981
521080;201402;1195;3037;786;2350;160;570;268;668;428;1238
521090;201402;3200;9480;2736;8845;990;3440;910;3001;1900;6441
521100;201402;1410;3698;1301;3575;274;738;869;2479;1143;3217
521120;201402;4729;13922;4350;13313;1056;3194;2375;7547;3431;10741
521130;201402;1106;3183;912;2835;219;787;442;1369;661;2156
521140;201402;900;3048;822;2872;300;1124;182;612;482;1736
521150;201402;12934;34333;8879;26593;2586;8663;3206;9471;5792;18134
521160;201402;734;1914;495;1424;88;282;274;745;362;1027
521170;201402;1323;3225;1125;2974;352;917;601;1597;953;2514
521180;201402;6381;21854;5863;20803;2116;8069;1579;5572;3695;13641
521190;201402;8501;25760;6518;22341;2268;8234;1980;6877;4248;15111
521200;201402;841;2247;790;2186;115;342;561;1544;676;1886
521205;201402;534;1686;461;1549;73;266;263;903;336;1169
521210;201402;887;2610;647;2132;242;921;214;611;456;1532
521220;201402;3769;10879;3197;10089;1114;3809;1209;3752;2323;7561
521225;201402;380;995;304;897;47;149;198;603;245;752
521230;201402;1334;4243;1232;4033;481;1674;508;1603;989;3277
521250;201402;25594;86959;24474;85183;9783;36627;9627;33871;19410;70498
521260;201402;806;2009;645;1725;113;389;358;888;471;1277
521270;201402;1723;5627;1615;5443;161;474;1250;4419;1411;4893
521280;201402;1801;5676;1564;5252;501;1822;582;1942;1083;3764
521290;201402;533;1565;401;1351;120;480;145;457;265;937
521295;201402;1097;3115;1026;3018;155;479;782;2312;937;2791
521300;201402;1810;5333;1678;5124;490;1537;826;2621;1316;4158
521305;201402;838;2233;708;2057;176;512;412;1240;588;1752
521308;201402;4983;15047;4048;13486;838;3114;2201;7230;3039;10344
521310;201402;7210;22432;5920;19989;2150;7719;1448;4732;3598;12451
521340;201402;254;800;227;755;63;242;99;303;162;545
521350;201402;2191;5702;1812;5192;250;773;1166;3544;1416;4317
521370;201402;1008;3280;928;3126;341;1226;281;892;622;2118
521375;201402;1351;3958;1179;3669;306;1063;590;1774;896;2837
521377;201402;999;2937;954;2883;84;241;817;2519;901;2760
521380;201402;3848;11420;3053;10036;737;2661;1008;3271;1745;5932
521385;201402;592;1698;534;1621;171;545;232;704;403;1249
521390;201402;1109;2950;831;2566;249;879;260;786;509;1665
521400;201402;2391;6530;2051;6133;334;1113;1479;4380;1813;5493
521405;201402;1295;3850;1108;3504;392;1362;383;1194;775;2556
521410;201402;734;2403;674;2298;308;1041;238;855;546;1896
521440;201402;1482;4172;1468;4157;149;377;1247;3638;1396;4015
521450;201402;4983;15312;4210;13914;1357;4812;1023;3248;2380;8060
521460;201402;6974;22120;6458;21337;1948;7016;3056;10039;5004;17055
521470;201402;697;1959;521;1627;127;450;98;292;225;742
521480;201402;512;1510;378;1266;125;422;95;316;220;738
521483;201402;3054;8232;2563;7397;720;2223;1032;2917;1752;5140
521486;201402;1601;4535;1449;4245;358;1168;887;2503;1245;3671
521487;201402;580;1597;449;1399;113;348;215;696;328;1044
521490;201402;826;2431;667;2209;112;423;444;1479;556;1902
521500;201402;1229;4102;1131;3899;213;819;642;2093;855;2912
521520;201402;892;2150;815;2056;199;438;431;1255;630;1693
521523;201402;11307;42661;10684;41564;3504;15059;2824;11297;6328;26356
521525;201402;1111;2913;986;2751;135;427;662;1794;797;2221
521530;201402;2033;6108;1426;4900;544;1972;235;758;779;2730
521540;201402;937;2675;677;2180;190;711;190;550;380;1261
521550;201402;961;2456;866;2323;257;744;453;1173;710;1917
521560;201402;4915;15141;3963;13881;1658;6372;1041;3496;2699;9868
521565;201402;701;1862;602;1738;113;323;400;1184;513;1507
521570;201402;4607;13083;3369;10611;1139;3860;1015;3198;2154;7058
521580;201402;669;1654;492;1409;177;553;141;394;318;947
521590;201402;748;2132;621;1919;231;773;114;367;345;1140
521600;201402;626;1660;458;1371;119;384;156;427;275;811
521630;201402;1790;4905;1513;4474;548;1883;262;617;810;2500
521640;201402;1771;5172;1554;4833;514;1857;435;1383;949;3240
521645;201402;654;2030;553;1791;136;491;228;679;364;1170
521680;201402;1449;4673;1257;4264;676;2425;196;623;872;3048
521690;201402;579;1756;522;1650;127;476;241;698;368;1174
521710;201402;2249;7146;2003;6664;427;1525;1148;3809;1575;5334
521720;201402;2042;6140;1877;5910;498;1634;1070;3476;1568;5110
521730;201402;3828;12976;3564;12452;1566;6008;920;2937;2486;8945
521740;201402;3433;9581;2780;8758;1278;4154;981;3242;2259;7396
521760;201402;12301;42517;11580;41384;2147;8563;7589;27316;9736;35879
521770;201402;2742;8455;2339;7636;1039;3640;493;1490;1532;5130
521800;201402;8669;26025;7521;24330;2752;9421;3231;10852;5983;20273
521805;201402;946;2215;766;1933;230;535;379;1082;609;1617
521810;201402;817;2423;722;2264;172;587;361;1112;533;1699
521830;201402;5432;18476;5133;18015;1067;4098;3339;11696;4406;15794
521839;201402;642;1946;534;1728;131;467;200;602;331;1069
521850;201402;6608;19034;5822;17749;1412;4336;3042;9392;4454;13728
521860;201402;1728;5325;1514;4896;425;1506;523;1616;948;3122
521870;201402;553;1957;516;1859;158;616;146;485;304;1101
521878;201402;525;1788;457;1609;133;524;174;576;307;1100
521880;201402;25155;67404;17465;54786;5983;20258;4893;15537;10876;35795
521890;201402;3604;11395;3086;10356;1179;4248;722;2394;1901;6642
521900;201402;1656;4446;1365;4046;357;1174;528;1453;885;2627
521910;201402;1204;3382;1053;3207;271;919;573;1786;844;2705
521920;201402;398;1203;356;1136;139;470;128;392;267;862
521925;201402;635;1980;570;1852;131;474;240;721;371;1195
521930;201402;3918;12746;3568;12082;1337;4814;1054;3585;2391;8399
521935;201402;668;2020;634;1955;199;645;324;974;523;1619
521940;201402;1132;3093;934;2762;341;1070;304;905;645;1975
521945;201402;665;2314;624;2265;140;463;429;1676;569;2139
521950;201402;533;1664;459;1535;147;524;175;590;322;1114
521960;201402;933;2768;801;2545;196;661;366;1147;562;1808
521970;201402;2474;7162;2266;6890;357;1101;1604;5024;1961;6125
521971;201402;997;2740;788;2384;187;638;302;883;489;1521
521973;201402;869;2930;790;2772;227;853;262;896;489;1749
521975;201402;13365;38832;12602;37853;2553;8363;7842;23722;10395;32085
521980;201402;1766;5613;1701;5541;280;897;1304;4404;1584;5301
521990;201402;1047;3314;972;3186;170;617;601;1939;771;2556
522000;201402;2077;6199;1842;5896;388;1330;1084;3608;1472;4938
522005;201402;377;989;288;849;75;232;135;397;210;629
522010;201402;2927;8885;2513;8192;907;3228;706;2213;1613;5441
522015;201402;1006;2980;845;2734;245;878;382;1230;627;2108
522020;201402;4481;12629;4002;12028;966;3182;2372;7007;3338;10189
522026;201402;649;1860;464;1666;206;796;133;495;339;1291
522028;201402;531;1600;481;1522;125;429;279;865;404;1294
522040;201402;3077;8001;2295;7001;814;2658;899;2762;1713;5420
522045;201402;12576;41843;10824;38222;3660;14196;2253;7712;5913;21908
522050;201402;1018;3028;838;2728;280;1008;318;982;598;1990
522060;201402;2981;9459;2545;8797;805;2993;1242;4266;2047;7259
522068;201402;1528;5010;1434;4907;147;444;1171;4226;1318;4670
522070;201402;826;2538;755;2423;122;474;478;1516;600;1990
522100;201402;804;2255;718;2124;274;922;304;818;578;1740
522108;201402;934;2782;828;2623;91;297;597;1954;688;2251
522119;201402;1259;3913;1065;3667;130;436;793;2851;923;3287
522130;201402;508;1470;439;1394;137;469;217;701;354;1170
522140;201402;17499;50222;15448;47232;4842;16097;6238;18698;11080;34795
522145;201402;921;2650;872;2569;450;1399;226;657;676;2056
522150;201402;1264;3360;1061;3084;383;1201;377;1135;760;2336
522155;201402;761;2267;688;2160;156;514;397;1304;553;1818
522157;201402;684;2026;604;1894;68;240;466;1460;534;1700
522160;201402;6059;17513;4502;14862;1795;6582;734;2272;2529;8854
522170;201402;3160;8851;2677;8174;788;2459;1103;3542;1891;6001
522180;201402;450;1301;341;1136;149;559;108;346;257;905
522185;201402;14346;45375;13293;43957;2962;10616;7943;26479;10905;37095
522190;201402;819;2285;714;2099;127;389;411;1226;538;1615
522200;201402;1555;5277;1446;5049;504;1920;422;1410;926;3330
522205;201402;1299;3781;1092;3432;330;1088;472;1494;802;2582
522220;201402;1286;3702;1073;3431;259;916;533;1831;792;2747
522230;201402;1084;3414;998;3276;193;720;632;2077;825;2797
530010;201402;252122;828153;228496;781136;70558;266945;74761;253565;145319;520510
110001;201401;4406;14609;3840;13702;1108;4103;2031;7355;3139;11458
110002;201401;12988;42365;11533;39853;3830;14272;4784;16618;8614;30890
110003;201401;980;3217;921;3123;274;990;382;1261;656;2251
110004;201401;9510;31521;8269;28942;2648;10126;2606;9143;5254;19269
110005;201401;2360;8018;2250;7810;866;3101;896;3154;1762;6255
110006;201401;3419;9250;2167;7521;725;2678;612;1994;1337;4672
110007;201401;1492;4792;1387;4643;330;1180;770;2733;1100;3913
110008;201401;2585;8926;2430;8706;583;2009;1603;6058;2186;8067
110009;201401;5336;15531;4212;13890;1107;3926;1988;6481;3095;10407
110010;201401;8397;24293;7455;23129;1550;4425;4722;15943;6272;20368
110011;201401;10803;33554;8997;30465;3412;12281;3093;10469;6505;22750
110012;201401;16785;52394;14680;48384;5090;17868;5205;17021;10295;34889
110013;201401;5239;16793;4400;15586;1416;5314;1932;6965;3348;12279
110014;201401;4305;12975;3680;12095;862;2977;2149;7167;3011;10144
110015;201401;5130;16746;4236;15144;1649;6295;1375;4945;3024;11240
110018;201401;5141;15324;4247;14173;1342;5001;1891;6090;3233;11091
110020;201401;55547;165601;47367;155513;11019;37410;27687;93918;38706;131328
110025;201401;4457;13224;3773;12000;634;2161;2634;8363;3268;10524
110026;201401;820;2409;694;2261;160;530;450;1518;610;2048
110028;201401;7464;22384;5741;19578;1760;6578;1560;5223;3320;11801
110029;201401;1699;5059;1377;4507;476;1623;551;1850;1027;3473
110030;201401;11268;32903;9326;30432;2565;8998;4804;16267;7369;25265
110032;201401;4080;13496;3701;12668;1080;3853;1540;5333;2620;9186
110033;201401;5508;17871;5156;17328;1738;5933;2305;8310;4043;14243
110034;201401;3865;10222;3253;9491;510;1451;2488;7373;2998;8824
110037;201401;2051;7042;1818;6612;512;1882;960;3558;1472;5440
110040;201401;3514;11644;3292;11244;1085;3992;1487;5038;2572;9030
110045;201401;5198;18082;4818;17631;1445;5635;2737;10003;4182;15638
110050;201401;1832;5924;1537;5537;540;1991;780;2882;1320;4873
110060;201401;992;3497;884;3303;259;1019;458;1709;717;2728
110070;201401;1943;6700;1891;6578;328;1199;1330;4649;1658;5848
110080;201401;3415;11093;3290;10934;694;2184;2421;8310;3115;10494
110090;201401;937;2800;754;2502;241;896;296;906;537;1802
110092;201401;1728;5628;1580;5439;377;1324;887;3230;1264;4554
110094;201401;3111;10097;2867;9740;753;2720;1654;5745;2407;8465
110100;201401;2651;8549;2312;7989;719;2589;1131;3940;1850;6529
110110;201401;1775;5802;1665;5674;753;2600;706;2527;1459;5127
110120;201401;1604;5466;1367;4884;380;1415;506;1819;886;3234
110130;201401;2784;8053;2136;7117;575;2014;1026;3464;1601;5478
110140;201401;2492;8683;2365;8488;530;1925;1522;5593;2052;7518
110143;201401;1571;5155;1248;4593;315;1197;677;2483;992;3680
110145;201401;990;3055;881;2883;174;617;551;1807;725;2424
110146;201401;454;1476;416;1419;110;389;222;773;332;1162
110147;201401;903;2726;714;2415;201;739;249;761;450;1500
110148;201401;1337;4030;1081;3516;352;1269;356;1091;708;2360
110149;201401;3701;10989;2945;9817;718;2542;1785;6036;2503;8578
110150;201401;2859;8534;2375;7824;392;1413;1517;5018;1909;6431
110155;201401;927;3122;880;3014;298;1094;423;1408;721;2502
110160;201401;2182;6923;1818;6286;620;2201;822;2875;1442;5076
110170;201401;3209;9402;2526;8236;560;1963;1536;5044;2096;7007
110175;201401;1622;5254;1262;4791;129;526;925;3570;1054;4096
110180;201401;1699;5357;1462;4965;351;1223;865;2983;1216;4206
120001;201401;2857;10350;2779;10212;728;2849;1529;5745;2257;8594
120005;201401;1547;6224;1506;6148;179;696;1155;4916;1334;5612
120010;201401;4429;15837;4260;15540;990;3433;2718;10412;3708;13845
120013;201401;1832;7195;1793;7129;397;1586;1152;4802;1549;6388
120017;201401;2110;7578;1998;7372;561;2182;941;3769;1502;5951
120020;201401;14127;62391;13922;61903;2555;10782;9961;46408;12516;57190
120025;201401;2679;9374;2608;9264;637;2394;1518;5478;2155;7872
120030;201401;5904;24009;5858;23945;540;2086;4937;20661;5477;22747
120032;201401;1368;6652;1324;6548;185;1056;960;4787;1145;5843
120033;201401;3592;13784;3563;13730;227;905;3140;12259;3367;13164
120034;201401;1773;7192;1764;7177;82;378;1637;6664;1719;7042
120035;201401;2722;13236;2691;13157;262;1235;2221;11227;2483;12462
120038;201401;3187;11779;3081;11555;891;3446;1599;6198;2490;9644
120039;201401;1384;7771;1363;7724;179;1074;1072;6175;1251;7249
120040;201401;44440;162805;41354;156342;12658;50360;19286;74946;31944;125306
120042;201401;2742;12074;2651;11848;435;2030;1852;8477;2287;10507
120043;201401;840;4036;816;3980;70;343;683;3402;753;3745
120045;201401;4398;15500;4353;15426;1103;3898;2883;10539;3986;14437
120050;201401;8132;33786;7896;33298;1540;6293;5164;23143;6704;29436
120060;201401;6533;31207;6438;31031;805;3913;5118;25395;5923;29308
120070;201401;2761;10594;2713;10470;590;2171;1716;6983;2306;9154
120080;201401;3686;14016;3544;13781;629;2489;2516;10110;3145;12599
130002;201401;2844;12154;2692;11898;286;1294;2121;9554;2407;10848
130006;201401;1686;7333;1524;7033;191;971;1104;5164;1295;6135
130008;201401;1968;8128;1890;7983;181;836;1504;6484;1685;7320
130010;201401;2717;9198;2364;8786;250;848;1941;7438;2191;8286
130014;201401;3445;11216;2997;10557;469;1791;1976;7060;2445;8851
130020;201401;2443;8639;2431;8625;51;191;2355;8363;2406;8554
130030;201401;6875;27267;6691;27025;580;1985;5758;23995;6338;25980
130040;201401;3641;11573;3447;11300;354;1237;2860;9414;3214;10651
130050;201401;5830;23620;5182;22600;768;3175;3576;16792;4344;19967
130060;201401;5903;25776;5570;25305;636;2821;4485;20899;5121;23720
130063;201401;3213;14358;3193;14317;377;1633;2648;12159;3025;13792
130068;201401;2996;12692;2794;12310;356;1735;2003;8884;2359;10619
130070;201401;6484;22107;5964;21432;716;2521;4665;17240;5381;19761
130080;201401;5029;22448;4873;22229;842;3976;3466;16301;4308;20277
130083;201401;1775;7494;1702;7373;307;1485;1159;5018;1466;6503
130090;201401;2414;8881;2307;8735;196;869;1956;7386;2152;8255
130100;201401;5376;20877;5180;20612;461;1984;4337;17462;4798;19446
130110;201401;6549;21413;6155;20939;811;2637;4856;17114;5667;19751
130115;201401;3644;13659;3488;13454;133;397;3267;12777;3400;13174
130120;201401;13016;50925;12737;50537;1224;4481;10735;43954;11959;48435
130130;201401;3310;14420;3221;14257;477;2075;2450;11164;2927;13239
130140;201401;5707;23182;5667;23130;140;419;5474;22596;5614;23015
130150;201401;3495;13057;3421;12962;222;1044;2994;11316;3216;12360
130160;201401;3856;16064;3795;15978;247;902;3446;14734;3693;15636
130165;201401;2734;11342;2697;11279;475;1991;2067;8788;2542;10779
130170;201401;8518;32053;7509;30759;1451;6051;4999;21485;6450;27536
130180;201401;3317;10617;3254;10532;119;359;3031;9873;3150;10232
130185;201401;8878;32038;8590;31659;1589;5617;6262;24079;7851;29696
130190;201401;16386;58339;14595;56098;3152;11757;9201;37712;12353;49469
130195;201401;1758;7409;1703;7326;97;451;1500;6533;1597;6984
130200;201401;1969;7212;1838;6990;352;1396;1206;4678;1558;6074
130210;201401;1126;4502;1071;4408;168;671;799;3419;967;4090
130220;201401;2011;8337;1856;8056;367;1785;1083;4755;1450;6540
130230;201401;3302;15096;3148;14840;413;2068;2317;11308;2730;13376
130240;201401;8130;31934;7533;31050;520;2420;6365;26675;6885;29095
130250;201401;17089;63213;16592;62499;3028;10929;11905;47009;14933;57938
130255;201401;3910;14352;3714;14021;187;600;3283;12776;3470;13376
130260;201401;245285;803404;223813;769957;63388;223529;114899;410971;178287;634500
130270;201401;7248;30451;6568;29392;1133;4938;4601;21676;5734;26614
130280;201401;3157;12466;3092;12371;149;490;2779;11420;2928;11910
130290;201401;10614;38662;10448;38423;236;681;9854;36845;10090;37526
130300;201401;4324;16999;4092;16669;348;1536;3349;13853;3697;15389
130310;201401;4813;18524;4405;18013;666;2639;3257;13831;3923;16470
130320;201401;2837;9863;2608;9555;378;1452;1858;6975;2236;8427
130330;201401;3447;12928;3097;12453;243;1032;2582;10594;2825;11626
130340;201401;16835;66282;16337;65474;3175;12011;10887;46667;14062;58678
130350;201401;3197;13063;3074;12918;351;1372;2470;10753;2821;12125
130353;201401;5535;17810;4931;16977;1337;4599;2727;10015;4064;14614
130356;201401;4178;15380;4035;15170;488;1702;3203;12603;3691;14305
130360;201401;2755;8008;2482;7692;51;108;2322;7392;2373;7500
130370;201401;4857;19343;4173;18436;267;1458;3486;15500;3753;16958
130380;201401;6703;28404;6482;28069;438;2052;5564;24356;6002;26408
130390;201401;4411;19940;4154;19503;486;2313;3219;15600;3705;17913
130395;201401;2007;7459;1853;7183;305;1327;1197;4635;1502;5962
130400;201401;2137;7834;2078;7751;96;376;1877;7091;1973;7467
130406;201401;9389;36163;8413;34644;2112;8471;4732;20972;6844;29443
130410;201401;4078;15680;3773;15117;916;3793;2098;8774;3014;12567
130420;201401;9825;42225;9520;41613;2922;12521;5195;24123;8117;36644
130423;201401;3045;12051;2893;11850;238;1141;2450;10063;2688;11204
130426;201401;1984;8626;1910;8496;344;1525;1316;6139;1660;7664
130430;201401;3410;12390;3245;12164;397;1637;2349;9000;2746;10637
130440;201401;3735;13672;3453;13367;212;709;3054;12209;3266;12918
140002;201401;1421;4807;1344;4694;188;633;947;3483;1135;4116
140005;201401;2575;8014;2412;7835;137;409;2171;7163;2308;7572
140010;201401;43994;144924;40134;138620;9531;35134;22468;79523;31999;114657
140015;201401;2800;9384;2709;9262;260;610;2296;8252;2556;8862
140017;201401;2834;9075;2705;8914;212;642;2307;7789;2519;8431
140020;201401;4229;14564;3965;14215;500;1725;3020;11232;3520;12957
140023;201401;1928;6818;1758;6537;267;1065;1179;4502;1446;5567
140028;201401;2109;5969;2052;5902;110;252;1855;5480;1965;5732
140030;201401;3498;11402;3358;11224;405;1018;2803;9871;3208;10889
140040;201401;1472;7129;1424;6990;131;723;1055;5296;1186;6019
140045;201401;2362;8668;2234;8491;308;1010;1709;6953;2017;7963
140047;201401;5105;14560;4705;14014;1567;4883;1893;6103;3460;10986
140050;201401;1471;4586;1376;4458;177;584;1038;3444;1215;4028
140060;201401;1378;4431;1267;4281;337;1182;730;2563;1067;3745
140070;201401;1416;6993;1414;6988;58;235;1342;6710;1400;6945
150010;201401;32069;105457;30830;103818;2294;8175;26137;89219;28431;97394
150013;201401;1529;4845;1482;4793;140;507;1214;3924;1354;4431
150020;201401;10641;37787;10409;37447;1442;5185;8102;29839;9544;35024
150030;201401;6235;27473;6083;27220;678;2574;5004;23434;5682;26008
150034;201401;4342;11929;4123;11666;150;338;3903;11206;4053;11544
150040;201401;12072;42482;10681;40750;2383;8350;6927;28658;9310;37008
150050;201401;5961;23010;5833;22773;647;2737;4663;18388;5310;21125
150060;201401;14820;49437;14084;48351;3581;12085;8439;30337;12020;42422
150070;201401;5274;22739;4889;22278;536;2476;4001;18609;4537;21085
150080;201401;59229;164216;53098;156573;7715;21192;38645;117963;46360;139155
150085;201401;5003;17940;4798;17646;729;2340;3701;14330;4430;16670
150090;201401;9787;38353;9271;37643;1221;4720;7208;30212;8429;34932
150095;201401;5042;17705;4700;17179;551;2015;3675;13828;4226;15843
150100;201401;3410;13018;3214;12732;284;1345;2594;10214;2878;11559
150110;201401;3120;15045;3109;15017;162;672;2874;14083;3036;14755
150120;201401;5832;23246;5713;23020;1031;4014;4174;17240;5205;21254
150125;201401;790;2468;733;2382;168;574;438;1427;606;2001
150130;201401;19486;63276;18642;62053;1797;6004;15103;51060;16900;57064
150140;201401;140699;429341;136037;423571;18544;57737;107263;339219;125807;396956
150145;201401;4836;15386;4494;14953;690;2420;3245;10970;3935;13390
150150;201401;9264;30977;8738;30150;1903;6813;5540;19412;7443;26225
150157;201401;2815;9054;2573;8720;415;1452;1927;6606;2342;8058
150160;201401;2750;9483;2637;9320;703;2393;1571;5848;2274;8241
150170;201401;21705;81122;20665;79775;3884;14705;14790;58355;18674;73060
150172;201401;2949;10365;2680;9965;346;1315;2114;8011;2460;9326
150175;201401;1989;6348;1928;6276;149;452;1687;5620;1836;6072
150178;201401;10631;33724;9272;32137;548;1649;8288;29458;8836;31107
150180;201401;17390;71146;16895;70471;1654;7234;14048;59486;15702;66720
150190;201401;7083;22947;6724;22463;440;1058;5866;20450;6306;21508
150195;201401;4508;16162;4240;15707;484;1805;3341;12589;3825;14394
150200;201401;4930;16307;4808;16160;143;431;4508;15340;4651;15771
150210;201401;21951;85177;21659;84760;2280;8475;18242;72877;20522;81352
150215;201401;5770;18785;5300;18108;1333;4685;3027;10657;4360;15342
150220;201401;12381;40307;11417;38793;2826;9850;6203;21769;9029;31619
150230;201401;11012;38260;10049;36901;859;3834;8272;30172;9131;34006
150240;201401;32989;102620;30318;98151;9248;31282;13456;45017;22704;76299
150250;201401;3878;15830;3760;15652;717;2844;2645;11602;3362;14446
150260;201401;1921;8018;1849;7882;395;1800;1112;4851;1507;6651
150270;201401;9475;29192;7423;26642;1713;6543;4522;16590;6235;23133
150275;201401;5673;21076;5395;20622;872;3394;3878;15170;4750;18564
150276;201401;2077;6327;1944;6158;324;1080;1467;4670;1791;5750
150277;201401;5022;15967;4426;15269;540;1903;3489;12327;4029;14230
150280;201401;5747;25348;5614;25055;855;3748;4188;19217;5043;22965
150285;201401;2599;10642;2572;10583;274;1127;2124;8866;2398;9993
150290;201401;8469;27058;8274;26819;860;2524;6813;22897;7673;25421
150293;201401;8176;26187;7132;24585;2452;8761;3091;11204;5543;19965
150295;201401;5608;19434;4997;18649;1197;4596;3127;12037;4324;16633
150300;201401;1781;6351;1743;6303;125;425;1462;5461;1587;5886
150304;201401;4065;12869;3545;12165;524;1824;2548;9033;3072;10857
150307;201401;6467;22582;6047;21989;487;1707;5020;18828;5507;20535
150309;201401;6358;23126;5947;22559;1631;6153;3636;14456;5267;20609
150310;201401;4899;23115;4825;22996;549;2458;3932;19352;4481;21810
150320;201401;8456;23088;8130;22736;582;1507;7085;20267;7667;21774
150330;201401;12928;47816;12341;46874;1572;5979;9538;37191;11110;43170
150340;201401;2104;7350;1994;7190;395;1520;1308;4772;1703;6292
150345;201401;6344;22713;5958;22190;698;2616;4796;18297;5494;20913
150350;201401;7177;24353;6852;23886;1005;3438;5064;18064;6069;21502
150360;201401;20533;66232;18150;63245;2889;10315;12804;46108;15693;56423
150370;201401;9827;37586;9466;37104;1154;4162;7700;31331;8854;35493
150375;201401;2710;11577;2658;11508;212;713;2302;10439;2514;11152
150380;201401;9198;29124;8406;28033;899;3183;6904;23154;7803;26337
150390;201401;8005;34804;7669;34127;1869;7870;4610;21777;6479;29647
150400;201401;5243;22240;5102;21945;647;2711;3783;16845;4430;19556
150405;201401;8074;25624;7372;24747;1491;4557;5010;17956;6501;22513
150410;201401;1673;6540;1645;6493;325;1339;1036;4214;1361;5553
150420;201401;32739;119601;29928;115040;7882;31904;15911;63582;23793;95486
150430;201401;6419;24213;6233;23887;800;3330;4772;18444;5572;21774
150440;201401;5258;18640;5155;18485;812;2856;3824;14042;4636;16898
150442;201401;21085;61982;19449;59902;3353;10545;13278;42153;16631;52698
150445;201401;5002;18070;4642;17559;715;2548;3518;13751;4233;16299
150450;201401;4168;20100;4039;19932;418;2032;3361;16966;3779;18998
150460;201401;6742;24930;5654;23770;471;2100;4862;20903;5333;23003
150470;201401;16799;52438;16279;51782;1375;3645;14154;46395;15529;50040
150475;201401;542;1745;466;1642;164;540;218;879;382;1419
150480;201401;13866;47995;13402;47323;987;3233;11420;41484;12407;44717
150490;201401;6334;24844;6222;24697;351;1398;5625;22561;5976;23959
150495;201401;4562;17066;4473;16920;333;1285;3921;14934;4254;16219
150497;201401;3242;11435;2981;11003;874;3259;1650;6354;2524;9613
150500;201401;2852;8562;2749;8406;418;1244;2042;6325;2460;7569
150503;201401;3729;11964;3216;11311;1196;4426;1386;5101;2582;9527
150506;201401;12252;44017;11343;42748;2792;9575;7298;29661;10090;39236
150510;201401;9546;38092;9015;37181;1489;6196;6280;27069;7769;33265
150520;201401;6006;25067;5919;24943;494;1665;5223;22650;5717;24315
150530;201401;11276;41161;10366;39807;1481;5162;7621;30569;9102;35731
150540;201401;4567;14348;4190;13794;361;1236;3459;11419;3820;12655
150543;201401;4721;15373;4386;14895;1359;4675;2451;8560;3810;13235
150548;201401;8028;26481;7591;25923;670;2133;6491;22682;7161;24815
150549;201401;2162;6986;2065;6871;111;278;1862;6365;1973;6643
150550;201401;20688;67139;18647;63670;5643;19997;8533;29859;14176;49856
150553;201401;21668;80377;19675;75611;7871;32427;3606;13690;11477;46117
150555;201401;1659;5314;1469;5044;243;904;1020;3549;1263;4453
150560;201401;1979;6483;1915;6342;246;883;1424;4701;1670;5584
150563;201401;2812;9512;2644;9218;617;2303;1560;5448;2177;7751
150565;201401;3344;12209;3152;11928;265;1103;2540;9787;2805;10890
150570;201401;5103;19995;5031;19872;423;1602;4219;17140;4642;18742
150580;201401;9255;38402;9106;38212;822;2972;7844;34120;8666;37092
150590;201401;5335;21796;5213;21653;121;504;4950;20719;5071;21223
150600;201401;7386;29554;7242;29309;616;2286;6207;25842;6823;28128
150610;201401;2406;8397;2241;8058;278;1161;1547;5472;1825;6633
150611;201401;2600;9675;2494;9432;315;1244;1790;6858;2105;8102
150613;201401;11086;35224;9837;33479;3350;11724;4528;16284;7878;28008
150616;201401;3019;8841;2414;8119;576;1926;1495;5185;2071;7111
150618;201401;7342;26176;7072;25667;2317;8814;3405;12635;5722;21449
150619;201401;5108;18050;4827;17637;727;2811;3443;12779;4170;15590
150620;201401;5978;22167;5475;21515;824;3238;4110;16781;4934;20019
150630;201401;5221;16807;5025;16562;448;1471;4204;14112;4652;15583
150635;201401;4410;14750;4169;14293;817;2892;2565;9134;3382;12026
150640;201401;1396;4596;1383;4575;43;120;1303;4370;1346;4490
150650;201401;11807;37316;10862;35644;2975;10204;5493;18393;8468;28597
150655;201401;5272;17781;4874;17202;730;2674;3603;12897;4333;15571
150658;201401;3979;13475;3789;13175;388;1622;2940;10154;3328;11776
150660;201401;5553;17966;5107;17403;1397;4714;2938;10449;4335;15163
150670;201401;6066;18128;5323;17238;1768;5789;2765;9581;4533;15370
150680;201401;49414;198268;46790;193433;16457;68052;20841;92815;37298;160867
150690;201401;1772;5954;1661;5750;278;990;1075;3829;1353;4819
150700;201401;5697;18267;5390;17869;1127;3732;3609;12276;4736;16008
150710;201401;4051;13229;3719;12714;403;1181;3013;10665;3416;11846
150715;201401;4883;16263;4426;15609;647;2364;3354;12034;4001;14398
150720;201401;6320;26446;6036;25943;1004;4068;4301;19456;5305;23524
150730;201401;8910;31432;8431;30792;1146;4081;6770;25344;7916;29425
150740;201401;3613;11801;3335;11319;491;1766;2253;7805;2744;9571
150745;201401;5862;18741;5470;18218;980;3455;3889;13080;4869;16535
150746;201401;1381;4621;1324;4522;200;752;882;3058;1082;3810
150747;201401;4866;16391;4541;15971;448;1482;3642;13318;4090;14800
150750;201401;2593;9240;2538;9177;111;249;2389;8837;2500;9086
150760;201401;11178;36985;10701;36343;2786;9435;6337;22395;9123;31830
150770;201401;5514;21154;5361;20932;907;3307;3964;16460;4871;19767
150775;201401;1110;3597;1006;3398;202;828;600;1933;802;2761
150780;201401;2994;10252;2972;10228;91;222;2809;9836;2900;10058
150790;201401;4858;15925;4594;15599;352;998;3912;13798;4264;14796
150795;201401;14656;46538;13434;44740;2290;7345;9451;32751;11741;40096
150796;201401;2756;8663;2668;8549;418;1263;2011;6729;2429;7992
150797;201401;3715;12653;3567;12433;170;631;3158;11111;3328;11742
150800;201401;13881;47153;12754;45765;3200;10980;8052;30729;11252;41709
150803;201401;6699;24624;6414;24221;911;3576;4685;18196;5596;21772
150805;201401;2663;9475;2489;9229;372;1314;1809;6950;2181;8264
150808;201401;5761;20119;5027;18766;2172;8573;1164;4539;3336;13112
150810;201401;19071;61238;16276;57850;2735;9339;11406;42892;14141;52231
150812;201401;5209;16423;4831;15899;478;1971;3700;11864;4178;13835
150815;201401;8670;28057;7872;27077;1255;4079;5938;21238;7193;25317
150820;201401;10371;31089;9523;30169;599;1251;8528;28006;9127;29257
150830;201401;12297;48072;11772;47227;809;3380;9635;39960;10444;43340
150835;201401;1939;7267;1810;6975;531;2159;801;3110;1332;5269
150840;201401;7251;21387;5886;19544;1474;5473;3088;10016;4562;15489
160005;201401;690;2671;657;2606;123;568;393;1538;516;2106
160010;201401;1531;5307;1520;5295;159;428;1304;4732;1463;5160
160015;201401;1509;5743;1479;5690;258;947;1058;4296;1316;5243
160020;201401;2275;7691;2127;7488;317;1149;1522;5511;1839;6660
160021;201401;804;3547;784;3514;146;698;535;2471;681;3169
160023;201401;964;3803;948;3777;88;309;821;3348;909;3657
160025;201401;1232;3581;1199;3546;22;73;1156;3422;1178;3495
160027;201401;7934;25009;7489;24501;2567;8507;3781;13061;6348;21568
160030;201401;39119;146848;36520;141251;8697;33407;22626;90428;31323;123835
160040;201401;3802;15267;3737;15168;187;818;3395;13838;3582;14656
160050;201401;3371;12761;3064;12311;1106;4322;1463;6400;2569;10722
160053;201401;2329;9545;2298;9505;621;2613;1421;6028;2042;8641
160055;201401;759;2995;745;2977;143;629;524;2106;667;2735
160060;201401;17339;58794;16366;57703;4812;16105;9805;36849;14617;52954
160070;201401;1984;8524;1961;8481;215;910;1645;7258;1860;8168
160080;201401;2614;9854;2602;9832;124;412;2423;9286;2547;9698
170025;201401;565;1956;518;1881;185;701;224;851;409;1552
170030;201401;1193;3972;1091;3783;313;1153;465;1631;778;2784
170035;201401;1521;4654;1270;4179;445;1601;387;1307;832;2908
170040;201401;1762;5970;1578;5698;292;1222;993;3580;1285;4802
170070;201401;2072;5718;1717;5276;494;1660;848;2640;1342;4300
170100;201401;2498;7046;2216;6551;343;1128;1603;4706;1946;5834
170105;201401;729;2428;625;2226;132;589;329;1126;461;1715
170110;201401;1200;3733;1056;3502;227;777;609;2037;836;2814
170130;201401;1394;4474;1240;4256;196;680;845;3019;1041;3699
170190;201401;1663;4856;1370;4433;636;2077;336;1232;972;3309
170200;201401;1459;4566;1154;4017;317;1226;370;1243;687;2469
170210;201401;28244;88897;24730;82791;9113;32993;7482;25789;16595;58782
170215;201401;1156;3728;1046;3561;138;500;786;2712;924;3212
170220;201401;6439;21605;5966;20868;935;3459;4043;14519;4978;17978
170230;201401;1459;4943;1289;4630;340;1393;597;2092;937;3485
170240;201401;2963;8495;2402;7764;341;1225;1614;5264;1955;6489
170255;201401;3627;11766;3114;10949;1066;3766;1271;4793;2337;8559
170270;201401;1045;2725;762;2341;151;491;459;1417;610;1908
170290;201401;2927;8978;2601;8584;203;597;2173;7493;2376;8090
170300;201401;2026;6519;1795;6135;301;1146;1174;4034;1475;5180
170305;201401;741;2328;618;2105;126;483;347;1173;473;1656
170307;201401;1067;3799;933;3563;251;986;415;1730;666;2716
170310;201401;1667;4637;1342;4120;372;1200;575;1851;947;3051
170320;201401;989;2931;808;2627;221;736;373;1264;594;2000
170330;201401;830;2539;701;2380;133;467;454;1548;587;2015
170360;201401;454;1615;433;1580;94;366;204;729;298;1095
170370;201401;1368;4142;1164;3849;194;758;700;2306;894;3064
170380;201401;2117;6782;1748;6239;416;1705;912;3196;1328;4901
170382;201401;556;1882;491;1780;100;393;317;1145;417;1538
170384;201401;1523;6390;1453;6272;371;1631;882;3933;1253;5564
170386;201401;903;2739;767;2541;203;757;325;1091;528;1848
170388;201401;653;1976;568;1832;122;465;221;697;343;1162
170389;201401;917;3167;859;3082;100;439;642;2269;742;2708
170390;201401;1327;3989;1160;3777;183;635;839;2802;1022;3437
170410;201401;471;1566;446;1520;67;254;297;1019;364;1273
170460;201401;520;1441;394;1236;107;370;131;411;238;781
170510;201401;755;2633;649;2466;126;550;338;1286;464;1836
170550;201401;5486;17377;4590;15761;1799;6643;1250;4401;3049;11044
170555;201401;1355;4026;1122;3677;290;1045;583;1906;873;2951
170560;201401;980;3386;826;3207;168;674;548;2213;716;2887
170600;201401;1291;3756;1158;3598;75;257;959;3038;1034;3295
170610;201401;1630;4991;1297;4461;196;757;764;2660;960;3417
170625;201401;431;1360;348;1196;91;325;93;322;184;647
170650;201401;1220;4038;1113;3840;283;1065;558;1935;841;3000
170700;201401;3934;13238;3335;12267;840;3414;1560;5957;2400;9371
170710;201401;1729;5202;1454;4775;210;820;973;3182;1183;4002
170720;201401;1831;4948;1597;4591;298;867;1069;3132;1367;3999
170730;201401;1114;3237;926;2957;289;1037;404;1279;693;2316
170740;201401;2211;7938;1972;7523;324;1343;1311;5036;1635;6379
170755;201401;877;2804;752;2541;204;736;290;959;494;1695
170765;201401;1569;4291;1278;3823;337;1111;533;1632;870;2743
170770;201401;1800;6315;1691;6112;392;1475;975;3643;1367;5118
170820;201401;4151;13385;3764;12788;1101;3981;1549;5388;2650;9369
170825;201401;759;2344;591;2027;140;530;242;831;382;1361
170830;201401;1328;3992;1255;3881;45;94;1170;3669;1215;3763
170900;201401;2825;10126;2724;9940;346;1281;2027;7646;2373;8927
170930;201401;4224;13030;3493;11988;1368;4937;1130;3880;2498;8817
170950;201401;12549;37304;9845;32810;3911;14651;2168;6821;6079;21472
170980;201401;500;1536;415;1405;113;427;210;699;323;1126
171050;201401;1277;4628;1214;4511;59;271;1074;3946;1133;4217
171070;201401;1698;5451;1575;5289;336;1184;970;3351;1306;4535
171090;201401;942;2766;801;2545;138;457;534;1717;672;2174
171110;201401;644;1904;532;1736;168;602;277;868;445;1470
171150;201401;854;2572;650;2196;124;455;358;1221;482;1676
171180;201401;627;1985;492;1711;129;491;188;688;317;1179
171190;201401;1880;6840;1634;6340;391;1615;778;3150;1169;4765
171195;201401;862;3156;788;3021;106;441;501;1995;607;2436
171200;201401;695;2284;577;2067;150;621;265;902;415;1523
171215;201401;464;1412;369;1246;69;264;160;553;229;817
171240;201401;833;2813;781;2728;84;248;613;2247;697;2495
171245;201401;665;2212;566;1986;122;473;242;842;364;1315
171250;201401;1159;3361;1037;3218;64;201;882;2782;946;2983
171270;201401;418;1734;392;1679;106;432;184;864;290;1296
171280;201401;910;2863;808;2688;194;624;403;1496;597;2120
171320;201401;4046;12506;3501;11702;1136;4002;1613;5406;2749;9408
171330;201401;2794;8550;2485;8097;648;2275;1333;4375;1981;6650
171360;201401;1504;4922;1286;4594;309;1135;694;2555;1003;3690
171370;201401;720;2056;648;1943;144;516;341;968;485;1484
171380;201401;1307;4465;1143;4138;342;1251;512;1921;854;3172
171395;201401;887;2782;750;2536;156;611;375;1259;531;1870
171420;201401;2277;7027;1857;6277;492;1817;779;2639;1271;4456
171430;201401;1036;3291;926;3130;209;726;557;1903;766;2629
171488;201401;2459;7650;2268;7378;586;1894;1209;4148;1795;6042
171500;201401;885;2753;789;2570;136;406;442;1494;578;1900
171510;201401;911;3300;830;3177;163;652;507;2036;670;2688
171515;201401;621;1804;493;1620;113;379;235;786;348;1165
171525;201401;595;2014;507;1851;103;424;272;977;375;1401
171550;201401;344;1167;298;1076;122;501;46;169;168;670
171570;201401;1231;3907;1097;3698;254;866;660;2301;914;3167
171575;201401;1948;5676;1562;4972;414;1357;670;2248;1084;3605
171610;201401;6149;21259;5656;20330;1925;7378;1914;6893;3839;14271
171620;201401;2289;7273;2096;6982;196;722;1688;5672;1884;6394
171630;201401;901;3019;754;2761;186;747;314;1147;500;1894
171650;201401;2405;7602;2018;6920;549;2036;839;2833;1388;4869
171660;201401;2621;7366;2111;6470;461;1507;1102;3447;1563;4954
171665;201401;1389;4308;1195;3991;221;821;734;2503;955;3324
171670;201401;2349;6414;1932;5865;452;1485;1098;3273;1550;4758
171700;201401;1114;3747;1015;3576;165;645;634;2252;799;2897
171720;201401;689;2206;608;2056;207;742;250;860;457;1602
171750;201401;1252;4151;1122;3901;395;1447;382;1356;777;2803
171780;201401;1171;3364;877;2944;156;594;496;1640;652;2234
171790;201401;1727;5584;1419;5148;291;1076;838;3192;1129;4268
171800;201401;710;2307;658;2233;97;370;445;1514;542;1884
171820;201401;9591;30097;8835;29161;2200;7863;4960;16606;7160;24469
171830;201401;1625;5980;1503;5716;376;1520;688;2639;1064;4159
171840;201401;768;2283;689;2174;65;222;522;1655;587;1877
171845;201401;808;2215;638;1930;91;325;368;1083;459;1408
171850;201401;1019;3698;916;3479;108;476;592;2250;700;2726
171855;201401;1248;4012;1137;3829;120;499;854;2810;974;3309
171865;201401;485;1575;411;1466;105;414;202;704;307;1118
171870;201401;661;2149;554;1959;127;475;249;921;376;1396
171875;201401;1371;4397;1164;4081;169;674;826;2884;995;3558
171880;201401;991;3550;974;3522;123;472;725;2706;848;3178
171884;201401;896;2603;667;2261;155;591;258;895;413;1486
171886;201401;1476;5073;1326;4756;445;1683;444;1644;889;3327
171888;201401;671;2094;579;1924;106;365;341;1177;447;1542
171889;201401;477;1610;458;1569;105;343;268;963;373;1306
171890;201401;1110;3729;1006;3577;139;589;674;2382;813;2971
171900;201401;434;1741;414;1693;100;400;223;944;323;1344
172000;201401;662;2149;568;2014;96;404;335;1157;431;1561
172010;201401;1168;4047;1114;3956;109;436;878;3143;987;3579
172015;201401;352;1339;307;1268;56;226;182;804;238;1030
172020;201401;2315;7732;2094;7410;310;1207;1480;5309;1790;6516
172025;201401;734;2187;603;1957;106;382;342;1104;448;1486
172030;201401;1084;3750;993;3583;167;699;633;2287;800;2986
172049;201401;1115;3204;1047;3109;143;414;775;2370;918;2784
172065;201401;1218;3644;1026;3399;131;491;806;2663;937;3154
172080;201401;2640;8139;2259;7495;296;1142;1495;4882;1791;6024
172085;201401;503;1395;389;1190;83;276;119;362;202;638
172090;201401;3441;10425;2700;9456;560;2133;1611;5790;2171;7923
172093;201401;575;1881;453;1664;187;785;167;584;354;1369
172097;201401;689;2044;577;1859;166;586;203;632;369;1218
172100;201401;25678;88945;23027;83561;8044;31971;6227;22562;14271;54533
172110;201401;1686;6179;1561;5999;151;557;1232;4898;1383;5455
172120;201401;5510;16626;4607;15487;496;1766;3490;11982;3986;13748
172125;201401;321;992;265;912;59;228;122;430;181;658
172130;201401;516;1508;456;1417;72;240;298;964;370;1204
172208;201401;2160;6767;2034;6561;444;1545;1106;3615;1550;5160
172210;201401;2280;6952;2154;6782;203;706;1783;5597;1986;6303
210005;201401;21538;70913;19463;67661;6246;23058;9246;32611;15492;55669
210010;201401;1623;5786;1466;5578;175;640;1113;4402;1288;5042
210015;201401;3506;11005;3242;10629;238;481;2752;9580;2990;10061
210020;201401;7183;18256;6762;17750;481;1412;5514;14687;5995;16099
210030;201401;5862;19746;5570;19349;452;1873;4636;16039;5088;17912
210040;201401;1942;5676;1771;5470;191;612;1366;4271;1557;4883
210043;201401;5890;18249;5542;17722;516;1639;4460;14599;4976;16238
210047;201401;6704;26437;6275;25685;918;4107;4271;17663;5189;21770
210050;201401;2486;8872;2000;8180;471;1912;1033;4496;1504;6408
210055;201401;1658;5735;1556;5597;204;695;1187;4367;1391;5062
210060;201401;7896;29323;7152;28156;803;3515;5274;21217;6077;24732
210070;201401;6817;20570;6460;20130;311;1061;5717;17937;6028;18998
210080;201401;3700;12821;3634;12726;87;342;3405;11974;3492;12316
210083;201401;3792;13525;3678;13389;189;692;3341;12313;3530;13005
210087;201401;2525;8010;2397;7855;200;708;2052;6756;2252;7464
210090;201401;9777;32663;9438;32107;500;1923;8190;27977;8690;29900
210095;201401;6129;23717;6007;23516;770;2954;4776;19176;5546;22130
210100;201401;7527;22584;7112;22102;324;1204;6331;19648;6655;20852
210110;201401;3174;11039;3090;10932;201;760;2604;9403;2805;10163
210120;201401;25132;74611;21616;70294;2322;8045;16503;54681;18825;62726
210125;201401;3361;11222;3238;11088;214;682;2867;10012;3081;10694
210130;201401;3768;11662;3638;11490;390;1202;2915;9338;3305;10540
210135;201401;1649;4884;1470;4624;126;399;1206;3864;1332;4263
210140;201401;17057;55281;14577;52045;3303;12121;8936;33246;12239;45367
210150;201401;4567;11758;4201;11305;149;396;3829;10314;3978;10710
210160;201401;18336;60564;17223;58929;2702;8799;12866;45620;15568;54419
210170;201401;13965;52129;13768;51855;1021;3463;12037;46379;13058;49842
210173;201401;1769;7665;1722;7568;142;656;1482;6571;1624;7227
210177;201401;2930;9664;2781;9475;328;1263;2187;7386;2515;8649
210180;201401;1461;4629;1394;4529;98;345;1178;3833;1276;4178
210190;201401;5079;16505;4796;16028;381;1696;3633;11846;4014;13542
210193;201401;1429;4599;1331;4432;91;356;1078;3631;1169;3987
210197;201401;1799;6351;1704;6247;116;475;1474;5463;1590;5938
210200;201401;9174;31151;8508;30196;1255;4220;6160;22902;7415;27122
210203;201401;6176;21145;5833;20713;499;1620;4983;18081;5482;19701
210207;201401;2952;10075;2806;9820;403;1381;2048;7376;2451;8757
210210;201401;8776;29857;8439;29389;311;1166;7399;26318;7710;27484
210215;201401;1724;6895;1676;6812;184;830;1340;5477;1524;6307
210220;201401;6184;24196;5992;23881;507;2012;4863;19932;5370;21944
210230;201401;5333;18274;4974;17709;456;1686;3978;14347;4434;16033
210232;201401;12061;42767;10945;41332;2261;8539;7229;28953;9490;37492
210235;201401;3461;10925;3147;10534;240;837;2657;8975;2897;9812
210237;201401;2531;9253;2504;9218;49;122;2414;9004;2463;9126
210240;201401;2971;9460;2855;9288;288;816;2283;7665;2571;8481
210250;201401;5007;15750;4812;15509;152;556;4460;14433;4612;14989
210255;201401;2721;8971;2505;8601;590;2196;1489;5167;2079;7363
210260;201401;5218;16838;4836;16284;666;2205;3608;12438;4274;14643
210270;201401;5243;15134;4733;14449;187;626;4197;12942;4384;13568
210275;201401;3479;8953;3271;8730;134;287;3069;8301;3203;8588
210280;201401;5939;17540;5201;16614;366;1244;4402;14246;4768;15490
210290;201401;5816;18696;5379;18158;519;1721;4402;15201;4921;16922
210300;201401;36030;111230;30899;104567;3230;11769;24273;83837;27503;95606
210310;201401;2846;8297;2720;8108;128;383;2385;7144;2513;7527
210312;201401;2149;7011;2113;6953;138;542;1860;6099;1998;6641
210315;201401;2320;8407;2234;8278;140;587;1904;7109;2044;7696
210317;201401;4284;12860;4108;12633;325;992;3506;10948;3831;11940
210320;201401;19440;61787;18296;60418;1226;4019;15927;53621;17153;57640
210325;201401;3571;11489;3230;10977;346;1293;2514;8598;2860;9891
210330;201401;31896;86747;27517;81956;3839;10089;20253;65454;24092;75543
210340;201401;11914;37540;10973;36394;1407;4052;8266;29276;9673;33328
210350;201401;10363;32925;9687;31986;793;2735;7844;26369;8637;29104
210355;201401;3950;14262;3644;13882;138;360;3346;13150;3484;13510
210360;201401;16494;51505;15590;50218;1452;4851;12344;40506;13796;45357
210370;201401;7997;21604;7239;20797;381;927;6409;18878;6790;19805
210375;201401;3242;10030;2833;9549;474;1745;2051;7014;2525;8759
210380;201401;6230;18400;5641;17542;666;1873;4457;14303;5123;16176
210390;201401;2738;9823;2552;9517;113;514;2261;8463;2374;8977
210400;201401;4850;15694;4684;15489;366;1132;4040;13610;4406;14742
210405;201401;8641;24410;7126;22351;2178;6920;3220;10983;5398;17903
210407;201401;2083;7382;1883;7071;198;696;1455;5716;1653;6412
210408;201401;2122;8662;2030;8551;76;305;1859;8031;1935;8336
210409;201401;3872;14145;3693;13870;291;1124;2967;11449;3258;12573
210410;201401;3540;11521;3322;11250;354;1152;2739;9487;3093;10639
210420;201401;4157;13979;3906;13536;364;1265;3138;11102;3502;12367
210430;201401;2007;6511;1968;6462;168;570;1660;5503;1828;6073
210440;201401;4225;13376;4134;13236;212;703;3694;11933;3906;12636
210450;201401;2868;9178;2636;8824;239;869;2121;7098;2360;7967
210455;201401;4169;12640;3614;11806;760;2527;2221;7517;2981;10044
210460;201401;4064;13169;3845;12884;207;799;3317;11212;3524;12011
210462;201401;1768;6430;1711;6323;181;697;1304;4932;1485;5629
210465;201401;2709;8941;2563;8756;390;1148;1986;7121;2376;8269
210467;201401;6148;20824;5771;20352;483;1523;4806;17610;5289;19133
210470;201401;1844;5432;1568;5029;101;377;1250;4040;1351;4417
210480;201401;13440;45737;12022;43813;3805;13868;5981;23528;9786;37396
210490;201401;3402;10447;3184;10125;361;1219;2477;7908;2838;9127
210500;201401;6720;26530;6462;26083;727;2870;5022;21055;5749;23925
210510;201401;6840;22849;6634;22620;339;743;5912;21118;6251;21861
210515;201401;3436;11288;3360;11194;187;556;3040;10296;3227;10852
210520;201401;2699;8598;2544;8386;221;751;2082;6985;2303;7736
210530;201401;39496;133014;34707;125640;11350;44180;16902;62373;28252;106553
210535;201401;3106;11073;3036;10945;163;602;2676;9750;2839;10352
210540;201401;12393;43940;11136;41909;2810;10563;5812;23758;8622;34321
210542;201401;6408;18766;5627;17914;333;957;4959;16210;5292;17167
210545;201401;2199;7529;2108;7381;88;404;1824;6385;1912;6789
210547;201401;3613;13068;3424;12770;238;936;2824;10699;3062;11635
210550;201401;6297;18012;5496;17119;314;764;4945;15839;5259;16603
210560;201401;3931;12853;3632;12390;255;1018;3026;10308;3281;11326
210565;201401;1541;5320;1341;5024;134;621;988;3690;1122;4311
210570;201401;12622;36630;11545;35386;1048;2767;9612;30590;10660;33357
210580;201401;2972;9370;2650;8959;325;962;2064;7338;2389;8300
210590;201401;4471;13833;4219;13532;312;981;3642;11896;3954;12877
210592;201401;2463;7927;2400;7828;107;406;2129;6938;2236;7344
210594;201401;2728;7934;2322;7407;168;505;1973;6461;2141;6966
210596;201401;2826;10712;2701;10488;344;1355;2000;7923;2344;9278
210598;201401;1998;6228;1880;6085;124;495;1663;5318;1787;5813
210600;201401;3304;9854;3074;9536;381;1202;2352;7343;2733;8545
210610;201401;2630;8470;2373;8163;264;953;1920;6662;2184;7615
210620;201401;1802;5613;1673;5444;55;147;1532;5055;1587;5202
210630;201401;3371;12632;2969;11855;539;2170;1768;7365;2307;9535
210632;201401;4813;16722;4439;16199;511;1856;3486;12967;3997;14823
210635;201401;1856;6748;1802;6668;91;306;1635;6162;1726;6468
210637;201401;2711;9386;2617;9259;131;489;2347;8399;2478;8888
210640;201401;4215;14218;4142;14135;27;88;4041;13873;4068;13961
210650;201401;6731;20729;6623;20598;188;571;6271;19638;6459;20209
210660;201401;7413;23349;6977;22663;298;841;6359;20821;6657;21662
210663;201401;2682;7881;2541;7698;154;543;2158;6559;2312;7102
210667;201401;1657;6151;1595;6061;93;417;1372;5247;1465;5664
210670;201401;4709;17765;4573;17533;461;1780;3584;14163;4045;15943
210675;201401;4816;13594;4582;13300;304;813;3958;11740;4262;12553
210680;201401;4441;12882;4010;12388;224;686;3484;10883;3708;11569
210690;201401;6797;23606;6536;23326;312;1070;5926;21443;6238;22513
210700;201401;2589;7351;2313;7032;219;439;1857;6195;2076;6634
210710;201401;4896;16061;4716;15782;194;668;4204;14168;4398;14836
210720;201401;2386;9034;2291;8898;156;684;1984;7711;2140;8395
210725;201401;1178;4412;1026;4139;131;585;640;2625;771;3210
210730;201401;1189;3771;1067;3637;110;347;873;3048;983;3395
210735;201401;3718;13942;3524;13613;661;2597;2393;9547;3054;12144
210740;201401;4909;13582;4593;13263;184;405;4265;12592;4449;12997
210745;201401;3674;11345;3479;11075;342;930;2835;9225;3177;10155
210750;201401;19768;56021;18292;54350;2276;6799;14604;44073;16880;50872
210760;201401;5897;16331;5629;16042;75;234;5472;15611;5547;15845
210770;201401;6190;17034;5312;16037;278;899;4677;14158;4955;15057
210780;201401;8642;29544;8099;28543;1156;4322;5747;20631;6903;24953
210790;201401;4772;14454;4137;13745;307;802;3533;12286;3840;13088
210800;201401;4935;14218;4536;13779;215;732;3856;12155;4071;12887
210805;201401;3705;15775;3616;15605;191;853;3119;13762;3310;14615
210810;201401;5626;17393;5096;16793;501;1217;4310;14907;4811;16124
210820;201401;8924;25898;8441;25261;1474;4384;5831;17985;7305;22369
210825;201401;5510;18670;5356;18475;246;852;4820;16857;5066;17709
210830;201401;8413;26661;8131;26351;355;1016;7347;24346;7702;25362
210840;201401;3750;10523;3483;10148;337;830;2728;8117;3065;8947
210845;201401;5512;17737;5316;17517;306;855;4651;15876;4957;16731
210850;201401;5912;22257;5563;21642;984;4279;3772;14721;4756;19000
210860;201401;17051;53710;16149;52487;1379;4842;13190;43111;14569;47953
210870;201401;6327;20947;5784;20244;825;2799;4192;15124;5017;17923
210880;201401;4039;13330;3969;13236;213;704;3558;12021;3771;12725
210890;201401;5341;16289;5017;15884;492;1703;4056;12849;4548;14552
210900;201401;4638;15415;4307;14839;1498;5289;1927;6996;3425;12285
210905;201401;1831;5782;1747;5676;127;326;1519;5097;1646;5423
210910;201401;10522;33531;9945;32640;1926;6796;6511;21578;8437;28374
210920;201401;3441;11520;3358;11410;153;463;3030;10517;3183;10980
210923;201401;1517;5692;1459;5601;199;800;1042;4165;1241;4965
210927;201401;4667;14947;4563;14840;36;97;4491;14662;4527;14759
210930;201401;2636;9721;2546;9598;210;962;2129;7997;2339;8959
210940;201401;2871;11516;2834;11443;317;1162;2293;9536;2610;10698
210945;201401;5893;17431;5704;17237;191;249;5451;16873;5642;17122
210950;201401;5593;17762;4956;16822;693;2422;3499;12205;4192;14627
210955;201401;1893;6426;1732;6160;287;1120;1171;4211;1458;5331
210960;201401;9186;30771;8873;30305;2173;7146;5741;20665;7914;27811
210970;201401;1368;5050;1224;4837;185;809;868;3475;1053;4284
210975;201401;1685;5987;1612;5853;181;667;1239;4581;1420;5248
210980;201401;8946;22687;8731;22445;617;1355;7662;20143;8279;21498
210990;201401;15646;46103;12811;42784;2299;8169;8641;29348;10940;37517
211000;201401;16131;52875;14788;51179;1083;3830;12544;44257;13627;48087
211003;201401;5090;17990;4703;17402;644;2561;3321;12607;3965;15168
211010;201401;6614;22421;6479;22259;147;482;6052;21048;6199;21530
211020;201401;7440;23044;7374;22963;194;392;7058;22259;7252;22651
211023;201401;2411;8285;2347;8172;175;629;1948;6930;2123;7559
211027;201401;3056;11942;2945;11767;289;1085;2339;9753;2628;10838
211030;201401;4224;13092;3827;12637;842;2322;2710;9564;3552;11886
211040;201401;4069;15792;3965;15620;149;646;3484;14010;3633;14656
211050;201401;10128;27802;9987;27638;483;1267;9260;25801;9743;27068
211060;201401;5609;20964;5512;20788;631;2226;4440;17265;5071;19491
211065;201401;1701;5927;1575;5761;62;236;1454;5371;1516;5607
211070;201401;8663;29485;8225;28737;820;2922;6496;23142;7316;26064
211080;201401;1341;4231;1105;3907;85;430;903;3110;988;3540
211085;201401;2017;6863;1761;6530;327;1177;1273;4904;1600;6081
211090;201401;3522;11199;3330;10935;221;870;2807;9156;3028;10026
211100;201401;6786;17941;6625;17751;95;344;6291;16810;6386;17154
211102;201401;3117;11652;3022;11514;350;1260;2442;9589;2792;10849
211105;201401;2794;8936;2510;8563;200;755;2089;7125;2289;7880
211107;201401;4480;13929;4145;13485;191;627;3692;12198;3883;12825
211110;201401;6467;19695;5175;17887;909;3063;3363;12306;4272;15369
211120;201401;31930;89230;28017;84329;4075;11978;19981;62627;24056;74605
211125;201401;2174;7065;1988;6777;188;623;1596;5541;1784;6164
211130;201401;145480;434636;137372;424314;28963;89429;92078;292109;121041;381538
211140;201401;5662;18401;5398;17986;295;1061;4669;15624;4964;16685
211150;201401;9830;30394;9364;29816;746;2396;7984;25814;8730;28210
211153;201401;3201;9688;2943;9392;312;795;2413;8089;2725;8884
211157;201401;1240;4123;1068;3858;142;623;735;2739;877;3362
211160;201401;4182;14508;3653;13626;397;1720;2737;10222;3134;11942
211163;201401;1685;5642;1612;5544;63;222;1461;5091;1524;5313
211167;201401;1468;5063;1370;4907;55;226;1218;4379;1273;4605
211170;201401;6666;18096;6472;17865;153;525;6026;16578;6179;17103
211172;201401;2380;7068;2104;6652;180;686;1691;5231;1871;5917
211174;201401;2835;8474;2614;8196;130;534;2267;7038;2397;7572
211176;201401;5566;16412;4788;15517;561;1521;3756;12803;4317;14324
211178;201401;3048;9858;2987;9794;74;202;2854;9460;2928;9662
211180;201401;4365;15779;4119;15389;414;1687;3227;12227;3641;13914
211190;201401;2776;9471;2540;9132;145;631;2174;7862;2319;8493
211195;201401;1459;4632;1263;4395;115;400;1018;3648;1133;4048
211200;201401;2157;7572;1953;7299;287;1007;1411;5591;1698;6598
211210;201401;6749;22408;6592;22175;544;1798;5553;18980;6097;20778
211220;201401;35323;106789;31259;101511;7391;24808;18724;62860;26115;87668
211223;201401;5940;17207;5546;16579;724;2222;3812;11963;4536;14185
211227;201401;1546;5893;1487;5802;159;720;1161;4531;1320;5251
211230;201401;8928;30665;8296;29580;1362;4933;5736;21013;7098;25946
211240;201401;8372;28475;8147;28216;364;1292;7489;26125;7853;27417
211245;201401;5071;15420;5004;15337;197;518;4635;14428;4832;14946
211250;201401;11891;44565;11338;43926;1453;4431;9186;37710;10639;42141
211260;201401;8265;26114;8160;25962;454;1311;7390;23824;7844;25135
211270;201401;9995;35907;9499;35260;663;2698;7940;29935;8603;32633
211280;201401;12226;35847;11779;35329;1319;3231;9786;30593;11105;33824
211285;201401;2002;7120;1753;6681;425;1699;864;3485;1289;5184
211290;201401;7730;25455;7577;25273;605;1708;6537;22423;7142;24131
211300;201401;8528;26543;7760;25435;656;2253;6294;20804;6950;23057
211400;201401;11779;35497;10404;33938;2504;8134;6065;21816;8569;29950
220005;201401;1703;5065;1640;4970;55;257;1447;4261;1502;4518
220010;201401;1722;4622;1320;4128;134;515;1036;3164;1170;3679
220020;201401;3713;11466;3531;11160;628;2128;2304;7250;2932;9378
220025;201401;2141;5383;2004;5185;65;204;1778;4541;1843;4745
220027;201401;1392;3860;1298;3744;104;234;1096;3261;1200;3495
220030;201401;3348;10186;3290;10093;318;1024;2705;8365;3023;9389
220040;201401;8332;26224;7988;25676;1545;5268;4997;16145;6542;21413
220045;201401;1442;4699;1316;4495;157;613;944;3184;1101;3797
220050;201401;4808;13968;4261;13201;352;1298;3437;10509;3789;11807
220060;201401;2028;5371;1934;5260;108;297;1735;4734;1843;5031
220070;201401;2573;7695;2307;7317;216;703;1804;5810;2020;6513
220080;201401;828;2581;785;2508;97;389;550;1688;647;2077
220090;201401;1767;4866;1588;4606;146;513;1255;3547;1401;4060
220095;201401;664;1888;635;1840;28;85;586;1689;614;1774
220100;201401;1408;4306;1218;3998;149;473;895;3024;1044;3497
220105;201401;2208;7395;2079;7154;217;780;1532;5312;1749;6092
220110;201401;3568;10452;3161;9867;286;1066;2553;7841;2839;8907
220115;201401;2174;8078;2100;7959;320;1272;1602;6141;1922;7413
220117;201401;1415;3785;1174;3437;80;255;942;2743;1022;2998
220120;201401;12621;36831;11779;35792;390;1489;10706;32495;11096;33984
220130;201401;784;2926;695;2811;57;171;603;2533;660;2704
220140;201401;1598;4321;1486;4182;284;641;1142;3390;1426;4031
220150;201401;7224;22977;6942;22583;454;1778;5868;18996;6322;20774
220155;201401;1049;3359;903;3092;83;356;626;2091;709;2447
220157;201401;1043;2709;960;2587;44;116;817;2207;861;2323
220160;201401;2856;8599;2574;8111;200;776;1953;6094;2153;6870
220170;201401;1288;4207;1200;4055;109;408;942;3211;1051;3619
220173;201401;2107;6430;1745;5739;80;370;1400;4541;1480;4911
220177;201401;1693;5059;1665;5012;80;260;1514;4560;1594;4820
220180;201401;1159;3180;1040;2993;63;216;795;2241;858;2457
220190;201401;4608;15285;4050;14578;510;1871;3099;11324;3609;13195
220191;201401;1434;4901;1375;4806;258;863;948;3361;1206;4224
220192;201401;1754;5107;1425;4547;169;530;1016;3286;1185;3816
220194;201401;1718;5037;1566;4770;192;645;1141;3390;1333;4035
220196;201401;2045;6193;1923;5988;212;764;1454;4497;1666;5261
220198;201401;1321;3684;1098;3390;29;97;1017;3169;1046;3266
220200;201401;4649;16170;4410;15802;747;2918;3025;10809;3772;13727
220202;201401;2050;6513;1879;6205;67;278;1651;5424;1718;5702
220205;201401;2919;7750;2593;7310;101;386;2254;6259;2355;6645
220207;201401;917;2831;805;2636;99;366;591;1929;690;2295
220208;201401;1658;5826;1536;5612;271;1158;1005;3626;1276;4784
220209;201401;1580;5008;1461;4808;97;387;1125;3719;1222;4106
220210;201401;1858;4981;1634;4691;94;332;1279;3683;1373;4015
220211;201401;1635;4967;1553;4857;107;475;1280;3961;1387;4436
220213;201401;1824;5337;1708;5123;110;385;1340;3959;1450;4344
220217;201401;1792;5839;1732;5763;74;223;1573;5310;1647;5533
220220;201401;11624;33874;10792;32558;1372;4101;7596;23534;8968;27635
220225;201401;995;3108;928;3002;40;169;807;2590;847;2759
220230;201401;6078;16219;5087;14893;278;826;4406;12973;4684;13799
220240;201401;2701;8760;2587;8553;212;783;2033;6659;2245;7442
220245;201401;1427;3953;1347;3853;63;170;1191;3453;1254;3623
220250;201401;3374;9152;3064;8742;60;142;2859;8255;2919;8397
220253;201401;1858;5582;1626;5176;125;463;1193;3828;1318;4291
220255;201401;1769;5056;1571;4715;111;443;1266;3680;1377;4123
220260;201401;5222;16959;4764;16113;492;1867;3525;11949;4017;13816
220265;201401;1237;4524;1183;4433;111;525;860;3198;971;3723
220270;201401;6685;22399;6533;22129;423;1930;5518;18239;5941;20169
220271;201401;1529;4381;1468;4298;83;241;1282;3808;1365;4049
220272;201401;1768;5570;1656;5403;112;472;1304;4215;1416;4687
220273;201401;1304;3782;1147;3543;113;376;856;2627;969;3003
220275;201401;2080;5575;1799;5216;81;263;1564;4548;1645;4811
220277;201401;2561;7090;2202;6557;180;575;1676;5054;1856;5629
220280;201401;1783;4672;1563;4356;106;385;1247;3427;1353;3812
220285;201401;1675;4573;1506;4339;101;313;1246;3676;1347;3989
220290;201401;6602;21596;5618;20347;553;2128;4380;16115;4933;18243
220300;201401;1910;6270;1694;5979;94;418;1440;5084;1534;5502
220310;201401;2600;8460;2162;7935;95;302;1948;7365;2043;7667
220320;201401;3389;10123;2870;9262;440;1491;2012;6530;2452;8021
220323;201401;1421;5345;1310;5187;213;910;936;3736;1149;4646
220325;201401;1278;4045;1183;3865;161;577;778;2615;939;3192
220327;201401;1367;4393;1246;4190;75;363;992;3267;1067;3630
220330;201401;3676;10623;3506;10397;281;937;2934;8736;3215;9673
220335;201401;2094;6067;1898;5829;100;359;1619;5004;1719;5363
220340;201401;1824;5241;1621;4965;156;537;1259;3827;1415;4364
220342;201401;1208;4000;1162;3931;121;493;851;2993;972;3486
220345;201401;2879;7977;2478;7336;88;242;2134;6348;2222;6590
220350;201401;4471;12196;3968;11528;304;979;3134;9126;3438;10105
220360;201401;1479;4071;1177;3601;112;377;856;2613;968;2990
220370;201401;9136;26531;8379;25542;481;1379;7416;22800;7897;24179
220375;201401;1552;4863;1445;4719;84;326;1282;4160;1366;4486
220380;201401;1386;3839;1207;3592;81;268;937;2805;1018;3073
220385;201401;704;1945;638;1820;38;133;523;1440;561;1573
220390;201401;10305;32847;9497;31301;2388;8410;4447;14778;6835;23188
220400;201401;1449;3525;1312;3339;66;220;1134;2820;1200;3040
220410;201401;1379;4003;1181;3731;107;449;938;2879;1045;3328
220415;201401;881;2393;797;2280;90;257;594;1711;684;1968
220420;201401;2262;6623;2073;6248;162;484;1658;5021;1820;5505
220430;201401;2973;8736;2831;8548;384;1206;2122;6424;2506;7630
220435;201401;1636;4852;1537;4708;82;262;1300;3988;1382;4250
220440;201401;2812;8480;2343;7949;143;396;2073;7177;2216;7573
220450;201401;2722;8141;2372;7672;580;1960;1409;4602;1989;6562
220455;201401;1427;4387;1284;4191;54;184;1154;3805;1208;3989
220460;201401;1029;2886;978;2811;64;188;839;2407;903;2595
220465;201401;2461;8157;2280;7886;515;1916;1416;4926;1931;6842
220470;201401;4058;12308;3695;11686;266;956;2851;8899;3117;9855
220480;201401;2343;7118;2160;6849;162;543;1772;5630;1934;6173
220490;201401;2386;7003;2278;6859;134;492;1949;5817;2083;6309
220500;201401;3422;9312;2983;8592;204;794;2366;6612;2570;7406
220510;201401;2939;8302;2267;7331;101;454;1778;5721;1879;6175
220515;201401;1969;4963;1750;4691;86;243;1472;3956;1558;4199
220520;201401;5033;14391;4750;13996;233;653;4147;12375;4380;13028
220525;201401;1470;4191;1369;4045;108;396;1106;3193;1214;3589
220527;201401;1442;4619;1347;4419;152;488;1040;3487;1192;3975
220530;201401;1186;3513;1107;3396;110;419;897;2668;1007;3087
220535;201401;889;2806;861;2764;81;319;681;2155;762;2474
220540;201401;3609;12223;3485;12030;289;1179;2824;9733;3113;10912
220545;201401;1429;4957;1373;4863;213;851;942;3295;1155;4146
220550;201401;9241;30610;8780;29785;1602;5821;5802;19724;7404;25545
220551;201401;1422;4908;1345;4777;134;566;1030;3623;1164;4189
220552;201401;1670;5275;1441;4888;130;602;1051;3424;1181;4026
220553;201401;1626;4869;1418;4575;86;308;1160;3744;1246;4052
220554;201401;928;2600;810;2438;112;342;576;1773;688;2115
220555;201401;2440;7235;2293;7053;99;343;1958;6109;2057;6452
220556;201401;1470;4722;1349;4496;103;434;1011;3333;1114;3767
220557;201401;1612;5399;1482;5156;203;811;983;3409;1186;4220
220558;201401;1032;3267;962;3138;108;420;723;2304;831;2724
220559;201401;1553;4467;1435;4295;79;269;1231;3681;1310;3950
220560;201401;1758;4422;1483;4049;83;233;1245;3384;1328;3617
220570;201401;7506;24147;7084;23577;1060;3256;5351;18447;6411;21703
220580;201401;6600;21672;6435;21478;419;1371;5722;19353;6141;20724
220585;201401;1920;7214;1863;7113;140;571;1570;6027;1710;6598
220590;201401;1413;4490;1281;4292;244;862;809;2756;1053;3618
220595;201401;2481;7240;2303;7003;86;288;2064;6307;2150;6595
220600;201401;1322;3332;1141;3115;225;501;741;2163;966;2664
220605;201401;2067;6193;1837;5840;117;393;1447;4623;1564;5016
220610;201401;2784;8758;2706;8648;175;685;2281;7230;2456;7915
220620;201401;7775;26793;7563;26473;413;1664;6592;23119;7005;24783
220630;201401;408;1261;349;1152;77;284;183;613;260;897
220635;201401;1876;6739;1755;6468;156;666;1162;4289;1318;4955
220640;201401;2811;8383;2692;8206;283;960;2075;6317;2358;7277
220650;201401;2484;6992;2242;6622;153;514;1808;5329;1961;5843
220660;201401;2487;8368;2040;7808;195;811;1718;6601;1913;7412
220665;201401;1221;4242;1171;4162;56;244;1029;3631;1085;3875
220667;201401;1752;5958;1670;5847;81;328;1434;5015;1515;5343
220669;201401;1894;6277;1777;6063;257;992;1222;4161;1479;5153
220670;201401;2158;6582;2034;6427;167;436;1740;5690;1907;6126
220672;201401;2282;6632;2212;6544;242;696;1833;5501;2075;6197
220675;201401;1363;3990;1280;3855;147;400;936;2876;1083;3276
220680;201401;2241;7438;2154;7308;212;698;1726;5972;1938;6670
220690;201401;1723;4974;1555;4700;130;480;1222;3641;1352;4121
220695;201401;860;2660;817;2588;78;261;613;1952;691;2213
220700;201401;9099;26686;8326;25542;795;2690;6395;19641;7190;22331
220710;201401;761;2310;666;2148;69;204;479;1581;548;1785
220720;201401;2142;5823;2034;5678;98;218;1807;5142;1905;5360
220730;201401;1379;3842;1214;3590;55;194;1015;2975;1070;3169
220735;201401;1037;2748;899;2523;80;260;663;1862;743;2122
220740;201401;1353;4438;1172;4189;220;724;824;3109;1044;3833
220750;201401;3969;11818;3769;11517;536;1476;2824;8976;3360;10452
220755;201401;1186;3541;1124;3441;69;206;965;2968;1034;3174
220760;201401;2646;9449;2479;9202;122;486;2166;8131;2288;8617
220770;201401;23334;81205;22067;78925;7674;28611;9035;33329;16709;61940
220775;201401;1173;2969;1154;2948;22;40;1124;2889;1146;2929
220777;201401;1696;4917;1604;4782;139;429;1304;3872;1443;4301
220779;201401;1152;3567;1122;3523;68;266;988;3063;1056;3329
220780;201401;6261;16496;5689;15750;470;1237;4665;13152;5135;14389
220785;201401;1293;3595;1254;3513;71;195;1131;3165;1202;3360
220790;201401;9349;31037;9087;30547;963;3536;7234;24279;8197;27815
220793;201401;919;2659;854;2555;67;223;692;2063;759;2286
220795;201401;1537;4350;1491;4282;110;344;1254;3620;1364;3964
220800;201401;17027;49131;15937;47508;1920;6648;11986;35060;13906;41708
220810;201401;3358;9965;2921;9183;245;946;2275;7072;2520;8018
220820;201401;5584;15901;5142;15329;322;1078;4379;13120;4701;14198
220830;201401;7684;22062;7340;21498;927;2739;5549;16467;6476;19206
220840;201401;14902;48573;13779;46330;3594;12372;6266;21885;9860;34257
220850;201401;2708;9977;2600;9810;349;1419;1984;7565;2333;8984
220855;201401;623;1968;564;1861;69;264;401;1299;470;1563
220860;201401;941;2685;886;2600;55;219;728;2091;783;2310
220865;201401;2666;7573;2209;6831;110;501;1810;5482;1920;5983
220870;201401;2422;8083;2135;7726;132;521;1856;6730;1988;7251
220880;201401;5380;14246;4950;13724;251;848;4340;12031;4591;12879
220885;201401;1336;4745;1187;4483;124;577;862;3252;986;3829
220887;201401;1330;3618;1175;3403;47;145;1047;3051;1094;3196
220890;201401;1613;5787;1450;5529;143;546;1154;4521;1297;5067
220900;201401;1885;5759;1709;5378;122;372;1375;4379;1497;4751
220910;201401;1735;5114;1558;4853;74;267;1351;4241;1425;4508
220915;201401;1042;3049;935;2875;51;229;731;2186;782;2415
220920;201401;1323;4948;1266;4870;121;545;983;3774;1104;4319
220930;201401;1484;4851;1319;4636;106;440;1067;3778;1173;4218
220935;201401;1029;3232;949;3061;67;297;689;2137;756;2434
220937;201401;1548;4333;1337;3968;76;270;1055;3067;1131;3337
220940;201401;1473;4536;1371;4315;104;398;1050;3284;1154;3682
220945;201401;474;1746;444;1652;58;248;305;1130;363;1378
220950;201401;1265;3260;938;2701;47;183;699;1957;746;2140
220955;201401;1624;4539;1389;4181;139;472;1067;3195;1206;3667
220960;201401;827;2341;732;2174;66;258;553;1596;619;1854
220965;201401;1684;5157;1598;5036;66;270;1383;4352;1449;4622
220970;201401;2146;5789;1585;4853;171;533;1050;3250;1221;3783
220975;201401;522;2082;520;2077;56;216;443;1791;499;2007
220980;201401;1492;4506;1341;4235;128;471;901;2935;1029;3406
220985;201401;1364;3942;1307;3863;129;441;998;2931;1127;3372
220987;201401;1488;4934;1401;4782;121;490;1051;3527;1172;4017
220990;201401;1803;5357;1600;5004;83;354;1243;3827;1326;4181
220995;201401;1203;3705;1011;3401;85;347;764;2600;849;2947
220997;201401;2107;6791;2014;6637;131;450;1788;5886;1919;6336
221000;201401;4444;13909;4151;13412;519;1809;3027;9778;3546;11587
221005;201401;1415;4547;1345;4418;411;1295;707;2441;1118;3736
221010;201401;1243;3388;1099;3198;58;178;938;2752;996;2930
221020;201401;1923;6034;1815;5836;128;569;1383;4346;1511;4915
221030;201401;1815;5073;1598;4766;87;356;1286;3781;1373;4137
221035;201401;1561;4269;1420;4093;89;256;1238;3609;1327;3865
221037;201401;637;1970;578;1868;36;159;462;1429;498;1588
221038;201401;642;1857;527;1672;44;154;363;1161;407;1315
221039;201401;932;2775;885;2705;69;233;758;2299;827;2532
221040;201401;5215;16197;4961;15786;421;1466;3893;12544;4314;14010
221050;201401;3751;11721;3481;11328;233;911;2954;9548;3187;10459
221060;201401;9164;25203;7922;23552;926;2901;5973;17864;6899;20765
221062;201401;1283;4555;1228;4479;37;113;1147;4214;1184;4327
221063;201401;1128;3674;1058;3541;363;1179;529;1928;892;3107
221065;201401;2707;8098;2546;7843;278;884;1969;6073;2247;6957
221070;201401;4398;13557;4011;12965;277;1069;3160;10185;3437;11254
221080;201401;3453;9575;3135;9147;228;752;2548;7452;2776;8204
221090;201401;1311;3678;1166;3461;52;205;966;2813;1018;3018
221093;201401;1796;5418;1713;5259;312;1045;1028;3094;1340;4139
221095;201401;977;2673;853;2500;40;117;761;2256;801;2373
221097;201401;802;2338;720;2199;63;258;539;1625;602;1883
221100;201401;122874;381635;117128;372190;25631;89784;74412;231474;100043;321258
221110;201401;9984;33655;9611;33179;746;2984;8053;27740;8799;30724
221120;201401;4259;14461;4103;14168;1200;4072;2352;8490;3552;12562
221130;201401;4683;14165;4179;13148;1012;3341;2285;7152;3297;10493
221135;201401;1463;4685;1376;4551;182;704;1006;3279;1188;3983
221140;201401;1404;3597;1299;3460;151;343;1031;2815;1182;3158
221150;201401;1224;3213;1044;2898;26;111;826;2278;852;2389
221160;201401;902;2430;855;2356;59;181;654;1809;713;1990
221170;201401;1104;3647;1066;3571;80;325;874;2891;954;3216
230010;201401;3433;9387;2828;8342;197;691;2230;6551;2427;7242
230015;201401;2781;9819;2617;9487;464;1936;1726;6130;2190;8066
230020;201401;14199;47905;13748;47072;1118;4191;11099;38201;12217;42392
230030;201401;12426;37385;11729;36300;1014;3482;9340;28882;10354;32364
230040;201401;4520;13054;3893;11976;348;1225;2978;9093;3326;10318
230050;201401;2536;8867;2211;8052;402;1624;1114;4060;1516;5684
230060;201401;1967;6049;1772;5683;175;647;1303;4157;1478;4804
230070;201401;4666;13032;4167;12335;398;1269;3134;9486;3532;10755
230075;201401;8759;32991;8330;32102;994;4621;6070;23245;7064;27866
230080;201401;2339;6640;2003;6164;123;430;1641;5041;1764;5471
230090;201401;3362;10528;3034;9939;298;1169;2280;7351;2578;8520
230100;201401;17132;54048;15916;51763;4504;15539;7484;24729;11988;40268
230110;201401;13901;46629;13098;44923;2604;9744;7709;26394;10313;36138
230120;201401;7929;22362;7077;21211;837;2776;5197;15683;6034;18459
230125;201401;2868;8611;2419;7749;204;825;1778;5613;1982;6438
230130;201401;5603;19022;4794;17264;454;1946;3373;12010;3827;13956
230140;201401;3458;11492;3030;10711;481;1802;1923;6961;2404;8763
230150;201401;1748;5613;1545;5204;294;1150;949;3055;1243;4205
230160;201401;6268;19452;5580;18436;592;2170;4129;13733;4721;15903
230170;201401;6455;20944;5660;19495;535;2150;4056;13818;4591;15968
230180;201401;1938;5671;1728;5293;153;572;1194;3588;1347;4160
230185;201401;4149;14178;3877;13650;725;2573;2394;8774;3119;11347
230190;201401;12255;41400;11360;39629;2242;8863;6336;21942;8578;30805
230195;201401;4926;15658;4504;14995;359;1541;3483;11248;3842;12789
230200;201401;5659;16850;5110;15775;681;2217;3559;11012;4240;13229
230205;201401;4377;14128;3940;13387;393;1681;2820;9564;3213;11245
230210;201401;9131;26805;8132;25227;2382;7559;3868;12488;6250;20047
230220;201401;13528;40948;12599;39384;2005;7045;8413;25974;10418;33019
230230;201401;7321;24809;6650;23374;1160;4201;3940;14064;5100;18265
230240;201401;13285;39746;12145;37667;876;3331;9261;28239;10137;31570
230250;201401;10173;31639;9961;31334;564;2129;8392;26258;8956;28387
230260;201401;14782;51251;13836;49308;3177;12066;7257;26493;10434;38559
230270;201401;6713;20878;6012;19670;643;2340;4505;14793;5148;17133
230280;201401;20050;61889;18545;59386;2805;9391;12835;41444;15640;50835
230290;201401;5117;16043;4523;14866;652;2231;2973;9901;3625;12132
230300;201401;4702;14981;4527;14718;534;2014;3341;10771;3875;12785
230310;201401;4907;14975;4391;14132;398;1586;3285;10407;3683;11993
230320;201401;7353;24100;6929;23362;843;3235;5016;16956;5859;20191
230330;201401;4639;14188;4184;13292;425;1563;2928;9187;3353;10750
230340;201401;3372;11951;3189;11553;536;2183;1951;6924;2487;9107
230350;201401;18173;56912;16455;53968;3034;10881;10106;33483;13140;44364
230360;201401;2990;9097;2644;8473;335;1228;1913;6068;2248;7296
230365;201401;2922;8758;2583;8196;204;788;1953;6168;2157;6956
230370;201401;54294;184341;50790;178476;15480;57149;24479;88834;39959;145983
230380;201401;7085;20876;6124;19254;586;2122;4298;13518;4884;15640
230390;201401;3643;11785;3278;11190;425;1752;2243;7565;2668;9317
230393;201401;3369;11450;2925;10513;272;1347;2045;7113;2317;8460
230395;201401;4917;15895;4607;15287;703;2697;2998;9832;3701;12529
230400;201401;5064;16185;4480;15360;427;1836;3473;11674;3900;13510
230410;201401;15814;50965;14347;48262;2537;9233;8467;28561;11004;37794
230420;201401;23760;80927;22524;78431;5785;22032;11048;38240;16833;60272
230423;201401;4808;15962;4496;15381;531;2024;3101;10797;3632;12821
230425;201401;5401;18550;5027;17714;739;2876;3396;11894;4135;14770
230426;201401;2824;8033;2367;7188;146;584;1798;5346;1944;5930
230427;201401;1732;5386;1321;4473;127;470;864;2840;991;3310
230428;201401;9046;30280;8838;29909;1799;6842;5566;18615;7365;25457
230430;201401;4591;15113;4354;14650;447;1831;3159;10447;3606;12278
230435;201401;4921;16595;4459;15785;1093;4244;2238;8105;3331;12349
230440;201401;355614;1127304;337961;1095758;88017;308428;166494;540602;254511;849030
230445;201401;4703;13018;4082;12144;370;1122;3026;9193;3396;10315
230450;201401;3672;12075;3182;11194;470;1872;2018;7146;2488;9018
230460;201401;1911;6476;1767;6200;201;823;1255;4380;1456;5203
230465;201401;4156;12816;3456;11524;339;1462;2247;7287;2586;8749
230470;201401;11272;41820;10907;41097;1532;6212;7780;29837;9312;36049
230480;201401;1457;4788;1303;4496;242;882;819;2850;1061;3732
230490;201401;2956;8787;2616;8169;462;1648;1376;4265;1838;5913
230495;201401;5690;19433;5195;18617;968;4086;3012;10803;3980;14889
230500;201401;10684;36745;10283;36091;904;3456;7909;28416;8813;31872
230510;201401;1515;5527;1299;4989;341;1411;526;2103;867;3514
230520;201401;5019;15521;4433;14499;512;1958;3002;9750;3514;11708
230523;201401;13321;45479;12445;43555;3762;14638;3639;12913;7401;27551
230526;201401;4152;13058;3680;12227;421;1629;2547;8485;2968;10114
230530;201401;5167;17622;4787;17101;1046;3770;3095;11275;4141;15045
230533;201401;3914;11418;3601;10831;295;1000;2771;8318;3066;9318
230535;201401;5409;16378;4795;15275;521;1756;3456;11162;3977;12918
230540;201401;18828;55174;16880;52321;1220;4476;13725;42243;14945;46719
230550;201401;20056;61873;18456;58868;4367;15191;9662;30545;14029;45736
230560;201401;6796;19844;6176;18716;337;1301;4862;14564;5199;15865
230565;201401;3274;9716;2714;8585;280;994;1860;5835;2140;6829
230570;201401;3943;10922;3549;10420;239;882;2924;8485;3163;9367
230580;201401;10378;32472;9950;31879;611;2037;8637;27956;9248;29993
230590;201401;9536;30814;8741;29377;831;3460;6404;21132;7235;24592
230600;201401;3624;10370;2802;8691;200;713;1896;5785;2096;6498
230610;201401;6026;20364;5668;19794;854;3268;4008;14123;4862;17391
230620;201401;2045;5926;1729;5285;166;606;1110;3300;1276;3906
230625;201401;7544;25605;6895;24133;1994;7615;2375;8333;4369;15948
230630;201401;11147;37206;10280;35502;2565;8689;5120;18712;7685;27401
230640;201401;26258;89951;24956;87986;3943;14760;17548;62637;21491;77397
230650;201401;4942;16081;4558;15318;408;1740;3456;11386;3864;13126
230655;201401;8580;33024;8282;32532;785;3190;6854;27295;7639;30485
230660;201401;6336;20237;5620;18961;570;2319;3987;13527;4557;15846
230670;201401;5954;16531;4916;14757;276;1032;3758;11002;4034;12034
230680;201401;2762;8253;2369;7543;384;1346;1426;4536;1810;5882
230690;201401;6374;21354;6234;21090;511;2205;4509;14940;5020;17145
230700;201401;9209;27334;8217;25584;885;3374;5573;16856;6458;20230
230710;201401;7637;25061;6859;23637;912;3155;4905;17332;5817;20487
230720;201401;1936;6138;1676;5640;231;863;1084;3659;1315;4522
230725;201401;3754;12814;3408;11986;674;2579;1910;6606;2584;9185
230730;201401;56771;176645;48916;164606;13328;48970;22167;75812;35495;124782
230740;201401;5263;17048;5013;16580;333;1410;4089;13318;4422;14728
230750;201401;8935;26368;7673;24316;733;2794;5717;17981;6450;20775
230760;201401;10070;31658;9780;30999;1443;5502;6855;20780;8298;26282
230763;201401;4221;13594;4000;13158;332;1511;3029;9591;3361;11102
230765;201401;42839;143133;40348;138134;13236;48608;13962;48536;27198;97144
230770;201401;23578;67056;21957;64745;1977;6818;16571;48466;18548;55284
230780;201401;5937;23976;5721;23461;1375;5749;3017;13072;4392;18821
230790;201401;2530;8807;2430;8635;303;1179;1861;6674;2164;7853
230800;201401;7836;28826;7281;27576;1769;7233;3414;13042;5183;20275
230810;201401;12419;41260;11917;40419;1425;5119;9028;31058;10453;36177
230820;201401;3397;11805;3058;11074;643;2614;1621;5876;2264;8490
230830;201401;7836;24177;7082;22807;739;2756;4990;16051;5729;18807
230835;201401;4117;11454;3565;10714;311;1037;2775;8356;3086;9393
230837;201401;3147;10987;2768;10213;389;1618;1805;6689;2194;8307
230840;201401;9324;31525;8576;30195;1374;5212;5606;20141;6980;25353
230850;201401;11124;34586;10530;33846;1386;4989;7715;24676;9101;29665
230860;201401;5049;15472;4675;14751;408;1536;3499;10932;3907;12468
230870;201401;18844;53282;17047;50329;1722;5881;12694;37202;14416;43083
230880;201401;1928;6786;1807;6545;267;1110;1159;4172;1426;5282
230890;201401;4089;15074;3797;14485;542;2423;2490;9366;3032;11789
230900;201401;2998;10214;2660;9509;512;1858;1462;5347;1974;7205
230910;201401;2980;9186;2462;8195;267;1066;1707;5567;1974;6633
230920;201401;4627;13867;4293;13449;337;1140;3492;11119;3829;12259
230930;201401;7728;24069;7050;22810;916;3190;4871;15840;5787;19030
230940;201401;7639;22064;6825;20882;390;1220;5727;17721;6117;18941
230945;201401;5819;17975;5081;16936;594;2161;3614;12196;4208;14357
230950;201401;6918;19405;5979;18134;413;1403;4637;14118;5050;15521
230960;201401;12280;40426;11434;38759;2708;10135;5462;18511;8170;28646
230970;201401;13260;43372;12179;41215;2637;10215;6083;20134;8720;30349
230980;201401;2825;9524;2602;9051;822;2892;1128;4127;1950;7019
230990;201401;1594;5073;1312;4483;168;713;862;2866;1030;3579
231000;201401;2867;7873;2322;6852;260;905;1490;4265;1750;5170
231010;201401;2964;8759;2603;8190;300;1206;1886;5809;2186;7015
231020;201401;7907;26894;7497;26075;1394;5150;4708;16694;6102;21844
231025;201401;7761;24975;7086;23827;1169;4102;4540;15685;5709;19787
231030;201401;7948;26756;6863;24504;1351;5131;3918;14168;5269;19299
231040;201401;2985;10150;2725;9598;297;1234;1883;6547;2180;7781
231050;201401;11947;35685;10689;33431;1139;3984;7642;23990;8781;27974
231060;201401;2414;7798;2237;7491;207;944;1632;5308;1839;6252
231070;201401;9261;29909;8654;28734;1556;5592;5340;17851;6896;23443
231080;201401;4268;13567;3943;12992;283;1272;2919;9251;3202;10523
231085;201401;4696;15394;4563;15165;744;2629;3270;11029;4014;13658
231090;201401;4079;11706;3460;10484;234;880;2530;7552;2764;8432
231095;201401;2214;7528;1941;6990;230;888;1333;4878;1563;5766
231100;201401;3023;9630;2552;8684;244;936;1839;6210;2083;7146
231110;201401;3736;12696;3646;12541;408;1514;2642;9166;3050;10680
231120;201401;2431;8098;2276;7832;390;1398;1468;5111;1858;6509
231123;201401;2189;6129;1888;5632;143;442;1485;4447;1628;4889
231126;201401;6670;18817;5523;17197;427;1554;4208;12975;4635;14529
231130;201401;20078;64234;18565;61559;4777;16692;9496;32901;14273;49593
231135;201401;4609;13778;3934;12737;405;1556;2838;9059;3243;10615
231140;201401;15281;50990;14345;49100;1538;7089;10030;32970;11568;40059
231150;201401;5881;17637;5109;16190;1024;3641;2644;8160;3668;11801
231160;201401;5697;19796;5442;19310;1433;5339;3148;11210;4581;16549
231170;201401;4755;15508;4430;14862;495;2042;3032;10020;3527;12062
231180;201401;14966;46376;13787;44116;2704;9438;8222;26011;10926;35449
231190;201401;5056;14329;4251;13175;387;1373;3248;9967;3635;11340
231195;201401;4644;16127;4071;15006;392;1721;3013;11154;3405;12875
231200;201401;7540;26877;6759;25308;701;3263;4813;17841;5514;21104
231210;201401;5067;16017;4429;15137;326;1420;3380;11634;3706;13054
231220;201401;14090;41018;12125;37685;1279;4659;7790;24386;9069;29045
231230;201401;9651;34466;9103;33460;1276;5246;6402;23601;7678;28847
231240;201401;11710;38203;10724;36454;1593;6127;6877;23608;8470;29735
231250;201401;2075;6100;1455;4590;303;974;570;1718;873;2692
231260;201401;4037;11612;3687;11129;516;1667;2479;7651;2995;9318
231270;201401;7611;21916;6915;20832;663;2605;5017;14728;5680;17333
231280;201401;1725;5829;1633;5643;167;619;1193;4164;1360;4783
231290;201401;33019;119086;30629;113161;7830;31842;12559;45398;20389;77240
231300;201401;4550;13619;3813;12111;365;1435;2667;8173;3032;9608
231310;201401;7416;21872;6383;19789;1338;4352;3285;10112;4623;14464
231320;201401;6968;21994;6217;20546;437;1757;4665;15367;5102;17124
231325;201401;2559;8031;2305;7576;213;770;1702;5636;1915;6406
231330;201401;14127;44639;12082;40744;2021;7016;7441;25441;9462;32457
231335;201401;5111;14982;4533;13934;331;1308;3596;10808;3927;12116
231340;201401;17820;59305;16830;57907;1565;5180;13433;47628;14998;52808
231350;201401;12214;42152;12008;41829;1445;4849;9614;34315;11059;39164
231355;201401;4297;14177;4165;13960;242;818;3595;12237;3837;13055
231360;201401;7077;23872;6644;23163;1770;6047;3696;13521;5466;19568
231370;201401;2373;6914;1930;6242;120;479;1441;4594;1561;5073
231375;201401;4066;14238;3881;13887;414;1873;2966;10389;3380;12262
231380;201401;5274;17418;4980;17009;837;3076;3412;11918;4249;14994
231390;201401;3410;10906;3239;10656;292;1178;2443;7944;2735;9122
231395;201401;4226;13817;3813;13162;778;2813;2287;8083;3065;10896
231400;201401;10364;31531;9557;30090;1022;3774;6659;21043;7681;24817
231410;201401;14796;49633;13571;47973;1561;5539;9783;35940;11344;41479
240010;201401;2429;7760;2204;7243;558;2082;952;3006;1510;5088
240020;201401;11795;37556;10652;35415;2900;10424;4703;15885;7603;26309
240030;201401;2537;7661;2469;7550;239;921;1937;5774;2176;6695
240040;201401;786;2394;689;2208;51;245;493;1493;544;1738
240050;201401;3592;10104;3231;9498;241;874;2421;6994;2662;7868
240060;201401;1429;4343;1364;4234;127;474;1031;3107;1158;3581
240070;201401;2823;8276;2700;8045;448;1423;1735;5106;2183;6529
240080;201401;3029;8351;2810;8044;272;751;2220;6473;2492;7224
240090;201401;2221;6202;1913;5611;65;267;1509;4329;1574;4596
240100;201401;10297;30067;9646;28805;1270;4516;5973;17633;7243;22149
240110;201401;5206;16042;4669;15088;952;3513;2688;8297;3640;11810
240120;201401;3007;10092;2917;9932;606;2225;1792;6230;2398;8455
240130;201401;2781;7757;2419;7204;212;773;1841;5411;2053;6184
240140;201401;2256;7156;2066;6809;451;1685;1076;3505;1527;5190
240145;201401;6228;19706;5640;18652;1596;5920;2765;9090;4361;15010
240150;201401;1022;3169;849;2824;137;564;495;1578;632;2142
240160;201401;1455;4839;1334;4633;155;623;917;3212;1072;3835
240165;201401;886;2928;807;2778;112;415;523;1833;635;2248
240170;201401;2549;7839;2313;7400;614;2146;1084;3503;1698;5649
240180;201401;2966;9404;2796;9109;736;2544;1431;4839;2167;7383
240185;201401;1495;5027;1454;4954;185;660;1060;3667;1245;4327
240190;201401;952;2938;892;2819;95;374;625;1921;720;2295
240200;201401;14209;37575;12030;34920;2374;7074;7376;22296;9750;29370
240210;201401;2728;7893;2546;7656;241;851;2079;6188;2320;7039
240220;201401;7394;24111;7108;23729;401;1729;6222;20569;6623;22298
240230;201401;5466;15854;5073;15171;472;1664;3899;11499;4371;13163
240240;201401;1788;5706;1408;4692;375;1354;301;889;676;2243
240250;201401;2863;8338;2723;8136;213;780;2169;6370;2382;7150
240260;201401;14904;50581;14263;49532;2498;9856;9251;32105;11749;41961
240270;201401;2349;7843;2243;7662;258;897;1633;5704;1891;6601
240280;201401;1628;4722;1473;4446;135;496;1056;3141;1191;3637
240290;201401;1423;4529;1230;4175;111;530;783;2550;894;3080
240300;201401;2059;5809;1642;4994;400;1340;690;2043;1090;3383
240310;201401;10399;30028;9543;28662;2263;7410;4876;14610;7139;22020
240320;201401;2044;6166;1694;5444;104;459;1194;3693;1298;4152
240325;201401;37356;105468;30180;93645;9409;31831;9356;29572;18765;61403
240330;201401;1535;4693;1314;4255;166;670;796;2465;962;3135
240340;201401;1609;4900;1443;4664;255;882;948;3058;1203;3940
240350;201401;2085;6514;1983;6355;257;992;1542;4840;1799;5832
240360;201401;7366;22522;6516;21282;1040;3687;4274;14316;5314;18003
240370;201401;1984;5538;1778;5208;129;469;1322;3849;1451;4318
240375;201401;894;2403;805;2284;143;468;466;1279;609;1747
240380;201401;2682;8128;2266;7229;338;1129;1297;4125;1635;5254
240390;201401;900;2601;751;2309;80;303;501;1515;581;1818
240400;201401;1432;3902;1261;3678;136;507;944;2677;1080;3184
240410;201401;542;1783;498;1692;79;315;312;1044;391;1359
240420;201401;4830;18544;4663;18164;1397;5557;2284;9409;3681;14966
240430;201401;3493;10217;3243;9778;356;1232;2316;6912;2672;8144
240440;201401;2661;7255;2521;6995;662;1906;1327;3712;1989;5618
240450;201401;3850;11714;3528;11120;550;2110;2136;6621;2686;8731
240460;201401;2835;9294;2754;9164;298;1196;2138;7034;2436;8230
240470;201401;3744;11515;3101;10181;523;1882;1800;5880;2323;7762
240480;201401;408;1066;377;1009;38;88;240;653;278;741
240485;201401;2138;6532;1912;6110;405;1428;1048;3340;1453;4768
240490;201401;1653;4264;1455;3990;87;330;1136;2994;1223;3324
240500;201401;2094;6416;2009;6281;204;718;1535;4804;1739;5522
240510;201401;1783;5539;1668;5318;240;843;1191;3811;1431;4654
240520;201401;1437;4233;1272;3997;225;802;829;2549;1054;3351
240530;201401;2197;7048;1983;6703;269;988;1398;4718;1667;5706
240540;201401;1856;5691;1785;5568;178;634;1323;4101;1501;4735
240550;201401;769;2253;704;2147;56;213;537;1594;593;1807
240560;201401;3263;9641;3114;9421;334;1099;2469;7448;2803;8547
240570;201401;3109;8982;2575;7794;601;2064;1119;3093;1720;5157
240580;201401;8075;25451;7664;24765;1306;4510;5470;17580;6776;22090
240590;201401;851;2438;762;2286;55;216;555;1632;610;1848
240600;201401;1523;4583;1251;4024;194;720;682;2087;876;2807
240610;201401;5003;14170;4461;13234;506;1680;3019;8819;3525;10499
240615;201401;1049;3036;884;2722;149;470;504;1563;653;2033
240620;201401;1666;5525;1562;5336;240;919;1133;3858;1373;4777
240630;201401;2043;6376;1954;6221;185;566;1476;4895;1661;5461
240640;201401;927;2771;789;2553;94;408;516;1615;610;2023
240650;201401;3680;11591;3440;11268;312;1176;2762;9026;3074;10202
240660;201401;2512;8131;2414;7975;280;979;1805;6076;2085;7055
240670;201401;2747;8323;2378;7585;352;1318;1366;4240;1718;5558
240680;201401;1506;4475;1236;3979;165;549;732;2407;897;2956
240690;201401;1088;3122;966;2924;104;376;688;2068;792;2444
240700;201401;2633;8049;2224;7269;147;661;1694;5375;1841;6036
240710;201401;18601;47757;16578;45186;3106;8575;10161;28641;13267;37216
240720;201401;5560;16344;5360;16038;1338;4437;3028;9022;4366;13459
240725;201401;1080;3261;838;2719;77;262;469;1495;546;1757
240730;201401;2267;7108;2053;6701;207;759;1429;4611;1636;5370
240740;201401;2275;6900;2057;6500;265;908;1340;4244;1605;5152
240750;201401;2235;8369;2068;8061;476;1993;1138;4500;1614;6493
240760;201401;1195;3680;1147;3606;107;308;919;3002;1026;3310
240770;201401;3498;10392;3233;9990;425;1468;2263;7007;2688;8475
240780;201401;5897;16913;4912;15360;908;3062;2728;8734;3636;11796
240790;201401;860;2711;702;2416;45;177;532;1847;577;2024
240800;201401;40514;119224;37299;113686;10692;34911;15381;47644;26073;82555
240810;201401;93598;285429;88779;276647;28932;93962;39525;125350;68457;219312
240820;201401;6894;20790;6001;19392;1120;4053;3216;10738;4336;14791
240830;201401;9329;28965;8868;28300;791;2676;7200;23360;7991;26036
240840;201401;1286;3653;1129;3389;111;409;711;2107;822;2516
240850;201401;1155;3612;923;3138;188;727;455;1461;643;2188
240860;201401;1310;3748;1137;3476;90;322;826;2484;916;2806
240870;201401;1158;3248;1008;2965;128;469;665;1836;793;2305
240880;201401;1172;4055;1115;3976;152;679;783;2742;935;3421
240890;201401;5480;15631;4825;14469;823;2805;2671;7925;3494;10730
240895;201401;2778;9576;2553;9190;394;1511;1719;6300;2113;7811
240910;201401;2601;8439;2442;8135;246;987;1803;5962;2049;6949
240920;201401;858;2804;789;2645;198;747;392;1272;590;2019
240930;201401;3579;9856;3285;9461;308;943;2599;7570;2907;8513
240933;201401;1449;4392;1297;4131;279;983;695;2249;974;3232
240940;201401;6563;18766;5627;17142;1176;3799;2949;8984;4125;12783
240950;201401;1153;3655;1096;3565;109;453;781;2539;890;2992
240960;201401;773;2480;711;2355;75;305;521;1704;596;2009
240970;201401;2027;5783;1744;5302;167;610;1199;3608;1366;4218
240980;201401;3318;11090;3118;10711;720;2719;1819;6229;2539;8948
240990;201401;3056;9253;2882;8909;579;2021;1762;5305;2341;7326
241000;201401;1081;3084;959;2875;96;353;689;2031;785;2384
241010;201401;2991;10160;2723;9673;465;1898;1779;6177;2244;8075
241020;201401;2100;6036;1774;5423;184;665;1073;3133;1257;3798
241025;201401;1515;4746;1413;4559;131;553;995;3149;1126;3702
241030;201401;2541;8453;2349;8121;155;580;1887;6605;2042;7185
241040;201401;2133;7549;1971;7255;221;961;1428;5271;1649;6232
241050;201401;1310;3954;1195;3753;102;414;890;2712;992;3126
241060;201401;998;2905;914;2770;116;368;678;2066;794;2434
241070;201401;908;2668;796;2463;99;371;546;1635;645;2006
241080;201401;1169;3550;1044;3327;88;373;716;2204;804;2577
241090;201401;2164;6287;1881;5792;128;539;1517;4607;1645;5146
241100;201401;1212;3668;1076;3357;103;369;739;2268;842;2637
241105;201401;1142;3508;1091;3419;186;622;666;2160;852;2782
241110;201401;852;2748;730;2492;87;381;430;1429;517;1810
241120;201401;7990;24348;7310;23270;1505;4913;4725;15430;6230;20343
241140;201401;3416;9764;3065;9075;426;1330;2008;5884;2434;7214
241142;201401;699;2110;508;1691;150;570;133;393;283;963
241150;201401;5740;17501;5323;16787;904;3000;3459;11031;4363;14031
241160;201401;1107;3274;1049;3166;166;551;708;2132;874;2683
241170;201401;1333;4000;1226;3797;157;555;748;2410;905;2965
241180;201401;1011;2792;814;2435;115;396;473;1358;588;1754
241190;201401;1033;2914;919;2705;82;330;630;1731;712;2061
241200;201401;20601;62653;19229;60441;5198;17581;9566;30539;14764;48120
241210;201401;1488;4450;1275;4023;271;960;618;1924;889;2884
241220;201401;7933;27091;7611;26482;1830;6790;4127;14699;5957;21489
241230;201401;3010;9222;2756;8858;223;864;2193;7013;2416;7877
241240;201401;1147;3343;878;2769;77;250;504;1642;581;1892
241250;201401;5592;17969;4954;16713;352;1676;3943;12983;4295;14659
241255;201401;1869;7199;1781;7001;485;1995;789;3238;1274;5233
241260;201401;4974;13640;4069;12221;341;1294;2855;8403;3196;9697
241270;201401;2050;6223;1815;5775;264;956;1045;3349;1309;4305
241280;201401;2144;6318;2007;6048;389;1217;1232;3790;1621;5007
241290;201401;3279;9167;2673;8213;499;1664;1548;4754;2047;6418
241300;201401;1389;4089;1269;3898;77;274;1002;3101;1079;3375
241310;201401;1532;4899;1463;4793;217;694;1031;3496;1248;4190
241320;201401;906;3058;845;2930;174;665;450;1580;624;2245
241330;201401;1537;4911;1447;4787;157;618;1157;3789;1314;4407
241335;201401;2581;8098;2473;7911;212;673;2043;6592;2255;7265
241340;201401;1954;6153;1766;5761;460;1653;829;2635;1289;4288
241350;201401;1944;6285;1835;6074;168;712;1387;4467;1555;5179
241355;201401;1271;3589;1135;3354;69;229;978;2858;1047;3087
241360;201401;2100;5894;1894;5502;147;550;1369;3797;1516;4347
241370;201401;1338;4179;1099;3665;197;715;577;1911;774;2626
241380;201401;725;2107;634;1921;98;360;342;1021;440;1381
241390;201401;2889;9818;2749;9552;664;2420;1584;5652;2248;8072
241400;201401;3884;11561;3679;11269;494;1756;2701;8250;3195;10006
241410;201401;2634;7947;2432;7667;448;1558;1640;5130;2088;6688
241415;201401;1557;4906;1456;4722;140;537;1043;3344;1183;3881
241420;201401;2186;7741;1952;7373;619;2603;824;3134;1443;5737
241430;201401;445;1384;419;1318;53;187;276;836;329;1023
241440;201401;5954;22018;5612;21428;956;3874;3955;15244;4911;19118
241445;201401;1018;3218;971;3150;165;478;720;2475;885;2953
241450;201401;3248;9225;3015;8897;480;1598;2129;6213;2609;7811
241460;201401;3546;10508;3193;9827;291;1111;2273;6891;2564;8002
241470;201401;1343;3847;1173;3636;135;536;860;2590;995;3126
241475;201401;1234;3913;1101;3669;71;339;785;2546;856;2885
241480;201401;3236;10664;2969;10257;1003;3593;1113;4210;2116;7803
241490;201401;635;1727;523;1556;57;232;357;1003;414;1235
241500;201401;717;2329;702;2309;10;44;670;2204;680;2248
250010;201401;2672;8583;2381;8089;240;1021;1720;5709;1960;6730
250020;201401;1674;4868;1311;4207;119;504;864;2674;983;3178
250030;201401;7863;22884;7156;21912;914;2865;5305;16677;6219;19542
250040;201401;4471;15295;4174;14726;788;2977;2614;9318;3402;12295
250050;201401;3596;11518;3387;11215;540;1999;2270;7632;2810;9631
250053;201401;1274;3905;1231;3844;195;685;818;2546;1013;3231
250057;201401;722;2667;703;2642;41;132;609;2397;650;2529
250060;201401;4878;15736;4707;15453;639;2421;3514;11312;4153;13733
250070;201401;4183;13198;3952;12805;438;1809;3056;9590;3494;11399
250073;201401;778;2379;704;2239;84;305;485;1537;569;1842
250077;201401;2239;6641;1891;6082;280;984;1060;3450;1340;4434
250080;201401;4738;13960;4584;13739;593;1889;3354;10086;3947;11975
250090;201401;2609;7929;2528;7804;150;568;2118;6409;2268;6977
250100;201401;3938;13507;3775;13218;454;1794;2867;10017;3321;11811
250110;201401;5717;17620;5478;17284;835;2958;4013;12571;4848;15529
250115;201401;556;1846;496;1710;54;256;297;965;351;1221
250120;201401;2237;6688;1942;6143;182;679;1415;4422;1597;5101
250130;201401;5664;17462;5359;17030;322;1176;4446;14258;4768;15434
250135;201401;1075;3310;989;3163;118;419;682;2202;800;2621
250140;201401;2092;6809;1937;6608;262;914;1429;4977;1691;5891
250150;201401;5060;17231;4683;16536;544;2204;3391;11912;3935;14116
250153;201401;1579;4183;1433;3972;131;454;1103;3033;1234;3487
250157;201401;1621;5731;1499;5470;365;1310;804;3076;1169;4386
250160;201401;3304;10442;3206;10281;219;818;2718;8771;2937;9589
250170;201401;1588;4717;1495;4567;325;1059;912;2833;1237;3892
250180;201401;16537;52533;16051;51703;2664;9954;10928;34232;13592;44186
250190;201401;3944;11917;3681;11465;618;2085;2370;7305;2988;9390
250200;201401;2214;6178;1781;5596;142;521;1471;4594;1613;5115
250205;201401;1006;3362;926;3213;86;402;611;2173;697;2575
250210;201401;1635;5416;1517;5240;186;802;1081;3652;1267;4454
250215;201401;1410;4878;1371;4803;208;847;855;2979;1063;3826
250220;201401;811;2307;677;2141;48;180;576;1798;624;1978
250230;201401;1704;4397;1400;3896;142;445;1074;2912;1216;3357
250240;201401;2644;8519;2351;8069;239;893;1743;6059;1982;6952
250250;201401;4514;13877;4171;13405;402;1386;3333;10803;3735;12189
250260;201401;1900;5888;1685;5536;130;515;1268;4164;1398;4679
250270;201401;1269;4105;1176;3990;154;547;887;3049;1041;3596
250280;201401;3787;11492;3509;11046;739;2403;2164;7099;2903;9502
250290;201401;2143;5725;1779;5255;60;225;1555;4583;1615;4808
250300;201401;5459;16276;5171;15915;629;2572;4055;11955;4684;14527
250310;201401;1149;3726;1046;3553;167;678;744;2495;911;3173
250320;201401;7881;25185;7518;24420;1195;4440;4902;15486;6097;19926
250330;201401;2549;8112;2237;7687;270;1062;1662;5665;1932;6727
250340;201401;1131;3337;1059;3230;63;224;886;2708;949;2932
250350;201401;4532;12484;4151;12011;199;692;3570;10435;3769;11127
250355;201401;2101;6518;1927;6253;131;550;1519;4912;1650;5462
250360;201401;2037;6146;1899;5951;119;452;1480;4659;1599;5111
250370;201401;13634;38930;11928;36878;894;2864;10235;31949;11129;34813
250375;201401;1094;3489;1037;3391;68;274;859;2808;927;3082
250380;201401;1655;4749;1574;4647;105;365;1364;4010;1469;4375
250390;201401;1962;5325;1640;4790;212;679;1091;3194;1303;3873
250400;201401;65874;187669;59991;179174;14880;47503;32322;98302;47202;145805
250403;201401;1506;5075;1458;5004;206;788;1077;3659;1283;4447
250407;201401;1160;3369;1009;3113;65;228;790;2399;855;2627
250410;201401;660;2156;582;2018;70;304;431;1475;501;1779
250415;201401;1823;5811;1690;5547;96;418;1283;4125;1379;4543
250420;201401;1305;4129;1215;3986;103;419;996;3196;1099;3615
250430;201401;6554;18523;6222;18046;504;1788;5071;14407;5575;16195
250435;201401;1632;5012;1473;4714;182;689;891;2926;1073;3615
250440;201401;4513;13680;4326;13432;271;1017;3659;11325;3930;12342
250450;201401;2080;5924;1861;5634;93;348;1651;4970;1744;5318
250460;201401;6248;19228;5848;18679;804;2770;4309;13924;5113;16694
250470;201401;1600;4451;1462;4255;148;533;1062;3027;1210;3560
250480;201401;3957;11950;3581;11409;170;679;3098;9817;3268;10496
250485;201401;616;1651;522;1492;29;112;409;1122;438;1234
250490;201401;4147;13477;4052;13339;804;2856;2635;8740;3439;11596
250500;201401;1915;5923;1795;5719;348;1158;1082;3527;1430;4685
250510;201401;4962;13968;4403;13200;318;1166;3554;10569;3872;11735
250520;201401;1874;5872;1786;5719;359;1322;1021;3181;1380;4503
250523;201401;1798;5753;1713;5638;236;819;1283;4291;1519;5110
250527;201401;1459;4468;1374;4357;60;272;1223;3821;1283;4093
250530;201401;672;2088;595;1988;52;206;482;1612;534;1818
250535;201401;1289;4173;1235;4065;86;368;989;3180;1075;3548
250540;201401;2473;7326;2327;7164;88;291;2120;6573;2208;6864
250550;201401;912;3041;844;2933;72;308;637;2181;709;2489
250560;201401;1735;5669;1698;5615;139;517;1429;4732;1568;5249
250570;201401;2495;8292;2276;7874;214;881;1697;5799;1911;6680
250580;201401;1112;3174;932;2878;135;529;617;1820;752;2349
250590;201401;1052;3249;953;3118;83;356;741;2373;824;2729
250600;201401;7854;22713;7500;22200;748;2240;5930;17791;6678;20031
250610;201401;3376;10136;3165;9828;384;1305;2279;7091;2663;8396
250620;201401;868;2541;808;2422;138;451;520;1548;658;1999
250625;201401;2136;7065;2102;7019;81;225;1935;6553;2016;6778
250630;201401;10295;33605;9806;32746;2286;8271;5325;17770;7611;26041
250640;201401;3888;11581;3644;11295;304;1197;3015;9178;3319;10375
250650;201401;905;2716;860;2631;163;613;446;1384;609;1997
250660;201401;2172;5284;1672;4687;29;84;1579;4443;1608;4527
250670;201401;2686;9160;2557;8917;286;1196;1825;6361;2111;7557
250680;201401;4943;14337;4710;14003;286;1038;3988;11824;4274;12862
250690;201401;6306;17080;6110;16816;633;1965;5102;13845;5735;15810
250700;201401;5316;16163;4997;15692;782;2758;3453;10695;4235;13453
250710;201401;4576;14757;4230;14305;664;2320;2934;10232;3598;12552
250720;201401;2556;7866;2448;7680;176;688;1983;6166;2159;6854
250730;201401;3626;11470;3486;11252;480;1771;2473;7916;2953;9687
250740;201401;2022;6097;1782;5685;219;780;1236;3897;1455;4677
250750;201401;101683;305489;96721;297982;19101;65099;61309;186181;80410;251280
250760;201401;2227;6722;2078;6491;222;863;1511;4644;1733;5507
250770;201401;3830;13399;3655;13160;811;3129;2157;7829;2968;10958
250780;201401;1888;5771;1659;5356;178;719;1139;3604;1317;4323
250790;201401;2468;8144;2341;7965;622;2099;1417;4980;2039;7079
250800;201401;2718;8023;2411;7521;180;662;1802;5493;1982;6155
250810;201401;1360;4057;1188;3807;121;491;937;2933;1058;3424
250820;201401;2009;6304;1961;6228;113;421;1633;5240;1746;5661
250830;201401;5884;19678;5633;19183;750;3051;3814;12735;4564;15786
250840;201401;1041;3354;915;3099;121;468;578;1954;699;2422
250850;201401;2423;7077;2177;6680;208;829;1400;4443;1608;5272
250855;201401;1089;3278;1033;3191;67;237;853;2606;920;2843
250860;201401;2875;9886;2674;9493;645;2511;1149;4088;1794;6599
250870;201401;1199;3475;1040;3220;79;303;752;2249;831;2552
250880;201401;1361;4061;1288;3957;126;424;1008;3100;1134;3524
250890;201401;9276;30352;8655;29489;1599;6385;5544;18572;7143;24957
250900;201401;3071;10276;2758;9695;323;1175;1914;6851;2237;8026
250905;201401;2108;6667;2018;6548;347;1183;1442;4718;1789;5901
250910;201401;5328;15798;5006;15308;532;1791;3772;11570;4304;13361
250915;201401;1740;5216;1596;4999;153;478;1295;4131;1448;4609
250920;201401;3541;10181;3340;9901;455;1344;2356;7220;2811;8564
250930;201401;1932;6397;1859;6275;367;1425;1234;4089;1601;5514
250933;201401;1186;3870;1146;3809;140;535;819;2726;959;3261
250937;201401;871;2724;785;2548;117;469;462;1489;579;1958
250939;201401;1715;5438;1563;5189;256;916;1005;3354;1261;4270
250940;201401;3953;11720;3699;11324;268;965;2898;8897;3166;9862
250950;201401;1353;4236;1244;4100;75;262;1026;3432;1101;3694
250960;201401;1354;4274;1210;4083;73;275;1017;3484;1090;3759
250970;201401;8903;24646;8060;23492;1315;3958;5414;15922;6729;19880
250980;201401;2668;8220;2469;7871;266;1072;1711;5272;1977;6344
250990;201401;2107;7413;1999;7193;295;1252;1355;4771;1650;6023
251000;201401;2573;7383;2124;6747;136;519;1693;5348;1829;5867
251010;201401;2843;8290;2607;7952;222;801;2021;6184;2243;6985
251020;201401;1659;5145;1545;5002;159;570;1253;4103;1412;4673
251030;201401;1314;3747;1201;3559;128;453;761;2255;889;2708
251040;201401;1936;6225;1753;5942;181;853;1250;4078;1431;4931
251050;201401;1134;3406;1011;3194;162;555;546;1804;708;2359
251060;201401;1045;2586;851;2344;89;320;640;1680;729;2000
251065;201401;589;1771;518;1663;77;277;310;958;387;1235
251070;201401;598;1740;572;1699;53;218;449;1256;502;1474
251080;201401;21273;59919;20011;57845;5463;16821;10584;30965;16047;47786
251090;201401;3054;9733;2742;9162;312;1199;1950;6459;2262;7658
251100;201401;994;3279;896;3106;131;517;579;1963;710;2480
251110;201401;2113;6166;1912;5842;222;749;1315;4035;1537;4784
251120;201401;6000;20636;5830;20341;821;3380;4487;15345;5308;18725
251130;201401;3987;10417;3586;9970;48;155;3447;9590;3495;9745
251140;201401;4352;13648;4076;13217;261;1061;3145;10172;3406;11233
251150;201401;2819;9314;2617;9039;339;1370;1906;6652;2245;8022
251160;201401;1879;6284;1812;6195;99;394;1592;5463;1691;5857
251170;201401;1426;4466;1384;4413;136;516;1124;3527;1260;4043
251180;201401;2926;8843;2700;8556;631;2095;1552;5021;2183;7116
251190;201401;4312;12603;4195;12463;289;918;3687;10986;3976;11904
251200;201401;4230;13137;4038;12888;249;913;3497;11193;3746;12106
251203;201401;1334;4246;1248;4062;116;486;754;2553;870;3039
251207;201401;1241;3938;1084;3644;89;379;755;2487;844;2866
251210;201401;8063;23464;7126;22180;1050;3286;5074;16160;6124;19446
251220;201401;1294;3535;1141;3292;176;544;715;2131;891;2675
251230;201401;5190;15888;4601;15197;453;1706;3836;12631;4289;14337
251240;201401;3166;10508;3089;10390;333;1346;2420;8034;2753;9380
251250;201401;10364;31741;9735;30747;1677;5761;6638;20820;8315;26581
251260;201401;539;1675;487;1608;40;143;365;1210;405;1353
251270;201401;4166;13030;3962;12773;152;646;3567;11478;3719;12124
251272;201401;1369;4234;1288;4120;120;401;1006;3288;1126;3689
251274;201401;997;3182;948;3087;134;552;540;1801;674;2353
251275;201401;1388;3962;1320;3856;144;548;979;2761;1123;3309
251276;201401;1499;4502;1426;4371;221;744;859;2714;1080;3458
251278;201401;622;2019;545;1837;85;318;311;1097;396;1415
251280;201401;2310;7432;2233;7296;301;1114;1625;5300;1926;6414
251290;201401;6035;17551;5758;17199;894;3086;4044;11796;4938;14882
251300;201401;766;2643;711;2562;71;333;501;1763;572;2096
251310;201401;3215;9550;2972;9198;220;855;2374;7275;2594;8130
251315;201401;1695;6071;1653;5991;322;1269;987;3625;1309;4894
251320;201401;2135;6065;1788;5506;141;520;1283;4014;1424;4534
251330;201401;2053;5390;1709;4943;119;498;1430;3972;1549;4470
251335;201401;995;3472;956;3401;112;461;688;2423;800;2884
251340;201401;3922;11034;3350;10161;341;1304;2343;6927;2684;8231
251350;201401;1626;5060;1486;4865;256;930;959;3160;1215;4090
251360;201401;1831;6031;1745;5934;126;518;1462;4997;1588;5515
251365;201401;898;2683;730;2323;68;273;475;1477;543;1750
251370;201401;21975;75367;21606;74751;4278;16508;14580;49555;18858;66063
251380;201401;1390;4329;1225;4042;95;415;946;3038;1041;3453
251385;201401;869;2460;801;2349;77;291;544;1542;621;1833
251390;201401;5753;20717;5456;20246;1029;4149;3643;13462;4672;17611
251392;201401;1070;3176;995;3053;122;395;701;2191;823;2586
251394;201401;613;1909;517;1720;39;161;360;1190;399;1351
251396;201401;866;2530;795;2405;88;296;593;1765;681;2061
251398;201401;1133;3310;948;2961;90;345;638;1963;728;2308
251400;201401;1370;3966;1264;3822;160;622;878;2558;1038;3180
251410;201401;1624;4309;1480;4070;166;525;1000;2798;1166;3323
251420;201401;2188;6381;1882;6043;194;732;1409;4475;1603;5207
251430;201401;1729;6226;1578;5984;119;528;1288;4905;1407;5433
251440;201401;1465;4469;1258;4086;169;629;865;2775;1034;3404
251445;201401;1556;4934;1489;4832;127;506;1226;3927;1353;4433
251450;201401;4834;15278;4336;14641;173;726;3765;12733;3938;13459
251455;201401;1210;3798;1075;3577;86;372;756;2508;842;2880
251460;201401;881;2794;849;2738;151;493;625;2052;776;2545
251465;201401;503;1590;461;1503;54;212;294;939;348;1151
251470;201401;1297;3760;1081;3358;141;540;621;1929;762;2469
251480;201401;1134;3112;1029;2937;64;244;823;2307;887;2551
251490;201401;2091;6216;1824;5853;308;1166;1154;3621;1462;4787
251500;201401;1745;5834;1701;5764;210;825;1286;4303;1496;5128
251510;201401;2590;8741;2425;8386;436;1621;1435;5028;1871;6649
251520;201401;1095;3053;1002;2911;142;442;550;1608;692;2050
251530;201401;11862;35230;11403;34555;834;3196;9644;28741;10478;31937
251540;201401;2835;9429;2635;9002;286;1202;1934;6557;2220;7759
251550;201401;3970;9961;3379;9223;186;647;2742;7285;2928;7932
251560;201401;748;2332;694;2242;112;466;410;1199;522;1665
251570;201401;1042;3126;900;2838;112;434;562;1803;674;2237
251580;201401;2192;6070;2032;5854;339;923;1478;4369;1817;5292
251590;201401;1695;5656;1674;5633;116;409;1448;4956;1564;5365
251593;201401;1018;3265;971;3187;151;565;614;1951;765;2516
251597;201401;1955;6091;1886;5984;205;783;1443;4484;1648;5267
251600;201401;7295;21783;6974;21268;955;3016;5055;15762;6010;18778
251610;201401;3637;11019;3372;10676;367;1260;2548;8164;2915;9424
251615;201401;1220;3568;1052;3266;123;441;659;2109;782;2550
251620;201401;17304;49762;15407;47358;2392;7836;10845;33779;13237;41615
251630;201401;5362;13703;4727;12936;395;1127;3727;10333;4122;11460
251640;201401;2673;7867;2201;7016;272;1028;1485;4685;1757;5713
251650;201401;4382;12531;3958;12005;336;1145;3210;9877;3546;11022
251660;201401;3588;12133;3316;11717;276;1301;2653;9178;2929;10479
251670;201401;4006;11759;3616;11225;153;517;3135;9744;3288;10261
251675;201401;751;2539;718;2485;172;654;386;1302;558;1956
251680;201401;2875;8083;2351;7310;147;626;1912;5824;2059;6450
251690;201401;3422;10860;3196;10456;408;1478;2162;7041;2570;8519
251700;201401;2077;6937;1980;6808;223;871;1546;5291;1769;6162
251710;201401;941;2489;725;2114;101;366;374;1029;475;1395
251720;201401;1390;4334;1290;4168;118;477;985;3131;1103;3608
251740;201401;742;2102;602;1851;118;397;329;1025;447;1422
260005;201401;24806;61896;22146;58385;4922;13468;13369;35448;18291;48916
260010;201401;9592;26462;7788;24223;798;2685;5992;18693;6790;21378
260020;201401;5801;17288;5194;16375;635;1988;3723;12225;4358;14213
260030;201401;5384;16405;5003;15847;535;1882;3843;12160;4378;14042
260040;201401;10189;24748;8472;22795;600;1439;7020;19532;7620;20971
260050;201401;10835;35622;10156;34854;666;2450;8849;30711;9515;33161
260060;201401;4079;11420;3768;10927;346;1054;2938;8617;3284;9671
260070;201401;9391;29011;8992;28443;2307;7884;5304;16841;7611;24725
260080;201401;5422;15883;4854;15056;603;2120;3384;10414;3987;12534
260090;201401;5230;14441;4964;14081;1045;2762;3349;9949;4394;12711
260100;201401;3501;9444;3232;9089;246;918;2587;7295;2833;8213
260105;201401;4468;13641;4329;13385;871;2855;2731;8424;3602;11279
260110;201401;21599;64660;20057;62815;1621;5041;16872;53596;18493;58637
260120;201401;11552;36099;11143;35394;3190;10480;5535;18325;8725;28805
260130;201401;3099;9021;2961;8803;490;1369;2064;6354;2554;7723
260140;201401;13406;34931;11481;32561;1277;4118;8632;24773;9909;28891
260150;201401;3123;9205;2789;8721;239;907;2158;6789;2397;7696
260160;201401;5993;18260;5448;17622;485;1682;4451;14684;4936;16366
260170;201401;17559;48744;16904;47888;1539;4126;13796;39812;15335;43938
260180;201401;3478;10813;3204;10422;234;944;2614;8432;2848;9376
260190;201401;15925;38844;15129;37848;1011;2779;12929;32333;13940;35112
260200;201401;11224;32979;10285;31570;1272;4087;7313;23340;8585;27427
260210;201401;11359;35750;10551;34598;799;2946;8669;28777;9468;31723
260220;201401;8969;28700;8780;28424;782;3198;7372;23387;8154;26585
260230;201401;9704;29111;9295;28549;691;2232;7636;23907;8327;26139
260240;201401;2892;9249;2585;8815;396;1448;1773;6095;2169;7543
260250;201401;2775;7518;2565;7255;188;520;2148;6172;2336;6692
260260;201401;11402;33796;11179;33515;939;3109;9282;28387;10221;31496
260270;201401;3525;10833;3337;10558;409;1555;2591;8061;3000;9616
260280;201401;12601;42531;11663;41042;833;3291;9640;34321;10473;37612
260290;201401;33671;103491;32728;102026;5904;21010;22272;67952;28176;88962
260300;201401;8421;25951;7552;24700;684;2662;5872;19295;6556;21957
260310;201401;5117;15525;4828;15080;1547;4552;2328;7892;3875;12444
260320;201401;6780;23229;6361;22626;562;2166;5082;18316;5644;20482
260330;201401;3117;9773;2892;9395;281;1124;1909;6427;2190;7551
260340;201401;1869;5595;1786;5484;113;406;1556;4745;1669;5151
260345;201401;25847;86184;24959;84415;7657;28200;11339;37018;18996;65218
260350;201401;4367;12924;4195;12654;487;1668;3114;9376;3601;11044
260360;201401;2373;7550;2283;7402;574;1989;1213;4019;1787;6008
260370;201401;6043;18930;5534;18024;789;2669;3889;12953;4678;15622
260380;201401;4981;16459;4656;16050;430;1466;3762;13237;4192;14703
260390;201401;4750;15013;4164;14107;508;1975;2959;9871;3467;11846
260392;201401;3496;11151;3320;10918;179;704;2924;9572;3103;10276
260400;201401;13693;41022;13215;40252;2718;9299;8568;25532;11286;34831
260410;201401;62386;186974;59478;182179;20148;62666;26961;85519;47109;148185
260415;201401;4047;13260;3585;12374;553;2282;2166;7416;2719;9698
260420;201401;11994;28326;10989;27254;774;2184;9207;22803;9981;24987
260430;201401;2705;9171;2490;8829;264;1091;1873;6572;2137;7663
260440;201401;3395;10591;3185;10182;558;2000;1902;5996;2460;7996
260450;201401;5035;15712;4803;15310;449;1611;3724;11906;4173;13517
260460;201401;5846;18233;5531;17763;932;3349;3583;11371;4515;14720
260470;201401;5055;14857;4773;14469;521;1688;3694;11429;4215;13117
260480;201401;3864;11483;3492;10921;667;2274;2314;7207;2981;9481
260490;201401;6042;15969;5346;14876;710;2366;3529;9789;4239;12155
260500;201401;6765;18920;6305;18274;722;2219;4647;13715;5369;15934
260510;201401;10345;27735;9683;26839;851;2525;7548;21586;8399;24111
260515;201401;4710;14852;3758;12855;470;1791;2213;7688;2683;9479
260520;201401;15896;43457;15487;42929;3546;9259;10098;29258;13644;38517
260530;201401;10270;30778;9073;29154;533;1620;7854;25777;8387;27397
260540;201401;5799;15284;5538;14999;703;1649;4367;12253;5070;13902
260545;201401;42;162;29;119;4;19;6;23;10;42
260550;201401;2815;9570;2527;9029;673;2692;1159;4106;1832;6798
260560;201401;6747;17521;6098;16601;344;947;5305;14484;5649;15431
260570;201401;6521;22659;6124;21965;1061;4255;4115;14831;5176;19086
260580;201401;3916;11009;3725;10729;336;1089;3076;8721;3412;9810
260590;201401;5642;15075;5443;14840;256;644;4938;13659;5194;14303
260600;201401;25892;81722;24675;79656;4792;16566;15425;50423;20217;66989
260610;201401;7088;21386;6774;20953;1310;4285;4644;14423;5954;18708
260620;201401;17281;54284;16717;53348;3311;11868;10592;33058;13903;44926
260630;201401;2276;6911;1980;6431;243;946;1429;4596;1672;5542
260640;201401;17358;48084;16546;46913;2356;7298;11947;33740;14303;41038
260650;201401;5526;17756;5285;17355;797;2629;3468;12193;4265;14822
260660;201401;8253;23583;7487;22594;659;2114;6094;18585;6753;20699
260670;201401;2399;6920;2050;6447;285;1031;1351;4273;1636;5304
260680;201401;23394;64424;22173;62429;5079;15352;12240;34091;17319;49443
260690;201401;3555;9969;3109;9266;240;884;2450;7215;2690;8099
260700;201401;5529;16502;5422;16392;91;204;5229;16007;5320;16211
260710;201401;1300;4041;1190;3880;144;566;877;2812;1021;3378
260720;201401;17369;57563;16596;56176;4662;16214;8483;29565;13145;45779
260730;201401;7360;24515;6654;23488;884;3278;4909;17595;5793;20873
260740;201401;1359;4196;1208;3933;179;630;736;2435;915;3065
260750;201401;6752;21839;6377;21321;595;1966;5239;17897;5834;19863
260760;201401;4719;13394;4451;13048;537;1669;3313;9812;3850;11481
260765;201401;7914;28399;7703;28096;1549;6417;4888;17835;6437;24252
260770;201401;4283;11262;3937;10803;240;867;3166;8513;3406;9380
260775;201401;5297;15553;5035;15162;618;2228;3573;10457;4191;12685
260780;201401;3957;13213;3834;12991;927;3473;2161;7304;3088;10777
260790;201401;118838;310513;114776;304739;26876;75207;68253;181348;95129;256555
260795;201401;3019;9833;2846;9563;491;1765;1870;6408;2361;8173
260800;201401;4724;13065;4412;12647;245;990;3785;10563;4030;11553
260805;201401;4106;12125;3725;11538;598;1989;2470;7681;3068;9670
260810;201401;7420;21611;7239;21376;471;1672;6282;18427;6753;20099
260820;201401;4574;13398;4308;13031;1352;4166;2246;6884;3598;11050
260825;201401;3059;9938;2899;9707;299;1014;2333;7923;2632;8937
260830;201401;3660;12062;3418;11629;1014;3295;1841;6625;2855;9920
260840;201401;4205;12417;3903;11990;260;997;3304;10083;3564;11080
260845;201401;4171;12546;3899;12017;701;2328;2534;7808;3235;10136
260850;201401;4924;17102;4528;16260;1158;4745;2160;7549;3318;12294
260860;201401;2994;10001;2804;9692;355;1266;2038;7168;2393;8434
260870;201401;4160;11758;3804;11317;588;1646;2721;8373;3309;10019
260875;201401;7420;20027;6763;19015;1055;3072;4397;12743;5452;15815
260880;201401;8912;28728;8537;28195;1046;3507;6662;22337;7708;25844
260890;201401;14865;43096;14323;42299;1633;5529;10684;31565;12317;37094
260900;201401;6077;19006;5287;17679;1050;3706;3095;10544;4145;14250
260910;201401;3052;9483;2785;9078;307;1176;2118;6894;2425;8070
260915;201401;4538;15237;4417;15066;110;356;4107;14248;4217;14604
260920;201401;3478;10655;3313;10431;530;1851;2342;7510;2872;9361
260930;201401;4144;13319;3732;12744;535;1832;2644;9256;3179;11088
260940;201401;14011;40243;13043;38555;2538;8841;7348;21171;9886;30012
260950;201401;6111;19899;5850;19384;883;3729;3798;11814;4681;15543
260960;201401;67371;190329;64197;185278;13964;43104;36879;107355;50843;150459
260970;201401;5333;17572;5018;17096;668;2666;3577;12107;4245;14773
260980;201401;3998;12822;3825;12595;264;992;3187;10652;3451;11644
260990;201401;17972;56670;16715;54999;2444;7752;11991;41419;14435;49171
261000;201401;15148;43954;12700;39952;2864;9659;6676;21428;9540;31087
261010;201401;2801;7899;2631;7682;245;547;2187;6715;2432;7262
261020;201401;6200;18644;5738;17956;457;1740;4593;14013;5050;15753
261030;201401;3405;11493;3267;11264;344;1291;2583;8882;2927;10173
261040;201401;5376;17587;4701;16527;604;2434;3345;11740;3949;14174
261050;201401;8724;24968;8198;24151;1310;4046;5311;15625;6621;19671
261060;201401;11297;35527;10921;34901;1884;6700;7594;23926;9478;30626
261070;201401;48493;127929;44563;122575;10512;30307;25143;70054;35655;100361
261080;201401;5720;17781;5445;17332;449;1438;4499;14582;4948;16020
261090;201401;16035;45749;15115;44502;1650;5069;11884;35283;13534;40352
261100;201401;7313;23684;6838;22955;616;2494;5367;17910;5983;20404
261110;201401;66515;193044;61254;185517;15560;48533;33071;105825;48631;154358
261120;201401;3610;10004;3327;9653;155;465;2919;8567;3074;9032
261130;201401;7046;18537;6765;18224;290;796;6150;16581;6440;17377
261140;201401;3231;9271;3002;8911;639;2120;1780;5204;2419;7324
261150;201401;5530;16910;5015;16194;641;2329;3630;11844;4271;14173
261153;201401;1971;5733;1681;5329;115;444;1383;4400;1498;4844
261160;201401;223867;592067;214803;580001;46734;129928;129475;359249;176209;489177
261170;201401;5982;17006;5599;16451;903;2732;4065;12053;4968;14785
261180;201401;9465;27221;9191;26844;1162;3495;7042;20799;8204;24294
261190;201401;5382;17221;5146;16915;819;3562;3535;10969;4354;14531
261200;201401;3927;9804;3721;9532;623;1626;2576;6674;3199;8300
261210;201401;1931;5271;1861;5179;149;414;1585;4476;1734;4890
261220;201401;12493;41555;11146;38597;2195;8405;6011;20667;8206;29072
261230;201401;4048;12695;3837;12434;171;590;3456;11256;3627;11846
261240;201401;4860;14578;4631;14157;829;2503;3135;9763;3964;12266
261245;201401;3859;12280;3379;11485;270;1161;2458;8432;2728;9593
261247;201401;3499;11023;3082;10260;436;1541;2088;7030;2524;8571
261250;201401;19331;52561;18693;51709;3406;9737;13716;38076;17122;47813
261255;201401;4368;13512;3941;12814;335;1228;3036;10027;3371;11255
261260;201401;12201;35506;11282;34445;662;1817;9915;30907;10577;32724
261270;201401;3820;11167;3591;10816;510;1681;2503;7544;3013;9225
261280;201401;2741;8561;2515;8238;275;1038;1848;6041;2123;7079
261290;201401;3002;8713;2711;8340;243;849;2191;6815;2434;7664
261300;201401;10224;35021;9364;33547;1680;6744;5962;21260;7642;28004
261310;201401;8456;25989;8098;25397;1877;6244;4744;14887;6621;21131
261320;201401;5937;18774;5623;18170;690;2229;4124;13671;4814;15900
261330;201401;5478;16610;5339;16412;460;1518;4370;13488;4830;15006
261340;201401;4573;15121;4390;14838;688;2702;2864;9701;3552;12403
261350;201401;7948;27336;7582;26694;665;2879;5951;20754;6616;23633
261360;201401;9472;24788;8720;23780;1265;3594;5987;16674;7252;20268
261370;201401;20842;62892;19825;61399;3839;12654;13031;40587;16870;53241
261380;201401;4145;14514;3891;14086;633;2344;2623;9795;3256;12139
261390;201401;17034;53200;15735;50984;2815;10130;9512;30619;12327;40749
261400;201401;4829;17140;4459;16424;644;2693;3002;11137;3646;13830
261410;201401;8090;24393;7714;23814;1071;3442;5566;17519;6637;20961
261420;201401;7914;26880;7684;26533;2004;7601;4374;15317;6378;22918
261430;201401;3603;11255;3089;10581;419;1449;2240;7892;2659;9341
261440;201401;1661;5104;1553;4936;122;491;1248;3926;1370;4417
261450;201401;14104;41600;13744;41118;1078;3407;11967;35835;13045;39242
261460;201401;8484;24661;7965;23938;821;2344;5881;19091;6702;21435
261470;201401;3940;10824;3636;10473;238;773;3102;8904;3340;9677
261480;201401;3421;12722;3212;12338;422;1785;2355;8926;2777;10711
261485;201401;4938;15537;4611;14971;1080;3767;2514;8275;3594;12042
261500;201401;5914;16539;5310;15734;755;2050;3921;12199;4676;14249
261510;201401;2046;6608;1936;6452;168;570;1541;5203;1709;5773
261520;201401;2588;8552;2312;8077;212;861;1619;5673;1831;6534
261530;201401;12437;40823;11144;38329;2513;9651;5293;18192;7806;27843
261540;201401;7308;23867;7092;23498;1655;5249;4595;15824;6250;21073
261550;201401;3454;10567;3323;10377;468;1824;2529;7604;2997;9428
261560;201401;6833;22489;6313;21818;1348;4534;4274;15367;5622;19901
261570;201401;3504;11071;3206;10611;472;1628;2208;7412;2680;9040
261580;201401;5855;18947;5252;17971;461;1740;4150;14502;4611;16242
261590;201401;2833;7988;2509;7544;353;1142;1731;5298;2084;6440
261600;201401;5071;14405;4379;13423;533;1729;3199;9928;3732;11657
261610;201401;2294;7077;2017;6677;161;657;1646;5362;1807;6019
261618;201401;2566;7417;2431;7236;292;946;1876;5546;2168;6492
261620;201401;4541;14140;4325;13812;481;1650;3145;10247;3626;11897
261630;201401;8111;24100;7226;22557;1387;4966;3994;12170;5381;17136
261640;201401;32775;86441;30541;83662;2421;6918;25162;70048;27583;76966
261650;201401;3808;12371;3601;12063;506;1915;2673;8971;3179;10886
270010;201401;4431;17112;4089;16419;527;2457;2810;11297;3337;13754
270020;201401;3925;12218;3691;11849;553;2077;2640;8304;3193;10381
270030;201401;45080;138044;43253;135287;11944;38304;23972;77011;35916;115315
270040;201401;10343;32424;9936;31971;1596;4653;7486;25036;9082;29689
270050;201401;3978;11752;3705;11386;443;1651;2762;8355;3205;10006
270060;201401;1589;5452;1538;5381;379;1458;905;3146;1284;4604
270070;201401;4122;12963;3888;12627;173;788;3389;10855;3562;11643
270080;201401;1287;4134;1169;3966;256;961;703;2362;959;3323
270090;201401;2054;6578;2008;6523;59;237;1885;6112;1944;6349
270100;201401;6415;20349;6159;20012;1354;4701;3973;12850;5327;17551
270110;201401;3412;9810;3157;9513;593;1852;1983;6420;2576;8272
270120;201401;3038;9013;2750;8622;159;606;2328;7336;2487;7942
270130;201401;4984;15863;4754;15589;667;2127;3630;12310;4297;14437
270135;201401;1710;4992;1637;4909;91;192;1477;4560;1568;4752
270140;201401;9289;24400;8319;23146;883;3506;6410;16670;7293;20176
270150;201401;2606;9169;2548;9093;235;977;2138;7581;2373;8558
270160;201401;4872;16807;4520;16366;348;1249;3750;13782;4098;15031
270170;201401;4016;13457;3722;13013;843;3385;2030;7058;2873;10443
270180;201401;2230;7552;2009;7273;180;826;1590;5707;1770;6533
270190;201401;1891;6340;1810;6217;161;624;1412;4892;1573;5516
270200;201401;2716;9254;2572;9027;244;1102;2044;7015;2288;8117
270210;201401;4206;14526;4097;14375;491;2009;3311;11554;3802;13563
270220;201401;1698;5410;1594;5209;299;1147;861;2870;1160;4017
270230;201401;11108;36879;9904;35010;1570;6551;6638;23158;8208;29709
270235;201401;6474;21697;6182;21211;372;1635;5246;17928;5618;19563
270240;201401;9718;29538;8689;28181;1633;5592;5682;18568;7315;24160
270250;201401;3444;8972;3156;8650;182;495;2837;7804;3019;8299
270255;201401;5071;15695;4246;14264;432;1849;2958;9750;3390;11599
270260;201401;6311;20560;6152;20279;892;3448;4464;14730;5356;18178
270270;201401;1202;3499;1115;3369;191;614;701;2068;892;2682
270280;201401;3664;11132;3477;10866;482;1807;2448;7496;2930;9303
270290;201401;8312;29737;7951;29095;901;3708;6120;22373;7021;26081
270300;201401;3281;11511;3119;11320;197;877;2744;9941;2941;10818
270310;201401;7199;22775;6558;21658;445;2022;5267;16999;5712;19021
270320;201401;6250;20784;6059;20453;1717;6550;2984;10141;4701;16691
270330;201401;4799;16096;4554;15767;399;1490;3750;13110;4149;14600
270340;201401;1774;5566;1618;5366;215;771;1190;4021;1405;4792
270350;201401;2093;5945;1945;5754;341;1048;1240;3906;1581;4954
270360;201401;2091;6584;2048;6532;284;879;1624;5326;1908;6205
270370;201401;1715;5681;1594;5471;194;756;1078;3837;1272;4593
270375;201401;2897;9131;2769;8943;427;1735;1984;6136;2411;7871
270380;201401;6137;18904;5866;18534;609;1983;4541;14695;5150;16678
270390;201401;1444;4026;1306;3853;187;647;882;2520;1069;3167
270400;201401;6105;19055;5662;18430;601;2286;4119;13256;4720;15542
270410;201401;4977;15561;4753;15139;602;2088;3400;10798;4002;12886
270420;201401;5438;18013;5296;17814;301;1404;4510;14911;4811;16315
270430;201401;140585;413954;135490;406915;36098;111293;75933;234747;112031;346040
270440;201401;4976;15661;4735;15294;400;1478;3765;12251;4165;13729
270450;201401;6478;20638;6301;20412;645;2476;4990;16149;5635;18625
270460;201401;3551;10016;3218;9553;269;1018;2571;7450;2840;8468
270470;201401;10744;35264;10317;34514;1650;5598;6820;23538;8470;29136
270480;201401;3085;9955;2869;9572;361;1463;1874;6025;2235;7488
270490;201401;991;3208;939;3128;98;405;697;2275;795;2680
270500;201401;5358;18700;5190;18453;535;1960;4111;15038;4646;16998
270510;201401;6042;18928;5562;18252;954;4007;3939;12249;4893;16256
270520;201401;3691;12111;3497;11794;1029;3723;1719;5895;2748;9618
270530;201401;1533;4604;1370;4391;224;704;918;3078;1142;3782
270540;201401;2027;7157;1878;6934;185;913;1468;5287;1653;6200
270550;201401;7037;21675;6289;20682;1153;3974;4084;13828;5237;17802
270560;201401;2968;9529;2832;9307;566;2145;1872;5999;2438;8144
270570;201401;4304;14293;3978;13795;499;2096;2703;9339;3202;11435
270580;201401;1990;6756;1916;6633;331;1240;1339;4686;1670;5926
270590;201401;1359;4730;1279;4589;104;479;1067;3785;1171;4264
270600;201401;2823;9654;2587;9321;226;1116;2000;7014;2226;8130
270610;201401;3226;10359;3018;10053;338;1214;2338;7785;2676;8999
270620;201401;1464;5003;1335;4810;151;711;1001;3510;1152;4221
270630;201401;18201;51313;17283;49918;2625;7677;12508;36726;15133;44403
270640;201401;5846;18438;5345;17830;453;1917;4360;14283;4813;16200
270642;201401;2478;8562;2327;8320;427;1730;1482;5310;1909;7040
270644;201401;2277;6891;2124;6719;254;731;1722;5601;1976;6332
270650;201401;3988;12927;3855;12744;885;3469;2211;7109;3096;10578
270660;201401;2527;6620;2059;5907;167;607;1447;4073;1614;4680
270670;201401;15277;42739;13577;40667;1824;5864;9935;30406;11759;36270
270680;201401;4143;12876;4026;12738;249;740;3589;11490;3838;12230
270690;201401;8728;25250;8156;24549;2735;8118;3727;12207;6462;20325
270700;201401;803;2538;766;2480;131;521;476;1489;607;2010
270710;201401;5448;18723;5244;18451;652;2328;4116;14716;4768;17044
270720;201401;3315;11567;3090;11182;289;1351;2441;8707;2730;10058
270730;201401;6600;20794;6300;20412;1234;4090;4359;14369;5593;18459
270740;201401;2387;7213;2255;7016;372;1299;1457;4512;1829;5811
270750;201401;4714;15516;4438;15100;584;2078;3331;11449;3915;13527
270760;201401;3554;10808;3251;10312;426;1453;2327;7432;2753;8885
270770;201401;17785;48981;15385;46059;2994;9570;9603;29367;12597;38937
270780;201401;1931;6334;1804;6138;277;1005;1255;4329;1532;5334
270790;201401;1614;5187;1482;4971;406;1483;688;2323;1094;3806
270800;201401;11252;34471;10641;33683;1009;3548;8608;27285;9617;30833
270810;201401;3384;10619;2827;9598;398;1597;1732;5851;2130;7448
270820;201401;1892;6484;1749;6232;282;1151;1151;4066;1433;5217
270830;201401;5303;16653;4886;16114;1279;4717;2735;9033;4014;13750
270840;201401;7352;25823;6789;25088;506;2432;5628;20551;6134;22983
270850;201401;7589;25402;7437;25219;1518;6399;5041;16157;6559;22556
270860;201401;11443;35207;10810;34345;1774;6687;7710;23873;9484;30560
270870;201401;2273;6737;1860;5866;303;1026;1104;3483;1407;4509
270880;201401;7739;25580;7370;25041;526;2271;6179;20703;6705;22974
270890;201401;2619;8166;2450;7892;419;1610;1638;5128;2057;6738
270895;201401;3041;11419;2900;11236;276;1092;2379;9408;2655;10500
270900;201401;1914;5326;1580;4841;108;425;1222;3643;1330;4068
270910;201401;3220;11449;3163;11333;319;1439;2555;8914;2874;10353
270915;201401;9873;34370;9069;32894;1958;8101;5029;18121;6987;26222
270920;201401;6227;20030;5869;19523;319;1470;5074;16707;5393;18177
270930;201401;17072;47258;14297;43791;3150;10264;7980;25185;11130;35449
270940;201401;5755;19901;5589;19696;880;3338;4061;14437;4941;17775
280010;201401;719;2147;635;2010;70;278;407;1274;477;1552
280020;201401;4922;15040;4446;14185;921;3112;2651;8481;3572;11593
280030;201401;71799;194315;65120;184428;16512;49648;33525;96219;50037;145867
280040;201401;3154;10056;2871;9676;369;1274;2119;7374;2488;8648
280050;201401;4108;13373;3852;12990;1091;3734;2063;7314;3154;11048
280060;201401;4192;14386;4061;14171;982;3750;2360;8293;3342;12043
280067;201401;7536;21798;6456;20342;723;2528;4775;15024;5498;17552
280070;201401;1811;6440;1747;6345;346;1324;1166;4303;1512;5627
280100;201401;4018;12836;3656;12189;1000;3503;1748;5957;2748;9460
280110;201401;1370;4259;1269;4097;97;390;1010;3229;1107;3619
280120;201401;7845;25149;7339;24346;1289;4015;4953;17386;6242;21401
280130;201401;7778;22874;7354;22251;1306;4541;4830;14348;6136;18889
280140;201401;5435;15310;4947;14670;600;1818;3780;11362;4380;13180
280150;201401;3310;10522;3073;10091;493;1941;1933;6083;2426;8024
280160;201401;1539;4451;1413;4256;173;601;1002;3012;1175;3613
280170;201401;4555;14109;4207;13679;513;1675;3219;10824;3732;12499
280190;201401;1111;3278;1018;3133;110;439;718;2119;828;2558
280200;201401;1095;3488;1034;3388;168;693;734;2314;902;3007
280210;201401;12456;40366;11947;39617;2589;9028;7511;25545;10100;34573
280220;201401;1558;4848;1496;4771;101;385;1292;4115;1393;4500
280230;201401;3846;11401;3475;10781;722;2378;2008;6408;2730;8786
280240;201401;3415;10432;3149;10017;274;837;2475;8016;2749;8853
280250;201401;778;2127;697;2008;122;417;410;1100;532;1517
280260;201401;2044;5478;1878;5275;122;358;1608;4538;1730;4896
280270;201401;2207;7060;1957;6644;150;611;1512;5067;1662;5678
280280;201401;4050;13648;3788;13222;955;2948;2028;7960;2983;10908
280290;201401;16491;54258;15367;52336;2883;10603;10289;35358;13172;45961
280300;201401;10004;30782;9364;30067;853;2884;7775;25253;8628;28137
280310;201401;1438;4130;1287;3902;107;413;918;2712;1025;3125
280320;201401;7665;26062;7192;25231;1457;5788;3787;13243;5244;19031
280330;201401;4543;13222;4309;12926;545;1828;3303;9892;3848;11720
280340;201401;3732;11615;3600;11442;332;1095;2912;9530;3244;10625
280350;201401;21211;63676;20038;61923;3072;9852;14035;44281;17107;54133
280360;201401;5808;18774;5512;18314;1234;4614;3269;10757;4503;15371
280370;201401;1938;5608;1785;5361;216;766;1281;3756;1497;4522
280380;201401;982;3095;915;3005;115;456;690;2216;805;2672
280390;201401;3227;9694;2891;9100;777;2298;1599;5205;2376;7503
280400;201401;4404;12850;4055;12386;854;2528;2585;8274;3439;10802
280410;201401;2343;7805;2150;7460;371;1488;1279;4328;1650;5816
280420;201401;4119;12107;3867;11734;253;812;3326;10183;3579;10995
280430;201401;2162;5923;2047;5780;190;639;1662;4666;1852;5305
280440;201401;5048;15044;4740;14666;471;1504;3881;12150;4352;13654
280445;201401;2423;7051;2256;6763;114;454;1854;5445;1968;5899
280450;201401;8907;24436;8288;23713;772;1878;6882;20426;7654;22304
280460;201401;6830;19041;6188;18163;1122;3460;4159;12463;5281;15923
280470;201401;1791;5486;1644;5267;179;630;1233;3949;1412;4579
280480;201401;30586;94161;29602;92739;5323;19414;19608;59940;24931;79354
280490;201401;3698;11580;3436;11084;439;1603;2521;8121;2960;9724
280500;201401;882;2384;836;2328;33;109;740;2040;773;2149
280510;201401;2738;8129;2380;7655;311;1162;1751;5651;2062;6813
280520;201401;1718;4964;1590;4797;207;570;1209;3807;1416;4377
280530;201401;2049;6462;1960;6342;263;912;1486;4910;1749;5822
280540;201401;9058;25054;8568;24409;340;1183;7654;21680;7994;22863
280550;201401;7086;19428;6394;18336;639;2174;4651;13212;5290;15386
280560;201401;7838;23413;7448;22789;561;1946;6057;18454;6618;20400
280570;201401;6591;18821;6079;18170;928;3232;4174;12295;5102;15527
280580;201401;5622;17349;4906;16167;796;2757;3280;11026;4076;13783
280590;201401;2358;7300;2180;7085;294;1156;1613;5219;1907;6375
280600;201401;4008;12497;3789;12111;403;1580;2725;8546;3128;10126
280610;201401;2312;6878;2195;6702;343;1176;1413;4291;1756;5467
280620;201401;5033;15709;4553;14780;803;2777;2876;9434;3679;12211
280630;201401;3777;12622;3654;12432;369;1128;2925;10388;3294;11516
280640;201401;2239;6435;2096;6270;136;322;1852;5670;1988;5992
280650;201401;1102;3489;1028;3351;182;659;662;2164;844;2823
280660;201401;2611;7754;2515;7596;304;986;2043;6124;2347;7110
280670;201401;15720;42304;15018;41406;1806;5321;11428;31558;13234;36879
280680;201401;2749;7452;2405;7012;181;580;2019;5880;2200;6460
280690;201401;968;2851;856;2682;126;452;564;1704;690;2156
280700;201401;1155;3440;1019;3245;89;289;743;2415;832;2704
280710;201401;10385;29316;9805;28616;619;1889;8437;24704;9056;26593
280720;201401;2469;6804;2229;6514;199;625;1737;5154;1936;5779
280730;201401;940;2863;906;2815;84;283;757;2370;841;2653
280740;201401;12646;35268;11142;33067;1776;5194;7507;23008;9283;28202
280750;201401;3517;11135;3278;10710;298;1254;2383;7644;2681;8898
280760;201401;5702;17897;5272;17342;730;2388;3888;13331;4618;15719
290010;201401;2999;6785;2210;5578;83;336;1746;4150;1829;4486
290020;201401;4976;15818;4549;15382;398;1200;3936;13631;4334;14831
290030;201401;3188;10420;3101;10275;503;1798;2233;7361;2736;9159
290035;201401;4546;12523;4120;11970;315;983;3433;10082;3748;11065
290040;201401;3742;11069;3474;10742;288;1104;2837;8653;3125;9757
290050;201401;2727;9023;2576;8797;269;1036;1958;6747;2227;7783
290060;201401;1311;3410;1101;3160;239;782;733;2028;972;2810
290070;201401;30766;81751;26926;76994;6017;17917;14342;43279;20359;61196
290080;201401;5863;18202;5228;17401;665;2290;3907;13355;4572;15645
290090;201401;2274;5113;1833;4649;254;678;1447;3708;1701;4386
290100;201401;10164;29571;9015;27666;1806;5578;5111;16472;6917;22050
290110;201401;5240;16110;5077;15839;944;3208;3352;10380;4296;13588
290115;201401;4802;14669;4284;13986;321;1149;3297;10948;3618;12097
290120;201401;6722;18764;6282;18223;467;1354;5373;15729;5840;17083
290130;201401;4519;12024;3989;11410;343;970;3326;9648;3669;10618
290135;201401;5118;13414;4512;12444;485;1607;2997;8174;3482;9781
290140;201401;3836;12666;3421;12140;375;1455;2739;9753;3114;11208
290150;201401;2105;6315;2033;6215;200;660;1687;5143;1887;5803
290160;201401;3460;9765;3384;9673;375;731;2870;8593;3245;9324
290170;201401;2828;9574;2609;9225;244;1006;2100;7427;2344;8433
290180;201401;3017;8721;2679;8230;300;1053;1936;5956;2236;7009
290190;201401;4162;13904;4031;13680;438;1600;3053;10451;3491;12051
290195;201401;2204;6233;1917;5818;152;524;1523;4662;1675;5186
290200;201401;3819;12463;3514;11922;439;1583;2579;8797;3018;10380
290205;201401;2877;9251;2682;8960;428;1712;1864;6063;2292;7775
290210;201401;15778;43928;14917;42930;2473;5828;10708;33712;13181;39540
290220;201401;2398;7367;2303;7225;323;1209;1618;4921;1941;6130
290225;201401;3032;8341;2879;8176;222;482;2501;7376;2723;7858
290230;201401;2350;7927;2313;7878;221;790;1916;6609;2137;7399
290240;201401;3861;10433;3503;9939;420;1317;2537;7130;2957;8447
290250;201401;3765;12159;3218;11307;306;1143;2422;8640;2728;9783
290260;201401;4675;14647;4393;14216;488;1694;3403;11047;3891;12741
290265;201401;3333;10988;3167;10690;320;1292;2407;8086;2727;9378
290270;201401;11946;44614;11328;43727;1506;6162;8518;33524;10024;39686
290280;201401;5085;17215;4858;16781;696;2568;3349;11820;4045;14388
290290;201401;9553;31272;8812;30068;1708;6119;5676;19757;7384;25876
290300;201401;4382;12625;3408;10892;342;1176;2358;7720;2700;8896
290310;201401;1520;4681;1432;4559;245;909;969;3015;1214;3924
290320;201401;26046;82041;23565;78750;5228;18646;13891;47138;19119;65784
290323;201401;4036;11043;3344;10316;213;777;2862;8805;3075;9582
290327;201401;3958;12968;3718;12498;523;1875;2555;8615;3078;10490
290330;201401;1885;5103;1810;5021;270;850;1421;3876;1691;4726
290340;201401;5042;16193;4687;15730;1275;4454;2561;8785;3836;13239
290350;201401;4934;15222;4111;14134;580;2032;2831;10066;3411;12098
290360;201401;4103;13281;3748;12804;226;846;3252;11258;3478;12104
290370;201401;4517;13753;4218;13368;552;1753;3301;10639;3853;12392
290380;201401;5583;16602;4976;15752;377;1418;4054;12769;4431;14187
290390;201401;14918;49123;14309;48105;3034;9991;8871;31438;11905;41429
290395;201401;2767;9111;2519;8692;254;1100;1869;6441;2123;7541
290400;201401;3615;11360;3262;10866;550;1829;2256;7660;2806;9489
290405;201401;4394;14272;3867;13366;522;1876;2559;9120;3081;10996
290410;201401;5984;18204;5154;17014;589;2468;3730;11995;4319;14463
290420;201401;3313;9891;2779;9137;256;995;2169;7077;2425;8072
290430;201401;3436;11060;3130;10612;718;2471;1878;6618;2596;9089
290440;201401;2989;8046;2511;7447;205;702;2010;6032;2215;6734
290450;201401;3532;10533;3196;10051;640;1940;2045;6702;2685;8642
290460;201401;13065;41221;12381;40088;3735;12889;5575;17925;9310;30814
290470;201401;4714;13488;3793;12288;901;3325;1960;6450;2861;9775
290475;201401;5027;17895;4616;17175;516;2064;3381;12800;3897;14864
290480;201401;2630;6927;2348;6563;341;1057;1604;4529;1945;5586
290485;201401;4616;15322;4283;14861;473;2146;3310;11316;3783;13462
290490;201401;7831;21695;7600;21384;883;2719;6042;16975;6925;19694
290500;201401;4603;14866;4001;13774;785;2914;1964;6730;2749;9644
290510;201401;3398;10089;3003;9542;254;969;2352;7495;2606;8464
290515;201401;2797;8919;2670;8705;174;547;2151;7189;2325;7736
290520;201401;11642;36468;9591;32670;1149;4612;6055;20566;7204;25178
290530;201401;5249;15368;4538;14363;419;1394;3637;11581;4056;12975
290540;201401;3941;11469;3755;11231;503;1460;2841;8726;3344;10186
290550;201401;4384;11818;3887;11208;185;549;3446;9983;3631;10532
290560;201401;6043;18166;5406;17262;1145;3871;3278;10605;4423;14476
290570;201401;40029;118189;37736;114789;5273;17172;27308;82736;32581;99908
290580;201401;7244;25899;6982;25505;1443;5194;4638;17646;6081;22840
290590;201401;7443;24186;6310;22326;464;1927;5021;17746;5485;19673
290600;201401;18000;56568;17103;55198;2644;8673;11622;38734;14266;47407
290610;201401;2333;8297;1994;7631;201;953;1451;5472;1652;6425
290620;201401;7229;21752;6549;20789;548;1901;5378;17148;5926;19049
290630;201401;8189;22577;7258;21589;878;2628;5745;17306;6623;19934
290640;201401;2696;8074;2275;7352;263;935;1579;5110;1842;6045
290650;201401;11620;35019;10967;34034;3243;10164;5796;18774;9039;28938
290660;201401;3691;10467;3084;9610;207;747;2458;7699;2665;8446
290670;201401;6479;20776;5997;20043;919;2953;4431;15443;5350;18396
290680;201401;10295;30891;9612;30087;586;2024;8154;25712;8740;27736
290682;201401;4334;13157;3948;12630;211;847;3275;10408;3486;11255
290685;201401;3220;8461;2458;7396;325;1063;1486;4589;1811;5652
290687;201401;8171;22302;6588;20427;1162;3896;4109;12996;5271;16892
290689;201401;3127;8991;2659;8247;274;901;2028;6344;2302;7245
290690;201401;5411;16156;5002;15616;617;2083;3845;12064;4462;14147
290700;201401;2234;7152;2150;7034;233;823;1654;5453;1887;6276
290710;201401;7662;25189;7166;24403;407;1391;6247;21509;6654;22900
290720;201401;18409;55068;16523;52745;2290;6840;12760;42160;15050;49000
290730;201401;7362;20802;6750;20018;1394;4010;4335;13333;5729;17343
290740;201401;941;2865;806;2641;140;470;491;1659;631;2129
290750;201401;10026;29190;8763;26986;1612;5860;4847;14082;6459;19942
290755;201401;2418;6957;2066;6377;130;497;1630;4997;1760;5494
290760;201401;4478;13393;3726;12318;395;1305;2747;9207;3142;10512
290770;201401;2542;9020;2376;8802;150;665;1937;7226;2087;7891
290780;201401;8784;23496;7873;22256;1005;2535;5856;17201;6861;19736
290790;201401;4612;14060;4329;13659;499;1548;3315;10849;3814;12397
290800;201401;7252;16193;5579;14410;1066;2582;3943;10651;5009;13233
290810;201401;4902;15925;4320;15028;327;1228;3302;11674;3629;12902
290820;201401;5362;15729;4844;15019;569;2014;3591;11100;4160;13114
290830;201401;4030;11948;3835;11622;345;1414;2980;8699;3325;10113
290840;201401;17458;50175;16137;48371;2553;7384;11270;35326;13823;42710
290850;201401;6676;20300;6545;20104;1392;4255;4486;14210;5878;18465
290860;201401;4766;17355;4557;17079;734;2783;3281;12693;4015;15476
290870;201401;4759;14433;4031;13456;481;1917;2913;9601;3394;11518
290880;201401;1388;3933;1154;3573;117;373;763;2415;880;2788
290890;201401;6181;17832;5928;17495;750;2255;4538;13489;5288;15744
290900;201401;2422;7163;1855;6245;287;1095;942;3135;1229;4230
290910;201401;4767;13551;4158;12679;303;1012;3399;10416;3702;11428
290920;201401;4783;14424;4375;13893;360;1007;3560;11581;3920;12588
290930;201401;7375;24185;6741;23068;870;3313;4701;15942;5571;19255
290940;201401;3473;11295;3269;11040;277;995;2753;9458;3030;10453
290950;201401;1536;4426;1420;4268;219;702;998;3000;1217;3702
290960;201401;5900;17301;5439;16708;405;1283;4408;13758;4813;15041
290970;201401;3682;12178;3438;11768;489;1733;2274;8005;2763;9738
290980;201401;10595;32179;9507;30069;2773;9184;3777;11991;6550;21175
290990;201401;9150;27864;8275;26461;926;3144;6304;20265;7230;23409
291000;201401;3022;9457;2813;9190;407;1372;2106;7045;2513;8417
291005;201401;12985;37672;11921;36112;2205;7180;7741;23784;9946;30964
291010;201401;3047;10083;2509;8877;371;1420;1481;5271;1852;6691
291020;201401;1376;3729;1076;3197;126;461;626;1801;752;2262
291030;201401;2069;6004;1722;5270;177;590;1107;3361;1284;3951
291040;201401;5428;17374;5053;16831;750;2661;3600;12106;4350;14767
291050;201401;7991;26943;7381;25824;1947;7299;3788;13309;5735;20608
291060;201401;6207;23232;5942;22917;804;3554;4473;17181;5277;20735
291070;201401;16053;48175;14880;46510;1888;5613;11074;35773;12962;41386
291072;201401;20335;64853;17984;60296;6301;22617;5976;20999;12277;43616
291075;201401;5137;15326;4692;14731;325;1033;3640;11757;3965;12790
291077;201401;1539;4575;1318;4230;144;564;900;2844;1044;3408
291080;201401;80987;252105;73777;239701;21643;73915;29531;95439;51174;169354
291085;201401;5640;15384;4956;14468;606;1850;3781;11128;4387;12978
291090;201401;1394;3678;1238;3476;138;520;949;2550;1087;3070
291100;201401;2669;7240;2253;6804;128;523;1922;5753;2050;6276
291110;201401;4960;18080;4519;17387;763;3223;3026;11631;3789;14854
291120;201401;7536;20493;7122;19922;1015;2987;5281;14833;6296;17820
291125;201401;1639;3736;1344;3425;139;351;1018;2707;1157;3058
291130;201401;2996;9288;2641;8701;251;993;1885;6173;2136;7166
291140;201401;4086;12471;3841;12038;560;1833;2634;8362;3194;10195
291150;201401;2003;5276;1922;5179;182;529;1505;4026;1687;4555
291160;201401;5530;17094;4921;16211;1160;3980;2884;9569;4044;13549
291165;201401;2401;7251;1984;6470;140;604;1436;4563;1576;5167
291170;201401;20602;53960;17932;50680;1359;4626;14270;40050;15629;44676
291180;201401;6406;17179;5335;15756;616;2005;3896;11461;4512;13466
291185;201401;3820;10612;3629;10366;305;1003;3004;8475;3309;9478
291190;201401;7472;21367;6784;20549;908;2722;5026;15825;5934;18547
291200;201401;3077;9408;2635;8651;325;1248;1814;5932;2139;7180
291210;201401;7443;17921;6561;16945;575;1582;5209;13540;5784;15122
291220;201401;4163;13412;3966;13075;610;2280;2778;9031;3388;11311
291230;201401;3940;10462;3551;10007;173;479;3153;8984;3326;9463
291240;201401;4780;13285;4077;12068;301;939;3169;9315;3470;10254
291250;201401;3757;11444;3014;10223;315;1115;2117;7309;2432;8424
291260;201401;1161;3502;1103;3415;108;364;856;2645;964;3009
291270;201401;4414;15165;4206;14794;393;1525;3299;11717;3692;13242
291280;201401;2396;6172;1840;5521;515;1535;1039;3248;1554;4783
291290;201401;5950;16952;5404;16287;977;3039;3412;10600;4389;13639
291300;201401;4465;13387;3758;12210;493;1780;2477;8055;2970;9835
291310;201401;5309;15551;4718;14588;457;1497;3557;11028;4014;12525
291320;201401;5824;19311;5164;18045;1488;5747;2370;8108;3858;13855
291330;201401;1571;4969;1490;4838;210;804;943;2928;1153;3732
291340;201401;3828;11584;3101;10552;358;1419;2335;7869;2693;9288
291345;201401;3446;11487;3289;11318;249;885;2868;10008;3117;10893
291350;201401;6085;18351;5472;17428;635;2144;3694;12071;4329;14215
291360;201401;35967;105915;33868;102886;8225;25038;21046;66290;29271;91328
291370;201401;9041;26862;8700;26428;1108;3258;6566;20593;7674;23851
291380;201401;3841;11993;3418;11302;339;1142;2428;8285;2767;9427
291390;201401;10437;29509;9590;28524;1412;4097;7164;21738;8576;25835
291400;201401;16847;44811;13835;40811;2260;6866;8808;27036;11068;33902
291410;201401;3262;8584;2427;7378;202;832;1785;5246;1987;6078
291420;201401;2261;6048;2028;5769;92;223;1864;5378;1956;5601
291430;201401;3344;9991;2970;9503;257;1017;2309;7319;2566;8336
291440;201401;5945;19274;5129;17786;587;2178;3848;13544;4435;15722
291450;201401;7347;23182;6879;22438;434;1411;5668;18894;6102;20305
291460;201401;12946;40174;11689;38373;2403;8424;7254;24059;9657;32483
291465;201401;8100;23809;7409;23016;898;3094;5731;17811;6629;20905
291470;201401;15449;43807;13889;41896;1319;4080;10753;33408;12072;37488
291480;201401;34934;96158;31397;91277;5532;17955;19871;57437;25403;75392
291490;201401;4226;14521;4150;14416;522;1802;3325;11766;3847;13568
291500;201401;4171;12307;3653;11592;277;969;2942;9375;3219;10344
291510;201401;3532;11079;3336;10813;144;509;3028;9876;3172;10385
291520;201401;4040;11281;3621;10718;625;1766;2392;7543;3017;9309
291530;201401;2101;6240;1805;5774;499;1726;843;2778;1342;4504
291535;201401;4308;12776;3914;12206;355;1175;2924;9461;3279;10636
291540;201401;2201;5423;1904;5113;185;450;1566;4337;1751;4787
291550;201401;5632;15394;5109;14669;1320;3862;2687;7897;4007;11759
291560;201401;16872;44313;13458;40445;1634;5088;10041;30937;11675;36025
291570;201401;2349;6418;2248;6290;169;439;1950;5554;2119;5993
291580;201401;5854;18157;5259;17250;783;3091;3436;11189;4219;14280
291590;201401;2003;6325;1805;6003;324;1193;1124;3866;1448;5059
291600;201401;5518;15591;4145;13657;1024;3726;1996;6468;3020;10194
291610;201401;5200;15342;5060;15152;439;1492;4181;12476;4620;13968
291620;201401;3045;7327;2548;6801;182;461;2027;5625;2209;6086
291630;201401;3220;8182;2859;7781;279;722;2385;6668;2664;7390
291640;201401;17595;48909;14812;45299;3888;12996;6337;19517;10225;32513
291650;201401;8011;24385;7441;23729;658;1716;6253;20750;6911;22466
291660;201401;2375;6380;2131;6049;268;907;1463;4025;1731;4932
291670;201401;2501;7084;2324;6805;357;1110;1315;4113;1672;5223
291680;201401;4986;14393;4532;13671;1162;4013;2071;6440;3233;10453
291685;201401;4324;11274;3854;10715;428;1196;2903;8406;3331;9602
291690;201401;3980;11073;3322;10051;328;1014;2292;7029;2620;8043
291700;201401;9385;29750;8747;28719;1108;3758;6324;21225;7432;24983
291710;201401;5903;16034;5179;15091;1132;3551;2888;8788;4020;12339
291720;201401;3791;13470;3496;12860;394;1700;2588;9354;2982;11054
291730;201401;5805;18959;5463;18514;1273;4453;3428;11984;4701;16437
291733;201401;2614;7852;2249;7380;301;1037;1504;5020;1805;6057
291735;201401;2352;6925;2047;6468;126;490;1695;5302;1821;5792
291740;201401;3993;11765;3193;10537;337;1296;2230;7358;2567;8654
291750;201401;21826;58284;17517;51943;3934;12218;9337;28162;13271;40380
291760;201401;12119;39292;11331;37900;3983;14549;4866;16469;8849;31018
291770;201401;7991;23427;7318;22295;1271;4215;4748;14318;6019;18533
291780;201401;4267;13432;4071;13065;573;1820;2980;9698;3553;11518
291790;201401;2430;7833;2306;7668;161;661;1935;6385;2096;7046
291800;201401;31284;92646;28552;88774;6266;20399;16952;54089;23218;74488
291810;201401;10630;31071;9274;29477;681;2456;7496;24066;8177;26522
291820;201401;3584;11005;3286;10590;377;1240;2465;8061;2842;9301
291830;201401;4373;12002;4112;11625;567;1767;3056;8623;3623;10390
291835;201401;6083;19338;5116;17764;1197;4449;3081;10731;4278;15180
291840;201401;47361;133860;41142;127258;5288;16376;31903;100999;37191;117375
291845;201401;2998;8818;2715;8507;268;818;2304;7332;2572;8150
291850;201401;4824;13637;4089;12620;463;1387;3045;9677;3508;11064
291855;201401;1642;4484;1421;4199;235;787;991;2887;1226;3674
291860;201401;2001;6105;1762;5649;167;587;1154;3702;1321;4289
291870;201401;1330;3695;1084;3257;110;418;700;2075;810;2493
291875;201401;2829;9232;2581;8828;255;1049;1779;5973;2034;7022
291880;201401;4562;14714;4397;14468;332;1091;3737;12465;4069;13556
291890;201401;1412;3604;1199;3343;175;506;828;2346;1003;2852
291900;201401;1279;3741;1141;3540;122;434;858;2631;980;3065
291905;201401;2940;7907;2497;7206;227;773;1761;5140;1988;5913
291910;201401;2563;7148;2287;6797;175;648;1848;5436;2023;6084
291915;201401;6623;20913;5966;19621;534;1844;4857;16225;5391;18069
291920;201401;32534;96343;30278;93087;6337;20059;18102;57395;24439;77454
291930;201401;2548;7616;2329;7302;258;904;1744;5482;2002;6386
291940;201401;3571;10332;2746;8884;411;1512;1556;4885;1967;6397
291950;201401;9185;31462;8394;30192;2160;7915;4357;16165;6517;24080
291955;201401;7805;25849;7632;25590;1706;5808;4807;16558;6513;22366
291960;201401;3378;10162;2928;9546;366;1142;2070;7123;2436;8265
291970;201401;4410;13300;3941;12711;604;2040;2719;8946;3323;10986
291980;201401;11401;33318;8790;29561;1176;4119;6085;21007;7261;25126
291990;201401;2144;7052;1984;6805;216;773;1447;5103;1663;5876
291992;201401;2810;8776;2753;8667;513;1698;1911;5977;2424;7675
291995;201401;2114;6308;1906;6016;242;802;1412;4528;1654;5330
292000;201401;2325;7009;2119;6709;469;1652;1277;3992;1746;5644
292010;201401;6207;16300;4837;14255;488;1497;3665;10844;4153;12341
292020;201401;4445;15320;4133;14815;608;2372;2908;10589;3516;12961
292030;201401;2176;6931;1962;6628;252;946;1278;4360;1530;5306
292040;201401;4599;12998;4121;12501;362;1048;3423;10786;3785;11834
292045;201401;2438;8746;2411;8700;101;342;2241;8141;2342;8483
292050;201401;6332;20050;5631;18667;572;2365;3882;12667;4454;15032
292060;201401;10810;30901;10411;30367;1058;3182;8476;24814;9534;27996
292070;201401;4359;14117;4257;13992;395;1147;3709;12448;4104;13595
292080;201401;3698;9853;3236;9257;295;901;2594;7486;2889;8387
292090;201401;4240;11520;3671;10874;343;1172;2967;8809;3310;9981
292100;201401;11051;31055;9644;29325;2730;8704;5028;15902;7758;24606
292105;201401;3162;9772;2768;9225;211;853;2199;7313;2410;8166
292110;201401;7042;18802;5447;16504;1223;3883;3075;9607;4298;13490
292120;201401;8503;24335;7700;22933;1543;4822;4194;13136;5737;17958
292130;201401;3219;8689;2903;8250;627;1692;1863;5486;2490;7178
292140;201401;5482;14411;4805;13534;591;1676;3353;9804;3944;11480
292145;201401;2678;8316;2453;7972;215;686;1833;6250;2048;6936
292150;201401;13538;41728;12620;40278;923;3391;9866;31870;10789;35261
292160;201401;2704;7897;2340;7413;194;595;1912;6228;2106;6823
292170;201401;8657;26359;7499;24357;1152;4128;4666;15412;5818;19540
292180;201401;3488;10248;2875;9302;440;1483;1807;5964;2247;7447
292190;201401;3204;9223;2837;8708;578;1911;1796;5554;2374;7465
292200;201401;5638;19420;5137;18379;1586;6130;1948;7012;3534;13142
292205;201401;3981;12529;3672;12121;277;1068;2934;9687;3211;10755
292210;201401;6579;19235;5817;18213;524;1762;4585;14671;5109;16433
292220;201401;1908;5501;1814;5368;431;1220;1086;3267;1517;4487
292225;201401;2983;9558;2765;9240;200;719;2241;7586;2441;8305
292230;201401;6234;18960;5975;18565;700;2615;4532;13744;5232;16359
292240;201401;4388;14140;4101;13500;660;2371;2492;8100;3152;10471
292250;201401;5191;16240;4912;15726;1091;3646;2587;8350;3678;11996
292260;201401;3072;9679;2933;9474;329;1132;2280;7359;2609;8491
292265;201401;3060;10129;2804;9676;242;1010;2080;7128;2322;8138
292270;201401;3887;10855;3178;10023;276;1082;2528;7969;2804;9051
292273;201401;2784;6848;2162;6071;307;856;1525;4471;1832;5327
292275;201401;1891;5004;1780;4852;223;693;1339;3621;1562;4314
292280;201401;2055;6226;1881;6038;200;524;1453;4987;1653;5511
292285;201401;2590;7405;2309;7007;237;831;1753;5394;1990;6225
292290;201401;7342;22429;6239;21016;453;1724;4937;16941;5390;18665
292300;201401;8421;26246;7432;25155;2273;7820;4111;14469;6384;22289
292303;201401;2768;8920;2605;8698;114;443;2251;7543;2365;7986
292305;201401;3142;8657;2999;8471;106;330;2695;7645;2801;7975
292310;201401;5832;17972;5346;17306;281;1006;4527;14732;4808;15738
292320;201401;5892;18286;5351;17367;604;2310;4038;12987;4642;15297
292330;201401;1988;5745;1878;5604;239;799;1423;4192;1662;4991
292335;201401;5289;13989;4814;13371;407;1150;4026;11266;4433;12416
292340;201401;6520;19154;5736;17967;563;1898;4176;13189;4739;15087
292350;201401;2096;6564;1962;6402;240;902;1529;4959;1769;5861
292360;201401;4890;14501;4721;14000;184;563;4122;12506;4306;13069
292370;201401;8509;26278;7775;25185;1124;3540;5326;18163;6450;21703
292380;201401;7370;21686;6935;21012;603;1697;5665;17443;6268;19140
292390;201401;3709;8531;3301;8092;106;201;3092;7671;3198;7872
292400;201401;22049;65971;21164;64554;3188;10401;14742;45854;17930;56255
292405;201401;4338;11845;3810;11209;270;822;3178;9474;3448;10296
292410;201401;1878;5157;1795;5061;148;442;1558;4387;1706;4829
292420;201401;3727;12166;3602;12027;175;497;3269;11174;3444;11671
292430;201401;5438;16889;4548;15699;290;1205;3559;12281;3849;13486
292440;201401;8550;28287;7979;27454;299;1174;6962;24308;7261;25482
292450;201401;4395;13232;3633;12028;347;1266;2616;8804;2963;10070
292460;201401;5603;17065;5002;15993;985;3248;3059;9946;4044;13194
292465;201401;2354;7300;2050;6806;244;958;1466;4869;1710;5827
292467;201401;2169;7183;2064;7003;429;1575;1306;4486;1735;6061
292470;201401;3194;8672;2687;7869;229;814;1998;5769;2227;6583
292480;201401;5899;16645;5112;15544;374;1316;4189;12776;4563;14092
292490;201401;2315;6523;1967;6010;193;725;1453;4358;1646;5083
292500;201401;6579;20066;5779;18720;575;2193;4185;13635;4760;15828
292510;201401;13145;38246;11756;36314;1226;4134;9021;28300;10247;32434
292520;201401;5783;17983;5404;17343;1619;5313;2588;8451;4207;13764
292525;201401;5475;14538;4814;13763;414;1246;3845;11151;4259;12397
292530;201401;25078;76388;23187;74141;5266;17549;13903;45930;19169;63479
292540;201401;2809;8411;2568;8061;445;1620;1766;5471;2211;7091
292550;201401;6320;20970;5727;20100;953;3501;3882;13977;4835;17478
292560;201401;4209;11706;3629;10959;313;1140;2923;8698;3236;9838
292570;201401;4022;12009;3876;11855;131;407;3403;10751;3534;11158
292575;201401;5949;20650;5813;20402;1062;3858;4052;14278;5114;18136
292580;201401;7174;21389;6685;20778;574;1810;5536;17442;6110;19252
292590;201401;7194;23184;6897;22710;1005;3327;4949;16572;5954;19899
292593;201401;3254;8659;2777;7963;256;753;2128;6089;2384;6842
292595;201401;5892;16753;5205;15869;520;1712;3917;12050;4437;13762
292600;201401;10548;30112;9969;29392;1266;2994;7974;24641;9240;27635
292610;201401;4326;12702;3619;11525;514;1725;2310;7526;2824;9251
292620;201401;5829;18192;5164;17416;341;1293;4585;15505;4926;16798
292630;201401;9869;25262;8674;23521;827;2352;6537;18039;7364;20391
292640;201401;8234;26962;7345;25790;657;2432;5669;20440;6326;22872
292650;201401;4861;13467;4673;13251;528;1133;3725;11357;4253;12490
292660;201401;10982;34020;10542;33371;1512;4886;7737;25075;9249;29961
292665;201401;2869;8535;2810;8453;95;263;2617;7963;2712;8226
292670;201401;3842;11091;3041;9753;351;1258;1955;6312;2306;7570
292680;201401;3600;11016;3412;10752;319;1040;2793;8812;3112;9852
292690;201401;3332;9213;2462;7891;314;1128;1620;5288;1934;6416
292700;201401;9098;28133;8000;26557;1171;3702;5673;19758;6844;23460
292710;201401;1915;6385;1829;6258;97;366;1620;5562;1717;5928
292720;201401;9470;24835;8429;23664;774;2282;6986;19799;7760;22081
292730;201401;3360;10467;3264;10313;565;1736;2201;7192;2766;8928
292740;201401;349705;999504;334207;977075;80987;251124;196275;575316;277262;826440
292750;201401;5888;16405;5355;15700;396;1172;4344;12969;4740;14141
292760;201401;4207;13713;3911;13197;575;2135;2537;8667;3112;10802
292770;201401;6015;18762;5682;18239;1362;4457;3358;11174;4720;15631
292780;201401;1836;4580;1471;4138;202;702;1047;2883;1249;3585
292790;201401;3331;9064;3192;8914;276;653;2642;7734;2918;8387
292800;201401;9403;28771;8850;27889;951;3254;6784;21424;7735;24678
292805;201401;3135;9397;2900;9063;585;2001;1853;5837;2438;7838
292810;201401;9919;30603;8478;28708;1256;4451;6154;21363;7410;25814
292820;201401;7348;21439;5455;18776;442;1694;4374;15176;4816;16870
292830;201401;1874;5633;1704;5402;124;497;1378;4326;1502;4823
292840;201401;7174;23968;6726;23350;471;1821;5731;19951;6202;21772
292850;201401;3221;8621;2706;7863;346;1071;1892;5450;2238;6521
292860;201401;15159;41858;14604;41175;2029;5735;11178;31970;13207;37705
292870;201401;18914;53575;16951;50524;3392;11139;9682;28420;13074;39559
292880;201401;11733;35493;10684;33854;2013;6525;6565;21079;8578;27604
292890;201401;5495;19292;5005;18358;1023;3946;2816;10628;3839;14574
292895;201401;2718;6963;2236;6227;285;821;1622;4483;1907;5304
292900;201401;3041;9601;2886;9349;437;1691;1917;5996;2354;7687
292905;201401;4172;12473;3560;11699;328;996;2935;9962;3263;10958
292910;201401;5048;15927;4700;15283;843;2945;2950;9556;3793;12501
292920;201401;8494;25565;8101;24934;945;3197;6089;18299;7034;21496
292925;201401;5080;16155;4548;15423;404;1469;3555;12137;3959;13606
292930;201401;6441;21094;6165;20582;845;3450;4423;14391;5268;17841
292935;201401;2117;6082;1798;5732;137;349;1507;5032;1644;5381
292937;201401;3332;8613;2855;8016;318;1031;2189;6060;2507;7091
292940;201401;3045;8589;2453;7790;310;996;1624;5410;1934;6406
292950;201401;8240;25268;7898;24705;1042;3880;5670;17255;6712;21135
292960;201401;4521;12973;4215;12518;484;1597;2962;8720;3446;10317
292970;201401;4238;13403;3930;13011;196;807;3322;11009;3518;11816
292975;201401;3330;9335;3229;9179;366;1074;2626;7510;2992;8584
292980;201401;3544;10092;2931;9358;412;1584;2006;6366;2418;7950
292990;201401;12132;35258;11174;33825;766;2488;9456;28731;10222;31219
293000;201401;2939;7873;2428;7232;129;452;2099;6241;2228;6693
293010;201401;18497;53286;16432;50044;3238;10944;9895;30045;13133;40989
293015;201401;7927;26243;6520;24193;1147;4569;4074;15089;5221;19658
293020;201401;9367;31443;8796;30644;644;2519;7199;25379;7843;27898
293030;201401;5527;16379;4547;14940;472;1708;3124;10595;3596;12303
293040;201401;3778;12147;3627;11980;264;942;3112;10334;3376;11276
293050;201401;19636;56699;17624;54111;2913;9200;11505;36507;14418;45707
293060;201401;4303;11143;3660;10126;421;1277;2459;6747;2880;8024
293070;201401;19926;61587;18583;59300;5316;17710;9278;30227;14594;47937
293075;201401;3475;11165;3173;10809;298;1082;2593;8906;2891;9988
293076;201401;3710;10586;3485;10270;292;833;2895;8698;3187;9531
293077;201401;5074;15821;4428;15005;863;3120;2705;9310;3568;12430
293080;201401;4848;15429;4473;14819;329;1411;3517;11442;3846;12853
293090;201401;3565;11323;2955;10469;312;1110;2248;8135;2560;9245
293100;201401;5658;17601;4900;16284;539;1918;3597;12165;4136;14083
293105;201401;3848;12999;3430;12182;587;2139;2211;8027;2798;10166
293110;201401;1941;5920;1836;5747;112;430;1527;4756;1639;5186
293120;201401;4040;13705;3768;13325;348;1261;3006;10815;3354;12076
293130;201401;3930;11598;3225;10804;195;742;2818;9580;3013;10322
293135;201401;27828;73589;22047;65980;4270;15120;11258;33301;15528;48421
293140;201401;2083;6305;2023;6221;205;790;1555;4654;1760;5444
293150;201401;5838;19301;5299;18291;1103;3861;3033;10916;4136;14777
293160;201401;3443;9565;3280;9368;524;1167;2452;7464;2976;8631
293170;201401;3399;10565;3200;10268;457;1573;2310;7571;2767;9144
293180;201401;5346;15249;4508;13969;390;1445;3511;10714;3901;12159
293190;201401;13703;42200;13102;41302;622;2771;11276;34832;11898;37603
293200;201401;6296;18698;5648;17759;287;1066;4875;15260;5162;16326
293210;201401;4676;14396;4367;13882;547;1840;3077;9922;3624;11762
293220;201401;5157;15796;4685;15076;1239;4219;2339;7700;3578;11919
293230;201401;3907;12436;3627;12051;429;1642;2799;9258;3228;10900
293240;201401;4499;11864;3597;10626;191;577;2830;8362;3021;8939
293245;201401;4365;12886;4017;12325;509;1600;2807;8913;3316;10513
293250;201401;5951;17118;5498;16472;841;2671;3792;11392;4633;14063
293260;201401;4712;14325;3980;13289;361;1332;2967;10090;3328;11422
293270;201401;5817;16144;5532;15837;585;1574;4651;13603;5236;15177
293280;201401;5690;16267;4997;15366;434;1271;3852;12288;4286;13559
293290;201401;16415;55827;15641;54267;3613;12987;8781;31216;12394;44203
293300;201401;6310;16259;5473;15330;494;1360;4356;12375;4850;13735
293305;201401;4683;11993;4175;11297;310;921;3408;9234;3718;10155
293310;201401;2689;7047;2240;6320;254;820;1525;4248;1779;5068
293315;201401;4894;12600;4481;11979;740;1963;2781;7861;3521;9824
293317;201401;2538;7594;2322;7198;317;1010;1519;4749;1836;5759
293320;201401;8146;26814;7968;26583;965;3507;6383;21252;7348;24759
293325;201401;1920;5645;1604;5154;314;1078;994;3234;1308;4312
293330;201401;54737;175154;49673;166787;11351;41520;26643;90823;37994;132343
293340;201401;2720;7841;2182;6923;318;1153;1473;4574;1791;5727
293345;201401;3409;10483;2905;9761;366;1222;2028;7073;2394;8295
293350;201401;6703;18835;6442;18520;497;1351;5579;16341;6076;17692
293360;201401;13706;42058;12579;40580;784;2564;10660;35171;11444;37735
310010;201401;1222;3357;900;2845;238;901;377;1092;615;1993
310020;201401;3842;12289;3238;10981;1084;3983;574;1756;1658;5739
310030;201401;2447;8287;2197;7805;728;2698;913;3272;1641;5970
310040;201401;965;2717;828;2534;109;412;575;1709;684;2121
310050;201401;1903;6741;1700;6246;361;1562;796;2862;1157;4424
310060;201401;3053;10906;2937;10728;358;1354;2276;8481;2634;9835
310070;201401;308;910;228;754;34;146;102;303;136;449
310080;201401;766;2400;629;2134;175;683;200;624;375;1307
310090;201401;4715;14405;4135;13397;730;2671;2443;7919;3173;10590
310100;201401;3263;10245;2793;9487;340;1332;2020;6832;2360;8164
310110;201401;5875;16858;4997;15564;1124;4060;2653;8127;3777;12187
310120;201401;581;1939;555;1891;233;930;199;554;432;1484
310130;201401;456;1452;418;1394;109;415;198;624;307;1039
310140;201401;267;929;233;865;72;308;50;157;122;465
310150;201401;4816;15231;4426;14522;995;3717;2222;7214;3217;10931
310160;201401;7055;23195;6169;21605;1854;7222;2341;8027;4195;15249
310163;201401;765;2636;696;2494;190;782;254;865;444;1647
310170;201401;9675;28216;8972;27141;1831;5932;5385;16869;7216;22801
310180;201401;1833;5420;1500;4960;397;1493;686;2191;1083;3684
310190;201401;2519;8557;2295;8181;684;2702;330;1208;1014;3910
310200;201401;1878;6454;1600;5890;497;1985;504;1827;1001;3812
310205;201401;941;3039;865;2878;181;605;493;1691;674;2296
310210;201401;2445;7894;2273;7623;391;1453;1546;5172;1937;6625
310220;201401;1261;3652;1027;3357;213;762;595;1920;808;2682
310230;201401;2886;9660;2528;8870;764;3099;929;2974;1693;6073
310240;201401;1014;3623;871;3345;152;667;446;1793;598;2460
310250;201401;962;3382;940;3349;192;793;581;1976;773;2769
310260;201401;3162;10353;2711;9389;746;2935;1000;3363;1746;6298
310270;201401;2334;7145;2111;6813;264;966;1543;5008;1807;5974
310280;201401;2086;6192;1900;5893;647;2334;729;2115;1376;4449
310285;201401;2205;7871;2087;7695;265;935;1590;6066;1855;7001
310290;201401;1322;4186;1237;4058;385;1470;560;1620;945;3090
310300;201401;1882;6519;1786;6327;504;1955;941;3307;1445;5262
310310;201401;399;1125;296;909;58;197;139;419;197;616
310320;201401;367;1286;330;1189;84;348;145;501;229;849
310330;201401;487;1277;371;1076;46;176;205;530;251;706
310340;201401;8301;26798;7434;25377;1523;5490;4307;15167;5830;20657
310350;201401;14339;43147;11821;38553;4272;15147;2960;9719;7232;24866
310360;201401;446;1443;434;1422;92;356;277;851;369;1207
310370;201401;1432;5182;1382;5084;475;1817;605;2265;1080;4082
310375;201401;1268;3495;951;2945;153;570;486;1452;639;2022
310380;201401;395;1131;320;1024;137;489;116;333;253;822
310390;201401;485;1758;414;1596;118;504;67;227;185;731
310400;201401;10125;30902;8231;27528;2759;10190;2161;7133;4920;17323
310410;201401;1026;3343;680;2802;244;1091;113;444;357;1535
310420;201401;5664;16677;3416;11421;826;3126;522;1544;1348;4670
310430;201401;1591;5558;1353;5050;454;1810;342;1260;796;3070
310440;201401;621;1845;547;1730;156;562;197;578;353;1140
310445;201401;1177;4091;1019;3825;157;659;646;2469;803;3128
310450;201401;4408;13229;3715;12202;842;2925;2133;7222;2975;10147
310460;201401;1538;5086;1360;4767;469;1783;305;1133;774;2916
310470;201401;3700;9788;3173;9137;326;1113;2466;7116;2792;8229
310480;201401;1024;3277;893;3010;228;865;370;1170;598;2035
310490;201401;3277;11286;2891;10545;980;3914;1012;3699;1992;7613
310500;201401;1479;5206;1376;5008;440;1768;517;1825;957;3593
310510;201401;2495;8384;2206;7727;810;3078;470;1561;1280;4639
310520;201401;1284;3690;1131;3435;99;314;742;2267;841;2581
310530;201401;839;2732;575;2071;124;498;95;334;219;832
310540;201401;3670;12299;3420;11927;1197;4442;1258;4472;2455;8914
310550;201401;1159;3630;988;3342;318;1248;349;1092;667;2340
310560;201401;15991;51066;14013;47225;4674;17527;4547;14571;9221;32098
310570;201401;1265;3993;1193;3897;168;642;869;2798;1037;3440
310590;201401;4118;12388;3329;10884;662;2496;1193;3699;1855;6195
310600;201401;1617;5503;1537;5332;515;2001;512;1657;1027;3658
310610;201401;549;1904;510;1816;154;649;173;554;327;1203
310620;201401;185809;600328;155226;538226;42782;165721;57239;189869;100021;355590
310630;201401;4119;13776;3918;13402;892;3504;2379;7845;3271;11349
310640;201401;1445;4538;1195;4099;396;1478;334;1077;730;2555
310650;201401;2866;9328;2383;8512;525;2031;1187;4346;1712;6377
310660;201401;1287;4090;1150;3899;198;786;800;2638;998;3424
310665;201401;1168;3734;1085;3618;209;747;709;2407;918;3154
310670;201401;55871;178650;52009;170074;16157;56085;21411;68804;37568;124889
310680;201401;795;2417;736;2322;176;611;368;1140;544;1751
310690;201401;1218;4238;1026;3828;298;1289;248;881;546;2170
310700;201401;519;1457;445;1349;130;446;209;597;339;1043
310710;201401;7287;24131;5908;21866;1482;6169;2064;7484;3546;13653
310720;201401;842;2653;776;2529;239;902;344;1020;583;1922
310730;201401;9309;30212;8671;29219;2047;7495;5011;16958;7058;24453
310740;201401;4966;17317;4330;15967;1627;6528;1013;3555;2640;10083
310750;201401;1592;4226;1330;3872;252;769;828;2421;1080;3190
310760;201401;604;1946;533;1826;134;501;229;770;363;1271
310770;201401;716;2682;709;2674;307;1274;266;956;573;2230
310780;201401;3590;10541;3267;9997;588;1832;2004;6208;2592;8040
310790;201401;1730;5688;1605;5493;472;1691;804;2814;1276;4505
310800;201401;3039;10105;2515;9056;1043;4095;367;1283;1410;5378
310810;201401;1518;4309;1405;4127;369;1225;658;1816;1027;3041
310820;201401;1479;4301;1103;3652;318;1165;332;1039;650;2204
310825;201401;2362;8270;1950;7543;168;872;1446;5515;1614;6387
310830;201401;1424;4916;1214;4467;442;1743;344;1209;786;2952
310840;201401;2206;7539;2004;7113;769;2998;524;1728;1293;4726
310850;201401;1515;4681;1304;4399;235;911;881;2927;1116;3838
310855;201401;3057;10198;2798;9788;748;2751;1495;5417;2243;8168
310860;201401;7652;24574;6901;23297;1298;4563;3895;13653;5193;18216
310870;201401;1020;2988;875;2732;204;706;396;1217;600;1923
310880;201401;1245;3925;957;3384;195;786;445;1571;640;2357
310890;201401;2718;8831;2172;7795;657;2646;467;1568;1124;4214
310900;201401;4299;14653;3789;13663;1172;4703;1472;5099;2644;9802
310910;201401;1989;5879;1459;4897;431;1625;337;1078;768;2703
310920;201401;1845;5853;1518;5375;410;1660;719;2539;1129;4199
310925;201401;931;3155;851;3021;315;1242;252;890;567;2132
310930;201401;5187;15671;4287;14259;921;3284;2341;8018;3262;11302
310940;201401;6166;18642;5392;17487;1096;3941;2965;9607;4061;13548
310945;201401;1281;3710;1044;3385;242;913;552;1714;794;2627
310950;201401;1919;6605;1608;5978;618;2543;432;1502;1050;4045
310960;201401;458;1600;412;1512;145;584;140;519;285;1103
310970;201401;1465;5239;1149;4376;425;1761;126;428;551;2189
310980;201401;465;1235;332;994;61;218;140;366;201;584
310990;201401;1143;3996;1000;3705;224;948;356;1234;580;2182
311000;201401;4580;16179;4136;15232;1340;5514;1371;4805;2711;10319
311010;201401;950;3110;846;2924;267;984;386;1299;653;2283
311020;201401;872;2808;757;2622;140;553;353;1179;493;1732
311030;201401;1836;5669;1467;4901;485;1813;478;1414;963;3227
311040;201401;502;1725;438;1552;120;446;103;351;223;797
311050;201401;2596;8477;2222;7748;720;2745;829;2884;1549;5629
311060;201401;2331;7472;1943;6619;554;2027;447;1488;1001;3515
311070;201401;1707;6181;1518;5792;458;1991;463;1722;921;3713
311080;201401;1193;3252;1077;3072;160;527;701;2015;861;2542
311090;201401;1655;6394;1462;5974;509;2350;263;1007;772;3357
311100;201401;2293;8179;2075;7730;949;3682;476;1788;1425;5470
311110;201401;3817;9535;2867;8219;618;2015;1442;4011;2060;6026
311115;201401;1091;3404;960;3209;129;551;602;2022;731;2573
311120;201401;8620;25637;7190;23063;2383;8547;1920;5698;4303;14245
311130;201401;2402;7480;1960;6903;661;2669;776;2608;1437;5277
311140;201401;1236;3680;1075;3481;191;727;723;2297;914;3024
311150;201401;2412;8139;2236;7856;567;2059;1135;4116;1702;6175
311160;201401;4855;16713;4188;15609;1522;6092;1294;4745;2816;10837
311170;201401;745;2347;598;2060;55;214;329;1190;384;1404
311180;201401;1574;4458;1164;3651;367;1277;232;637;599;1914
311190;201401;1091;3342;936;3026;249;935;340;999;589;1934
311200;201401;2523;7908;2219;7294;900;3233;497;1459;1397;4692
311205;201401;1179;3925;1058;3694;278;1111;383;1376;661;2487
311210;201401;908;3025;840;2915;174;604;575;2056;749;2660
311220;201401;912;2968;738;2568;203;744;234;810;437;1554
311230;201401;8907;27586;7658;25472;1680;6097;3815;13072;5495;19169
311240;201401;1346;4207;1133;3856;378;1451;324;1047;702;2498
311250;201401;1318;4459;1207;4289;387;1501;354;1113;741;2614
311260;201401;2930;8123;2231;6878;725;2468;600;1747;1325;4215
311265;201401;1316;3577;1031;3190;168;634;669;2040;837;2674
311270;201401;3357;11323;3039;10906;639;2675;1868;6571;2507;9246
311280;201401;1385;3939;1069;3353;284;987;327;1002;611;1989
311290;201401;2308;7659;2150;7332;418;1413;1224;4345;1642;5758
311300;201401;5003;16905;4593;16276;783;3138;2906;10402;3689;13540
311310;201401;490;1767;476;1745;124;538;182;619;306;1157
311320;201401;4026;13787;3557;12744;986;4004;1172;3965;2158;7969
311330;201401;5489;17103;4737;15904;1726;6251;1478;4939;3204;11190
311340;201401;12055;39730;11113;37977;4003;14776;3173;10773;7176;25549
311350;201401;2292;6962;1986;6425;457;1767;880;2701;1337;4468
311360;201401;1328;3798;1069;3455;469;1607;291;971;760;2578
311370;201401;4473;13661;4025;12891;1012;3971;1660;4989;2672;8960
311380;201401;472;1592;405;1464;130;532;107;342;237;874
311390;201401;1945;7356;1867;7203;813;3498;554;2031;1367;5529
311400;201401;1698;5756;1581;5555;471;1876;662;2137;1133;4013
311410;201401;1997;7369;1875;7191;672;2766;864;3344;1536;6110
311420;201401;2307;8120;2024;7435;734;2873;421;1376;1155;4249
311430;201401;3876;12406;2997;10474;722;2780;565;1917;1287;4697
311440;201401;2226;7864;1889;7324;776;3348;427;1631;1203;4979
311450;201401;2328;8415;2083;7851;744;3005;569;2039;1313;5044
311455;201401;1549;4302;1369;4055;300;1017;754;2160;1054;3177
311460;201401;604;2029;502;1818;125;574;126;426;251;1000
311470;201401;592;1903;482;1675;137;568;142;447;279;1015
311480;201401;794;2287;761;2234;270;826;276;759;546;1585
311490;201401;312;1251;302;1219;114;482;93;372;207;854
311500;201401;512;1571;425;1411;160;581;142;454;302;1035
311510;201401;3116;9871;2619;8934;1009;3881;663;2113;1672;5994
311520;201401;686;2396;655;2332;253;971;240;829;493;1800
311530;201401;10986;29867;7711;24102;2189;8169;2078;6125;4267;14294
311535;201401;699;2195;529;1849;134;532;111;377;245;909
311540;201401;702;2568;672;2522;255;976;295;1103;550;2079
311545;201401;2124;6866;2034;6731;348;1273;1361;4505;1709;5778
311547;201401;1655;4684;1419;4325;150;499;949;2912;1099;3411
311550;201401;3289;10947;2922;10212;942;3641;875;2977;1817;6618
311560;201401;277;753;247;716;58;192;132;365;190;557
311570;201401;2004;5174;1709;4828;132;392;1427;4102;1559;4494
311580;201401;2317;5234;1977;4821;585;1409;1097;2747;1682;4156
311590;201401;375;1226;329;1163;91;386;89;310;180;696
311600;201401;1326;4092;1160;3882;247;849;667;2343;914;3192
311610;201401;3493;12251;3246;11859;935;3391;1590;6278;2525;9669
311615;201401;2614;8787;2321;8279;317;1260;1579;5672;1896;6932
311620;201401;443;1450;400;1392;116;476;192;624;308;1100
311630;201401;1453;4394;1254;4032;344;1097;594;1953;938;3050
311640;201401;889;2792;759;2584;140;511;523;1789;663;2300
311650;201401;2426;7017;2040;6407;332;1212;1128;3550;1460;4762
311660;201401;2540;9130;2297;8558;680;2831;446;1447;1126;4278
311670;201401;1381;4375;1221;4082;467;1716;442;1421;909;3137
311680;201401;2262;7229;1938;6772;509;1886;1019;3651;1528;5537
311690;201401;522;1492;442;1396;88;310;280;870;368;1180
311700;201401;2123;6300;1905;5983;201;814;1442;4421;1643;5235
311710;201401;1703;5362;1361;4755;591;2276;360;1206;951;3482
311720;201401;403;1405;377;1352;79;302;227;800;306;1102
311730;201401;4895;13410;3304;10627;1035;3689;1125;3374;2160;7063
311740;201401;1001;2900;875;2752;396;1253;360;1192;756;2445
311750;201401;3808;13178;3574;12859;624;2491;2335;8490;2959;10981
311760;201401;789;2771;742;2672;263;1097;240;731;503;1828
311770;201401;2552;8176;2121;7413;612;2414;672;2260;1284;4674
311780;201401;1004;3859;879;3542;300;1340;143;556;443;1896
311783;201401;2056;6860;1857;6495;214;933;1211;4336;1425;5269
311787;201401;652;2294;484;1799;96;379;95;315;191;694
311790;201401;1271;4189;1065;3777;307;1167;232;796;539;1963
311800;201401;3791;13225;2841;10260;675;2658;209;616;884;3274
311810;201401;1040;3549;1005;3482;45;213;868;2963;913;3176
311820;201401;819;2749;707;2482;238;960;309;980;547;1940
311830;201401;10325;37756;9572;35839;3959;15580;2052;7633;6011;23213
311840;201401;3417;10379;2954;9684;1017;3670;1112;3549;2129;7219
311850;201401;315;964;274;897;74;259;126;410;200;669
311860;201401;48275;153803;42675;143049;11662;42987;17714;57647;29376;100634
311870;201401;2299;7069;1907;6333;494;1879;628;1950;1122;3829
311880;201401;6894;21277;6407;20659;982;3205;4478;15040;5460;18245
311890;201401;1594;5103;1359;4611;416;1576;508;1640;924;3216
311900;201401;800;2530;729;2432;156;533;438;1538;594;2071
311910;201401;4659;14012;3855;12920;1200;4372;1522;5153;2722;9525
311920;201401;2042;6810;1790;6444;217;902;1246;4442;1463;5344
311930;201401;4761;14556;4298;13791;1642;5744;1266;4038;2908;9782
311940;201401;12645;39724;11073;36500;3784;13768;2636;8284;6420;22052
311950;201401;2262;6852;1975;6498;136;451;1647;5496;1783;5947
311960;201401;370;1328;341;1264;120;481;114;402;234;883
311970;201401;468;1714;411;1592;136;582;69;246;205;828
311980;201401;743;2134;581;1895;144;506;258;868;402;1374
311990;201401;492;1536;447;1470;186;656;135;411;321;1067
311995;201401;1034;3240;808;2736;216;824;199;562;415;1386
312000;201401;670;2148;643;2108;110;413;365;1185;475;1598
312010;201401;1034;3376;947;3191;191;695;434;1468;625;2163
312015;201401;1580;4952;1380;4612;231;906;793;2678;1024;3584
312020;201401;914;3029;822;2897;222;884;429;1481;651;2365
312030;201401;1773;5416;1603;5194;252;924;1164;3727;1416;4651
312040;201401;667;2587;598;2386;219;985;136;512;355;1497
312050;201401;1499;5228;1309;4826;402;1638;262;907;664;2545
312060;201401;743;2307;663;2198;324;1148;176;519;500;1667
312070;201401;939;2988;644;2327;177;696;225;796;402;1492
312080;201401;2585;7374;2045;6529;476;1831;906;2619;1382;4450
312083;201401;938;2745;801;2553;111;415;498;1570;609;1985
312087;201401;2320;7181;2091;6870;396;1368;1372;4613;1768;5981
312090;201401;9781;32289;9022;30989;2835;10821;3650;12037;6485;22858
312100;201401;1345;4644;1191;4399;277;1145;644;2436;921;3581
312110;201401;1170;4248;1055;3996;372;1552;197;670;569;2222
312120;201401;903;3187;823;3012;266;1100;204;652;470;1752
312125;201401;1171;3878;1047;3603;286;1080;432;1472;718;2552
312130;201401;810;2524;671;2226;166;633;250;785;416;1418
312140;201401;1149;3653;976;3245;217;790;367;1111;584;1901
312150;201401;575;1663;493;1499;57;204;310;917;367;1121
312160;201401;7947;27781;7375;26651;2425;9594;2536;9246;4961;18840
312170;201401;1009;3080;920;2897;131;448;565;1809;696;2257
312180;201401;1587;5019;1474;4830;454;1562;559;1822;1013;3384
312190;201401;646;2167;519;1914;212;882;94;311;306;1193
312200;201401;4666;14476;4116;13551;551;1918;2828;9390;3379;11308
312210;201401;1155;3270;936;2941;260;921;396;1183;656;2104
312220;201401;1867;6261;1706;6078;296;1113;1209;4478;1505;5591
312230;201401;17777;60319;15265;55278;7139;27552;2604;9699;9743;37251
312235;201401;1762;5097;1477;4656;196;757;953;2992;1149;3749
312240;201401;1103;3831;956;3522;293;1156;312;1143;605;2299
312245;201401;2372;7079;2087;6700;182;542;1697;5581;1879;6123
312247;201401;889;2702;701;2404;216;824;324;1127;540;1951
312250;201401;1123;3374;1002;3172;220;779;481;1486;701;2265
312260;201401;896;3001;782;2850;112;510;544;1949;656;2459
312270;201401;783;2550;690;2369;184;765;222;638;406;1403
312280;201401;469;1637;433;1553;183;702;47;160;230;862
312290;201401;773;2730;727;2664;295;1193;149;546;444;1739
312300;201401;1109;3745;941;3357;295;1118;115;354;410;1472
312310;201401;941;3650;864;3460;282;1216;340;1333;622;2549
312320;201401;2416;6987;2012;6207;563;1983;545;1412;1108;3395
312330;201401;1124;3501;1018;3342;309;1157;476;1555;785;2712
312340;201401;306;824;287;796;52;192;201;510;253;702
312350;201401;371;980;348;953;50;164;274;711;324;875
312352;201401;1625;5479;1524;5340;531;1890;780;2835;1311;4725
312360;201401;3636;12560;3219;11701;1069;4208;774;2763;1843;6971
312370;201401;1644;5486;1532;5293;527;2022;557;1848;1084;3870
312380;201401;1989;5979;1834;5732;277;935;1240;3986;1517;4921
312385;201401;1201;3861;1133;3733;170;687;771;2439;941;3126
312390;201401;2017;6928;1770;6414;578;2272;355;1234;933;3506
312400;201401;3338;11289;3056;10750;1039;3771;1264;4617;2303;8388
312410;201401;10445;35726;9503;33842;2923;11391;3215;11136;6138;22527
312420;201401;3989;13088;3813;12883;734;2536;2576;8980;3310;11516
312430;201401;8469;25691;7566;24349;1436;4910;4753;15792;6189;20702
312440;201401;596;1988;532;1867;178;678;194;678;372;1356
312450;201401;1125;4213;1042;4035;478;1884;324;1251;802;3135
312460;201401;396;1233;356;1188;91;349;178;562;269;911
312470;201401;748;2184;529;1742;137;535;102;326;239;861
312480;201401;1287;4047;1124;3858;418;1508;465;1582;883;3090
312490;201401;2323;6190;1861;5576;292;1050;1099;3195;1391;4245
312500;201401;593;2123;563;2070;157;680;274;971;431;1651
312510;201401;2022;7104;1795;6595;527;2174;578;1928;1105;4102
312520;201401;392;1359;351;1271;122;481;107;384;229;865
312530;201401;565;1911;541;1859;110;452;294;954;404;1406
312540;201401;1450;4732;1186;4210;204;843;689;2374;893;3217
312550;201401;622;2045;563;1923;70;280;355;1181;425;1461
312560;201401;2120;5810;1897;5517;241;806;1398;4092;1639;4898
312570;201401;2652;8312;2375;7803;751;2650;680;2155;1431;4805
312580;201401;521;1773;428;1590;111;486;171;595;282;1081
312590;201401;1825;6290;1635;5884;546;2226;489;1589;1035;3815
312595;201401;2001;6909;1797;6413;528;2033;753;2605;1281;4638
312600;201401;775;2851;719;2724;219;941;278;978;497;1919
312610;201401;8467;27109;7358;24926;2722;9966;2057;6724;4779;16690
312620;201401;2045;6021;1578;5415;100;324;1293;4627;1393;4951
312630;201401;507;1743;471;1674;136;550;196;663;332;1213
312640;201401;580;1937;482;1729;113;461;197;664;310;1125
312650;201401;2326;7072;1735;5974;202;835;905;3069;1107;3904
312660;201401;1231;3501;1067;3292;198;736;670;1995;868;2731
312670;201401;5879;18639;5496;18036;1406;5341;2764;8760;4170;14101
312675;201401;1439;4653;1293;4366;252;903;676;2314;928;3217
312680;201401;1697;5279;1526;4992;254;963;900;2985;1154;3948
312690;201401;2405;6726;2011;6179;418;1507;1082;3194;1500;4701
312695;201401;891;3242;839;3162;152;581;546;2132;698;2713
312700;201401;2164;6451;1698;5571;334;1268;852;2738;1186;4006
312705;201401;1389;4215;1235;4003;195;665;844;2753;1039;3418
312707;201401;1754;5528;1466;5039;283;1158;750;2530;1033;3688
312710;201401;7939;23005;6099;19804;2340;8466;1355;4071;3695;12537
312720;201401;755;2593;691;2472;203;809;267;901;470;1710
312730;201401;1877;4778;1445;4316;215;764;912;2733;1127;3497
312733;201401;1754;4814;1375;4115;122;463;969;2782;1091;3245
312735;201401;874;2684;780;2544;287;994;338;1105;625;2099
312737;201401;1034;2558;731;2145;250;771;267;834;517;1605
312738;201401;499;1648;409;1480;140;594;147;478;287;1072
312740;201401;499;1446;345;1245;125;500;92;336;217;836
312750;201401;1276;4753;1224;4644;348;1482;558;2084;906;3566
312760;201401;2401;7900;1945;7022;612;2474;443;1622;1055;4096
312770;201401;44189;124505;35124;110925;10482;36113;11041;34712;21523;70825
312780;201401;2739;9970;2479;9518;563;2364;1352;5318;1915;7682
312790;201401;364;989;235;764;71;249;61;187;132;436
312800;201401;5120;17762;4532;16555;1468;5809;1357;5056;2825;10865
312810;201401;2176;6811;1654;5923;575;2271;326;1083;901;3354
312820;201401;2118;6429;1965;6180;270;1014;1231;3735;1501;4749
312825;201401;1519;4236;1351;4031;150;483;1054;3136;1204;3619
312830;201401;2692;8824;2017;7477;581;2403;308;1121;889;3524
312840;201401;1134;3870;973;3570;237;1017;366;1257;603;2274
312850;201401;691;2299;601;2118;180;729;184;627;364;1356
312860;201401;1303;3816;1021;3397;351;1362;326;951;677;2313
312870;201401;5578;17994;4438;15875;1301;5283;1184;4045;2485;9328
312880;201401;1180;3627;997;3310;248;947;433;1360;681;2307
312890;201401;1551;4880;1256;4350;449;1763;414;1352;863;3115
312900;201401;1363;4674;1320;4605;369;1340;732;2597;1101;3937
312910;201401;1469;3500;1168;3099;332;1050;502;1215;834;2265
312920;201401;984;3300;876;3145;302;1212;344;1181;646;2393
312930;201401;2170;6607;1958;6311;448;1555;1003;3291;1451;4846
312940;201401;917;3132;830;2965;238;1004;256;851;494;1855
312950;201401;3443;10019;2839;9121;987;3482;1122;3561;2109;7043
312960;201401;1897;5891;1715;5653;222;737;1268;4289;1490;5026
312965;201401;1741;5759;1525;5362;357;1368;808;2902;1165;4270
312970;201401;1127;3946;1019;3805;424;1786;171;613;595;2399
312980;201401;20682;73885;20028;72304;7920;30581;6906;24193;14826;54774
312990;201401;398;1253;308;1090;116;460;89;300;205;760
313000;201401;513;1772;455;1662;145;650;143;440;288;1090
313005;201401;2594;8581;2324;8129;398;1538;1404;4931;1802;6469
313010;201401;4002;13663;3634;13046;1130;4466;1386;4720;2516;9186
313020;201401;1044;3622;952;3409;308;1250;292;922;600;2172
313030;201401;1559;4481;1269;4088;367;1360;623;1878;990;3238
313040;201401;957;3432;817;3033;208;850;204;728;412;1578
313050;201401;1853;6216;1579;5801;514;2085;529;1878;1043;3963
313055;201401;1472;5068;1388;4948;149;526;1041;3846;1190;4372
313060;201401;937;3339;882;3213;405;1531;145;523;550;2054
313065;201401;1902;6472;1774;6279;277;1132;1271;4451;1548;5583
313070;201401;1242;3730;1020;3316;265;1011;479;1470;744;2481
313080;201401;466;1493;383;1333;116;466;103;298;219;764
313090;201401;5196;16174;4889;15627;818;2863;3271;10574;4089;13437
313100;201401;1098;3623;1028;3520;176;679;712;2398;888;3077
313110;201401;1677;5107;1353;4506;339;1350;504;1539;843;2889
313115;201401;2843;10174;2731;9947;924;3756;1172;4022;2096;7778
313120;201401;3768;11168;3275;10445;1181;3979;1366;4421;2547;8400
313130;201401;25911;84243;23702;79657;7218;26830;8181;26081;15399;52911
313140;201401;721;1916;536;1629;50;188;337;1002;387;1190
313150;201401;1645;5230;1496;4974;660;2275;396;1374;1056;3649
313160;201401;1175;3611;1061;3429;229;871;614;1888;843;2759
313170;201401;9680;36133;9033;34531;3524;14059;1851;7112;5375;21171
313180;201401;2684;7199;2078;6407;668;2323;679;2013;1347;4336
313190;201401;3495;13130;3268;12491;942;3856;1193;4509;2135;8365
313200;201401;1495;4777;1349;4551;223;911;832;2805;1055;3716
313210;201401;4553;14694;3933;13864;986;3959;2015;6970;3001;10929
313220;201401;1250;3883;970;3282;251;965;235;704;486;1669
313230;201401;2521;9036;2381;8823;431;1681;1481;5719;1912;7400
313240;201401;8043;27902;7013;25960;2091;8463;2712;10078;4803;18541
313250;201401;7635;24382;7007;23387;1268;4327;4230;14592;5498;18919
313260;201401;601;1922;507;1745;145;575;136;439;281;1014
313270;201401;5501;16619;5000;15878;844;2833;3315;10699;4159;13532
313280;201401;525;1767;423;1510;93;379;93;300;186;679
313290;201401;1034;3771;870;3435;281;1194;208;766;489;1960
313300;201401;1943;6791;1694;6159;537;2102;353;1187;890;3289
313310;201401;1051;3770;967;3593;266;1131;208;715;474;1846
313320;201401;2374;7404;2031;6821;460;1659;834;2801;1294;4460
313330;201401;3847;12869;3482;12185;765;3078;1662;5751;2427;8829
313340;201401;2170;5360;1724;4736;372;1089;965;2606;1337;3695
313350;201401;3318;10522;2623;8980;685;2524;502;1541;1187;4065
313360;201401;1182;3660;921;3162;308;1251;370;1131;678;2382
313370;201401;1450;5136;1377;4928;295;1223;592;1948;887;3171
313375;201401;2022;5528;1401;4626;369;1472;510;1630;879;3102
313380;201401;6663;23241;5882;21534;2338;9229;1474;5097;3812;14326
313390;201401;909;3363;879;3316;140;622;568;2102;708;2724
313400;201401;3711;11108;3464;10802;436;1482;2629;8326;3065;9808
313410;201401;1349;3930;1162;3681;267;939;666;2097;933;3036
313420;201401;19129;48463;12842;37265;3135;10369;2953;8239;6088;18608
313430;201401;1306;4312;1185;4107;378;1467;406;1328;784;2795
313440;201401;6480;15952;4972;14208;786;2451;3441;9873;4227;12324
313450;201401;720;2179;593;1923;152;611;205;592;357;1203
313460;201401;2667;9621;2428;9200;864;3571;688;2496;1552;6067
313470;201401;3411;9722;3264;9553;383;1020;2667;8038;3050;9058
313480;201401;1141;3421;888;2971;178;687;376;1202;554;1889
313490;201401;1471;4999;1135;4429;468;1832;240;964;708;2796
313500;201401;447;1438;427;1403;90;345;257;820;347;1165
313505;201401;8760;26432;8292;25866;549;1348;7326;23651;7875;24999
313507;201401;1293;3928;1178;3758;249;927;655;2094;904;3021
313510;201401;15801;47919;14323;46083;2488;8369;9942;32760;12430;41129
313520;201401;15972;49339;13801;45762;2109;8183;8866;29263;10975;37446
313530;201401;532;1887;477;1771;76;322;192;672;268;994
313535;201401;2508;7671;2269;7282;397;1363;1400;4566;1797;5929
313540;201401;1152;3679;944;3173;284;1023;239;742;523;1765
313545;201401;1371;5107;1225;4849;251;1182;728;2776;979;3958
313550;201401;1944;6778;1872;6624;532;2039;938;3203;1470;5242
313560;201401;2299;5802;2038;5499;247;650;1562;4391;1809;5041
313570;201401;801;2977;705;2790;275;1198;217;796;492;1994
313580;201401;6130;17792;5384;16790;754;2497;3894;12285;4648;14782
313590;201401;1065;3247;872;3023;374;1337;398;1411;772;2748
313600;201401;3829;11987;3424;11351;654;2402;1968;6624;2622;9026
313610;201401;1160;3689;1013;3404;282;1047;407;1338;689;2385
313620;201401;7435;25311;7059;24525;2425;8983;2303;7879;4728;16862
313630;201401;8489;27110;7510;25639;2372;8909;2506;8917;4878;17826
313640;201401;845;2739;748;2609;274;1024;281;983;555;2007
313650;201401;2289;7606;2054;7235;306;1130;1463;5267;1769;6397
313652;201401;1021;3710;946;3562;182;726;551;2107;733;2833
313655;201401;957;3268;812;3026;202;868;470;1694;672;2562
313657;201401;1157;3891;1067;3735;168;769;686;2171;854;2940
313660;201401;895;3146;830;3033;233;982;393;1368;626;2350
313665;201401;3035;10256;2848;9865;698;2756;1340;4474;2038;7230
313670;201401;51394;152356;37434;128905;12005;45515;10990;36731;22995;82246
313680;201401;1103;3361;979;3170;120;408;705;2312;825;2720
313690;201401;918;3368;849;3239;236;917;340;1355;576;2272
313695;201401;1494;4984;1297;4670;186;802;901;3219;1087;4021
313700;201401;3907;13171;3353;12419;537;2095;2334;8784;2871;10879
313710;201401;1384;3965;1183;3671;380;1297;543;1622;923;2919
313720;201401;5297;18121;4682;16876;1293;5192;1366;4423;2659;9615
313730;201401;1269;3561;1026;3264;149;516;667;2149;816;2665
313740;201401;2055;7578;1734;6732;618;2697;219;785;837;3482
313750;201401;2953;9216;2619;8578;839;3017;688;2072;1527;5089
313753;201401;1838;5709;1583;5260;489;1763;585;1970;1074;3733
313760;201401;4325;14615;3754;13444;1234;4896;1051;3592;2285;8488
313770;201401;3647;12483;3481;12113;1255;4646;981;3378;2236;8024
313780;201401;3920;11409;3212;10361;868;3207;1394;4358;2262;7565
313790;201401;553;1957;539;1935;117;447;308;1121;425;1568
313800;201401;1258;3654;1130;3452;191;675;687;2079;878;2754
313810;201401;1477;4625;1420;4541;241;797;961;3145;1202;3942
313820;201401;13074;39189;11072;35628;3192;11424;3968;12750;7160;24174
313830;201401;463;1615;401;1486;138;578;111;399;249;977
313835;201401;1057;3613;1017;3547;236;903;554;1932;790;2835
313840;201401;7416;22922;6387;21255;1956;7313;2106;6703;4062;14016
313850;201401;1262;3602;1149;3409;265;912;614;1734;879;2646
313860;201401;2621;8356;2285;7641;699;2605;499;1513;1198;4118
313862;201401;1075;2999;781;2525;232;829;208;660;440;1489
313865;201401;2226;7199;2087;6959;338;1282;1405;4635;1743;5917
313867;201401;1047;3716;906;3422;323;1276;295;1133;618;2409
313868;201401;1546;5575;1396;5251;182;807;924;3473;1106;4280
313870;201401;915;2903;822;2764;230;901;333;1033;563;1934
313880;201401;2272;7402;2087;7157;490;1998;1054;3342;1544;5340
313890;201401;1996;5566;1714;5215;303;936;1088;3388;1391;4324
313900;201401;4672;17431;4408;16848;1687;7173;1170;4415;2857;11588
313910;201401;763;2649;665;2442;285;1144;114;379;399;1523
313920;201401;3667;11987;3379;11502;585;2037;2078;7403;2663;9440
313925;201401;2119;5751;1627;4856;139;484;1073;3200;1212;3684
313930;201401;5276;17747;4508;16413;841;3381;2560;9559;3401;12940
313940;201401;7286;26047;6485;24722;2322;9584;2428;9522;4750;19106
313950;201401;4793;14258;4086;13106;1308;4764;1327;4055;2635;8819
313960;201401;6038;16778;5090;15473;1732;5982;1276;3819;3008;9801
313970;201401;1494;4453;1257;4189;259;943;782;2615;1041;3558
313980;201401;1198;4083;1049;3814;329;1350;299;1039;628;2389
313990;201401;1999;7701;1798;7243;672;2928;431;1601;1103;4529
314000;201401;8103;28317;7572;27295;2221;8914;3843;13600;6064;22514
314010;201401;1067;3199;900;2989;183;711;473;1507;656;2218
314015;201401;1593;6066;1478;5809;543;2243;417;1671;960;3914
314020;201401;492;1621;419;1453;146;562;118;377;264;939
314030;201401;832;2736;671;2367;137;549;227;757;364;1306
314040;201401;642;1927;567;1792;198;676;268;809;466;1485
314050;201401;1907;6363;1619;5773;503;2003;450;1476;953;3479
314053;201401;1443;4941;1378;4857;250;866;948;3472;1198;4338
314055;201401;2235;6763;2004;6440;212;698;1489;4909;1701;5607
314060;201401;1086;3574;957;3339;146;610;582;1993;728;2603
314070;201401;3676;12059;3017;10700;911;3541;774;2610;1685;6151
314080;201401;1876;5908;1376;4839;288;1133;331;1070;619;2203
314085;201401;1844;6606;1622;6302;541;2331;568;2210;1109;4541
314090;201401;3485;12161;3193;11604;1048;4152;1177;4356;2225;8508
314100;201401;3499;9625;3086;9031;387;1161;2317;6921;2704;8082
314110;201401;4439;14924;3954;13917;1031;4151;1425;4634;2456;8785
314120;201401;1035;2585;590;1883;200;736;145;429;345;1165
314130;201401;677;1986;426;1420;100;370;86;256;186;626
314140;201401;5045;16123;4562;15217;1086;3928;2155;7282;3241;11210
314150;201401;1737;4678;1375;4122;252;844;741;2212;993;3056
314160;201401;2388;6562;1996;6037;167;553;1624;4984;1791;5537
314170;201401;1072;3411;924;3093;182;731;463;1461;645;2192
314180;201401;6491;21148;5854;20198;1675;6353;2578;9072;4253;15425
314190;201401;812;2629;727;2488;234;917;271;890;505;1807
314200;201401;3062;10105;2786;9609;451;1787;1834;6242;2285;8029
314210;201401;1954;6240;1766;5886;439;1576;845;2739;1284;4315
314220;201401;1743;5801;1489;5262;507;1985;346;1054;853;3039
314225;201401;1175;3704;1065;3550;72;187;943;3235;1015;3422
314230;201401;700;2473;658;2395;208;841;218;745;426;1586
314240;201401;1128;3663;1017;3489;254;864;604;2151;858;3015
314250;201401;512;1594;415;1393;131;502;140;425;271;927
314260;201401;1303;4779;1247;4658;412;1642;467;1745;879;3387
314270;201401;2716;9569;2569;9310;329;1346;1737;6335;2066;7681
314280;201401;3242;9487;2409;7927;746;2825;629;1834;1375;4659
314290;201401;5411;15502;4657;14302;676;2241;3216;9930;3892;12171
314300;201401;1953;6695;1828;6412;638;2397;654;2222;1292;4619
314310;201401;6563;21408;5823;19879;2334;8513;1393;4583;3727;13096
314315;201401;974;3762;913;3643;161;734;530;2141;691;2875
314320;201401;3321;10382;2773;9618;971;3696;1000;3412;1971;7108
314330;201401;53546;176689;50838;171905;16235;59880;22132;73816;38367;133696
314340;201401;2477;7132;1423;4900;372;1438;155;354;527;1792
314345;201401;1284;4452;1153;4248;362;1399;557;2129;919;3528
314350;201401;1415;4228;1162;3813;466;1679;287;934;753;2613
314360;201401;698;2268;523;1907;151;652;124;421;275;1073
314370;201401;565;2025;530;1981;172;701;263;974;435;1675
314380;201401;1093;3443;852;3022;339;1287;225;808;564;2095
314390;201401;15309;47507;12860;42747;4209;15271;3544;11373;7753;26644
314400;201401;5473;15734;4512;14410;1377;4422;2440;8168;3817;12590
314410;201401;2502;8397;2248;7870;753;2944;783;2577;1536;5521
314420;201401;772;2296;639;2110;95;387;475;1547;570;1934
314430;201401;8143;24738;7383;23370;2517;8741;2240;7216;4757;15957
314435;201401;1196;4037;1092;3837;176;763;669;2269;845;3032
314437;201401;1189;3135;1061;2953;101;281;828;2330;929;2611
314440;201401;750;2103;530;1808;197;746;107;341;304;1087
314450;201401;1741;5266;1516;4949;513;1943;629;1891;1142;3834
314460;201401;4608;16265;4137;15217;1420;5718;775;2818;2195;8536
314465;201401;2376;7771;2195;7448;230;957;1629;5428;1859;6385
314467;201401;1090;3176;965;2967;200;598;565;1799;765;2397
314470;201401;2396;7981;1917;6864;563;2340;413;1225;976;3565
314480;201401;7248;25483;5535;20803;1345;5451;535;1808;1880;7259
314490;201401;968;2998;824;2720;239;927;344;1059;583;1986
314500;201401;2792;8121;2335;7253;725;2522;774;2400;1499;4922
314505;201401;1784;5622;1692;5458;398;1425;951;3053;1349;4478
314510;201401;1817;5431;1390;4758;517;1926;344;1143;861;3069
314520;201401;3796;14768;3197;13192;1118;5061;559;2094;1677;7155
314530;201401;7211;26020;6694;25217;1245;4926;4001;15642;5246;20568
314535;201401;2768;8045;2456;7638;387;1316;1624;5115;2011;6431
314537;201401;1427;4422;1216;4054;276;1072;563;1900;839;2972
314540;201401;464;1453;410;1334;124;467;122;361;246;828
314545;201401;1362;4439;1224;4226;277;1043;635;2186;912;3229
314550;201401;517;1663;444;1565;150;621;117;385;267;1006
314560;201401;5309;19209;4710;17652;1282;5315;1125;4091;2407;9406
314570;201401;370;1175;333;1101;101;364;151;475;252;839
314580;201401;459;1623;396;1493;151;642;95;346;246;988
314585;201401;653;2367;549;2153;172;733;146;570;318;1303
314587;201401;1717;5630;1564;5344;292;1049;822;2836;1114;3885
314590;201401;4224;14897;3198;12081;766;3135;391;1347;1157;4482
314600;201401;2118;7383;1782;6795;694;2956;323;1130;1017;4086
314610;201401;8305;30186;7856;29131;2570;10333;2482;8885;5052;19218
314620;201401;1733;5264;1569;5065;231;749;1160;3867;1391;4616
314625;201401;1556;5139;1517;5090;218;797;1094;3724;1312;4521
314630;201401;5122;15477;4518;14508;675;2414;3003;9825;3678;12239
314640;201401;835;2440;718;2235;250;848;188;538;438;1386
314650;201401;1285;3976;1040;3521;277;1087;420;1288;697;2375
314655;201401;1688;5109;1335;4470;281;984;653;2202;934;3186
314660;201401;204;579;165;502;25;90;95;275;120;365
314670;201401;1468;4190;1212;3747;229;790;657;2004;886;2794
314675;201401;1865;5811;1684;5504;222;831;1073;3549;1295;4380
314690;201401;2731;8873;2371;8232;748;2985;669;2144;1417;5129
314700;201401;10041;38683;9127;36714;4168;17637;1956;8152;6124;25789
314710;201401;8370;27362;6062;22183;1455;6010;732;2480;2187;8490
314720;201401;2667;9113;2264;8301;709;2874;872;3145;1581;6019
314730;201401;2451;7777;2113;7298;761;2951;632;2064;1393;5015
314740;201401;3009;10374;2783;9956;920;3597;994;3407;1914;7004
314750;201401;327;1099;299;1034;67;283;136;445;203;728
314760;201401;1814;6482;1400;5407;335;1500;259;812;594;2312
314770;201401;1202;3873;790;2759;102;425;107;295;209;720
314780;201401;308;868;234;766;92;345;84;254;176;599
314790;201401;13412;41973;10513;36857;4130;16546;2407;7768;6537;24314
314795;201401;1526;4730;1361;4463;155;686;1016;3169;1171;3855
314800;201401;17112;53385;14494;48167;5883;20649;2762;9364;8645;30013
314810;201401;12886;39617;10294;34942;3315;12716;2406;8038;5721;20754
314820;201401;1101;3141;788;2685;287;1080;238;741;525;1821
314830;201401;1677;5847;1486;5469;559;2267;510;1872;1069;4139
314840;201401;1133;4034;910;3703;185;878;533;2166;718;3044
314850;201401;2217;6553;1916;6049;390;1442;1024;3197;1414;4639
314860;201401;3275;11468;3038;11083;613;2498;1818;6635;2431;9133
314870;201401;5695;18803;5139;18044;835;3337;3509;12487;4344;15824
314875;201401;1692;5891;1656;5843;324;1123;1223;4412;1547;5535
314880;201401;812;2445;727;2302;83;287;504;1589;587;1876
314890;201401;600;1904;461;1632;140;559;109;326;249;885
314900;201401;406;1314;332;1182;108;406;139;487;247;893
314910;201401;1699;6062;1512;5733;606;2502;326;1171;932;3673
314915;201401;2505;8025;2231;7637;236;937;1762;6022;1998;6959
314920;201401;654;1936;499;1706;104;406;223;714;327;1120
314930;201401;5145;17880;4587;16666;1522;6034;975;3506;2497;9540
314940;201401;405;1227;383;1186;96;308;187;570;283;878
314950;201401;370;1330;330;1240;96;411;72;246;168;657
314960;201401;784;2633;669;2403;206;808;167;569;373;1377
314970;201401;863;3136;786;2966;312;1297;181;637;493;1934
314980;201401;2223;6921;2027;6605;841;2935;290;896;1131;3831
314990;201401;3139;10291;2588;9065;950;3629;427;1340;1377;4969
314995;201401;1551;4956;1416;4766;261;1051;920;2985;1181;4036
315000;201401;1019;3125;870;2908;154;616;537;1760;691;2376
315010;201401;491;1603;408;1428;131;532;136;421;267;953
315015;201401;1881;5938;1745;5775;346;1226;1183;4049;1529;5275
315020;201401;756;2521;686;2398;202;804;264;823;466;1627
315030;201401;1004;3134;879;2907;347;1259;174;555;521;1814
315040;201401;941;2957;869;2835;174;595;533;1732;707;2327
315050;201401;1610;4921;1362;4505;470;1725;421;1330;891;3055
315053;201401;1142;3452;997;3222;266;1036;375;1138;641;2174
315057;201401;1908;6574;1575;6075;253;1008;986;3940;1239;4948
315060;201401;939;3255;807;2915;246;972;191;718;437;1690
315070;201401;671;2081;626;2013;165;589;346;1077;511;1666
315080;201401;3494;12208;3179;11547;857;3364;1395;5076;2252;8440
315090;201401;756;2780;680;2622;195;822;221;899;416;1721
315100;201401;1174;4118;962;3646;277;1164;238;861;515;2025
315110;201401;1651;5120;1460;4792;439;1553;587;1902;1026;3455
315120;201401;13749;33861;10109;29212;1987;6305;5202;15900;7189;22205
315130;201401;1815;6128;1653;5807;603;2317;432;1473;1035;3790
315140;201401;2417;8315;2041;7469;593;2505;576;1854;1169;4359
315150;201401;4720;13333;3643;11436;906;3279;1329;4008;2235;7287
315160;201401;1365;3958;1240;3787;256;873;709;2131;965;3004
315170;201401;1361;4187;1187;3945;282;1033;653;2242;935;3275
315180;201401;13628;43298;10887;37507;3111;12191;2597;8528;5708;20719
315190;201401;2377;6462;1949;5843;631;2022;829;2503;1460;4525
315200;201401;4482;15397;3784;13844;1189;4799;960;3377;2149;8176
315210;201401;8528;26901;7453;24928;2762;10011;2226;7258;4988;17269
315213;201401;1127;3695;1094;3648;100;309;914;3144;1014;3453
315217;201401;2724;9361;2309;8653;401;1688;1302;4944;1703;6632
315220;201401;10089;30425;9048;29027;1832;6058;5600;18466;7432;24524
315230;201401;2435;6694;2266;6494;138;369;1983;5777;2121;6146
315240;201401;3272;10797;3010;10339;616;2341;1749;6006;2365;8347
315250;201401;9040;29875;7124;26318;2464;10189;2124;7785;4588;17974
315260;201401;1067;3612;918;3273;356;1403;147;457;503;1860
315270;201401;872;3158;764;2925;252;1035;163;594;415;1629
315280;201401;3950;12321;3212;10670;1140;4029;736;2287;1876;6316
315290;201401;1258;3653;985;3216;377;1366;162;533;539;1899
315300;201401;498;1481;407;1367;213;766;109;331;322;1097
315310;201401;1215;4148;1111;3975;157;632;737;2611;894;3243
315320;201401;834;2832;719;2666;239;947;310;1185;549;2132
315330;201401;818;2993;657;2621;275;1228;97;368;372;1596
315340;201401;4200;12428;3631;11556;945;3292;1675;5370;2620;8662
315350;201401;1850;5344;1539;4931;202;614;1134;3784;1336;4398
315360;201401;1681;5772;1396;5008;341;1300;435;1482;776;2782
315370;201401;621;1901;550;1794;133;497;294;932;427;1429
315380;201401;281;1017;256;945;83;333;42;138;125;471
315390;201401;1951;7044;1721;6505;616;2521;372;1378;988;3899
315400;201401;4453;14201;4075;13451;1137;4036;1878;6266;3015;10302
315410;201401;1719;4895;1469;4492;328;1214;783;2283;1111;3497
315415;201401;1139;3904;1060;3781;479;1759;374;1381;853;3140
315420;201401;1530;4883;1166;4190;354;1349;194;676;548;2025
315430;201401;4014;11174;3084;9603;794;2824;962;2889;1756;5713
315440;201401;972;3036;881;2895;176;666;482;1576;658;2242
315445;201401;2168;6301;1849;5875;307;1119;1190;3750;1497;4869
315450;201401;2504;8102;2363;7892;477;1615;1528;5271;2005;6886
315460;201401;39036;132861;35227;124799;11837;45484;8806;30264;20643;75748
315470;201401;538;1729;491;1642;92;340;289;943;381;1283
315480;201401;1383;4434;1013;3628;220;889;228;766;448;1655
315490;201401;3246;9420;2832;8840;544;2025;1613;4867;2157;6892
315500;201401;456;1493;315;1135;70;304;124;386;194;690
315510;201401;1467;4324;1275;4009;168;595;819;2563;987;3158
315520;201401;1154;3660;975;3417;169;683;586;1982;755;2665
315530;201401;492;1768;466;1725;229;885;133;471;362;1356
315540;201401;1278;3948;1034;3550;224;956;364;1212;588;2168
315550;201401;1679;5075;1464;4797;502;1826;584;1877;1086;3703
315560;201401;7139;24001;6593;23261;978;3853;4490;15887;5468;19740
315570;201401;2387;7617;2243;7406;488;1835;1289;4185;1777;6020
315580;201401;2696;8499;2237;7629;641;2597;799;2522;1440;5119
315590;201401;873;2600;807;2504;123;458;556;1692;679;2150
315600;201401;2592;9487;2177;8812;354;1546;1341;5670;1695;7216
315610;201401;987;3014;856;2738;212;810;294;781;506;1591
315620;201401;337;1215;330;1200;105;395;149;555;254;950
315630;201401;995;3251;865;3041;243;901;229;793;472;1694
315640;201401;735;2374;651;2204;227;884;191;590;418;1474
315645;201401;840;2751;741;2507;299;1116;157;503;456;1619
315650;201401;1850;5616;1696;5397;167;678;1280;3981;1447;4659
315660;201401;2665;7412;2428;7080;441;1413;1493;4329;1934;5742
315670;201401;11547;41987;10706;40332;4032;16366;3168;11687;7200;28053
315680;201401;2844;10167;2382;9290;916;3740;578;2378;1494;6118
315690;201401;3169;10372;2664;9456;962;3769;710;2515;1672;6284
315700;201401;7266;23650;6356;21806;1426;5627;3000;9817;4426;15444
315710;201401;1812;5485;1500;5000;237;933;855;2813;1092;3746
315720;201401;2972;9896;2716;9405;887;3488;987;3145;1874;6633
315725;201401;1629;5095;1324;4704;440;1589;616;2258;1056;3847
315727;201401;652;2118;588;1985;141;514;283;945;424;1459
315730;201401;985;3109;902;2949;210;740;472;1557;682;2297
315733;201401;1148;3767;1072;3613;473;1681;310;1016;783;2697
315737;201401;1367;4257;1162;3906;141;535;720;2453;861;2988
315740;201401;1026;3371;907;3152;264;1061;377;1199;641;2260
315750;201401;1130;3577;1023;3431;109;462;747;2435;856;2897
315760;201401;930;2671;910;2642;24;67;866;2530;890;2597
315765;201401;1447;4598;1358;4454;177;618;1002;3333;1179;3951
315770;201401;1664;5446;1532;5174;470;1718;530;1736;1000;3454
315780;201401;23490;78800;21977;75587;7505;27681;6481;22446;13986;50127
315790;201401;3172;11158;2913;10600;339;1207;1935;7300;2274;8507
315800;201401;1532;6081;1303;5410;413;1882;237;943;650;2825
315810;201401;1475;4321;1275;4013;273;909;737;2265;1010;3174
315820;201401;3061;10259;2647;9653;712;2750;1363;5095;2075;7845
315830;201401;1471;5057;1364;4839;341;1388;425;1438;766;2826
315840;201401;713;2001;571;1743;108;373;172;483;280;856
315850;201401;1335;4833;1301;4767;399;1523;505;1824;904;3347
315860;201401;428;1606;370;1482;121;550;75;302;196;852
315870;201401;466;1429;401;1327;117;435;131;393;248;828
315880;201401;1092;3047;917;2827;276;973;405;1213;681;2186
315890;201401;1649;5726;1505;5506;456;1738;741;2825;1197;4563
315895;201401;5087;16249;4763;15634;1446;5254;2005;6396;3451;11650
315900;201401;763;2508;714;2423;192;768;367;1142;559;1910
315910;201401;619;2226;577;2143;230;888;232;845;462;1733
315920;201401;1444;4373;1066;3572;308;1154;305;932;613;2086
315930;201401;1110;3184;929;2856;292;979;291;860;583;1839
315935;201401;1159;3959;1086;3803;333;1269;337;1144;670;2413
315940;201401;640;2129;591;2044;177;696;252;839;429;1535
315950;201401;1222;3866;1147;3717;344;1147;620;2048;964;3195
315960;201401;2789;9684;2252;8582;1033;4509;171;568;1204;5077
315970;201401;806;2319;660;2107;82;262;484;1601;566;1863
315980;201401;4047;10459;2912;8512;809;2698;865;2195;1674;4893
315990;201401;4332;13246;3876;12532;900;3440;2017;6377;2917;9817
316000;201401;577;1926;512;1819;230;895;138;469;368;1364
316010;201401;454;1688;407;1577;113;512;102;331;215;843
316020;201401;1186;3830;954;3425;185;754;509;1834;694;2588
316030;201401;3626;10507;2709;9073;394;1477;1441;4948;1835;6425
316040;201401;3450;11022;2533;8925;430;1715;294;800;724;2515
316045;201401;2090;6934;1956;6716;288;906;1363;4995;1651;5901
316050;201401;367;1213;324;1149;88;336;148;517;236;853
316060;201401;780;2407;646;2216;125;537;371;1202;496;1739
316070;201401;6032;20506;5625;19685;1858;7171;2309;7710;4167;14881
316080;201401;736;2800;667;2606;164;717;133;523;297;1240
316090;201401;609;1836;472;1557;119;458;119;348;238;806
316095;201401;1290;4358;1183;4155;351;1299;651;2326;1002;3625
316100;201401;2715;9339;2175;7948;611;2522;414;1400;1025;3922
316105;201401;941;2706;717;2335;173;622;311;1047;484;1669
316110;201401;12328;44280;11279;42299;1537;6551;7842;30042;9379;36593
316120;201401;1277;4497;1188;4296;391;1474;455;1642;846;3116
316130;201401;1152;2885;896;2522;198;653;453;1264;651;1917
316140;201401;1069;3227;839;2855;146;543;481;1667;627;2210
316150;201401;1265;4044;1211;3963;320;1225;628;1971;948;3196
316160;201401;1236;3757;1001;3299;147;561;544;1776;691;2337
316165;201401;934;2656;806;2451;164;578;443;1315;607;1893
316170;201401;1405;4159;1072;3567;238;923;413;1273;651;2196
316180;201401;1226;4015;1014;3605;305;1254;288;950;593;2204
316190;201401;2682;8389;1463;5210;289;1101;240;739;529;1840
316200;201401;3762;12445;2976;10901;885;3779;832;2881;1717;6660
316210;201401;4991;16567;4649;15862;2138;7824;940;3192;3078;11016
316220;201401;664;2085;483;1751;127;537;58;211;185;748
316225;201401;1086;3258;969;3104;146;549;642;2001;788;2550
316230;201401;458;1398;381;1261;79;291;190;647;269;938
316240;201401;6232;20078;5470;19093;712;2535;4071;14465;4783;17000
316245;201401;3038;10937;2885;10685;295;1359;2177;8023;2472;9382
316250;201401;9037;29091;8058;27091;3289;11890;2058;6530;5347;18420
316255;201401;2350;7657;2097;7361;352;1177;1467;5306;1819;6483
316257;201401;1350;3892;1066;3389;282;1024;378;1120;660;2144
316260;201401;1807;5301;1410;4732;345;1295;723;2438;1068;3733
316265;201401;1180;3486;1043;3211;101;356;734;2228;835;2584
316270;201401;5142;16894;4823;16236;1464;5377;1986;6742;3450;12119
316280;201401;3270;11125;2967;10526;637;2538;1523;5383;2160;7921
316290;201401;3149;10668;2919;10224;766;3055;1268;4192;2034;7247
316292;201401;3757;12733;3483;12210;1072;4194;1410;4664;2482;8858
316294;201401;791;2658;525;2007;128;579;70;244;198;823
316295;201401;1946;7014;1833;6781;464;1987;922;3182;1386;5169
316300;201401;957;3042;840;2836;96;340;558;1944;654;2284
316310;201401;697;2234;547;1923;130;516;182;630;312;1146
316320;201401;565;1943;503;1855;144;603;123;434;267;1037
316330;201401;974;2995;824;2723;148;488;457;1551;605;2039
316340;201401;1151;3819;1027;3570;350;1373;269;842;619;2215
316350;201401;1474;4936;1351;4731;283;1023;735;2740;1018;3763
316360;201401;767;2042;610;1830;86;272;442;1337;528;1609
316370;201401;5053;16972;4544;15957;1569;5936;1008;3604;2577;9540
316380;201401;1443;4145;1200;3784;140;500;820;2603;960;3103
316390;201401;908;2800;767;2553;274;1000;290;968;564;1968
316400;201401;1471;5029;1318;4754;358;1412;513;1868;871;3280
316410;201401;1212;4129;1136;4010;266;1053;633;2203;899;3256
316420;201401;2004;6928;1867;6746;302;1228;1186;4362;1488;5590
316430;201401;927;2891;786;2642;253;941;277;887;530;1828
316440;201401;619;2122;548;2026;241;1014;191;657;432;1671
316443;201401;691;2153;592;1956;152;555;212;678;364;1233
316447;201401;1341;4537;1283;4436;176;688;1006;3446;1182;4134
316450;201401;2203;7846;1977;7386;489;1881;1071;4161;1560;6042
316460;201401;859;2790;808;2707;224;858;440;1382;664;2240
316470;201401;8107;27117;6468;23416;2123;8742;1821;6204;3944;14946
316480;201401;254;892;230;848;65;253;72;254;137;507
316490;201401;367;1204;350;1165;116;415;142;461;258;876
316500;201401;1064;3957;765;3035;197;857;47;169;244;1026
316510;201401;951;3499;865;3325;363;1453;239;928;602;2381
316520;201401;1198;3812;1006;3527;284;1160;371;1182;655;2342
316530;201401;1191;3896;1007;3509;270;1150;397;1167;667;2317
316540;201401;1018;3391;925;3239;270;1115;313;990;583;2105
316550;201401;1258;4380;1163;4230;258;1058;721;2604;979;3662
316553;201401;2207;8242;1889;7478;654;2775;399;1532;1053;4307
316555;201401;2763;9923;2491;9607;242;944;1982;7814;2224;8758
316556;201401;590;1714;497;1543;52;203;326;963;378;1166
316557;201401;727;2721;705;2684;291;1152;258;986;549;2138
316560;201401;370;1269;311;1132;81;352;78;248;159;600
316570;201401;1415;4579;1273;4281;260;949;649;2178;909;3127
316580;201401;286;849;231;745;65;239;70;206;135;445
316590;201401;1357;4122;1148;3744;222;874;636;1985;858;2859
316600;201401;1177;3919;1080;3730;185;695;630;2139;815;2834
316610;201401;607;2285;570;2218;144;645;319;1214;463;1859
316620;201401;2170;7085;1936;6610;498;1897;867;2909;1365;4806
316630;201401;1527;5193;1367;4870;586;2185;375;1361;961;3546
316640;201401;260;870;238;831;69;282;93;295;162;577
316650;201401;928;3680;842;3534;207;896;441;1959;648;2855
316660;201401;136;419;119;390;32;133;44;122;76;255
316670;201401;1839;5539;1498;4852;571;2121;298;802;869;2923
316680;201401;1972;6009;1742;5649;233;782;1309;4332;1542;5114
316690;201401;1131;3937;1032;3759;393;1608;320;1112;713;2720
316695;201401;1251;3941;1126;3725;113;371;744;2583;857;2954
316700;201401;351;1201;328;1143;80;323;154;499;234;822
316710;201401;3427;13277;3038;12422;1068;4578;882;3834;1950;8412
316720;201401;20152;69341;17605;63695;6406;24521;4328;15505;10734;40026
316730;201401;427;1390;377;1289;101;387;182;567;283;954
316740;201401;748;2633;681;2503;273;1098;179;614;452;1712
316750;201401;419;1499;386;1429;107;453;124;420;231;873
316760;201401;3604;12373;3096;11803;1838;7115;801;3237;2639;10352
316770;201401;1480;4493;1333;4294;227;820;872;2888;1099;3708
316780;201401;701;2470;660;2392;265;1032;173;599;438;1631
316790;201401;847;2534;639;2179;184;719;222;722;406;1441
316800;201401;5858;19842;5365;18920;1190;4906;2702;9087;3892;13993
316805;201401;887;2405;846;2353;144;382;621;1794;765;2176
316810;201401;539;1721;494;1632;137;505;230;732;367;1237
316820;201401;393;1138;271;932;108;412;43;137;151;549
316830;201401;596;2172;576;2136;214;853;207;738;421;1591
316840;201401;3096;9504;2708;8781;805;2959;1050;3216;1855;6175
316850;201401;2127;6864;1973;6583;465;1728;1019;3363;1484;5091
316860;201401;24018;75946;21974;72153;6294;23073;9402;30536;15696;53609
316870;201401;7039;24098;6311;22358;2369;9053;1302;4491;3671;13544
316880;201401;882;3060;854;3016;360;1401;241;794;601;2195
316890;201401;1434;3791;1145;3393;494;1620;388;1107;882;2727
316900;201401;2702;8704;2402;8111;766;2903;734;2247;1500;5150
316905;201401;441;1575;409;1501;180;702;111;388;291;1090
316910;201401;704;2470;590;2227;140;556;199;775;339;1331
316920;201401;1532;4751;1254;4311;207;790;628;2139;835;2929
316930;201401;9475;33362;8388;31129;2605;10884;2024;7130;4629;18014
316935;201401;4803;14706;3648;12685;1278;4945;848;2793;2126;7738
316940;201401;6991;24081;6019;22042;1595;6462;1652;5861;3247;12323
316950;201401;1500;4537;1328;4305;221;847;863;2751;1084;3598
316960;201401;5263;14104;4494;13106;1031;3304;2525;7323;3556;10627
316970;201401;3506;11773;3344;11490;1391;5363;843;2644;2234;8007
316980;201401;937;3020;770;2747;386;1461;187;672;573;2133
316990;201401;9882;33737;9063;31907;3771;14383;1271;4281;5042;18664
317000;201401;2562;9449;2491;9361;282;848;2043;8145;2325;8993
317005;201401;2382;7935;2291;7818;407;1429;1639;5673;2046;7102
317010;201401;29435;82143;20386;66671;5915;21676;4859;16510;10774;38186
317020;201401;48006;145177;33863;115477;8859;33484;7818;24957;16677;58441
317030;201401;884;2542;754;2343;134;508;417;1282;551;1790
317040;201401;12849;40130;11592;37797;4321;14845;4149;13739;8470;28584
317043;201401;819;2394;695;2228;195;670;349;1121;544;1791
317047;201401;1137;3129;905;2732;161;554;427;1279;588;1833
317050;201401;1823;6681;1613;6177;490;2051;519;1899;1009;3950
317052;201401;2407;7925;2158;7551;290;1100;1566;5550;1856;6650
317057;201401;1758;5205;1403;4600;242;956;694;2228;936;3184
317060;201401;385;1166;300;977;83;310;107;320;190;630
317065;201401;1216;4125;1106;3940;157;632;797;2833;954;3465
317070;201401;9448;32083;7621;27984;2389;9667;1670;6209;4059;15876
317075;201401;1254;3987;1101;3707;399;1472;352;1125;751;2597
317080;201401;6942;20510;6427;19663;2112;7033;2330;7143;4442;14176
317090;201401;4814;16779;4539;16291;788;2937;2964;10861;3752;13798
317100;201401;3263;9835;2847;9128;992;3564;1115;3368;2107;6932
317103;201401;1978;7035;1702;6459;370;1728;749;2765;1119;4493
317107;201401;1315;4206;1153;3882;279;1066;553;1776;832;2842
317110;201401;744;2093;535;1692;154;588;193;545;347;1133
317115;201401;1079;3522;963;3266;146;523;616;2099;762;2622
317120;201401;13197;45658;11551;41760;3981;15362;3975;14176;7956;29538
317130;201401;8878;28997;8133;27638;2279;8764;3428;11293;5707;20057
317140;201401;657;2311;620;2237;84;337;390;1408;474;1745
317150;201401;1031;2869;879;2695;116;427;625;1890;741;2317
317160;201401;3819;10465;2939;9361;441;1665;1903;5959;2344;7624
317170;201401;1935;5886;1803;5648;264;969;1074;3208;1338;4177
317180;201401;1798;6275;1465;5521;422;1739;439;1625;861;3364
317190;201401;1257;3908;1155;3769;102;382;926;3016;1028;3398
317200;201401;4440;15193;4124;14502;1437;5499;1029;3466;2466;8965
317210;201401;1071;3439;924;3200;283;1107;400;1366;683;2473
317220;201401;351;1272;342;1262;128;478;165;631;293;1109
320010;201401;5918;18870;5313;17501;938;3395;2672;8743;3610;12138
320013;201401;1966;5899;1480;5053;214;782;841;2948;1055;3730
320016;201401;3445;9842;2990;9213;537;1683;1986;6237;2523;7920
320020;201401;4213;13936;3907;13267;1358;4923;1399;4745;2757;9668
320030;201401;1734;5779;1584;5452;472;1756;622;2083;1094;3839
320035;201401;1701;5457;1548;5182;538;1966;513;1676;1051;3642
320040;201401;3119;10734;2664;9654;701;2763;768;2708;1469;5471
320050;201401;1913;5402;1651;4883;316;1048;902;2610;1218;3658
320060;201401;10967;35222;8840;30300;2277;8655;3032;9847;5309;18502
320070;201401;1819;6214;1610;5711;518;1974;405;1331;923;3305
320080;201401;5481;16597;4527;14685;1416;4974;1445;4604;2861;9578
320090;201401;8584;25209;7121;22454;2098;7152;3072;9373;5170;16525
320100;201401;3250;9936;2725;8888;661;2328;1234;3948;1895;6276
320110;201401;1544;4791;1420;4544;390;1344;465;1454;855;2798
320115;201401;1856;6893;1786;6730;704;2725;807;3095;1511;5820
320120;201401;17080;59255;15420;55984;5683;22057;4216;15387;9899;37444
320130;201401;40110;136453;37850;131667;11615;43874;16506;55970;28121;99844
320140;201401;4103;13561;3004;10815;747;2987;321;1074;1068;4061
320150;201401;17962;52157;13759;44117;4364;15091;2237;7051;6601;22142
320160;201401;5325;16748;4696;15732;1280;4832;2012;6294;3292;11126
320170;201401;1907;6389;1757;6059;604;2166;551;1965;1155;4131
320180;201401;911;3045;824;2910;306;1139;304;1073;610;2212
320190;201401;4290;15792;3953;14894;1421;5585;1082;4036;2503;9621
320200;201401;1127;3778;1016;3540;318;1198;418;1466;736;2664
320210;201401;6026;16764;5264;15473;1295;4314;2645;7517;3940;11831
320220;201401;2883;8957;2296;7907;695;2619;800;2772;1495;5391
320225;201401;1453;5247;1293;4821;463;1837;266;1015;729;2852
320230;201401;4265;14494;4001;13984;1363;5181;1378;4911;2741;10092
320240;201401;9141;28696;7478;25422;2296;8360;1873;6534;4169;14894
320245;201401;4176;14513;3932;13930;1276;4769;1527;5370;2803;10139
320250;201401;1761;5579;1357;4646;352;1329;290;913;642;2242
320255;201401;2032;6912;1775;6460;729;2854;597;2239;1326;5093
320260;201401;1203;3860;986;3283;272;1009;368;1090;640;2099
320265;201401;2509;7815;2136;7366;282;1015;1546;5494;1828;6509
320270;201401;2427;7861;2088;7200;544;2001;942;3225;1486;5226
320280;201401;7233;22223;6696;21344;1407;4904;3745;11927;5152;16831
320290;201401;1534;5342;1398;4954;532;1965;346;1150;878;3115
320300;201401;4365;14993;4076;14381;1262;4746;1552;5466;2814;10212
320305;201401;4723;15810;4355;14958;1137;4321;1946;6488;3083;10809
320310;201401;1985;6146;1797;5811;465;1634;785;2436;1250;4070
320313;201401;2316;7152;1728;5800;488;1897;289;861;777;2758
320316;201401;2232;7127;2119;6860;607;2076;927;2976;1534;5052
320320;201401;18535;61309;16419;57206;5046;19611;6410;21699;11456;41310
320330;201401;2891;9078;2578;8523;577;1914;1434;4910;2011;6824
320332;201401;4913;17023;4518;16304;1528;5814;1793;6663;3321;12477
320334;201401;1462;5199;1220;4608;423;1776;230;786;653;2562
320335;201401;2199;6731;1664;5558;581;2152;297;926;878;3078
320340;201401;5729;16606;4666;14762;1176;4141;2076;6453;3252;10594
320350;201401;5523;14454;4171;12219;883;2943;1909;5447;2792;8390
320360;201401;1768;4804;1369;4066;273;917;664;1860;937;2777
320370;201401;3445;11624;3036;10821;936;3483;1152;4120;2088;7603
320380;201401;2754;8658;2479;8121;601;2114;1222;3917;1823;6031
320390;201401;8212;25431;7002;23050;2099;7700;2393;7584;4492;15284
320400;201401;4148;12119;3552;11283;779;2802;2046;6311;2825;9113
320405;201401;4156;12536;3840;12121;1188;4199;2040;6247;3228;10446
320410;201401;6092;15481;4578;13754;772;2418;3085;9406;3857;11824
320420;201401;2299;7310;1839;6594;793;3080;290;983;1083;4063
320425;201401;2457;6367;2034;5758;333;1138;1217;3398;1550;4536
320430;201401;2373;7137;2154;6711;444;1524;1070;3267;1514;4791
320435;201401;2311;8136;2078;7610;955;3653;636;2377;1591;6030
320440;201401;1440;4928;1303;4536;412;1554;386;1254;798;2808
320450;201401;2488;8176;2193;7562;655;2479;906;3026;1561;5505
320455;201401;4657;16825;3848;14802;1204;4843;732;2755;1936;7598
320460;201401;2939;9931;2495;8976;797;3103;754;2593;1551;5696
320465;201401;1561;5121;1289;4430;281;1032;500;1673;781;2705
320470;201401;4240;13511;3260;11342;1070;4083;472;1511;1542;5594
320480;201401;1945;6013;1644;5434;418;1594;677;2108;1095;3702
320490;201401;17634;57145;15088;52078;5216;19378;4760;16857;9976;36235
320495;201401;1300;4312;1163;3993;480;1787;284;943;764;2730
320500;201401;43447;140283;39108;132147;13257;48496;16075;53067;29332;101563
320501;201401;3575;12000;3336;11582;1174;4589;1404;4690;2578;9279
320503;201401;2297;8457;2009;7715;696;2848;495;1732;1191;4580
320506;201401;3227;10394;2346;8148;715;2684;288;906;1003;3590
320510;201401;8223;26827;7487;25376;2645;9574;2666;8909;5311;18483
320515;201401;2098;6110;1891;5724;544;1768;677;2027;1221;3795
320517;201401;2175;7348;1878;6703;697;2690;411;1377;1108;4067
320520;201401;31950;105392;28037;97744;9311;35876;11419;39478;20730;75354
320530;201401;27621;88216;24176;81308;6729;25713;10057;32195;16786;57908
330010;201401;16227;52575;15207;50476;3436;12890;8639;27613;12075;40503
330015;201401;1965;5589;1715;5113;482;1611;588;1685;1070;3296
330020;201401;16420;50376;15173;48390;3757;12943;8223;26069;11980;39012
330022;201401;1644;5359;1483;5052;327;1282;767;2495;1094;3777
330023;201401;3376;11134;3196;10755;872;3239;1255;4043;2127;7282
330025;201401;3300;10306;3065;9939;786;2752;1802;5781;2588;8533
330030;201401;7480;26448;6938;25311;2082;8378;2867;9943;4949;18321
330040;201401;14405;41934;12370;38695;3466;11677;5930;18235;9396;29912
330045;201401;64584;190481;59601;182898;9545;31551;39954;122269;49499;153820
330050;201401;2935;9549;2637;8951;970;3692;669;2084;1639;5776
330060;201401;5470;17170;4969;16449;1177;4385;2938;9755;4115;14140
330070;201401;25293;79745;23332;76215;6729;23645;10028;32720;16757;56365
330080;201401;9102;26679;8714;26153;1896;5660;5653;17533;7549;23193
330090;201401;3210;9114;3024;8783;881;2796;1386;3920;2267;6716
330093;201401;1964;5838;1729;5451;435;1478;684;2111;1119;3589
330095;201401;1200;4222;1128;4056;436;1744;175;536;611;2280
330100;201401;54689;185275;51408;179689;12524;48717;25871;90715;38395;139432
330110;201401;2653;8541;2450;8157;830;2986;760;2513;1590;5499
330115;201401;2451;7539;2288;7259;758;2632;919;2818;1677;5450
330120;201401;2517;7487;2307;7203;740;2476;946;2886;1686;5362
330130;201401;3960;13279;3621;12619;1217;4597;1331;4603;2548;9200
330140;201401;3403;10528;3115;10131;843;3034;1433;4655;2276;7689
330150;201401;2584;7853;2031;6703;570;2078;430;1365;1000;3443
330160;201401;1391;4918;1302;4724;487;1928;410;1426;897;3354
330170;201401;102586;317002;96779;308032;14747;50444;68202;217422;82949;267866
330180;201401;1722;5390;1576;5111;257;1063;994;2989;1251;4052
330185;201401;7903;25412;7407;24575;1976;6930;3936;13406;5912;20336
330187;201401;4292;12478;3858;11763;831;2884;2239;6752;3070;9636
330190;201401;27969;86043;26818;84201;6948;23286;15467;47839;22415;71125
330200;201401;13487;43336;12322;41098;2930;10095;6539;22237;9469;32332
330205;201401;2577;7131;2324;6711;526;1789;1146;3157;1672;4946
330210;201401;4736;12482;3472;10166;1051;3370;775;2233;1826;5603
330220;201401;11224;36112;10539;34741;3521;12613;3309;10367;6830;22980
330225;201401;4020;12866;3802;12530;596;2322;2635;8658;3231;10980
330227;201401;17586;50764;16008;48608;3922;12760;9053;26950;12975;39710
330230;201401;1511;4531;1392;4316;434;1519;531;1512;965;3031
330240;201401;20267;63802;18317;60412;7072;25581;3251;10461;10323;36042
330245;201401;1221;3971;1033;3581;316;1197;220;763;536;1960
330250;201401;37241;110772;35188;107494;10177;31712;18455;57585;28632;89297
330260;201401;3694;11854;3466;11383;896;3235;1525;4830;2421;8065
330270;201401;14051;42036;12061;38838;3640;12514;4434;14430;8074;26944
330280;201401;1982;6377;1723;5850;406;1577;777;2452;1183;4029
330285;201401;17760;53922;16446;52093;3743;12549;9904;31576;13647;44125
330290;201401;3556;10115;3185;9618;670;2328;1814;5197;2484;7525
330300;201401;4138;13691;3964;13411;964;3529;2041;6965;3005;10494
330310;201401;2763;8218;2535;7834;629;2063;1247;3809;1876;5872
330320;201401;12079;36802;11389;35751;1918;6525;7883;24724;9801;31249
330330;201401;31595;92149;29273;88534;7469;24428;16815;50155;24284;74583
330340;201401;14480;45590;12071;40728;3785;13814;3409;11320;7194;25134
330350;201401;92071;299401;89822;296232;16802;55949;63229;212484;80031;268433
330360;201401;5537;17765;5419;17577;805;2875;3993;12881;4798;15756
330370;201401;3789;14253;3609;13803;1442;5732;1167;4501;2609;10233
330380;201401;4349;14436;3873;13575;1118;4220;1759;6177;2877;10397
330385;201401;4052;14292;3781;13748;1309;5087;1336;4838;2645;9925
330390;201401;24130;82291;22283;78593;5510;21760;11114;38249;16624;60009
330395;201401;3362;10203;3153;9852;529;1814;1970;6182;2499;7996
330400;201401;2578;8755;2376;8371;550;2261;1156;3734;1706;5995
330410;201401;3099;10000;2692;9173;637;2288;1297;4440;1934;6728
330411;201401;2519;8084;2291;7639;498;1923;1165;3650;1663;5573
330412;201401;1379;4816;1119;4315;273;1192;390;1457;663;2649
330414;201401;25714;74006;22169;69273;4604;15321;13410;42043;18014;57364
330415;201401;3671;11729;3279;11019;846;3181;1409;4709;2255;7890
330420;201401;7699;25406;6114;22092;1831;7274;1073;3860;2904;11134
330430;201401;8219;24719;7446;23379;1807;6346;3592;10997;5399;17343
330440;201401;2118;7176;1795;6502;598;2449;405;1344;1003;3793
330450;201401;1611;5704;1526;5525;481;1958;589;2074;1070;4032
330452;201401;10580;33190;8905;29864;2540;9455;3522;11282;6062;20737
330455;201401;466467;1392404;405120;1291972;111448;381508;197867;628958;309315;1010466
330460;201401;1387;4745;1310;4601;367;1472;608;2085;975;3557
330470;201401;4363;14575;4105;14056;1488;5502;1233;4109;2721;9611
330475;201401;8229;26577;7494;25378;2048;7669;3669;12350;5717;20019
330480;201401;6447;19802;6095;19164;1769;6023;2496;7776;4265;13799
330490;201401;99985;284558;93452;275124;13284;41263;69950;206767;83234;248030
330500;201401;6881;21239;6479;20440;1468;5001;3357;10850;4825;15851
330510;201401;41681;136703;39525;133145;13892;47649;18110;62752;32002;110401
330513;201401;1580;4817;1464;4591;577;1904;471;1459;1048;3363
330515;201401;3072;9889;2834;9451;973;3478;1017;3341;1990;6819
330520;201401;13390;40600;12424;39053;3226;10684;6575;20799;9801;31483
330530;201401;1551;4698;1448;4519;396;1383;702;2108;1098;3491
330540;201401;3296;10188;2899;9571;894;3187;1114;3593;2008;6780
330550;201401;8972;30038;8044;28349;3287;12338;1914;6863;5201;19201
330555;201401;10356;32073;9389;30615;1919;6502;5814;19311;7733;25813
330560;201401;4181;13046;3944;12659;865;3235;2200;6868;3065;10103
330570;201401;3677;10733;3216;9972;854;2781;1630;5133;2484;7914
330575;201401;5388;16580;5003;15860;1202;4108;2864;8799;4066;12907
330580;201401;16636;54803;14883;51288;5147;18603;5088;17978;10235;36581
330590;201401;1960;6008;1840;5800;550;1840;886;2803;1436;4643
330600;201401;9558;29200;8292;27197;1304;5260;5221;16340;6525;21600
330610;201401;8903;29312;8260;28117;2219;8424;3869;12979;6088;21403
330615;201401;1670;6016;1545;5668;683;2611;400;1520;1083;4131
330620;201401;4008;14253;3723;13687;1333;5246;1028;3941;2361;9187
330630;201401;20953;69895;19079;65968;5404;20818;8741;28839;14145;49657
350010;201401;2922;9349;2375;8171;725;2678;433;1413;1158;4091
350020;201401;615;1764;478;1510;121;435;180;533;301;968
350030;201401;4720;15339;4025;13792;1419;5347;1167;3905;2586;9252
350040;201401;588;2172;519;2019;175;740;102;356;277;1096
350050;201401;1410;4674;1191;4271;324;1338;379;1235;703;2573
350055;201401;614;2077;595;2047;177;659;287;969;464;1628
350060;201401;85;291;79;281;24;106;28;84;52;190
350070;201401;2661;9018;2201;7929;523;2084;408;1290;931;3374
350075;201401;499;1830;460;1746;158;644;118;419;276;1063
350080;201401;597;1784;484;1552;135;500;172;537;307;1037
350090;201401;595;1735;456;1498;124;442;123;368;247;810
350100;201401;1937;6773;1672;6141;570;2257;478;1689;1048;3946
350110;201401;458;1411;369;1210;109;397;110;323;219;720
350115;201401;1317;4382;1187;4055;278;1088;519;1622;797;2710
350120;201401;547;1507;334;1064;76;273;86;259;162;532
350130;201401;3701;11507;3391;10901;878;3147;1429;4246;2307;7393
350140;201401;691;2200;629;2073;166;627;251;781;417;1408
350150;201401;438;1518;402;1433;153;580;95;330;248;910
350160;201401;6084;19529;4740;16573;1471;5690;1649;5299;3120;10989
350170;201401;2267;8149;2048;7597;737;2843;457;1610;1194;4453
350180;201401;1438;3804;1205;3414;310;925;514;1428;824;2353
350190;201401;3191;11109;2775;10267;888;3752;1129;3743;2017;7495
350200;201401;420;1454;382;1388;130;537;127;440;257;977
350210;201401;7575;21594;6111;19045;2343;7918;1870;5530;4213;13448
350220;201401;3129;10227;2883;9755;1016;3884;804;2460;1820;6344
350230;201401;741;2559;685;2467;236;927;225;806;461;1733
350240;201401;598;1834;521;1712;120;469;279;870;399;1339
350250;201401;2751;10307;2660;10128;1125;4542;839;3177;1964;7719
350260;201401;1057;2865;895;2579;215;645;370;1094;585;1739
350270;201401;5270;16471;4713;15341;1026;3581;2216;7199;3242;10780
350275;201401;2028;6799;1824;6486;558;2203;708;2357;1266;4560
350280;201401;22711;60858;15194;47001;3930;13096;3042;9514;6972;22610
350290;201401;1731;6128;1564;5733;486;1869;453;1712;939;3581
350300;201401;487;1566;457;1499;152;542;143;472;295;1014
350310;201401;1016;3417;955;3276;221;891;411;1351;632;2242
350315;201401;563;1800;468;1599;78;345;153;491;231;836
350320;201401;12064;40284;11183;38272;3578;13116;1952;6484;5530;19600
350330;201401;9578;28763;8519;26571;2068;7210;4419;12880;6487;20090
350335;201401;551;1647;508;1557;132;420;190;644;322;1064
350340;201401;1038;3343;834;2965;230;898;215;745;445;1643
350350;201401;764;2473;677;2327;186;721;222;770;408;1491
350360;201401;814;2909;717;2679;227;892;238;910;465;1802
350370;201401;707;2221;549;1854;108;409;118;356;226;765
350380;201401;3752;12383;3182;11487;1328;5175;685;2329;2013;7504
350390;201401;8645;28399;7807;26894;2089;7761;3766;12579;5855;20340
350395;201401;302;994;252;888;76;290;49;168;125;458
350400;201401;8213;24515;6864;22094;2036;7209;2403;7389;4439;14598
350410;201401;7538;28315;6795;26559;2442;10313;1579;5932;4021;16245
350420;201401;1018;3264;835;2907;391;1447;76;252;467;1699
350430;201401;866;2747;756;2558;205;836;371;1192;576;2028
350440;201401;1389;4505;1317;4378;486;1724;592;1902;1078;3626
350450;201401;8266;25651;6867;22835;2200;7864;1809;5821;4009;13685
350460;201401;1528;4588;1137;3756;335;1216;319;934;654;2150
350470;201401;236;696;202;638;54;198;88;253;142;451
350480;201401;774;2419;533;1835;89;349;88;255;177;604
350490;201401;2105;6193;1813;5813;521;1932;844;2518;1365;4450
350500;201401;613;1837;536;1721;136;493;227;680;363;1173
350510;201401;1105;3591;965;3288;302;1172;339;1027;641;2199
350520;201401;1276;5031;1164;4783;450;1935;290;1165;740;3100
350530;201401;2536;7750;2113;6813;814;2842;495;1435;1309;4277
350535;201401;1469;4398;1437;4352;80;280;1259;3827;1339;4107
350540;201401;2061;6038;1770;5530;510;1755;665;2078;1175;3833
350550;201401;10909;32565;8918;29145;2540;9366;3310;10149;5850;19515
350560;201401;3481;11836;3182;11241;655;2467;1653;5997;2308;8464
350570;201401;21032;73759;19404;70016;6331;24473;6830;23674;13161;48147
350580;201401;2014;6711;1715;6054;516;2021;254;766;770;2787
350590;201401;4042;13466;3255;11704;1037;4142;1074;3491;2111;7633
350600;201401;38803;100367;27450;82586;5834;19171;12943;37871;18777;57042
350610;201401;9202;27342;7481;24445;2023;7432;3317;10368;5340;17800
350620;201401;467;1459;391;1342;90;351;166;546;256;897
350630;201401;1639;5230;1330;4615;422;1671;130;393;552;2064
350635;201401;4998;16499;4093;14697;1247;4703;1513;5501;2760;10204
350640;201401;695;2239;593;1971;181;647;183;564;364;1211
350650;201401;4215;14071;3193;11611;1221;4880;298;1029;1519;5909
350660;201401;3788;12249;3353;11487;956;3517;1542;5243;2498;8760
350670;201401;1869;5884;1761;5697;359;1312;1108;3440;1467;4752
350680;201401;1216;3838;992;3376;295;1197;390;1260;685;2457
350690;201401;1062;3661;931;3374;284;1145;233;781;517;1926
350700;201401;2678;9399;2369;8690;936;3819;849;2768;1785;6587
350710;201401;2173;6966;1993;6689;360;1375;1291;4268;1651;5643
350715;201401;1128;3491;1009;3261;270;974;380;1147;650;2121
350720;201401;142;440;132;421;50;178;43;112;93;290
350730;201401;419;1630;399;1568;124;542;111;397;235;939
350740;201401;2401;7384;2177;6892;591;2036;896;2845;1487;4881
350745;201401;352;1139;290;990;67;274;121;358;188;632
350750;201401;9820;30700;7733;26519;2145;8113;1900;6113;4045;14226
350760;201401;12136;39411;11131;37583;3652;13787;4741;15098;8393;28885
350770;201401;905;2730;666;2257;145;566;233;770;378;1336
350775;201401;629;1894;581;1812;138;497;252;774;390;1271
350780;201401;2099;6477;1615;5467;419;1578;243;781;662;2359
350790;201401;2133;7095;1737;6241;538;2038;340;1105;878;3143
350800;201401;3081;10688;2942;10452;670;2657;1741;6067;2411;8724
350810;201401;2607;7750;2309;7225;785;2683;690;2166;1475;4849
350820;201401;547;1527;414;1251;91;312;143;390;234;702
350830;201401;890;2861;655;2271;124;475;126;358;250;833
350840;201401;2327;8501;1958;7532;637;2691;353;1178;990;3869
350850;201401;6848;23580;5757;20954;1944;7495;1274;4371;3218;11866
350860;201401;3390;11169;3263;10979;533;2042;2398;8019;2931;10061
350870;201401;2423;8408;2185;8043;765;3026;1059;3907;1824;6933
350880;201401;1690;5824;1457;5296;447;1752;279;1015;726;2767
350890;201401;648;1968;530;1718;99;355;171;467;270;822
350900;201401;4581;15559;3889;14039;1055;4160;1112;3749;2167;7909
350910;201401;874;2763;832;2674;376;1258;270;858;646;2116
350920;201401;9673;29614;9032;28556;1778;6248;5642;17185;7420;23433
350925;201401;5341;16905;4814;15863;1457;5260;1999;6360;3456;11620
350930;201401;1547;4351;1302;3944;162;607;908;2633;1070;3240
350940;201401;2303;7809;2112;7491;453;1882;1262;4276;1715;6158
350945;201401;947;3210;847;3003;230;908;340;1150;570;2058
350950;201401;71889;233924;61649;213187;18317;69281;23960;80405;42277;149686
350960;201401;4610;16506;4135;15442;844;3629;2211;7917;3055;11546
350970;201401;4269;15761;3905;14867;1535;6283;1124;4123;2659;10406
350980;201401;683;2250;631;2163;289;1079;129;437;418;1516
350990;201401;1806;6442;1615;6083;581;2384;520;1909;1101;4293
350995;201401;815;2980;774;2902;221;941;370;1315;591;2256
351000;201401;3522;10988;3093;10166;533;2055;1763;5569;2296;7624
351010;201401;422;1301;314;1072;121;455;63;216;184;671
351015;201401;956;3226;833;2994;319;1308;231;742;550;2050
351020;201401;7776;25922;6951;24676;1860;7119;3662;13218;5522;20337
351030;201401;1392;5245;1298;5027;379;1665;420;1550;799;3215
351040;201401;3698;12029;3440;11588;833;3258;1948;6166;2781;9424
351050;201401;9107;30118;7604;27194;2669;10354;2447;8724;5116;19078
351060;201401;33087;105566;28257;96660;9524;34550;9356;32173;18880;66723
351070;201401;1815;5264;1338;4412;464;1679;244;716;708;2395
351080;201401;2780;8530;2205;7830;667;2595;937;3256;1604;5851
351090;201401;386;1365;313;1210;111;491;51;179;162;670
351100;201401;1913;6257;1705;5841;671;2352;479;1680;1150;4032
351110;201401;8026;23434;5902;19561;1940;7076;1646;5169;3586;12245
351120;201401;600;1877;514;1677;73;292;252;737;325;1029
351130;201401;865;2417;454;1561;90;359;115;352;205;711
351140;201401;2003;7028;1839;6668;704;2796;553;1951;1257;4747
351150;201401;2224;7834;1842;6806;504;2048;422;1413;926;3461
351160;201401;1524;5443;1389;5124;477;1955;451;1599;928;3554
351170;201401;1642;5496;1332;4764;377;1455;484;1589;861;3044
351190;201401;817;2710;710;2433;179;648;148;444;327;1092
351200;201401;2220;6788;1936;6272;352;1355;951;2806;1303;4161
351210;201401;1095;3487;934;3174;298;1112;276;871;574;1983
351220;201401;3526;12104;3137;11297;909;3582;1266;4480;2175;8062
351230;201401;1893;6476;1722;6137;562;2223;782;2711;1344;4934
351240;201401;1032;3421;765;2801;217;886;183;595;400;1481
351250;201401;876;2577;662;2141;145;515;307;950;452;1465
351260;201401;1193;3624;1082;3390;304;1047;397;1187;701;2234
351270;201401;391;1424;361;1366;120;524;108;360;228;884
351280;201401;5270;16107;3885;12921;1055;3746;1122;3366;2177;7112
351290;201401;1008;3146;900;2929;284;961;260;796;544;1757
351300;201401;10068;37586;8871;34768;2629;11206;3165;12284;5794;23490
351310;201401;3391;10791;2873;9843;728;2883;1331;4204;2059;7087
351320;201401;1009;3616;893;3345;306;1262;205;671;511;1933
351330;201401;286;843;259;793;105;328;69;204;174;532
351340;201401;6674;23568;6071;22332;1768;6868;2901;10705;4669;17573
351350;201401;7809;26052;7034;24400;2135;7812;2520;8418;4655;16230
351360;201401;4899;15187;4625;14721;1298;4673;2120;6538;3418;11211
351370;201401;1946;6454;1606;5728;549;2184;355;1128;904;3312
351380;201401;37598;119807;35278;115136;9568;34173;16304;50959;25872;85132
351385;201401;251;804;245;795;93;308;86;276;179;584
351390;201401;1243;4273;1113;4000;436;1677;348;1177;784;2854
351400;201401;1232;4023;1176;3896;430;1512;409;1390;839;2902
351410;201401;2944;9117;2642;8606;629;2212;1311;4209;1940;6421
351420;201401;459;1369;336;1097;76;275;55;164;131;439
351430;201401;892;2868;813;2722;168;626;515;1702;683;2328
351440;201401;4707;14642;4138;13437;1575;5361;1026;3132;2601;8493
351450;201401;1817;5257;1608;4983;497;1575;824;2647;1321;4222
351460;201401;831;2667;712;2433;342;1253;193;621;535;1874
351470;201401;1085;3401;975;3197;391;1415;280;892;671;2307
351480;201401;2968;9904;2722;9485;695;2893;1293;4343;1988;7236
351490;201401;1998;6878;1807;6466;386;1629;959;3261;1345;4890
351492;201401;299;1023;231;839;49;214;64;187;113;401
351495;201401;156;549;130;479;39;153;45;156;84;309
351500;201401;20254;66426;18240;62508;5836;21666;7170;23997;13006;45663
351510;201401;7593;25110;6620;23447;1699;6540;3307;11607;5006;18147
351512;201401;404;1239;357;1149;94;327;141;448;235;775
351515;201401;1956;6703;1648;5984;534;2092;437;1506;971;3598
351518;201401;1619;5688;1247;5044;376;1679;237;896;613;2575
351519;201401;783;2603;692;2397;200;799;259;826;459;1625
351520;201401;807;2299;403;1458;64;271;49;155;113;426
351530;201401;467;1492;405;1336;89;317;123;354;212;671
351535;201401;2638;6966;2158;6271;270;904;1442;4106;1712;5010
351540;201401;2126;6916;1914;6527;950;3434;346;1147;1296;4581
351550;201401;5751;17877;4605;15509;1632;5803;1194;3913;2826;9716
351560;201401;430;1437;385;1336;146;557;58;192;204;749
351565;201401;240;823;223;777;68;281;85;259;153;540
351570;201401;12519;41456;11028;38429;3467;12583;4658;16271;8125;28854
351580;201401;399;1134;305;931;48;153;112;315;160;468
351590;201401;456;1302;401;1177;139;440;79;214;218;654
351600;201401;1873;5548;1729;5284;420;1497;805;2237;1225;3734
351610;201401;655;1856;560;1696;118;424;276;780;394;1204
351620;201401;18462;61630;14863;53793;4223;16667;3646;11857;7869;28524
351630;201401;14818;51016;13718;49211;4013;14932;7038;25701;11051;40633
351640;201401;8388;27556;7054;25232;1804;7062;3485;12262;5289;19324
351650;201401;366;1124;247;832;64;241;36;111;100;352
351660;201401;877;2789;698;2380;167;655;202;610;369;1265
351670;201401;4199;13480;3596;12203;759;2954;1740;5594;2499;8548
351680;201401;627;1967;446;1523;100;366;75;229;175;595
351685;201401;441;1364;358;1220;109;394;121;423;230;817
351690;201401;1340;4042;1068;3443;455;1473;254;760;709;2233
351700;201401;1469;4502;1348;4281;453;1509;438;1340;891;2849
351710;201401;806;2560;684;2282;169;579;199;623;368;1202
351720;201401;1660;5361;1293;4392;285;1083;432;1398;717;2481
351730;201401;1108;3375;956;3165;403;1485;255;781;658;2266
351740;201401;4588;13384;4003;12148;1082;3543;1285;3657;2367;7200
351750;201401;1503;5033;1323;4653;403;1551;342;1112;745;2663
351760;201401;3773;12418;3382;11567;908;3383;1453;4772;2361;8155
351770;201401;2255;7444;1965;6902;740;2708;820;2884;1560;5592
351780;201401;1622;4690;1117;3610;303;1085;224;673;527;1758
351790;201401;1148;3482;981;3243;329;1165;424;1375;753;2540
351800;201401;340;841;296;757;44;137;174;406;218;543
351810;201401;1197;3718;1133;3638;297;1113;687;2085;984;3198
351820;201401;2500;7565;1819;6308;675;2517;198;654;873;3171
351830;201401;4068;13573;3714;12795;931;3547;1676;5567;2607;9114
351840;201401;8972;31470;8100;29646;2775;10733;2501;9129;5276;19862
351850;201401;1288;4450;1096;4034;311;1275;220;725;531;2000
351860;201401;3600;11810;3350;11336;806;3095;1798;5788;2604;8883
351870;201401;35224;111087;32668;106679;7752;27415;18983;61704;26735;89119
351880;201401;112527;372162;99989;347036;32655;120031;29140;100785;61795;220816
351885;201401;657;2428;615;2329;171;687;266;974;437;1661
351890;201401;819;2485;656;2136;209;718;141;427;350;1145
351900;201401;1453;4541;1277;4257;412;1479;460;1537;872;3016
351905;201401;401;1427;347;1325;97;428;153;530;250;958
351907;201401;14759;47604;13041;44260;3017;11559;6333;20471;9350;32030
351910;201401;1169;3816;1087;3671;265;1011;364;1147;629;2158
351920;201401;1200;3531;1143;3446;277;958;665;1931;942;2889
351925;201401;974;2886;918;2796;131;500;633;1810;764;2310
351930;201401;3143;10942;2921;10469;852;3466;1235;4016;2087;7482
351940;201401;1014;3145;950;3028;279;985;545;1660;824;2645
351950;201401;1377;3938;1025;3233;217;751;440;1304;657;2055
351960;201401;3923;12853;3393;11853;1223;4470;1323;4676;2546;9146
351970;201401;7037;26899;6428;25600;2387;10072;2011;7950;4398;18022
351980;201401;955;2988;811;2713;182;712;320;965;502;1677
351990;201401;1595;4665;1322;4126;373;1361;371;1000;744;2361
352000;201401;2490;8164;2293;7765;574;2098;1010;3290;1584;5388
352010;201401;2284;7915;2103;7464;758;2845;452;1604;1210;4449
352020;201401;1500;4933;1362;4656;433;1555;433;1492;866;3047
352030;201401;4498;14405;4125;13935;974;3523;2345;8074;3319;11597
352040;201401;1829;6534;1593;5938;457;1810;357;1251;814;3061
352042;201401;2292;6683;1755;5547;447;1583;844;2590;1291;4173
352044;201401;1368;4744;1119;4109;277;1093;244;815;521;1908
352050;201401;7715;26565;5799;22104;1781;7464;998;3329;2779;10793
352060;201401;807;2447;725;2320;210;789;284;821;494;1610
352070;201401;731;2011;678;1928;293;902;195;581;488;1483
352080;201401;536;1683;461;1555;125;480;152;455;277;935
352090;201401;1692;5598;1414;5018;348;1378;467;1527;815;2905
352100;201401;1797;6256;1619;5903;546;2228;571;1872;1117;4100
352110;201401;433;1646;387;1537;114;494;111;418;225;912
352115;201401;378;1251;323;1134;96;372;149;492;245;864
352120;201401;981;2933;863;2771;180;624;491;1622;671;2246
352130;201401;1792;5128;1362;4392;372;1314;521;1537;893;2851
352140;201401;1445;4707;1137;4012;336;1254;441;1553;777;2807
352150;201401;606;1849;499;1657;178;640;178;565;356;1205
352160;201401;1243;3580;1147;3443;261;841;637;1928;898;2769
352170;201401;3181;9929;2921;9483;829;2934;1361;4218;2190;7152
352180;201401;3594;10472;3186;9726;869;2891;1396;4044;2265;6935
352190;201401;1069;3355;981;3198;224;889;499;1489;723;2378
352200;201401;420;1481;352;1344;76;320;159;624;235;944
352210;201401;16018;44370;13041;39997;2664;8708;7696;24204;10360;32912
352215;201401;562;1809;508;1730;78;297;291;1014;369;1311
352220;201401;14961;50692;13999;48751;4754;17611;5210;18077;9964;35688
352230;201401;13626;47543;12135;44751;3798;15353;4552;16458;8350;31811
352240;201401;9976;32315;9260;31041;3192;12016;3547;11222;6739;23238
352250;201401;22661;74071;20169;69043;5368;20157;7868;26616;13236;46773
352260;201401;5338;16766;3882;13754;1049;4147;1193;3853;2242;8000
352265;201401;940;3053;822;2866;143;578;505;1718;648;2296
352270;201401;2590;8926;2267;8201;887;3401;484;1664;1371;5065
352280;201401;2455;7810;2122;7270;603;2312;697;2311;1300;4623
352290;201401;1303;4280;1142;3929;283;1106;330;1010;613;2116
352300;201401;954;2911;804;2641;242;851;336;1102;578;1953
352310;201401;31740;108993;28980;104275;8041;31196;16299;57597;24340;88793
352320;201401;5663;17858;4986;16607;1597;5808;1641;4921;3238;10729
352330;201401;2192;7339;1929;7021;726;2847;650;2373;1376;5220
352340;201401;5807;20183;4857;17874;1638;6489;904;3046;2542;9535
352350;201401;1767;6589;1609;6230;445;1883;529;1959;974;3842
352360;201401;1185;3976;1062;3724;303;1257;558;1796;861;3053
352370;201401;905;3106;827;2939;195;775;376;1316;571;2091
352380;201401;1019;3308;906;3119;358;1388;244;802;602;2190
352390;201401;11555;35579;9342;31362;2178;8440;4339;13549;6517;21989
352400;201401;3219;9816;2225;7856;653;2560;838;2804;1491;5364
352410;201401;3731;11134;2894;9709;949;3450;860;2756;1809;6206
352420;201401;1293;3776;1212;3635;464;1552;422;1249;886;2801
352430;201401;6251;20064;5558;18910;2207;8179;1699;5595;3906;13774
352440;201401;15799;50639;13224;45584;3585;13379;5042;16921;8627;30300
352450;201401;634;1930;451;1579;123;472;92;286;215;758
352460;201401;2684;9162;2442;8713;874;3484;819;2687;1693;6171
352470;201401;4904;14048;3073;10236;591;2163;1280;4155;1871;6318
352480;201401;5398;15478;4474;13792;1207;4303;1820;5152;3027;9455
352490;201401;738;2678;638;2445;156;673;119;432;275;1105
352500;201401;8760;28745;8277;27929;3812;13880;2367;7307;6179;21187
352510;201401;3386;11909;2824;10693;1002;4087;675;2485;1677;6572
352520;201401;2454;8803;2234;8307;577;2321;1212;4435;1789;6756
352530;201401;6352;20822;4880;17667;1411;5613;812;2716;2223;8329
352540;201401;488;1625;399;1428;102;412;129;451;231;863
352550;201401;1072;3688;884;3275;307;1235;207;726;514;1961
352560;201401;553;1718;464;1529;93;363;209;608;302;971
352570;201401;1539;4979;1107;3965;258;1061;276;869;534;1930
352580;201401;932;2851;822;2666;294;1090;334;989;628;2079
352585;201401;217;735;173;639;41;169;53;176;94;345
352590;201401;13674;45062;12346;42496;2936;11330;6513;21706;9449;33036
352600;201401;1894;6205;1759;5911;621;2167;589;1937;1210;4104
352610;201401;3630;11828;3260;11227;1262;4759;1011;3348;2273;8107
352620;201401;5508;17927;5239;17569;1251;4427;3311;11176;4562;15603
352630;201401;848;2846;801;2729;238;895;356;1184;594;2079
352640;201401;3066;9977;2546;8829;585;2262;1010;3385;1595;5647
352650;201401;845;2546;645;2141;150;532;193;615;343;1147
352660;201401;1092;3855;899;3387;286;1150;258;959;544;2109
352670;201401;7764;26743;6850;24964;2632;10057;1627;5885;4259;15942
352680;201401;3187;11569;2652;10175;665;2809;721;2454;1386;5263
352690;201401;24470;74556;19845;65689;5249;19115;8131;26031;13380;45146
352700;201401;775;2351;625;2120;189;737;270;869;459;1606
352710;201401;5187;15685;3888;13056;1068;4008;1358;4302;2426;8310
352720;201401;8875;30327;8360;29246;2766;10252;3193;11123;5959;21375
352725;201401;411;1247;284;956;54;217;76;238;130;455
352730;201401;2612;9211;2308;8390;629;2502;670;2192;1299;4694
352740;201401;2256;6802;1945;6244;539;2050;848;2445;1387;4495
352750;201401;387;1223;320;1100;109;412;65;188;174;600
352760;201401;954;3380;890;3260;300;1209;457;1610;757;2819
352770;201401;927;2919;876;2821;242;855;318;1022;560;1877
352780;201401;608;2098;541;1952;158;637;168;541;326;1178
352790;201401;656;1939;536;1737;157;563;100;313;257;876
352800;201401;1122;4287;931;3757;277;1148;156;554;433;1702
352810;201401;1033;2808;789;2363;153;536;310;897;463;1433
352820;201401;553;1717;471;1571;211;753;83;280;294;1033
352830;201401;417;1239;328;1047;87;283;50;140;137;423
352840;201401;3497;12458;3133;11678;956;3812;1052;3919;2008;7731
352850;201401;9926;32783;8777;30752;2549;9549;3260;11549;5809;21098
352860;201401;1039;3505;966;3343;398;1459;232;728;630;2187
352870;201401;1094;2839;881;2429;137;491;477;1180;614;1671
352880;201401;2272;6962;1836;5984;436;1546;448;1329;884;2875
352885;201401;311;1082;297;1051;90;351;113;375;203;726
352890;201401;707;2067;626;1901;149;517;208;570;357;1087
352900;201401;18993;58792;14829;50230;4034;14883;5644;18370;9678;33253
352910;201401;285;934;254;866;78;277;33;93;111;370
352920;201401;3398;10578;2928;9656;979;3581;967;2935;1946;6516
352930;201401;7062;22859;5718;19857;1656;6191;1068;3594;2724;9785
352940;201401;27135;93249;23765;85196;8412;31815;4407;15285;12819;47100
352950;201401;316;1012;230;824;60;258;57;179;117;437
352960;201401;517;1712;396;1400;79;304;59;191;138;495
352965;201401;365;1042;301;923;77;246;43;129;120;375
352970;201401;3360;8969;3002;8503;384;1176;2159;6225;2543;7401
352980;201401;1449;4399;1250;4083;420;1424;487;1664;907;3088
352990;201401;3661;12431;3422;12011;1189;4559;1119;3768;2308;8327
353000;201401;529;1501;407;1249;89;305;109;295;198;600
353010;201401;2864;8305;2194;6931;616;2191;757;2193;1373;4384
353020;201401;4406;12414;3209;9864;541;1897;1322;3679;1863;5576
353030;201401;5027;15360;4410;14123;1579;5487;947;2847;2526;8334
353040;201401;693;2015;601;1872;201;685;215;649;416;1334
353050;201401;5529;19495;4786;17946;1806;7260;1374;4897;3180;12157
353060;201401;33639;110717;31520;107414;5654;22874;20800;67790;26454;90664
353070;201401;8719;30290;7045;26434;2452;9689;1603;6080;4055;15769
353080;201401;4715;16589;3986;14878;1323;5332;1059;3679;2382;9011
353090;201401;597;2030;534;1901;92;396;254;822;346;1218
353100;201401;273;832;227;726;99;327;47;142;146;469
353110;201401;7886;25070;7117;23654;1709;6064;3859;12996;5568;19060
353120;201401;464;1603;407;1473;146;596;93;303;239;899
353130;201401;3006;9512;2675;8929;1016;3715;921;2890;1937;6605
353140;201401;2596;7478;2140;6564;668;2242;640;1776;1308;4018
353150;201401;1952;6294;1645;5706;613;2243;371;1326;984;3569
353160;201401;616;1884;514;1674;150;516;98;294;248;810
353170;201401;525;1894;478;1807;188;795;176;634;364;1429
353180;201401;5431;17532;4818;16388;787;3130;2972;9750;3759;12880
353190;201401;3630;11834;3180;10778;802;3024;1414;4424;2216;7448
353200;201401;856;3064;777;2894;252;1058;283;991;535;2049
353205;201401;538;1749;442;1527;106;369;145;513;251;882
353210;201401;1028;2808;851;2495;126;448;520;1480;646;1928
353215;201401;563;1795;490;1639;106;400;161;548;267;948
353220;201401;908;2835;825;2670;224;801;275;859;499;1660
353230;201401;970;3124;893;2995;226;877;297;914;523;1791
353240;201401;2178;7369;1990;6976;650;2548;774;2490;1424;5038
353250;201401;1226;3551;1041;3215;300;1002;358;1045;658;2047
353260;201401;1148;3421;1021;3214;338;1130;376;1139;714;2269
353270;201401;648;2002;564;1840;182;646;150;445;332;1091
353280;201401;560;1876;490;1757;171;653;121;424;292;1077
353282;201401;1759;5949;1711;5873;311;1201;1118;3741;1429;4942
353284;201401;331;954;256;812;74;243;67;207;141;450
353286;201401;146;441;98;325;24;75;13;47;37;122
353290;201401;444;1606;406;1535;171;675;136;504;307;1179
353300;201401;1862;6058;1677;5651;598;2159;521;1602;1119;3761
353310;201401;352;1127;335;1081;141;481;89;269;230;750
353320;201401;524;1498;456;1387;111;402;217;617;328;1019
353325;201401;495;1770;421;1618;117;487;55;212;172;699
353330;201401;497;1545;421;1385;103;387;171;510;274;897
353340;201401;3160;10382;2754;9563;934;3515;942;3146;1876;6661
353350;201401;3433;10631;3067;9970;1016;3565;1391;4384;2407;7949
353360;201401;426;1518;377;1398;100;433;191;655;291;1088
353370;201401;708;2339;645;2182;174;624;296;991;470;1615
353380;201401;418;1405;378;1333;105;415;158;535;263;950
353390;201401;5406;14733;3928;12026;910;3090;1402;3878;2312;6968
353400;201401;615;1946;517;1736;116;427;146;413;262;840
353410;201401;683;2133;582;1973;180;675;289;955;469;1630
353420;201401;699;2081;530;1658;163;550;157;445;320;995
353430;201401;2469;8685;1819;6791;459;1784;116;344;575;2128
353440;201401;59965;200076;54561;187061;17052;61714;17125;57056;34177;118770
353450;201401;457;1413;410;1332;111;424;146;444;257;868
353460;201401;3559;10100;3038;9178;629;2072;1576;4731;2205;6803
353470;201401;11268;36225;8976;31408;2758;10558;1992;6757;4750;17315
353475;201401;1710;5031;1285;4096;329;1162;345;994;674;2156
353480;201401;1525;4637;1387;4391;321;1179;736;2205;1057;3384
353490;201401;1632;4733;1377;4220;369;1261;365;1009;734;2270
353500;201401;1196;3498;1118;3365;480;1544;377;1067;857;2611
353510;201401;1374;4522;1168;3962;330;1243;338;986;668;2229
353520;201401;1143;3589;982;3294;387;1385;249;845;636;2230
353530;201401;2749;8417;2485;7936;660;2373;1072;3270;1732;5643
353540;201401;1954;6111;1805;5859;672;2275;657;2168;1329;4443
353550;201401;6739;19722;6030;18569;1183;4290;3319;9505;4502;13795
353560;201401;2197;7349;1854;6723;441;1855;704;2436;1145;4291
353570;201401;489;1582;412;1420;103;407;204;624;307;1031
353580;201401;2416;8056;2268;7791;778;3004;1159;3767;1937;6771
353590;201401;798;2335;684;2136;262;889;165;533;427;1422
353600;201401;1883;5505;1724;5231;395;1332;851;2593;1246;3925
353610;201401;600;2145;531;2002;146;627;160;572;306;1199
353620;201401;2361;8312;2145;7896;714;2864;712;2473;1426;5337
353625;201401;372;1040;265;850;96;346;63;173;159;519
353630;201401;1715;5931;1390;5145;339;1409;267;881;606;2290
353640;201401;1575;4612;1441;4351;376;1225;606;1852;982;3077
353650;201401;6681;20556;4814;16361;1053;3888;1747;5583;2800;9471
353657;201401;325;1083;296;1019;72;293;108;345;180;638
353660;201401;1391;3624;1045;3089;458;1499;160;322;618;1821
353670;201401;4839;16194;4293;15042;1380;5275;1360;4500;2740;9775
353680;201401;664;2402;632;2345;328;1268;165;606;493;1874
353690;201401;519;1449;364;1188;104;385;126;378;230;763
353700;201401;2319;7614;2070;7054;508;1960;647;2042;1155;4002
353710;201401;2065;7218;1679;6339;604;2534;522;1902;1126;4436
353715;201401;474;1426;412;1315;79;291;199;621;278;912
353720;201401;2089;6666;1842;6293;383;1343;1063;3757;1446;5100
353730;201401;4451;14109;3654;12287;917;3334;967;3004;1884;6338
353740;201401;2311;7131;1883;6232;632;2195;488;1557;1120;3752
353750;201401;686;2462;580;2204;190;781;145;562;335;1343
353760;201401;7353;23847;6163;21646;1925;7190;2421;8592;4346;15782
353770;201401;793;2523;533;1862;108;408;52;126;160;534
353780;201401;5868;21170;5350;20118;2535;9796;1259;4976;3794;14772
353790;201401;3111;11267;2812;10633;1003;4203;509;1952;1512;6155
353800;201401;14390;47103;11759;41974;3331;13081;4555;15713;7886;28794
353810;201401;1195;4024;1066;3732;329;1215;413;1443;742;2658
353820;201401;1228;4402;1183;4325;414;1731;470;1568;884;3299
353830;201401;798;2207;637;1908;135;451;249;729;384;1180
353850;201401;1850;6216;1741;6028;453;1708;835;2787;1288;4495
353860;201401;2433;8423;2084;7630;721;2851;632;2277;1353;5128
353870;201401;23536;74867;18150;63708;4267;16788;5981;19020;10248;35808
353880;201401;2270;7624;2085;7344;410;1702;1245;4250;1655;5952
353890;201401;2387;6354;1807;5427;529;1782;751;2129;1280;3911
353900;201401;1160;3674;874;3022;209;794;195;587;404;1381
353910;201401;2128;7593;2030;7330;667;2556;815;2980;1482;5536
353920;201401;2534;7680;1961;6492;457;1592;365;1119;822;2711
353930;201401;3814;13831;3339;12806;1206;4912;732;2739;1938;7651
353940;201401;1524;4953;1344;4577;334;1332;529;1641;863;2973
353950;201401;3628;12033;3350;11526;573;2290;2124;7114;2697;9404
353960;201401;591;1935;491;1705;114;445;136;401;250;846
353970;201401;526;1572;463;1491;56;226;330;1034;386;1260
353980;201401;14319;43066;12220;39704;3030;10599;6266;20177;9296;30776
353990;201401;516;1628;476;1531;146;518;170;484;316;1002
354000;201401;1913;5774;1364;4681;307;1192;132;390;439;1582
354010;201401;383;1217;347;1156;156;534;99;333;255;867
354020;201401;4717;14657;4303;13805;1475;5105;1629;4867;3104;9972
354025;201401;1053;3101;858;2743;229;814;196;603;425;1417
354030;201401;626;1698;442;1422;146;529;138;407;284;936
354040;201401;790;2185;634;1897;94;346;370;1031;464;1377
354050;201401;938;3204;870;3058;331;1267;225;772;556;2039
354060;201401;4602;15157;3744;13338;1016;3912;1484;5085;2500;8997
354070;201401;3651;12351;3216;11347;1166;4419;748;2614;1914;7033
354075;201401;2255;8633;2167;8478;767;3247;914;3519;1681;6766
354080;201401;1900;5956;1540;5083;411;1416;460;1409;871;2825
354085;201401;303;861;271;804;33;130;188;512;221;642
354090;201401;1162;3550;1104;3459;162;577;812;2499;974;3076
354100;201401;16851;58436;14651;54340;3987;15836;6385;23602;10372;39438
354105;201401;860;2801;727;2544;185;758;262;806;447;1564
354110;201401;833;2438;687;2214;188;680;214;639;402;1319
354120;201401;2230;6422;1933;5897;553;1895;653;1860;1206;3755
354130;201401;5220;16137;4577;14865;1740;6040;1296;3968;3036;10008
354140;201401;20246;54397;13661;41642;2684;9371;5491;15474;8175;24845
354150;201401;4494;12810;3619;11257;1068;3674;1427;4251;2495;7925
354160;201401;4014;13451;3567;12490;1055;3986;1402;4742;2457;8728
354165;201401;405;1536;372;1451;136;567;85;344;221;911
354170;201401;1622;5364;1340;4678;293;1173;465;1448;758;2621
354180;201401;512;1581;498;1556;54;202;347;1029;401;1231
354190;201401;1644;5590;1444;5133;499;1881;443;1520;942;3401
354200;201401;1150;3389;958;3036;225;843;370;1027;595;1870
354210;201401;852;3029;772;2845;179;786;301;1011;480;1797
354220;201401;3116;9949;2835;9412;967;3409;1076;3471;2043;6880
354230;201401;790;2656;745;2575;236;858;338;1175;574;2033
354240;201401;1328;4578;1104;4076;320;1302;255;884;575;2186
354250;201401;527;1737;443;1595;188;762;123;413;311;1175
354260;201401;9519;29219;8698;27925;2740;9698;3445;10946;6185;20644
354270;201401;1133;4107;1061;3947;333;1377;412;1527;745;2904
354280;201401;901;2703;844;2606;181;639;453;1393;634;2032
354290;201401;1321;4746;1219;4520;400;1584;325;1188;725;2772
354300;201401;3926;13857;3839;13690;1080;4060;1973;7007;3053;11067
354310;201401;794;2680;636;2282;185;725;143;510;328;1235
354320;201401;835;2549;723;2319;213;774;227;666;440;1440
354323;201401;346;1033;284;929;110;388;89;260;199;648
354325;201401;1309;4583;1200;4347;334;1354;427;1418;761;2772
354330;201401;7957;25344;7264;23983;2018;7240;3644;11646;5662;18886
354340;201401;29938;99191;25905;91805;9834;37526;8688;29876;18522;67402
354350;201401;1156;3523;1087;3399;322;1069;542;1634;864;2703
354360;201401;443;1449;368;1317;92;357;36;120;128;477
354370;201401;1129;3815;999;3541;159;690;670;2289;829;2979
354380;201401;1314;4014;1106;3652;413;1523;181;510;594;2033
354390;201401;11562;38176;8933;32265;2261;8987;2463;8469;4724;17456
354400;201401;2114;7641;1869;7055;491;2039;568;2030;1059;4069
354410;201401;6399;19895;5395;18295;1312;4901;2747;9251;4059;14152
354420;201401;1674;5046;1404;4445;445;1519;448;1336;893;2855
354425;201401;3518;10333;3105;9594;1074;3565;931;2928;2005;6493
354430;201401;1369;4583;1272;4439;332;1310;595;1990;927;3300
354440;201401;548;1681;443;1468;95;355;179;569;274;924
354450;201401;486;1428;334;1095;60;255;92;256;152;511
354460;201401;801;2423;710;2257;263;884;301;947;564;1831
354470;201401;465;1395;380;1221;65;264;171;497;236;761
354480;201401;761;2344;685;2219;145;550;337;984;482;1534
354490;201401;758;2611;608;2236;149;596;187;601;336;1197
354500;201401;2553;8780;2351;8407;865;3392;678;2447;1543;5839
354510;201401;681;2329;615;2187;195;750;245;857;440;1607
354515;201401;352;1248;289;1093;71;304;85;297;156;601
354520;201401;5590;20093;4541;17306;1465;6203;1508;5489;2973;11692
354530;201401;2787;10241;2625;9929;777;3178;1362;5102;2139;8280
354540;201401;1363;4292;1200;4001;398;1414;426;1457;824;2871
354550;201401;537;1846;482;1706;103;386;177;584;280;970
354560;201401;1436;4421;1147;3779;329;1111;349;1120;678;2231
354570;201401;628;1989;531;1760;187;675;113;353;300;1028
354580;201401;8947;26763;7451;23931;1587;5781;3555;10824;5142;16605
354600;201401;1720;6019;1543;5673;507;2162;610;2074;1117;4236
354610;201401;467;1319;336;1052;66;219;96;260;162;479
354620;201401;428;1509;354;1364;102;473;117;414;219;887
354625;201401;277;934;237;852;63;259;57;189;120;448
354630;201401;1905;6758;1736;6359;736;2703;531;1864;1267;4567
354640;201401;4117;14045;3595;12921;1055;4273;790;2617;1845;6890
354650;201401;998;3092;912;2911;188;697;507;1554;695;2251
354660;201401;1967;6028;1565;5266;493;1865;565;1816;1058;3681
354670;201401;1624;5369;1317;4582;381;1463;321;945;702;2408
354680;201401;5326;18143;4923;17272;1435;5381;1823;6181;3258;11562
354690;201401;873;2988;629;2379;128;523;173;594;301;1117
354700;201401;1175;3391;820;2619;137;512;332;926;469;1438
354710;201401;625;1897;540;1720;146;560;175;492;321;1052
354720;201401;194;572;160;501;58;183;41;135;99;318
354730;201401;6608;23682;5942;22335;1801;7268;2438;8888;4239;16156
354740;201401;233;783;200;709;47;171;47;170;94;341
354750;201401;2316;7571;1993;7131;689;2672;734;2590;1423;5262
354760;201401;2198;7469;1895;6778;629;2389;430;1487;1059;3876
354765;201401;281;751;193;598;37;146;32;86;69;232
354770;201401;2802;8349;2274;7481;1017;3633;376;1151;1393;4784
354780;201401;34695;112912;32502;107958;8383;30841;15733;49658;24116;80499
354790;201401;870;2883;766;2700;218;839;309;1004;527;1843
354800;201401;1876;5736;1718;5523;474;1668;968;3118;1442;4786
354805;201401;881;2798;691;2388;111;444;119;374;230;818
354810;201401;688;2329;524;1956;172;706;87;309;259;1015
354820;201401;1050;3806;961;3636;306;1316;223;749;529;2065
354830;201401;436;1369;385;1273;123;467;129;394;252;861
354840;201401;796;2434;736;2321;232;779;261;806;493;1585
354850;201401;14756;48712;11551;41947;3210;12918;3895;13177;7105;26095
354860;201401;1272;4243;1170;4071;316;1339;537;1728;853;3067
354870;201401;42819;140255;40431;135314;12633;45242;18534;60554;31167;105796
354880;201401;4077;13020;3054;10733;884;3399;727;2274;1611;5673
354890;201401;14980;46982;13124;43307;3742;13524;4445;14069;8187;27593
354900;201401;604;1724;491;1562;167;588;177;551;344;1139
354910;201401;6475;20368;3888;14179;898;3593;453;1570;1351;5163
354920;201401;506;1517;394;1314;116;415;94;295;210;710
354925;201401;369;1084;226;784;43;164;36;108;79;272
354930;201401;258;806;238;757;75;272;65;202;140;474
354940;201401;2346;8426;1853;7065;738;2954;291;1063;1029;4017
354950;201401;1469;4996;1353;4832;252;1047;830;2911;1082;3958
354960;201401;785;2540;686;2372;204;789;240;798;444;1587
354970;201401;3968;13489;3548;12633;799;3252;1791;6090;2590;9342
354980;201401;32622;82038;18817;58231;4095;14240;6160;17678;10255;31918
354990;201401;36354;123568;33555;117786;7996;31099;17100;58231;25096;89330
354995;201401;1969;6296;1857;6131;482;1684;940;3134;1422;4818
355000;201401;1621;5561;1429;5211;511;1997;351;1257;862;3254
355010;201401;3659;11858;3143;10690;828;3128;1393;4627;2221;7755
355020;201401;3222;11756;2810;10951;1405;5801;681;2657;2086;8458
355030;201401;860766;2568773;797461;2446381;219678;733035;327880;982807;547558;1715842
355040;201401;2896;9738;2605;9192;918;3564;1163;3916;2081;7480
355050;201401;1256;4078;1051;3661;317;1191;264;910;581;2101
355060;201401;4921;17275;4036;15244;1112;4718;866;2963;1978;7681
355070;201401;6283;20205;5682;19207;1343;5240;2969;9477;4312;14717
355080;201401;1276;4755;1084;4211;341;1491;151;490;492;1981
355090;201401;1080;3958;927;3595;220;946;382;1400;602;2346
355100;201401;29470;97279;26627;92321;9545;34909;8783;31206;18328;66115
355110;201401;1302;4618;1197;4386;414;1656;373;1321;787;2977
355120;201401;657;2144;576;1981;184;686;224;736;408;1422
355130;201401;540;1504;350;1086;92;318;112;292;204;610
355140;201401;1026;3785;982;3684;308;1288;425;1541;733;2829
355150;201401;3453;11800;3045;11021;988;3740;1108;3879;2096;7619
355160;201401;1516;5336;1338;5041;558;2349;354;1178;912;3527
355170;201401;9584;28060;6952;23318;2310;8434;1760;5746;4070;14180
355180;201401;2875;9115;2519;8458;716;2781;949;3001;1665;5782
355190;201401;1270;4569;1176;4361;498;1893;329;1192;827;3085
355200;201401;901;3417;866;3341;431;1751;196;739;627;2490
355210;201401;2766;9735;2551;9291;781;3200;994;3345;1775;6545
355220;201401;29312;101870;27195;97681;12039;44916;7076;26161;19115;71077
355230;201401;1143;3450;756;2573;143;567;170;496;313;1063
355240;201401;21887;68719;17224;58325;4145;15624;6621;20762;10766;36386
355250;201401;24879;85350;22611;80919;6787;26076;9822;34698;16609;60774
355255;201401;890;2537;659;2063;119;406;192;573;311;979
355260;201401;1600;4773;1449;4504;398;1385;540;1552;938;2937
355270;201401;1659;5206;1582;5084;246;996;1109;3372;1355;4368
355280;201401;23467;72325;20720;67068;5212;19027;9143;28259;14355;47286
355290;201401;858;2817;798;2709;176;656;376;1220;552;1876
355300;201401;863;2859;676;2457;165;641;185;614;350;1255
355310;201401;1054;3312;947;3118;243;847;427;1442;670;2289
355320;201401;745;2413;665;2231;187;706;224;632;411;1338
355330;201401;1576;5776;1365;5368;498;2166;370;1336;868;3502
355340;201401;3141;8721;2930;8359;788;2512;1527;4132;2315;6644
355350;201401;1369;4936;1240;4664;416;1670;326;1229;742;2899
355360;201401;1176;4184;1105;4048;282;1160;695;2506;977;3666
355365;201401;310;998;266;911;74;285;66;216;140;501
355370;201401;6994;18664;5250;16621;1941;6750;1897;6037;3838;12787
355380;201401;3673;11333;2905;9552;821;2948;611;1734;1432;4682
355385;201401;985;3277;940;3194;390;1476;227;707;617;2183
355390;201401;1409;4002;1229;3652;341;1090;418;1207;759;2297
355395;201401;1720;5405;1351;4521;249;951;540;1650;789;2601
355400;201401;8822;31185;8090;29632;2866;11527;2973;10395;5839;21922
355410;201401;12970;48551;12206;46910;4850;19822;3239;12560;8089;32382
355420;201401;825;3069;791;2990;328;1310;248;952;576;2262
355430;201401;3627;10951;3176;10150;810;2853;1444;4462;2254;7315
355440;201401;885;2981;742;2616;214;787;182;563;396;1350
355450;201401;2548;8673;2181;7914;645;2606;675;2305;1320;4911
355460;201401;569;1660;444;1425;126;481;127;343;253;824
355465;201401;438;1359;376;1240;117;417;94;304;211;721
355470;201401;954;3009;786;2717;285;1107;244;776;529;1883
355475;201401;138;535;122;486;31;129;37;161;68;290
355480;201401;3227;12010;3055;11625;986;4034;1284;4755;2270;8789
355490;201401;826;2477;670;2161;194;695;153;492;347;1187
355495;201401;724;2463;686;2392;195;764;276;914;471;1678
355500;201401;8393;25832;6026;20567;1473;5587;1169;3632;2642;9219
355510;201401;2078;5910;1465;4685;335;1232;415;1229;750;2461
355520;201401;390;1032;263;786;57;198;72;183;129;381
355530;201401;221;567;122;379;26;92;22;66;48;158
355535;201401;714;2215;592;1978;161;645;177;489;338;1134
355540;201401;10236;33640;9743;32821;2832;10315;4691;15498;7523;25813
355550;201401;712;2284;669;2199;195;708;305;976;500;1684
355560;201401;1431;4293;1106;3658;278;1038;231;641;509;1679
355570;201401;189;644;166;588;40;146;38;124;78;270
355580;201401;1245;3820;1090;3503;406;1463;366;1111;772;2574
355590;201401;256;736;229;682;48;181;113;322;161;503
355600;201401;1051;3491;898;3124;379;1402;204;676;583;2078
355610;201401;1422;4232;1222;3915;370;1299;471;1452;841;2751
355620;201401;3916;12888;3216;11305;777;3111;1287;4106;2064;7217
355630;201401;3239;9620;2114;7221;445;1735;673;2093;1118;3828
355635;201401;992;3367;877;3156;191;766;505;1784;696;2550
355640;201401;3809;12900;3248;11578;1156;4331;581;2022;1737;6353
355645;201401;3384;12410;3227;12113;690;2867;1944;7215;2634;10082
355650;201401;6528;21105;5756;19575;1280;5200;3226;10186;4506;15386
355660;201401;1335;4389;1126;3980;359;1425;391;1287;750;2712
355670;201401;2262;7403;1569;5773;405;1703;475;1522;880;3225
355680;201401;1759;6124;1451;5376;544;2130;286;1009;830;3139
355690;201401;342;1200;305;1124;200;778;25;64;225;842
355695;201401;334;1031;253;838;35;119;19;48;54;167
355700;201401;6407;23246;5926;22068;1827;7389;2415;8600;4242;15989
355710;201401;12394;32584;8102;24658;2619;8554;1971;5739;4590;14293
355715;201401;241;739;162;572;43;164;29;101;72;265
355720;201401;1469;4938;1236;4436;419;1660;364;1169;783;2829
355730;201401;773;2745;706;2607;287;1127;156;585;443;1712
410010;201401;1635;5289;1493;4985;412;1498;435;1425;847;2923
410020;201401;1243;4303;1169;4145;376;1409;403;1416;779;2825
410030;201401;1072;3778;929;3430;288;1157;169;633;457;1790
410040;201401;12909;43857;11941;41876;4195;15811;3291;11388;7486;27199
410045;201401;1083;3161;831;2695;259;913;260;780;519;1693
410050;201401;3072;9058;2199;7400;711;2612;593;1927;1304;4539
410060;201401;1944;6353;1769;6001;555;2099;603;1976;1158;4075
410070;201401;2177;6297;1783;5476;667;2239;351;952;1018;3191
410080;201401;1448;4422;1232;4029;305;1076;617;1923;922;2999
410090;201401;1130;3652;1029;3436;366;1323;316;996;682;2319
410100;201401;2906;8904;2250;7417;674;2568;432;1282;1106;3850
410105;201401;502;1638;408;1420;97;389;74;221;171;610
410110;201401;2601;8221;2319;7633;590;2211;807;2571;1397;4782
410115;201401;557;1590;481;1425;100;340;155;421;255;761
410120;201401;2899;10100;2762;9898;1098;4188;1082;3951;2180;8139
410130;201401;1379;4707;1267;4444;385;1346;567;2017;952;3363
410140;201401;15059;42925;11029;35397;3286;11745;3693;11756;6979;23501
410150;201401;17956;45978;9125;27885;1837;6349;1737;4716;3574;11065
410160;201401;3343;10853;3076;10419;1022;3840;1053;3578;2075;7418
410165;201401;765;2344;647;2091;139;485;302;944;441;1429
410170;201401;1739;5472;1502;4958;589;2102;417;1329;1006;3431
410180;201401;8621;28154;7593;25923;1987;7714;3377;10711;5364;18425
410185;201401;659;1846;603;1749;171;532;336;986;507;1518
410190;201401;2183;6667;1952;6146;627;2145;518;1524;1145;3669
410200;201401;4987;14638;4224;13139;1430;4915;695;2075;2125;6990
410210;201401;2586;8020;2089;6936;506;1917;411;1174;917;3091
410220;201401;619;1829;497;1585;102;364;183;562;285;926
410230;201401;1840;6031;1696;5783;659;2472;563;1842;1222;4314
410240;201401;5183;16501;4813;15725;1589;5610;1681;5404;3270;11014
410250;201401;2467;7143;1862;5932;607;2172;369;1046;976;3218
410260;201401;1699;5388;1517;5051;455;1621;533;1737;988;3358
410270;201401;528;1597;456;1457;126;444;189;601;315;1045
410275;201401;910;2758;656;2220;115;429;354;1197;469;1626
410280;201401;2848;8665;2098;7040;465;1787;358;1132;823;2919
410290;201401;3234;10278;2900;9646;813;2899;1174;3923;1987;6822
410300;201401;611;1789;552;1668;86;318;302;835;388;1153
410302;201401;570;1685;483;1548;56;184;311;1020;367;1204
410304;201401;1451;4841;1334;4598;401;1443;556;1983;957;3426
410305;201401;2188;5940;1887;5507;543;1695;1019;3025;1562;4720
410310;201401;2308;7891;2136;7560;686;2644;749;2727;1435;5371
410315;201401;625;1950;495;1675;115;413;150;466;265;879
410320;201401;1233;3690;843;2879;178;700;70;206;248;906
410322;201401;581;1782;441;1471;120;421;123;399;243;820
410330;201401;1481;4242;1268;3831;361;1196;384;1112;745;2308
410335;201401;1051;3179;908;2923;249;911;328;987;577;1898
410337;201401;791;2180;684;1992;135;465;291;791;426;1256
410340;201401;578;1756;461;1453;87;315;133;355;220;670
410345;201401;1864;5716;1554;5059;501;1794;361;1085;862;2879
410347;201401;824;2397;605;1973;168;606;147;460;315;1066
410350;201401;1018;3278;793;2809;225;901;113;350;338;1251
410360;201401;3361;10551;3074;10082;1018;3624;908;2999;1926;6623
410370;201401;12825;38435;9938;32224;2606;9643;2838;8481;5444;18124
410380;201401;1364;4420;1283;4260;299;1066;689;2275;988;3341
410390;201401;2811;8407;2315;7504;848;2967;615;1848;1463;4815
410395;201401;888;3082;810;2906;219;902;370;1297;589;2199
410400;201401;5088;16857;4570;15848;1464;5694;1328;4452;2792;10146
410405;201401;946;2846;792;2539;217;824;297;873;514;1697
410410;201401;1351;4693;1290;4589;502;1974;294;1007;796;2981
410420;201401;9577;31850;8591;29650;2931;11021;2163;6949;5094;17970
410425;201401;3156;10348;2346;8463;526;2145;355;1233;881;3378
410430;201401;15344;43454;11967;37209;3452;11903;3446;10617;6898;22520
410440;201401;3556;11479;3289;10985;913;3301;1513;5059;2426;8360
410442;201401;2941;10406;2715;9874;938;3609;840;3066;1778;6675
410445;201401;2374;8097;2075;7560;655;2585;746;2842;1401;5427
410450;201401;2642;7653;2157;6737;676;2265;422;1193;1098;3458
410460;201401;2372;7263;2013;6529;542;1936;730;2254;1272;4190
410465;201401;1787;6788;1648;6446;606;2467;494;1833;1100;4300
410470;201401;1912;6208;1700;5725;520;1850;584;1963;1104;3813
410480;201401;29696;88775;24716;79152;9259;32393;6381;19639;15640;52032
410490;201401;11345;37703;9638;33941;3136;12075;3009;10460;6145;22535
410500;201401;1505;4891;1268;4357;482;1823;309;1061;791;2884
410510;201401;2375;6492;1808;5370;489;1585;725;2012;1214;3597
410520;201401;3218;11488;3075;11189;1205;4640;1031;3759;2236;8399
410530;201401;1641;4827;1403;4348;375;1351;526;1515;901;2866
410540;201401;3813;11267;2795;9349;726;2623;955;3171;1681;5794
410550;201401;6515;20628;5251;17758;1663;6234;789;2407;2452;8641
410560;201401;1258;4160;1029;3567;242;898;259;772;501;1670
410570;201401;2823;9411;2611;9063;810;2920;1078;4019;1888;6939
410580;201401;25180;81557;22469;75903;7597;28170;6467;20713;14064;48883
410590;201401;1227;4001;856;2934;159;601;205;635;364;1236
410600;201401;1891;5801;1645;5317;479;1635;699;2272;1178;3907
410610;201401;829;2625;728;2431;200;715;309;986;509;1701
410620;201401;1710;6289;1567;5927;522;2089;376;1387;898;3476
410630;201401;2480;7497;2122;6803;574;2047;769;2351;1343;4398
410640;201401;4943;14832;4068;13176;1329;4889;935;2866;2264;7755
410645;201401;1282;4626;1231;4524;539;2142;348;1293;887;3435
410650;201401;2442;7644;2056;6875;717;2557;505;1597;1222;4154
410655;201401;918;2856;778;2577;238;868;216;692;454;1560
410657;201401;621;1923;530;1739;153;589;200;579;353;1168
410660;201401;3810;11267;3058;9634;1104;3752;617;1804;1721;5556
410670;201401;995;2895;778;2464;204;717;192;568;396;1285
410680;201401;2393;8545;2051;7643;567;2149;689;2712;1256;4861
410685;201401;667;2057;627;1992;116;359;408;1319;524;1678
410690;201401;107576;317831;77386;255701;19005;69991;18701;55811;37706;125802
410700;201401;2263;7467;2143;7234;706;2616;855;2758;1561;5374
410710;201401;1080;3445;892;2992;243;907;231;717;474;1624
410712;201401;757;2403;682;2257;314;1124;167;579;481;1703
410715;201401;1043;3362;926;3104;243;890;321;1043;564;1933
410720;201401;4092;13031;3479;11736;1053;3798;945;3034;1998;6832
410725;201401;1127;3314;844;2751;218;770;232;670;450;1440
410730;201401;711;2193;654;2064;285;959;169;519;454;1478
410740;201401;944;2890;687;2352;157;623;295;991;452;1614
410750;201401;1805;5581;1631;5173;536;1899;452;1314;988;3213
410752;201401;261;791;220;714;47;187;102;299;149;486
410753;201401;455;1397;359;1195;75;287;141;439;216;726
410754;201401;993;3094;883;2912;119;435;588;2007;707;2442
410755;201401;723;2045;588;1820;122;445;285;823;407;1268
410760;201401;2437;8074;2340;7887;903;3248;803;2635;1706;5883
410765;201401;15561;47571;12115;40624;2931;10985;2095;6884;5026;17869
410770;201401;890;2584;752;2324;257;869;203;571;460;1440
410773;201401;1193;3786;1085;3587;286;1061;492;1505;778;2566
410775;201401;1817;5464;1754;5357;503;1481;1045;3349;1548;4830
410780;201401;584;1753;465;1540;141;490;151;554;292;1044
410785;201401;920;3061;757;2580;263;935;270;924;533;1859
410790;201401;595;1850;502;1639;132;509;101;263;233;772
410800;201401;2400;6890;2017;6209;811;2752;604;1759;1415;4511
410810;201401;323;1018;266;884;34;130;112;365;146;495
410820;201401;1064;3284;918;2954;262;928;229;724;491;1652
410830;201401;30882;94825;26061;86200;8087;29275;8671;28477;16758;57752
410832;201401;1164;3557;1073;3394;245;921;524;1519;769;2440
410840;201401;7336;23409;6094;20628;2061;7629;1127;3411;3188;11040
410845;201401;1585;4841;1414;4493;275;962;787;2527;1062;3489
410850;201401;2747;8283;2489;7913;559;2067;1326;4196;1885;6263
410855;201401;728;2086;614;1852;169;559;207;615;376;1174
410860;201401;3664;10816;3174;9929;785;2584;1467;4753;2252;7337
410865;201401;1662;5849;1508;5543;414;1647;710;2669;1124;4316
410870;201401;1368;4313;1296;4191;652;2301;321;960;973;3261
410880;201401;4488;13570;3691;12123;988;3797;883;2513;1871;6310
410890;201401;1094;3448;851;2996;275;1063;109;318;384;1381
410895;201401;1070;3827;979;3620;358;1414;308;1095;666;2509
410900;201401;868;2509;690;2222;139;509;211;651;350;1160
410910;201401;317;998;289;946;61;220;136;426;197;646
410920;201401;831;2588;695;2351;215;786;190;591;405;1377
410930;201401;2071;6586;1836;6171;562;2205;645;2080;1207;4285
410940;201401;20696;71305;18726;67634;6264;24665;7406;26856;13670;51521
410950;201401;1893;6349;1732;6048;372;1365;1002;3564;1374;4929
410960;201401;6526;18864;4629;15305;1524;5510;1428;4796;2952;10306
410965;201401;1064;3451;959;3231;270;988;407;1384;677;2372
410970;201401;5165;15985;4340;14304;1476;5480;954;3143;2430;8623
410975;201401;1432;4313;1214;3931;223;853;616;1993;839;2846
410980;201401;4963;14946;3405;11616;846;3241;777;2514;1623;5755
410990;201401;1066;3335;815;2784;252;955;209;637;461;1592
411000;201401;453;1406;342;1159;77;300;50;144;127;444
411005;201401;482;1461;372;1185;97;313;60;166;157;479
411007;201401;2163;7110;2022;6817;624;2236;914;3186;1538;5422
411010;201401;3938;13737;3670;13136;1390;5476;838;2747;2228;8223
411020;201401;2587;8449;2383;8094;806;3084;827;2828;1633;5912
411030;201401;819;2304;720;2122;229;747;187;511;416;1258
411040;201401;394;1296;330;1148;108;397;74;252;182;649
411050;201401;2124;7752;1924;7290;697;2840;354;1274;1051;4114
411060;201401;2081;6720;1832;6188;579;2191;310;927;889;3118
411065;201401;395;1220;324;1078;57;199;108;333;165;532
411070;201401;4354;14415;3364;12135;1063;4245;426;1352;1489;5597
411080;201401;2014;6478;1874;6195;497;1849;789;2586;1286;4435
411090;201401;616;1608;495;1446;89;317;120;316;209;633
411095;201401;1573;4637;1263;4046;310;1112;322;991;632;2103
411100;201401;1492;4380;1143;3708;262;956;261;811;523;1767
411110;201401;926;2839;719;2376;205;727;110;307;315;1034
411120;201401;1700;5449;1508;5054;483;1758;460;1505;943;3263
411125;201401;4683;15494;4569;15276;1633;5776;2100;6904;3733;12680
411130;201401;772;2412;649;2154;190;666;213;716;403;1382
411140;201401;2185;7939;1922;7260;707;2805;383;1537;1090;4342
411150;201401;5932;17044;5002;15254;1459;4848;1243;3438;2702;8286
411155;201401;1162;3535;1051;3290;363;1260;343;985;706;2245
411160;201401;310;951;280;893;107;358;82;250;189;608
411170;201401;799;2755;729;2592;216;818;229;802;445;1620
411180;201401;6175;19272;5485;17960;1652;5967;1662;5375;3314;11342
411190;201401;1793;5382;1540;4911;453;1610;448;1352;901;2962
411200;201401;4017;12790;3508;11956;1237;4640;1272;4203;2509;8843
411210;201401;2783;8171;2321;7331;872;2999;338;1014;1210;4013
411220;201401;1191;3510;975;3106;247;906;401;1155;648;2061
411230;201401;1063;3297;844;2809;272;1009;208;630;480;1639
411240;201401;1392;3479;847;2632;257;886;202;547;459;1433
411250;201401;3118;8829;2602;7887;789;2504;803;2441;1592;4945
411260;201401;263;767;208;675;59;221;86;252;145;473
411270;201401;2031;6557;1882;6287;602;2238;791;2565;1393;4803
411275;201401;1525;4681;1348;4275;386;1265;348;1057;734;2322
411280;201401;1738;5458;1413;4745;409;1576;219;649;628;2225
411290;201401;1025;2933;865;2620;226;748;302;951;528;1699
411295;201401;1041;3168;971;3050;208;732;409;1254;617;1986
411300;201401;1306;3434;932;2723;90;309;372;984;462;1293
411310;201401;833;2464;681;2211;151;581;297;930;448;1511
411320;201401;5586;17488;4673;15677;1297;4569;1222;3985;2519;8554
411325;201401;1536;5053;1392;4770;205;807;906;3108;1111;3915
411330;201401;3516;11732;3220;11211;1268;4756;938;3234;2206;7990
411340;201401;984;2936;670;2188;154;576;246;794;400;1370
411342;201401;899;2606;744;2264;205;692;189;501;394;1193
411345;201401;1050;3429;978;3293;281;1038;479;1612;760;2650
411350;201401;2582;8260;2013;7087;635;2440;266;843;901;3283
411360;201401;515;1328;335;989;48;189;136;323;184;512
411370;201401;43098;127925;33670;110113;7565;29176;11424;34163;18989;63339
411373;201401;1399;4560;1223;4195;345;1370;292;945;637;2315
411375;201401;1081;3170;925;2840;252;829;283;800;535;1629
411380;201401;1273;3474;827;2554;150;528;239;702;389;1230
411390;201401;1800;5591;1624;5334;366;1362;955;3040;1321;4402
411400;201401;1667;5150;1387;4539;336;1239;441;1386;777;2625
411410;201401;2422;7709;2153;7093;713;2687;549;1526;1262;4213
411420;201401;4472;13177;3574;11277;984;3485;720;1966;1704;5451
411430;201401;2828;9324;2471;8678;751;2852;1028;3497;1779;6349
411435;201401;558;1832;486;1647;130;484;165;540;295;1024
411440;201401;2558;8542;2375;8209;903;3352;679;2406;1582;5758
411450;201401;2008;6270;1851;6015;457;1583;988;3237;1445;4820
411460;201401;4293;13965;3466;11957;1298;4782;615;2011;1913;6793
411470;201401;916;2881;680;2284;184;676;115;339;299;1015
411480;201401;4550;14309;3777;12842;1680;6200;768;2455;2448;8655
411490;201401;1649;5309;1509;5066;635;2420;349;1044;984;3464
411500;201401;1487;4520;1146;3809;359;1310;268;839;627;2149
411510;201401;2444;7323;1973;6392;628;2268;383;1074;1011;3342
411520;201401;27812;80958;19590;63871;6286;22684;3920;12074;10206;34758
411530;201401;901;2635;631;2130;247;945;103;289;350;1234
411535;201401;447;1356;236;851;42;179;21;67;63;246
411540;201401;2987;8285;2419;7260;480;1533;1272;3902;1752;5435
411545;201401;1006;3626;946;3503;224;914;587;2158;811;3072
411550;201401;719;2043;587;1821;254;866;127;362;381;1228
411560;201401;2562;7927;2156;6972;609;2162;481;1457;1090;3619
411570;201401;5888;16673;4567;14447;1344;4794;1106;3653;2450;8447
411573;201401;981;3082;937;3004;235;821;492;1599;727;2420
411575;201401;1426;4720;1259;4351;339;1252;472;1610;811;2862
411580;201401;3510;10709;2732;9156;639;2494;483;1420;1122;3914
411585;201401;480;1707;377;1408;92;368;56;197;148;565
411590;201401;566;1724;515;1617;137;497;148;439;285;936
411600;201401;363;1123;304;1005;68;276;76;256;144;532
411605;201401;2289;6529;1734;5474;459;1605;650;1975;1109;3580
411610;201401;2181;6553;2082;6380;517;1708;1310;3943;1827;5651
411620;201401;2695;9080;2558;8851;859;3213;1016;3592;1875;6805
411630;201401;697;1924;445;1515;134;532;80;239;214;771
411640;201401;588;1837;496;1638;139;509;175;537;314;1046
411650;201401;186;611;166;573;43;171;55;170;98;341
411660;201401;788;2364;692;2184;188;626;281;906;469;1532
411670;201401;1680;5004;1515;4691;495;1748;520;1483;1015;3231
411680;201401;1660;5221;1473;4902;382;1267;796;2827;1178;4094
411690;201401;3575;10983;3075;10065;1091;3847;773;2540;1864;6387
411695;201401;818;2669;702;2439;144;516;344;1215;488;1731
411700;201401;1835;5502;1424;4728;381;1432;383;1196;764;2628
411705;201401;2246;7851;1992;7369;481;1833;1138;4337;1619;6170
411710;201401;2154;6762;1754;5865;514;1880;365;1078;879;2958
411720;201401;667;2043;522;1699;107;395;136;414;243;809
411721;201401;713;2182;609;1966;179;635;146;414;325;1049
411722;201401;673;2086;559;1854;142;540;165;499;307;1039
411725;201401;1287;4248;936;3392;240;952;227;824;467;1776
411727;201401;2320;6790;1911;5916;503;1715;770;2271;1273;3986
411729;201401;534;1508;422;1329;79;269;157;460;236;729
411730;201401;5547;16735;4773;15248;1537;5304;1685;5368;3222;10672
411740;201401;519;1561;428;1367;121;457;163;472;284;929
411745;201401;862;2757;728;2429;182;673;171;525;353;1198
411750;201401;4188;13395;3397;11414;1038;3867;589;1805;1627;5672
411760;201401;8634;26517;7910;25299;2908;9915;2475;8253;5383;18168
411770;201401;3809;13705;3429;12778;1329;5185;746;2828;2075;8013
411780;201401;2982;10037;2893;9928;415;1380;2090;7587;2505;8967
411790;201401;2375;7139;1928;6270;624;2323;592;1839;1216;4162
411800;201401;1227;3772;824;2790;138;519;119;304;257;823
411810;201401;1528;4852;1351;4450;383;1446;364;1010;747;2456
411820;201401;16321;52124;13866;47631;4813;17091;4165;15140;8978;32231
411830;201401;432;1208;360;1113;114;347;141;476;255;823
411840;201401;8618;26463;7145;23573;2150;7817;1950;6233;4100;14050
411845;201401;514;1685;414;1455;112;434;77;267;189;701
411850;201401;5966;18613;5105;16889;1393;5014;1400;4583;2793;9597
411860;201401;856;2807;738;2545;205;756;203;654;408;1410
411870;201401;1012;3641;825;3129;142;582;203;723;345;1305
411880;201401;2463;7168;2138;6612;492;1730;1032;3227;1524;4957
411885;201401;1422;4005;1169;3607;360;1242;350;972;710;2214
411890;201401;1306;4105;977;3342;261;1002;192;570;453;1572
411900;201401;911;2997;712;2483;225;803;107;366;332;1169
411910;201401;1196;4192;1070;3904;320;1297;349;1194;669;2491
411915;201401;11770;34678;8244;27149;1993;7380;1883;5549;3876;12929
411920;201401;985;3580;899;3348;274;1118;190;668;464;1786
411925;201401;596;1766;481;1563;148;514;151;474;299;988
411930;201401;6070;20550;5453;19297;1867;7061;1880;6778;3747;13839
411940;201401;3567;12223;3242;11522;1063;3984;872;3081;1935;7065
411950;201401;9910;32830;8730;30550;2652;10138;3755;12943;6407;23081
411960;201401;5394;16797;5100;16245;1400;4990;2330;7183;3730;12173
411965;201401;515;1652;415;1462;110;441;111;393;221;834
411970;201401;756;2233;609;1990;212;753;144;444;356;1197
411980;201401;2086;5873;1500;4944;194;715;808;2659;1002;3374
411990;201401;28277;99273;25140;92666;9351;36803;6486;24303;15837;61106
411995;201401;3026;9766;2791;9292;1144;4108;703;2293;1847;6401
412000;201401;2020;5701;1649;5059;360;1275;669;1818;1029;3093
412010;201401;709;2447;637;2274;179;671;186;653;365;1324
412015;201401;638;2025;540;1814;105;392;276;919;381;1311
412020;201401;428;1282;331;1091;115;415;124;380;239;795
412030;201401;589;1881;413;1456;90;380;120;388;210;768
412033;201401;719;2278;570;1927;142;532;101;297;243;829
412035;201401;946;2801;778;2497;199;742;303;898;502;1640
412040;201401;723;2429;659;2264;245;888;190;632;435;1520
412050;201401;1572;4824;1260;4144;318;1169;275;865;593;2034
412060;201401;6737;24094;6242;22939;1985;7781;2356;8609;4341;16390
412065;201401;970;3004;833;2719;243;894;235;710;478;1604
412070;201401;1097;3187;994;2971;213;699;386;1131;599;1830
412080;201401;1932;6234;1455;5183;408;1594;150;463;558;2057
412085;201401;284;811;172;590;49;187;42;132;91;319
412090;201401;4802;16138;4616;15795;1022;3801;2899;10031;3921;13832
412100;201401;2197;7076;1966;6683;647;2343;676;2274;1323;4617
412110;201401;1017;3079;797;2630;265;929;241;774;506;1703
412120;201401;2318;8024;2143;7619;566;2234;1002;3415;1568;5649
412125;201401;961;3022;862;2859;257;933;323;1077;580;2010
412130;201401;744;2169;559;1813;117;441;120;359;237;800
412135;201401;557;1624;429;1360;89;311;183;527;272;838
412140;201401;1817;5663;1561;5146;450;1603;444;1468;894;3071
412150;201401;2785;8507;2478;7903;441;1555;1387;4320;1828;5875
412160;201401;1191;3813;932;3170;278;1066;322;1052;600;2118
412170;201401;4342;14843;3787;13713;1343;5182;1279;4588;2622;9770
412175;201401;1482;5253;1356;4974;396;1590;523;1946;919;3536
412180;201401;1730;5590;1373;4955;530;2127;359;1213;889;3340
412190;201401;2957;9155;2501;8401;959;3420;644;2278;1603;5698
412200;201401;2254;7699;1670;6072;399;1555;499;1790;898;3345
412210;201401;732;2127;464;1535;114;444;90;269;204;713
412215;201401;3154;10546;2878;10029;509;1829;1832;6605;2341;8434
412217;201401;1160;3495;1108;3400;227;804;683;1970;910;2774
412220;201401;5620;19042;5425;18661;1928;7024;2647;9077;4575;16101
412230;201401;2894;10153;2604;9523;826;3324;730;2546;1556;5870
412240;201401;8862;23942;5293;17032;1107;3998;763;2155;1870;6153
412250;201401;2160;6746;1977;6373;735;2579;453;1343;1188;3922
412260;201401;1289;3912;886;3036;203;808;254;753;457;1561
412265;201401;1159;3763;1087;3630;286;1156;499;1598;785;2754
412270;201401;758;2572;612;2201;140;572;99;331;239;903
412280;201401;668;2100;543;1851;167;606;242;799;409;1405
412290;201401;1224;3512;1040;3156;223;764;387;1109;610;1873
412300;201401;1766;5346;1482;4798;474;1744;392;1186;866;2930
412310;201401;1200;3473;1070;3303;218;589;684;2365;902;2954
412320;201401;688;1921;510;1611;140;526;172;521;312;1047
412330;201401;1977;5515;1535;4739;390;1321;671;2048;1061;3369
412340;201401;740;2383;536;1853;107;408;107;348;214;756
412350;201401;2457;7995;2101;7198;655;2436;399;1249;1054;3685
412360;201401;338;1104;296;996;66;236;79;225;145;461
412370;201401;1121;3553;893;3107;307;1119;246;847;553;1966
412380;201401;2014;6191;1759;5650;460;1556;616;2029;1076;3585
412382;201401;699;2044;534;1699;144;531;141;401;285;932
412385;201401;2477;8071;2310;7723;679;2391;865;3002;1544;5393
412390;201401;2432;7396;2245;7075;827;2842;778;2406;1605;5248
412395;201401;964;2726;789;2450;132;434;476;1500;608;1934
412400;201401;1190;3736;1069;3511;339;1194;415;1404;754;2598
412402;201401;2045;6450;1761;5839;550;1993;466;1408;1016;3401
412405;201401;4013;11893;2698;9022;669;2583;278;812;947;3395
412410;201401;6195;20601;5680;19542;2459;9296;1076;3626;3535;12922
412420;201401;524;1589;435;1425;140;508;114;315;254;823
412430;201401;453;1383;384;1237;119;429;154;449;273;878
412440;201401;3981;12191;3551;11453;690;2471;1509;5103;2199;7574
412450;201401;388;1240;325;1083;74;280;65;169;139;449
412460;201401;983;2816;700;2292;173;658;156;479;329;1137
412470;201401;2024;7024;1862;6630;613;2333;661;2339;1274;4672
412480;201401;1329;3997;993;3267;225;812;178;485;403;1297
412490;201401;1279;3862;1163;3594;302;970;330;1013;632;1983
412500;201401;2013;6134;1740;5598;503;1816;430;1229;933;3045
412510;201401;2739;9449;2446;8669;819;3147;790;2707;1609;5854
412520;201401;1802;5179;1411;4528;405;1395;482;1539;887;2934
412530;201401;790;2399;669;2127;212;718;164;503;376;1221
412535;201401;417;1278;306;993;79;281;95;264;174;545
412540;201401;1207;3619;951;3074;180;687;376;1193;556;1880
412545;201401;899;2607;754;2295;145;490;260;708;405;1198
412550;201401;23998;74077;17216;58903;4746;17683;3250;10337;7996;28020
412555;201401;311;988;236;797;49;178;42;115;91;293
412560;201401;4268;14591;3711;13431;1171;4669;766;2477;1937;7146
412570;201401;4314;13496;3422;11402;976;3587;716;2312;1692;5899
412575;201401;1044;3359;889;2990;221;841;273;850;494;1691
412580;201401;1466;4091;1102;3466;258;880;356;1065;614;1945
412590;201401;490;1524;405;1370;156;563;99;340;255;903
412600;201401;1469;4777;1291;4420;430;1634;375;1192;805;2826
412610;201401;762;2499;630;2180;205;794;157;472;362;1266
412620;201401;1258;4208;1087;3840;386;1494;247;835;633;2329
412625;201401;13696;39520;11646;35698;4237;14072;2434;7371;6671;21443
412627;201401;958;3023;713;2504;225;854;82;277;307;1131
412630;201401;3507;11402;3151;10637;862;3127;955;3116;1817;6243
412635;201401;529;1635;391;1320;96;335;54;164;150;499
412640;201401;863;2651;639;2139;142;528;129;392;271;920
412650;201401;2264;6521;1881;5806;504;1729;644;1773;1148;3502
412660;201401;3040;9316;2573;8357;654;2447;621;1875;1275;4322
412665;201401;725;1981;463;1514;140;510;130;400;270;910
412667;201401;1464;4482;1207;3981;308;1178;342;1026;650;2204
412670;201401;649;2069;459;1610;112;457;65;171;177;628
412680;201401;1468;4911;1247;4374;345;1295;330;1050;675;2345
412690;201401;670;2153;545;1873;191;721;85;276;276;997
412700;201401;1820;6089;1615;5740;611;2424;554;1902;1165;4326
412710;201401;8818;28071;7493;25336;2127;7897;1839;5961;3966;13858
412720;201401;1639;5254;1180;4070;267;988;124;343;391;1331
412730;201401;2795;8575;2013;6910;604;2229;253;780;857;3009
412740;201401;2118;7049;1912;6575;749;2745;261;937;1010;3682
412750;201401;3440;11581;3195;11140;635;2502;2080;7092;2715;9594
412760;201401;2251;7638;2160;7479;675;2603;848;2770;1523;5373
412770;201401;11807;35296;8130;27217;1838;6905;1624;4944;3462;11849
412780;201401;1472;4931;1319;4576;400;1481;392;1284;792;2765
412785;201401;2456;7312;1854;6040;602;2128;707;2239;1309;4367
412788;201401;1341;4549;1269;4416;341;1383;531;1728;872;3111
412790;201401;1127;3621;964;3275;209;786;288;876;497;1662
412795;201401;1031;3103;900;2864;304;1056;270;812;574;1868
412796;201401;2600;8427;2437;8097;644;2378;1096;3502;1740;5880
412800;201401;3519;10684;2878;9453;773;2808;845;2603;1618;5411
412810;201401;9722;28105;6454;20864;1790;6370;1452;4240;3242;10610
412820;201401;6238;19550;4799;16678;1437;5444;987;3469;2424;8913
412830;201401;401;1313;344;1199;102;420;81;235;183;655
412840;201401;2240;6546;1882;5842;543;1887;450;1351;993;3238
412850;201401;2543;7858;2245;7434;425;1621;1138;3647;1563;5268
412853;201401;1632;4956;1467;4674;263;1058;815;2384;1078;3442
412855;201401;1655;4896;1382;4373;462;1689;351;959;813;2648
412860;201401;1254;3897;1113;3645;289;1082;501;1568;790;2650
412862;201401;801;2243;632;1898;176;586;215;601;391;1187
412863;201401;1205;4196;1167;4130;178;680;802;2825;980;3505
412865;201401;660;2092;496;1689;112;418;173;602;285;1020
412870;201401;1029;3024;887;2802;325;1124;280;877;605;2001
412880;201401;1577;4355;1359;4007;387;1267;329;925;716;2192
420005;201401;483;1536;347;1224;73;282;150;503;223;785
420010;201401;3212;10194;2778;9471;446;1629;1914;6605;2360;8234
420020;201401;751;2545;489;1823;82;348;65;208;147;556
420030;201401;501;1499;314;1120;89;363;53;169;142;532
420040;201401;1003;3172;693;2561;226;936;149;481;375;1417
420050;201401;796;2579;654;2245;202;717;242;816;444;1533
420055;201401;318;1038;225;817;58;223;47;151;105;374
420060;201401;377;1346;292;1121;71;297;36;129;107;426
420070;201401;2010;6503;1735;5812;333;1240;741;2574;1074;3814
420075;201401;200;600;119;400;30;118;30;83;60;201
420080;201401;560;1929;504;1808;180;713;105;359;285;1072
420090;201401;684;2462;537;2111;134;543;95;384;229;927
420100;201401;1482;4880;1377;4734;369;1304;816;2851;1185;4155
420110;201401;446;1544;406;1453;130;474;157;576;287;1050
420120;201401;320;1138;270;1032;110;454;47;164;157;618
420125;201401;357;1505;343;1471;135;617;94;373;229;990
420127;201401;587;1861;287;1088;94;384;34;123;128;507
420130;201401;2699;9427;2428;8892;754;3133;890;2969;1644;6102
420140;201401;4874;14754;3633;12421;1066;4084;766;2452;1832;6536
420150;201401;741;2287;534;1807;171;625;140;419;311;1044
420160;201401;296;896;195;660;48;192;35;92;83;284
420165;201401;209;698;150;540;24;93;35;131;59;224
420170;201401;233;781;168;648;62;282;18;51;80;333
420180;201401;447;1465;284;1047;74;277;68;236;142;513
420190;201401;556;1802;386;1456;136;569;57;191;193;760
420195;201401;1399;4078;1131;3708;294;1059;531;1785;825;2844
420200;201401;2894;9595;1931;7365;627;2688;305;1005;932;3693
420205;201401;1049;3581;952;3398;305;1179;383;1352;688;2531
420207;201401;1301;3954;969;3251;305;1149;248;753;553;1902
420208;201401;558;1739;418;1462;161;597;120;417;281;1014
420209;201401;355;1184;229;850;44;174;53;201;97;375
420210;201401;1747;5834;1229;4760;336;1509;169;584;505;2093
420213;201401;860;3235;826;3160;180;721;532;2045;712;2766
420215;201401;481;1643;380;1346;113;430;64;211;177;641
420220;201401;423;1673;397;1612;167;729;79;278;246;1007
420230;201401;4467;14131;3552;12427;910;3590;1729;5912;2639;9502
420240;201401;12321;38697;8728;31289;1997;8553;3377;10815;5374;19368
420243;201401;571;1830;473;1612;129;510;144;476;273;986
420245;201401;1124;3620;839;3026;221;932;178;554;399;1486
420250;201401;844;2750;795;2672;306;1126;303;1031;609;2157
420253;201401;662;1759;548;1604;125;382;257;836;382;1218
420257;201401;429;1348;333;1161;94;327;146;511;240;838
420260;201401;1352;4621;1225;4375;367;1440;547;1945;914;3385
420270;201401;513;1698;258;966;34;131;27;88;61;219
420280;201401;2323;6748;1593;5453;435;1753;525;1571;960;3324
420285;201401;149;440;60;226;9;38;1;2;10;40
420287;201401;651;2036;570;1880;147;529;222;729;369;1258
420290;201401;6136;18657;4111;13977;1005;3779;1290;4073;2295;7852
420300;201401;5433;17435;3752;13749;980;4119;708;2578;1688;6697
420310;201401;849;2624;816;2567;188;633;490;1491;678;2124
420315;201401;952;3234;770;2846;202;843;305;1131;507;1974
420320;201401;4669;15247;4035;14118;1230;4886;1552;5193;2782;10079
420325;201401;467;1534;454;1503;154;574;138;437;292;1011
420330;201401;1274;4537;1022;3837;355;1456;181;554;536;2010
420340;201401;1483;4714;1214;4074;280;1026;364;1165;644;2191
420350;201401;1593;5218;1398;4816;415;1548;579;1998;994;3546
420360;201401;3648;11978;2859;10169;1039;4051;483;1578;1522;5629
420370;201401;1986;5729;1772;5444;242;760;1413;4331;1655;5091
420380;201401;5418;18612;4665;16830;1491;5855;1186;4200;2677;10055
420390;201401;2067;6299;1312;4677;424;1654;269;862;693;2516
420395;201401;2047;6462;1595;5440;407;1580;331;989;738;2569
420400;201401;1483;4531;1144;3865;347;1362;349;1088;696;2450
420410;201401;801;2271;586;1916;159;584;270;868;429;1452
420415;201401;507;1640;411;1395;125;461;139;459;264;920
420417;201401;800;2644;698;2412;152;538;322;1129;474;1667
420419;201401;423;1401;326;1224;158;635;76;291;234;926
420420;201401;14908;46805;11890;40517;3915;14546;3576;12012;7491;26558
420425;201401;1190;3375;772;2483;108;435;325;938;433;1373
420430;201401;4113;13158;2878;10219;859;3360;749;2587;1608;5947
420435;201401;201;694;153;568;68;283;24;82;92;365
420440;201401;1480;4407;932;3246;339;1289;151;468;490;1757
420445;201401;444;1309;342;1127;93;323;148;495;241;818
420450;201401;1273;3816;775;2782;182;748;149;435;331;1183
420455;201401;2263;7140;2040;6745;623;2376;828;2629;1451;5005
420460;201401;9666;31162;7998;27986;2357;9350;2915;9714;5272;19064
420470;201401;1194;3414;824;2707;244;883;237;762;481;1645
420475;201401;181;595;119;439;42;159;25;97;67;256
420480;201401;6012;18346;5083;16750;2065;7619;808;2577;2873;10196
420490;201401;710;2473;597;2221;178;698;146;513;324;1211
420500;201401;2125;6674;1786;6066;537;1992;870;2960;1407;4952
420510;201401;182;795;177;772;74;333;38;148;112;481
420515;201401;159;586;132;519;41;173;20;77;61;250
420517;201401;949;2957;874;2810;134;458;563;1833;697;2291
420519;201401;413;1201;317;1005;63;204;116;377;179;581
420520;201401;736;2213;610;2017;175;631;247;789;422;1420
420530;201401;1359;4808;1131;4229;371;1529;256;833;627;2362
420535;201401;254;782;183;630;56;210;37;115;93;325
420540;201401;18633;57716;14612;49268;5062;18957;4140;13160;9202;32117
420543;201401;494;1360;366;1142;53;181;211;694;264;875
420545;201401;1559;5138;1306;4571;383;1513;377;1234;760;2747
420550;201401;4788;16025;4105;14425;1225;4862;1259;4325;2484;9187
420555;201401;464;1522;394;1368;143;543;112;381;255;924
420560;201401;585;1765;485;1553;87;311;244;787;331;1098
420570;201401;1961;6593;1619;5764;492;1968;460;1531;952;3499
420580;201401;1075;3704;927;3439;283;1151;411;1551;694;2702
420590;201401;3262;10517;2445;8604;620;2409;488;1584;1108;3993
420600;201401;855;3041;784;2872;221;884;312;1153;533;2037
420610;201401;612;2048;447;1662;141;578;73;241;214;819
420620;201401;1204;3853;1077;3622;409;1499;245;797;654;2296
420630;201401;1061;3536;850;2984;267;1038;238;704;505;1742
420640;201401;617;2100;340;1348;84;389;33;137;117;526
420650;201401;2143;6731;1260;4568;244;1003;213;646;457;1649
420660;201401;667;2022;556;1814;114;417;284;906;398;1323
420665;201401;786;2322;524;1764;93;359;177;518;270;877
420670;201401;1725;5647;1346;4798;345;1374;217;699;562;2073
420675;201401;235;770;174;623;41;167;77;252;118;419
420680;201401;508;1293;319;992;64;240;103;297;167;537
420690;201401;778;2743;574;2162;137;589;177;602;314;1191
420700;201401;5942;18499;5000;16547;1662;6133;1302;4093;2964;10226
420710;201401;749;2786;651;2582;244;1037;165;628;409;1665
420720;201401;1983;6220;1719;5860;497;1777;941;3220;1438;4997
420730;201401;4635;14737;4088;13737;1513;5430;1407;4671;2920;10101
420740;201401;749;2558;734;2534;182;673;469;1603;651;2276
420750;201401;2442;8133;1804;6557;411;1720;539;1719;950;3439
420757;201401;115;405;98;375;26;111;27;96;53;207
420760;201401;433;1434;326;1136;73;275;98;333;171;608
420765;201401;592;2075;422;1616;129;539;83;308;212;847
420768;201401;1264;4566;1094;4164;375;1498;376;1484;751;2982
420770;201401;877;2842;595;2182;181;731;151;520;332;1251
420775;201401;664;2170;502;1752;140;509;127;419;267;928
420780;201401;1693;5290;1215;4123;340;1244;344;1101;684;2345
420785;201401;323;1010;229;767;31;122;86;262;117;384
420790;201401;1333;4935;1122;4337;332;1382;425;1578;757;2960
420800;201401;924;2776;584;1996;163;630;119;359;282;989
420810;201401;2543;9058;2098;7995;726;3106;514;1891;1240;4997
420820;201401;7911;27585;6652;25394;2366;10105;2268;8520;4634;18625
420830;201401;2739;9395;2383;8712;924;3658;786;2778;1710;6436
420840;201401;870;2739;565;2101;156;661;156;536;312;1197
420845;201401;1148;4023;976;3674;352;1463;162;561;514;2024
420850;201401;1939;6543;1377;5348;473;2012;271;1049;744;3061
420860;201401;678;2016;460;1611;183;718;159;539;342;1257
420870;201401;1390;4131;1132;3766;447;1640;329;1053;776;2693
420880;201401;1478;5038;1239;4411;326;1206;240;816;566;2022
420890;201401;12553;30340;6074;19259;1197;4491;2293;6571;3490;11062
420895;201401;222;623;111;371;40;142;26;87;66;229
420900;201401;2298;6826;1581;5400;449;1688;369;1193;818;2881
420910;201401;22768;71475;15681;56137;3955;16211;3880;12955;7835;29166
420915;201401;658;2606;606;2471;172;723;268;1141;440;1864
420917;201401;421;1314;242;793;54;213;75;196;129;409
420920;201401;189;559;107;371;38;142;17;60;55;202
420930;201401;19953;62491;17542;58125;5764;20896;5788;19104;11552;40000
420940;201401;4448;13916;3905;12722;1161;4245;1169;3467;2330;7712
420945;201401;241;766;161;564;43;170;44;147;87;317
420950;201401;550;1691;300;1137;75;324;50;178;125;502
420960;201401;1448;4616;1249;4258;424;1609;388;1209;812;2818
420970;201401;2721;8713;2417;8227;677;2493;1224;4259;1901;6752
420980;201401;441;1491;377;1374;123;450;178;692;301;1142
420985;201401;552;1694;354;1263;104;408;92;311;196;719
420990;201401;892;2702;625;2236;155;614;182;601;337;1215
421000;201401;681;2460;494;1961;151;658;57;170;208;828
421003;201401;649;1913;291;1030;64;252;43;129;107;381
421005;201401;258;842;216;764;65;256;101;350;166;606
421010;201401;6729;21382;5426;18751;1816;6775;1566;5158;3382;11933
421020;201401;530;1761;425;1550;91;332;211;827;302;1159
421030;201401;1043;3877;969;3687;348;1410;296;1137;644;2547
421040;201401;888;2795;767;2581;259;958;274;856;533;1814
421050;201401;1952;5374;1210;4115;317;1237;394;1245;711;2482
421055;201401;275;917;192;701;46;185;48;155;94;340
421060;201401;542;2043;458;1801;129;541;101;370;230;911
421070;201401;791;2551;552;1973;149;604;155;572;304;1176
421080;201401;677;2233;623;2110;197;724;257;843;454;1567
421085;201401;532;1495;311;1098;79;306;66;251;145;557
421090;201401;416;1256;325;1053;82;278;142;461;224;739
421100;201401;1018;3237;761;2659;207;764;177;548;384;1312
421105;201401;1404;4697;1259;4416;331;1261;514;1865;845;3126
421110;201401;1636;5449;1429;5101;517;2036;436;1464;953;3500
421120;201401;1588;5347;1247;4488;300;1254;368;1204;668;2458
421125;201401;404;1301;331;1140;111;418;111;352;222;770
421130;201401;3427;11631;2873;10585;1068;4344;920;3379;1988;7723
421140;201401;433;1396;356;1229;109;406;122;401;231;807
421145;201401;548;1848;434;1522;75;296;186;624;261;920
421150;201401;554;1856;434;1625;116;469;172;641;288;1110
421160;201401;827;2596;577;2069;127;496;176;593;303;1089
421165;201401;329;1186;267;991;65;257;103;397;168;654
421170;201401;1841;6069;1587;5378;487;1764;728;2410;1215;4174
421175;201401;1360;4179;1092;3732;360;1429;337;1031;697;2460
421180;201401;525;1564;332;1136;103;406;125;384;228;790
421185;201401;452;1336;365;1164;65;199;186;625;251;824
421187;201401;322;1013;257;882;78;278;91;293;169;571
421189;201401;528;1641;477;1541;132;463;167;531;299;994
421190;201401;9914;32654;7822;28245;2467;9538;2191;7887;4658;17425
421200;201401;1073;3668;951;3391;288;1111;310;1069;598;2180
421205;201401;221;725;170;608;38;162;38;112;76;274
421210;201401;2116;6685;1809;5913;589;2044;537;1739;1126;3783
421220;201401;2494;8663;2244;8147;750;2966;676;2458;1426;5424
421223;201401;784;2309;527;1861;166;624;240;839;406;1463
421225;201401;1192;3765;1011;3393;295;1070;375;1244;670;2314
421227;201401;952;3269;873;3147;258;926;500;1875;758;2801
421230;201401;745;2562;681;2403;195;750;235;772;430;1522
421240;201401;554;1898;388;1408;90;354;51;157;141;511
421250;201401;1908;6045;1365;5052;492;1991;344;1242;836;3233
421260;201401;267;833;161;620;39;148;31;113;70;261
421265;201401;215;732;182;632;37;146;43;157;80;303
421270;201401;671;1889;428;1475;147;543;83;310;230;853
421280;201401;1631;5251;1348;4816;466;1914;375;1334;841;3248
421290;201401;1964;5707;1343;4510;441;1569;281;867;722;2436
421300;201401;314;1010;275;930;111;423;97;302;208;725
421310;201401;519;1816;457;1647;151;552;106;380;257;932
421315;201401;371;1151;241;876;50;187;57;191;107;378
421320;201401;536;1862;380;1432;70;293;64;182;134;475
421330;201401;640;2272;561;2103;226;966;64;221;290;1187
421335;201401;570;1912;467;1707;129;509;93;345;222;854
421340;201401;1768;5892;1603;5597;551;2100;651;2247;1202;4347
421350;201401;1082;3738;915;3375;308;1260;241;843;549;2103
421360;201401;3264;10044;2250;8018;514;2120;735;2473;1249;4593
421370;201401;1090;3941;950;3625;324;1367;246;907;570;2274
421380;201401;1039;3068;875;2751;176;607;419;1304;595;1911
421390;201401;199;658;154;538;22;82;40;145;62;227
421400;201401;391;1527;326;1366;135;591;75;292;210;883
421410;201401;365;1166;300;1034;74;263;133;479;207;742
421415;201401;320;1061;210;820;67;273;55;204;122;477
421420;201401;1420;4544;1115;3784;259;942;238;741;497;1683
421430;201401;295;995;237;878;82;356;44;144;126;500
421440;201401;821;2529;589;2104;175;684;213;717;388;1401
421450;201401;615;2166;494;1860;179;729;101;357;280;1086
421460;201401;659;2202;475;1792;120;509;107;370;227;879
421470;201401;503;1940;454;1826;136;578;181;716;317;1294
421480;201401;2823;9099;2024;7441;628;2627;555;1856;1183;4483
421490;201401;286;1015;202;802;92;390;40;156;132;546
421500;201401;2692;9820;2429;9277;1022;4304;521;1912;1543;6216
421505;201401;401;1402;368;1315;130;472;124;448;254;920
421507;201401;618;2119;501;1827;121;455;186;680;307;1135
421510;201401;300;1148;277;1100;87;398;114;388;201;786
421520;201401;806;2226;539;1682;58;228;269;763;327;991
421530;201401;445;1523;319;1248;96;427;110;406;206;833
421535;201401;707;2226;447;1653;104;410;208;762;312;1172
421540;201401;386;1214;335;1111;81;308;122;384;203;692
421545;201401;1228;4340;1028;3936;325;1396;205;737;530;2133
421550;201401;2171;7573;1994;7228;758;2986;584;2043;1342;5029
421555;201401;279;904;143;520;32;130;32;108;64;238
421560;201401;184;580;96;356;24;96;15;57;39;153
421565;201401;1096;3509;1002;3347;445;1594;306;982;751;2576
421567;201401;947;3609;828;3289;383;1568;165;658;548;2226
421568;201401;483;1646;399;1465;119;454;124;466;243;920
421569;201401;197;646;118;447;23;96;25;90;48;186
421570;201401;1012;3496;784;2957;272;1127;190;681;462;1808
421575;201401;610;2107;548;1978;118;450;285;1042;403;1492
421580;201401;4247;14387;3470;12619;1329;5387;744;2422;2073;7809
421590;201401;261;838;212;733;47;173;94;308;141;481
421600;201401;597;1848;460;1555;137;497;118;392;255;889
421605;201401;687;2206;501;1823;131;549;114;394;245;943
421610;201401;1849;4885;1472;4347;205;649;925;2746;1130;3395
421620;201401;4912;15488;3668;12867;1300;4892;1122;3981;2422;8873
421625;201401;374;1266;247;914;66;275;76;263;142;538
421630;201401;2615;8105;1749;6130;472;1799;415;1407;887;3206
421635;201401;293;1043;255;974;72;299;92;320;164;619
421640;201401;1093;3609;982;3424;218;775;594;2118;812;2893
421650;201401;2354;8087;2084;7472;814;3208;320;1074;1134;4282
421660;201401;9193;31665;7651;28631;2620;10806;2201;7787;4821;18593
421670;201401;1128;3837;900;3297;260;1045;256;922;516;1967
421680;201401;1448;4875;1306;4526;531;1982;223;697;754;2679
421690;201401;2063;6957;1640;5920;465;1804;269;926;734;2730
421700;201401;722;2315;484;1793;165;673;120;366;285;1039
421710;201401;342;1241;279;1065;107;416;73;268;180;684
421715;201401;304;898;194;668;48;176;57;198;105;374
421720;201401;1744;5529;1376;4857;542;2134;392;1265;934;3399
421725;201401;130;473;126;462;40;158;52;186;92;344
421730;201401;616;1941;340;1264;86;356;76;231;162;587
421740;201401;701;2265;541;1882;160;658;120;324;280;982
421750;201401;1424;4438;1145;3848;344;1265;395;1208;739;2473
421755;201401;435;1458;346;1212;102;393;101;323;203;716
421760;201401;441;1475;305;1140;87;367;126;448;213;815
421770;201401;3722;11550;3100;10293;1301;4541;734;2498;2035;7039
421775;201401;566;1729;390;1388;90;332;120;424;210;756
421780;201401;1729;6120;1421;5434;577;2380;374;1341;951;3721
421790;201401;991;2900;646;2300;199;816;154;495;353;1311
421795;201401;396;1235;285;955;46;164;84;283;130;447
421800;201401;2544;8541;2054;7551;581;2382;658;2209;1239;4591
421810;201401;613;2092;505;1818;151;594;92;311;243;905
421820;201401;1102;3640;938;3301;218;927;310;979;528;1906
421825;201401;1339;4662;1243;4420;221;879;672;2323;893;3202
421830;201401;3089;10823;2902;10450;724;2704;1497;5631;2221;8335
421835;201401;182;587;144;522;55;231;55;174;110;405
421840;201401;516;1864;465;1733;188;771;153;533;341;1304
421850;201401;573;1699;435;1461;145;509;127;449;272;958
421860;201401;455;1532;342;1293;73;300;96;346;169;646
421870;201401;5163;15616;3794;12740;1144;4140;670;2189;1814;6329
421875;201401;339;1068;208;763;48;201;50;159;98;360
421880;201401;1058;3629;873;3161;270;1115;209;680;479;1795
421885;201401;361;1299;330;1215;87;330;133;484;220;814
421890;201401;1091;3798;951;3503;324;1288;278;1008;602;2296
421895;201401;427;1483;407;1447;116;423;209;762;325;1185
421900;201401;887;2944;744;2588;209;776;255;807;464;1583
421910;201401;529;1743;385;1396;100;409;101;321;201;730
421915;201401;619;1929;497;1658;112;414;177;554;289;968
421917;201401;567;1816;454;1607;147;618;140;445;287;1063
421920;201401;774;2445;634;2243;300;1157;180;567;480;1724
421930;201401;3843;11422;2822;9469;859;3220;444;1450;1303;4670
421935;201401;890;3190;725;2804;205;872;248;936;453;1808
421940;201401;306;1205;248;1021;89;399;52;190;141;589
421950;201401;4383;12710;2584;8971;787;2910;508;1783;1295;4693
421960;201401;263;862;213;747;55;211;56;189;111;400
421970;201401;2069;6519;1624;5484;559;2086;319;951;878;3037
421985;201401;449;1300;286;961;44;181;89;305;133;486
430003;201401;918;2711;741;2401;207;747;239;760;446;1507
430005;201401;295;1010;261;934;63;242;135;459;198;701
430010;201401;2157;6353;1696;5445;541;1805;593;1975;1134;3780
430020;201401;1115;3046;985;2851;240;804;529;1444;769;2248
430030;201401;1515;4287;1347;3958;394;1225;520;1459;914;2684
430040;201401;13061;34231;11273;31491;3533;10304;4682;13289;8215;23593
430045;201401;736;2060;598;1789;113;382;340;984;453;1366
430047;201401;210;611;168;525;43;137;79;251;122;388
430050;201401;1077;3058;733;2390;151;586;299;913;450;1499
430055;201401;268;792;194;628;43;153;89;280;132;433
430057;201401;78;209;36;123;8;32;11;24;19;56
430060;201401;14982;50012;13495;47338;4383;16027;6062;21869;10445;37896
430063;201401;1095;3336;914;2940;259;874;401;1325;660;2199
430064;201401;1687;5108;1441;4700;398;1319;706;2413;1104;3732
430066;201401;173;456;129;387;33;112;66;188;99;300
430070;201401;552;1808;425;1487;111;423;120;377;231;800
430080;201401;619;2061;497;1778;126;514;131;424;257;938
430085;201401;652;1914;499;1650;152;568;207;646;359;1214
430087;201401;996;3042;955;2966;103;341;758;2338;861;2679
430090;201401;763;2099;298;991;38;138;78;272;116;410
430100;201401;1019;3286;832;2922;305;1172;193;571;498;1743
430105;201401;728;2408;603;2162;213;837;134;461;347;1298
430107;201401;259;874;207;713;43;166;84;270;127;436
430110;201401;2208;6639;2065;6402;674;2281;921;2801;1595;5082
430120;201401;1758;5486;1438;4794;297;1043;847;2799;1144;3842
430130;201401;4577;11800;4203;11312;732;2101;2680;7327;3412;9428
430140;201401;1205;3943;948;3329;304;1093;316;1095;620;2188
430150;201401;919;2528;651;2023;156;521;196;597;352;1118
430155;201401;506;1620;387;1345;104;355;152;541;256;896
430160;201401;18689;55695;17496;53720;3898;13267;9645;30153;13543;43420
430163;201401;1883;5796;1636;5334;397;1476;754;2463;1151;3939
430165;201401;285;1024;245;939;111;439;43;161;154;600
430170;201401;790;2333;405;1420;98;383;85;259;183;642
430175;201401;966;3120;798;2752;176;553;407;1508;583;2061
430180;201401;1147;3176;987;2912;238;775;467;1373;705;2148
430185;201401;755;1909;418;1264;65;228;136;348;201;576
430187;201401;753;2365;676;2228;176;683;279;881;455;1564
430190;201401;2275;6840;2030;6413;518;1900;959;3012;1477;4912
430192;201401;188;592;103;334;17;60;34;104;51;164
430195;201401;250;762;84;309;14;52;13;36;27;88
430200;201401;1821;5988;1566;5479;551;2064;291;1021;842;3085
430205;201401;509;1547;412;1377;48;196;278;914;326;1110
430210;201401;6364;18501;3727;12745;984;3617;670;2133;1654;5750
430215;201401;330;988;254;832;56;205;111;345;167;550
430220;201401;674;1800;337;1140;66;265;52;164;118;429
430222;201401;321;1013;252;861;65;253;103;334;168;587
430223;201401;325;1014;300;972;61;204;197;647;258;851
430225;201401;61;179;37;120;6;14;7;20;13;34
430230;201401;2154;6872;2029;6741;351;1104;1530;5262;1881;6366
430235;201401;261;889;215;773;64;253;53;174;117;427
430237;201401;401;1133;334;1015;52;186;211;613;263;799
430240;201401;1094;3338;883;2911;307;1156;254;734;561;1890
430245;201401;868;2958;736;2653;203;748;310;1156;513;1904
430250;201401;1614;4538;1476;4292;564;1742;494;1472;1058;3214
430258;201401;211;605;148;478;25;87;65;207;90;294
430260;201401;843;2425;569;1845;76;280;320;1048;396;1328
430265;201401;324;1045;269;910;96;344;31;81;127;425
430270;201401;3497;10091;3180;9553;857;2921;1544;4561;2401;7482
430280;201401;5312;15443;4656;14208;1430;4680;1929;5802;3359;10482
430290;201401;2481;6977;2364;6851;327;961;1912;5644;2239;6605
430300;201401;9930;30995;8597;28472;3414;11896;3071;10484;6485;22380
430310;201401;8568;27586;7743;25972;2618;9478;3069;10034;5687;19512
430320;201401;818;2520;602;2070;90;303;308;1110;398;1413
430330;201401;983;2758;854;2511;255;802;325;883;580;1685
430340;201401;730;1941;465;1579;105;407;218;728;323;1135
430350;201401;6205;20183;5398;18408;2059;7393;1758;5902;3817;13295
430355;201401;240;661;158;508;29;114;37;103;66;217
430360;201401;1128;3009;1000;2799;175;527;582;1629;757;2156
430367;201401;342;957;238;768;40;144;78;234;118;378
430370;201401;603;1813;503;1612;173;602;127;370;300;972
430380;201401;869;2268;487;1570;136;461;166;553;302;1014
430390;201401;4265;12896;3341;10908;835;2996;1032;3181;1867;6177
430400;201401;1323;3210;936;2657;258;815;444;1185;702;2000
430410;201401;703;1945;556;1703;102;355;285;864;387;1219
430420;201401;4602;13661;3801;11824;1164;3712;1462;4575;2626;8287
430430;201401;777;2213;533;1733;167;584;132;404;299;988
430435;201401;1993;5555;1711;5028;388;1175;934;2782;1322;3957
430440;201401;4628;14537;3908;13198;803;3001;1759;6151;2562;9152
430450;201401;9154;26816;7585;23562;2739;9014;2314;7156;5053;16170
430460;201401;26003;80738;21718;72871;7047;25460;7409;24915;14456;50375
430461;201401;481;1365;172;563;37;126;38;127;75;253
430462;201401;342;1028;291;945;114;400;99;318;213;718
430463;201401;3904;13058;3511;12252;940;3595;1648;5759;2588;9354
430465;201401;633;1776;538;1613;127;424;331;979;458;1403
430466;201401;4328;13008;4097;12597;1276;4254;1889;5790;3165;10044
430467;201401;594;1836;525;1722;134;489;249;788;383;1277
430468;201401;1411;4255;1267;4022;535;1864;258;786;793;2650
430469;201401;134;362;47;175;11;42;13;54;24;96
430470;201401;7328;19901;5614;17098;1872;6232;1657;5017;3529;11249
430471;201401;926;3161;838;2970;305;1137;191;681;496;1818
430480;201401;862;2436;496;1637;80;295;103;296;183;591
430485;201401;239;759;137;503;26;93;47;185;73;278
430490;201401;535;1597;384;1309;107;385;130;452;237;837
430495;201401;418;1276;298;1016;74;277;74;239;148;516
430500;201401;1649;4695;1431;4314;413;1387;664;1960;1077;3347
430510;201401;26930;85344;21312;71576;7260;26789;5742;18350;13002;45139
430511;201401;479;1470;279;954;72;240;35;111;107;351
430512;201401;1333;3554;1194;3322;335;971;461;1346;796;2317
430513;201401;675;1936;487;1541;85;273;223;715;308;988
430515;201401;614;1847;501;1603;102;351;212;698;314;1049
430517;201401;1367;4643;1255;4407;245;933;772;2675;1017;3608
430520;201401;1777;5296;1445;4596;474;1604;537;1656;1011;3260
430530;201401;933;2685;546;1785;112;421;139;399;251;820
430535;201401;2387;7911;2098;7254;557;2146;677;2301;1234;4447
430537;201401;616;1795;436;1497;55;183;332;1172;387;1355
430540;201401;740;1835;577;1616;131;413;326;876;457;1289
430543;201401;602;1598;543;1538;135;412;338;974;473;1386
430544;201401;711;2441;630;2220;149;558;313;1065;462;1623
430545;201401;1399;4588;1227;4371;450;1523;594;2365;1044;3888
430550;201401;609;1925;493;1671;121;466;193;630;314;1096
430558;201401;120;361;82;275;32;120;11;25;43;145
430560;201401;388;1004;251;759;51;198;109;311;160;509
430570;201401;1187;3187;876;2626;225;770;413;1143;638;1913
430580;201401;1055;3098;756;2490;261;895;204;694;465;1589
430583;201401;118;334;50;170;11;44;4;10;15;54
430585;201401;365;1005;247;750;82;288;101;275;183;563
430587;201401;296;933;256;845;110;380;68;222;178;602
430590;201401;1541;4423;1468;4308;349;1155;821;2356;1170;3511
430593;201401;37;146;35;138;14;61;8;26;22;87
430595;201401;168;523;110;400;35;134;13;36;48;170
430597;201401;381;1207;322;1080;58;218;133;429;191;647
430600;201401;2020;5774;1387;4332;320;1053;487;1486;807;2539
430605;201401;1345;4300;1108;3783;275;1029;448;1568;723;2597
430607;201401;702;1939;615;1790;135;444;346;975;481;1419
430610;201401;8208;22520;6618;20002;1583;5330;2987;9018;4570;14348
430613;201401;222;584;135;414;37;115;37;97;74;212
430620;201401;967;3056;820;2714;243;904;302;920;545;1824
430630;201401;464;1409;297;990;86;288;58;175;144;463
430632;201401;722;2046;491;1564;86;324;262;775;348;1099
430635;201401;674;1907;500;1566;111;345;236;760;347;1105
430637;201401;545;1574;499;1485;87;317;319;891;406;1208
430640;201401;1865;5422;1066;3553;230;809;202;561;432;1370
430642;201401;480;1304;343;1077;67;233;180;575;247;808
430645;201401;188;573;112;389;25;96;27;87;52;183
430650;201401;2069;6996;1823;6436;401;1484;995;3605;1396;5089
430655;201401;310;945;275;866;66;233;97;255;163;488
430660;201401;6036;18217;4903;16098;1535;5549;1889;6109;3424;11658
430670;201401;503;1485;458;1398;45;132;343;1086;388;1218
430673;201401;764;1927;462;1436;125;396;208;650;333;1046
430675;201401;190;596;127;438;26;104;54;182;80;286
430676;201401;4546;14075;4178;13473;1289;4502;1859;6151;3148;10653
430680;201401;1264;3816;957;3141;222;835;365;1105;587;1940
430690;201401;4500;13268;3806;11925;1207;3969;1454;4707;2661;8676
430692;201401;278;965;213;825;35;140;131;515;166;655
430693;201401;1773;5126;1398;4279;312;1032;416;1243;728;2275
430695;201401;508;1476;422;1304;98;347;199;572;297;919
430697;201401;444;1275;349;1115;117;377;128;444;245;821
430700;201401;10891;29228;5878;19197;1130;4161;775;2290;1905;6451
430705;201401;409;1309;383;1264;136;490;145;477;281;967
430710;201401;1871;4953;1505;4353;300;955;793;2392;1093;3347
430720;201401;905;2290;600;1844;174;577;228;742;402;1319
430730;201401;1772;5003;1503;4585;366;1116;817;2629;1183;3745
430740;201401;618;1820;400;1346;120;429;55;155;175;584
430745;201401;533;1565;384;1237;69;236;153;484;222;720
430750;201401;1812;5296;1590;4884;393;1341;792;2337;1185;3678
430755;201401;659;1897;481;1506;113;412;202;554;315;966
430760;201401;3686;9512;2933;8598;632;2040;1601;4879;2233;6919
430770;201401;6805;20783;5803;19048;1455;5267;2699;8733;4154;14000
430780;201401;2411;6971;1775;5756;495;1752;659;2000;1154;3752
430781;201401;651;2016;491;1694;145;535;172;581;317;1116
430783;201401;575;1520;452;1303;84;269;202;540;286;809
430786;201401;117;404;101;358;36;141;13;42;49;183
430790;201401;3712;10509;2573;8184;554;2067;1120;3335;1674;5402
430800;201401;780;2452;627;2070;164;580;207;656;371;1236
430805;201401;465;1376;360;1183;39;139;231;783;270;922
430807;201401;323;1014;271;899;63;252;90;261;153;513
430810;201401;611;1776;347;1203;60;247;64;204;124;451
430820;201401;1231;4131;1019;3593;334;1276;298;987;632;2263
430825;201401;457;1307;257;818;45;155;78;232;123;387
430830;201401;2731;8129;2550;7845;396;1273;1636;5318;2032;6591
430840;201401;993;3150;912;2968;235;751;403;1386;638;2137
430843;201401;99;327;77;255;15;49;30;94;45;143
430845;201401;435;1308;369;1190;130;455;59;179;189;634
430850;201401;3303;10310;3000;9749;929;3215;1174;3797;2103;7012
430860;201401;694;2311;558;1983;181;763;129;399;310;1162
430865;201401;723;2031;669;1934;215;634;308;904;523;1538
430870;201401;621;1820;419;1429;140;492;122;400;262;892
430880;201401;1384;4123;1155;3664;463;1583;282;912;745;2495
430885;201401;179;582;155;540;51;194;45;147;96;341
430890;201401;1662;4553;1363;4011;97;337;903;2631;1000;2968
430900;201401;3223;8892;3060;8682;579;1715;2057;5970;2636;7685
430905;201401;1083;3305;793;2656;272;977;191;621;463;1598
430910;201401;1807;5917;1556;5420;589;2204;553;1874;1142;4078
430912;201401;589;1698;466;1492;73;266;251;780;324;1046
430915;201401;415;1472;314;1256;86;369;84;351;170;720
430920;201401;17863;57534;16570;55149;5787;20051;8586;28551;14373;48602
430925;201401;92;266;74;229;21;73;38;114;59;187
430930;201401;9283;29722;7798;26665;2343;8524;2960;10469;5303;18993
430940;201401;1123;3559;916;3153;217;849;282;935;499;1784
430950;201401;1613;4636;1259;3865;364;1179;358;1073;722;2252
430955;201401;105;349;83;290;26;100;23;71;49;171
430957;201401;317;1084;261;959;70;272;106;392;176;664
430960;201401;1745;5150;1512;4739;586;1936;467;1490;1053;3426
430965;201401;1335;4168;1168;3845;197;744;787;2539;984;3283
430970;201401;534;1571;351;1174;94;348;93;304;187;652
430975;201401;640;2122;503;1783;96;366;267;937;363;1303
430980;201401;558;1391;349;1083;94;335;132;363;226;698
430990;201401;641;2136;500;1766;165;605;103;363;268;968
430995;201401;730;2200;659;2064;230;735;238;747;468;1482
431000;201401;1705;4714;1030;3312;245;906;141;380;386;1286
431010;201401;2821;8506;2011;6842;552;2079;617;1981;1169;4060
431020;201401;14475;36817;10409;29366;2898;8653;3208;9354;6106;18007
431030;201401;404;1263;257;906;59;216;61;224;120;440
431033;201401;2896;8547;2669;8216;639;2057;1504;4878;2143;6935
431036;201401;200;596;97;332;24;91;26;72;50;163
431040;201401;1014;3022;870;2775;239;840;433;1355;672;2195
431041;201401;589;1663;532;1579;195;618;177;553;372;1171
431043;201401;389;1330;318;1160;150;595;105;345;255;940
431046;201401;115;358;89;299;25;90;34;109;59;199
431050;201401;1831;4696;1581;4343;330;940;957;2687;1287;3627
431053;201401;626;2100;539;1911;170;672;184;634;354;1306
431055;201401;697;1999;648;1910;85;263;457;1362;542;1625
431057;201401;335;979;205;728;57;222;80;277;137;499
431060;201401;6304;18795;5992;18416;1348;3891;3945;12763;5293;16654
431065;201401;446;1389;425;1352;51;175;286;912;337;1087
431070;201401;756;2252;491;1638;112;388;121;359;233;747
431075;201401;286;876;191;667;34;131;61;216;95;347
431080;201401;697;2283;589;2057;161;599;112;374;273;973
431085;201401;933;2525;757;2232;141;443;425;1253;566;1696
431087;201401;626;1808;558;1679;72;197;385;1183;457;1380
431090;201401;531;1385;301;941;96;311;57;168;153;479
431100;201401;4766;13489;4055;12233;1175;3756;1631;5075;2806;8831
431110;201401;1621;4519;1308;3905;336;1073;651;1888;987;2961
431112;201401;666;2141;639;2097;233;761;299;1014;532;1775
431113;201401;630;1938;487;1601;166;544;128;435;294;979
431115;201401;1481;4514;1362;4297;316;1066;785;2449;1101;3515
431120;201401;2672;8799;2427;8317;756;2907;989;3230;1745;6137
431123;201401;528;1689;449;1533;125;443;213;747;338;1190
431125;201401;1393;4398;1111;3794;340;1205;417;1509;757;2714
431127;201401;125;351;68;219;11;37;11;34;22;71
431130;201401;3911;11533;3319;10546;976;3389;1380;4411;2356;7800
431140;201401;3831;10269;2374;7746;480;1848;702;2001;1182;3849
431142;201401;551;1691;509;1617;66;227;324;1056;390;1283
431150;201401;1342;4121;1095;3642;302;1018;384;1325;686;2343
431160;201401;967;2915;835;2636;171;543;414;1392;585;1935
431162;201401;446;1227;237;799;35;144;34;96;69;240
431164;201401;106;288;38;139;14;49;2;5;16;54
431170;201401;928;2813;765;2473;243;826;217;695;460;1521
431171;201401;872;2684;788;2520;243;824;186;554;429;1378
431173;201401;482;1476;451;1420;105;340;267;851;372;1191
431175;201401;1315;3701;1151;3454;397;1268;454;1346;851;2614
431177;201401;982;3299;898;3115;295;1119;375;1298;670;2417
431179;201401;131;350;83;255;19;64;28;75;47;139
431180;201401;2774;8476;2265;7304;599;2143;665;1983;1264;4126
431190;201401;765;2152;476;1584;135;495;151;499;286;994
431198;201401;376;1248;331;1154;150;579;64;200;214;779
431200;201401;294;868;124;421;24;85;15;50;39;135
431205;201401;302;1011;236;826;61;225;85;289;146;514
431210;201401;785;2275;684;2062;181;561;346;1042;527;1603
431213;201401;317;996;269;903;74;277;93;298;167;575
431215;201401;344;1033;180;620;30;107;20;55;50;162
431217;201401;247;770;196;654;66;237;48;167;114;404
431220;201401;1220;3172;912;2600;125;429;492;1336;617;1765
431225;201401;1371;4164;1220;3902;284;982;650;2096;934;3078
431230;201401;951;2906;754;2498;122;455;416;1387;538;1842
431235;201401;76;184;37;115;13;44;10;29;23;73
431237;201401;448;1478;394;1401;137;555;161;540;298;1095
431238;201401;50;167;43;149;10;41;13;41;23;82
431240;201401;2824;8880;2446;8219;878;3179;723;2403;1601;5582
431242;201401;428;1411;405;1366;165;629;23;63;188;692
431244;201401;441;1103;341;956;74;252;153;391;227;643
431245;201401;1021;2886;888;2666;179;558;557;1690;736;2248
431247;201401;212;681;182;624;69;256;64;205;133;461
431250;201401;1898;6100;1707;5813;572;2123;652;2277;1224;4400
431260;201401;389;1150;279;930;69;262;61;185;130;447
431261;201401;229;834;200;768;53;235;53;196;106;431
431262;201401;352;1022;165;583;26;125;64;212;90;337
431265;201401;1348;3692;844;2626;205;713;242;634;447;1347
431267;201401;194;600;160;540;44;159;69;214;113;373
431270;201401;2401;6915;2103;6470;695;2294;986;3061;1681;5355
431275;201401;215;714;147;524;46;153;25;77;71;230
431280;201401;163;514;112;393;27;106;27;75;54;181
431290;201401;352;1162;278;966;75;295;60;196;135;491
431295;201401;219;707;132;452;25;100;28;79;53;179
431300;201401;149;531;99;386;34;139;8;30;42;169
431301;201401;246;814;186;658;40;152;44;141;84;293
431303;201401;710;1951;547;1643;141;488;215;617;356;1105
431306;201401;2145;6103;1704;5273;334;1238;591;1628;925;2866
431308;201401;58;203;54;192;39;143;11;36;50;179
431310;201401;772;2493;576;2053;107;406;216;791;323;1197
431320;201401;871;2576;564;1964;170;666;123;389;293;1055
431330;201401;2168;5669;1158;3737;348;1237;189;589;537;1826
431333;201401;287;782;200;613;40;133;62;169;102;302
431335;201401;100;298;84;262;19;59;28;78;47;137
431337;201401;2639;8289;2160;7234;625;2185;604;2012;1229;4197
431339;201401;614;1826;493;1542;114;373;227;727;341;1100
431340;201401;27705;75488;20896;63969;5250;17878;7865;23603;13115;41481
431342;201401;624;1684;544;1542;138;416;309;853;447;1269
431344;201401;371;1076;296;942;29;99;175;565;204;664
431346;201401;300;822;191;573;56;173;49;148;105;321
431349;201401;598;1764;467;1448;93;285;153;474;246;759
431350;201401;3912;11985;3525;11291;630;2337;2088;6469;2718;8806
431360;201401;770;2156;610;1889;175;575;224;690;399;1265
431365;201401;1321;4171;1170;3916;458;1681;420;1375;878;3056
431370;201401;5566;16356;4782;15065;1329;4504;2057;6626;3386;11130
431380;201401;1133;3465;1080;3357;171;574;758;2324;929;2898
431390;201401;3486;10352;2603;8605;840;3057;714;2234;1554;5291
431395;201401;1608;4921;1455;4676;387;1317;585;1934;972;3251
431400;201401;185;618;124;482;36;152;11;29;47;181
431402;201401;1211;3123;802;2373;160;518;375;1071;535;1589
431403;201401;323;971;247;834;86;323;50;166;136;489
431405;201401;4582;13257;3712;11953;851;3223;1787;5523;2638;8746
431406;201401;807;2589;633;2157;217;771;222;741;439;1512
431407;201401;649;2032;506;1700;168;582;115;360;283;942
431410;201401;16799;52965;13872;47219;5414;19815;3249;11525;8663;31340
431413;201401;217;551;109;351;12;44;49;155;61;199
431415;201401;925;2690;779;2415;190;645;384;1159;574;1804
431417;201401;664;1745;538;1549;97;306;287;854;384;1160
431420;201401;1611;4548;1433;4257;354;1132;768;2320;1122;3452
431430;201401;602;1681;454;1428;113;388;166;489;279;877
431440;201401;32805;97730;29694;92557;9994;32693;12915;41864;22909;74557
431442;201401;208;681;167;575;52;203;20;50;72;253
431445;201401;508;1422;356;1082;63;196;133;392;196;588
431446;201401;499;1485;379;1236;99;334;161;522;260;856
431447;201401;848;2441;618;1924;108;364;288;917;396;1281
431449;201401;908;2627;758;2379;128;441;382;1228;510;1669
431450;201401;2279;6103;2105;5841;543;1572;1262;3492;1805;5064
431455;201401;632;1657;427;1239;120;371;138;368;258;739
431460;201401;3670;10578;3223;9710;918;2914;1245;3828;2163;6742
431470;201401;2208;6552;1854;5764;526;1635;781;2565;1307;4200
431475;201401;149;443;58;232;12;52;5;23;17;75
431477;201401;631;1826;510;1583;106;358;267;807;373;1165
431478;201401;202;546;97;300;24;78;36;112;60;190
431480;201401;2667;8030;2140;7039;730;2601;560;1794;1290;4395
431490;201401;109122;315360;96966;297191;17932;62934;62043;186422;79975;249356
431500;201401;1190;3161;970;2752;291;849;330;930;621;1779
431505;201401;376;1079;350;1042;32;85;283;858;315;943
431507;201401;455;1135;372;978;83;212;219;590;302;802
431510;201401;2223;6249;1881;5652;362;1190;1021;2996;1383;4186
431513;201401;162;479;112;364;28;91;51;162;79;253
431514;201401;118;304;53;166;9;32;9;23;18;55
431515;201401;752;2306;583;1891;132;476;272;810;404;1286
431517;201401;90;301;84;286;39;142;21;65;60;207
431520;201401;493;1509;330;1109;68;254;74;251;142;505
431530;201401;4669;11581;3693;10466;1031;2991;1980;5950;3011;8941
431531;201401;292;842;208;670;51;180;80;264;131;444
431532;201401;562;1616;507;1507;180;583;152;436;332;1019
431535;201401;390;1166;278;875;63;224;77;219;140;443
431540;201401;2211;7210;1998;6899;303;989;1278;4762;1581;5751
431545;201401;135;401;60;213;5;18;12;48;17;66
431550;201401;2450;7546;2289;7261;546;1969;1093;3406;1639;5375
431555;201401;776;2081;687;1950;166;474;349;1003;515;1477
431560;201401;24077;76468;21090;70405;8806;30054;6255;21984;15061;52038
431570;201401;5735;16638;5238;15897;1643;5103;2830;8719;4473;13822
431575;201401;496;1342;375;1150;59;208;156;468;215;676
431580;201401;720;2333;616;2094;156;596;230;733;386;1329
431590;201401;987;2853;720;2299;79;271;387;1244;466;1515
431595;201401;619;1803;535;1622;132;426;187;577;319;1003
431600;201401;2256;6870;1760;5808;464;1735;358;989;822;2724
431610;201401;1670;4808;1264;4058;315;1087;607;1946;922;3033
431620;201401;391;1258;252;836;87;306;91;281;178;587
431630;201401;1414;3943;1116;3305;277;861;554;1659;831;2520
431640;201401;6049;18426;5552;17623;1577;5528;2819;8758;4396;14286
431642;201401;519;1587;461;1463;76;286;251;767;327;1053
431643;201401;227;615;197;561;45;149;106;271;151;420
431645;201401;1821;5630;1679;5390;406;1331;942;3122;1348;4453
431647;201401;174;497;126;388;38;117;27;65;65;182
431650;201401;245;787;174;634;37;153;32;96;69;249
431660;201401;1496;4564;1182;3894;404;1386;397;1254;801;2640
431670;201401;1376;3936;1146;3526;334;1151;469;1377;803;2528
431673;201401;233;698;153;518;43;156;37;120;80;276
431675;201401;302;1015;233;800;55;194;62;186;117;380
431680;201401;10251;29536;8157;25823;2534;8634;2758;8814;5292;17448
431690;201401;25685;75465;21373;68730;6822;23578;7958;25965;14780;49543
431695;201401;146;507;107;402;23;88;26;73;49;161
431697;201401;527;1500;472;1397;137;419;196;601;333;1020
431700;201401;1676;4783;1452;4352;294;962;752;2208;1046;3170
431710;201401;13137;39344;11096;35798;3275;11115;4388;14752;7663;25867
431720;201401;7189;20780;6097;18751;1420;4947;3118;9398;4538;14345
431725;201401;39;140;37;135;22;84;5;18;27;102
431730;201401;3791;11934;3173;10757;969;3682;1112;3783;2081;7465
431740;201401;6043;18084;5434;16893;1939;6523;1607;4818;3546;11341
431750;201401;10556;30589;9145;28295;1904;6376;4841;15310;6745;21686
431755;201401;272;719;81;282;18;71;14;40;32;111
431760;201401;4029;12511;3424;11337;986;3543;975;3121;1961;6664
431770;201401;2366;6608;2025;6055;527;1693;1006;2950;1533;4643
431775;201401;253;726;199;622;80;262;52;143;132;405
431780;201401;2444;6698;1907;5692;553;1803;526;1471;1079;3274
431790;201401;1196;3853;1076;3638;284;1043;545;1820;829;2863
431795;201401;478;1456;392;1243;78;264;191;600;269;864
431800;201401;9702;29227;8295;26619;2773;9767;2450;7681;5223;17448
431805;201401;297;726;88;299;18;72;18;57;36;129
431810;201401;3807;10843;3268;9709;815;2648;1510;4438;2325;7086
431820;201401;2814;9011;2535;8471;767;2799;916;2979;1683;5778
431830;201401;10956;29627;9288;27023;3306;10523;3298;9579;6604;20102
431840;201401;3609;10963;3208;10192;989;3276;1371;4446;2360;7722
431842;201401;757;1987;453;1397;96;313;140;417;236;730
431843;201401;348;1050;316;992;78;267;171;523;249;790
431844;201401;170;512;133;442;36;139;40;123;76;262
431845;201401;545;1676;502;1584;56;180;347;1124;403;1304
431846;201401;531;1621;460;1491;86;318;259;835;345;1153
431848;201401;198;539;105;352;19;79;21;63;40;142
431849;201401;369;934;129;404;27;95;33;90;60;185
431850;201401;5035;14963;4535;14033;1092;3705;2270;6868;3362;10573
431860;201401;975;2804;817;2552;204;709;398;1184;602;1893
431861;201401;89;294;59;208;13;43;9;29;22;72
431862;201401;495;1723;424;1567;157;645;103;353;260;998
431870;201401;26516;76177;22589;69177;6348;21426;9364;27867;15712;49293
431880;201401;4794;15433;4054;13734;1230;4583;1561;5104;2791;9687
431890;201401;5926;17323;5228;16045;2031;6589;1555;4918;3586;11507
431900;201401;1004;3162;815;2791;242;937;308;954;550;1891
431910;201401;916;2243;486;1423;108;357;182;488;290;845
431912;201401;618;1830;497;1581;154;484;172;570;326;1054
431915;201401;1402;3901;1083;3320;303;979;365;1135;668;2114
431920;201401;1554;4462;1436;4300;201;579;1084;3334;1285;3913
431930;201401;1318;3713;1047;3268;155;474;617;2050;772;2524
431935;201401;106;407;98;388;45;194;19;53;64;247
431936;201401;483;1411;444;1341;74;221;288;945;362;1166
431937;201401;346;950;209;658;51;181;55;163;106;344
431940;201401;2811;7865;1957;6199;546;1840;535;1680;1081;3520
431950;201401;1943;6287;1739;5909;517;1914;654;2139;1171;4053
431960;201401;3743;11302;3459;10754;1078;3566;1172;3688;2250;7254
431970;201401;511;1417;295;970;50;182;77;239;127;421
431971;201401;134;406;113;378;31;106;46;150;77;256
431973;201401;479;1714;424;1599;67;255;249;1009;316;1264
431975;201401;15;62;11;51;2;12;3;13;5;25
431980;201401;1549;4574;1406;4290;383;1366;548;1524;931;2890
431990;201401;8888;25181;7267;22649;1496;5373;3242;9777;4738;15150
432000;201401;11174;33370;9286;30013;3058;10336;3747;12196;6805;22532
432010;201401;2541;7639;2225;7031;513;1861;1051;3189;1564;5050
432020;201401;2183;5911;1915;5546;338;1049;1203;3477;1541;4526
432023;201401;539;1594;420;1323;106;385;163;474;269;859
432026;201401;1222;3859;1055;3487;250;843;514;1735;764;2578
432030;201401;414;1252;351;1110;98;340;138;408;236;748
432032;201401;549;1484;380;1180;75;260;206;625;281;885
432035;201401;850;2796;783;2658;203;737;430;1439;633;2176
432040;201401;760;2264;546;1818;126;457;125;322;251;779
432045;201401;202;685;175;629;51;199;68;245;119;444
432050;201401;791;2337;716;2195;143;462;406;1274;549;1736
432055;201401;821;2593;719;2392;154;572;431;1394;585;1966
432057;201401;471;1263;383;1093;38;135;248;661;286;796
432060;201401;467;1343;211;745;59;227;48;157;107;384
432065;201401;244;721;191;625;47;175;83;244;130;419
432067;201401;999;3310;758;2728;210;784;324;1152;534;1936
432070;201401;2476;6940;1961;5897;645;2172;598;1693;1243;3865
432080;201401;4291;12678;3800;11783;1234;4063;1474;4498;2708;8561
432085;201401;259;857;226;794;80;324;64;211;144;535
432090;201401;1768;5558;1516;5017;601;2146;422;1220;1023;3366
432100;201401;1218;3692;723;2527;177;649;126;377;303;1026
432110;201401;3108;9462;2558;8355;856;3090;472;1484;1328;4574
432120;201401;5327;16439;4651;15149;1671;5869;1364;4401;3035;10270
432130;201401;2385;7054;2071;6628;562;1949;1147;3709;1709;5658
432132;201401;422;1325;263;937;43;156;94;301;137;457
432135;201401;797;2428;758;2359;139;455;491;1536;630;1991
432140;201401;2962;8806;2434;7832;697;2387;905;3184;1602;5571
432143;201401;1377;4284;1208;4005;299;1015;671;2307;970;3322
432145;201401;1078;3468;750;2687;247;972;134;420;381;1392
432146;201401;280;894;206;708;70;255;52;172;122;427
432147;201401;833;2688;687;2364;194;691;277;980;471;1671
432149;201401;417;1262;300;980;87;299;94;301;181;600
432150;201401;3756;11183;2958;9651;988;3499;868;2759;1856;6258
432160;201401;4601;15195;4154;14441;1484;5449;1548;5646;3032;11095
432162;201401;338;836;103;335;25;91;25;69;50;160
432163;201401;360;956;108;345;19;61;20;69;39;130
432166;201401;814;2468;672;2168;139;511;312;927;451;1438
432170;201401;831;2810;619;2338;143;587;123;427;266;1014
432180;201401;2846;7678;2089;6429;611;2058;608;1798;1219;3856
432183;201401;405;1372;374;1305;152;548;92;322;244;870
432185;201401;864;2525;589;1941;134;484;216;699;350;1183
432190;201401;3595;10141;2698;8133;719;2321;803;2280;1522;4601
432195;201401;1299;3739;1175;3550;197;640;755;2286;952;2926
432200;201401;3168;9952;2645;9040;833;3054;1086;3803;1919;6857
432210;201401;437;1306;380;1225;108;404;179;531;287;935
432215;201401;896;2849;803;2693;161;518;485;1720;646;2238
432218;201401;316;895;242;746;43;141;107;307;150;448
432220;201401;3886;10689;3284;9699;493;1684;2052;5924;2545;7608
432225;201401;63;217;54;201;30;114;10;39;40;153
432230;201401;1091;3096;893;2724;278;955;374;1017;652;1972
432232;201401;576;1717;457;1489;101;365;240;779;341;1144
432234;201401;550;1555;423;1235;106;326;166;450;272;776
432235;201401;76;237;46;164;14;63;7;23;21;86
432237;201401;506;1426;460;1353;38;142;371;1071;409;1213
432240;201401;15682;52796;13797;50290;3359;13412;7989;29721;11348;43133
432250;201401;5603;19902;5316;19310;2379;9337;1343;4961;3722;14298
432252;201401;479;1441;407;1297;131;450;181;577;312;1027
432253;201401;1267;4287;1011;3618;342;1281;307;1101;649;2382
432254;201401;484;1305;199;658;53;187;25;78;78;265
432255;201401;209;529;118;390;32;108;40;143;72;251
432260;201401;7058;18631;5224;15561;1282;4026;2397;7243;3679;11269
432270;201401;2746;8628;2434;8091;735;2523;1144;3902;1879;6425
432280;201401;1231;3637;807;2725;183;707;209;604;392;1311
432285;201401;140;454;70;237;20;72;13;36;33;108
432290;201401;609;1879;427;1451;100;379;158;506;258;885
432300;201401;23421;73158;21650;70099;5974;20644;11056;35721;17030;56365
432310;201401;999;3173;882;2950;205;770;435;1393;640;2163
432320;201401;282;800;183;597;53;174;57;194;110;368
432330;201401;236;706;109;386;17;57;11;33;28;90
432335;201401;209;616;94;331;24;92;8;23;32;115
432340;201401;304;798;160;494;40;131;41;121;81;252
432345;201401;776;2238;718;2146;160;581;374;1026;534;1607
432350;201401;460;1327;324;1074;79;275;85;263;164;538
432360;201401;45;144;35;124;15;53;11;38;26;91
432370;201401;489;1410;412;1273;39;115;275;873;314;988
432375;201401;883;2297;718;2024;132;380;422;1218;554;1598
432377;201401;80;275;39;129;7;22;11;28;18;50
432380;201401;857;3097;796;2964;356;1463;244;841;600;2304
500020;201401;2081;6902;1665;6010;511;2056;464;1564;975;3620
500025;201401;1003;2586;659;1983;133;418;271;796;404;1214
500060;201401;6127;18259;5145;16824;680;2235;3692;12565;4372;14800
500070;201401;3961;12104;3438;11226;820;3064;1589;5069;2409;8133
500080;201401;1801;5416;1361;4618;461;1713;381;1349;842;3062
500085;201401;2074;5658;1570;4875;206;705;942;2838;1148;3543
500090;201401;2319;7014;1847;6159;419;1465;941;3240;1360;4705
500100;201401;2493;7712;2341;7476;815;2966;993;3001;1808;5967
500110;201401;8072;24036;6745;22054;1132;4166;3888;13267;5020;17433
500124;201401;1835;6119;1587;5695;307;1105;863;3375;1170;4480
500150;201401;1318;3627;1115;3320;308;1027;519;1479;827;2506
500190;201401;4825;13107;3855;11915;872;2934;2081;6681;2953;9615
500200;201401;2575;6720;1905;5764;391;1375;1019;2983;1410;4358
500210;201401;4873;14940;4260;14008;1022;3620;2132;7231;3154;10851
500215;201401;1739;5525;1481;5022;359;1384;591;1884;950;3268
500220;201401;2701;8696;2240;7818;559;2140;821;2929;1380;5069
500230;201401;2424;6689;1949;5970;747;2547;655;1963;1402;4510
500240;201401;4765;14947;3625;12701;741;2915;1516;5553;2257;8468
500260;201401;2457;6840;2049;6186;422;1417;1002;2851;1424;4268
500270;201401;104598;280168;73373;227221;21633;73296;18101;56411;39734;129707
500280;201401;1302;3906;1130;3666;214;731;686;2297;900;3028
500290;201401;3865;10162;2621;8042;735;2613;867;2431;1602;5044
500295;201401;2297;7273;1793;6064;439;1720;480;1409;919;3129
500310;201401;778;2117;703;2019;178;554;366;1016;544;1570
500315;201401;2868;9239;2508;8734;578;1956;1457;5436;2035;7392
500320;201401;13290;45574;11852;42993;4090;15737;4221;16283;8311;32020
500325;201401;4089;11109;3171;9645;917;3087;1327;3869;2244;6956
500330;201401;5518;15630;4528;13844;1480;4906;1731;5192;3211;10098
500345;201401;2417;7302;2089;6732;528;1903;1007;3148;1535;5051
500348;201401;2393;7226;2213;6932;286;1018;1619;5041;1905;6059
500350;201401;1231;3828;811;2869;140;520;237;883;377;1403
500370;201401;22797;72736;18623;64683;4833;18793;6835;23791;11668;42584
500375;201401;2640;7409;2037;6330;470;1556;954;3061;1424;4617
500380;201401;2871;8516;2483;7752;784;2631;803;2447;1587;5078
500390;201401;565;1242;376;973;57;184;252;602;309;786
500400;201401;1266;4108;1077;3658;339;1282;304;923;643;2205
500410;201401;2128;6080;1758;5551;479;1659;767;2432;1246;4091
500430;201401;2612;8029;2172;7379;556;2013;958;3400;1514;5413
500440;201401;1328;3942;1137;3639;298;1080;582;1801;880;2881
500450;201401;2137;6772;1731;5952;454;1768;345;1059;799;2827
500460;201401;3596;11142;2954;10161;803;3031;1169;3974;1972;7005
500470;201401;2970;9074;2305;7607;670;2414;417;1267;1087;3681
500480;201401;2009;6592;1869;6380;203;712;1457;5115;1660;5827
500490;201401;1062;3110;909;2861;290;1028;289;915;579;1943
500500;201401;3404;10702;2802;9847;1047;4146;891;3080;1938;7226
500510;201401;875;2401;618;1967;140;534;237;675;377;1209
500515;201401;1889;5186;1530;4698;276;836;931;3077;1207;3913
500520;201401;2760;9821;2465;9414;623;2520;1388;5540;2011;8060
500525;201401;1144;3791;1001;3522;233;877;511;1888;744;2765
500540;201401;5087;15156;3456;11953;1018;4011;753;2462;1771;6473
500560;201401;4536;15600;4137;15021;913;3492;2639;9745;3552;13237
500568;201401;3787;10218;2907;8925;686;2253;1341;4186;2027;6439
500570;201401;7440;20988;5476;17565;1671;5768;2006;6476;3677;12244
500580;201401;3419;10245;2753;9037;533;1883;1601;5267;2134;7150
500600;201401;2928;8441;2285;7389;660;2338;850;2732;1510;5070
500620;201401;7402;21285;5628;18329;1280;4757;2829;9099;4109;13856
500625;201401;682;2084;465;1614;109;432;156;508;265;940
500627;201401;249;697;177;556;39;140;37;121;76;261
500630;201401;6095;17456;4970;15858;1746;6187;1407;4469;3153;10656
500635;201401;2337;9321;2081;8950;314;1300;1347;6304;1661;7604
500640;201401;1419;3705;1152;3325;159;523;759;2136;918;2659
500660;201401;15384;47578;12891;43319;2990;11262;6019;20224;9009;31486
500690;201401;3041;8913;2516;8263;704;2397;1285;4502;1989;6899
500710;201401;3510;11014;3212;10549;848;2985;1651;5455;2499;8440
500720;201401;4546;13939;3613;12085;1164;4297;1055;3442;2219;7739
500730;201401;944;2757;757;2374;180;628;297;904;477;1532
500740;201401;3657;10415;2731;8768;605;2255;1197;3639;1802;5894
500750;201401;810;2478;750;2394;198;682;403;1317;601;1999
500755;201401;1244;3763;973;3256;235;868;367;1162;602;2030
500769;201401;4577;12567;3196;9869;727;2512;1022;2896;1749;5408
500770;201401;1656;5081;1356;4502;395;1418;448;1498;843;2916
500780;201401;1058;3381;944;3154;286;1033;416;1357;702;2390
500790;201401;8621;24948;7309;22648;1487;5430;3870;11427;5357;16857
500793;201401;2395;7077;1936;6311;357;1298;856;2658;1213;3956
500795;201401;2278;6926;2064;6620;273;744;1505;5183;1778;5927
500797;201401;914;2553;715;2230;155;533;332;1050;487;1583
500800;201401;2390;7104;2006;6550;667;2451;797;2611;1464;5062
500830;201401;15531;46735;11791;39021;3488;12611;3238;10417;6726;23028
500840;201401;1383;4101;1070;3493;220;778;472;1541;692;2319
510010;201401;1243;4009;1167;3880;391;1380;501;1718;892;3098
510020;201401;2739;8143;2024;6831;586;2113;509;1643;1095;3756
510025;201401;8933;27580;7939;25921;2510;9122;3163;10055;5673;19177
510030;201401;2091;5758;1779;5292;577;1797;752;2253;1329;4050
510035;201401;893;2703;766;2507;176;591;415;1429;591;2020
510040;201401;1684;4737;1350;4239;293;1044;679;2099;972;3143
510050;201401;1840;5454;1381;4615;389;1448;502;1665;891;3113
510060;201401;1223;3699;974;3232;276;1005;311;1001;587;2006
510080;201401;1300;4098;1098;3754;327;1308;361;1112;688;2420
510100;201401;629;1716;428;1316;95;331;153;446;248;777
510120;201401;289;597;194;493;15;32;167;433;182;465
510125;201401;3005;8122;2412;7106;472;1704;1142;3175;1614;4879
510130;201401;2067;5811;1780;5376;557;1779;704;2156;1261;3935
510140;201401;2931;9801;2477;9098;926;3575;813;3042;1739;6617
510160;201401;1268;4337;1214;4278;88;351;1065;3755;1153;4106
510170;201401;5941;18631;5070;17007;1296;4874;2251;7328;3547;12202
510180;201401;10584;29812;8140;25843;2578;8730;2836;9841;5414;18571
510185;201401;1143;3760;1071;3657;248;816;686;2491;934;3307
510190;201401;1607;5580;1338;5131;331;1429;567;2271;898;3700
510250;201401;13510;43702;11810;41358;3714;13913;5490;19732;9204;33645
510260;201401;2543;9697;2349;9299;728;3062;1025;4262;1753;7324
510263;201401;4168;11850;3218;10254;919;3228;1041;3175;1960;6403
510267;201401;5146;15145;3877;12450;914;3244;1382;4228;2296;7472
510268;201401;858;2546;745;2384;209;744;369;1171;578;1915
510269;201401;807;2660;735;2551;226;818;312;1118;538;1936
510270;201401;2341;7509;2146;7203;363;1214;1336;4733;1699;5947
510279;201401;2046;6704;1882;6428;706;2693;581;1802;1287;4495
510285;201401;1469;4608;1261;4237;365;1336;434;1399;799;2735
510300;201401;3061;9619;2755;9190;402;1509;2007;6675;2409;8184
510305;201401;1596;5180;1340;4708;374;1456;424;1500;798;2956
510310;201401;1095;3227;873;2870;310;1130;250;802;560;1932
510320;201401;3948;12018;3202;10518;989;3766;578;1627;1567;5393
510325;201401;5463;17801;4810;16874;632;2191;3650;13284;4282;15475
510330;201401;2685;9056;2352;8445;639;2557;901;3295;1540;5852
510335;201401;4417;14271;3945;13632;691;2387;2788;10050;3479;12437
510336;201401;502;1619;459;1538;104;372;224;757;328;1129
510337;201401;2219;7546;1963;7055;771;2850;600;2375;1371;5225
510340;201401;60457;182133;49349;165361;19707;72518;10573;37437;30280;109955
510343;201401;1133;3447;1045;3340;121;369;839;2765;960;3134
510345;201401;1655;4993;1426;4591;368;1292;479;1469;847;2761
510350;201401;3325;9937;2801;9212;811;2891;1309;4396;2120;7287
510360;201401;1773;4839;1349;4323;284;984;844;2657;1128;3641
510370;201401;876;3257;791;3114;231;936;390;1596;621;2532
510380;201401;474;1570;389;1393;140;556;65;217;205;773
510385;201401;877;3357;762;3063;134;590;353;1520;487;2110
510390;201401;1132;3603;1046;3503;265;826;598;2193;863;3019
510395;201401;813;2177;633;1944;117;384;372;1193;489;1577
510410;201401;3879;13025;3685;12695;1090;4056;1834;6314;2924;10370
510420;201401;2256;6042;1749;5207;302;1064;905;2672;1207;3736
510450;201401;579;1642;451;1466;147;541;145;456;292;997
510452;201401;604;1976;448;1608;116;468;156;522;272;990
510454;201401;733;2363;648;2240;163;589;345;1245;508;1834
510455;201401;993;3091;776;2686;195;799;291;963;486;1762
510460;201401;1942;5728;1741;5453;361;1309;1113;3381;1474;4690
510480;201401;4025;11268;3193;9710;809;2663;1079;3208;1888;5871
510490;201401;1466;4906;1321;4690;364;1404;728;2556;1092;3960
510500;201401;1393;4323;1052;3685;292;1171;461;1543;753;2714
510510;201401;3021;10812;2697;10255;1048;4231;930;3571;1978;7802
510515;201401;5579;17551;4639;15636;1228;4658;1312;4169;2540;8827
510517;201401;1701;5258;1520;4992;457;1451;895;3091;1352;4542
510520;201401;2142;5662;1693;5042;137;477;1271;3777;1408;4254
510523;201401;1037;3203;886;2958;272;976;414;1349;686;2325
510525;201401;7775;20081;5134;15972;1258;4287;1813;5550;3071;9837
510530;201401;560;1624;491;1525;89;323;282;877;371;1200
510550;201401;2692;9093;2360;8520;664;2495;1051;3936;1715;6431
510558;201401;2061;6079;1638;5446;504;1836;620;2036;1124;3872
510560;201401;1599;5350;1203;4641;437;1772;271;1115;708;2887
510562;201401;5084;15842;4500;14705;1579;5694;1446;4758;3025;10452
510590;201401;2727;7994;2212;7345;640;2338;961;3240;1601;5578
510600;201401;1476;3844;1038;3170;170;572;532;1566;702;2138
510610;201401;2691;8176;2452;7854;288;1070;1908;6066;2196;7136
510615;201401;2106;7032;1882;6649;640;2441;787;2755;1427;5196
510617;201401;527;1658;471;1575;80;305;340;1143;420;1448
510618;201401;1303;3952;990;3345;255;979;430;1438;685;2417
510619;201401;771;2159;519;1708;104;375;155;508;259;883
510620;201401;1182;3254;812;2707;295;1113;171;524;466;1637
510621;201401;1035;3667;916;3409;272;1111;307;1089;579;2200
510622;201401;3549;11054;2451;8569;590;2329;389;1157;979;3486
510623;201401;3672;10730;3126;9850;1109;3688;1140;3592;2249;7280
510624;201401;1168;3715;963;3336;224;878;402;1313;626;2191
510625;201401;2299;6845;1879;6095;548;2009;495;1532;1043;3541
510626;201401;1248;4033;1036;3689;343;1336;470;1680;813;3016
510627;201401;688;2130;554;1889;206;767;166;565;372;1332
510628;201401;1504;3962;1203;3596;177;597;819;2449;996;3046
510629;201401;1763;5922;1551;5479;558;2170;341;1131;899;3301
510630;201401;2596;8777;2212;8123;728;3007;582;2184;1310;5191
510631;201401;403;1189;364;1127;78;242;229;713;307;955
510637;201401;2569;7990;2360;7618;740;2644;1054;3297;1794;5941
510642;201401;4701;15590;4064;14754;1405;5368;1799;6846;3204;12214
510645;201401;701;1780;564;1613;216;640;168;540;384;1180
510650;201401;5922;20429;5553;19980;1393;5295;3340;12504;4733;17799
510665;201401;1217;3347;874;2798;217;780;344;1082;561;1862
510670;201401;349;875;213;677;48;179;79;233;127;412
510675;201401;6093;20485;5331;19038;1836;7199;1493;5208;3329;12407
510677;201401;2540;6555;1906;5726;281;888;1329;4145;1610;5033
510680;201401;791;2510;677;2315;154;589;290;926;444;1515
510682;201401;2351;7512;1954;6810;522;1943;804;2938;1326;4881
510685;201401;931;2603;802;2447;103;360;577;1765;680;2125
510700;201401;3976;10946;2967;9412;620;2174;1707;5408;2327;7582
510704;201401;7859;22788;6617;20634;1768;6228;3120;9400;4888;15628
510706;201401;1648;5248;1343;4749;418;1562;602;2121;1020;3683
510710;201401;3586;10351;2868;8921;835;2946;929;2581;1764;5527
510715;201401;701;1851;487;1505;124;416;174;502;298;918
510718;201401;1703;5210;1519;4963;405;1367;857;2880;1262;4247
510719;201401;442;1026;274;808;35;145;123;330;158;475
510720;201401;1254;2994;931;2613;88;270;716;2042;804;2312
510724;201401;811;2547;693;2322;158;587;396;1290;554;1877
510726;201401;666;1811;560;1633;159;485;199;557;358;1042
510729;201401;649;1830;534;1651;158;527;214;667;372;1194
510730;201401;2279;7217;2046;6802;497;1917;1107;3501;1604;5418
510735;201401;1054;3688;898;3424;335;1361;351;1338;686;2699
510740;201401;977;2553;803;2307;179;512;473;1397;652;1909
510757;201401;662;2355;614;2252;173;672;291;1064;464;1736
510760;201401;27144;78657;22182;70221;7999;27216;7131;22618;15130;49834
510770;201401;4372;11998;4025;11601;646;1862;2541;8232;3187;10094
510774;201401;378;1109;314;1005;71;255;153;477;224;732
510775;201401;850;2406;682;2146;250;898;250;791;500;1689
510776;201401;448;1288;373;1155;87;305;174;525;261;830
510777;201401;1393;4402;1116;4061;273;1128;662;2376;935;3504
510779;201401;623;1885;482;1627;86;315;182;641;268;956
510780;201401;3832;11502;3359;10846;785;2730;1872;6220;2657;8950
510785;201401;1865;5703;1561;5197;532;1884;559;1896;1091;3780
510787;201401;2005;6392;1777;6002;552;2038;683;2256;1235;4294
510788;201401;354;1119;326;1081;147;479;102;354;249;833
510790;201401;14830;44124;10515;35998;2986;11826;1398;4623;4384;16449
510792;201401;5696;19020;4386;16276;1125;4816;815;2845;1940;7661
510794;201401;1360;4282;1088;3856;497;1863;214;686;711;2549
510795;201401;8672;28828;7094;25645;2332;9145;1803;6600;4135;15745
510800;201401;1775;5176;1500;4815;423;1495;703;2163;1126;3658
510805;201401;1800;5173;1494;4735;266;964;992;3106;1258;4070
510810;201401;676;1679;536;1488;153;458;265;723;418;1181
510820;201401;833;2112;648;1840;158;529;250;639;408;1168
510830;201401;550;1945;500;1865;174;692;222;881;396;1573
510835;201401;707;2236;559;1957;199;766;209;677;408;1443
510840;201401;48721;125643;40137;115071;10338;31610;20771;61582;31109;93192
510850;201401;1661;4964;1364;4516;596;2214;206;544;802;2758
510860;201401;2463;8417;2052;7512;707;2814;356;1243;1063;4057
510880;201401;826;2810;729;2640;258;985;255;928;513;1913
510885;201401;557;1608;426;1414;93;354;185;615;278;969
510890;201401;889;3048;775;2836;260;1071;195;637;455;1708
510895;201401;1116;3665;1003;3459;307;1182;395;1285;702;2467
520005;201401;1189;3939;1111;3817;362;1310;483;1675;845;2985
520010;201401;1854;6484;1643;6034;719;2961;253;789;972;3750
520013;201401;3935;11167;3061;9640;777;2611;1383;4405;2160;7016
520015;201401;577;1619;469;1457;135;434;170;545;305;979
520017;201401;1178;3769;1038;3534;294;1083;437;1456;731;2539
520020;201401;417;1125;323;976;90;287;157;497;247;784
520025;201401;21963;72987;21433;72336;3396;12131;16448;55753;19844;67884
520030;201401;4513;14899;4034;14118;1362;5157;1489;5322;2851;10479
520050;201401;339;1032;314;979;64;225;204;613;268;838
520055;201401;667;2046;574;1888;149;485;288;982;437;1467
520060;201401;1656;5233;1477;4894;344;1269;583;1979;927;3248
520080;201401;1573;5153;1420;4899;381;1355;720;2553;1101;3908
520082;201401;611;2103;584;2046;149;519;339;1225;488;1744
520085;201401;1008;3241;889;2964;207;767;342;1133;549;1900
520090;201401;921;2284;751;2056;136;347;420;1243;556;1590
520110;201401;38848;119701;31074;108002;12511;47761;7649;27106;20160;74867
520120;201401;262;689;157;505;38;145;37;124;75;269
520130;201401;3661;10983;3407;10598;727;2443;2039;6362;2766;8805
520140;201401;42833;145533;39032;138051;14178;54165;10847;38209;25025;92374
520145;201401;543;1413;404;1219;96;319;160;465;256;784
520150;201401;680;1822;563;1687;163;535;265;779;428;1314
520160;201401;824;2529;739;2405;258;888;277;922;535;1810
520170;201401;3883;9709;3152;8927;602;1843;2155;6233;2757;8076
520180;201401;1750;5508;1520;5134;450;1648;606;2036;1056;3684
520215;201401;1632;4379;1429;4091;281;895;858;2472;1139;3367
520235;201401;817;2255;644;2002;188;643;266;802;454;1445
520250;201401;1103;3774;1035;3664;355;1331;491;1778;846;3109
520260;201401;736;1993;568;1686;96;330;281;804;377;1134
520280;201401;578;1702;528;1627;245;816;129;445;374;1261
520310;201401;995;2570;806;2325;213;649;429;1327;642;1976
520320;201401;1459;4784;1238;4353;217;816;690;2486;907;3302
520330;201401;2819;8932;2202;7819;669;2555;436;1485;1105;4040
520340;201401;1884;4902;1522;4477;226;625;1156;3524;1382;4149
520350;201401;2984;9157;2615;8429;957;3310;1048;3289;2005;6599
520355;201401;1113;3927;1082;3860;430;1613;432;1521;862;3134
520357;201401;886;2450;762;2271;70;237;525;1549;595;1786
520360;201401;595;1667;530;1565;145;439;238;710;383;1149
520380;201401;1103;3091;846;2652;176;614;440;1396;616;2010
520390;201401;1187;3192;841;2723;280;1038;312;921;592;1959
520393;201401;569;1527;521;1450;95;282;337;943;432;1225
520396;201401;707;2313;659;2232;103;394;440;1506;543;1900
520400;201401;1696;4921;1455;4589;284;974;890;2835;1174;3809
520410;201401;1475;4088;1196;3691;363;1231;531;1618;894;2849
520420;201401;339;949;257;802;48;175;113;332;161;507
520425;201401;1410;3983;1332;3851;446;1376;619;1768;1065;3144
520430;201401;1868;5077;1453;4409;314;1096;615;1788;929;2884
520440;201401;3165;8650;2423;7473;877;2993;609;1852;1486;4845
520450;201401;9283;27498;7386;23929;2143;7783;1409;4201;3552;11984
520455;201401;665;2025;553;1845;217;791;152;508;369;1299
520460;201401;809;2409;672;2181;191;690;252;797;443;1487
520465;201401;796;2221;701;2097;172;635;311;847;483;1482
520470;201401;1735;5724;1591;5511;412;1438;942;3421;1354;4859
520480;201401;952;2857;837;2669;194;645;491;1585;685;2230
520485;201401;1140;3969;1065;3836;415;1598;459;1651;874;3249
520490;201401;4303;13587;3507;12351;1505;5728;1094;3856;2599;9584
520495;201401;1391;3810;1161;3534;82;242;998;3107;1080;3349
520500;201401;2023;5498;1819;5216;627;1916;727;2255;1354;4171
520505;201401;894;2588;774;2409;124;376;535;1726;659;2102
520510;201401;11050;31504;7572;25651;2325;8715;1835;6219;4160;14934
520520;201401;1031;3046;878;2842;340;1180;332;1091;672;2271
520530;201401;2377;7447;2050;6912;488;1668;987;3696;1475;5364
520540;201401;2957;9172;2597;8562;850;2954;1002;3303;1852;6257
520545;201401;1315;4105;1141;3754;339;1202;327;1021;666;2223
520547;201401;785;2520;647;2281;225;873;174;571;399;1444
520549;201401;8481;26476;7461;25226;2176;7866;3744;12749;5920;20615
520551;201401;3716;11440;3576;11271;1106;3634;1948;6397;3054;10031
520552;201401;689;2334;673;2311;125;480;448;1528;573;2008
520570;201401;572;1701;434;1470;186;673;78;258;264;931
520580;201401;1954;5826;1633;5350;499;1846;516;1614;1015;3460
520590;201401;1506;4320;1286;3971;353;1158;489;1426;842;2584
520620;201401;7026;23155;6447;22282;1520;5664;3710;12962;5230;18626
520630;201401;630;1803;546;1702;163;502;297;954;460;1456
520640;201401;2509;7628;2260;7240;810;2711;950;3191;1760;5902
520650;201401;795;2334;694;2146;286;940;251;768;537;1708
520660;201401;362;1162;322;1086;107;396;97;322;204;718
520670;201401;793;2412;768;2374;74;184;663;2105;737;2289
520680;201401;589;1797;512;1688;181;653;188;615;369;1268
520690;201401;312;830;226;714;36;119;121;398;157;517
520710;201401;449;1155;316;908;11;39;197;550;208;589
520725;201401;1780;4762;1397;4196;332;1135;722;2119;1054;3254
520735;201401;674;2040;551;1824;183;654;161;513;344;1167
520740;201401;1676;4946;1419;4590;400;1373;665;2141;1065;3514
520750;201401;682;1863;523;1652;142;509;295;928;437;1437
520753;201401;1145;3418;1109;3362;176;489;835;2642;1011;3131
520760;201401;1134;3214;1005;3049;334;1099;533;1597;867;2696
520780;201401;2012;5102;1719;4707;213;557;1305;3684;1518;4241
520790;201401;2493;7217;2243;6868;350;1179;1587;4908;1937;6087
520800;201401;17110;51657;15372;49593;3668;11691;9053;31525;12721;43216
520810;201401;929;2632;847;2527;149;470;606;1873;755;2343
520815;201401;427;1487;344;1323;166;727;30;105;196;832
520830;201401;1682;4355;1322;3980;60;159;1194;3687;1254;3846
520840;201401;1625;5561;1476;5266;516;1948;500;1828;1016;3776
520850;201401;773;2294;619;2083;191;687;271;892;462;1579
520860;201401;6962;20121;5275;17860;1487;5469;2481;8623;3968;14092
520870;201401;119987;342812;87981;285554;28517;101110;25118;80816;53635;181926
520880;201401;6634;19646;4933;16935;1466;5686;686;2153;2152;7839
520890;201401;3663;10985;3269;10378;791;2702;1706;5410;2497;8112
520910;201401;3205;10152;2663;9017;840;3157;651;2117;1491;5274
520915;201401;908;2616;686;2188;172;567;255;769;427;1336
520920;201401;3128;8606;2271;7218;604;2090;656;2134;1260;4224
520929;201401;442;1322;402;1276;119;391;203;644;322;1035
520940;201401;949;2943;863;2808;133;500;602;1926;735;2426
520945;201401;637;1632;562;1514;207;563;205;537;412;1100
520960;201401;884;2630;734;2399;133;465;412;1349;545;1814
520970;201401;3344;9898;2760;8855;634;2302;1074;3362;1708;5664
520980;201401;1005;2761;933;2667;223;712;613;1720;836;2432
520990;201401;3657;11517;3355;10961;688;2465;1735;6266;2423;8731
520993;201401;1104;3129;910;2780;145;487;529;1593;674;2080
520995;201401;2542;7105;2293;6770;377;1180;1611;4759;1988;5939
521000;201401;7641;23337;6620;21688;1572;5711;3335;10938;4907;16649
521010;201401;3748;11906;3263;10975;861;3137;1319;4476;2180;7613
521015;201401;676;1943;581;1791;139;442;295;928;434;1370
521020;201401;4381;13143;3515;11354;1217;4241;685;1968;1902;6209
521030;201401;806;2193;712;2061;151;458;456;1339;607;1797
521040;201401;5363;16005;4945;15354;1952;6157;2232;7277;4184;13434
521056;201401;979;3055;837;2820;295;1040;337;1168;632;2208
521060;201401;1123;3205;992;3001;245;793;402;1183;647;1976
521080;201401;1177;3010;785;2357;157;558;275;700;432;1258
521090;201401;3098;9348;2675;8756;984;3434;900;2973;1884;6407
521100;201401;1389;3664;1286;3545;255;699;878;2499;1133;3198
521120;201401;4701;13889;4333;13290;1042;3142;2385;7603;3427;10745
521130;201401;1082;3131;911;2841;220;780;439;1374;659;2154
521140;201401;890;3020;814;2847;303;1135;174;586;477;1721
521150;201401;12587;33854;8875;26787;2641;8848;3339;9969;5980;18817
521160;201401;722;1890;505;1453;90;294;285;773;375;1067
521170;201401;1310;3205;1126;2979;345;893;616;1646;961;2539
521180;201401;6322;21730;5818;20710;2136;8147;1577;5591;3713;13738
521190;201401;8444;25641;6497;22297;2283;8289;1983;6891;4266;15180
521200;201401;833;2216;782;2155;109;314;567;1573;676;1887
521205;201401;486;1583;435;1485;74;273;256;881;330;1154
521210;201401;876;2593;643;2127;242;916;211;607;453;1523
521220;201401;3766;10890;3196;10100;1116;3821;1210;3758;2326;7579
521225;201401;379;994;303;896;48;157;195;590;243;747
521230;201401;1319;4208;1220;4004;478;1662;508;1598;986;3260
521250;201401;25437;86754;24391;85061;9835;36780;9615;33898;19450;70678
521260;201401;796;1986;638;1706;113;390;350;864;463;1254
521270;201401;1717;5618;1611;5436;164;483;1243;4403;1407;4886
521280;201401;1778;5615;1546;5208;494;1786;592;1998;1086;3784
521290;201401;504;1510;387;1317;112;452;144;469;256;921
521295;201401;1095;3113;1024;3016;157;489;778;2299;935;2788
521300;201401;1801;5322;1669;5111;558;1768;737;2342;1295;4110
521305;201401;838;2233;709;2059;176;512;413;1242;589;1754
521308;201401;4954;15001;4039;13473;822;3052;2245;7396;3067;10448
521310;201401;7132;22211;5886;19880;2171;7794;1479;4851;3650;12645
521340;201401;243;786;223;749;70;264;89;281;159;545
521350;201401;2189;5714;1811;5205;250;775;1169;3562;1419;4337
521370;201401;998;3252;921;3102;333;1194;297;956;630;2150
521375;201401;1339;3924;1173;3648;293;1010;602;1821;895;2831
521377;201401;1003;2954;958;2900;86;247;818;2526;904;2773
521380;201401;3749;11205;3008;9941;732;2672;1131;3646;1863;6318
521385;201401;587;1691;529;1612;174;552;229;702;403;1254
521390;201401;1106;2935;829;2552;256;903;257;774;513;1677
521400;201401;2398;6555;2061;6161;338;1124;1483;4388;1821;5512
521405;201401;1234;3709;1083;3429;338;1190;429;1339;767;2529
521410;201401;735;2406;675;2301;310;1046;239;858;549;1904
521440;201401;1471;4134;1458;4120;150;384;1239;3603;1389;3987
521450;201401;4941;15191;4168;13781;1372;4903;1009;3178;2381;8081
521460;201401;6949;22101;6438;21324;1950;7048;3054;10058;5004;17106
521470;201401;696;1974;527;1659;128;459;105;320;233;779
521480;201401;509;1510;379;1276;125;425;93;313;218;738
521483;201401;3060;8263;2575;7436;724;2236;1050;2979;1774;5215
521486;201401;1578;4510;1429;4223;358;1183;868;2463;1226;3646
521487;201401;565;1552;435;1355;108;328;212;688;320;1016
521490;201401;816;2418;664;2209;118;443;430;1443;548;1886
521500;201401;1216;4064;1122;3871;207;786;660;2177;867;2963
521520;201401;883;2134;812;2048;197;432;431;1256;628;1688
521523;201401;11290;42620;10694;41600;3488;15023;2904;11549;6392;26572
521525;201401;1105;2901;979;2737;134;430;659;1791;793;2221
521530;201401;2001;6049;1418;4895;544;1978;235;767;779;2745
521540;201401;888;2609;664;2167;200;763;175;503;375;1266
521550;201401;952;2431;858;2300;253;733;450;1164;703;1897
521560;201401;4901;15114;3954;13867;1660;6387;1039;3500;2699;9887
521565;201401;700;1863;600;1737;110;317;404;1197;514;1514
521570;201401;4545;12928;3348;10561;1137;3851;1027;3257;2164;7108
521580;201401;667;1651;493;1410;174;543;156;441;330;984
521590;201401;747;2132;621;1920;232;780;115;370;347;1150
521600;201401;619;1650;455;1368;117;389;156;421;273;810
521630;201401;1786;4891;1512;4467;560;1929;258;607;818;2536
521640;201401;1743;5129;1534;4806;520;1888;421;1350;941;3238
521645;201401;643;2015;548;1795;145;530;221;667;366;1197
521680;201401;1446;4678;1260;4282;680;2443;198;627;878;3070
521690;201401;576;1748;520;1645;126;474;243;710;369;1184
521710;201401;2211;7008;1977;6555;415;1479;1157;3824;1572;5303
521720;201401;2048;6160;1883;5930;498;1632;1076;3498;1574;5130
521730;201401;3803;12912;3552;12417;1546;5933;958;3088;2504;9021
521740;201401;3413;9546;2766;8731;1281;4168;966;3197;2247;7365
521760;201401;12159;42182;11494;41172;2118;8442;7621;27483;9739;35925
521770;201401;2725;8425;2331;7631;1041;3654;490;1482;1531;5136
521800;201401;8634;25960;7498;24283;2742;9403;3290;11049;6032;20452
521805;201401;932;2192;778;1942;249;567;377;1074;626;1641
521810;201401;812;2423;721;2268;177;606;356;1102;533;1708
521830;201401;5435;18538;5147;18094;1066;4089;3384;11883;4450;15972
521839;201401;602;1881;511;1693;132;470;198;617;330;1087
521850;201401;6488;18769;5795;17664;1404;4303;3140;9723;4544;14026
521860;201401;1717;5314;1507;4892;423;1510;532;1649;955;3159
521870;201401;550;1949;514;1853;157;614;146;486;303;1100
521878;201401;470;1609;432;1528;133;525;162;553;295;1078
521880;201401;24766;66570;17283;54344;5997;20345;4858;15457;10855;35802
521890;201401;3570;11292;3059;10263;1187;4275;714;2360;1901;6635
521900;201401;1659;4457;1368;4057;359;1183;530;1458;889;2641
521910;201401;1179;3354;1040;3194;270;925;582;1814;852;2739
521920;201401;388;1184;353;1127;136;462;137;419;273;881
521925;201401;622;1941;558;1814;126;458;241;725;367;1183
521930;201401;3856;12608;3527;11977;1333;4810;1065;3634;2398;8444
521935;201401;669;2027;635;1962;199;647;326;981;525;1628
521940;201401;1137;3096;940;2768;351;1112;307;900;658;2012
521945;201401;660;2294;618;2243;134;440;429;1677;563;2117
521950;201401;506;1635;443;1522;147;542;172;602;319;1144
521960;201401;930;2763;803;2552;197;665;372;1168;569;1833
521970;201401;2461;7125;2258;6858;367;1133;1596;4997;1963;6130
521971;201401;960;2659;770;2344;192;656;307;890;499;1546
521973;201401;856;2908;781;2759;228;852;255;891;483;1743
521975;201401;13252;38718;12522;37784;2519;8266;7854;23880;10373;32146
521980;201401;1750;5599;1693;5536;284;911;1307;4429;1591;5340
521990;201401;1025;3264;958;3148;177;635;588;1903;765;2538
522000;201401;2078;6206;1846;5908;390;1344;1092;3627;1482;4971
522005;201401;349;953;283;849;72;233;139;411;211;644
522010;201401;2865;8759;2490;8148;905;3247;709;2228;1614;5475
522015;201401;1004;2973;844;2731;245;884;385;1235;630;2119
522020;201401;4456;12598;3985;12007;978;3239;2342;6919;3320;10158
522026;201401;642;1855;463;1667;209;807;133;495;342;1302
522028;201401;530;1596;480;1515;121;417;283;874;404;1291
522040;201401;3041;7915;2263;6924;810;2665;876;2700;1686;5365
522045;201401;12344;41227;10717;37891;3634;14079;2227;7642;5861;21721
522050;201401;1008;3005;833;2713;283;1023;324;996;607;2019
522060;201401;2943;9379;2526;8740;799;2980;1243;4278;2042;7258
522068;201401;1510;4974;1421;4876;140;424;1166;4210;1306;4634
522070;201401;824;2536;754;2422;118;462;482;1532;600;1994
522100;201401;804;2250;718;2119;271;914;308;826;579;1740
522108;201401;932;2779;827;2621;94;309;598;1958;692;2267
522119;201401;1261;3923;1067;3677;130;437;795;2860;925;3297
522130;201401;506;1479;438;1404;132;460;222;725;354;1185
522140;201401;17398;50042;15386;47129;4809;16000;6279;18883;11088;34883
522145;201401;901;2628;854;2549;445;1400;217;636;662;2036
522150;201401;1260;3356;1057;3078;384;1198;374;1135;758;2333
522155;201401;725;2180;661;2089;145;481;393;1292;538;1773
522157;201401;686;2037;606;1905;71;254;466;1461;537;1715
522160;201401;6126;17836;4626;15310;1902;6945;794;2487;2696;9432
522170;201401;3166;8867;2685;8195;782;2432;1143;3683;1925;6115
522180;201401;435;1278;335;1134;151;572;110;356;261;928
522185;201401;14089;44894;13139;43618;2926;10560;7892;26346;10818;36906
522190;201401;797;2250;703;2081;125;388;413;1231;538;1619
522200;201401;1558;5285;1448;5056;506;1918;428;1442;934;3360
522205;201401;1288;3763;1086;3425;331;1095;469;1488;800;2583
522220;201401;1180;3519;1012;3299;239;858;532;1836;771;2694
522230;201401;1085;3417;999;3279;196;727;630;2076;826;2803
530010;201401;251170;826850;227872;780423;70527;267168;74525;253775;145052;520943
